test4sub83of100,test4pub1of1,1,317,172,775,151,1098
test4sub45of100,test4pub1of1,1,317,172,720,193,1085
test4sub4of100,test4pub1of1,1,317,172,481,235,888
test4sub54of100,test4pub1of1,1,317,172,321,273,766
test4sub62of100,test4pub1of1,1,317,172,389,312,873
test4sub15of100,test4pub1of1,1,317,172,457,359,988
test4sub39of100,test4pub1of1,1,317,172,483,393,1048
test4sub35of100,test4pub1of1,1,317,172,732,432,1336
test4sub42of100,test4pub1of1,1,317,172,563,473,1208
test4sub14of100,test4pub1of1,1,317,172,188,513,873
test4sub74of100,test4pub1of1,1,317,172,537,553,1262
test4sub76of100,test4pub1of1,1,317,172,659,593,1424
test4sub77of100,test4pub1of1,1,317,172,404,633,1209
test4sub44of100,test4pub1of1,1,317,172,272,673,1117
test4sub93of100,test4pub1of1,1,317,172,773,713,1658
test4sub32of100,test4pub1of1,1,317,172,71,753,996
test4sub19of100,test4pub1of1,1,317,172,390,792,1354
test4sub7of100,test4pub1of1,1,317,172,468,833,1473
test4sub59of100,test4pub1of1,1,317,172,266,873,1311
test4sub96of100,test4pub1of1,1,317,172,385,931,1488
test4sub16of100,test4pub1of1,1,317,172,485,953,1610
test4sub2of100,test4pub1of1,1,317,172,537,993,1702
test4sub69of100,test4pub1of1,1,317,172,620,1033,1825
test4sub99of100,test4pub1of1,1,317,172,480,1073,1725
test4sub1of100,test4pub1of1,1,317,172,159,1115,1446
test4sub87of100,test4pub1of1,1,317,172,732,1153,2057
test4sub66of100,test4pub1of1,1,317,172,273,1197,1642
test4sub5of100,test4pub1of1,1,317,172,127,1237,1536
test4sub48of100,test4pub1of1,1,317,172,34,1277,1483
test4sub63of100,test4pub1of1,1,317,172,766,1317,2255
test4sub34of100,test4pub1of1,1,317,172,266,1357,1795
test4sub6of100,test4pub1of1,1,317,172,274,1397,1843
test4sub51of100,test4pub1of1,1,317,172,323,1436,1931
test4sub65of100,test4pub1of1,1,317,172,417,1477,2066
test4sub33of100,test4pub1of1,1,317,172,709,1516,2397
test4sub91of100,test4pub1of1,1,317,172,586,1557,2315
test4sub9of100,test4pub1of1,1,317,172,308,1596,2076
test4sub22of100,test4pub1of1,1,317,172,737,1636,2545
test4sub17of100,test4pub1of1,1,317,172,267,1676,2115
test4sub11of100,test4pub1of1,1,317,172,245,1716,2133
test4sub70of100,test4pub1of1,1,317,172,488,1757,2417
test4sub94of100,test4pub1of1,1,317,172,317,1797,2286
test4sub78of100,test4pub1of1,1,317,172,405,1837,2414
test4sub40of100,test4pub1of1,1,317,172,362,1877,2411
test4sub55of100,test4pub1of1,1,317,172,1017,1800,2989
test4sub24of100,test4pub1of1,1,317,172,1064,1794,3030
test4sub31of100,test4pub1of1,1,317,172,1069,1829,3070
test4sub26of100,test4pub1of1,1,317,172,1076,1863,3111
test4sub86of100,test4pub1of1,1,317,172,1087,1890,3149
test4sub100of100,test4pub1of1,1,317,172,1109,1909,3190
test4sub71of100,test4pub1of1,1,317,172,1116,1940,3228
test4sub73of100,test4pub1of1,1,317,172,1134,1960,3266
test4sub57of100,test4pub1of1,1,317,172,1140,1998,3310
test4sub27of100,test4pub1of1,1,317,172,1153,2025,3350
test4sub10of100,test4pub1of1,1,317,172,1177,2041,3390
test4sub79of100,test4pub1of1,1,317,172,1248,2010,3430
test4sub64of100,test4pub1of1,1,317,172,1318,1981,3471
test4sub41of100,test4pub1of1,1,317,172,1321,2017,3510
test4sub21of100,test4pub1of1,1,317,172,1348,2030,3550
test4sub92of100,test4pub1of1,1,317,172,1349,2069,3590
test4sub30of100,test4pub1of1,1,317,172,1370,2088,3630
test4sub36of100,test4pub1of1,1,317,172,1386,2112,3670
test4sub67of100,test4pub1of1,1,317,172,1391,2147,3710
test4sub38of100,test4pub1of1,1,317,172,1401,2177,3750
test4sub82of100,test4pub1of1,1,317,172,1454,2164,3790
test4sub80of100,test4pub1of1,1,317,172,1457,2201,3830
test4sub61of100,test4pub1of1,1,317,172,1486,2212,3870
test4sub81of100,test4pub1of1,1,317,172,1501,2238,3911
test4sub43of100,test4pub1of1,1,317,172,1505,2274,3951
test4sub47of100,test4pub1of1,1,317,172,1518,2301,3991
test4sub25of100,test4pub1of1,1,317,172,1548,2310,4030
test4sub8of100,test4pub1of1,1,317,172,1579,2319,4070
test4sub68of100,test4pub1of1,1,317,172,1585,2353,4110
test4sub37of100,test4pub1of1,1,317,172,1619,2359,4150
test4sub53of100,test4pub1of1,1,317,172,1631,2388,4191
test4sub97of100,test4pub1of1,1,317,172,1665,2393,4230
test4sub49of100,test4pub1of1,1,317,172,1693,2406,4271
test4sub28of100,test4pub1of1,1,317,172,1786,2352,4310
test4sub84of100,test4pub1of1,1,317,172,1798,2380,4350
test4sub90of100,test4pub1of1,1,317,172,1802,2385,4359
test4sub52of100,test4pub1of1,1,317,172,1836,2422,4430
test4sub12of100,test4pub1of1,1,317,172,1836,2462,4470
test4sub46of100,test4pub1of1,1,317,172,1858,2480,4510
test4sub23of100,test4pub1of1,1,317,172,1864,2514,4550
test4sub95of100,test4pub1of1,1,317,172,1868,2551,4591
test4sub88of100,test4pub1of1,1,317,172,1869,2589,4630
test4sub13of100,test4pub1of1,1,317,172,1874,2625,4671
test4sub29of100,test4pub1of1,1,317,172,1899,2639,4710
test4sub20of100,test4pub1of1,1,317,172,1905,2673,4750
test4sub89of100,test4pub1of1,1,317,172,1906,2713,4791
test4sub72of100,test4pub1of1,1,317,172,1911,2748,4831
test4sub18of100,test4pub1of1,1,317,172,1950,2748,4870
test4sub56of100,test4pub1of1,1,317,172,1975,2764,4911
test4sub50of100,test4pub1of1,1,317,172,1989,2790,4951
test4sub98of100,test4pub1of1,1,317,172,1997,2822,4991
test4sub3of100,test4pub1of1,1,317,172,2016,2842,5030
test4sub75of100,test4pub1of1,1,317,172,2036,2863,5071
test4sub60of100,test4pub1of1,1,317,172,2047,2892,5111
test4sub58of100,test4pub1of1,1,317,172,2050,2928,5150
test4sub85of100,test4pub1of1,1,317,172,2090,2929,5191
test4sub48of100,test4pub1of1,10,1468,182,16,459,657
test4sub32of100,test4pub1of1,10,1468,182,23,557,762
test4sub5of100,test4pub1of1,10,1468,182,33,545,760
test4sub14of100,test4pub1of1,10,1468,182,44,569,795
test4sub59of100,test4pub1of1,10,1468,182,51,604,837
test4sub34of100,test4pub1of1,10,1468,182,52,644,878
test4sub11of100,test4pub1of1,10,1468,182,48,682,912
test4sub17of100,test4pub1of1,10,1468,182,54,720,956
test4sub1of100,test4pub1of1,10,1468,182,41,759,982
test4sub44of100,test4pub1of1,10,1468,182,57,798,1037
test4sub66of100,test4pub1of1,10,1468,182,60,836,1078
test4sub6of100,test4pub1of1,10,1468,182,79,857,1118
test4sub9of100,test4pub1of1,10,1468,182,81,895,1158
test4sub94of100,test4pub1of1,10,1468,182,97,920,1199
test4sub54of100,test4pub1of1,10,1468,182,99,957,1238
test4sub51of100,test4pub1of1,10,1468,182,111,678,971
test4sub30of100,test4pub1of1,10,1468,182,421,715,1318
test4sub21of100,test4pub1of1,10,1468,182,422,755,1359
test4sub71of100,test4pub1of1,10,1468,182,425,792,1399
test4sub60of100,test4pub1of1,10,1468,182,428,828,1438
test4sub92of100,test4pub1of1,10,1468,182,430,866,1478
test4sub29of100,test4pub1of1,10,1468,182,431,905,1518
test4sub85of100,test4pub1of1,10,1468,182,433,943,1558
test4sub88of100,test4pub1of1,10,1468,182,434,982,1598
test4sub100of100,test4pub1of1,10,1468,182,428,1020,1630
test4sub95of100,test4pub1of1,10,1468,182,437,1059,1678
test4sub46of100,test4pub1of1,10,1468,182,443,1094,1719
test4sub52of100,test4pub1of1,10,1468,182,446,1131,1759
test4sub90of100,test4pub1of1,10,1468,182,451,1166,1799
test4sub84of100,test4pub1of1,10,1468,182,454,1203,1839
test4sub18of100,test4pub1of1,10,1468,182,457,1239,1878
test4sub20of100,test4pub1of1,10,1468,182,457,1278,1917
test4sub49of100,test4pub1of1,10,1468,182,462,1314,1958
test4sub53of100,test4pub1of1,10,1468,182,466,1351,1999
test4sub58of100,test4pub1of1,10,1468,182,469,1383,2034
test4sub75of100,test4pub1of1,10,1468,182,475,1422,2079
test4sub50of100,test4pub1of1,10,1468,182,465,1459,2106
test4sub25of100,test4pub1of1,10,1468,182,478,1499,2159
test4sub81of100,test4pub1of1,10,1468,182,481,1535,2198
test4sub47of100,test4pub1of1,10,1468,182,481,1575,2238
test4sub56of100,test4pub1of1,10,1468,182,475,1613,2270
test4sub37of100,test4pub1of1,10,1468,182,469,1651,2302
test4sub12of100,test4pub1of1,10,1468,182,449,1690,2321
test4sub28of100,test4pub1of1,10,1468,182,460,1730,2372
test4sub80of100,test4pub1of1,10,1468,182,487,1770,2439
test4sub82of100,test4pub1of1,10,1468,182,490,1806,2478
test4sub38of100,test4pub1of1,10,1468,182,493,1843,2518
test4sub26of100,test4pub1of1,10,1468,182,498,1878,2558
test4sub64of100,test4pub1of1,10,1468,182,499,1918,2599
test4sub31of100,test4pub1of1,10,1468,182,501,1955,2638
test4sub55of100,test4pub1of1,10,1468,182,502,1995,2679
test4sub83of100,test4pub1of1,10,1468,182,505,2032,2719
test4sub57of100,test4pub1of1,10,1468,182,506,2071,2759
test4sub86of100,test4pub1of1,10,1468,182,510,2043,2735
test4sub63of100,test4pub1of1,10,1468,182,511,2082,2775
test4sub8of100,test4pub1of1,10,1468,182,473,2118,2773
test4sub67of100,test4pub1of1,10,1468,182,496,2156,2834
test4sub98of100,test4pub1of1,10,1468,182,462,2188,2832
test4sub61of100,test4pub1of1,10,1468,182,485,2227,2894
test4sub3of100,test4pub1of1,10,1468,182,472,2267,2921
test4sub23of100,test4pub1of1,10,1468,182,440,2306,2928
test4sub97of100,test4pub1of1,10,1468,182,466,2470,3118
test4sub73of100,test4pub1of1,10,1468,182,508,2386,3076
test4sub79of100,test4pub1of1,10,1468,182,505,2423,3110
test4sub68of100,test4pub1of1,10,1468,182,471,2454,3107
test4sub22of100,test4pub1of1,10,1468,182,606,2491,3279
test4sub13of100,test4pub1of1,10,1468,182,603,2530,3315
test4sub72of100,test4pub1of1,10,1468,182,601,2567,3350
test4sub93of100,test4pub1of1,10,1468,182,508,2607,3297
test4sub40of100,test4pub1of1,10,1468,182,581,2644,3407
test4sub43of100,test4pub1of1,10,1468,182,481,2682,3345
test4sub89of100,test4pub1of1,10,1468,182,600,2721,3503
test4sub19of100,test4pub1of1,10,1468,182,581,2760,3523
test4sub41of100,test4pub1of1,10,1468,182,498,2800,3480
test4sub96of100,test4pub1of1,10,1468,182,581,2838,3601
test4sub77of100,test4pub1of1,10,1468,182,580,2875,3637
test4sub78of100,test4pub1of1,10,1468,182,580,2915,3677
test4sub62of100,test4pub1of1,10,1468,182,580,2950,3712
test4sub7of100,test4pub1of1,10,1468,182,580,2989,3751
test4sub65of100,test4pub1of1,10,1468,182,580,3029,3791
test4sub27of100,test4pub1of1,10,1468,182,748,2949,3879
test4sub10of100,test4pub1of1,10,1468,182,754,2983,3919
test4sub99of100,test4pub1of1,10,1468,182,580,3147,3909
test4sub39of100,test4pub1of1,10,1468,182,579,3186,3947
test4sub15of100,test4pub1of1,10,1468,182,580,3231,3993
test4sub2of100,test4pub1of1,10,1468,182,579,3261,4022
test4sub42of100,test4pub1of1,10,1468,182,578,3299,4059
test4sub16of100,test4pub1of1,10,1468,182,579,3344,4105
test4sub70of100,test4pub1of1,10,1468,182,579,3381,4142
test4sub4of100,test4pub1of1,10,1468,182,580,3420,4182
test4sub91of100,test4pub1of1,10,1468,182,578,3458,4218
test4sub69of100,test4pub1of1,10,1468,182,578,3495,4255
test4sub74of100,test4pub1of1,10,1468,182,579,3537,4298
test4sub33of100,test4pub1of1,10,1468,182,577,3572,4331
test4sub45of100,test4pub1of1,10,1468,182,577,3615,4374
test4sub87of100,test4pub1of1,10,1468,182,576,3649,4407
test4sub76of100,test4pub1of1,10,1468,182,577,3692,4451
test4sub35of100,test4pub1of1,10,1468,182,575,3727,4484
test4sub24of100,test4pub1of1,10,1468,182,501,3764,4447
test4sub36of100,test4pub1of1,10,1468,182,497,3802,4481
test4sub48of100,test4pub1of1,100,12976,134,234,909,1277
test4sub32of100,test4pub1of1,100,12976,134,658,529,1321
test4sub1of100,test4pub1of1,100,12976,134,690,541,1365
test4sub5of100,test4pub1of1,100,12976,134,690,581,1405
test4sub14of100,test4pub1of1,100,12976,134,761,550,1445
test4sub11of100,test4pub1of1,100,12976,134,1022,329,1485
test4sub59of100,test4pub1of1,100,12976,134,1096,299,1529
test4sub17of100,test4pub1of1,100,12976,134,1170,265,1569
test4sub44of100,test4pub1of1,100,12976,134,1176,303,1613
test4sub66of100,test4pub1of1,100,12976,134,1208,315,1657
test4sub6of100,test4pub1of1,100,12976,134,1248,319,1701
test4sub9of100,test4pub1of1,100,12976,134,1375,232,1741
test4sub94of100,test4pub1of1,100,12976,134,1379,253,1766
test4sub54of100,test4pub1of1,100,12976,134,1437,257,1828
test4sub51of100,test4pub1of1,100,12976,134,1461,274,1869
test4sub40of100,test4pub1of1,100,12976,134,1584,188,1906
test4sub96of100,test4pub1of1,100,12976,134,1590,228,1952
test4sub62of100,test4pub1of1,100,12976,134,1654,209,1997
test4sub19of100,test4pub1of1,100,12976,134,1756,147,2037
test4sub39of100,test4pub1of1,100,12976,134,2129,42,2305
test4sub34of100,test4pub1of1,100,12976,134,2140,71,2345
test4sub2of100,test4pub1of1,100,12976,134,2143,112,2389
test4sub43of100,test4pub1of1,100,12976,134,2283,44,2461
test4sub77of100,test4pub1of1,100,12976,134,2395,44,2573
test4sub78of100,test4pub1of1,100,12976,134,2411,73,2618
test4sub65of100,test4pub1of1,100,12976,134,2461,66,2661
test4sub7of100,test4pub1of1,100,12976,134,2481,90,2705
test4sub99of100,test4pub1of1,100,12976,134,2485,142,2761
test4sub4of100,test4pub1of1,100,12976,134,2510,169,2813
test4sub91of100,test4pub1of1,100,12976,134,2522,201,2857
test4sub82of100,test4pub1of1,100,12976,134,2558,209,2901
test4sub80of100,test4pub1of1,100,12976,134,2562,253,2949
test4sub61of100,test4pub1of1,100,12976,134,2563,295,2992
test4sub81of100,test4pub1of1,100,12976,134,2570,329,3033
test4sub47of100,test4pub1of1,100,12976,134,2582,450,3166
test4sub25of100,test4pub1of1,100,12976,134,2583,486,3203
test4sub8of100,test4pub1of1,100,12976,134,2589,525,3248
test4sub37of100,test4pub1of1,100,12976,134,2593,557,3284
test4sub53of100,test4pub1of1,100,12976,134,2597,601,3332
test4sub97of100,test4pub1of1,100,12976,134,2598,645,3377
test4sub68of100,test4pub1of1,100,12976,134,2590,657,3381
test4sub28of100,test4pub1of1,100,12976,134,2603,700,3437
test4sub46of100,test4pub1of1,100,12976,134,2631,741,3506
test4sub23of100,test4pub1of1,100,12976,134,2635,780,3549
test4sub49of100,test4pub1of1,100,12976,134,2602,823,3559
test4sub84of100,test4pub1of1,100,12976,134,2623,866,3623
test4sub52of100,test4pub1of1,100,12976,134,2620,910,3664
test4sub16of100,test4pub1of1,100,12976,134,2625,950,3709
test4sub90of100,test4pub1of1,100,12976,134,2623,993,3750
test4sub95of100,test4pub1of1,100,12976,134,2651,1023,3808
test4sub88of100,test4pub1of1,100,12976,134,2669,1055,3858
test4sub13of100,test4pub1of1,100,12976,134,2672,1099,3905
test4sub29of100,test4pub1of1,100,12976,134,2676,1139,3949
test4sub89of100,test4pub1of1,100,12976,134,2686,1169,3989
test4sub72of100,test4pub1of1,100,12976,134,2719,1180,4033
test4sub56of100,test4pub1of1,100,12976,134,2724,1218,4076
test4sub50of100,test4pub1of1,100,12976,134,2735,1247,4116
test4sub3of100,test4pub1of1,100,12976,134,2737,1286,4157
test4sub75of100,test4pub1of1,100,12976,134,2768,1295,4197
test4sub60of100,test4pub1of1,100,12976,134,2809,1293,4236
test4sub58of100,test4pub1of1,100,12976,134,2812,1331,4277
test4sub85of100,test4pub1of1,100,12976,134,2815,1368,4317
test4sub15of100,test4pub1of1,100,12976,134,2866,1357,4357
test4sub20of100,test4pub1of1,100,12976,134,2866,1401,4401
test4sub70of100,test4pub1of1,100,12976,134,2910,1397,4441
test4sub55of100,test4pub1of1,100,12976,134,2932,1415,4481
test4sub73of100,test4pub1of1,100,12976,134,2937,1450,4521
test4sub41of100,test4pub1of1,100,12976,134,3054,1373,4561
test4sub12of100,test4pub1of1,100,12976,134,3114,1353,4601
test4sub74of100,test4pub1of1,100,12976,134,3161,1346,4641
test4sub18of100,test4pub1of1,100,12976,134,3181,1366,4681
test4sub27of100,test4pub1of1,100,12976,134,3196,1391,4721
test4sub98of100,test4pub1of1,100,12976,134,3196,1431,4761
test4sub42of100,test4pub1of1,100,12976,134,3201,1466,4801
test4sub76of100,test4pub1of1,100,12976,134,3212,1495,4841
test4sub33of100,test4pub1of1,100,12976,134,3217,1530,4881
test4sub45of100,test4pub1of1,100,12976,134,3283,1504,4921
test4sub69of100,test4pub1of1,100,12976,134,3325,1502,4961
test4sub87of100,test4pub1of1,100,12976,134,3360,1496,4990
test4sub22of100,test4pub1of1,100,12976,134,3372,1535,5041
test4sub35of100,test4pub1of1,100,12976,134,3392,1555,5081
test4sub63of100,test4pub1of1,100,12976,134,3397,1590,5121
test4sub93of100,test4pub1of1,100,12976,134,3460,1667,5261
test4sub83of100,test4pub1of1,100,12976,134,3470,1703,5307
test4sub24of100,test4pub1of1,100,12976,134,3601,1617,5352
test4sub71of100,test4pub1of1,100,12976,134,3604,1649,5387
test4sub26of100,test4pub1of1,100,12976,134,3625,1670,5429
test4sub31of100,test4pub1of1,100,12976,134,3627,1712,5473
test4sub86of100,test4pub1of1,100,12976,134,3634,1745,5513
test4sub100of100,test4pub1of1,100,12976,134,3654,1769,5557
test4sub57of100,test4pub1of1,100,12976,134,3657,1806,5597
test4sub10of100,test4pub1of1,100,12976,134,3724,1785,5643
test4sub64of100,test4pub1of1,100,12976,134,3728,1826,5688
test4sub79of100,test4pub1of1,100,12976,134,3730,1865,5729
test4sub38of100,test4pub1of1,100,12976,134,3746,1893,5773
test4sub36of100,test4pub1of1,100,12976,134,3761,1918,5813
test4sub30of100,test4pub1of1,100,12976,134,3762,1960,5856
test4sub67of100,test4pub1of1,100,12976,134,3793,1970,5897
test4sub21of100,test4pub1of1,100,12976,134,3778,2013,5925
test4sub92of100,test4pub1of1,100,12976,134,3780,2062,5976
test4sub48of100,test4pub1of10,1,317,24,5,830,859
test4sub32of100,test4pub1of10,1,317,24,9,867,900
test4sub5of100,test4pub1of10,1,317,24,16,900,940
test4sub1of100,test4pub1of10,1,317,24,19,937,980
test4sub14of100,test4pub1of10,1,317,24,22,978,1024
test4sub11of100,test4pub1of10,1,317,24,27,1013,1064
test4sub59of100,test4pub1of10,1,317,24,31,1048,1103
test4sub34of100,test4pub1of10,1,317,24,32,1088,1144
test4sub44of100,test4pub1of10,1,317,24,34,1126,1184
test4sub17of100,test4pub1of10,1,317,24,34,1166,1224
test4sub66of100,test4pub1of10,1,317,24,42,1198,1264
test4sub6of100,test4pub1of10,1,317,24,43,1237,1304
test4sub9of100,test4pub1of10,1,317,24,46,1273,1343
test4sub94of100,test4pub1of10,1,317,24,49,1311,1384
test4sub54of100,test4pub1of10,1,317,24,50,1349,1423
test4sub51of100,test4pub1of10,1,317,24,52,1388,1464
test4sub40of100,test4pub1of10,1,317,24,53,1426,1503
test4sub96of100,test4pub1of10,1,317,24,53,1466,1543
test4sub62of100,test4pub1of10,1,317,24,55,1505,1584
test4sub19of100,test4pub1of10,1,317,24,59,1541,1624
test4sub77of100,test4pub1of10,1,317,24,62,1578,1664
test4sub78of100,test4pub1of10,1,317,24,62,1618,1704
test4sub15of100,test4pub1of10,1,317,24,64,1656,1744
test4sub65of100,test4pub1of10,1,317,24,64,1696,1784
test4sub7of100,test4pub1of10,1,317,24,70,1730,1824
test4sub99of100,test4pub1of10,1,317,24,78,1762,1864
test4sub4of100,test4pub1of10,1,317,24,82,1798,1904
test4sub39of100,test4pub1of10,1,317,24,83,1837,1944
test4sub16of100,test4pub1of10,1,317,24,86,1874,1984
test4sub74of100,test4pub1of10,1,317,24,89,1911,2024
test4sub70of100,test4pub1of10,1,317,24,88,1951,2063
test4sub2of100,test4pub1of10,1,317,24,91,1989,2104
test4sub42of100,test4pub1of10,1,317,24,93,2027,2144
test4sub91of100,test4pub1of10,1,317,24,94,2066,2184
test4sub69of100,test4pub1of10,1,317,24,95,2105,2224
test4sub76of100,test4pub1of10,1,317,24,97,2143,2264
test4sub33of100,test4pub1of10,1,317,24,102,2178,2304
test4sub45of100,test4pub1of10,1,317,24,103,2217,2344
test4sub35of100,test4pub1of10,1,317,24,104,2256,2384
test4sub22of100,test4pub1of10,1,317,24,105,2295,2424
test4sub87of100,test4pub1of10,1,317,24,105,2334,2463
test4sub63of100,test4pub1of10,1,317,24,107,2372,2503
test4sub93of100,test4pub1of10,1,317,24,108,2411,2543
test4sub55of100,test4pub1of10,1,317,24,110,2450,2584
test4sub83of100,test4pub1of10,1,317,24,112,2488,2624
test4sub73of100,test4pub1of10,1,317,24,115,2525,2664
test4sub27of100,test4pub1of10,1,317,24,118,2562,2704
test4sub41of100,test4pub1of10,1,317,24,127,2593,2744
test4sub82of100,test4pub1of10,1,317,24,138,2622,2784
test4sub80of100,test4pub1of10,1,317,24,154,2646,2824
test4sub61of100,test4pub1of10,1,317,24,156,2684,2864
test4sub24of100,test4pub1of10,1,317,24,158,2722,2904
test4sub81of100,test4pub1of10,1,317,24,160,2759,2943
test4sub43of100,test4pub1of10,1,317,24,160,2799,2983
test4sub47of100,test4pub1of10,1,317,24,160,2838,3022
test4sub8of100,test4pub1of10,1,317,24,162,2876,3062
test4sub37of100,test4pub1of10,1,317,24,165,2915,3104
test4sub25of100,test4pub1of10,1,317,24,163,2955,3142
test4sub68of100,test4pub1of10,1,317,24,164,2995,3183
test4sub28of100,test4pub1of10,1,317,24,167,3032,3223
test4sub84of100,test4pub1of10,1,317,24,171,3069,3264
test4sub71of100,test4pub1of10,1,317,24,194,3086,3304
test4sub26of100,test4pub1of10,1,317,24,235,3085,3344
test4sub31of100,test4pub1of10,1,317,24,278,3081,3383
test4sub86of100,test4pub1of10,1,317,24,319,3081,3424
test4sub100of100,test4pub1of10,1,317,24,362,3077,3463
test4sub57of100,test4pub1of10,1,317,24,403,3077,3504
test4sub10of100,test4pub1of10,1,317,24,449,3070,3543
test4sub64of100,test4pub1of10,1,317,24,494,3066,3584
test4sub79of100,test4pub1of10,1,317,24,535,3065,3624
test4sub38of100,test4pub1of10,1,317,24,579,3061,3664
test4sub36of100,test4pub1of10,1,317,24,619,3061,3704
test4sub30of100,test4pub1of10,1,317,24,662,3057,3743
test4sub67of100,test4pub1of10,1,317,24,703,3057,3784
test4sub21of100,test4pub1of10,1,317,24,756,3043,3823
test4sub46of100,test4pub1of10,1,317,24,173,3667,3864
test4sub48of100,test4pub2of10,1,189,11,401,3003,3415
test4sub32of100,test4pub2of10,1,189,11,441,2970,3422
test4sub5of100,test4pub2of10,1,189,11,481,2933,3425
test4sub14of100,test4pub2of10,1,189,11,565,2852,3428
test4sub11of100,test4pub2of10,1,189,11,605,2815,3431
test4sub59of100,test4pub2of10,1,189,11,645,2776,3432
test4sub34of100,test4pub2of10,1,189,11,685,2738,3434
test4sub44of100,test4pub2of10,1,189,11,725,2698,3434
test4sub1of100,test4pub2of10,1,189,11,522,2904,3437
test4sub17of100,test4pub2of10,1,189,11,765,2660,3436
test4sub66of100,test4pub2of10,1,189,11,805,2624,3440
test4sub6of100,test4pub2of10,1,189,11,845,2584,3440
test4sub9of100,test4pub2of10,1,189,11,885,2546,3442
test4sub94of100,test4pub2of10,1,189,11,925,2507,3443
test4sub54of100,test4pub2of10,1,189,11,965,2469,3445
test4sub51of100,test4pub2of10,1,189,11,1005,2429,3445
test4sub96of100,test4pub2of10,1,189,11,1085,2352,3448
test4sub62of100,test4pub2of10,1,189,11,1125,2311,3447
test4sub19of100,test4pub2of10,1,189,11,1166,2275,3452
test4sub77of100,test4pub2of10,1,189,11,1205,2236,3452
test4sub90of100,test4pub1of10,1,317,24,171,3745,3940
test4sub78of100,test4pub2of10,1,189,11,1246,2234,3491
test4sub15of100,test4pub2of10,1,189,11,1285,2197,3493
test4sub65of100,test4pub2of10,1,189,11,1325,2158,3494
test4sub7of100,test4pub2of10,1,189,11,1365,2120,3496
test4sub99of100,test4pub2of10,1,189,11,1405,2080,3496
test4sub4of100,test4pub2of10,1,189,11,1445,2043,3499
test4sub39of100,test4pub2of10,1,189,11,1485,2003,3499
test4sub16of100,test4pub2of10,1,189,11,1525,1966,3502
test4sub74of100,test4pub2of10,1,189,11,1565,1925,3501
test4sub70of100,test4pub2of10,1,189,11,1605,1887,3503
test4sub2of100,test4pub2of10,1,189,11,1645,1849,3505
test4sub42of100,test4pub2of10,1,189,11,1685,1811,3507
test4sub91of100,test4pub2of10,1,189,11,1725,1771,3507
test4sub41of100,test4pub2of10,1,189,11,2285,1229,3525
test4sub27of100,test4pub2of10,1,189,11,2245,1268,3524
test4sub83of100,test4pub2of10,1,189,11,2165,1350,3526
test4sub55of100,test4pub2of10,1,189,11,2125,1391,3527
test4sub73of100,test4pub2of10,1,189,11,2205,1310,3526
test4sub76of100,test4pub2of10,1,189,11,1805,1712,3528
test4sub93of100,test4pub2of10,1,189,11,2085,1431,3527
test4sub63of100,test4pub2of10,1,189,11,2045,1471,3527
test4sub87of100,test4pub2of10,1,189,11,2005,1512,3528
test4sub22of100,test4pub2of10,1,189,11,1965,1552,3528
test4sub35of100,test4pub2of10,1,189,11,1925,1592,3528
test4sub69of100,test4pub2of10,1,189,11,1765,1752,3528
test4sub33of100,test4pub2of10,1,189,11,1845,1672,3528
test4sub92of100,test4pub1of10,1,317,24,2109,1883,4016
test4sub82of100,test4pub2of10,1,189,11,2325,1231,3567
test4sub80of100,test4pub2of10,1,189,11,2365,1194,3570
test4sub61of100,test4pub2of10,1,189,11,2405,1157,3573
test4sub24of100,test4pub2of10,1,189,11,2445,1120,3576
test4sub81of100,test4pub2of10,1,189,11,2485,1084,3580
test4sub43of100,test4pub2of10,1,189,11,2525,1048,3584
test4sub47of100,test4pub2of10,1,189,11,2565,1012,3588
test4sub8of100,test4pub2of10,1,189,11,2605,975,3591
test4sub37of100,test4pub2of10,1,189,11,2645,939,3595
test4sub25of100,test4pub2of10,1,189,11,2686,901,3598
test4sub68of100,test4pub2of10,1,189,11,2725,864,3600
test4sub28of100,test4pub2of10,1,189,11,2765,828,3604
test4sub84of100,test4pub2of10,1,189,11,2805,793,3609
test4sub71of100,test4pub2of10,1,189,11,2845,756,3612
test4sub26of100,test4pub2of10,1,189,11,2885,719,3615
test4sub31of100,test4pub2of10,1,189,11,2925,682,3618
test4sub86of100,test4pub2of10,1,189,11,2965,646,3622
test4sub100of100,test4pub2of10,1,189,11,3005,609,3625
test4sub57of100,test4pub2of10,1,189,11,3045,574,3630
test4sub64of100,test4pub2of10,1,189,11,3125,497,3633
test4sub79of100,test4pub2of10,1,189,11,3165,457,3633
test4sub38of100,test4pub2of10,1,189,11,3205,419,3635
test4sub36of100,test4pub2of10,1,189,11,3245,380,3636
test4sub30of100,test4pub2of10,1,189,11,3285,342,3638
test4sub67of100,test4pub2of10,1,189,11,3325,302,3638
test4sub23of100,test4pub1of10,1,317,24,173,3931,4128
test4sub21of100,test4pub2of10,1,189,11,3365,303,3679
test4sub46of100,test4pub2of10,1,189,11,3405,265,3681
test4sub32of100,test4pub3of10,1,189,19,3074,257,3350
test4sub5of100,test4pub3of10,1,189,19,3078,257,3354
test4sub14of100,test4pub3of10,1,189,19,3081,254,3354
test4sub11of100,test4pub3of10,1,189,19,3084,254,3357
test4sub59of100,test4pub3of10,1,189,19,3084,254,3357
test4sub44of100,test4pub3of10,1,189,19,3087,254,3360
test4sub34of100,test4pub3of10,1,189,19,3087,257,3363
test4sub1of100,test4pub3of10,1,189,19,3089,257,3365
test4sub17of100,test4pub3of10,1,189,19,3089,261,3369
test4sub66of100,test4pub3of10,1,189,19,3092,259,3370
test4sub6of100,test4pub3of10,1,189,19,3092,262,3373
test4sub9of100,test4pub3of10,1,189,19,3095,259,3373
test4sub94of100,test4pub3of10,1,189,19,3095,262,3376
test4sub51of100,test4pub3of10,1,189,19,3098,259,3376
test4sub54of100,test4pub3of10,1,189,19,3097,261,3377
test4sub62of100,test4pub3of10,1,189,19,3100,260,3379
test4sub96of100,test4pub3of10,1,189,19,3100,262,3381
test4sub19of100,test4pub3of10,1,189,19,3104,258,3381
test4sub77of100,test4pub3of10,1,189,19,3104,261,3384
test4sub78of100,test4pub3of10,1,189,19,3143,222,3384
test4sub90of100,test4pub2of10,1,189,11,3481,224,3716
test4sub15of100,test4pub3of10,1,189,19,3146,222,3387
test4sub65of100,test4pub3of10,1,189,19,3146,224,3389
test4sub7of100,test4pub3of10,1,189,19,3148,221,3388
test4sub99of100,test4pub3of10,1,189,19,3149,224,3392
test4sub39of100,test4pub3of10,1,189,19,3151,221,3391
test4sub4of100,test4pub3of10,1,189,19,3151,224,3394
test4sub16of100,test4pub3of10,1,189,19,3154,222,3395
test4sub74of100,test4pub3of10,1,189,19,3154,224,3397
test4sub70of100,test4pub3of10,1,189,19,3157,221,3397
test4sub2of100,test4pub3of10,1,189,19,3157,224,3400
test4sub91of100,test4pub3of10,1,189,19,3160,224,3403
test4sub42of100,test4pub3of10,1,189,19,3160,227,3406
test4sub41of100,test4pub3of10,1,189,19,3177,212,3408
test4sub83of100,test4pub3of10,1,189,19,3178,215,3412
test4sub27of100,test4pub3of10,1,189,19,3177,216,3412
test4sub55of100,test4pub3of10,1,189,19,3181,219,3419
test4sub73of100,test4pub3of10,1,189,19,3182,221,3422
test4sub76of100,test4pub3of10,1,189,19,3184,223,3426
test4sub63of100,test4pub3of10,1,189,19,3185,225,3429
test4sub87of100,test4pub3of10,1,189,19,3186,226,3431
test4sub35of100,test4pub3of10,1,189,19,3187,230,3436
test4sub22of100,test4pub3of10,1,189,19,3186,231,3436
test4sub69of100,test4pub3of10,1,189,19,3188,235,3442
test4sub93of100,test4pub3of10,1,189,19,3184,235,3438
test4sub33of100,test4pub3of10,1,189,19,3188,239,3446
test4sub92of100,test4pub2of10,1,189,11,3557,214,3782
test4sub82of100,test4pub3of10,1,189,19,3219,216,3454
test4sub80of100,test4pub3of10,1,189,19,3222,217,3458
test4sub61of100,test4pub3of10,1,189,19,3227,216,3462
test4sub24of100,test4pub3of10,1,189,19,3230,216,3465
test4sub81of100,test4pub3of10,1,189,19,3234,216,3469
test4sub43of100,test4pub3of10,1,189,19,3237,216,3472
test4sub47of100,test4pub3of10,1,189,19,3240,215,3474
test4sub8of100,test4pub3of10,1,189,19,3244,216,3479
test4sub37of100,test4pub3of10,1,189,19,3247,215,3481
test4sub25of100,test4pub3of10,1,189,19,3251,215,3485
test4sub68of100,test4pub3of10,1,189,19,3254,214,3487
test4sub28of100,test4pub3of10,1,189,19,3258,214,3491
test4sub84of100,test4pub3of10,1,189,19,3261,214,3494
test4sub71of100,test4pub3of10,1,189,19,3265,214,3498
test4sub26of100,test4pub3of10,1,189,19,3268,215,3502
test4sub31of100,test4pub3of10,1,189,19,3271,214,3504
test4sub86of100,test4pub3of10,1,189,19,3275,215,3509
test4sub100of100,test4pub3of10,1,189,19,3278,215,3512
test4sub57of100,test4pub3of10,1,189,19,3283,213,3515
test4sub79of100,test4pub3of10,1,189,19,3286,215,3520
test4sub64of100,test4pub3of10,1,189,19,3285,218,3522
test4sub38of100,test4pub3of10,1,189,19,3288,218,3525
test4sub36of100,test4pub3of10,1,189,19,3288,221,3528
test4sub30of100,test4pub3of10,1,189,19,3291,222,3532
test4sub67of100,test4pub3of10,1,189,19,3291,225,3535
test4sub21of100,test4pub3of10,1,189,19,3331,188,3538
test4sub23of100,test4pub2of10,1,189,11,3669,192,3872
test4sub32of100,test4pub4of10,1,189,25,2953,192,3170
test4sub46of100,test4pub3of10,1,189,19,3334,196,3549
test4sub5of100,test4pub4of10,1,189,25,2955,197,3177
test4sub14of100,test4pub4of10,1,189,25,2956,199,3180
test4sub11of100,test4pub4of10,1,189,25,2958,200,3183
test4sub59of100,test4pub4of10,1,189,25,2958,204,3187
test4sub44of100,test4pub4of10,1,189,25,2961,203,3189
test4sub34of100,test4pub4of10,1,189,25,2965,203,3193
test4sub1of100,test4pub4of10,1,189,25,2968,203,3196
test4sub17of100,test4pub4of10,1,189,25,2971,203,3199
test4sub66of100,test4pub4of10,1,189,25,2972,206,3203
test4sub6of100,test4pub4of10,1,189,25,2975,206,3206
test4sub9of100,test4pub4of10,1,189,25,2975,209,3209
test4sub94of100,test4pub4of10,1,189,25,2977,210,3212
test4sub51of100,test4pub4of10,1,189,25,2978,209,3212
test4sub62of100,test4pub4of10,1,189,25,2980,210,3215
test4sub54of100,test4pub4of10,1,189,25,2980,210,3215
test4sub96of100,test4pub4of10,1,189,25,2982,209,3216
test4sub19of100,test4pub4of10,1,189,25,2983,210,3218
test4sub78of100,test4pub4of10,1,189,25,2985,210,3220
test4sub77of100,test4pub4of10,1,189,25,2985,210,3220
test4sub90of100,test4pub3of10,1,189,19,3369,210,3598
test4sub15of100,test4pub4of10,1,189,25,2988,210,3223
test4sub7of100,test4pub4of10,1,189,25,2991,210,3226
test4sub65of100,test4pub4of10,1,189,25,2991,210,3226
test4sub99of100,test4pub4of10,1,189,25,2993,210,3228
test4sub39of100,test4pub4of10,1,189,25,2994,209,3228
test4sub4of100,test4pub4of10,1,189,25,2996,210,3231
test4sub16of100,test4pub4of10,1,189,25,2996,210,3231
test4sub70of100,test4pub4of10,1,189,25,2999,210,3234
test4sub74of100,test4pub4of10,1,189,25,2999,210,3234
test4sub2of100,test4pub4of10,1,189,25,3002,209,3236
test4sub91of100,test4pub4of10,1,189,25,3004,207,3236
test4sub42of100,test4pub4of10,1,189,25,3008,206,3239
test4sub41of100,test4pub4of10,1,189,25,3011,203,3239
test4sub83of100,test4pub4of10,1,189,25,3014,203,3242
test4sub27of100,test4pub4of10,1,189,25,3018,199,3242
test4sub55of100,test4pub4of10,1,189,25,3021,198,3244
test4sub73of100,test4pub4of10,1,189,25,3024,195,3244
test4sub76of100,test4pub4of10,1,189,25,3028,194,3247
test4sub63of100,test4pub4of10,1,189,25,3031,192,3248
test4sub87of100,test4pub4of10,1,189,25,3034,191,3250
test4sub35of100,test4pub4of10,1,189,25,3037,190,3252
test4sub22of100,test4pub4of10,1,189,25,3040,190,3255
test4sub69of100,test4pub4of10,1,189,25,3044,190,3259
test4sub93of100,test4pub4of10,1,189,25,3047,187,3259
test4sub33of100,test4pub4of10,1,189,25,3050,186,3261
test4sub92of100,test4pub3of10,1,189,19,3435,183,3637
test4sub82of100,test4pub4of10,1,189,25,3057,182,3264
test4sub80of100,test4pub4of10,1,189,25,3060,179,3264
test4sub61of100,test4pub4of10,1,189,25,3064,178,3267
test4sub24of100,test4pub4of10,1,189,25,3067,174,3266
test4sub81of100,test4pub4of10,1,189,25,3071,174,3270
test4sub43of100,test4pub4of10,1,189,25,3074,171,3270
test4sub47of100,test4pub4of10,1,189,25,3077,169,3271
test4sub38of100,test4pub4of10,1,189,25,3127,141,3293
test4sub64of100,test4pub4of10,1,189,25,3124,146,3295
test4sub79of100,test4pub4of10,1,189,25,3120,151,3296
test4sub57of100,test4pub4of10,1,189,25,3117,154,3296
test4sub100of100,test4pub4of10,1,189,25,3114,160,3299
test4sub86of100,test4pub4of10,1,189,25,3110,163,3298
test4sub31of100,test4pub4of10,1,189,25,3107,169,3301
test4sub26of100,test4pub4of10,1,189,25,3103,174,3302
test4sub71of100,test4pub4of10,1,189,25,3100,180,3305
test4sub84of100,test4pub4of10,1,189,25,3097,185,3307
test4sub28of100,test4pub4of10,1,189,25,3094,190,3309
test4sub68of100,test4pub4of10,1,189,25,3090,194,3309
test4sub25of100,test4pub4of10,1,189,25,3087,200,3312
test4sub37of100,test4pub4of10,1,189,25,3084,205,3314
test4sub8of100,test4pub4of10,1,189,25,3080,166,3271
test4sub36of100,test4pub4of10,1,189,25,3130,165,3320
test4sub30of100,test4pub4of10,1,189,25,3133,164,3322
test4sub67of100,test4pub4of10,1,189,25,3137,164,3326
test4sub21of100,test4pub4of10,1,189,25,3140,162,3327
test4sub23of100,test4pub3of10,1,189,19,3524,160,3703
test4sub32of100,test4pub5of10,1,189,26,2775,160,2961
test4sub46of100,test4pub4of10,1,189,25,3150,156,3331
test4sub5of100,test4pub5of10,1,189,26,2781,156,2963
test4sub14of100,test4pub5of10,1,189,26,2785,153,2964
test4sub11of100,test4pub5of10,1,189,26,2788,152,2966
test4sub59of100,test4pub5of10,1,189,26,2791,148,2965
test4sub44of100,test4pub5of10,1,189,26,2794,147,2967
test4sub34of100,test4pub5of10,1,189,26,2798,145,2969
test4sub1of100,test4pub5of10,1,189,26,2801,143,2970
test4sub17of100,test4pub5of10,1,189,26,2805,140,2971
test4sub66of100,test4pub5of10,1,189,26,2808,140,2974
test4sub6of100,test4pub5of10,1,189,26,2811,137,2974
test4sub9of100,test4pub5of10,1,189,26,2814,136,2976
test4sub94of100,test4pub5of10,1,189,26,2816,134,2976
test4sub51of100,test4pub5of10,1,189,26,2817,136,2979
test4sub62of100,test4pub5of10,1,189,26,2819,137,2982
test4sub54of100,test4pub5of10,1,189,26,2819,140,2985
test4sub19of100,test4pub5of10,1,189,26,2822,140,2988
test4sub96of100,test4pub5of10,1,189,26,2822,143,2991
test4sub77of100,test4pub5of10,1,189,26,2825,142,2993
test4sub78of100,test4pub5of10,1,189,26,2825,145,2996
test4sub90of100,test4pub4of10,1,189,25,3199,145,3369
test4sub15of100,test4pub5of10,1,189,26,2828,148,3002
test4sub7of100,test4pub5of10,1,189,26,2830,146,3002
test4sub65of100,test4pub5of10,1,189,26,2830,148,3004
test4sub99of100,test4pub5of10,1,189,26,2833,145,3004
test4sub39of100,test4pub5of10,1,189,26,2833,148,3007
test4sub16of100,test4pub5of10,1,189,26,2835,146,3007
test4sub4of100,test4pub5of10,1,189,26,2835,148,3009
test4sub70of100,test4pub5of10,1,189,26,2838,145,3009
test4sub74of100,test4pub5of10,1,189,26,2839,148,3013
test4sub2of100,test4pub5of10,1,189,26,2841,145,3012
test4sub91of100,test4pub5of10,1,189,26,2841,147,3014
test4sub41of100,test4pub5of10,1,189,26,2844,144,3014
test4sub42of100,test4pub5of10,1,189,26,2843,147,3016
test4sub27of100,test4pub5of10,1,189,26,2846,145,3017
test4sub83of100,test4pub5of10,1,189,26,2846,147,3019
test4sub55of100,test4pub5of10,1,189,26,2849,145,3020
test4sub73of100,test4pub5of10,1,189,26,2849,147,3022
test4sub63of100,test4pub5of10,1,189,26,2852,144,3022
test4sub76of100,test4pub5of10,1,189,26,2852,146,3024
test4sub87of100,test4pub5of10,1,189,26,2854,144,3024
test4sub35of100,test4pub5of10,1,189,26,2858,143,3027
test4sub22of100,test4pub5of10,1,189,26,2861,140,3027
test4sub93of100,test4pub5of10,1,189,26,2864,141,3031
test4sub69of100,test4pub5of10,1,189,26,2863,141,3030
test4sub33of100,test4pub5of10,1,189,26,2866,140,3032
test4sub92of100,test4pub4of10,1,189,25,3238,141,3404
test4sub80of100,test4pub5of10,1,189,26,2869,140,3035
test4sub82of100,test4pub5of10,1,189,26,2869,140,3035
test4sub61of100,test4pub5of10,1,189,26,2871,140,3037
test4sub24of100,test4pub5of10,1,189,26,2872,140,3038
test4sub43of100,test4pub5of10,1,189,26,2874,140,3040
test4sub81of100,test4pub5of10,1,189,26,2874,143,3043
test4sub38of100,test4pub5of10,1,189,26,2898,121,3045
test4sub47of100,test4pub5of10,1,189,26,2897,122,3045
test4sub64of100,test4pub5of10,1,189,26,2900,122,3048
test4sub57of100,test4pub5of10,1,189,26,2902,120,3048
test4sub79of100,test4pub5of10,1,189,26,2902,122,3050
test4sub86of100,test4pub5of10,1,189,26,2904,121,3051
test4sub100of100,test4pub5of10,1,189,26,2903,123,3052
test4sub31of100,test4pub5of10,1,189,26,2905,121,3052
test4sub26of100,test4pub5of10,1,189,26,2907,121,3054
test4sub71of100,test4pub5of10,1,189,26,2909,121,3056
test4sub84of100,test4pub5of10,1,189,26,2911,121,3058
test4sub28of100,test4pub5of10,1,189,26,2913,119,3058
test4sub68of100,test4pub5of10,1,189,26,2915,119,3060
test4sub25of100,test4pub5of10,1,189,26,2917,118,3061
test4sub37of100,test4pub5of10,1,189,26,2919,118,3063
test4sub8of100,test4pub5of10,1,189,26,2920,117,3063
test4sub36of100,test4pub5of10,1,189,26,2925,115,3066
test4sub30of100,test4pub5of10,1,189,26,2928,114,3068
test4sub67of100,test4pub5of10,1,189,26,2931,112,3069
test4sub21of100,test4pub5of10,1,189,26,2931,114,3071
test4sub23of100,test4pub4of10,1,189,25,3306,111,3442
test4sub32of100,test4pub6of10,1,189,11,2537,111,2659
test4sub46of100,test4pub5of10,1,189,26,2937,111,3074
test4sub5of100,test4pub6of10,1,189,11,2540,111,2662
test4sub14of100,test4pub6of10,1,189,11,2540,112,2663
test4sub11of100,test4pub6of10,1,189,11,2542,111,2664
test4sub59of100,test4pub6of10,1,189,11,2543,111,2665
test4sub44of100,test4pub6of10,1,189,11,2545,112,2668
test4sub34of100,test4pub6of10,1,189,11,2545,112,2668
test4sub1of100,test4pub6of10,1,189,11,2548,111,2670
test4sub17of100,test4pub6of10,1,189,11,2548,111,2670
test4sub66of100,test4pub6of10,1,189,11,2550,112,2673
test4sub6of100,test4pub6of10,1,189,11,2550,112,2673
test4sub94of100,test4pub6of10,1,189,11,2553,111,2675
test4sub9of100,test4pub6of10,1,189,11,2553,112,2676
test4sub51of100,test4pub6of10,1,189,11,2555,111,2677
test4sub62of100,test4pub6of10,1,189,11,2558,108,2677
test4sub54of100,test4pub6of10,1,189,11,2561,108,2680
test4sub19of100,test4pub6of10,1,189,11,2564,105,2680
test4sub96of100,test4pub6of10,1,189,11,2567,119,2697
test4sub77of100,test4pub6of10,1,189,11,2570,119,2700
test4sub78of100,test4pub6of10,1,189,11,2573,116,2700
test4sub90of100,test4pub5of10,1,189,26,2975,115,3116
test4sub7of100,test4pub6of10,1,189,11,2578,113,2702
test4sub15of100,test4pub6of10,1,189,11,2578,116,2705
test4sub99of100,test4pub6of10,1,189,11,2581,113,2705
test4sub65of100,test4pub6of10,1,189,11,2581,116,2708
test4sub16of100,test4pub6of10,1,189,11,2583,114,2708
test4sub39of100,test4pub6of10,1,189,11,2583,117,2711
test4sub70of100,test4pub6of10,1,189,11,2586,114,2711
test4sub4of100,test4pub6of10,1,189,11,2585,118,2714
test4sub74of100,test4pub6of10,1,189,11,2588,116,2715
test4sub2of100,test4pub6of10,1,189,11,2588,119,2718
test4sub91of100,test4pub6of10,1,189,11,2591,116,2718
test4sub41of100,test4pub6of10,1,189,11,2591,118,2720
test4sub27of100,test4pub6of10,1,189,11,2593,116,2720
test4sub42of100,test4pub6of10,1,189,11,2593,119,2723
test4sub83of100,test4pub6of10,1,189,11,2596,116,2723
test4sub55of100,test4pub6of10,1,189,11,2596,118,2725
test4sub73of100,test4pub6of10,1,189,11,2598,117,2726
test4sub63of100,test4pub6of10,1,189,11,2598,119,2728
test4sub76of100,test4pub6of10,1,189,11,2601,116,2728
test4sub87of100,test4pub6of10,1,189,11,2601,119,2731
test4sub35of100,test4pub6of10,1,189,11,2603,117,2731
test4sub22of100,test4pub6of10,1,189,11,2604,119,2734
test4sub69of100,test4pub6of10,1,189,11,2606,116,2733
test4sub93of100,test4pub6of10,1,189,11,2606,118,2735
test4sub92of100,test4pub5of10,1,189,26,3008,116,3150
test4sub33of100,test4pub6of10,1,189,11,2609,118,2738
test4sub82of100,test4pub6of10,1,189,11,2611,116,2738
test4sub80of100,test4pub6of10,1,189,11,2611,119,2741
test4sub24of100,test4pub6of10,1,189,11,2614,116,2741
test4sub61of100,test4pub6of10,1,189,11,2614,121,2746
test4sub43of100,test4pub6of10,1,189,11,2616,118,2745
test4sub81of100,test4pub6of10,1,189,11,2619,118,2748
test4sub38of100,test4pub6of10,1,189,11,2622,116,2749
test4sub47of100,test4pub6of10,1,189,11,2622,118,2751
test4sub64of100,test4pub6of10,1,189,11,2624,116,2751
test4sub57of100,test4pub6of10,1,189,11,2624,118,2753
test4sub79of100,test4pub6of10,1,189,11,2627,116,2754
test4sub86of100,test4pub6of10,1,189,11,2627,119,2757
test4sub100of100,test4pub6of10,1,189,11,2629,120,2760
test4sub31of100,test4pub6of10,1,189,11,2630,122,2763
test4sub71of100,test4pub6of10,1,189,11,2632,122,2765
test4sub26of100,test4pub6of10,1,189,11,2632,125,2768
test4sub84of100,test4pub6of10,1,189,11,2634,126,2771
test4sub28of100,test4pub6of10,1,189,11,2635,127,2773
test4sub68of100,test4pub6of10,1,189,11,2637,128,2776
test4sub25of100,test4pub6of10,1,189,11,2637,131,2779
test4sub37of100,test4pub6of10,1,189,11,2639,128,2778
test4sub8of100,test4pub6of10,1,189,11,2640,130,2781
test4sub36of100,test4pub6of10,1,189,11,2642,128,2781
test4sub67of100,test4pub6of10,1,189,11,2645,128,2784
test4sub30of100,test4pub6of10,1,189,11,2645,128,2784
test4sub23of100,test4pub5of10,1,189,26,3047,136,3209
test4sub21of100,test4pub6of10,1,189,11,2648,139,2798
test4sub32of100,test4pub7of10,1,189,18,2348,139,2505
test4sub46of100,test4pub6of10,1,189,11,2651,139,2801
test4sub5of100,test4pub7of10,1,189,18,2351,138,2507
test4sub14of100,test4pub7of10,1,189,18,2351,138,2507
test4sub11of100,test4pub7of10,1,189,18,2353,138,2509
test4sub59of100,test4pub7of10,1,189,18,2354,138,2510
test4sub34of100,test4pub7of10,1,189,18,2356,138,2512
test4sub44of100,test4pub7of10,1,189,18,2356,139,2513
test4sub1of100,test4pub7of10,1,189,18,2359,138,2515
test4sub17of100,test4pub7of10,1,189,18,2359,138,2515
test4sub6of100,test4pub7of10,1,189,18,2361,139,2518
test4sub66of100,test4pub7of10,1,189,18,2361,139,2518
test4sub9of100,test4pub7of10,1,189,18,2364,139,2521
test4sub94of100,test4pub7of10,1,189,18,2364,139,2521
test4sub62of100,test4pub7of10,1,189,18,2367,138,2523
test4sub51of100,test4pub7of10,1,189,18,2367,139,2524
test4sub19of100,test4pub7of10,1,189,18,2369,139,2526
test4sub54of100,test4pub7of10,1,189,18,2369,139,2526
test4sub96of100,test4pub7of10,1,189,18,2385,124,2527
test4sub77of100,test4pub7of10,1,189,18,2388,123,2529
test4sub78of100,test4pub7of10,1,189,18,2388,125,2531
test4sub90of100,test4pub6of10,1,189,11,2693,122,2826
test4sub7of100,test4pub7of10,1,189,18,2391,125,2534
test4sub15of100,test4pub7of10,1,189,18,2393,124,2535
test4sub99of100,test4pub7of10,1,189,18,2394,127,2539
test4sub65of100,test4pub7of10,1,189,18,2396,126,2540
test4sub16of100,test4pub7of10,1,189,18,2396,130,2544
test4sub70of100,test4pub7of10,1,189,18,2399,130,2547
test4sub39of100,test4pub7of10,1,189,18,2399,132,2549
test4sub74of100,test4pub7of10,1,189,18,2404,130,2552
test4sub4of100,test4pub7of10,1,189,18,2404,130,2552
test4sub91of100,test4pub7of10,1,189,18,2406,130,2554
test4sub2of100,test4pub7of10,1,189,18,2406,131,2555
test4sub41of100,test4pub7of10,1,189,18,2409,130,2557
test4sub27of100,test4pub7of10,1,189,18,2409,130,2557
test4sub42of100,test4pub7of10,1,189,18,2411,131,2560
test4sub83of100,test4pub7of10,1,189,18,2412,131,2561
test4sub73of100,test4pub7of10,1,189,18,2414,130,2562
test4sub55of100,test4pub7of10,1,189,18,2414,131,2563
test4sub63of100,test4pub7of10,1,189,18,2416,130,2564
test4sub76of100,test4pub7of10,1,189,18,2417,130,2565
test4sub87of100,test4pub7of10,1,189,18,2419,131,2568
test4sub35of100,test4pub7of10,1,189,18,2419,131,2568
test4sub22of100,test4pub7of10,1,189,18,2421,130,2569
test4sub69of100,test4pub7of10,1,189,18,2422,130,2570
test4sub93of100,test4pub7of10,1,189,18,2424,131,2573
test4sub92of100,test4pub6of10,1,189,11,2726,131,2868
test4sub33of100,test4pub7of10,1,189,18,2426,130,2574
test4sub82of100,test4pub7of10,1,189,18,2427,131,2576
test4sub24of100,test4pub7of10,1,189,18,2429,131,2578
test4sub80of100,test4pub7of10,1,189,18,2429,131,2578
test4sub43of100,test4pub7of10,1,189,18,2434,129,2581
test4sub61of100,test4pub7of10,1,189,18,2434,129,2581
test4sub38of100,test4pub7of10,1,189,18,2437,128,2583
test4sub81of100,test4pub7of10,1,189,18,2437,129,2584
test4sub64of100,test4pub7of10,1,189,18,2440,129,2587
test4sub47of100,test4pub7of10,1,189,18,2439,129,2586
test4sub79of100,test4pub7of10,1,189,18,2442,128,2588
test4sub57of100,test4pub7of10,1,189,18,2442,129,2589
test4sub86of100,test4pub7of10,1,189,18,2445,127,2590
test4sub100of100,test4pub7of10,1,189,18,2448,125,2591
test4sub31of100,test4pub7of10,1,189,18,2451,129,2598
test4sub71of100,test4pub7of10,1,189,18,2454,126,2598
test4sub26of100,test4pub7of10,1,189,18,2456,126,2600
test4sub84of100,test4pub7of10,1,189,18,2459,126,2603
test4sub28of100,test4pub7of10,1,189,18,2462,124,2604
test4sub68of100,test4pub7of10,1,189,18,2464,123,2605
test4sub37of100,test4pub7of10,1,189,18,2467,124,2609
test4sub25of100,test4pub7of10,1,189,18,2467,127,2612
test4sub8of100,test4pub7of10,1,189,18,2470,127,2615
test4sub36of100,test4pub7of10,1,189,18,2470,130,2618
test4sub23of100,test4pub6of10,1,189,11,2785,119,2915
test4sub67of100,test4pub7of10,1,189,18,2472,122,2612
test4sub30of100,test4pub7of10,1,189,18,2473,123,2614
test4sub21of100,test4pub7of10,1,189,18,2486,123,2627
test4sub32of100,test4pub8of10,1,189,11,2186,121,2318
test4sub46of100,test4pub7of10,1,189,18,2488,123,2629
test4sub5of100,test4pub8of10,1,189,11,2189,121,2321
test4sub14of100,test4pub8of10,1,189,11,2189,123,2323
test4sub59of100,test4pub8of10,1,189,11,2191,121,2323
test4sub11of100,test4pub8of10,1,189,11,2191,124,2326
test4sub44of100,test4pub8of10,1,189,11,2194,121,2326
test4sub34of100,test4pub8of10,1,189,11,2194,123,2328
test4sub17of100,test4pub8of10,1,189,11,2196,122,2329
test4sub1of100,test4pub8of10,1,189,11,2196,125,2332
test4sub66of100,test4pub8of10,1,189,11,2200,122,2333
test4sub6of100,test4pub8of10,1,189,11,2199,124,2334
test4sub94of100,test4pub8of10,1,189,11,2202,124,2337
test4sub9of100,test4pub8of10,1,189,11,2202,125,2338
test4sub51of100,test4pub8of10,1,189,11,2205,124,2340
test4sub62of100,test4pub8of10,1,189,11,2205,124,2340
test4sub19of100,test4pub8of10,1,189,11,2207,125,2343
test4sub54of100,test4pub8of10,1,189,11,2208,125,2344
test4sub77of100,test4pub8of10,1,189,11,2210,124,2345
test4sub96of100,test4pub8of10,1,189,11,2210,125,2346
test4sub78of100,test4pub8of10,1,189,11,2212,125,2348
test4sub90of100,test4pub7of10,1,189,18,2515,125,2658
test4sub7of100,test4pub8of10,1,189,11,2215,124,2350
test4sub15of100,test4pub8of10,1,189,11,2218,122,2351
test4sub99of100,test4pub8of10,1,189,11,2220,122,2353
test4sub65of100,test4pub8of10,1,189,11,2223,119,2353
test4sub16of100,test4pub8of10,1,189,11,2226,118,2355
test4sub70of100,test4pub8of10,1,189,11,2228,117,2356
test4sub39of100,test4pub8of10,1,189,11,2231,119,2361
test4sub74of100,test4pub8of10,1,189,11,2233,117,2361
test4sub4of100,test4pub8of10,1,189,11,2234,119,2364
test4sub2of100,test4pub8of10,1,189,11,2236,117,2364
test4sub91of100,test4pub8of10,1,189,11,2236,119,2366
test4sub41of100,test4pub8of10,1,189,11,2239,116,2366
test4sub27of100,test4pub8of10,1,189,11,2239,119,2369
test4sub83of100,test4pub8of10,1,189,11,2241,117,2369
test4sub42of100,test4pub8of10,1,189,11,2241,119,2371
test4sub55of100,test4pub8of10,1,189,11,2244,116,2371
test4sub73of100,test4pub8of10,1,189,11,2244,119,2374
test4sub63of100,test4pub8of10,1,189,11,2246,116,2373
test4sub76of100,test4pub8of10,1,189,11,2247,118,2376
test4sub87of100,test4pub8of10,1,189,11,2249,117,2377
test4sub35of100,test4pub8of10,1,189,11,2249,119,2379
test4sub69of100,test4pub8of10,1,189,11,2252,116,2379
test4sub22of100,test4pub8of10,1,189,11,2252,120,2383
test4sub92of100,test4pub7of10,1,189,18,2557,118,2693
test4sub93of100,test4pub8of10,1,189,11,2254,121,2386
test4sub82of100,test4pub8of10,1,189,11,2257,118,2386
test4sub33of100,test4pub8of10,1,189,11,2257,120,2388
test4sub80of100,test4pub8of10,1,189,11,2260,117,2388
test4sub24of100,test4pub8of10,1,189,11,2260,120,2391
test4sub61of100,test4pub8of10,1,189,11,2262,118,2391
test4sub43of100,test4pub8of10,1,189,11,2262,120,2393
test4sub38of100,test4pub8of10,1,189,11,2265,118,2394
test4sub81of100,test4pub8of10,1,189,11,2265,120,2396
test4sub47of100,test4pub8of10,1,189,11,2268,117,2396
test4sub64of100,test4pub8of10,1,189,11,2267,119,2397
test4sub79of100,test4pub8of10,1,189,11,2270,118,2399
test4sub57of100,test4pub8of10,1,189,11,2270,120,2401
test4sub86of100,test4pub8of10,1,189,11,2272,117,2400
test4sub100of100,test4pub8of10,1,189,11,2273,120,2404
test4sub31of100,test4pub8of10,1,189,11,2279,113,2403
test4sub71of100,test4pub8of10,1,189,11,2280,115,2406
test4sub26of100,test4pub8of10,1,189,11,2282,114,2407
test4sub84of100,test4pub8of10,1,189,11,2285,113,2409
test4sub28of100,test4pub8of10,1,189,11,2285,113,2409
test4sub68of100,test4pub8of10,1,189,11,2288,113,2412
test4sub40of100,test4pub2of10,1,189,11,1259,3236,4506
test4sub25of100,test4pub8of10,1,189,11,2294,109,2414
test4sub8of100,test4pub8of10,1,189,11,2297,106,2414
test4sub36of100,test4pub8of10,1,189,11,2300,106,2417
test4sub23of100,test4pub7of10,1,189,18,2605,103,2726
test4sub30of100,test4pub8of10,1,189,11,2306,102,2419
test4sub67of100,test4pub8of10,1,189,11,2306,103,2420
test4sub21of100,test4pub8of10,1,189,11,2308,102,2421
test4sub32of100,test4pub9of10,1,189,11,2038,102,2151
test4sub46of100,test4pub8of10,1,189,11,2311,123,2445
test4sub5of100,test4pub9of10,1,189,11,2040,126,2177
test4sub14of100,test4pub9of10,1,189,11,2042,123,2176
test4sub59of100,test4pub9of10,1,189,11,2043,126,2180
test4sub44of100,test4pub9of10,1,189,11,2045,127,2183
test4sub11of100,test4pub9of10,1,189,11,2045,129,2185
test4sub34of100,test4pub9of10,1,189,11,2048,127,2186
test4sub17of100,test4pub9of10,1,189,11,2048,129,2188
test4sub66of100,test4pub9of10,1,189,11,2052,128,2191
test4sub1of100,test4pub9of10,1,189,11,2052,130,2193
test4sub6of100,test4pub9of10,1,189,11,2054,128,2193
test4sub94of100,test4pub9of10,1,189,11,2057,128,2196
test4sub9of100,test4pub9of10,1,189,11,2057,128,2196
test4sub51of100,test4pub9of10,1,189,11,2060,127,2198
test4sub62of100,test4pub9of10,1,189,11,2060,128,2199
test4sub54of100,test4pub9of10,1,189,11,2062,128,2201
test4sub19of100,test4pub9of10,1,189,11,2062,131,2204
test4sub96of100,test4pub9of10,1,189,11,2065,128,2204
test4sub77of100,test4pub9of10,1,189,11,2065,130,2206
test4sub90of100,test4pub8of10,1,189,11,2339,128,2478
test4sub78of100,test4pub9of10,1,189,11,2067,130,2208
test4sub7of100,test4pub9of10,1,189,11,2070,128,2209
test4sub15of100,test4pub9of10,1,189,11,2070,130,2211
test4sub65of100,test4pub9of10,1,189,11,2073,138,2222
test4sub99of100,test4pub9of10,1,189,11,2072,140,2223
test4sub70of100,test4pub9of10,1,189,11,2075,139,2225
test4sub16of100,test4pub9of10,1,189,11,2075,145,2231
test4sub39of100,test4pub9of10,1,189,11,2080,139,2230
test4sub74of100,test4pub9of10,1,189,11,2081,142,2234
test4sub2of100,test4pub9of10,1,189,11,2083,142,2236
test4sub4of100,test4pub9of10,1,189,11,2083,145,2239
test4sub41of100,test4pub9of10,1,189,11,2086,142,2239
test4sub91of100,test4pub9of10,1,189,11,2085,145,2241
test4sub83of100,test4pub9of10,1,189,11,2088,143,2242
test4sub27of100,test4pub9of10,1,189,11,2088,145,2244
test4sub55of100,test4pub9of10,1,189,11,2091,143,2245
test4sub42of100,test4pub9of10,1,189,11,2091,145,2247
test4sub73of100,test4pub9of10,1,189,11,2093,143,2247
test4sub63of100,test4pub9of10,1,189,11,2093,146,2250
test4sub76of100,test4pub9of10,1,189,11,2096,145,2252
test4sub87of100,test4pub9of10,1,189,11,2096,146,2253
test4sub35of100,test4pub9of10,1,189,11,2098,146,2255
test4sub69of100,test4pub9of10,1,189,11,2098,146,2255
test4sub33of100,test4pub9of10,1,189,11,2108,159,2278
test4sub61of100,test4pub9of10,1,189,11,2110,157,2278
test4sub22of100,test4pub9of10,1,189,11,2102,144,2257
test4sub80of100,test4pub9of10,1,189,11,2108,162,2281
test4sub82of100,test4pub9of10,1,189,11,2105,166,2282
test4sub43of100,test4pub9of10,1,189,11,2113,160,2284
test4sub93of100,test4pub9of10,1,189,11,2105,168,2284
test4sub92of100,test4pub8of10,1,189,11,2373,171,2555
test4sub38of100,test4pub9of10,1,189,11,2113,159,2283
test4sub24of100,test4pub9of10,1,189,11,2110,161,2282
test4sub81of100,test4pub9of10,1,189,11,2115,166,2292
test4sub47of100,test4pub9of10,1,189,11,2115,168,2294
test4sub79of100,test4pub9of10,1,189,11,2118,168,2297
test4sub64of100,test4pub9of10,1,189,11,2118,171,2300
test4sub86of100,test4pub9of10,1,189,11,2121,170,2302
test4sub57of100,test4pub9of10,1,189,11,2121,173,2305
test4sub100of100,test4pub9of10,1,189,11,2123,173,2307
test4sub31of100,test4pub9of10,1,189,11,2123,176,2310
test4sub71of100,test4pub9of10,1,189,11,2126,176,2313
test4sub26of100,test4pub9of10,1,189,11,2126,178,2315
test4sub84of100,test4pub9of10,1,189,11,2128,178,2317
test4sub28of100,test4pub9of10,1,189,11,2129,190,2330
test4sub68of100,test4pub9of10,1,189,11,2131,190,2332
test4sub40of100,test4pub3of10,1,189,19,4158,193,4370
test4sub25of100,test4pub9of10,1,189,11,2134,193,2338
test4sub8of100,test4pub9of10,1,189,11,2134,195,2340
test4sub36of100,test4pub9of10,1,189,11,2136,196,2343
test4sub23of100,test4pub8of10,1,189,11,2407,199,2617
test4sub67of100,test4pub9of10,1,189,11,2139,198,2348
test4sub30of100,test4pub9of10,1,189,11,2139,201,2351
test4sub21of100,test4pub9of10,1,189,11,2141,200,2352
test4sub32of100,test4pub10of10,1,190,11,1864,203,2078
test4sub46of100,test4pub9of10,1,189,11,2165,181,2357
test4sub5of100,test4pub10of10,1,190,11,1889,180,2080
test4sub14of100,test4pub10of10,1,190,11,1890,181,2082
test4sub59of100,test4pub10of10,1,190,11,1892,180,2083
test4sub44of100,test4pub10of10,1,190,11,1895,178,2084
test4sub34of100,test4pub10of10,1,190,11,1898,176,2085
test4sub11of100,test4pub10of10,1,190,11,1898,177,2086
test4sub17of100,test4pub10of10,1,190,11,1901,175,2087
test4sub66of100,test4pub10of10,1,190,11,1903,174,2088
test4sub1of100,test4pub10of10,1,190,11,1906,172,2089
test4sub6of100,test4pub10of10,1,190,11,1906,173,2090
test4sub94of100,test4pub10of10,1,190,11,1908,171,2090
test4sub9of100,test4pub10of10,1,190,11,1909,172,2092
test4sub62of100,test4pub10of10,1,190,11,1911,171,2093
test4sub51of100,test4pub10of10,1,190,11,1911,172,2094
test4sub54of100,test4pub10of10,1,190,11,1914,170,2095
test4sub96of100,test4pub10of10,1,190,11,1917,169,2097
test4sub19of100,test4pub10of10,1,190,11,1916,169,2096
test4sub90of100,test4pub9of10,1,189,11,2197,168,2376
test4sub77of100,test4pub10of10,1,190,11,1919,170,2100
test4sub7of100,test4pub10of10,1,190,11,1922,169,2102
test4sub78of100,test4pub10of10,1,190,11,1921,170,2102
test4sub15of100,test4pub10of10,1,190,11,1924,168,2103
test4sub65of100,test4pub10of10,1,190,11,1934,159,2104
test4sub99of100,test4pub10of10,1,190,11,1937,157,2105
test4sub70of100,test4pub10of10,1,190,11,1937,157,2105
test4sub39of100,test4pub10of10,1,190,11,1944,152,2107
test4sub16of100,test4pub10of10,1,190,11,1943,153,2107
test4sub74of100,test4pub10of10,1,190,11,1946,152,2109
test4sub2of100,test4pub10of10,1,190,11,1949,150,2110
test4sub41of100,test4pub10of10,1,190,11,1952,148,2111
test4sub4of100,test4pub10of10,1,190,11,1952,149,2112
test4sub83of100,test4pub10of10,1,190,11,1955,147,2113
test4sub91of100,test4pub10of10,1,190,11,1954,148,2113
test4sub27of100,test4pub10of10,1,190,11,1957,146,2114
test4sub55of100,test4pub10of10,1,190,11,1957,147,2115
test4sub73of100,test4pub10of10,1,190,11,1960,145,2116
test4sub42of100,test4pub10of10,1,190,11,1959,146,2116
test4sub37of100,test4pub8of10,1,189,11,2291,365,2667
test4sub76of100,test4pub10of10,1,190,11,1965,145,2121
test4sub87of100,test4pub10of10,1,190,11,1965,146,2122
test4sub69of100,test4pub10of10,1,190,11,1968,143,2122
test4sub35of100,test4pub10of10,1,190,11,1967,144,2122
test4sub33of100,test4pub10of10,1,190,11,1991,122,2124
test4sub22of100,test4pub10of10,1,190,11,1991,123,2125
test4sub80of100,test4pub10of10,1,190,11,1993,122,2126
test4sub82of100,test4pub10of10,1,190,11,1995,121,2127
test4sub43of100,test4pub10of10,1,190,11,1996,121,2128
test4sub93of100,test4pub10of10,1,190,11,1997,121,2129
test4sub92of100,test4pub9of10,1,189,11,2276,121,2408
test4sub61of100,test4pub10of10,1,190,11,1991,123,2125
test4sub38of100,test4pub10of10,1,190,11,1999,124,2134
test4sub24of100,test4pub10of10,1,190,11,2001,122,2134
test4sub81of100,test4pub10of10,1,190,11,2004,120,2135
test4sub47of100,test4pub10of10,1,190,11,2007,118,2136
test4sub79of100,test4pub10of10,1,190,11,2010,116,2137
test4sub64of100,test4pub10of10,1,190,11,2012,115,2138
test4sub86of100,test4pub10of10,1,190,11,2015,113,2139
test4sub57of100,test4pub10of10,1,190,11,2017,111,2139
test4sub100of100,test4pub10of10,1,190,11,2020,110,2141
test4sub31of100,test4pub10of10,1,190,11,2023,108,2142
test4sub71of100,test4pub10of10,1,190,11,2025,106,2142
test4sub26of100,test4pub10of10,1,190,11,2028,105,2144
test4sub84of100,test4pub10of10,1,190,11,2030,103,2144
test4sub53of100,test4pub1of10,1,317,24,2109,3143,5276
test4sub68of100,test4pub10of10,1,190,11,2045,128,2184
test4sub40of100,test4pub4of10,1,189,25,3971,126,4122
test4sub25of100,test4pub10of10,1,190,11,2050,127,2188
test4sub8of100,test4pub10of10,1,190,11,2053,124,2188
test4sub36of100,test4pub10of10,1,190,11,2055,123,2189
test4sub97of100,test4pub1of10,1,317,24,2129,3167,5320
test4sub67of100,test4pub10of10,1,190,11,2061,156,2228
test4sub30of100,test4pub10of10,1,190,11,2063,155,2229
test4sub21of100,test4pub10of10,1,190,11,2066,154,2231
test4sub46of100,test4pub10of10,1,190,11,2069,152,2232
test4sub49of100,test4pub1of10,1,317,24,2153,3187,5364
test4sub90of100,test4pub10of10,1,190,11,2088,173,2272
test4sub37of100,test4pub9of10,1,189,11,2386,153,2550
test4sub92of100,test4pub10of10,1,190,11,2120,143,2274
test4sub53of100,test4pub2of10,1,189,11,4818,89,4918
test4sub40of100,test4pub5of10,1,189,26,3728,88,3842
test4sub63of100,test4pub10of10,1,190,11,1962,305,2278
test4sub97of100,test4pub2of10,1,189,11,4861,50,4922
test4sub45of100,test4pub2of10,1,189,11,1886,3028,4925
test4sub49of100,test4pub2of10,1,189,11,4905,13,4929
test4sub37of100,test4pub10of10,1,190,11,2263,15,2289
test4sub40of100,test4pub6of10,1,189,11,3419,13,3443
test4sub53of100,test4pub3of10,1,189,19,4571,16,4606
test4sub97of100,test4pub3of10,1,189,19,4575,16,4610
test4sub45of100,test4pub3of10,1,189,19,4578,16,4613
test4sub49of100,test4pub3of10,1,189,19,4581,15,4615
test4sub40of100,test4pub7of10,1,189,18,3132,15,3165
test4sub53of100,test4pub4of10,1,189,25,4208,15,4248
test4sub97of100,test4pub4of10,1,189,25,4211,15,4251
test4sub45of100,test4pub4of10,1,189,25,4215,15,4255
test4sub49of100,test4pub4of10,1,189,25,4218,16,4259
test4sub40of100,test4pub8of10,1,189,11,2847,15,2873
test4sub53of100,test4pub5of10,1,189,26,3853,15,3894
test4sub97of100,test4pub5of10,1,189,26,3857,16,3899
test4sub45of100,test4pub5of10,1,189,26,3860,17,3903
test4sub49of100,test4pub5of10,1,189,26,3863,16,3905
test4sub40of100,test4pub9of10,1,189,11,2593,16,2620
test4sub53of100,test4pub6of10,1,189,11,3472,16,3499
test4sub97of100,test4pub6of10,1,189,11,3476,15,3502
test4sub45of100,test4pub6of10,1,189,11,3480,16,3507
test4sub49of100,test4pub6of10,1,189,11,3483,15,3509
test4sub40of100,test4pub10of10,1,190,11,2334,15,2360
test4sub53of100,test4pub7of10,1,189,18,3189,14,3221
test4sub97of100,test4pub7of10,1,189,18,3192,13,3223
test4sub45of100,test4pub7of10,1,189,18,3196,14,3228
test4sub49of100,test4pub7of10,1,189,18,3199,14,3231
test4sub53of100,test4pub8of10,1,189,11,2903,12,2926
test4sub97of100,test4pub8of10,1,189,11,2906,11,2928
test4sub45of100,test4pub8of10,1,189,11,2910,10,2931
test4sub49of100,test4pub8of10,1,189,11,2914,10,2935
test4sub53of100,test4pub9of10,1,189,11,2646,11,2668
test4sub45of100,test4pub9of10,1,189,11,2652,9,2672
test4sub97of100,test4pub9of10,1,189,11,2649,15,2675
test4sub49of100,test4pub9of10,1,189,11,2656,12,2679
test4sub53of100,test4pub10of10,1,190,11,2381,10,2402
test4sub45of100,test4pub10of10,1,190,11,2384,9,2404
test4sub97of100,test4pub10of10,1,190,11,2388,6,2405
test4sub49of100,test4pub10of10,1,190,11,2391,5,2407
test4sub48of100,test4pub3of10,1,189,19,3068,2070,5157
test4sub48of100,test4pub4of10,1,189,25,4759,1,4785
test4sub48of100,test4pub5of10,1,189,26,4389,1,4416
test4sub48of100,test4pub6of10,1,189,11,3993,0,4004
test4sub48of100,test4pub7of10,1,189,18,3693,1,3712
test4sub48of100,test4pub8of10,1,189,11,3393,1,3405
test4sub48of100,test4pub9of10,1,189,11,3125,0,3136
test4sub48of100,test4pub10of10,1,190,11,2849,1,2861
test4sub10of100,test4pub2of10,1,189,11,3085,3006,6102
test4sub10of100,test4pub3of10,1,189,19,5756,0,5775
test4sub10of100,test4pub4of10,1,189,25,5377,1,5403
test4sub10of100,test4pub5of10,1,189,26,5007,1,5034
test4sub10of100,test4pub6of10,1,189,11,4610,1,4622
test4sub10of100,test4pub7of10,1,189,18,4311,9,4338
test4sub10of100,test4pub8of10,1,189,11,4019,1,4031
test4sub10of100,test4pub9of10,1,189,11,3751,1,3763
test4sub10of100,test4pub10of10,1,190,11,3476,1,3488
test4sub28of100,test4pub10of10,1,190,11,2042,3007,5060
test4sub48of100,test4pub1of10,10,1468,24,7,38,69
test4sub23of100,test4pub9of10,1,189,11,2336,3032,5379
test4sub32of100,test4pub1of10,10,1468,24,32,55,111
test4sub5of100,test4pub1of10,10,1468,24,37,92,153
test4sub1of100,test4pub1of10,10,1468,24,46,123,193
test4sub23of100,test4pub10of10,1,190,11,5092,121,5224
test4sub14of100,test4pub1of10,10,1468,24,54,155,233
test4sub11of100,test4pub1of10,10,1468,24,62,187,273
test4sub59of100,test4pub1of10,10,1468,24,68,221,313
test4sub34of100,test4pub1of10,10,1468,24,75,254,353
test4sub17of100,test4pub1of10,10,1468,24,79,290,393
test4sub44of100,test4pub1of10,10,1468,24,80,329,433
test4sub66of100,test4pub1of10,10,1468,24,88,360,472
test4sub6of100,test4pub1of10,10,1468,24,92,401,517
test4sub9of100,test4pub1of10,10,1468,24,94,439,557
test4sub94of100,test4pub1of10,10,1468,24,96,477,597
test4sub54of100,test4pub1of10,10,1468,24,98,515,637
test4sub51of100,test4pub1of10,10,1468,24,100,553,677
test4sub40of100,test4pub1of10,10,1468,24,102,590,716
test4sub96of100,test4pub1of10,10,1468,24,104,629,757
test4sub62of100,test4pub1of10,10,1468,24,109,664,797
test4sub19of100,test4pub1of10,10,1468,24,110,703,837
test4sub77of100,test4pub1of10,10,1468,24,112,740,876
test4sub4of100,test4pub1of10,10,1468,24,122,770,916
test4sub69of100,test4pub1of10,10,1468,24,126,807,957
test4sub76of100,test4pub1of10,10,1468,24,128,845,997
test4sub33of100,test4pub1of10,10,1468,24,135,878,1037
test4sub45of100,test4pub1of10,10,1468,24,138,915,1077
test4sub87of100,test4pub1of10,10,1468,24,141,952,1117
test4sub83of100,test4pub1of10,10,1468,24,160,973,1157
test4sub81of100,test4pub2of10,10,190,11,142,971,1124
test4sub24of100,test4pub1of10,10,1468,24,174,999,1197
test4sub31of100,test4pub1of10,10,1468,24,176,1037,1237
test4sub26of100,test4pub1of10,10,1468,24,177,1076,1277
test4sub86of100,test4pub1of10,10,1468,24,178,1115,1317
test4sub97of100,test4pub2of10,10,190,11,158,1113,1282
test4sub100of100,test4pub1of10,10,1468,24,181,1152,1357
test4sub71of100,test4pub1of10,10,1468,24,182,1191,1397
test4sub27of100,test4pub2of10,10,190,11,162,1193,1366
test4sub73of100,test4pub1of10,10,1468,24,186,1231,1441
test4sub80of100,test4pub2of10,10,190,11,165,1231,1407
test4sub57of100,test4pub1of10,10,1468,24,187,1274,1485
test4sub8of100,test4pub2of10,10,190,11,172,1269,1452
test4sub28of100,test4pub2of10,10,190,11,174,1268,1453
test4sub10of100,test4pub1of10,10,1468,24,193,1309,1526
test4sub79of100,test4pub1of10,10,1468,24,198,1347,1569
test4sub64of100,test4pub1of10,10,1468,24,201,1384,1609
test4sub5of100,test4pub2of10,10,190,11,185,1379,1575
test4sub21of100,test4pub1of10,10,1468,24,221,1404,1649
test4sub92of100,test4pub1of10,10,1468,24,224,1441,1689
test4sub46of100,test4pub2of10,10,190,11,221,1426,1658
test4sub47of100,test4pub1of10,10,1468,24,243,1465,1732
test4sub25of100,test4pub1of10,10,1468,24,244,1504,1772
test4sub68of100,test4pub1of10,10,1468,24,248,1540,1812
test4sub37of100,test4pub1of10,10,1468,24,250,1579,1853
test4sub53of100,test4pub1of10,10,1468,24,269,1600,1893
test4sub49of100,test4pub1of10,10,1468,24,275,1634,1933
test4sub90of100,test4pub2of10,10,190,11,260,1628,1899
test4sub23of100,test4pub1of10,10,1468,24,296,1653,1973
test4sub32of100,test4pub2of10,10,190,11,276,1652,1939
test4sub1of100,test4pub2of10,10,190,11,289,1641,1941
test4sub48of100,test4pub2of10,10,190,11,340,1590,1941
test4sub34of100,test4pub2of10,10,190,11,345,1587,1943
test4sub66of100,test4pub2of10,10,190,11,430,1504,1945
test4sub6of100,test4pub2of10,10,190,11,473,1461,1945
test4sub11of100,test4pub2of10,10,190,11,488,1449,1948
test4sub14of100,test4pub2of10,10,190,11,498,1439,1948
test4sub44of100,test4pub2of10,10,190,11,521,1419,1951
test4sub17of100,test4pub2of10,10,190,11,521,1419,1951
test4sub59of100,test4pub2of10,10,190,11,530,1412,1953
test4sub94of100,test4pub2of10,10,190,11,553,1389,1953
test4sub9of100,test4pub2of10,10,190,11,582,1363,1956
test4sub54of100,test4pub2of10,10,190,11,593,1352,1956
test4sub51of100,test4pub2of10,10,190,11,633,1314,1958
test4sub74of100,test4pub1of10,10,1468,24,680,1329,2033
test4sub40of100,test4pub2of10,10,190,11,673,1315,1999
test4sub96of100,test4pub2of10,10,190,11,714,1276,2001
test4sub62of100,test4pub2of10,10,190,11,754,1237,2002
test4sub19of100,test4pub2of10,10,190,11,794,1199,2004
test4sub77of100,test4pub2of10,10,190,11,833,1160,2004
test4sub4of100,test4pub2of10,10,190,11,873,1122,2006
test4sub70of100,test4pub1of10,10,1468,24,932,1125,2081
test4sub69of100,test4pub2of10,10,190,11,913,1123,2047
test4sub76of100,test4pub2of10,10,190,11,953,1085,2049
test4sub33of100,test4pub2of10,10,190,11,993,1047,2051
test4sub43of100,test4pub1of10,10,1468,24,1034,1067,2125
test4sub93of100,test4pub1of10,10,1468,24,1052,1088,2164
test4sub45of100,test4pub2of10,10,190,11,1034,1086,2131
test4sub55of100,test4pub1of10,10,1468,24,1064,1117,2205
test4sub88of100,test4pub1of10,1,317,24,176,10167,10367
test4sub29of100,test4pub1of10,1,317,24,177,10206,10407
test4sub72of100,test4pub1of10,1,317,24,180,10243,10447
test4sub56of100,test4pub1of10,1,317,24,182,10282,10488
test4sub84of100,test4pub2of10,10,190,11,1048,1272,2331
test4sub12of100,test4pub1of10,1,317,24,174,10330,10528
test4sub95of100,test4pub1of10,1,317,24,175,10367,10566
test4sub52of100,test4pub1of10,1,317,24,176,10406,10606
test4sub20of100,test4pub1of10,1,317,24,179,10445,10648
test4sub89of100,test4pub1of10,1,317,24,181,10483,10688
test4sub18of100,test4pub1of10,1,317,24,182,10522,10728
test4sub30of100,test4pub2of10,10,190,11,1051,1508,2570
test4sub50of100,test4pub1of10,1,317,24,183,10560,10767
test4sub98of100,test4pub1of10,1,317,24,184,10599,10807
test4sub3of100,test4pub1of10,1,317,24,185,10639,10848
test4sub87of100,test4pub2of10,10,190,11,1073,1606,2690
test4sub83of100,test4pub2of10,10,190,11,1113,1568,2692
test4sub82of100,test4pub1of10,10,1468,24,1146,1595,2765
test4sub24of100,test4pub2of10,10,190,11,1154,1566,2731
test4sub31of100,test4pub2of10,10,190,11,1194,1528,2733
test4sub26of100,test4pub2of10,10,190,11,1234,1489,2734
test4sub86of100,test4pub2of10,10,190,11,1273,1451,2735
test4sub81of100,test4pub1of10,10,1468,24,1303,1482,2809
test4sub42of100,test4pub1of10,10,1468,24,1370,1454,2848
test4sub27of100,test4pub1of10,10,1468,24,1377,1487,2888
test4sub73of100,test4pub2of10,10,190,11,1397,1446,2854
test4sub80of100,test4pub1of10,10,1468,24,1419,1486,2929
test4sub8of100,test4pub1of10,10,1468,24,1463,1481,2968
test4sub57of100,test4pub2of10,10,190,11,1442,1481,2934
test4sub28of100,test4pub1of10,10,1468,24,1466,1519,3009
test4sub7of100,test4pub1of10,10,1468,24,1481,1543,3048
test4sub10of100,test4pub2of10,10,190,11,1485,1519,3015
test4sub79of100,test4pub2of10,10,190,11,1525,1481,3017
test4sub5of100,test4pub3of10,10,190,11,1410,1442,2863
test4sub21of100,test4pub2of10,10,190,11,1605,1403,3019
test4sub92of100,test4pub2of10,10,190,11,1646,1363,3020
test4sub46of100,test4pub1of10,10,1468,24,1669,1400,3093
test4sub16of100,test4pub1of10,10,1468,24,1682,1427,3133
test4sub47of100,test4pub2of10,10,190,11,1689,1399,3099
test4sub25of100,test4pub2of10,10,190,11,1729,1361,3101
test4sub68of100,test4pub2of10,10,190,11,1769,1323,3103
test4sub37of100,test4pub2of10,10,190,11,1809,1285,3105
test4sub53of100,test4pub2of10,10,190,11,1849,1245,3105
test4sub49of100,test4pub2of10,10,190,11,1889,1208,3108
test4sub32of100,test4pub3of10,10,190,11,1774,1168,2953
test4sub23of100,test4pub2of10,10,190,11,1929,1170,3110
test4sub1of100,test4pub3of10,10,190,11,1776,1167,2954
test4sub48of100,test4pub3of10,10,190,11,1776,1169,2956
test4sub34of100,test4pub3of10,10,190,11,1778,1168,2957
test4sub66of100,test4pub3of10,10,190,11,1780,1168,2959
test4sub6of100,test4pub3of10,10,190,11,1780,1171,2962
test4sub14of100,test4pub3of10,10,190,11,1783,1168,2962
test4sub11of100,test4pub3of10,10,190,11,1783,1170,2964
test4sub44of100,test4pub3of10,10,190,11,1785,1168,2964
test4sub17of100,test4pub3of10,10,190,11,1785,1171,2967
test4sub94of100,test4pub3of10,10,190,11,1788,1168,2967
test4sub59of100,test4pub3of10,10,190,11,1788,1170,2969
test4sub9of100,test4pub3of10,10,190,11,1790,1168,2969
test4sub54of100,test4pub3of10,10,190,11,1791,1170,2972
test4sub51of100,test4pub3of10,10,190,11,1793,1168,2972
test4sub40of100,test4pub3of10,10,190,11,1834,1130,2975
test4sub74of100,test4pub2of10,10,190,11,1989,1131,3131
test4sub96of100,test4pub3of10,10,190,11,1836,1130,2977
test4sub62of100,test4pub3of10,10,190,11,1836,1130,2977
test4sub77of100,test4pub3of10,10,190,11,1839,1130,2980
test4sub19of100,test4pub3of10,10,190,11,1838,1130,2979
test4sub4of100,test4pub3of10,10,190,11,1841,1130,2982
test4sub70of100,test4pub2of10,10,190,11,2037,1090,3138
test4sub69of100,test4pub3of10,10,190,11,1884,1090,2985
test4sub76of100,test4pub3of10,10,190,11,1884,1090,2985
test4sub43of100,test4pub2of10,10,190,11,2082,1051,3144
test4sub93of100,test4pub2of10,10,190,11,2121,1012,3144
test4sub55of100,test4pub2of10,10,190,11,2161,974,3146
test4sub88of100,test4pub2of10,1,189,11,9909,934,10854
test4sub29of100,test4pub2of10,1,189,11,9949,897,10857
test4sub72of100,test4pub2of10,1,189,11,9989,857,10857
test4sub56of100,test4pub2of10,1,189,11,10029,819,10859
test4sub84of100,test4pub1of10,10,1468,24,2342,859,3225
test4sub12of100,test4pub2of10,1,189,11,10069,843,10923
test4sub2of100,test4pub1of10,10,1468,24,2401,856,3281
test4sub95of100,test4pub2of10,1,189,11,10109,837,10957
test4sub52of100,test4pub2of10,1,189,11,10149,799,10959
test4sub33of100,test4pub3of10,10,190,11,2303,783,3097
test4sub20of100,test4pub2of10,1,189,11,10189,763,10963
test4sub89of100,test4pub2of10,1,189,11,10229,726,10966
test4sub45of100,test4pub3of10,10,190,11,2373,720,3104
test4sub30of100,test4pub1of10,10,1468,24,2582,726,3332
test4sub50of100,test4pub2of10,1,189,11,10309,687,11007
test4sub85of100,test4pub1of10,1,317,24,189,11283,11496
test4sub98of100,test4pub2of10,1,189,11,10349,687,11047
test4sub3of100,test4pub2of10,1,189,11,10389,649,11049
test4sub83of100,test4pub3of10,10,190,11,2527,646,3184
test4sub82of100,test4pub2of10,10,190,11,2721,611,3343
test4sub24of100,test4pub3of10,10,190,11,2566,612,3189
test4sub26of100,test4pub3of10,10,190,11,2568,611,3190
test4sub31of100,test4pub3of10,10,190,11,2568,611,3190
test4sub86of100,test4pub3of10,10,190,11,2570,612,3193
test4sub81of100,test4pub3of10,10,190,11,2609,576,3196
test4sub38of100,test4pub1of10,10,1468,24,2821,579,3424
test4sub42of100,test4pub2of10,10,190,11,2805,575,3391
test4sub73of100,test4pub3of10,10,190,11,2690,536,3237
test4sub80of100,test4pub3of10,10,190,11,2729,498,3238
test4sub67of100,test4pub1of10,10,1468,24,2930,518,3472
test4sub57of100,test4pub3of10,10,190,11,2770,503,3284
test4sub64of100,test4pub2of10,10,190,11,1565,1865,3441
test4sub28of100,test4pub3of10,10,190,11,2809,465,3285
test4sub10of100,test4pub3of10,10,190,11,2850,426,3287
test4sub5of100,test4pub4of10,10,190,24,2626,423,3073
test4sub79of100,test4pub3of10,10,190,11,2852,424,3287
test4sub64of100,test4pub3of10,10,190,11,3364,2,3377
test4sub92of100,test4pub3of10,10,190,11,2855,422,3288
test4sub21of100,test4pub3of10,10,190,11,2854,422,3287
test4sub28of100,test4pub4of10,10,190,24,3138,4,3166
test4sub46of100,test4pub3of10,10,190,11,2893,384,3288
test4sub64of100,test4pub4of10,10,190,24,3142,3,3169
test4sub16of100,test4pub2of10,10,190,11,3089,344,3444
test4sub47of100,test4pub3of10,10,190,11,2934,345,3290
test4sub28of100,test4pub5of10,10,190,11,3068,4,3083
test4sub25of100,test4pub3of10,10,190,11,2936,342,3289
test4sub68of100,test4pub3of10,10,190,11,2937,341,3289
test4sub37of100,test4pub3of10,10,190,11,2939,339,3289
test4sub53of100,test4pub3of10,10,190,11,2940,339,3290
test4sub32of100,test4pub4of10,10,190,24,2716,337,3077
test4sub49of100,test4pub3of10,10,190,11,2942,338,3291
test4sub23of100,test4pub3of10,10,190,11,2944,335,3290
test4sub1of100,test4pub4of10,10,190,24,2719,336,3079
test4sub48of100,test4pub4of10,10,190,24,2721,334,3079
test4sub34of100,test4pub4of10,10,190,24,2721,335,3080
test4sub66of100,test4pub4of10,10,190,24,2724,332,3080
test4sub14of100,test4pub4of10,10,190,24,2726,330,3080
test4sub64of100,test4pub5of10,10,190,11,3071,16,3098
test4sub6of100,test4pub4of10,10,190,24,2726,331,3081
test4sub44of100,test4pub4of10,10,190,24,2729,328,3081
test4sub11of100,test4pub4of10,10,190,24,2728,329,3081
test4sub17of100,test4pub4of10,10,190,24,2731,327,3082
test4sub94of100,test4pub4of10,10,190,24,2731,327,3082
test4sub59of100,test4pub4of10,10,190,24,2734,325,3083
test4sub9of100,test4pub5of10,10,190,11,2658,325,2994
test4sub54of100,test4pub4of10,10,190,24,2736,324,3084
test4sub51of100,test4pub4of10,10,190,24,2736,324,3084
test4sub40of100,test4pub4of10,10,190,24,2739,321,3084
test4sub74of100,test4pub3of10,10,190,11,2965,322,3298
test4sub96of100,test4pub4of10,10,190,24,2741,320,3085
test4sub62of100,test4pub4of10,10,190,24,2741,320,3085
test4sub19of100,test4pub4of10,10,190,24,2744,318,3086
test4sub77of100,test4pub4of10,10,190,24,2744,318,3086
test4sub70of100,test4pub3of10,10,190,11,2972,316,3299
test4sub4of100,test4pub4of10,10,190,24,2746,317,3087
test4sub69of100,test4pub4of10,10,190,24,2749,313,3086
test4sub76of100,test4pub4of10,10,190,24,2749,313,3086
test4sub93of100,test4pub3of10,10,190,11,2978,312,3301
test4sub43of100,test4pub3of10,10,190,11,2978,312,3301
test4sub55of100,test4pub3of10,10,190,11,2980,309,3300
test4sub88of100,test4pub3of10,1,189,19,10507,309,10835
test4sub72of100,test4pub3of10,1,189,19,10509,308,10836
test4sub29of100,test4pub3of10,1,189,19,10509,308,10836
test4sub56of100,test4pub3of10,1,189,19,10512,305,10836
test4sub84of100,test4pub3of10,10,190,11,3026,266,3303
test4sub12of100,test4pub3of10,1,189,19,10575,242,10836
test4sub2of100,test4pub2of10,10,190,11,3237,210,3458
test4sub95of100,test4pub3of10,1,189,19,10610,209,10838
test4sub52of100,test4pub3of10,1,189,19,10612,207,10838
test4sub33of100,test4pub4of10,10,190,24,2862,205,3091
test4sub20of100,test4pub3of10,1,189,19,10616,204,10839
test4sub89of100,test4pub3of10,1,189,19,10618,202,10839
test4sub45of100,test4pub4of10,10,190,24,2868,200,3092
test4sub50of100,test4pub3of10,1,189,19,10660,162,10841
test4sub30of100,test4pub3of10,10,190,11,3133,162,3306
test4sub98of100,test4pub3of10,1,189,19,10699,122,10840
test4sub85of100,test4pub2of10,1,189,11,11037,122,11170
test4sub83of100,test4pub4of10,10,190,24,2950,121,3095
test4sub3of100,test4pub3of10,1,189,19,10701,121,10841
test4sub82of100,test4pub3of10,10,190,11,3178,119,3308
test4sub28of100,test4pub6of10,10,190,16,2935,10,2961
test4sub24of100,test4pub4of10,10,190,24,2952,119,3095
test4sub31of100,test4pub4of10,10,190,24,2955,117,3096
test4sub26of100,test4pub4of10,10,190,24,2954,117,3095
test4sub86of100,test4pub4of10,10,190,24,2957,115,3096
test4sub81of100,test4pub4of10,10,190,24,2960,120,3104
test4sub42of100,test4pub3of10,10,190,11,3226,83,3320
test4sub38of100,test4pub2of10,10,190,11,3381,84,3476
test4sub73of100,test4pub4of10,10,190,24,3002,81,3107
test4sub80of100,test4pub4of10,10,190,24,3002,82,3108
test4sub57of100,test4pub4of10,10,190,24,3047,38,3109
test4sub67of100,test4pub2of10,10,190,11,3429,38,3478
test4sub10of100,test4pub4of10,10,190,24,3139,65,3228
test4sub37of100,test4pub4of10,10,190,24,3152,58,3234
test4sub53of100,test4pub4of10,10,190,24,3154,56,3234
test4sub32of100,test4pub5of10,10,190,11,3079,57,3147
test4sub49of100,test4pub4of10,10,190,24,3156,57,3237
test4sub23of100,test4pub4of10,10,190,24,3158,56,3238
test4sub1of100,test4pub5of10,10,190,11,3083,57,3151
test4sub48of100,test4pub5of10,10,190,11,3085,56,3152
test4sub34of100,test4pub5of10,10,190,11,3086,57,3154
test4sub66of100,test4pub5of10,10,190,11,3087,59,3157
test4sub14of100,test4pub5of10,10,190,11,3089,58,3158
test4sub70of100,test4pub4of10,10,190,24,3167,56,3247
test4sub77of100,test4pub5of10,10,190,11,3091,58,3160
test4sub19of100,test4pub5of10,10,190,11,3091,57,3159
test4sub5of100,test4pub5of10,10,190,11,3064,90,3165
test4sub79of100,test4pub4of10,10,190,24,3141,90,3255
test4sub92of100,test4pub4of10,10,190,24,3143,90,3257
test4sub21of100,test4pub4of10,10,190,24,3144,89,3257
test4sub46of100,test4pub4of10,10,190,24,3145,90,3259
test4sub16of100,test4pub3of10,10,190,11,3373,88,3472
test4sub47of100,test4pub4of10,10,190,24,3148,89,3261
test4sub25of100,test4pub4of10,10,190,24,3149,89,3262
test4sub68of100,test4pub4of10,10,190,24,3151,89,3264
test4sub4of100,test4pub5of10,10,190,11,3092,74,3177
test4sub69of100,test4pub5of10,10,190,11,3093,74,3178
test4sub76of100,test4pub5of10,10,190,11,3094,75,3180
test4sub93of100,test4pub4of10,10,190,24,3171,76,3271
test4sub43of100,test4pub4of10,10,190,24,3172,76,3272
test4sub62of100,test4pub5of10,10,190,11,3091,78,3180
test4sub55of100,test4pub4of10,10,190,24,3173,77,3274
test4sub96of100,test4pub5of10,10,190,11,3091,79,3181
test4sub64of100,test4pub6of10,10,190,16,2951,79,3046
test4sub88of100,test4pub4of10,1,189,25,10545,81,10651
test4sub74of100,test4pub4of10,10,190,24,3166,80,3270
test4sub72of100,test4pub4of10,1,189,25,10547,82,10654
test4sub40of100,test4pub5of10,10,190,11,3090,82,3183
test4sub29of100,test4pub4of10,1,189,25,10548,84,10657
test4sub51of100,test4pub5of10,10,190,11,3090,83,3184
test4sub56of100,test4pub4of10,1,189,25,10549,84,10658
test4sub54of100,test4pub5of10,10,190,11,3090,85,3186
test4sub84of100,test4pub4of10,10,190,24,3179,86,3289
test4sub9of100,test4pub4of10,10,190,24,3166,85,3275
test4sub12of100,test4pub4of10,1,189,25,10551,87,10663
test4sub59of100,test4pub5of10,10,190,11,3090,87,3188
test4sub2of100,test4pub3of10,10,190,11,3407,89,3507
test4sub95of100,test4pub4of10,1,189,25,10553,88,10666
test4sub52of100,test4pub4of10,1,189,25,10554,89,10668
test4sub33of100,test4pub5of10,10,190,11,3109,87,3207
test4sub20of100,test4pub4of10,1,189,25,10557,89,10671
test4sub89of100,test4pub4of10,1,189,25,10559,87,10671
test4sub45of100,test4pub5of10,10,190,11,3113,88,3212
test4sub50of100,test4pub4of10,1,189,25,10561,87,10673
test4sub30of100,test4pub4of10,10,190,24,3191,88,3303
test4sub98of100,test4pub4of10,1,189,25,10562,89,10676
test4sub94of100,test4pub5of10,10,190,11,3090,90,3191
test4sub85of100,test4pub3of10,1,189,19,10944,90,11053
test4sub17of100,test4pub5of10,10,190,11,3090,91,3192
test4sub83of100,test4pub5of10,10,190,11,3118,92,3221
test4sub11of100,test4pub5of10,10,190,11,3089,93,3193
test4sub3of100,test4pub4of10,1,189,25,10566,93,10684
test4sub44of100,test4pub5of10,10,190,11,3089,93,3193
test4sub82of100,test4pub4of10,10,190,24,3196,93,3313
test4sub24of100,test4pub5of10,10,190,11,3121,94,3226
test4sub6of100,test4pub5of10,10,190,11,3089,95,3195
test4sub28of100,test4pub7of10,10,190,17,2843,92,2952
test4sub81of100,test4pub5of10,10,190,11,3123,93,3227
test4sub42of100,test4pub4of10,10,190,24,3199,96,3319
test4sub38of100,test4pub3of10,10,190,11,3425,96,3532
test4sub73of100,test4pub5of10,10,190,11,3123,97,3231
test4sub80of100,test4pub5of10,10,190,11,3123,97,3231
test4sub67of100,test4pub3of10,10,190,11,3426,99,3536
test4sub10of100,test4pub5of10,10,190,11,3130,98,3239
test4sub86of100,test4pub5of10,10,190,11,3123,101,3235
test4sub57of100,test4pub5of10,10,190,11,3124,100,3235
test4sub26of100,test4pub5of10,10,190,11,3123,102,3236
test4sub31of100,test4pub5of10,10,190,11,3122,102,3235
test4sub37of100,test4pub5of10,10,190,11,3135,101,3247
test4sub32of100,test4pub6of10,10,190,16,3000,98,3114
test4sub49of100,test4pub5of10,10,190,11,3138,100,3249
test4sub23of100,test4pub5of10,10,190,11,3139,102,3252
test4sub1of100,test4pub6of10,10,190,16,3003,103,3122
test4sub48of100,test4pub6of10,10,190,16,3004,105,3125
test4sub53of100,test4pub5of10,10,190,11,3136,113,3260
test4sub34of100,test4pub6of10,10,190,16,3007,107,3130
test4sub66of100,test4pub6of10,10,190,16,3009,105,3130
test4sub14of100,test4pub6of10,10,190,16,3012,104,3132
test4sub70of100,test4pub5of10,10,190,11,3151,103,3265
test4sub19of100,test4pub6of10,10,190,16,3015,104,3135
test4sub77of100,test4pub6of10,10,190,16,3015,104,3135
test4sub79of100,test4pub5of10,10,190,11,3156,103,3270
test4sub5of100,test4pub6of10,10,190,16,3018,104,3138
test4sub92of100,test4pub5of10,10,190,11,3158,104,3273
test4sub21of100,test4pub5of10,10,190,11,3158,104,3273
test4sub46of100,test4pub5of10,10,190,11,3161,103,3275
test4sub16of100,test4pub5of10,10,190,11,3161,103,3275
test4sub47of100,test4pub5of10,10,190,11,3163,104,3278
test4sub25of100,test4pub5of10,10,190,11,3163,104,3278
test4sub68of100,test4pub5of10,10,190,11,3165,104,3280
test4sub69of100,test4pub6of10,10,190,16,3030,101,3147
test4sub4of100,test4pub6of10,10,190,16,3030,104,3150
test4sub76of100,test4pub6of10,10,190,16,3032,102,3150
test4sub93of100,test4pub5of10,10,190,11,3173,101,3285
test4sub43of100,test4pub5of10,10,190,11,3173,101,3285
test4sub55of100,test4pub5of10,10,190,11,3176,100,3287
test4sub62of100,test4pub6of10,10,190,16,3037,102,3155
test4sub96of100,test4pub6of10,10,190,16,3040,101,3157
test4sub64of100,test4pub7of10,10,190,17,2901,101,3019
test4sub88of100,test4pub5of10,1,189,26,10255,101,10382
test4sub74of100,test4pub5of10,10,190,11,3181,101,3293
test4sub40of100,test4pub6of10,10,190,16,3045,101,3162
test4sub72of100,test4pub5of10,1,189,26,10258,101,10385
test4sub29of100,test4pub5of10,1,189,26,10260,101,10387
test4sub51of100,test4pub6of10,10,190,16,3048,102,3166
test4sub56of100,test4pub5of10,1,189,26,10263,101,10390
test4sub54of100,test4pub6of10,10,190,16,3050,101,3167
test4sub84of100,test4pub5of10,10,190,11,3190,101,3302
test4sub9of100,test4pub6of10,10,190,16,3053,102,3171
test4sub59of100,test4pub6of10,10,190,16,3055,101,3172
test4sub12of100,test4pub5of10,1,189,26,10268,101,10395
test4sub2of100,test4pub4of10,10,190,24,3271,101,3396
test4sub95of100,test4pub5of10,1,189,26,10270,102,10398
test4sub52of100,test4pub5of10,1,189,26,10272,102,10400
test4sub33of100,test4pub6of10,10,190,16,3060,101,3177
test4sub17of100,test4pub6of10,10,190,16,3072,106,3194
test4sub85of100,test4pub4of10,1,189,25,10655,111,10791
test4sub94of100,test4pub6of10,10,190,16,3069,111,3196
test4sub98of100,test4pub5of10,1,189,26,10280,115,10421
test4sub83of100,test4pub6of10,10,190,16,3072,110,3198
test4sub30of100,test4pub5of10,10,190,11,3205,116,3332
test4sub45of100,test4pub6of10,10,190,16,3064,120,3200
test4sub20of100,test4pub5of10,1,189,26,10275,124,10425
test4sub89of100,test4pub5of10,1,189,26,10275,123,10424
test4sub50of100,test4pub5of10,1,189,26,10278,121,10425
test4sub3of100,test4pub5of10,1,189,26,10287,117,10430
test4sub11of100,test4pub6of10,10,190,16,3074,117,3207
test4sub44of100,test4pub6of10,10,190,16,3076,120,3212
test4sub82of100,test4pub5of10,10,190,11,3215,122,3348
test4sub24of100,test4pub6of10,10,190,16,3079,122,3217
test4sub6of100,test4pub6of10,10,190,16,3079,125,3220
test4sub28of100,test4pub8of10,10,190,21,2836,139,2996
test4sub81of100,test4pub6of10,10,190,16,3084,139,3239
test4sub42of100,test4pub5of10,10,190,11,3224,139,3374
test4sub38of100,test4pub5of10,10,190,11,3225,141,3377
test4sub73of100,test4pub6of10,10,190,16,3089,139,3244
test4sub80of100,test4pub6of10,10,190,16,3089,140,3245
test4sub10of100,test4pub6of10,10,190,16,3092,138,3246
test4sub67of100,test4pub4of10,10,190,24,3305,141,3470
test4sub57of100,test4pub6of10,10,190,16,3094,142,3252
test4sub86of100,test4pub6of10,10,190,16,3094,144,3254
test4sub31of100,test4pub6of10,10,190,16,3096,145,3257
test4sub26of100,test4pub6of10,10,190,16,3096,148,3260
test4sub37of100,test4pub6of10,10,190,16,3100,147,3263
test4sub32of100,test4pub7of10,10,190,17,2961,150,3128
test4sub49of100,test4pub6of10,10,190,16,3102,148,3266
test4sub23of100,test4pub6of10,10,190,16,3105,147,3268
test4sub1of100,test4pub7of10,10,190,17,2969,144,3130
test4sub48of100,test4pub7of10,10,190,17,2971,145,3133
test4sub53of100,test4pub6of10,10,190,16,3113,142,3271
test4sub34of100,test4pub7of10,10,190,17,2976,146,3139
test4sub66of100,test4pub7of10,10,190,17,2976,147,3140
test4sub70of100,test4pub6of10,10,190,16,3118,146,3280
test4sub14of100,test4pub7of10,10,190,17,2979,149,3145
test4sub19of100,test4pub7of10,10,190,17,2981,147,3145
test4sub77of100,test4pub7of10,10,190,17,2981,149,3147
test4sub79of100,test4pub6of10,10,190,16,3123,149,3288
test4sub5of100,test4pub7of10,10,190,17,2984,149,3150
test4sub21of100,test4pub6of10,10,190,16,3125,149,3290
test4sub92of100,test4pub6of10,10,190,16,3125,150,3291
test4sub18of100,test4pub2of10,1,189,11,10269,1311,11591
test4sub46of100,test4pub6of10,10,190,16,3128,152,3296
test4sub47of100,test4pub6of10,10,190,16,3130,152,3298
test4sub25of100,test4pub6of10,10,190,16,3130,162,3308
test4sub69of100,test4pub7of10,10,190,17,2994,161,3172
test4sub68of100,test4pub6of10,10,190,16,3133,164,3313
test4sub76of100,test4pub7of10,10,190,17,2996,162,3175
test4sub4of100,test4pub7of10,10,190,17,2996,165,3178
test4sub43of100,test4pub6of10,10,190,16,3138,164,3318
test4sub93of100,test4pub6of10,10,190,16,3137,167,3320
test4sub55of100,test4pub6of10,10,190,16,3140,168,3324
test4sub62of100,test4pub7of10,10,190,17,3001,169,3187
test4sub96of100,test4pub7of10,10,190,17,3003,169,3189
test4sub64of100,test4pub8of10,10,190,21,2898,171,3090
test4sub88of100,test4pub6of10,1,189,11,9959,168,10138
test4sub74of100,test4pub6of10,10,190,16,3145,170,3331
test4sub72of100,test4pub6of10,1,189,11,9962,169,10142
test4sub40of100,test4pub7of10,10,190,17,3008,171,3196
test4sub29of100,test4pub6of10,1,189,11,9964,168,10143
test4sub51of100,test4pub7of10,10,190,17,3011,170,3198
test4sub54of100,test4pub7of10,10,190,17,3014,171,3202
test4sub56of100,test4pub6of10,1,189,11,9966,171,10148
test4sub84of100,test4pub6of10,10,190,16,3155,170,3341
test4sub9of100,test4pub7of10,10,190,17,3016,171,3204
test4sub12of100,test4pub6of10,1,189,11,9972,171,10154
test4sub59of100,test4pub7of10,10,190,17,3018,171,3206
test4sub2of100,test4pub5of10,10,190,11,3298,170,3479
test4sub95of100,test4pub6of10,1,189,11,9974,171,10156
test4sub52of100,test4pub6of10,1,189,11,9976,178,10165
test4sub33of100,test4pub7of10,10,190,17,3024,180,3221
test4sub17of100,test4pub7of10,10,190,17,3041,164,3222
test4sub94of100,test4pub7of10,10,190,17,3043,162,3222
test4sub85of100,test4pub5of10,1,189,26,10395,164,10585
test4sub83of100,test4pub7of10,10,190,17,3044,164,3225
test4sub30of100,test4pub6of10,10,190,16,3185,164,3365
test4sub45of100,test4pub7of10,10,190,17,3048,162,3227
test4sub20of100,test4pub6of10,1,189,11,10001,164,10176
test4sub89of100,test4pub6of10,1,189,11,10002,164,10177
test4sub50of100,test4pub6of10,1,189,11,10004,164,10179
test4sub98of100,test4pub6of10,1,189,11,9997,164,10172
test4sub3of100,test4pub6of10,1,189,11,10006,164,10181
test4sub11of100,test4pub7of10,10,190,17,3055,163,3235
test4sub44of100,test4pub7of10,10,190,17,3058,162,3237
test4sub82of100,test4pub6of10,10,190,16,3200,159,3375
test4sub24of100,test4pub7of10,10,190,17,3064,158,3239
test4sub6of100,test4pub7of10,10,190,17,3067,156,3240
test4sub28of100,test4pub9of10,10,190,12,2772,142,2926
test4sub81of100,test4pub7of10,10,190,17,3085,140,3242
test4sub42of100,test4pub6of10,10,190,16,3226,141,3383
test4sub38of100,test4pub4of10,10,190,24,3442,141,3607
test4sub73of100,test4pub7of10,10,190,17,3090,143,3250
test4sub80of100,test4pub7of10,10,190,17,3091,145,3253
test4sub10of100,test4pub7of10,10,190,17,3093,146,3256
test4sub67of100,test4pub5of10,10,190,11,3373,146,3530
test4sub57of100,test4pub7of10,10,190,17,3098,147,3262
test4sub86of100,test4pub7of10,10,190,17,3101,144,3262
test4sub31of100,test4pub7of10,10,190,17,3104,143,3264
test4sub26of100,test4pub7of10,10,190,17,3107,141,3265
test4sub37of100,test4pub7of10,10,190,17,3110,140,3267
test4sub49of100,test4pub7of10,10,190,17,3112,138,3267
test4sub32of100,test4pub8of10,10,190,21,3006,140,3167
test4sub23of100,test4pub7of10,10,190,17,3115,137,3269
test4sub1of100,test4pub8of10,10,190,21,3009,139,3169
test4sub48of100,test4pub8of10,10,190,21,3011,138,3170
test4sub53of100,test4pub7of10,10,190,17,3117,140,3274
test4sub66of100,test4pub8of10,10,190,21,3018,133,3172
test4sub34of100,test4pub8of10,10,190,21,3018,135,3174
test4sub70of100,test4pub7of10,10,190,17,3127,133,3277
test4sub27of100,test4pub3of10,10,190,11,2689,1152,3852
test4sub14of100,test4pub8of10,10,190,21,3023,133,3177
test4sub77of100,test4pub8of10,10,190,21,3025,132,3178
test4sub79of100,test4pub7of10,10,190,17,3134,130,3281
test4sub5of100,test4pub8of10,10,190,21,3028,132,3181
test4sub92of100,test4pub7of10,10,190,17,3137,130,3284
test4sub21of100,test4pub7of10,10,190,17,3137,132,3286
test4sub18of100,test4pub3of10,1,189,19,11244,130,11393
test4sub46of100,test4pub7of10,10,190,17,3142,130,3289
test4sub47of100,test4pub7of10,10,190,17,3145,127,3289
test4sub25of100,test4pub7of10,10,190,17,3154,121,3292
test4sub87of100,test4pub3of10,10,190,11,2525,1329,3865
test4sub68of100,test4pub7of10,10,190,17,3160,117,3294
test4sub76of100,test4pub8of10,10,190,21,3054,120,3195
test4sub4of100,test4pub8of10,10,190,21,3056,120,3197
test4sub43of100,test4pub7of10,10,190,17,3165,117,3299
test4sub93of100,test4pub7of10,10,190,17,3167,117,3301
test4sub55of100,test4pub7of10,10,190,17,3170,116,3303
test4sub62of100,test4pub8of10,10,190,21,3066,115,3202
test4sub96of100,test4pub8of10,10,190,21,3067,116,3204
test4sub88of100,test4pub7of10,1,189,18,9827,115,9960
test4sub64of100,test4pub9of10,10,190,12,2864,117,2993
test4sub74of100,test4pub7of10,10,190,17,3178,114,3309
test4sub72of100,test4pub7of10,1,189,18,9829,116,9963
test4sub29of100,test4pub7of10,1,189,18,9832,114,9964
test4sub40of100,test4pub8of10,10,190,21,3074,116,3211
test4sub51of100,test4pub8of10,10,190,21,3077,114,3212
test4sub56of100,test4pub7of10,1,189,18,9837,114,9969
test4sub54of100,test4pub8of10,10,190,21,3079,114,3214
test4sub9of100,test4pub8of10,10,190,21,3082,114,3217
test4sub84of100,test4pub7of10,10,190,17,3188,114,3319
test4sub12of100,test4pub7of10,1,189,18,9841,114,9973
test4sub59of100,test4pub8of10,10,190,21,3084,115,3220
test4sub95of100,test4pub7of10,1,189,18,9844,114,9976
test4sub2of100,test4pub6of10,10,190,16,3332,114,3462
test4sub52of100,test4pub7of10,1,189,18,9854,106,9978
test4sub33of100,test4pub8of10,10,190,21,3098,105,3224
test4sub17of100,test4pub8of10,10,190,21,3100,106,3227
test4sub94of100,test4pub8of10,10,190,21,3101,106,3228
test4sub85of100,test4pub6of10,1,189,11,10162,105,10278
test4sub83of100,test4pub8of10,10,190,21,3103,105,3229
test4sub45of100,test4pub8of10,10,190,21,3105,106,3232
test4sub30of100,test4pub7of10,10,190,17,3211,106,3334
test4sub20of100,test4pub7of10,1,189,18,9865,105,9988
test4sub89of100,test4pub7of10,1,189,18,9865,105,9988
test4sub8of100,test4pub3of10,10,190,11,2769,1133,3913
test4sub98of100,test4pub7of10,1,189,18,9868,107,9993
test4sub3of100,test4pub7of10,1,189,18,9870,107,9995
test4sub11of100,test4pub8of10,10,190,21,3113,113,3247
test4sub82of100,test4pub7of10,10,190,17,3222,111,3350
test4sub44of100,test4pub8of10,10,190,21,3115,118,3254
test4sub6of100,test4pub8of10,10,190,21,3118,118,3257
test4sub24of100,test4pub8of10,10,190,21,3118,121,3260
test4sub28of100,test4pub10of10,10,191,13,2632,120,2765
test4sub81of100,test4pub8of10,10,190,21,3121,121,3263
test4sub42of100,test4pub7of10,10,190,17,3229,122,3368
test4sub38of100,test4pub6of10,10,190,16,3371,122,3509
test4sub73of100,test4pub8of10,10,190,21,3129,122,3272
test4sub80of100,test4pub8of10,10,190,21,3132,121,3274
test4sub10of100,test4pub8of10,10,190,21,3135,121,3277
test4sub67of100,test4pub6of10,10,190,16,3383,121,3520
test4sub86of100,test4pub8of10,10,190,21,3141,122,3284
test4sub57of100,test4pub8of10,10,190,21,3140,125,3286
test4sub26of100,test4pub8of10,10,190,21,3143,125,3289
test4sub31of100,test4pub8of10,10,190,21,3143,128,3292
test4sub49of100,test4pub8of10,10,190,21,3145,129,3295
test4sub37of100,test4pub8of10,10,190,21,3145,131,3297
test4sub23of100,test4pub8of10,10,190,21,3148,129,3298
test4sub32of100,test4pub9of10,10,190,12,2943,131,3086
test4sub48of100,test4pub9of10,10,190,12,2945,129,3086
test4sub1of100,test4pub9of10,10,190,12,2945,131,3088
test4sub53of100,test4pub8of10,10,190,21,3152,129,3302
test4sub66of100,test4pub9of10,10,190,12,2948,134,3094
test4sub34of100,test4pub9of10,10,190,12,2950,131,3093
test4sub70of100,test4pub8of10,10,190,21,3155,133,3309
test4sub14of100,test4pub9of10,10,190,12,2952,132,3096
test4sub27of100,test4pub4of10,10,190,24,3616,134,3774
test4sub79of100,test4pub8of10,10,190,21,3160,131,3312
test4sub77of100,test4pub9of10,10,190,12,2955,133,3100
test4sub92of100,test4pub8of10,10,190,21,3162,131,3314
test4sub5of100,test4pub9of10,10,190,12,2957,134,3103
test4sub21of100,test4pub8of10,10,190,21,3164,132,3317
test4sub18of100,test4pub4of10,1,189,25,10995,135,11155
test4sub46of100,test4pub8of10,10,190,21,3167,132,3320
test4sub47of100,test4pub8of10,10,190,21,3168,133,3322
test4sub87of100,test4pub4of10,10,190,24,3629,131,3784
test4sub25of100,test4pub8of10,10,190,21,3170,133,3324
test4sub68of100,test4pub8of10,10,190,21,3173,131,3325
test4sub76of100,test4pub9of10,10,190,12,2970,131,3113
test4sub43of100,test4pub8of10,10,190,21,3178,128,3327
test4sub4of100,test4pub9of10,10,190,12,2972,131,3115
test4sub93of100,test4pub8of10,10,190,21,3180,129,3330
test4sub62of100,test4pub9of10,10,190,12,2978,129,3119
test4sub55of100,test4pub8of10,10,190,21,3182,129,3332
test4sub88of100,test4pub8of10,1,189,11,9640,129,9780
test4sub96of100,test4pub9of10,10,190,12,2980,129,3121
test4sub74of100,test4pub8of10,10,190,21,3188,129,3338
test4sub64of100,test4pub10of10,10,191,13,2699,129,2841
test4sub72of100,test4pub8of10,1,189,11,9645,127,9783
test4sub29of100,test4pub8of10,1,189,11,9645,129,9785
test4sub40of100,test4pub9of10,10,190,12,2987,128,3127
test4sub51of100,test4pub9of10,10,190,12,2988,130,3130
test4sub56of100,test4pub8of10,1,189,11,9650,127,9788
test4sub54of100,test4pub9of10,10,190,12,2990,129,3131
test4sub84of100,test4pub8of10,10,190,21,3197,127,3345
test4sub9of100,test4pub9of10,10,190,12,2992,130,3134
test4sub12of100,test4pub8of10,1,189,11,9655,127,9793
test4sub59of100,test4pub9of10,10,190,12,2995,129,3136
test4sub2of100,test4pub7of10,10,190,17,3308,127,3452
test4sub95of100,test4pub8of10,1,189,11,9657,130,9798
test4sub52of100,test4pub8of10,1,189,11,9660,127,9798
test4sub33of100,test4pub9of10,10,190,12,3000,129,3141
test4sub94of100,test4pub9of10,10,190,12,3002,127,3141
test4sub17of100,test4pub9of10,10,190,12,3002,129,3143
test4sub83of100,test4pub9of10,10,190,12,3005,127,3144
test4sub85of100,test4pub7of10,1,189,18,9967,129,10114
test4sub30of100,test4pub8of10,10,190,21,3212,127,3360
test4sub45of100,test4pub9of10,10,190,12,3007,129,3148
test4sub20of100,test4pub8of10,1,189,11,9669,126,9806
test4sub89of100,test4pub8of10,1,189,11,9670,129,9810
test4sub8of100,test4pub4of10,10,190,24,3678,125,3827
test4sub98of100,test4pub8of10,1,189,11,9674,127,9812
test4sub3of100,test4pub8of10,1,189,11,9676,124,9811
test4sub11of100,test4pub9of10,10,190,12,3023,121,3156
test4sub82of100,test4pub8of10,10,190,21,3228,120,3369
test4sub44of100,test4pub9of10,10,190,12,3030,116,3158
test4sub6of100,test4pub9of10,10,190,12,3032,113,3157
test4sub24of100,test4pub9of10,10,190,12,3035,114,3161
test4sub81of100,test4pub9of10,10,190,12,3039,110,3161
test4sub42of100,test4pub8of10,10,190,21,3247,109,3377
test4sub38of100,test4pub7of10,10,190,17,3356,106,3479
test4sub73of100,test4pub9of10,10,190,12,3047,107,3166
test4sub7of100,test4pub2of10,10,190,11,3005,1195,4211
test4sub80of100,test4pub9of10,10,190,12,3050,106,3168
test4sub10of100,test4pub9of10,10,190,12,3053,103,3168
test4sub67of100,test4pub7of10,10,190,17,3367,103,3487
test4sub86of100,test4pub9of10,10,190,12,3059,100,3171
test4sub57of100,test4pub9of10,10,190,12,3061,99,3172
test4sub26of100,test4pub9of10,10,190,12,3064,97,3173
test4sub31of100,test4pub9of10,10,190,12,3067,96,3175
test4sub49of100,test4pub9of10,10,190,12,3070,94,3176
test4sub23of100,test4pub9of10,10,190,12,3073,93,3178
test4sub37of100,test4pub9of10,10,190,12,3073,93,3178
test4sub32of100,test4pub10of10,10,191,13,2792,93,2898
test4sub48of100,test4pub10of10,10,191,13,2793,94,2900
test4sub1of100,test4pub10of10,10,191,13,2795,91,2899
test4sub53of100,test4pub9of10,10,190,12,3078,90,3180
test4sub34of100,test4pub10of10,10,191,13,2800,88,2901
test4sub66of100,test4pub10of10,10,191,13,2799,89,2901
test4sub70of100,test4pub9of10,10,190,12,3085,87,3184
test4sub14of100,test4pub10of10,10,191,13,2802,87,2902
test4sub79of100,test4pub9of10,10,190,12,3088,86,3186
test4sub27of100,test4pub5of10,10,190,11,3675,89,3775
test4sub39of100,test4pub1of10,10,1468,24,1153,3127,4304
test4sub99of100,test4pub1of10,10,1468,24,1149,3172,4345
test4sub5of100,test4pub10of10,10,191,13,2810,161,2984
test4sub21of100,test4pub9of10,10,190,12,3093,172,3277
test4sub46of100,test4pub9of10,10,190,12,3095,170,3277
test4sub18of100,test4pub5of10,1,189,26,10758,170,10954
test4sub87of100,test4pub5of10,10,190,11,3686,167,3864
test4sub47of100,test4pub9of10,10,190,12,3098,167,3277
test4sub68of100,test4pub9of10,10,190,12,3100,165,3277
test4sub25of100,test4pub9of10,10,190,12,3100,165,3277
test4sub76of100,test4pub10of10,10,191,13,2819,162,2994
test4sub43of100,test4pub9of10,10,190,12,3103,162,3277
test4sub61of100,test4pub1of10,10,1468,24,1165,3200,4389
test4sub93of100,test4pub9of10,10,190,12,3105,193,3310
test4sub62of100,test4pub10of10,10,191,13,2825,192,3030
test4sub55of100,test4pub9of10,10,190,12,3108,193,3313
test4sub88of100,test4pub9of10,1,189,11,9499,191,9701
test4sub96of100,test4pub10of10,10,191,13,2827,193,3033
test4sub74of100,test4pub9of10,10,190,12,3112,191,3315
test4sub72of100,test4pub9of10,1,189,11,9502,191,9704
test4sub29of100,test4pub9of10,1,189,11,9505,191,9707
test4sub40of100,test4pub10of10,10,191,13,2833,191,3037
test4sub56of100,test4pub9of10,1,189,11,9507,190,9708
test4sub51of100,test4pub10of10,10,191,13,2835,192,3040
test4sub84of100,test4pub9of10,10,190,12,3121,189,3322
test4sub54of100,test4pub10of10,10,191,13,2838,190,3041
test4sub12of100,test4pub9of10,1,189,11,9512,189,9712
test4sub9of100,test4pub10of10,10,191,13,2840,191,3044
test4sub59of100,test4pub10of10,10,191,13,2843,189,3045
test4sub2of100,test4pub8of10,10,190,21,3331,189,3541
test4sub95of100,test4pub9of10,1,189,11,9517,188,9716
test4sub52of100,test4pub9of10,1,189,11,9517,190,9718
test4sub33of100,test4pub10of10,10,191,13,2847,188,3048
test4sub94of100,test4pub10of10,10,191,13,2848,189,3050
test4sub83of100,test4pub10of10,10,191,13,2850,187,3050
test4sub17of100,test4pub10of10,10,191,13,2850,187,3050
test4sub50of100,test4pub7of10,1,189,18,9867,416,10301
test4sub85of100,test4pub8of10,1,189,11,9795,186,9992
test4sub30of100,test4pub9of10,10,190,12,3135,188,3335
test4sub20of100,test4pub9of10,1,189,11,9527,185,9723
test4sub45of100,test4pub10of10,10,191,13,2855,187,3055
test4sub8of100,test4pub5of10,10,190,11,3728,186,3925
test4sub89of100,test4pub9of10,1,189,11,9529,186,9726
test4sub3of100,test4pub9of10,1,189,11,9532,186,9729
test4sub98of100,test4pub9of10,1,189,11,9532,186,9729
test4sub11of100,test4pub10of10,10,191,13,2862,186,3061
test4sub82of100,test4pub9of10,10,190,12,3145,186,3343
test4sub6of100,test4pub10of10,10,191,13,2865,184,3062
test4sub44of100,test4pub10of10,10,191,13,2865,185,3063
test4sub81of100,test4pub10of10,10,191,13,2867,184,3064
test4sub24of100,test4pub10of10,10,191,13,2867,184,3064
test4sub42of100,test4pub9of10,10,190,12,3153,182,3347
test4sub38of100,test4pub8of10,10,190,21,3358,182,3561
test4sub73of100,test4pub10of10,10,191,13,2872,182,3067
test4sub7of100,test4pub3of10,10,190,11,4045,182,4238
test4sub10of100,test4pub10of10,10,191,13,2875,180,3068
test4sub80of100,test4pub10of10,10,191,13,2875,181,3069
test4sub86of100,test4pub10of10,10,191,13,2877,180,3070
test4sub67of100,test4pub8of10,10,190,21,3365,180,3566
test4sub57of100,test4pub10of10,10,191,13,2879,178,3070
test4sub26of100,test4pub10of10,10,191,13,2880,179,3072
test4sub31of100,test4pub10of10,10,191,13,2882,178,3073
test4sub49of100,test4pub10of10,10,191,13,2882,178,3073
test4sub23of100,test4pub10of10,10,191,13,2884,177,3074
test4sub37of100,test4pub10of10,10,191,13,2885,177,3075
test4sub53of100,test4pub10of10,10,191,13,2888,174,3075
test4sub70of100,test4pub10of10,10,191,13,2890,171,3074
test4sub79of100,test4pub10of10,10,191,13,2892,171,3076
test4sub27of100,test4pub6of10,10,190,16,3627,169,3812
test4sub39of100,test4pub2of10,10,190,11,4262,131,4404
test4sub35of100,test4pub1of10,10,1468,24,1283,3170,4477
test4sub97of100,test4pub1of10,10,1468,24,1295,3198,4517
test4sub41of100,test4pub1of10,10,1468,24,1311,3222,4557
test4sub78of100,test4pub1of10,10,1468,24,1314,3259,4597
test4sub21of100,test4pub10of10,10,191,13,2984,239,3236
test4sub99of100,test4pub2of10,10,190,11,4312,239,4562
test4sub46of100,test4pub10of10,10,191,13,2986,241,3240
test4sub18of100,test4pub6of10,1,189,11,10534,240,10785
test4sub87of100,test4pub6of10,10,190,16,3720,240,3976
test4sub47of100,test4pub10of10,10,191,13,2989,240,3242
test4sub25of100,test4pub10of10,10,191,13,2990,240,3243
test4sub100of100,test4pub2of10,10,190,11,1314,3245,4570
test4sub68of100,test4pub10of10,10,191,13,2989,240,3242
test4sub43of100,test4pub10of10,10,191,13,2992,239,3244
test4sub93of100,test4pub10of10,10,191,13,3017,216,3246
test4sub61of100,test4pub2of10,10,190,11,4345,217,4573
test4sub55of100,test4pub10of10,10,191,13,3019,214,3246
test4sub88of100,test4pub10of10,1,190,11,9414,215,9640
test4sub74of100,test4pub10of10,10,191,13,3022,215,3250
test4sub72of100,test4pub10of10,1,190,11,9417,214,9642
test4sub29of100,test4pub10of10,1,190,11,9419,213,9643
test4sub56of100,test4pub10of10,1,190,11,9420,214,9645
test4sub84of100,test4pub10of10,10,191,13,3029,211,3253
test4sub71of100,test4pub2of10,10,190,11,1354,3216,4581
test4sub12of100,test4pub10of10,1,190,11,9424,212,9647
test4sub2of100,test4pub9of10,10,190,12,3317,211,3540
test4sub95of100,test4pub10of10,1,190,11,9428,211,9650
test4sub52of100,test4pub10of10,1,190,11,9430,211,9652
test4sub50of100,test4pub8of10,1,189,11,9982,209,10202
test4sub85of100,test4pub9of10,1,189,11,9711,212,9934
test4sub20of100,test4pub10of10,1,190,11,9436,211,9658
test4sub30of100,test4pub10of10,10,191,13,3041,213,3267
test4sub8of100,test4pub6of10,10,190,16,3777,210,4003
test4sub89of100,test4pub10of10,1,190,11,9439,211,9661
test4sub3of100,test4pub10of10,1,190,11,9441,210,9662
test4sub98of100,test4pub10of10,1,190,11,9441,212,9664
test4sub82of100,test4pub10of10,10,191,13,3050,209,3272
test4sub42of100,test4pub10of10,10,191,13,3053,207,3273
test4sub38of100,test4pub9of10,10,190,12,3336,208,3556
test4sub7of100,test4pub4of10,10,190,24,4003,206,4233
test4sub67of100,test4pub9of10,10,190,12,3342,205,3559
test4sub27of100,test4pub7of10,10,190,17,3658,199,3874
test4sub39of100,test4pub3of10,10,190,11,4238,201,4450
test4sub35of100,test4pub2of10,10,190,11,4434,161,4606
test4sub97of100,test4pub3of10,10,190,11,4317,124,4452
test4sub41of100,test4pub2of10,10,190,11,4513,85,4609
test4sub78of100,test4pub2of10,10,190,11,4553,47,4611
test4sub99of100,test4pub3of10,10,190,11,4399,45,4455
test4sub18of100,test4pub7of10,1,189,18,10473,45,10536
test4sub87of100,test4pub7of10,10,190,17,3823,44,3884
test4sub100of100,test4pub3of10,10,190,11,4405,43,4459
test4sub61of100,test4pub3of10,10,190,11,4407,42,4460
test4sub88of100,test4pub1of10,10,1468,24,4586,79,4689
test4sub72of100,test4pub2of10,10,190,11,4568,76,4655
test4sub29of100,test4pub2of10,10,190,11,4568,78,4657
test4sub56of100,test4pub1of10,10,1468,24,4591,114,4729
test4sub71of100,test4pub3of10,10,190,11,4415,112,4538
test4sub12of100,test4pub2of10,10,190,11,4573,113,4697
test4sub2of100,test4pub10of10,10,191,13,3246,112,3371
test4sub95of100,test4pub2of10,10,190,11,4576,112,4699
test4sub52of100,test4pub2of10,10,190,11,4578,111,4700
test4sub50of100,test4pub9of10,1,189,11,9921,112,10044
test4sub85of100,test4pub10of10,1,190,11,9647,110,9768
test4sub20of100,test4pub2of10,10,190,11,4582,110,4703
test4sub8of100,test4pub7of10,10,190,17,3850,110,3977
test4sub89of100,test4pub2of10,10,190,11,4587,108,4706
test4sub3of100,test4pub2of10,10,190,11,4587,111,4709
test4sub98of100,test4pub1of10,10,1468,24,4610,146,4780
test4sub38of100,test4pub10of10,10,191,13,3263,146,3422
test4sub7of100,test4pub5of10,10,190,11,4134,147,4292
test4sub67of100,test4pub10of10,10,191,13,3265,148,3426
test4sub27of100,test4pub8of10,10,190,21,3753,149,3923
test4sub35of100,test4pub3of10,10,190,11,4441,149,4601
test4sub39of100,test4pub4of10,10,190,24,4214,152,4390
test4sub97of100,test4pub4of10,10,190,24,4217,151,4392
test4sub41of100,test4pub3of10,10,190,11,4443,154,4608
test4sub99of100,test4pub4of10,10,190,24,4219,154,4397
test4sub78of100,test4pub3of10,10,190,11,4445,156,4612
test4sub87of100,test4pub8of10,10,190,21,3763,157,3941
test4sub18of100,test4pub8of10,1,189,11,10217,159,10387
test4sub100of100,test4pub4of10,10,190,24,4224,159,4407
test4sub61of100,test4pub4of10,10,190,24,4224,161,4409
test4sub88of100,test4pub2of10,10,190,11,4645,124,4780
test4sub72of100,test4pub1of10,10,1468,24,4667,166,4857
test4sub16of100,test4pub4of10,10,190,24,3342,1088,4454
test4sub29of100,test4pub1of10,10,1468,24,4669,204,4897
test4sub71of100,test4pub4of10,10,190,24,4304,167,4495
test4sub56of100,test4pub2of10,10,190,11,4685,170,4866
test4sub12of100,test4pub1of10,10,1468,24,4709,208,4941
test4sub95of100,test4pub1of10,10,1468,24,4710,247,4981
test4sub52of100,test4pub1of10,10,1468,24,4712,285,5021
test4sub50of100,test4pub10of10,1,190,11,9756,285,10052
test4sub20of100,test4pub1of10,10,1468,24,4715,322,5061
test4sub85of100,test4pub2of10,10,190,11,4694,322,5027
test4sub8of100,test4pub8of10,10,190,21,3855,322,4198
test4sub89of100,test4pub1of10,10,1468,24,4718,360,5102
test4sub3of100,test4pub1of10,10,1468,24,4720,397,5141
test4sub98of100,test4pub2of10,10,190,11,4737,359,5107
test4sub7of100,test4pub6of10,10,190,16,4145,357,4518
test4sub27of100,test4pub9of10,10,190,12,3698,355,4065
test4sub35of100,test4pub4of10,10,190,24,4365,354,4743
test4sub39of100,test4pub5of10,10,190,11,4291,352,4654
test4sub97of100,test4pub5of10,10,190,11,4294,351,4656
test4sub41of100,test4pub4of10,10,190,24,4372,349,4745
test4sub99of100,test4pub5of10,10,190,11,4299,348,4658
test4sub78of100,test4pub4of10,10,190,24,4377,347,4748
test4sub87of100,test4pub9of10,10,190,12,3715,347,4074
test4sub18of100,test4pub9of10,1,189,11,10107,346,10464
test4sub100of100,test4pub5of10,10,190,11,4308,345,4664
test4sub61of100,test4pub5of10,10,190,11,4311,345,4667
test4sub88of100,test4pub3of10,10,190,11,4615,343,4969
test4sub16of100,test4pub6of10,10,190,16,4218,302,4536
test4sub72of100,test4pub3of10,10,190,11,4657,302,4970
test4sub29of100,test4pub3of10,10,190,11,4697,265,4973
test4sub71of100,test4pub5of10,10,190,11,4396,265,4672
test4sub56of100,test4pub3of10,10,190,11,4701,264,4976
test4sub90of100,test4pub1of10,10,1468,24,1911,3270,5205
test4sub12of100,test4pub3of10,10,190,11,4742,263,5016
test4sub95of100,test4pub3of10,10,190,11,4781,225,5017
test4sub50of100,test4pub2of10,10,190,11,4978,185,5174
test4sub52of100,test4pub3of10,10,190,11,4821,187,5019
test4sub20of100,test4pub3of10,10,190,11,4861,148,5020
test4sub85of100,test4pub1of10,10,1468,24,5039,186,5249
test4sub8of100,test4pub9of10,10,190,12,3974,184,4170
test4sub89of100,test4pub3of10,10,190,11,4901,149,5061
test4sub98of100,test4pub3of10,10,190,11,4942,110,5063
test4sub3of100,test4pub3of10,10,190,11,4941,112,5064
test4sub27of100,test4pub10of10,10,191,13,3771,109,3893
test4sub7of100,test4pub7of10,10,190,17,4365,110,4492
test4sub39of100,test4pub6of10,10,190,16,4506,111,4633
test4sub35of100,test4pub5of10,10,190,11,4644,111,4766
test4sub41of100,test4pub5of10,10,190,11,4647,111,4769
test4sub97of100,test4pub6of10,10,190,16,4508,111,4635
test4sub78of100,test4pub5of10,10,190,11,4649,111,4771
test4sub99of100,test4pub6of10,10,190,16,4511,111,4638
test4sub87of100,test4pub10of10,10,191,13,3780,111,3904
test4sub18of100,test4pub10of10,1,190,11,10177,109,10297
test4sub100of100,test4pub6of10,10,190,16,4516,111,4643
test4sub88of100,test4pub4of10,10,190,24,4733,109,4866
test4sub61of100,test4pub6of10,10,190,16,4519,111,4646
test4sub72of100,test4pub4of10,10,190,24,4736,109,4869
test4sub16of100,test4pub7of10,10,190,17,4382,111,4510
test4sub71of100,test4pub6of10,10,190,16,4524,109,4649
test4sub29of100,test4pub4of10,10,190,24,4738,111,4873
test4sub56of100,test4pub5of10,10,190,11,4665,108,4784
test4sub90of100,test4pub3of10,10,190,11,5005,73,5089
test4sub12of100,test4pub4of10,10,190,24,4780,73,4877
test4sub95of100,test4pub4of10,10,190,24,4782,74,4880
test4sub50of100,test4pub1of10,10,1468,24,5185,116,5325
test4sub20of100,test4pub5of10,10,190,11,4708,117,4836
test4sub52of100,test4pub4of10,10,190,24,4784,120,4928
test4sub85of100,test4pub3of10,10,190,11,5049,85,5145
test4sub8of100,test4pub10of10,10,191,13,3877,88,3978
test4sub98of100,test4pub5of10,10,190,11,4750,86,4847
test4sub89of100,test4pub4of10,10,190,24,4826,89,4939
test4sub3of100,test4pub4of10,10,190,24,4828,91,4943
test4sub7of100,test4pub8of10,10,190,21,4371,92,4484
test4sub35of100,test4pub6of10,10,190,16,4619,92,4727
test4sub39of100,test4pub7of10,10,190,17,4480,92,4589
test4sub97of100,test4pub7of10,10,190,17,4482,92,4591
test4sub41of100,test4pub6of10,10,190,16,4621,92,4729
test4sub78of100,test4pub6of10,10,190,16,4623,92,4731
test4sub99of100,test4pub7of10,10,190,17,4485,92,4594
test4sub18of100,test4pub1of10,10,1468,24,5243,130,5397
test4sub88of100,test4pub5of10,10,190,11,4767,127,4905
test4sub100of100,test4pub7of10,10,190,17,4490,129,4636
test4sub72of100,test4pub5of10,10,190,11,4769,127,4907
test4sub61of100,test4pub7of10,10,190,17,4492,130,4639
test4sub16of100,test4pub8of10,10,190,21,4389,127,4537
test4sub71of100,test4pub7of10,10,190,17,4495,129,4641
test4sub29of100,test4pub5of10,10,190,11,4774,130,4915
test4sub56of100,test4pub4of10,10,190,24,4850,130,5004
test4sub12of100,test4pub5of10,10,190,11,4778,128,4917
test4sub90of100,test4pub4of10,10,190,24,4853,128,5005
test4sub95of100,test4pub5of10,10,190,11,4781,128,4920
test4sub50of100,test4pub3of10,10,190,11,5126,85,5222
test4sub20of100,test4pub4of10,10,190,24,4903,84,5011
test4sub52of100,test4pub5of10,10,190,11,4830,81,4922
test4sub85of100,test4pub4of10,10,190,24,4909,81,5014
test4sub98of100,test4pub4of10,10,190,24,4914,76,5014
test4sub4of100,test4pub10of10,10,191,13,2822,1223,4058
test4sub89of100,test4pub5of10,10,190,11,4841,75,4927
test4sub3of100,test4pub5of10,10,190,11,4844,73,4928
test4sub7of100,test4pub9of10,10,190,12,4259,71,4342
test4sub39of100,test4pub8of10,10,190,21,4467,69,4557
test4sub35of100,test4pub7of10,10,190,17,4573,71,4661
test4sub97of100,test4pub8of10,10,190,21,4469,69,4559
test4sub41of100,test4pub7of10,10,190,17,4576,72,4665
test4sub78of100,test4pub7of10,10,190,17,4578,69,4664
test4sub99of100,test4pub8of10,10,190,21,4472,71,4564
test4sub88of100,test4pub6of10,10,190,16,4757,31,4804
test4sub18of100,test4pub2of10,10,190,11,5353,34,5398
test4sub72of100,test4pub6of10,10,190,16,4760,31,4807
test4sub100of100,test4pub8of10,10,190,21,4515,33,4569
test4sub16of100,test4pub9of10,10,190,12,4312,31,4355
test4sub71of100,test4pub8of10,10,190,21,4520,31,4572
test4sub61of100,test4pub8of10,10,190,21,4517,31,4569
test4sub29of100,test4pub6of10,10,190,16,4767,31,4814
test4sub56of100,test4pub6of10,10,190,16,4767,31,4814
test4sub90of100,test4pub5of10,10,190,11,4908,30,4949
test4sub12of100,test4pub6of10,10,190,16,4770,31,4817
test4sub95of100,test4pub6of10,10,190,16,4772,31,4819
test4sub50of100,test4pub4of10,10,190,24,4986,31,5041
test4sub20of100,test4pub6of10,10,190,16,4774,30,4820
test4sub52of100,test4pub6of10,10,190,16,4775,31,4822
test4sub98of100,test4pub6of10,10,190,16,4777,31,4824
test4sub85of100,test4pub5of10,10,190,11,4915,31,4957
test4sub3of100,test4pub6of10,10,190,16,4780,30,4826
test4sub89of100,test4pub6of10,10,190,16,4780,31,4827
test4sub39of100,test4pub9of10,10,190,12,4332,31,4375
test4sub7of100,test4pub10of10,10,191,13,4049,31,4093
test4sub97of100,test4pub9of10,10,190,12,4335,29,4376
test4sub35of100,test4pub8of10,10,190,21,4540,31,4592
test4sub41of100,test4pub8of10,10,190,21,4542,29,4592
test4sub78of100,test4pub8of10,10,190,21,4542,32,4595
test4sub99of100,test4pub9of10,10,190,12,4340,29,4381
test4sub88of100,test4pub7of10,10,190,17,4651,31,4699
test4sub72of100,test4pub7of10,10,190,17,4653,30,4700
test4sub18of100,test4pub3of10,10,190,11,5232,31,5274
test4sub100of100,test4pub9of10,10,190,12,4344,31,4387
test4sub16of100,test4pub10of10,10,191,13,4062,33,4108
test4sub61of100,test4pub9of10,10,190,12,4347,32,4391
test4sub71of100,test4pub9of10,10,190,12,4347,35,4394
test4sub29of100,test4pub7of10,10,190,17,4660,36,4713
test4sub56of100,test4pub7of10,10,190,17,4661,38,4716
test4sub90of100,test4pub6of10,10,190,16,4802,38,4856
test4sub95of100,test4pub7of10,10,190,17,4665,42,4724
test4sub50of100,test4pub5of10,10,190,11,4943,44,4998
test4sub12of100,test4pub7of10,10,190,17,4663,47,4727
test4sub52of100,test4pub7of10,10,190,17,4668,49,4734
test4sub20of100,test4pub7of10,10,190,17,4668,51,4736
test4sub85of100,test4pub6of10,10,190,16,4810,52,4878
test4sub98of100,test4pub7of10,10,190,17,4670,54,4741
test4sub3of100,test4pub7of10,10,190,17,4673,54,4744
test4sub89of100,test4pub7of10,10,190,17,4673,57,4747
test4sub39of100,test4pub10of10,10,191,13,4081,57,4151
test4sub97of100,test4pub10of10,10,191,13,4082,57,4152
test4sub41of100,test4pub9of10,10,190,12,4368,55,4435
test4sub35of100,test4pub9of10,10,190,12,4368,58,4438
test4sub99of100,test4pub10of10,10,191,13,4087,59,4159
test4sub78of100,test4pub9of10,10,190,12,4370,60,4442
test4sub88of100,test4pub8of10,10,190,21,4578,60,4659
test4sub18of100,test4pub4of10,10,190,24,5039,60,5123
test4sub100of100,test4pub10of10,10,191,13,4095,60,4168
test4sub61of100,test4pub10of10,10,191,13,4098,58,4169
test4sub72of100,test4pub8of10,10,190,21,4578,58,4657
test4sub71of100,test4pub10of10,10,191,13,4101,59,4173
test4sub29of100,test4pub8of10,10,190,21,4592,57,4670
test4sub56of100,test4pub8of10,10,190,21,4594,58,4673
test4sub95of100,test4pub8of10,10,190,21,4604,51,4676
test4sub50of100,test4pub6of10,10,190,16,4850,53,4919
test4sub12of100,test4pub8of10,10,190,21,4605,55,4681
test4sub90of100,test4pub7of10,10,190,17,4713,56,4786
test4sub52of100,test4pub8of10,10,190,21,4612,54,4687
test4sub20of100,test4pub8of10,10,190,21,4615,54,4690
test4sub85of100,test4pub7of10,10,190,17,4724,53,4794
test4sub98of100,test4pub8of10,10,190,21,4620,54,4695
test4sub3of100,test4pub8of10,10,190,21,4623,54,4698
test4sub89of100,test4pub8of10,10,190,21,4625,55,4701
test4sub41of100,test4pub10of10,10,191,13,4142,53,4208
test4sub35of100,test4pub10of10,10,191,13,4145,51,4209
test4sub78of100,test4pub10of10,10,191,13,4148,48,4209
test4sub88of100,test4pub9of10,10,190,12,4434,47,4493
test4sub18of100,test4pub5of10,10,190,11,5025,46,5082
test4sub72of100,test4pub9of10,10,190,12,4442,44,4498
test4sub29of100,test4pub9of10,10,190,12,4446,43,4501
test4sub56of100,test4pub9of10,10,190,12,4449,42,4503
test4sub95of100,test4pub9of10,10,190,12,4451,42,4505
test4sub50of100,test4pub7of10,10,190,17,4765,43,4825
test4sub12of100,test4pub9of10,10,190,12,4457,42,4511
test4sub90of100,test4pub8of10,10,190,21,4665,42,4728
test4sub52of100,test4pub9of10,10,190,12,4462,43,4517
test4sub20of100,test4pub9of10,10,190,12,4465,42,4519
test4sub85of100,test4pub8of10,10,190,21,4673,42,4736
test4sub98of100,test4pub9of10,10,190,12,4471,42,4525
test4sub3of100,test4pub9of10,10,190,12,4474,41,4527
test4sub89of100,test4pub9of10,10,190,12,4476,41,4529
test4sub88of100,test4pub10of10,10,191,13,4199,38,4250
test4sub18of100,test4pub6of10,10,190,16,4935,37,4988
test4sub72of100,test4pub10of10,10,191,13,4204,37,4254
test4sub29of100,test4pub10of10,10,191,13,4207,36,4256
test4sub56of100,test4pub10of10,10,191,13,4210,34,4257
test4sub95of100,test4pub10of10,10,191,13,4213,32,4258
test4sub50of100,test4pub8of10,10,190,21,4703,30,4754
test4sub12of100,test4pub10of10,10,191,13,4218,30,4261
test4sub90of100,test4pub9of10,10,190,12,4504,28,4544
test4sub52of100,test4pub10of10,10,191,13,4223,29,4265
test4sub20of100,test4pub10of10,10,191,13,4226,27,4266
test4sub85of100,test4pub9of10,10,190,12,4512,25,4549
test4sub98of100,test4pub10of10,10,191,13,4231,25,4269
test4sub3of100,test4pub10of10,10,191,13,4234,23,4270
test4sub89of100,test4pub10of10,10,191,13,4237,21,4271
test4sub18of100,test4pub7of10,10,190,17,4834,18,4869
test4sub50of100,test4pub9of10,10,190,12,4530,14,4556
test4sub90of100,test4pub10of10,10,191,13,4251,13,4277
test4sub85of100,test4pub10of10,10,191,13,4255,10,4278
test4sub18of100,test4pub8of10,10,190,21,4748,6,4775
test4sub50of100,test4pub10of10,10,191,13,4263,5,4281
test4sub18of100,test4pub9of10,10,190,12,4550,2,4564
test4sub18of100,test4pub10of10,10,191,13,4270,1,4284
test4sub22of100,test4pub1of10,10,1468,24,2671,3045,5740
test4sub75of100,test4pub1of10,1,317,24,186,13693,13903
test4sub58of100,test4pub1of10,1,317,24,187,13733,13944
test4sub60of100,test4pub1of10,1,317,24,188,13772,13984
test4sub63of100,test4pub1of10,10,1468,24,2694,3182,5900
test4sub13of100,test4pub1of10,1,317,24,176,13854,14054
test4sub22of100,test4pub2of10,10,190,11,5697,199,5907
test4sub75of100,test4pub2of10,1,189,11,13445,161,13617
test4sub58of100,test4pub2of10,1,189,11,13485,121,13617
test4sub36of100,test4pub1of10,10,1468,24,1152,4809,5985
test4sub91of100,test4pub1of10,10,1468,24,1154,4847,6025
test4sub15of100,test4pub1of10,10,1468,24,1156,4885,6065
test4sub60of100,test4pub2of10,1,189,11,13525,203,13739
test4sub63of100,test4pub2of10,10,190,11,5857,165,6033
test4sub13of100,test4pub2of10,1,189,11,13605,126,13742
test4sub22of100,test4pub3of10,10,190,11,5742,128,5881
test4sub58of100,test4pub3of10,1,189,19,13270,125,13414
test4sub75of100,test4pub3of10,1,189,19,13270,127,13416
test4sub36of100,test4pub2of10,10,190,11,5941,87,6039
test4sub91of100,test4pub2of10,10,190,11,5981,49,6041
test4sub15of100,test4pub2of10,10,190,11,6021,9,6041
test4sub60of100,test4pub3of10,1,189,19,13392,12,13423
test4sub13of100,test4pub3of10,1,189,19,13394,9,13422
test4sub63of100,test4pub3of10,10,190,11,5868,11,5890
test4sub22of100,test4pub4of10,10,190,24,5644,10,5678
test4sub58of100,test4pub4of10,1,189,25,13016,12,13053
test4sub36of100,test4pub3of10,10,190,11,5873,9,5893
test4sub75of100,test4pub4of10,1,189,25,13018,11,13054
test4sub15of100,test4pub3of10,10,190,11,5876,10,5897
test4sub91of100,test4pub3of10,10,190,11,5875,12,5898
test4sub13of100,test4pub4of10,1,189,25,13023,9,13057
test4sub60of100,test4pub4of10,1,189,25,13023,12,13060
test4sub22of100,test4pub5of10,10,190,11,5579,9,5599
test4sub63of100,test4pub4of10,10,190,24,5655,9,5688
test4sub58of100,test4pub5of10,1,189,26,12656,10,12692
test4sub36of100,test4pub4of10,10,190,24,5657,12,5693
test4sub75of100,test4pub5of10,1,189,26,12659,10,12695
test4sub15of100,test4pub4of10,10,190,24,5660,11,5695
test4sub13of100,test4pub5of10,1,189,26,12662,9,12697
test4sub60of100,test4pub5of10,1,189,26,12664,9,12699
test4sub91of100,test4pub4of10,10,190,24,5662,11,5697
test4sub22of100,test4pub6of10,10,190,16,5452,11,5479
test4sub63of100,test4pub5of10,10,190,11,5591,10,5612
test4sub58of100,test4pub6of10,1,189,11,12268,11,12290
test4sub36of100,test4pub5of10,10,190,11,5595,9,5615
test4sub75of100,test4pub6of10,1,189,11,12271,11,12293
test4sub15of100,test4pub5of10,10,190,11,5597,10,5618
test4sub13of100,test4pub6of10,1,189,11,12273,11,12295
test4sub60of100,test4pub6of10,1,189,11,12276,10,12297
test4sub91of100,test4pub5of10,10,190,11,5600,11,5622
test4sub22of100,test4pub7of10,10,190,17,5325,11,5353
test4sub63of100,test4pub6of10,10,190,16,5465,11,5492
test4sub58of100,test4pub7of10,1,189,18,11978,11,12007
test4sub75of100,test4pub7of10,1,189,18,11982,7,12007
test4sub15of100,test4pub6of10,10,190,16,5470,8,5494
test4sub13of100,test4pub7of10,1,189,18,11984,10,12012
test4sub36of100,test4pub6of10,10,190,16,5467,11,5494
test4sub60of100,test4pub7of10,1,189,18,11986,9,12013
test4sub91of100,test4pub6of10,10,190,16,5474,10,5500
test4sub22of100,test4pub8of10,10,190,21,5231,9,5261
test4sub63of100,test4pub7of10,10,190,17,5338,10,5365
test4sub75of100,test4pub8of10,1,189,11,11690,8,11709
test4sub58of100,test4pub8of10,1,189,11,11689,9,11709
test4sub15of100,test4pub7of10,10,190,17,5342,9,5368
test4sub36of100,test4pub7of10,10,190,17,5343,9,5369
test4sub13of100,test4pub8of10,1,189,11,11692,11,11714
test4sub91of100,test4pub7of10,10,190,17,5346,9,5372
test4sub60of100,test4pub8of10,1,189,11,11695,10,11716
test4sub63of100,test4pub8of10,10,190,21,5242,9,5272
test4sub22of100,test4pub9of10,10,190,12,5037,10,5059
test4sub75of100,test4pub9of10,1,189,11,11428,11,11450
test4sub58of100,test4pub9of10,1,189,11,11429,11,11451
test4sub36of100,test4pub8of10,10,190,21,5247,11,5279
test4sub15of100,test4pub8of10,10,190,21,5247,11,5279
test4sub13of100,test4pub9of10,1,189,11,11433,11,11455
test4sub91of100,test4pub8of10,10,190,21,5250,11,5282
test4sub60of100,test4pub9of10,1,189,11,11436,10,11457
test4sub63of100,test4pub9of10,10,190,12,5047,10,5069
test4sub22of100,test4pub10of10,10,191,13,4766,11,4790
test4sub75of100,test4pub10of10,1,190,11,11162,9,11182
test4sub58of100,test4pub10of10,1,190,11,11163,9,11183
test4sub15of100,test4pub9of10,10,190,12,5054,9,5075
test4sub36of100,test4pub9of10,10,190,12,5054,10,5076
test4sub13of100,test4pub10of10,1,190,11,11168,9,11188
test4sub91of100,test4pub9of10,10,190,12,5057,12,5081
test4sub63of100,test4pub10of10,10,191,13,4776,12,4801
test4sub60of100,test4pub10of10,1,190,11,11170,14,11195
test4sub36of100,test4pub10of10,10,191,13,4782,10,4805
test4sub58of100,test4pub2of10,10,190,11,6108,12,6131
test4sub75of100,test4pub2of10,10,190,11,6108,12,6131
test4sub13of100,test4pub2of10,10,190,11,6114,10,6135
test4sub91of100,test4pub10of10,10,191,13,4787,10,4810
test4sub15of100,test4pub10of10,10,191,13,4782,17,4812
test4sub58of100,test4pub1of10,10,1468,24,6144,45,6213
test4sub75of100,test4pub1of10,10,1468,24,6144,84,6252
test4sub13of100,test4pub1of10,10,1468,24,6146,122,6292
test4sub60of100,test4pub1of10,10,1468,24,6141,165,6330
test4sub58of100,test4pub3of10,10,190,11,6013,122,6146
test4sub75of100,test4pub3of10,10,190,11,6053,84,6148
test4sub13of100,test4pub3of10,10,190,11,6093,47,6151
test4sub60of100,test4pub2of10,10,190,11,6290,9,6310
test4sub58of100,test4pub4of10,10,190,24,5910,8,5942
test4sub75of100,test4pub4of10,10,190,24,5913,9,5946
test4sub13of100,test4pub4of10,10,190,24,5916,9,5949
test4sub60of100,test4pub3of10,10,190,11,6145,9,6165
test4sub58of100,test4pub5of10,10,190,11,5845,9,5865
test4sub75of100,test4pub5of10,10,190,11,5848,8,5867
test4sub13of100,test4pub5of10,10,190,11,5851,8,5870
test4sub58of100,test4pub6of10,10,190,16,5717,6,5739
test4sub75of100,test4pub6of10,10,190,16,5720,6,5742
test4sub13of100,test4pub6of10,10,190,16,5723,6,5745
test4sub60of100,test4pub4of10,10,190,24,5929,15,5968
test4sub58of100,test4pub7of10,10,190,17,5586,9,5612
test4sub75of100,test4pub7of10,10,190,17,5589,8,5614
test4sub13of100,test4pub7of10,10,190,17,5592,7,5616
test4sub58of100,test4pub8of10,10,190,21,5490,6,5517
test4sub60of100,test4pub5of10,10,190,11,5871,9,5891
test4sub58of100,test4pub9of10,10,190,12,5293,2,5307
test4sub13of100,test4pub8of10,10,190,21,5495,3,5519
test4sub75of100,test4pub8of10,10,190,21,5493,5,5519
test4sub58of100,test4pub10of10,10,191,13,5014,5,5032
test4sub60of100,test4pub6of10,10,190,16,5746,6,5768
test4sub75of100,test4pub9of10,10,190,12,5298,5,5315
test4sub13of100,test4pub9of10,10,190,12,5298,5,5315
test4sub60of100,test4pub7of10,10,190,17,5615,3,5635
test4sub75of100,test4pub10of10,10,191,13,5023,2,5038
test4sub13of100,test4pub10of10,10,191,13,5023,1,5037
test4sub60of100,test4pub8of10,10,190,21,5514,1,5536
test4sub60of100,test4pub9of10,10,190,12,5311,1,5324
test4sub60of100,test4pub10of10,10,191,13,5030,1,5044
test4sub48of100,test4pub1of10,100,12976,61,187,41,289
test4sub30of100,test4pub2of10,100,191,21,181,1,203
test4sub62of100,test4pub2of10,100,191,21,182,1,204
test4sub50of100,test4pub2of10,100,191,21,188,1,210
test4sub89of100,test4pub2of10,100,191,21,190,1,212
test4sub35of100,test4pub2of10,100,191,21,192,1,214
test4sub81of100,test4pub2of10,100,191,21,193,1,215
test4sub86of100,test4pub2of10,100,191,21,209,1,231
test4sub33of100,test4pub2of10,100,191,21,209,1,231
test4sub97of100,test4pub2of10,100,191,21,214,1,236
test4sub2of100,test4pub2of10,100,191,21,220,1,242
test4sub27of100,test4pub2of10,100,191,21,221,1,243
test4sub80of100,test4pub2of10,100,191,21,223,1,245
test4sub31of100,test4pub2of10,100,191,21,232,1,254
test4sub12of100,test4pub2of10,100,191,21,237,1,259
test4sub8of100,test4pub2of10,100,191,21,238,1,260
test4sub28of100,test4pub2of10,100,191,21,263,1,285
test4sub42of100,test4pub2of10,100,191,21,264,1,286
test4sub4of100,test4pub2of10,100,191,21,267,1,289
test4sub85of100,test4pub2of10,100,191,21,267,1,289
test4sub10of100,test4pub2of10,100,191,21,270,1,292
test4sub72of100,test4pub2of10,100,191,21,281,1,303
test4sub52of100,test4pub2of10,100,191,21,281,1,303
test4sub84of100,test4pub2of10,100,191,21,284,1,306
test4sub63of100,test4pub2of10,100,191,21,285,1,307
test4sub46of100,test4pub2of10,100,191,21,287,1,309
test4sub36of100,test4pub2of10,100,191,21,292,1,314
test4sub21of100,test4pub2of10,100,191,21,293,1,315
test4sub3of100,test4pub2of10,100,191,21,320,1,342
test4sub29of100,test4pub2of10,100,191,21,342,1,364
test4sub32of100,test4pub1of10,100,12976,61,409,44,514
test4sub90of100,test4pub2of10,100,191,21,349,39,409
test4sub24of100,test4pub2of10,100,191,21,366,23,410
test4sub55of100,test4pub2of10,100,191,21,374,15,410
test4sub79of100,test4pub2of10,100,191,21,375,17,413
test4sub26of100,test4pub2of10,100,191,21,390,3,414
test4sub41of100,test4pub2of10,100,191,21,391,2,414
test4sub58of100,test4pub2of10,100,191,21,392,3,416
test4sub67of100,test4pub2of10,100,191,21,394,1,416
test4sub88of100,test4pub2of10,100,191,21,399,1,421
test4sub64of100,test4pub2of10,100,191,21,400,2,423
test4sub19of100,test4pub8of10,10,190,21,3023,3012,6056
test4sub19of100,test4pub9of10,10,190,12,5831,1,5844
test4sub19of100,test4pub10of10,10,191,13,5550,1,5564
test4sub68of100,test4pub2of10,100,191,21,410,1,432
test4sub19of100,test4pub2of10,100,191,21,412,1,434
test4sub69of100,test4pub8of10,10,190,21,3051,3005,6077
test4sub49of100,test4pub2of10,100,191,21,428,3,452
test4sub61of100,test4pub2of10,100,191,21,429,3,453
test4sub47of100,test4pub2of10,100,191,21,429,3,453
test4sub69of100,test4pub9of10,10,190,12,5854,2,5868
test4sub69of100,test4pub10of10,10,191,13,5574,1,5588
test4sub53of100,test4pub2of10,100,191,21,435,1,457
test4sub69of100,test4pub2of10,100,191,21,435,1,457
test4sub48of100,test4pub2of10,100,191,21,448,1,470
test4sub25of100,test4pub2of10,100,191,21,457,1,479
test4sub23of100,test4pub2of10,100,191,21,461,1,483
test4sub18of100,test4pub2of10,100,191,21,469,1,491
test4sub60of100,test4pub2of10,100,191,21,524,1,546
test4sub37of100,test4pub2of10,100,191,21,537,3,561
test4sub38of100,test4pub2of10,100,191,21,539,1,561
test4sub56of100,test4pub2of10,100,191,21,545,1,567
test4sub98of100,test4pub2of10,100,191,21,545,1,567
test4sub5of100,test4pub1of10,100,12976,61,727,41,829
test4sub77of100,test4pub10of10,10,191,13,2807,3038,5858
test4sub92of100,test4pub9of10,10,190,12,3090,3039,6141
test4sub1of100,test4pub1of10,100,12976,61,742,70,873
test4sub5of100,test4pub2of10,100,191,21,705,43,769
test4sub92of100,test4pub10of10,10,191,13,5848,42,5903
test4sub1of100,test4pub2of10,100,191,21,749,1,771
test4sub14of100,test4pub1of10,100,12976,61,849,45,955
test4sub14of100,test4pub2of10,100,191,21,831,1,853
test4sub32of100,test4pub2of10,100,191,21,924,2,947
test4sub17of100,test4pub1of10,100,12976,61,989,46,1096
test4sub17of100,test4pub2of10,100,191,21,983,32,1036
test4sub44of100,test4pub1of10,100,12976,61,995,84,1140
test4sub44of100,test4pub2of10,100,191,21,1017,1,1039
test4sub66of100,test4pub1of10,100,12976,61,1097,43,1201
test4sub95of100,test4pub2of10,100,191,21,1037,39,1097
test4sub6of100,test4pub1of10,100,12976,61,1127,57,1245
test4sub66of100,test4pub2of10,100,191,21,1077,43,1141
test4sub73of100,test4pub2of10,100,191,21,1093,27,1141
test4sub6of100,test4pub2of10,100,191,21,1121,1,1143
test4sub9of100,test4pub1of10,100,12976,61,1197,43,1301
test4sub20of100,test4pub2of10,100,191,21,1159,17,1197
test4sub48of100,test4pub3of10,100,191,17,976,18,1011
test4sub71of100,test4pub2of10,100,191,21,1162,15,1198
test4sub9of100,test4pub2of10,100,191,21,1177,1,1199
test4sub9of100,test4pub3of10,100,191,17,997,0,1014
test4sub94of100,test4pub1of10,100,12976,61,1262,43,1366
test4sub57of100,test4pub2of10,100,191,21,1206,33,1260
test4sub13of100,test4pub2of10,100,191,21,1206,35,1262
test4sub94of100,test4pub2of10,100,191,21,1240,1,1262
test4sub94of100,test4pub3of10,100,191,17,1060,1,1078
test4sub82of100,test4pub2of10,100,191,21,1301,2,1324
test4sub92of100,test4pub2of10,100,191,21,1304,1,1326
test4sub5of100,test4pub3of10,100,191,17,1158,31,1206
test4sub54of100,test4pub1of10,100,12976,61,1392,44,1497
test4sub54of100,test4pub2of10,100,191,21,1373,1,1395
test4sub54of100,test4pub3of10,100,191,17,1193,1,1211
test4sub1of100,test4pub3of10,100,191,17,1219,3,1239
test4sub75of100,test4pub2of10,100,191,21,1404,2,1427
test4sub22of100,test4pub2of10,100,191,21,1416,1,1438
test4sub86of100,test4pub1of10,100,12976,61,1497,43,1601
test4sub80of100,test4pub1of10,100,12976,61,1516,69,1646
test4sub14of100,test4pub3of10,100,191,17,1281,55,1353
test4sub99of100,test4pub2of10,100,191,21,1469,51,1541
test4sub86of100,test4pub3of10,100,191,17,1294,45,1356
test4sub28of100,test4pub1of10,100,12976,61,1555,73,1689
test4sub7of100,test4pub1of10,100,12976,61,1565,108,1734
test4sub80of100,test4pub3of10,100,191,17,1337,90,1444
test4sub10of100,test4pub1of10,100,12976,61,1594,126,1781
test4sub39of100,test4pub1of10,100,12976,61,1603,164,1828
test4sub63of100,test4pub1of10,100,12976,61,1613,196,1870
test4sub43of100,test4pub2of10,100,191,21,1555,189,1765
test4sub28of100,test4pub3of10,100,191,17,1382,179,1578
test4sub46of100,test4pub1of10,100,12976,61,1634,218,1913
test4sub36of100,test4pub1of10,100,12976,61,1638,259,1958
test4sub17of100,test4pub3of10,100,191,17,1400,248,1665
test4sub3of100,test4pub1of10,100,12976,61,1648,300,2009
test4sub32of100,test4pub3of10,100,191,17,1415,289,1721
test4sub44of100,test4pub3of10,100,191,17,1419,286,1722
test4sub7of100,test4pub2of10,100,191,21,1609,281,1911
test4sub87of100,test4pub1of10,100,12976,61,1676,321,2058
test4sub35of100,test4pub1of10,100,12976,61,1681,361,2103
test4sub55of100,test4pub1of10,100,12976,61,1688,408,2157
test4sub79of100,test4pub1of10,100,12976,61,1692,450,2203
test4sub93of100,test4pub1of10,100,12976,61,1694,494,2249
test4sub10of100,test4pub3of10,100,191,17,1474,468,1959
test4sub83of100,test4pub1of10,100,12976,61,1725,509,2295
test4sub26of100,test4pub1of10,100,12976,61,1730,542,2333
test4sub58of100,test4pub1of10,100,12976,61,1734,582,2377
test4sub67of100,test4pub1of10,100,12976,61,1748,610,2419
test4sub66of100,test4pub3of10,100,191,17,1503,606,2126
test4sub88of100,test4pub1of10,100,12976,61,1752,648,2461
test4sub68of100,test4pub1of10,100,12976,61,1762,682,2505
test4sub6of100,test4pub3of10,100,191,17,1519,678,2214
test4sub39of100,test4pub2of10,100,191,21,1703,677,2401
test4sub47of100,test4pub1of10,100,12976,61,1781,707,2549
test4sub61of100,test4pub1of10,100,12976,61,1791,742,2594
test4sub24of100,test4pub1of10,100,12976,61,1805,770,2636
test4sub63of100,test4pub3of10,100,191,17,1562,768,2347
test4sub25of100,test4pub1of10,100,12976,61,1822,798,2681
test4sub9of100,test4pub4of10,100,191,29,667,799,1495
test4sub100of100,test4pub1of10,100,12976,61,1828,836,2725
test4sub94of100,test4pub4of10,100,191,29,690,819,1538
test4sub46of100,test4pub3of10,100,191,17,1606,813,2436
test4sub21of100,test4pub1of10,100,12976,61,1874,835,2770
test4sub41of100,test4pub1of10,100,12976,61,1878,875,2814
test4sub36of100,test4pub3of10,100,191,17,1650,854,2521
test4sub38of100,test4pub1of10,100,12976,61,1902,894,2857
test4sub81of100,test4pub1of10,100,12976,61,1906,933,2900
test4sub11of100,test4pub1of10,100,12976,61,1909,971,2941
test4sub54of100,test4pub4of10,100,191,29,779,946,1754
test4sub37of100,test4pub1of10,100,12976,61,1948,977,2986
test4sub3of100,test4pub3of10,100,191,17,1702,975,2694
test4sub53of100,test4pub1of10,100,12976,61,1954,1014,3029
test4sub7of100,test4pub3of10,100,191,17,1709,1014,2740
test4sub87of100,test4pub2of10,100,191,21,1933,974,2928
test4sub5of100,test4pub4of10,100,191,29,850,969,1848
test4sub49of100,test4pub1of10,100,12976,61,2007,1015,3083
test4sub84of100,test4pub1of10,100,12976,61,2015,1049,3125
test4sub90of100,test4pub1of10,100,12976,61,2019,1089,3169
test4sub1of100,test4pub4of10,100,191,29,885,1068,1982
test4sub35of100,test4pub3of10,100,191,17,1806,1056,2879
test4sub52of100,test4pub1of10,100,12976,61,2081,1071,3213
test4sub31of100,test4pub1of10,100,12976,61,2129,1067,3257
test4sub27of100,test4pub1of10,100,12976,61,2171,1065,3297
test4sub30of100,test4pub1of10,100,12976,61,2187,1093,3341
test4sub8of100,test4pub1of10,100,12976,61,2209,1115,3385
test4sub97of100,test4pub1of10,100,12976,61,2252,1116,3429
test4sub4of100,test4pub1of10,100,12976,61,2270,1138,3469
test4sub45of100,test4pub1of10,100,12976,61,2295,1158,3514
test4sub23of100,test4pub1of10,100,12976,61,2303,1193,3557
test4sub60of100,test4pub1of10,100,12976,61,2307,1233,3601
test4sub57of100,test4pub1of10,100,12976,61,2311,1269,3641
test4sub82of100,test4pub1of10,100,12976,61,2350,1274,3685
test4sub92of100,test4pub1of10,100,12976,61,2353,1310,3724
test4sub86of100,test4pub4of10,100,191,29,1199,1310,2538
test4sub43of100,test4pub1of10,100,12976,61,2367,1341,3769
test4sub51of100,test4pub1of10,100,12976,61,2383,1369,3813
test4sub20of100,test4pub1of10,100,12976,61,2434,1358,3853
test4sub34of100,test4pub1of10,100,12976,61,2435,1401,3897
test4sub96of100,test4pub1of10,100,12976,61,2439,1440,3940
test4sub76of100,test4pub1of10,100,12976,61,2443,1477,3981
test4sub91of100,test4pub1of10,100,12976,61,2475,1490,4026
test4sub55of100,test4pub3of10,100,191,17,2248,1468,3733
test4sub93of100,test4pub2of10,100,191,21,2432,1470,3923
test4sub79of100,test4pub3of10,100,191,17,2248,1470,3735
test4sub83of100,test4pub2of10,100,191,21,2433,1471,3925
test4sub26of100,test4pub3of10,100,191,17,2252,1470,3739
test4sub58of100,test4pub3of10,100,191,17,2253,1471,3741
test4sub67of100,test4pub3of10,100,191,17,2253,1471,3741
test4sub66of100,test4pub4of10,100,191,29,1347,1471,2847
test4sub88of100,test4pub3of10,100,191,17,2255,1472,3744
test4sub68of100,test4pub3of10,100,191,17,2256,1473,3746
test4sub6of100,test4pub4of10,100,191,29,1351,1471,2851
test4sub39of100,test4pub3of10,100,191,17,2258,1474,3749
test4sub47of100,test4pub3of10,100,191,17,2259,1473,3749
test4sub61of100,test4pub3of10,100,191,17,2286,1448,3751
test4sub2of100,test4pub1of10,100,12976,61,2553,1472,4086
test4sub24of100,test4pub3of10,100,191,17,2329,1449,3795
test4sub63of100,test4pub4of10,100,191,29,1424,1449,2902
test4sub59of100,test4pub1of10,100,12976,61,2584,1488,4133
test4sub19of100,test4pub1of10,100,12976,61,2613,1499,4173
test4sub9of100,test4pub5of10,100,191,34,788,1490,2312
test4sub25of100,test4pub3of10,100,191,17,2374,1492,3883
test4sub33of100,test4pub1of10,100,12976,61,2639,1517,4217
test4sub100of100,test4pub2of10,100,191,21,2601,1492,4114
test4sub94of100,test4pub5of10,100,191,34,832,1494,2360
test4sub46of100,test4pub4of10,100,191,29,1513,1493,3035
test4sub21of100,test4pub3of10,100,191,17,2462,1452,3931
test4sub36of100,test4pub4of10,100,191,29,1599,1409,3037
test4sub41of100,test4pub3of10,100,191,17,2505,1411,3933
test4sub38of100,test4pub3of10,100,191,17,2550,1368,3935
test4sub99of100,test4pub1of10,100,12976,61,2806,1403,4270
test4sub48of100,test4pub4of10,100,191,29,1675,1378,3082
test4sub81of100,test4pub3of10,100,191,17,2593,1369,3979
test4sub11of100,test4pub2of10,100,191,21,2817,1328,4166
test4sub54of100,test4pub5of10,100,191,34,1048,1330,2412
test4sub16of100,test4pub1of10,100,12976,61,2899,1358,4318
test4sub15of100,test4pub1of10,100,12976,61,2923,1373,4357
test4sub37of100,test4pub3of10,100,191,17,2678,1370,4065
test4sub3of100,test4pub4of10,100,191,29,1771,1372,3172
test4sub22of100,test4pub1of10,100,12976,61,2930,1410,4401
test4sub32of100,test4pub4of10,100,191,29,1808,1378,3215
test4sub14of100,test4pub4of10,100,191,29,1808,1380,3217
test4sub17of100,test4pub4of10,100,191,29,1811,1377,3217
test4sub53of100,test4pub3of10,100,191,17,2722,1375,4114
test4sub42of100,test4pub1of10,100,12976,61,2971,1418,4450
test4sub7of100,test4pub4of10,100,191,29,1818,1415,3262
test4sub87of100,test4pub3of10,100,191,17,2725,1417,4159
test4sub5of100,test4pub5of10,100,191,34,1142,1417,2593
test4sub56of100,test4pub1of10,100,12976,61,3010,1426,4497
test4sub49of100,test4pub3of10,100,191,17,2776,1412,4205
test4sub84of100,test4pub3of10,100,191,17,2817,1372,4206
test4sub90of100,test4pub3of10,100,191,17,2861,1331,4209
test4sub1of100,test4pub5of10,100,191,34,1275,1331,2640
test4sub44of100,test4pub4of10,100,191,29,1962,1325,3316
test4sub72of100,test4pub1of10,100,12976,61,3140,1345,4546
test4sub52of100,test4pub3of10,100,191,17,2906,1331,4254
test4sub95of100,test4pub1of10,100,12976,61,3172,1356,4589
test4sub31of100,test4pub3of10,100,191,17,2949,1331,4297
test4sub27of100,test4pub3of10,100,191,17,2990,1292,4299
test4sub30of100,test4pub3of10,100,191,17,3034,1249,4300
test4sub8of100,test4pub3of10,100,191,17,3077,1208,4302
test4sub97of100,test4pub3of10,100,191,17,3121,1164,4302
test4sub4of100,test4pub3of10,100,191,17,3162,1125,4304
test4sub23of100,test4pub3of10,100,191,17,3250,1037,4304
test4sub40of100,test4pub1of10,100,12976,61,3529,1051,4641
test4sub60of100,test4pub3of10,100,191,17,3294,1038,4349
test4sub57of100,test4pub3of10,100,191,17,3334,1000,4351
test4sub82of100,test4pub3of10,100,191,17,3377,958,4352
test4sub86of100,test4pub5of10,100,191,34,1832,918,2784
test4sub65of100,test4pub1of10,10,1468,24,1084,9964,11072
test4sub43of100,test4pub3of10,100,191,17,3461,915,4393
test4sub51of100,test4pub2of10,100,191,21,3688,874,4583
test4sub20of100,test4pub3of10,100,191,17,3545,834,4396
test4sub34of100,test4pub2of10,100,191,21,3772,791,4584
test4sub96of100,test4pub2of10,100,191,21,3815,750,4586
test4sub76of100,test4pub2of10,100,191,21,3857,710,4588
test4sub55of100,test4pub4of10,100,191,29,2811,666,3506
test4sub93of100,test4pub3of10,100,191,17,3720,666,4403
test4sub79of100,test4pub4of10,100,191,29,2814,667,3510
test4sub26of100,test4pub4of10,100,191,29,2816,666,3511
test4sub83of100,test4pub3of10,100,191,17,3723,666,4406
test4sub58of100,test4pub4of10,100,191,29,2818,666,3513
test4sub67of100,test4pub4of10,100,191,29,2819,666,3514
test4sub88of100,test4pub4of10,100,191,29,2821,665,3515
test4sub66of100,test4pub5of10,100,191,34,2142,665,2841
test4sub68of100,test4pub4of10,100,191,29,2823,665,3517
test4sub6of100,test4pub5of10,100,191,34,2145,665,2844
test4sub39of100,test4pub4of10,100,191,29,2826,665,3520
test4sub47of100,test4pub4of10,100,191,29,2827,665,3521
test4sub61of100,test4pub4of10,100,191,29,2829,664,3522
test4sub71of100,test4pub1of10,100,12976,61,3998,691,4750
test4sub2of100,test4pub3of10,100,191,17,3779,662,4458
test4sub24of100,test4pub4of10,100,191,29,2872,664,3565
test4sub63of100,test4pub5of10,100,191,34,2195,662,2891
test4sub59of100,test4pub2of10,100,191,21,4008,620,4649
test4sub9of100,test4pub6of10,100,191,28,1928,581,2537
test4sub25of100,test4pub4of10,100,191,29,2961,580,3570
test4sub74of100,test4pub1of10,100,12976,61,4157,580,4798
test4sub33of100,test4pub3of10,100,191,17,3910,578,4505
test4sub100of100,test4pub3of10,100,191,17,3912,579,4508
test4sub94of100,test4pub6of10,100,191,28,1976,577,2581
test4sub21of100,test4pub4of10,100,191,29,3009,577,3615
test4sub36of100,test4pub5of10,100,191,34,2330,577,2941
test4sub41of100,test4pub4of10,100,191,29,3011,578,3618
test4sub38of100,test4pub4of10,100,191,29,3012,577,3618
test4sub91of100,test4pub2of10,100,191,21,3901,780,4702
test4sub99of100,test4pub3of10,100,191,17,3961,537,4515
test4sub11of100,test4pub3of10,100,191,17,3964,536,4517
test4sub81of100,test4pub4of10,100,191,29,3057,537,3623
test4sub54of100,test4pub6of10,100,191,28,2028,537,2593
test4sub16of100,test4pub2of10,100,191,21,4192,494,4707
test4sub37of100,test4pub4of10,100,191,29,3143,456,3628
test4sub15of100,test4pub2of10,100,191,21,4232,456,4709
test4sub3of100,test4pub5of10,100,191,34,2466,455,2955
test4sub92of100,test4pub3of10,100,191,17,3418,1090,4525
test4sub32of100,test4pub5of10,100,191,34,2508,416,2958
test4sub17of100,test4pub5of10,100,191,34,2510,414,2958
test4sub14of100,test4pub5of10,100,191,34,2510,418,2962
test4sub53of100,test4pub4of10,100,191,29,3192,415,3636
test4sub46of100,test4pub5of10,100,191,34,2328,602,2964
test4sub7of100,test4pub5of10,100,191,34,2556,376,2966
test4sub87of100,test4pub4of10,100,191,29,3237,375,3641
test4sub5of100,test4pub6of10,100,191,28,2208,373,2609
test4sub48of100,test4pub5of10,100,191,34,2375,560,2969
test4sub56of100,test4pub3of10,100,191,17,4189,330,4536
test4sub84of100,test4pub4of10,100,191,29,3284,332,3645
test4sub49of100,test4pub4of10,100,191,29,3283,333,3645
test4sub1of100,test4pub6of10,100,191,28,2255,333,2616
test4sub90of100,test4pub4of10,100,191,29,3286,333,3648
test4sub44of100,test4pub5of10,100,191,34,2610,335,2979
test4sub72of100,test4pub3of10,100,191,17,4238,294,4549
test4sub95of100,test4pub3of10,100,191,17,4281,253,4551
test4sub31of100,test4pub4of10,100,191,29,3374,253,3656
test4sub30of100,test4pub4of10,100,191,29,3377,252,3658
test4sub27of100,test4pub4of10,100,191,29,3377,252,3658
test4sub97of100,test4pub4of10,100,191,29,3379,252,3660
test4sub8of100,test4pub4of10,100,191,29,3379,253,3661
test4sub23of100,test4pub4of10,100,191,29,3382,253,3664
test4sub4of100,test4pub4of10,100,191,29,3381,253,3663
test4sub22of100,test4pub3of10,100,191,17,4094,449,4560
test4sub40of100,test4pub2of10,100,191,21,4516,210,4747
test4sub60of100,test4pub4of10,100,191,29,3427,212,3668
test4sub82of100,test4pub4of10,100,191,29,3429,209,3667
test4sub57of100,test4pub4of10,100,191,29,3429,211,3669
test4sub86of100,test4pub6of10,100,191,28,2400,209,2637
test4sub65of100,test4pub2of10,10,190,11,11029,173,11213
test4sub43of100,test4pub4of10,100,191,29,3471,172,3672
test4sub51of100,test4pub3of10,100,191,17,4380,172,4569
test4sub20of100,test4pub4of10,100,191,29,3473,171,3673
test4sub34of100,test4pub3of10,100,191,17,4382,172,4571
test4sub96of100,test4pub3of10,100,191,17,4384,171,4572
test4sub76of100,test4pub3of10,100,191,17,4386,171,4574
test4sub55of100,test4pub5of10,100,191,34,2800,171,3005
test4sub79of100,test4pub5of10,100,191,34,2802,170,3006
test4sub93of100,test4pub4of10,100,191,29,3481,171,3681
test4sub83of100,test4pub4of10,100,191,29,3483,171,3683
test4sub67of100,test4pub5of10,100,191,34,2807,169,3010
test4sub58of100,test4pub5of10,100,191,34,2806,171,3011
test4sub88of100,test4pub5of10,100,191,34,2809,169,3012
test4sub66of100,test4pub6of10,100,191,28,2457,170,2655
test4sub6of100,test4pub6of10,100,191,28,2459,168,2655
test4sub68of100,test4pub5of10,100,191,34,2811,170,3015
test4sub39of100,test4pub5of10,100,191,34,2813,169,3016
test4sub47of100,test4pub5of10,100,191,34,2813,171,3018
test4sub61of100,test4pub5of10,100,191,34,2815,169,3018
test4sub10of100,test4pub4of10,100,191,29,2026,1639,3694
test4sub71of100,test4pub3of10,100,191,17,4442,130,4589
test4sub63of100,test4pub6of10,100,191,28,2507,130,2665
test4sub24of100,test4pub5of10,100,191,34,2858,131,3023
test4sub52of100,test4pub4of10,100,191,29,3331,338,3698
test4sub9of100,test4pub7of10,100,191,29,2343,130,2502
test4sub25of100,test4pub5of10,100,191,34,2863,130,3027
test4sub69of100,test4pub1of10,100,12976,61,3226,1642,4929
test4sub74of100,test4pub2of10,100,191,21,4673,131,4825
test4sub94of100,test4pub7of10,100,191,29,2388,133,2550
test4sub100of100,test4pub4of10,100,191,29,3585,135,3749
test4sub21of100,test4pub5of10,100,191,34,2908,136,3078
test4sub36of100,test4pub6of10,100,191,28,2557,138,2723
test4sub41of100,test4pub5of10,100,191,34,2911,138,3083
test4sub38of100,test4pub5of10,100,191,34,2911,141,3086
test4sub19of100,test4pub3of10,100,191,17,3865,773,4655
test4sub91of100,test4pub3of10,100,191,17,4499,141,4657
test4sub11of100,test4pub4of10,100,191,29,3595,138,3762
test4sub81of100,test4pub5of10,100,191,34,2916,140,3090
test4sub54of100,test4pub7of10,100,191,29,2400,139,2568
test4sub16of100,test4pub3of10,100,191,17,4504,141,4662
test4sub37of100,test4pub5of10,100,191,34,2920,139,3093
test4sub15of100,test4pub3of10,100,191,17,4507,141,4665
test4sub3of100,test4pub6of10,100,191,28,2571,138,2737
test4sub92of100,test4pub4of10,100,191,29,3602,140,3771
test4sub32of100,test4pub6of10,100,191,28,2573,139,2740
test4sub17of100,test4pub6of10,100,191,28,2573,141,2742
test4sub14of100,test4pub6of10,100,191,28,2578,137,2743
test4sub53of100,test4pub5of10,100,191,34,2930,139,3103
test4sub7of100,test4pub6of10,100,191,28,2580,137,2745
test4sub46of100,test4pub6of10,100,191,28,2580,139,2747
test4sub5of100,test4pub7of10,100,191,29,2416,137,2582
test4sub87of100,test4pub5of10,100,191,34,2934,139,3107
test4sub56of100,test4pub4of10,100,191,29,3616,137,3782
test4sub48of100,test4pub6of10,100,191,28,2584,139,2751
test4sub49of100,test4pub5of10,100,191,34,2939,137,3110
test4sub84of100,test4pub5of10,100,191,34,2939,139,3112
test4sub1of100,test4pub7of10,100,191,29,2423,137,2589
test4sub90of100,test4pub5of10,100,191,34,2941,139,3114
test4sub44of100,test4pub6of10,100,191,28,2595,133,2756
test4sub72of100,test4pub4of10,100,191,29,3626,135,3790
test4sub31of100,test4pub5of10,100,191,34,2949,134,3117
test4sub95of100,test4pub4of10,100,191,29,3628,136,3793
test4sub30of100,test4pub5of10,100,191,34,2951,134,3119
test4sub27of100,test4pub5of10,100,191,34,2952,137,3123
test4sub8of100,test4pub5of10,100,191,34,2954,134,3122
test4sub97of100,test4pub5of10,100,191,34,2954,136,3124
test4sub23of100,test4pub5of10,100,191,34,2956,134,3124
test4sub4of100,test4pub5of10,100,191,34,2956,137,3127
test4sub40of100,test4pub3of10,100,191,17,4544,135,4696
test4sub22of100,test4pub4of10,100,191,29,3637,137,3803
test4sub60of100,test4pub5of10,100,191,34,2960,135,3129
test4sub82of100,test4pub5of10,100,191,34,2961,137,3132
test4sub86of100,test4pub7of10,100,191,29,2445,135,2609
test4sub57of100,test4pub5of10,100,191,34,2963,137,3134
test4sub65of100,test4pub3of10,10,190,11,11048,135,11194
test4sub43of100,test4pub5of10,100,191,34,2965,137,3136
test4sub51of100,test4pub4of10,100,191,29,3646,135,3810
test4sub20of100,test4pub5of10,100,191,34,2967,137,3138
test4sub34of100,test4pub4of10,100,191,29,3648,136,3813
test4sub96of100,test4pub4of10,100,191,29,3649,138,3816
test4sub76of100,test4pub4of10,100,191,29,3651,136,3816
test4sub55of100,test4pub6of10,100,191,28,2620,138,2786
test4sub79of100,test4pub6of10,100,191,28,2622,135,2785
test4sub93of100,test4pub5of10,100,191,34,2974,137,3145
test4sub83of100,test4pub5of10,100,191,34,2976,136,3146
test4sub67of100,test4pub6of10,100,191,28,2624,138,2790
test4sub58of100,test4pub6of10,100,191,28,2626,136,2790
test4sub88of100,test4pub6of10,100,191,28,2627,138,2793
test4sub6of100,test4pub7of10,100,191,29,2463,136,2628
test4sub66of100,test4pub7of10,100,191,29,2462,139,2630
test4sub39of100,test4pub6of10,100,191,28,2631,136,2795
test4sub68of100,test4pub6of10,100,191,28,2631,138,2797
test4sub47of100,test4pub6of10,100,191,28,2633,136,2797
test4sub61of100,test4pub6of10,100,191,28,2633,138,2799
test4sub10of100,test4pub5of10,100,191,34,2987,136,3157
test4sub71of100,test4pub4of10,100,191,29,3667,138,3834
test4sub24of100,test4pub6of10,100,191,28,2638,136,2802
test4sub63of100,test4pub7of10,100,191,29,2472,138,2639
test4sub52of100,test4pub5of10,100,191,34,2992,136,3162
test4sub9of100,test4pub8of10,100,191,21,2365,138,2524
test4sub25of100,test4pub6of10,100,191,28,2642,136,2806
test4sub26of100,test4pub5of10,100,191,34,2804,328,3166
test4sub69of100,test4pub3of10,100,191,17,4622,97,4736
test4sub94of100,test4pub8of10,100,191,21,2413,95,2529
test4sub100of100,test4pub5of10,100,191,34,3043,92,3169
test4sub21of100,test4pub6of10,100,191,28,2694,92,2814
test4sub36of100,test4pub7of10,100,191,29,2530,89,2648
test4sub41of100,test4pub6of10,100,191,28,2699,88,2815
test4sub19of100,test4pub4of10,100,191,29,3732,87,3848
test4sub38of100,test4pub6of10,100,191,28,2701,89,2818
test4sub11of100,test4pub5of10,100,191,34,3056,87,3177
test4sub91of100,test4pub4of10,100,191,29,3734,89,3852
test4sub81of100,test4pub6of10,100,191,28,2706,86,2820
test4sub54of100,test4pub8of10,100,191,21,2431,89,2541
test4sub37of100,test4pub6of10,100,191,28,2708,87,2823
test4sub49of100,test4pub6of10,100,191,28,2725,86,2839
test4sub87of100,test4pub6of10,100,191,28,2722,91,2841
test4sub56of100,test4pub5of10,100,191,34,3075,92,3201
test4sub46of100,test4pub7of10,100,191,29,2554,94,2677
test4sub48of100,test4pub7of10,100,191,29,2559,91,2679
test4sub5of100,test4pub8of10,100,191,21,2445,97,2563
test4sub2of100,test4pub4of10,100,191,29,3535,313,3877
test4sub14of100,test4pub7of10,100,191,29,2549,103,2681
test4sub7of100,test4pub7of10,100,191,29,2552,99,2680
test4sub17of100,test4pub7of10,100,191,29,2549,104,2682
test4sub32of100,test4pub7of10,100,191,29,2547,106,2682
test4sub3of100,test4pub7of10,100,191,29,2545,111,2685
test4sub92of100,test4pub5of10,100,191,34,3065,106,3205
test4sub15of100,test4pub4of10,100,191,29,3741,112,3882
test4sub16of100,test4pub4of10,100,191,29,3739,115,3883
test4sub84of100,test4pub6of10,100,191,28,2727,100,2855
test4sub1of100,test4pub8of10,100,191,21,2452,100,2573
test4sub44of100,test4pub7of10,100,191,29,2564,99,2692
test4sub90of100,test4pub6of10,100,191,28,2730,100,2858
test4sub31of100,test4pub6of10,100,191,28,2732,100,2860
test4sub72of100,test4pub5of10,100,191,34,3084,100,3218
test4sub30of100,test4pub6of10,100,191,28,2734,100,2862
test4sub95of100,test4pub5of10,100,191,34,3086,100,3220
test4sub8of100,test4pub6of10,100,191,28,2738,99,2865
test4sub27of100,test4pub6of10,100,191,28,2737,100,2865
test4sub23of100,test4pub6of10,100,191,28,2740,99,2867
test4sub97of100,test4pub6of10,100,191,28,2740,99,2867
test4sub40of100,test4pub4of10,100,191,29,3773,99,3901
test4sub4of100,test4pub6of10,100,191,28,2742,99,2869
test4sub60of100,test4pub6of10,100,191,28,2745,99,2872
test4sub22of100,test4pub5of10,100,191,34,3096,100,3230
test4sub86of100,test4pub8of10,100,191,21,2472,99,2592
test4sub82of100,test4pub6of10,100,191,28,2747,99,2874
test4sub65of100,test4pub4of10,10,190,24,10958,99,11081
test4sub57of100,test4pub6of10,100,191,28,2749,99,2876
test4sub43of100,test4pub6of10,100,191,28,2751,99,2878
test4sub51of100,test4pub5of10,100,191,34,3104,100,3238
test4sub34of100,test4pub5of10,100,191,34,3106,99,3239
test4sub20of100,test4pub6of10,100,191,28,2754,99,2881
test4sub96of100,test4pub5of10,100,191,34,3108,99,3241
test4sub76of100,test4pub5of10,100,191,34,3108,99,3241
test4sub79of100,test4pub7of10,100,191,29,2593,99,2721
test4sub55of100,test4pub7of10,100,191,29,2593,99,2721
test4sub33of100,test4pub4of10,100,191,29,3583,307,3919
test4sub83of100,test4pub6of10,100,191,28,2761,99,2888
test4sub58of100,test4pub7of10,100,191,29,2597,99,2725
test4sub67of100,test4pub7of10,100,191,29,2597,99,2725
test4sub6of100,test4pub8of10,100,191,21,2491,98,2610
test4sub88of100,test4pub7of10,100,191,29,2600,98,2727
test4sub39of100,test4pub7of10,100,191,29,2602,98,2729
test4sub66of100,test4pub8of10,100,191,21,2493,99,2613
test4sub47of100,test4pub7of10,100,191,29,2604,99,2732
test4sub68of100,test4pub7of10,100,191,29,2604,99,2732
test4sub10of100,test4pub6of10,100,191,28,2773,99,2900
test4sub61of100,test4pub7of10,100,191,29,2606,99,2734
test4sub24of100,test4pub7of10,100,191,29,2609,98,2736
test4sub71of100,test4pub5of10,100,191,34,3127,99,3260
test4sub52of100,test4pub6of10,100,191,28,2777,99,2904
test4sub63of100,test4pub8of10,100,191,21,2502,99,2622
test4sub25of100,test4pub7of10,100,191,29,2614,99,2742
test4sub9of100,test4pub9of10,100,191,27,2387,99,2513
test4sub69of100,test4pub4of10,100,191,29,3813,98,3940
test4sub26of100,test4pub6of10,100,191,28,2782,99,2909
test4sub94of100,test4pub9of10,100,191,27,2391,99,2517
test4sub100of100,test4pub6of10,100,191,28,2784,99,2911
test4sub36of100,test4pub8of10,100,191,21,2512,98,2631
test4sub21of100,test4pub7of10,100,191,29,2621,98,2748
test4sub19of100,test4pub5of10,100,191,34,3141,98,3273
test4sub41of100,test4pub7of10,100,191,29,2623,99,2751
test4sub38of100,test4pub7of10,100,191,29,2625,99,2753
test4sub11of100,test4pub6of10,100,191,28,2791,99,2918
test4sub81of100,test4pub7of10,100,191,29,2628,98,2755
test4sub91of100,test4pub5of10,100,191,34,3146,98,3278
test4sub49of100,test4pub7of10,100,191,29,2646,82,2757
test4sub37of100,test4pub7of10,100,191,29,2646,83,2758
test4sub54of100,test4pub9of10,100,191,27,2421,84,2532
test4sub87of100,test4pub7of10,100,191,29,2648,84,2761
test4sub56of100,test4pub6of10,100,191,28,2815,84,2927
test4sub46of100,test4pub8of10,100,191,21,2541,84,2646
test4sub48of100,test4pub8of10,100,191,21,2542,85,2648
test4sub5of100,test4pub9of10,100,191,27,2426,83,2536
test4sub14of100,test4pub8of10,100,191,21,2544,85,2650
test4sub17of100,test4pub8of10,100,191,21,2545,84,2650
test4sub32of100,test4pub8of10,100,191,21,2546,86,2653
test4sub2of100,test4pub5of10,100,191,34,3171,85,3290
test4sub3of100,test4pub8of10,100,191,21,2547,86,2654
test4sub92of100,test4pub6of10,100,191,28,2823,86,2937
test4sub15of100,test4pub5of10,100,191,34,3175,88,3297
test4sub16of100,test4pub5of10,100,191,34,3176,87,3297
test4sub7of100,test4pub8of10,100,191,21,2545,88,2654
test4sub84of100,test4pub7of10,100,191,29,2662,84,2775
test4sub1of100,test4pub9of10,100,191,27,2435,87,2549
test4sub90of100,test4pub7of10,100,191,29,2665,85,2779
test4sub44of100,test4pub8of10,100,191,21,2556,87,2664
test4sub31of100,test4pub7of10,100,191,29,2667,85,2781
test4sub72of100,test4pub6of10,100,191,28,2833,87,2948
test4sub95of100,test4pub6of10,100,191,28,2836,86,2950
test4sub30of100,test4pub7of10,100,191,29,2669,89,2787
test4sub8of100,test4pub7of10,100,191,29,2672,88,2789
test4sub27of100,test4pub7of10,100,191,29,2672,88,2789
test4sub97of100,test4pub7of10,100,191,29,2674,89,2792
test4sub42of100,test4pub3of10,100,191,17,4141,723,4881
test4sub23of100,test4pub7of10,100,191,29,2674,91,2794
test4sub40of100,test4pub5of10,100,191,34,3194,89,3317
test4sub60of100,test4pub7of10,100,191,29,2679,88,2796
test4sub22of100,test4pub6of10,100,191,28,2845,89,2962
test4sub86of100,test4pub9of10,100,191,27,2454,88,2569
test4sub82of100,test4pub7of10,100,191,29,2681,89,2799
test4sub65of100,test4pub5of10,10,190,11,10982,89,11082
test4sub57of100,test4pub7of10,100,191,29,2684,89,2802
test4sub51of100,test4pub6of10,100,191,28,2852,88,2968
test4sub43of100,test4pub7of10,100,191,29,2686,88,2803
test4sub20of100,test4pub7of10,100,191,29,2688,88,2805
test4sub34of100,test4pub6of10,100,191,28,2854,89,2971
test4sub76of100,test4pub6of10,100,191,28,2856,89,2973
test4sub96of100,test4pub6of10,100,191,28,2856,89,2973
test4sub55of100,test4pub8of10,100,191,21,2584,89,2694
test4sub79of100,test4pub8of10,100,191,21,2584,89,2694
test4sub33of100,test4pub5of10,100,191,34,3213,88,3335
test4sub83of100,test4pub7of10,100,191,29,2695,89,2813
test4sub67of100,test4pub8of10,100,191,21,2588,89,2698
test4sub58of100,test4pub8of10,100,191,21,2588,89,2698
test4sub88of100,test4pub8of10,100,191,21,2591,89,2701
test4sub6of100,test4pub9of10,100,191,27,2472,89,2588
test4sub66of100,test4pub9of10,100,191,27,2475,88,2590
test4sub39of100,test4pub8of10,100,191,21,2593,89,2703
test4sub68of100,test4pub8of10,100,191,21,2595,89,2705
test4sub47of100,test4pub8of10,100,191,21,2595,89,2705
test4sub61of100,test4pub8of10,100,191,21,2598,89,2708
test4sub10of100,test4pub7of10,100,191,29,2706,89,2824
test4sub71of100,test4pub6of10,100,191,28,2875,88,2991
test4sub24of100,test4pub8of10,100,191,21,2600,89,2710
test4sub63of100,test4pub9of10,100,191,27,2484,89,2600
test4sub52of100,test4pub7of10,100,191,29,2711,89,2829
test4sub9of100,test4pub10of10,100,192,24,2406,89,2519
test4sub25of100,test4pub8of10,100,191,21,2605,89,2715
test4sub26of100,test4pub7of10,100,191,29,2716,88,2833
test4sub69of100,test4pub5of10,100,191,34,3234,89,3357
test4sub100of100,test4pub7of10,100,191,29,2718,89,2836
test4sub94of100,test4pub10of10,100,192,24,2410,89,2523
test4sub21of100,test4pub8of10,100,191,21,2612,88,2721
test4sub36of100,test4pub9of10,100,191,27,2493,90,2610
test4sub19of100,test4pub6of10,100,191,28,2889,87,3004
test4sub41of100,test4pub8of10,100,191,21,2614,89,2724
test4sub38of100,test4pub8of10,100,191,21,2616,87,2724
test4sub11of100,test4pub7of10,100,191,29,2725,89,2843
test4sub81of100,test4pub8of10,100,191,21,2618,88,2727
test4sub91of100,test4pub6of10,100,191,28,2894,90,3012
test4sub37of100,test4pub8of10,100,191,21,2621,87,2729
test4sub49of100,test4pub8of10,100,191,21,2621,89,2731
test4sub87of100,test4pub8of10,100,191,21,2623,87,2731
test4sub54of100,test4pub10of10,100,192,24,2424,89,2537
test4sub46of100,test4pub9of10,100,191,27,2508,86,2621
test4sub56of100,test4pub7of10,100,191,29,2735,87,2851
test4sub5of100,test4pub10of10,100,192,24,2429,87,2540
test4sub48of100,test4pub9of10,100,191,27,2510,87,2624
test4sub17of100,test4pub9of10,100,191,27,2512,86,2625
test4sub14of100,test4pub9of10,100,191,27,2512,88,2627
test4sub2of100,test4pub6of10,100,191,28,2908,85,3021
test4sub32of100,test4pub9of10,100,191,27,2515,87,2629
test4sub92of100,test4pub7of10,100,191,29,2744,85,2858
test4sub3of100,test4pub9of10,100,191,27,2517,87,2631
test4sub15of100,test4pub6of10,100,191,28,2912,86,3026
test4sub16of100,test4pub6of10,100,191,28,2913,87,3028
test4sub7of100,test4pub9of10,100,191,27,2522,85,2634
test4sub84of100,test4pub8of10,100,191,21,2640,87,2748
test4sub90of100,test4pub8of10,100,191,21,2642,85,2748
test4sub1of100,test4pub10of10,100,192,24,2443,87,2554
test4sub31of100,test4pub8of10,100,191,21,2645,86,2752
test4sub44of100,test4pub9of10,100,191,27,2526,85,2638
test4sub72of100,test4pub7of10,100,191,29,2756,85,2870
test4sub95of100,test4pub7of10,100,191,29,2756,85,2870
test4sub30of100,test4pub8of10,100,191,21,2650,84,2755
test4sub27of100,test4pub8of10,100,191,21,2653,82,2756
test4sub8of100,test4pub8of10,100,191,21,2653,84,2758
test4sub42of100,test4pub4of10,100,191,29,3961,82,4072
test4sub97of100,test4pub8of10,100,191,21,2655,90,2766
test4sub40of100,test4pub6of10,100,191,28,2933,88,3049
test4sub23of100,test4pub8of10,100,191,21,2657,90,2768
test4sub22of100,test4pub7of10,100,191,29,2769,87,2885
test4sub60of100,test4pub8of10,100,191,21,2660,89,2770
test4sub86of100,test4pub10of10,100,192,24,2463,88,2575
test4sub82of100,test4pub8of10,100,191,21,2662,88,2771
test4sub65of100,test4pub6of10,10,190,16,10934,89,11039
test4sub57of100,test4pub8of10,100,191,21,2664,89,2774
test4sub43of100,test4pub8of10,100,191,21,2667,89,2777
test4sub51of100,test4pub7of10,100,191,29,2776,89,2894
test4sub20of100,test4pub8of10,100,191,21,2669,88,2778
test4sub34of100,test4pub7of10,100,191,29,2778,89,2896
test4sub96of100,test4pub7of10,100,191,29,2780,88,2897
test4sub76of100,test4pub7of10,100,191,29,2780,89,2898
test4sub55of100,test4pub9of10,100,191,27,2556,88,2671
test4sub79of100,test4pub9of10,100,191,27,2556,88,2671
test4sub83of100,test4pub8of10,100,191,21,2676,88,2785
test4sub33of100,test4pub6of10,100,191,28,2951,88,3067
test4sub58of100,test4pub9of10,100,191,27,2560,88,2675
test4sub67of100,test4pub9of10,100,191,27,2560,89,2676
test4sub88of100,test4pub9of10,100,191,27,2563,88,2678
test4sub6of100,test4pub10of10,100,192,24,2482,89,2595
test4sub39of100,test4pub9of10,100,191,27,2565,87,2679
test4sub66of100,test4pub10of10,100,192,24,2484,89,2597
test4sub47of100,test4pub9of10,100,191,27,2567,87,2681
test4sub68of100,test4pub9of10,100,191,27,2567,89,2683
test4sub10of100,test4pub8of10,100,191,21,2688,89,2798
test4sub61of100,test4pub9of10,100,191,27,2569,89,2685
test4sub24of100,test4pub9of10,100,191,27,2572,89,2688
test4sub71of100,test4pub7of10,100,191,29,2799,89,2917
test4sub52of100,test4pub8of10,100,191,21,2692,89,2802
test4sub63of100,test4pub10of10,100,192,24,2493,89,2606
test4sub25of100,test4pub9of10,100,191,27,2576,88,2691
test4sub26of100,test4pub8of10,100,191,21,2697,87,2805
test4sub69of100,test4pub6of10,100,191,28,2972,88,3088
test4sub100of100,test4pub8of10,100,191,21,2699,87,2807
test4sub21of100,test4pub9of10,100,191,27,2582,87,2696
test4sub93of100,test4pub6of10,100,191,28,2761,303,3092
test4sub36of100,test4pub10of10,100,192,24,2503,87,2614
test4sub19of100,test4pub7of10,100,191,29,2811,88,2928
test4sub41of100,test4pub9of10,100,191,27,2586,87,2700
test4sub38of100,test4pub9of10,100,191,27,2587,88,2702
test4sub11of100,test4pub8of10,100,191,21,2707,88,2816
test4sub81of100,test4pub10of10,100,192,24,2508,88,2620
test4sub91of100,test4pub7of10,100,191,29,2818,88,2935
test4sub37of100,test4pub9of10,100,191,27,2591,88,2706
test4sub87of100,test4pub9of10,100,191,27,2594,89,2710
test4sub49of100,test4pub9of10,100,191,27,2593,89,2709
test4sub46of100,test4pub10of10,100,192,24,2515,88,2627
test4sub56of100,test4pub8of10,100,191,21,2714,88,2823
test4sub48of100,test4pub10of10,100,192,24,2518,88,2630
test4sub17of100,test4pub10of10,100,192,24,2518,88,2630
test4sub14of100,test4pub10of10,100,192,24,2520,87,2631
test4sub2of100,test4pub7of10,100,191,29,2828,87,2944
test4sub32of100,test4pub10of10,100,192,24,2522,85,2631
test4sub92of100,test4pub8of10,100,191,21,2722,86,2829
test4sub15of100,test4pub7of10,100,191,29,2833,86,2948
test4sub3of100,test4pub10of10,100,192,24,2525,86,2635
test4sub7of100,test4pub10of10,100,192,24,2527,85,2636
test4sub16of100,test4pub7of10,100,191,29,2835,86,2950
test4sub90of100,test4pub9of10,100,191,27,2611,84,2722
test4sub84of100,test4pub9of10,100,191,27,2610,86,2723
test4sub31of100,test4pub9of10,100,191,27,2613,83,2723
test4sub44of100,test4pub10of10,100,192,24,2533,85,2642
test4sub72of100,test4pub8of10,100,191,21,2734,82,2837
test4sub95of100,test4pub8of10,100,191,21,2734,83,2838
test4sub27of100,test4pub9of10,100,191,27,2618,83,2728
test4sub30of100,test4pub9of10,100,191,27,2618,83,2728
test4sub8of100,test4pub9of10,100,191,27,2620,83,2730
test4sub42of100,test4pub5of10,100,191,34,3371,77,3482
test4sub97of100,test4pub9of10,100,191,27,2628,77,2732
test4sub40of100,test4pub7of10,100,191,29,2855,78,2962
test4sub22of100,test4pub8of10,100,191,21,2749,78,2848
test4sub23of100,test4pub9of10,100,191,27,2630,78,2735
test4sub60of100,test4pub9of10,100,191,27,2633,77,2737
test4sub82of100,test4pub9of10,100,191,27,2634,76,2737
test4sub65of100,test4pub7of10,10,190,17,10885,76,10978
test4sub57of100,test4pub9of10,100,191,27,2636,76,2739
test4sub43of100,test4pub9of10,100,191,27,2638,76,2741
test4sub51of100,test4pub8of10,100,191,21,2757,77,2855
test4sub34of100,test4pub8of10,100,191,21,2759,76,2856
test4sub20of100,test4pub9of10,100,191,27,2641,76,2744
test4sub96of100,test4pub8of10,100,191,21,2761,76,2858
test4sub76of100,test4pub8of10,100,191,21,2761,76,2858
test4sub55of100,test4pub10of10,100,192,24,2564,77,2665
test4sub79of100,test4pub10of10,100,192,24,2565,77,2666
test4sub83of100,test4pub9of10,100,191,27,2648,74,2749
test4sub33of100,test4pub7of10,100,191,29,2875,75,2979
test4sub67of100,test4pub10of10,100,192,24,2569,75,2668
test4sub58of100,test4pub10of10,100,192,24,2569,75,2668
test4sub88of100,test4pub10of10,100,192,24,2571,74,2669
test4sub39of100,test4pub10of10,100,192,24,2572,73,2669
test4sub47of100,test4pub10of10,100,192,24,2575,71,2670
test4sub68of100,test4pub10of10,100,192,24,2576,70,2670
test4sub61of100,test4pub10of10,100,192,24,2579,67,2670
test4sub10of100,test4pub9of10,100,191,27,2660,68,2755
test4sub24of100,test4pub10of10,100,192,24,2581,66,2671
test4sub71of100,test4pub8of10,100,191,21,2780,67,2868
test4sub52of100,test4pub9of10,100,191,27,2664,67,2758
test4sub25of100,test4pub10of10,100,192,24,2585,67,2676
test4sub26of100,test4pub9of10,100,191,27,2668,65,2760
test4sub69of100,test4pub7of10,100,191,29,2895,67,2991
test4sub100of100,test4pub9of10,100,191,27,2670,65,2762
test4sub21of100,test4pub10of10,100,192,24,2589,67,2680
test4sub93of100,test4pub7of10,100,191,29,2899,65,2993
test4sub19of100,test4pub8of10,100,191,21,2791,66,2878
test4sub41of100,test4pub10of10,100,192,24,2595,64,2683
test4sub38of100,test4pub10of10,100,192,24,2595,64,2683
test4sub81of100,test4pub9of10,100,191,27,2678,64,2769
test4sub11of100,test4pub9of10,100,191,27,2678,64,2769
test4sub37of100,test4pub10of10,100,192,24,2600,61,2685
test4sub91of100,test4pub8of10,100,191,21,2799,62,2882
test4sub87of100,test4pub10of10,100,192,24,2602,62,2688
test4sub49of100,test4pub10of10,100,192,24,2602,63,2689
test4sub56of100,test4pub9of10,100,191,27,2686,60,2773
test4sub2of100,test4pub8of10,100,191,21,2807,58,2886
test4sub92of100,test4pub9of10,100,191,27,2691,58,2776
test4sub15of100,test4pub8of10,100,191,21,2811,56,2888
test4sub16of100,test4pub8of10,100,191,21,2813,56,2890
test4sub90of100,test4pub10of10,100,192,24,2614,56,2694
test4sub31of100,test4pub10of10,100,192,24,2617,55,2696
test4sub84of100,test4pub10of10,100,192,24,2616,56,2696
test4sub72of100,test4pub9of10,100,191,27,2700,53,2780
test4sub95of100,test4pub9of10,100,191,27,2700,54,2781
test4sub27of100,test4pub10of10,100,192,24,2621,54,2699
test4sub30of100,test4pub10of10,100,192,24,2622,54,2700
test4sub42of100,test4pub6of10,100,191,28,3098,53,3179
test4sub8of100,test4pub10of10,100,192,24,2624,59,2707
test4sub97of100,test4pub10of10,100,192,24,2626,65,2715
test4sub40of100,test4pub8of10,100,191,21,2825,66,2912
test4sub22of100,test4pub9of10,100,191,27,2709,66,2802
test4sub23of100,test4pub10of10,100,192,24,2628,69,2721
test4sub60of100,test4pub10of10,100,192,24,2630,68,2722
test4sub82of100,test4pub10of10,100,192,24,2631,69,2724
test4sub57of100,test4pub10of10,100,192,24,2633,67,2724
test4sub65of100,test4pub8of10,10,190,21,10857,68,10946
test4sub51of100,test4pub9of10,100,191,27,2716,68,2811
test4sub43of100,test4pub10of10,100,192,24,2635,71,2730
test4sub20of100,test4pub10of10,100,192,24,2637,70,2731
test4sub34of100,test4pub9of10,100,191,27,2718,71,2816
test4sub76of100,test4pub9of10,100,191,27,2721,71,2819
test4sub96of100,test4pub9of10,100,191,27,2721,74,2822
test4sub83of100,test4pub10of10,100,192,24,2643,73,2740
test4sub33of100,test4pub8of10,100,191,21,2842,74,2937
test4sub10of100,test4pub10of10,100,192,24,2648,72,2744
test4sub71of100,test4pub9of10,100,191,27,2731,71,2829
test4sub52of100,test4pub10of10,100,192,24,2652,69,2745
test4sub26of100,test4pub10of10,100,192,24,2653,69,2746
test4sub69of100,test4pub8of10,100,191,21,2854,68,2943
test4sub100of100,test4pub10of10,100,192,24,2655,68,2747
test4sub93of100,test4pub8of10,100,191,21,2857,67,2945
test4sub19of100,test4pub9of10,100,191,27,2741,66,2834
test4sub11of100,test4pub10of10,100,192,24,2662,64,2750
test4sub91of100,test4pub9of10,100,191,27,2745,63,2835
test4sub56of100,test4pub10of10,100,192,24,2666,63,2753
test4sub2of100,test4pub9of10,100,191,27,2748,63,2838
test4sub92of100,test4pub10of10,100,192,24,2669,63,2756
test4sub15of100,test4pub9of10,100,191,27,2750,63,2840
test4sub16of100,test4pub9of10,100,191,27,2752,62,2841
test4sub72of100,test4pub10of10,100,192,24,2673,62,2759
test4sub95of100,test4pub10of10,100,192,24,2674,61,2759
test4sub42of100,test4pub7of10,100,191,29,2985,59,3073
test4sub40of100,test4pub9of10,100,191,27,2774,43,2844
test4sub22of100,test4pub10of10,100,192,24,2696,42,2762
test4sub65of100,test4pub9of10,10,190,12,10721,36,10769
test4sub51of100,test4pub10of10,100,192,24,2705,35,2764
test4sub34of100,test4pub10of10,100,192,24,2710,31,2765
test4sub76of100,test4pub10of10,100,192,24,2713,28,2765
test4sub96of100,test4pub10of10,100,192,24,2715,26,2765
test4sub33of100,test4pub9of10,100,191,27,2800,23,2850
test4sub71of100,test4pub10of10,100,192,24,2722,20,2766
test4sub69of100,test4pub10of10,100,192,24,2724,19,2767
test4sub93of100,test4pub9of10,100,191,27,2806,21,2854
test4sub19of100,test4pub10of10,100,192,24,2728,18,2770
test4sub91of100,test4pub10of10,100,192,24,2729,18,2771
test4sub2of100,test4pub10of10,100,192,24,2731,17,2772
test4sub15of100,test4pub10of10,100,192,24,2734,14,2772
test4sub16of100,test4pub10of10,100,192,24,2734,15,2773
test4sub40of100,test4pub10of10,100,192,24,2737,12,2773
test4sub42of100,test4pub8of10,100,191,21,2936,13,2970
test4sub65of100,test4pub10of10,10,191,13,10476,11,10500
test4sub33of100,test4pub10of10,100,192,24,2743,11,2778
test4sub69of100,test4pub9of10,100,191,27,2826,9,2862
test4sub93of100,test4pub10of10,100,192,24,2747,8,2779
test4sub42of100,test4pub9of10,100,191,27,2832,4,2863
test4sub65of100,test4pub1of10,100,12976,61,5413,43,5517
test4sub42of100,test4pub10of10,100,192,24,2756,40,2820
test4sub4of100,test4pub7of10,100,191,29,2677,430,3136
test4sub99of100,test4pub4of10,100,191,29,3593,713,4335
test4sub65of100,test4pub2of10,100,191,21,5393,2,5416
test4sub4of100,test4pub8of10,100,191,21,2998,3,3022
test4sub99of100,test4pub5of10,100,191,34,3627,2,3663
test4sub65of100,test4pub3of10,100,191,17,5214,3,5234
test4sub4of100,test4pub9of10,100,191,27,2885,1,2913
test4sub99of100,test4pub6of10,100,191,28,3278,2,3308
test4sub4of100,test4pub10of10,100,192,24,2807,2,2833
test4sub65of100,test4pub4of10,100,191,29,4312,1,4342
test4sub99of100,test4pub7of10,100,191,29,3116,1,3146
test4sub99of100,test4pub8of10,100,191,21,3010,1,3032
test4sub65of100,test4pub5of10,100,191,34,3637,1,3672
test4sub99of100,test4pub10of10,100,192,24,2813,1,2838
test4sub65of100,test4pub6of10,100,191,28,3288,1,3317
test4sub65of100,test4pub7of10,100,191,29,3124,1,3154
test4sub99of100,test4pub9of10,100,191,27,2897,1,2925
test4sub65of100,test4pub8of10,100,191,21,3017,1,3039
test4sub65of100,test4pub10of10,100,192,24,2820,1,2845
test4sub65of100,test4pub9of10,100,191,27,2904,0,2931
test4sub50of100,test4pub1of10,100,12976,61,3259,3050,6370
test4sub80of100,test4pub4of10,100,191,29,2111,3042,5182
test4sub89of100,test4pub1of10,100,12976,61,3281,3072,6414
test4sub28of100,test4pub4of10,100,191,29,2137,3060,5226
test4sub80of100,test4pub5of10,100,191,34,4476,45,4555
test4sub50of100,test4pub3of10,100,191,17,6062,45,6124
test4sub89of100,test4pub3of10,100,191,17,6106,3,6126
test4sub28of100,test4pub5of10,100,191,34,4520,3,4557
test4sub50of100,test4pub4of10,100,191,29,5201,4,5234
test4sub80of100,test4pub6of10,100,191,28,4170,4,4202
test4sub89of100,test4pub4of10,100,191,29,5203,3,5235
test4sub28of100,test4pub6of10,100,191,28,4173,5,4206
test4sub80of100,test4pub7of10,100,191,29,4009,3,4041
test4sub50of100,test4pub5of10,100,191,34,4527,4,4565
test4sub89of100,test4pub5of10,100,191,34,4529,3,4566
test4sub28of100,test4pub7of10,100,191,29,4013,2,4044
test4sub80of100,test4pub8of10,100,191,21,3904,4,3929
test4sub28of100,test4pub8of10,100,191,21,3908,2,3931
test4sub50of100,test4pub6of10,100,191,28,4182,4,4214
test4sub89of100,test4pub6of10,100,191,28,4182,3,4213
test4sub80of100,test4pub9of10,100,191,27,3792,2,3821
test4sub28of100,test4pub9of10,100,191,27,3792,3,3822
test4sub80of100,test4pub10of10,100,192,24,3715,1,3740
test4sub28of100,test4pub10of10,100,192,24,3716,1,3741
test4sub50of100,test4pub7of10,100,191,29,4021,2,4052
test4sub89of100,test4pub7of10,100,191,29,4021,5,4055
test4sub50of100,test4pub8of10,100,191,21,3918,1,3940
test4sub89of100,test4pub8of10,100,191,21,3920,10,3951
test4sub50of100,test4pub9of10,100,191,27,3803,9,3839
test4sub89of100,test4pub9of10,100,191,27,3813,1,3841
test4sub50of100,test4pub10of10,100,192,24,3732,1,3757
test4sub35of100,test4pub4of10,100,191,29,2232,3008,5269
test4sub89of100,test4pub10of10,100,192,24,3734,1,3759
test4sub35of100,test4pub5of10,100,191,34,4562,1,4597
test4sub35of100,test4pub6of10,100,191,28,4213,1,4242
test4sub35of100,test4pub7of10,100,191,29,4049,0,4078
test4sub35of100,test4pub8of10,100,191,21,3942,1,3964
test4sub35of100,test4pub9of10,100,191,27,3826,1,3854
test4sub35of100,test4pub10of10,100,192,24,3747,1,3772
test4sub70of100,test4pub1of10,100,12976,61,3403,3050,6514
test4sub70of100,test4pub2of10,100,191,21,6389,0,6410
test4sub70of100,test4pub3of10,100,191,17,6208,1,6226
test4sub70of100,test4pub4of10,100,191,29,5303,1,5333
test4sub45of100,test4pub2of10,100,191,21,3390,3005,6416
test4sub75of100,test4pub1of10,100,12976,61,3454,3050,6565
test4sub45of100,test4pub3of10,100,191,17,6213,43,6273
test4sub70of100,test4pub5of10,100,191,34,4627,43,4704
test4sub45of100,test4pub4of10,100,191,29,5351,2,5382
test4sub75of100,test4pub3of10,100,191,17,6257,4,6278
test4sub45of100,test4pub5of10,100,191,34,4674,1,4709
test4sub70of100,test4pub6of10,100,191,28,4322,3,4353
test4sub75of100,test4pub4of10,100,191,29,5355,3,5387
test4sub70of100,test4pub7of10,100,191,29,4161,19,4209
test4sub45of100,test4pub6of10,100,191,28,4325,20,4373
test4sub75of100,test4pub5of10,100,191,34,4697,2,4733
test4sub75of100,test4pub6of10,100,191,28,4350,1,4379
test4sub45of100,test4pub7of10,100,191,29,4183,4,4216
test4sub70of100,test4pub8of10,100,191,21,4072,7,4100
test4sub75of100,test4pub7of10,100,191,29,4187,1,4217
test4sub45of100,test4pub8of10,100,191,21,4079,1,4101
test4sub70of100,test4pub9of10,100,191,27,3962,2,3991
test4sub75of100,test4pub8of10,100,191,21,4082,1,4104
test4sub70of100,test4pub10of10,100,192,24,3884,2,3910
test4sub45of100,test4pub9of10,100,191,27,3964,3,3994
test4sub75of100,test4pub9of10,100,191,27,3968,8,4003
test4sub45of100,test4pub10of10,100,192,24,3888,7,3919
test4sub75of100,test4pub10of10,100,192,24,3896,1,3921
test4sub64of100,test4pub1of10,100,12976,61,3570,3049,6680
test4sub64of100,test4pub3of10,100,191,17,6374,1,6392
test4sub64of100,test4pub4of10,100,191,29,5469,1,5499
test4sub64of100,test4pub5of10,100,191,34,4792,1,4827
test4sub64of100,test4pub6of10,100,191,28,4442,1,4471
test4sub64of100,test4pub7of10,100,191,29,4279,0,4308
test4sub64of100,test4pub8of10,100,191,21,4172,1,4194
test4sub64of100,test4pub9of10,100,191,27,4056,1,4084
test4sub64of100,test4pub10of10,100,192,24,3977,1,4002
test4sub13of100,test4pub1of10,100,12976,61,3634,3049,6744
test4sub73of100,test4pub1of10,100,12976,61,3652,3075,6788
test4sub13of100,test4pub3of10,100,191,17,6438,42,6497
test4sub73of100,test4pub3of10,100,191,17,6481,1,6499
test4sub13of100,test4pub4of10,100,191,29,5574,2,5605
test4sub78of100,test4pub1of10,100,12976,61,3726,3051,6838
test4sub73of100,test4pub4of10,100,191,29,5577,44,5650
test4sub13of100,test4pub5of10,100,191,34,4899,45,4978
test4sub85of100,test4pub1of10,100,12976,61,3758,3062,6881
test4sub78of100,test4pub2of10,100,191,21,6712,44,6777
test4sub73of100,test4pub5of10,100,191,34,4943,46,5023
test4sub13of100,test4pub6of10,100,191,28,4593,44,4665
test4sub78of100,test4pub3of10,100,191,17,6574,3,6594
test4sub85of100,test4pub3of10,100,191,17,6574,3,6594
test4sub13of100,test4pub7of10,100,191,29,4472,4,4505
test4sub73of100,test4pub6of10,100,191,28,4638,4,4670
test4sub78of100,test4pub4of10,100,191,29,5671,5,5705
test4sub85of100,test4pub4of10,100,191,29,5672,4,5705
test4sub73of100,test4pub7of10,100,191,29,4478,3,4510
test4sub85of100,test4pub5of10,100,191,34,4998,2,5034
test4sub13of100,test4pub8of10,100,191,21,4368,3,4392
test4sub78of100,test4pub5of10,100,191,34,4998,5,5037
test4sub85of100,test4pub6of10,100,191,28,4649,3,4680
test4sub73of100,test4pub8of10,100,191,21,4374,2,4397
test4sub13of100,test4pub9of10,100,191,27,4258,3,4288
test4sub85of100,test4pub7of10,100,191,29,4487,1,4517
test4sub78of100,test4pub6of10,100,191,28,4652,5,4685
test4sub73of100,test4pub9of10,100,191,27,4261,4,4292
test4sub13of100,test4pub10of10,100,192,24,4182,4,4210
test4sub85of100,test4pub8of10,100,191,21,4382,4,4407
test4sub78of100,test4pub7of10,100,191,29,4493,4,4526
test4sub73of100,test4pub10of10,100,192,24,4186,3,4213
test4sub85of100,test4pub9of10,100,191,27,4269,2,4298
test4sub78of100,test4pub8of10,100,191,21,4389,1,4411
test4sub85of100,test4pub10of10,100,192,24,4191,1,4216
test4sub78of100,test4pub9of10,100,191,27,4274,1,4302
test4sub78of100,test4pub10of10,100,192,24,4195,1,4220
test4sub62of100,test4pub1of10,100,12976,61,3861,3047,6969
test4sub62of100,test4pub3of10,100,191,17,6662,1,6680
test4sub62of100,test4pub4of10,100,191,29,5757,1,5787
test4sub62of100,test4pub5of10,100,191,34,5080,1,5115
test4sub62of100,test4pub6of10,100,191,28,4730,1,4759
test4sub62of100,test4pub7of10,100,191,29,4567,0,4596
test4sub62of100,test4pub8of10,100,191,21,4460,0,4481
test4sub62of100,test4pub9of10,100,191,27,4344,1,4372
test4sub62of100,test4pub10of10,100,192,24,4265,1,4290
test4sub18of100,test4pub1of10,100,12976,61,3962,3050,7073
test4sub12of100,test4pub1of10,100,12976,61,4003,3055,7119
test4sub18of100,test4pub3of10,100,191,17,6765,45,6827
test4sub12of100,test4pub3of10,100,191,17,6811,1,6829
test4sub18of100,test4pub4of10,100,191,29,5904,1,5934
test4sub18of100,test4pub5of10,100,191,34,5228,1,5263
test4sub12of100,test4pub4of10,100,191,29,5907,1,5937
test4sub12of100,test4pub5of10,100,191,34,5230,1,5265
test4sub18of100,test4pub6of10,100,191,28,4878,2,4908
test4sub18of100,test4pub7of10,100,191,29,4715,1,4745
test4sub12of100,test4pub6of10,100,191,28,4881,1,4910
test4sub18of100,test4pub8of10,100,191,21,4608,9,4638
test4sub12of100,test4pub7of10,100,191,29,4718,9,4756
test4sub18of100,test4pub9of10,100,191,27,4500,1,4528
test4sub12of100,test4pub8of10,100,191,21,4619,1,4641
test4sub18of100,test4pub10of10,100,192,24,4422,9,4455
test4sub12of100,test4pub9of10,100,191,27,4503,9,4539
test4sub12of100,test4pub10of10,100,192,24,4432,1,4457
test4sub98of100,test4pub1of10,100,12976,61,4375,3046,7482
test4sub98of100,test4pub3of10,100,191,17,7173,1,7191
test4sub98of100,test4pub4of10,100,191,29,6269,1,6299
test4sub98of100,test4pub5of10,100,191,34,5592,1,5627
test4sub98of100,test4pub6of10,100,191,28,5242,1,5271
test4sub98of100,test4pub7of10,100,191,29,5079,1,5109
test4sub98of100,test4pub8of10,100,191,21,4972,1,4994
test4sub98of100,test4pub9of10,100,191,27,4856,1,4884
test4sub98of100,test4pub10of10,100,192,24,4777,1,4802
test4sub29of100,test4pub1of10,100,12976,61,4552,3044,7657
test4sub29of100,test4pub3of10,100,191,17,7350,0,7367
test4sub29of100,test4pub4of10,100,191,29,6445,1,6475
test4sub29of100,test4pub5of10,100,191,34,5768,1,5803
test4sub29of100,test4pub6of10,100,191,28,5418,1,5447
test4sub29of100,test4pub7of10,100,191,29,5254,1,5284
test4sub29of100,test4pub8of10,100,191,21,5147,1,5169
test4sub29of100,test4pub9of10,100,191,27,5031,1,5059
test4sub29of100,test4pub10of10,100,192,24,4952,1,4977
test4sub77of100,test4pub1of10,100,12976,61,4677,3050,7788
test4sub59of100,test4pub3of10,100,191,17,4447,3033,7497
test4sub77of100,test4pub2of10,100,191,21,7664,1,7686
test4sub59of100,test4pub4of10,100,191,29,6574,1,6604
test4sub59of100,test4pub5of10,100,191,34,5898,1,5933
test4sub59of100,test4pub6of10,100,191,28,5548,1,5577
test4sub77of100,test4pub3of10,100,191,17,7483,1,7501
test4sub48of100,test4pub1of100,1,318,24,5,39,68
test4sub59of100,test4pub7of10,100,191,29,5385,40,5454
test4sub77of100,test4pub4of10,100,191,29,6582,39,6650
test4sub32of100,test4pub1of100,1,318,24,8,75,107
test4sub5of100,test4pub1of100,1,318,24,17,106,147
test4sub1of100,test4pub1of100,1,318,24,27,136,187
test4sub14of100,test4pub1of100,1,318,24,27,176,227
test4sub11of100,test4pub1of100,1,318,24,28,215,267
test4sub34of100,test4pub1of100,1,318,24,30,254,308
test4sub17of100,test4pub1of100,1,318,24,31,292,347
test4sub44of100,test4pub1of100,1,318,24,32,332,388
test4sub66of100,test4pub1of100,1,318,24,34,369,427
test4sub6of100,test4pub1of100,1,318,24,35,409,468
test4sub94of100,test4pub1of100,1,318,24,36,447,507
test4sub9of100,test4pub1of100,1,318,24,36,487,547
test4sub51of100,test4pub1of100,1,318,24,41,523,588
test4sub54of100,test4pub1of100,1,318,24,41,562,627
test4sub40of100,test4pub1of100,1,318,24,41,602,667
test4sub96of100,test4pub1of100,1,318,24,44,639,707
test4sub62of100,test4pub1of100,1,318,24,44,679,747
test4sub77of100,test4pub5of10,100,191,34,5945,676,6655
test4sub59of100,test4pub8of10,100,191,21,5317,678,6016
test4sub19of100,test4pub1of100,1,318,24,51,712,787
test4sub78of100,test4pub1of100,1,318,24,52,752,828
test4sub65of100,test4pub1of100,1,318,24,55,788,867
test4sub15of100,test4pub1of100,1,318,24,58,826,908
test4sub7of100,test4pub1of100,1,318,24,58,864,946
test4sub99of100,test4pub1of100,1,318,24,59,904,987
test4sub4of100,test4pub1of100,1,318,24,60,943,1027
test4sub39of100,test4pub1of100,1,318,24,61,983,1068
test4sub16of100,test4pub1of100,1,318,24,61,1022,1107
test4sub74of100,test4pub3of10,100,191,17,4624,3943,8584
test4sub70of100,test4pub1of100,1,318,24,165,958,1147
test4sub53of100,test4pub6of10,100,191,28,2718,3951,6697
test4sub2of100,test4pub1of100,1,318,24,192,971,1187
test4sub42of100,test4pub1of100,1,318,24,200,1003,1227
test4sub91of100,test4pub1of100,1,318,24,209,1034,1267
test4sub69of100,test4pub1of100,1,318,24,215,1068,1307
test4sub33of100,test4pub1of100,1,318,24,222,1101,1347
test4sub30of100,test4pub2of100,1,190,10,209,1095,1314
test4sub76of100,test4pub1of100,1,318,24,235,1128,1387
test4sub45of100,test4pub1of100,1,318,24,242,1162,1428
test4sub87of100,test4pub1of100,1,318,24,248,1195,1467
test4sub35of100,test4pub1of100,1,318,24,255,1228,1507
test4sub63of100,test4pub1of100,1,318,24,262,1261,1547
test4sub89of100,test4pub2of100,1,190,10,249,1255,1514
test4sub22of100,test4pub1of100,1,318,24,276,1288,1588
test4sub50of100,test4pub2of100,1,190,10,262,1282,1554
test4sub93of100,test4pub1of100,1,318,24,288,1315,1627
test4sub81of100,test4pub2of100,1,190,10,275,1309,1594
test4sub86of100,test4pub2of100,1,190,10,287,1298,1595
test4sub97of100,test4pub2of100,1,190,10,293,1292,1595
test4sub80of100,test4pub2of100,1,190,10,298,1290,1598
test4sub100of100,test4pub1of100,1,318,24,324,1323,1671
test4sub8of100,test4pub2of100,1,190,10,311,1317,1638
test4sub71of100,test4pub1of100,1,318,24,337,1350,1711
test4sub73of100,test4pub1of100,1,318,24,344,1384,1752
test4sub13of100,test4pub2of100,1,190,10,330,1378,1718
test4sub10of100,test4pub1of100,1,318,24,356,1413,1793
test4sub79of100,test4pub1of100,1,318,24,363,1448,1835
test4sub85of100,test4pub2of100,1,190,10,349,1443,1802
test4sub64of100,test4pub1of100,1,318,24,375,1476,1875
test4sub41of100,test4pub1of100,1,318,24,383,1508,1915
test4sub75of100,test4pub2of100,1,190,10,369,1503,1882
test4sub21of100,test4pub1of100,1,318,24,395,1536,1955
test4sub92of100,test4pub1of100,1,318,24,402,1569,1995
test4sub38of100,test4pub1of100,1,318,24,408,1603,2035
test4sub84of100,test4pub2of100,1,190,10,395,1597,2002
test4sub61of100,test4pub1of100,1,318,24,491,1560,2075
test4sub82of100,test4pub1of100,1,318,24,491,1600,2115
test4sub43of100,test4pub1of100,1,318,24,495,1636,2155
test4sub47of100,test4pub1of100,1,318,24,496,1675,2195
test4sub46of100,test4pub2of100,1,190,10,478,1674,2162
test4sub25of100,test4pub1of100,1,318,24,499,1712,2235
test4sub95of100,test4pub2of100,1,190,10,481,1711,2202
test4sub68of100,test4pub1of100,1,318,24,501,1750,2275
test4sub37of100,test4pub1of100,1,318,24,503,1788,2315
test4sub20of100,test4pub2of100,1,190,10,495,1777,2282
test4sub49of100,test4pub1of100,1,318,24,515,1817,2356
test4sub29of100,test4pub2of100,1,190,10,498,1815,2323
test4sub3of100,test4pub2of100,1,190,10,497,1816,2323
test4sub90of100,test4pub2of100,1,190,10,499,1816,2325
test4sub32of100,test4pub2of100,1,190,10,499,1816,2325
test4sub23of100,test4pub1of100,1,318,24,519,1856,2399
test4sub88of100,test4pub1of100,1,318,24,522,1893,2439
test4sub1of100,test4pub2of100,1,190,10,503,1893,2406
test4sub58of100,test4pub2of100,1,190,10,504,1894,2408
test4sub18of100,test4pub1of100,1,318,24,525,1930,2479
test4sub56of100,test4pub1of100,1,318,24,535,1960,2519
test4sub98of100,test4pub1of100,1,318,24,542,1993,2559
test4sub60of100,test4pub1of100,1,318,24,542,2033,2599
test4sub11of100,test4pub2of100,1,190,10,554,2002,2566
test4sub54of100,test4pub2of100,1,190,10,585,1973,2568
test4sub40of100,test4pub2of100,1,190,10,625,1934,2569
test4sub96of100,test4pub2of100,1,190,10,665,1896,2571
test4sub77of100,test4pub6of10,100,191,28,6270,1857,8155
test4sub59of100,test4pub9of10,100,191,27,5879,1857,7763
test4sub17of100,test4pub2of100,1,190,10,525,2039,2574
test4sub19of100,test4pub2of100,1,190,10,745,1821,2576
test4sub78of100,test4pub2of100,1,190,10,785,1781,2576
test4sub65of100,test4pub2of100,1,190,10,825,1744,2579
test4sub15of100,test4pub2of100,1,190,10,865,1706,2581
test4sub7of100,test4pub2of100,1,190,10,905,1668,2583
test4sub99of100,test4pub2of100,1,190,10,945,1628,2583
test4sub4of100,test4pub2of100,1,190,10,985,1591,2586
test4sub74of100,test4pub4of10,100,191,29,7662,1510,9201
test4sub53of100,test4pub7of10,100,191,29,6505,1472,8006
test4sub39of100,test4pub2of100,1,190,10,1132,1449,2591
test4sub27of100,test4pub2of100,1,190,10,1140,1443,2593
test4sub16of100,test4pub2of100,1,190,10,1143,1440,2593
test4sub2of100,test4pub2of100,1,190,10,1145,1440,2595
test4sub42of100,test4pub2of100,1,190,10,1185,1400,2595
test4sub91of100,test4pub2of100,1,190,10,1225,1362,2597
test4sub69of100,test4pub2of100,1,190,10,1265,1323,2598
test4sub33of100,test4pub2of100,1,190,10,1305,1285,2600
test4sub26of100,test4pub1of100,1,318,24,1353,1294,2671
test4sub76of100,test4pub2of100,1,190,10,1345,1283,2638
test4sub45of100,test4pub2of100,1,190,10,1385,1245,2640
test4sub87of100,test4pub2of100,1,190,10,1425,1206,2641
test4sub35of100,test4pub2of100,1,190,10,1465,1168,2643
test4sub63of100,test4pub2of100,1,190,10,1505,1128,2643
test4sub89of100,test4pub1of100,1,318,24,1525,1171,2720
test4sub22of100,test4pub2of100,1,190,10,1545,1131,2686
test4sub86of100,test4pub1of100,1,318,24,1605,1130,2759
test4sub97of100,test4pub1of100,1,318,24,1605,1170,2799
test4sub31of100,test4pub2of100,1,190,10,1588,1168,2766
test4sub55of100,test4pub1of100,1,318,24,1634,1181,2839
test4sub8of100,test4pub1of100,1,318,24,1649,1206,2879
test4sub28of100,test4pub2of100,1,190,10,1670,1166,2846
test4sub67of100,test4pub1of100,1,318,24,1707,1188,2919
test4sub73of100,test4pub2of100,1,190,10,1709,1167,2886
test4sub13of100,test4pub1of100,1,318,24,1729,1206,2959
test4sub12of100,test4pub2of100,1,190,10,1749,1167,2926
test4sub81of100,test4pub1of100,1,318,24,1769,1206,2999
test4sub10of100,test4pub2of100,1,190,10,1751,1205,2966
test4sub79of100,test4pub2of100,1,190,10,1793,1165,2968
test4sub85of100,test4pub1of100,1,318,24,1813,1203,3040
test4sub64of100,test4pub2of100,1,190,10,1833,1165,3008
test4sub41of100,test4pub2of100,1,190,10,1873,1127,3010
test4sub75of100,test4pub1of100,1,318,24,1893,1167,3084
test4sub21of100,test4pub2of100,1,190,10,1913,1127,3050
test4sub92of100,test4pub2of100,1,190,10,1953,1089,3052
test4sub84of100,test4pub1of100,1,318,24,2012,1087,3123
test4sub48of100,test4pub2of100,1,190,10,527,2553,3090
test4sub61of100,test4pub2of100,1,190,10,2033,1049,3092
test4sub82of100,test4pub2of100,1,190,10,2073,1009,3092
test4sub43of100,test4pub2of100,1,190,10,2113,971,3094
test4sub47of100,test4pub2of100,1,190,10,2153,932,3095
test4sub62of100,test4pub2of100,1,190,10,705,2382,3097
test4sub25of100,test4pub2of100,1,190,10,2193,894,3097
test4sub38of100,test4pub2of100,1,190,10,1993,1096,3099
test4sub68of100,test4pub2of100,1,190,10,2233,856,3099
test4sub20of100,test4pub1of100,1,318,24,2292,855,3171
test4sub49of100,test4pub2of100,1,190,10,2313,815,3138
test4sub3of100,test4pub1of100,1,318,24,2333,854,3211
test4sub90of100,test4pub1of100,1,318,24,2335,892,3251
test4sub32of100,test4pub4of100,1,190,11,1279,892,2182
test4sub29of100,test4pub1of100,1,318,24,2368,899,3291
test4sub23of100,test4pub2of100,1,190,10,2358,890,3258
test4sub46of100,test4pub1of100,1,318,24,2172,1135,3331
test4sub88of100,test4pub2of100,1,190,10,2397,891,3298
test4sub58of100,test4pub1of100,1,318,24,2418,929,3371
test4sub95of100,test4pub1of100,1,318,24,2212,1175,3411
test4sub18of100,test4pub2of100,1,190,10,2437,931,3378
test4sub56of100,test4pub2of100,1,190,10,2477,893,3380
test4sub60of100,test4pub2of100,1,190,10,2557,814,3381
test4sub16of100,test4pub3of100,1,190,14,2432,818,3264
test4sub39of100,test4pub4of100,1,190,11,1545,821,2377
test4sub53of100,test4pub8of10,100,191,21,7872,823,8716
test4sub4of100,test4pub3of100,1,190,14,2425,828,3267
test4sub74of100,test4pub5of10,100,191,34,8494,830,9358
test4sub99of100,test4pub3of100,1,190,14,2423,834,3271
test4sub15of100,test4pub3of100,1,190,14,2420,838,3272
test4sub7of100,test4pub3of100,1,190,14,2423,835,3272
test4sub71of100,test4pub2of100,1,190,10,2570,842,3422
test4sub19of100,test4pub4of100,1,190,11,1531,844,2386
test4sub78of100,test4pub3of100,1,190,14,2416,845,3275
test4sub17of100,test4pub3of100,1,190,14,2414,849,3277
test4sub59of100,test4pub10of10,100,192,24,7656,849,8529
test4sub77of100,test4pub7of10,100,191,29,7962,852,8843
test4sub96of100,test4pub4of100,1,190,11,1526,853,2390
test4sub40of100,test4pub3of100,1,190,14,2409,856,3279
test4sub54of100,test4pub4of100,1,190,11,1523,859,2393
test4sub27of100,test4pub1of100,1,318,24,2603,836,3463
test4sub11of100,test4pub4of100,1,190,11,1521,863,2395
test4sub42of100,test4pub4of100,1,190,11,1550,837,2398
test4sub2of100,test4pub3of100,1,190,14,2434,837,3285
test4sub69of100,test4pub3of100,1,190,14,2437,836,3287
test4sub91of100,test4pub4of100,1,190,11,1552,836,2399
test4sub33of100,test4pub3of100,1,190,14,2439,836,3289
test4sub26of100,test4pub2of100,1,190,10,2629,799,3438
test4sub76of100,test4pub3of100,1,190,14,2477,801,3292
test4sub87of100,test4pub4of100,1,190,11,1595,798,2404
test4sub45of100,test4pub3of100,1,190,14,2480,800,3294
test4sub63of100,test4pub3of100,1,190,14,2482,798,3294
test4sub35of100,test4pub3of100,1,190,14,2482,799,3295
test4sub89of100,test4pub4of100,1,190,11,1640,757,2408
test4sub22of100,test4pub3of100,1,190,14,2525,760,3299
test4sub86of100,test4pub4of100,1,190,11,1680,720,2411
test4sub31of100,test4pub1of100,1,318,24,2776,719,3519
test4sub97of100,test4pub3of100,1,190,14,2605,719,3338
test4sub30of100,test4pub1of100,1,318,24,1324,2211,3559
test4sub55of100,test4pub2of100,1,190,10,2797,719,3526
test4sub28of100,test4pub1of100,1,318,24,2856,719,3599
test4sub65of100,test4pub3of100,1,190,14,2418,986,3418
test4sub67of100,test4pub2of100,1,190,10,2877,681,3568
test4sub37of100,test4pub2of100,1,190,10,2273,1285,3568
test4sub12of100,test4pub1of100,1,318,24,2936,683,3643
test4sub13of100,test4pub4of100,1,190,11,1880,682,2573
test4sub10of100,test4pub4of100,1,190,11,1920,645,2576
test4sub79of100,test4pub4of100,1,190,11,1922,644,2577
test4sub85of100,test4pub3of100,1,190,14,2845,608,3467
test4sub64of100,test4pub3of100,1,190,14,2847,606,3467
test4sub41of100,test4pub3of100,1,190,14,2850,605,3469
test4sub75of100,test4pub3of100,1,190,14,2889,567,3470
test4sub21of100,test4pub3of100,1,190,14,2890,569,3473
test4sub92of100,test4pub4of100,1,190,11,2007,567,2585
test4sub8of100,test4pub3of100,1,190,14,2685,776,3475
test4sub84of100,test4pub4of100,1,190,11,2044,532,2587
test4sub82of100,test4pub4of100,1,190,11,2047,532,2590
test4sub61of100,test4pub3of100,1,190,14,2931,532,3477
test4sub43of100,test4pub4of100,1,190,11,2049,531,2591
test4sub47of100,test4pub3of100,1,190,14,2934,531,3479
test4sub73of100,test4pub3of100,1,190,14,2725,743,3482
test4sub62of100,test4pub3of100,1,190,14,2936,532,3482
test4sub68of100,test4pub4of100,1,190,11,2054,532,2597
test4sub38of100,test4pub3of100,1,190,14,2938,533,3485
test4sub49of100,test4pub4of100,1,190,11,2092,496,2599
test4sub20of100,test4pub3of100,1,190,14,2977,496,3487
test4sub81of100,test4pub3of100,1,190,14,2805,674,3493
test4sub3of100,test4pub4of100,1,190,11,2132,462,2605
test4sub32of100,test4pub3of100,1,190,14,3057,425,3496
test4sub29of100,test4pub4of100,1,190,11,2212,385,2608
test4sub23of100,test4pub3of100,1,190,14,3097,387,3498
test4sub88of100,test4pub3of100,1,190,14,3137,347,3498
test4sub46of100,test4pub4of100,1,190,11,2252,349,2612
test4sub58of100,test4pub3of100,1,190,14,3177,310,3501
test4sub95of100,test4pub3of100,1,190,14,3217,272,3503
test4sub18of100,test4pub4of100,1,190,11,2333,273,2617
test4sub56of100,test4pub3of100,1,190,14,3220,244,3478
test4sub60of100,test4pub4of100,1,190,11,2364,244,2619
test4sub16of100,test4pub5of100,1,190,32,2314,245,2591
test4sub39of100,test4pub3of100,1,190,14,3253,244,3511
test4sub53of100,test4pub9of10,100,191,27,8578,244,8849
test4sub4of100,test4pub4of100,1,190,11,2370,245,2626
test4sub74of100,test4pub6of10,100,191,28,8973,245,9246
test4sub99of100,test4pub4of100,1,190,11,2373,243,2627
test4sub15of100,test4pub4of100,1,190,11,2375,243,2629
test4sub7of100,test4pub4of100,1,190,11,2375,244,2630
test4sub71of100,test4pub3of100,1,190,14,3261,245,3520
test4sub78of100,test4pub4of100,1,190,11,2377,245,2633
test4sub59of100,test4pub1of100,1,318,24,3434,284,3742
test4sub77of100,test4pub8of10,100,191,21,8706,284,9011
test4sub19of100,test4pub3of100,1,190,14,3261,285,3560
test4sub96of100,test4pub5of100,1,190,32,2329,284,2645
test4sub40of100,test4pub4of100,1,190,11,2381,286,2678
test4sub17of100,test4pub4of100,1,190,11,2378,285,2674
test4sub54of100,test4pub3of100,1,190,14,3268,287,3569
test4sub27of100,test4pub4of100,1,190,11,2385,288,2684
test4sub11of100,test4pub3of100,1,190,14,3270,291,3575
test4sub42of100,test4pub3of100,1,190,14,3272,290,3576
test4sub2of100,test4pub4of100,1,190,11,2388,292,2691
test4sub91of100,test4pub3of100,1,190,14,3275,290,3579
test4sub69of100,test4pub4of100,1,190,11,2389,292,2692
test4sub33of100,test4pub4of100,1,190,11,2392,290,2693
test4sub26of100,test4pub3of100,1,190,14,3277,292,3583
test4sub76of100,test4pub4of100,1,190,11,2394,290,2695
test4sub87of100,test4pub3of100,1,190,14,3279,295,3588
test4sub63of100,test4pub4of100,1,190,11,2397,294,2702
test4sub45of100,test4pub4of100,1,190,11,2396,296,2703
test4sub35of100,test4pub4of100,1,190,11,2399,293,2703
test4sub89of100,test4pub3of100,1,190,14,3284,295,3593
test4sub86of100,test4pub3of100,1,190,14,3286,294,3594
test4sub22of100,test4pub4of100,1,190,11,2401,296,2708
test4sub97of100,test4pub4of100,1,190,11,2440,257,2708
test4sub31of100,test4pub4of100,1,190,11,2440,259,2710
test4sub55of100,test4pub3of100,1,190,14,3365,220,3599
test4sub30of100,test4pub3of100,1,190,14,3365,222,3601
test4sub44of100,test4pub2of100,1,190,10,529,3211,3750
test4sub65of100,test4pub4of100,1,190,11,2520,185,2716
test4sub67of100,test4pub4of100,1,190,11,2522,183,2716
test4sub37of100,test4pub3of100,1,190,14,3408,185,3607
test4sub34of100,test4pub2of100,1,190,10,557,3187,3754
test4sub13of100,test4pub3of100,1,190,14,3449,145,3608
test4sub12of100,test4pub4of100,1,190,11,2564,144,2719
test4sub10of100,test4pub3of100,1,190,14,3451,144,3609
test4sub85of100,test4pub4of100,1,190,11,2569,143,2723
test4sub64of100,test4pub4of100,1,190,11,2570,145,2726
test4sub41of100,test4pub4of100,1,190,11,2572,142,2725
test4sub75of100,test4pub4of100,1,190,11,2572,144,2727
test4sub21of100,test4pub4of100,1,190,11,2575,144,2730
test4sub92of100,test4pub3of100,1,190,14,3460,146,3620
test4sub8of100,test4pub4of100,1,190,11,2577,144,2732
test4sub84of100,test4pub5of100,1,190,32,2525,148,2705
test4sub82of100,test4pub5of100,1,190,32,2527,146,2705
test4sub61of100,test4pub4of100,1,190,11,2580,149,2740
test4sub43of100,test4pub5of100,1,190,32,2530,147,2709
test4sub47of100,test4pub4of100,1,190,11,2582,148,2741
test4sub62of100,test4pub4of100,1,190,11,2584,147,2742
test4sub73of100,test4pub4of100,1,190,11,2584,149,2744
test4sub68of100,test4pub3of100,1,190,14,3471,147,3632
test4sub38of100,test4pub5of100,1,190,32,2535,148,2715
test4sub49of100,test4pub3of100,1,190,14,3474,146,3634
test4sub20of100,test4pub5of100,1,190,32,2538,147,2717
test4sub81of100,test4pub4of100,1,190,11,2596,141,2748
test4sub3of100,test4pub3of100,1,190,14,3481,143,3638
test4sub32of100,test4pub5of100,1,190,32,2546,142,2720
test4sub29of100,test4pub3of100,1,190,14,3483,144,3641
test4sub88of100,test4pub4of100,1,190,11,2601,142,2754
test4sub23of100,test4pub4of100,1,190,11,2600,144,2755
test4sub46of100,test4pub3of100,1,190,14,3488,141,3643
test4sub58of100,test4pub4of100,1,190,11,2603,143,2757
test4sub95of100,test4pub4of100,1,190,11,2606,141,2758
test4sub18of100,test4pub3of100,1,190,14,3491,142,3647
test4sub56of100,test4pub5of100,1,190,32,2557,140,2729
test4sub60of100,test4pub3of100,1,190,14,3495,141,3650
test4sub39of100,test4pub5of100,1,190,32,2560,140,2732
test4sub16of100,test4pub4of100,1,190,11,2612,142,2765
test4sub53of100,test4pub10of10,100,192,24,8743,139,8906
test4sub4of100,test4pub5of100,1,190,32,2563,141,2736
test4sub74of100,test4pub7of10,100,191,29,9053,139,9221
test4sub99of100,test4pub5of100,1,190,32,2565,141,2738
test4sub15of100,test4pub5of100,1,190,32,2568,141,2741
test4sub7of100,test4pub5of100,1,190,32,2569,143,2744
test4sub71of100,test4pub4of100,1,190,11,2623,143,2777
test4sub78of100,test4pub6of100,1,190,14,2497,148,2659
test4sub77of100,test4pub9of10,100,191,27,8873,107,9007
test4sub59of100,test4pub2of100,1,190,10,3701,110,3821
test4sub96of100,test4pub3of100,1,190,14,3552,108,3674
test4sub19of100,test4pub6of100,1,190,14,2540,110,2664
test4sub17of100,test4pub5of100,1,190,32,2617,107,2756
test4sub40of100,test4pub5of100,1,190,32,2617,109,2758
test4sub54of100,test4pub5of100,1,190,32,2619,107,2758
test4sub27of100,test4pub5of100,1,190,32,2623,105,2760
test4sub42of100,test4pub5of100,1,190,32,2626,103,2761
test4sub11of100,test4pub5of100,1,190,32,2626,105,2763
test4sub2of100,test4pub5of100,1,190,32,2628,103,2763
test4sub91of100,test4pub5of100,1,190,32,2629,105,2766
test4sub69of100,test4pub5of100,1,190,32,2631,102,2765
test4sub33of100,test4pub5of100,1,190,32,2631,104,2767
test4sub26of100,test4pub4of100,1,190,11,2686,101,2798
test4sub76of100,test4pub5of100,1,190,32,2634,103,2769
test4sub63of100,test4pub5of100,1,190,32,2639,99,2770
test4sub87of100,test4pub5of100,1,190,32,2639,101,2772
test4sub45of100,test4pub5of100,1,190,32,2641,99,2772
test4sub35of100,test4pub5of100,1,190,32,2642,101,2775
test4sub86of100,test4pub5of100,1,190,32,2644,98,2774
test4sub89of100,test4pub6of100,1,190,14,2570,100,2684
test4sub22of100,test4pub5of100,1,190,32,2646,97,2775
test4sub97of100,test4pub5of100,1,190,32,2647,100,2779
test4sub55of100,test4pub4of100,1,190,11,2701,101,2813
test4sub31of100,test4pub3of100,1,190,14,3586,104,3704
test4sub44of100,test4pub3of100,1,190,14,3589,103,3706
test4sub30of100,test4pub4of100,1,190,11,2704,104,2819
test4sub67of100,test4pub3of100,1,190,14,3591,104,3709
test4sub65of100,test4pub5of100,1,190,32,2654,104,2790
test4sub34of100,test4pub3of100,1,190,14,3594,104,3712
test4sub37of100,test4pub4of100,1,190,11,2708,105,2824
test4sub12of100,test4pub3of100,1,190,14,3596,104,3714
test4sub13of100,test4pub5of100,1,190,32,2659,104,2795
test4sub85of100,test4pub5of100,1,190,32,2661,104,2797
test4sub10of100,test4pub5of100,1,190,32,2661,104,2797
test4sub41of100,test4pub5of100,1,190,32,2663,104,2799
test4sub64of100,test4pub6of100,1,190,14,2589,104,2707
test4sub75of100,test4pub5of100,1,190,32,2666,103,2801
test4sub21of100,test4pub6of100,1,190,14,2594,102,2710
test4sub92of100,test4pub5of100,1,190,32,2670,102,2804
test4sub8of100,test4pub5of100,1,190,32,2671,101,2804
test4sub84of100,test4pub3of100,1,190,14,3611,100,3725
test4sub82of100,test4pub3of100,1,190,14,3612,99,3725
test4sub61of100,test4pub5of100,1,190,32,2677,99,2808
test4sub43of100,test4pub3of100,1,190,14,3615,99,3728
test4sub62of100,test4pub5of100,1,190,32,2680,99,2811
test4sub47of100,test4pub5of100,1,190,32,2680,99,2811
test4sub73of100,test4pub5of100,1,190,32,2682,99,2813
test4sub68of100,test4pub6of100,1,190,14,2608,99,2721
test4sub49of100,test4pub5of100,1,190,32,2685,99,2816
test4sub38of100,test4pub4of100,1,190,11,2736,99,2846
test4sub20of100,test4pub4of100,1,190,11,2739,98,2848
test4sub81of100,test4pub5of100,1,190,32,2687,99,2818
test4sub32of100,test4pub6of100,1,190,14,2615,99,2728
test4sub3of100,test4pub5of100,1,190,32,2689,99,2820
test4sub88of100,test4pub5of100,1,190,32,2691,99,2822
test4sub29of100,test4pub5of100,1,190,32,2691,99,2822
test4sub23of100,test4pub5of100,1,190,32,2693,99,2824
test4sub46of100,test4pub5of100,1,190,32,2694,100,2826
test4sub58of100,test4pub5of100,1,190,32,2696,99,2827
test4sub95of100,test4pub5of100,1,190,32,2696,99,2827
test4sub18of100,test4pub5of100,1,190,32,2698,99,2829
test4sub56of100,test4pub4of100,1,190,11,2750,99,2860
test4sub60of100,test4pub6of100,1,190,14,2627,98,2739
test4sub39of100,test4pub6of100,1,190,14,2627,98,2739
test4sub16of100,test4pub6of100,1,190,14,2629,98,2741
test4sub53of100,test4pub1of100,1,318,24,3811,136,3971
test4sub4of100,test4pub6of100,1,190,14,2631,134,2779
test4sub74of100,test4pub8of10,100,191,21,9084,135,9240
test4sub99of100,test4pub6of100,1,190,14,2634,133,2781
test4sub15of100,test4pub6of100,1,190,14,2636,133,2783
test4sub7of100,test4pub6of100,1,190,14,2639,131,2784
test4sub71of100,test4pub5of100,1,190,32,2715,131,2878
test4sub77of100,test4pub10of10,100,192,24,8901,125,9050
test4sub78of100,test4pub5of100,1,190,32,2721,127,2880
test4sub96of100,test4pub6of100,1,190,14,2649,126,2789
test4sub59of100,test4pub4of100,1,190,11,2775,128,2914
test4sub17of100,test4pub6of100,1,190,14,2651,126,2791
test4sub19of100,test4pub5of100,1,190,32,2725,128,2885
test4sub40of100,test4pub6of100,1,190,14,2653,126,2793
test4sub54of100,test4pub6of100,1,190,14,2654,128,2796
test4sub27of100,test4pub3of100,1,190,14,3667,125,3806
test4sub42of100,test4pub6of100,1,190,14,2656,127,2797
test4sub2of100,test4pub6of100,1,190,14,2658,126,2798
test4sub11of100,test4pub6of100,1,190,14,2658,128,2800
test4sub91of100,test4pub6of100,1,190,14,2660,126,2800
test4sub69of100,test4pub6of100,1,190,14,2661,128,2803
test4sub26of100,test4pub5of100,1,190,32,2737,125,2894
test4sub33of100,test4pub6of100,1,190,14,2663,128,2805
test4sub76of100,test4pub6of100,1,190,14,2665,128,2807
test4sub63of100,test4pub6of100,1,190,14,2665,128,2807
test4sub87of100,test4pub6of100,1,190,14,2667,128,2809
test4sub45of100,test4pub6of100,1,190,14,2667,129,2810
test4sub35of100,test4pub6of100,1,190,14,2669,129,2812
test4sub86of100,test4pub6of100,1,190,14,2670,129,2813
test4sub89of100,test4pub5of100,1,190,32,2746,129,2907
test4sub22of100,test4pub6of100,1,190,14,2672,128,2814
test4sub97of100,test4pub6of100,1,190,14,2674,128,2816
test4sub55of100,test4pub5of100,1,190,32,2752,125,2909
test4sub31of100,test4pub5of100,1,190,32,2754,125,2911
test4sub44of100,test4pub4of100,1,190,11,2809,122,2942
test4sub30of100,test4pub6of100,1,190,14,2684,124,2822
test4sub67of100,test4pub5of100,1,190,32,2760,122,2914
test4sub65of100,test4pub6of100,1,190,14,2686,124,2824
test4sub34of100,test4pub4of100,1,190,11,2814,121,2946
test4sub37of100,test4pub5of100,1,190,32,2762,124,2918
test4sub13of100,test4pub6of100,1,190,14,2690,122,2826
test4sub12of100,test4pub5of100,1,190,32,2764,124,2920
test4sub85of100,test4pub6of100,1,190,14,2692,123,2829
test4sub10of100,test4pub6of100,1,190,14,2693,125,2832
test4sub41of100,test4pub6of100,1,190,14,2694,123,2831
test4sub64of100,test4pub5of100,1,190,32,2769,125,2926
test4sub75of100,test4pub6of100,1,190,14,2697,123,2834
test4sub21of100,test4pub5of100,1,190,32,2771,125,2928
test4sub8of100,test4pub6of100,1,190,14,2699,123,2836
test4sub92of100,test4pub6of100,1,190,14,2699,125,2838
test4sub84of100,test4pub6of100,1,190,14,2701,124,2839
test4sub82of100,test4pub6of100,1,190,14,2702,126,2842
test4sub43of100,test4pub6of100,1,190,14,2704,124,2842
test4sub61of100,test4pub6of100,1,190,14,2703,126,2843
test4sub57of100,test4pub2of100,1,190,10,861,3131,4002
test4sub47of100,test4pub6of100,1,190,14,2706,126,2846
test4sub73of100,test4pub6of100,1,190,14,2708,124,2846
test4sub68of100,test4pub5of100,1,190,32,2782,127,2941
test4sub38of100,test4pub6of100,1,190,14,2711,125,2850
test4sub49of100,test4pub6of100,1,190,14,2710,127,2851
test4sub81of100,test4pub6of100,1,190,14,2713,125,2852
test4sub20of100,test4pub6of100,1,190,14,2713,127,2854
test4sub32of100,test4pub7of100,1,190,18,2578,125,2721
test4sub3of100,test4pub6of100,1,190,14,2715,127,2856
test4sub88of100,test4pub6of100,1,190,14,2717,125,2856
test4sub29of100,test4pub6of100,1,190,14,2718,127,2859
test4sub23of100,test4pub6of100,1,190,14,2720,125,2859
test4sub46of100,test4pub6of100,1,190,14,2720,126,2860
test4sub95of100,test4pub6of100,1,190,14,2722,125,2861
test4sub58of100,test4pub6of100,1,190,14,2722,127,2863
test4sub56of100,test4pub6of100,1,190,14,2725,125,2864
test4sub18of100,test4pub6of100,1,190,14,2724,127,2865
test4sub39of100,test4pub7of100,1,190,18,2590,126,2734
test4sub60of100,test4pub5of100,1,190,32,2801,128,2961
test4sub16of100,test4pub7of100,1,190,18,2592,125,2735
test4sub4of100,test4pub7of100,1,190,18,2629,90,2737
test4sub53of100,test4pub2of100,1,190,10,3929,90,4029
test4sub74of100,test4pub9of10,100,191,27,9103,90,9220
test4sub99of100,test4pub7of100,1,190,18,2632,91,2741
test4sub7of100,test4pub7of100,1,190,18,2634,89,2741
test4sub15of100,test4pub7of100,1,190,18,2634,90,2742
test4sub77of100,test4pub1of100,1,318,24,3956,128,4108
test4sub71of100,test4pub6of100,1,190,14,2773,128,2915
test4sub78of100,test4pub7of100,1,190,18,2639,127,2784
test4sub96of100,test4pub7of100,1,190,18,2639,127,2784
test4sub17of100,test4pub7of100,1,190,18,2641,128,2787
test4sub59of100,test4pub3of100,1,190,14,3789,128,3931
test4sub40of100,test4pub7of100,1,190,18,2644,128,2790
test4sub19of100,test4pub7of100,1,190,18,2643,129,2790
test4sub27of100,test4pub6of100,1,190,14,2783,128,2925
test4sub54of100,test4pub7of100,1,190,18,2646,128,2792
test4sub2of100,test4pub7of100,1,190,18,2648,128,2794
test4sub42of100,test4pub7of100,1,190,18,2648,129,2795
test4sub91of100,test4pub7of100,1,190,18,2650,129,2797
test4sub11of100,test4pub7of100,1,190,18,2650,129,2797
test4sub26of100,test4pub6of100,1,190,14,2790,128,2932
test4sub69of100,test4pub7of100,1,190,18,2653,129,2800
test4sub33of100,test4pub7of100,1,190,18,2655,129,2802
test4sub63of100,test4pub7of100,1,190,18,2658,127,2803
test4sub76of100,test4pub7of100,1,190,18,2657,128,2803
test4sub87of100,test4pub7of100,1,190,18,2660,126,2804
test4sub45of100,test4pub7of100,1,190,18,2660,128,2806
test4sub35of100,test4pub7of100,1,190,18,2662,127,2807
test4sub86of100,test4pub7of100,1,190,18,2662,129,2809
test4sub89of100,test4pub7of100,1,190,18,2664,127,2809
test4sub22of100,test4pub7of100,1,190,18,2665,129,2812
test4sub97of100,test4pub7of100,1,190,18,2667,127,2812
test4sub55of100,test4pub6of100,1,190,14,2804,129,2947
test4sub31of100,test4pub6of100,1,190,14,2806,127,2947
test4sub44of100,test4pub5of100,1,190,32,2880,129,3041
test4sub67of100,test4pub6of100,1,190,14,2809,128,2951
test4sub30of100,test4pub5of100,1,190,32,2882,133,3047
test4sub65of100,test4pub7of100,1,190,18,2674,133,2825
test4sub34of100,test4pub6of100,1,190,14,2811,136,2961
test4sub37of100,test4pub6of100,1,190,14,2813,137,2964
test4sub13of100,test4pub7of100,1,190,18,2677,137,2832
test4sub12of100,test4pub6of100,1,190,14,2816,136,2966
test4sub85of100,test4pub7of100,1,190,18,2679,137,2834
test4sub41of100,test4pub7of100,1,190,18,2682,137,2837
test4sub10of100,test4pub7of100,1,190,18,2681,137,2836
test4sub75of100,test4pub7of100,1,190,18,2684,136,2838
test4sub64of100,test4pub7of100,1,190,18,2684,137,2839
test4sub21of100,test4pub7of100,1,190,18,2686,137,2841
test4sub8of100,test4pub7of100,1,190,18,2687,138,2843
test4sub92of100,test4pub7of100,1,190,18,2689,137,2844
test4sub84of100,test4pub7of100,1,190,18,2689,137,2844
test4sub82of100,test4pub7of100,1,190,18,2691,137,2846
test4sub43of100,test4pub7of100,1,190,18,2691,137,2846
test4sub61of100,test4pub7of100,1,190,18,2693,138,2849
test4sub57of100,test4pub1of100,1,318,24,4013,174,4211
test4sub47of100,test4pub7of100,1,190,18,2696,172,2886
test4sub73of100,test4pub7of100,1,190,18,2697,173,2888
test4sub68of100,test4pub7of100,1,190,18,2699,172,2889
test4sub38of100,test4pub7of100,1,190,18,2699,173,2890
test4sub49of100,test4pub7of100,1,190,18,2702,171,2891
test4sub81of100,test4pub7of100,1,190,18,2702,173,2893
test4sub20of100,test4pub7of100,1,190,18,2704,171,2893
test4sub32of100,test4pub8of100,1,190,16,2557,173,2746
test4sub3of100,test4pub7of100,1,190,18,2706,171,2895
test4sub88of100,test4pub7of100,1,190,18,2707,174,2899
test4sub23of100,test4pub7of100,1,190,18,2709,171,2898
test4sub29of100,test4pub7of100,1,190,18,2709,173,2900
test4sub46of100,test4pub7of100,1,190,18,2711,171,2900
test4sub95of100,test4pub7of100,1,190,18,2711,173,2902
test4sub58of100,test4pub7of100,1,190,18,2713,171,2902
test4sub56of100,test4pub7of100,1,190,18,2714,173,2905
test4sub39of100,test4pub8of100,1,190,16,2568,171,2755
test4sub18of100,test4pub7of100,1,190,18,2716,173,2907
test4sub16of100,test4pub8of100,1,190,16,2570,171,2757
test4sub60of100,test4pub7of100,1,190,18,2718,173,2909
test4sub53of100,test4pub3of100,1,190,14,3869,171,4054
test4sub4of100,test4pub8of100,1,190,16,2572,173,2761
test4sub74of100,test4pub10of10,100,192,24,9114,171,9309
test4sub99of100,test4pub8of100,1,190,16,2575,173,2764
test4sub7of100,test4pub8of100,1,190,16,2577,171,2764
test4sub15of100,test4pub8of100,1,190,16,2577,173,2766
test4sub71of100,test4pub7of100,1,190,18,2765,133,2916
test4sub77of100,test4pub2of100,1,190,10,4065,135,4210
test4sub78of100,test4pub8of100,1,190,16,2620,134,2770
test4sub96of100,test4pub8of100,1,190,16,2620,134,2770
test4sub17of100,test4pub8of100,1,190,16,2622,135,2773
test4sub59of100,test4pub5of100,1,190,32,2981,135,3148
test4sub40of100,test4pub8of100,1,190,16,2625,134,2775
test4sub19of100,test4pub8of100,1,190,16,2625,134,2775
test4sub27of100,test4pub7of100,1,190,18,2775,134,2927
test4sub54of100,test4pub8of100,1,190,16,2627,135,2778
test4sub42of100,test4pub8of100,1,190,16,2630,134,2780
test4sub2of100,test4pub8of100,1,190,16,2630,134,2780
test4sub11of100,test4pub8of100,1,190,16,2632,134,2782
test4sub91of100,test4pub8of100,1,190,16,2632,135,2783
test4sub69of100,test4pub8of100,1,190,16,2635,134,2785
test4sub26of100,test4pub7of100,1,190,18,2783,134,2935
test4sub63of100,test4pub8of100,1,190,16,2637,134,2787
test4sub33of100,test4pub8of100,1,190,16,2637,135,2788
test4sub87of100,test4pub8of100,1,190,16,2640,137,2793
test4sub76of100,test4pub8of100,1,190,16,2640,140,2796
test4sub45of100,test4pub8of100,1,190,16,2642,138,2796
test4sub35of100,test4pub8of100,1,190,16,2642,140,2798
test4sub86of100,test4pub8of100,1,190,16,2644,139,2799
test4sub89of100,test4pub8of100,1,190,16,2645,141,2802
test4sub22of100,test4pub8of100,1,190,16,2647,138,2801
test4sub90of100,test4pub4of100,1,190,11,2172,1435,3618
test4sub86of100,test4pub9of100,1,190,13,2679,415,3107
test4sub35of100,test4pub9of100,1,190,13,2679,416,3108
test4sub76of100,test4pub9of100,1,190,13,2676,421,3110
test4sub45of100,test4pub9of100,1,190,13,2677,422,3112
test4sub33of100,test4pub9of100,1,190,13,2673,427,3113
test4sub63of100,test4pub9of100,1,190,13,2668,433,3114
test4sub70of100,test4pub2of100,1,190,10,1214,3441,4665
test4sub11of100,test4pub9of100,1,190,13,2663,439,3115
test4sub91of100,test4pub9of100,1,190,13,2663,440,3116
test4sub42of100,test4pub9of100,1,190,13,2660,444,3117
test4sub2of100,test4pub9of100,1,190,13,2661,445,3119
test4sub27of100,test4pub8of100,1,190,16,2763,448,3227
test4sub40of100,test4pub9of100,1,190,13,2655,451,3119
test4sub26of100,test4pub8of100,1,190,16,2771,437,3224
test4sub19of100,test4pub9of100,1,190,13,2656,453,3122
test4sub59of100,test4pub6of100,1,190,14,3043,455,3512
test4sub69of100,test4pub9of100,1,190,13,2665,437,3115
test4sub17of100,test4pub9of100,1,190,13,2653,456,3122
test4sub96of100,test4pub9of100,1,190,13,2651,458,3122
test4sub78of100,test4pub9of100,1,190,13,2649,462,3124
test4sub77of100,test4pub4of100,1,190,11,3165,462,3638
test4sub71of100,test4pub8of100,1,190,16,2752,466,3234
test4sub15of100,test4pub9of100,1,190,13,2646,468,3127
test4sub99of100,test4pub9of100,1,190,13,2644,471,3128
test4sub7of100,test4pub9of100,1,190,13,2644,471,3128
test4sub54of100,test4pub9of100,1,190,13,2658,448,3119
test4sub74of100,test4pub1of100,1,318,24,4214,475,4713
test4sub4of100,test4pub9of100,1,190,13,2642,476,3131
test4sub53of100,test4pub4of100,1,190,11,3156,480,3647
test4sub16of100,test4pub9of100,1,190,13,2637,483,3133
test4sub18of100,test4pub8of100,1,190,16,2742,484,3242
test4sub34of100,test4pub5of100,1,190,32,3023,565,3620
test4sub56of100,test4pub8of100,1,190,16,2740,487,3243
test4sub65of100,test4pub8of100,1,190,16,2661,569,3246
test4sub39of100,test4pub9of100,1,190,13,2635,487,3135
test4sub30of100,test4pub7of100,1,190,18,2806,573,3397
test4sub67of100,test4pub7of100,1,190,18,2800,575,3393
test4sub44of100,test4pub6of100,1,190,14,2937,580,3531
test4sub55of100,test4pub7of100,1,190,18,2797,584,3399
test4sub31of100,test4pub7of100,1,190,18,2798,585,3401
test4sub97of100,test4pub8of100,1,190,16,2647,587,3250
test4sub60of100,test4pub8of100,1,190,16,2744,479,3239
test4sub95of100,test4pub8of100,1,190,16,2738,490,3244
test4sub29of100,test4pub8of100,1,190,16,2735,492,3243
test4sub13of100,test4pub8of100,1,190,16,2666,563,3245
test4sub37of100,test4pub7of100,1,190,18,2814,563,3395
test4sub12of100,test4pub7of100,1,190,18,2817,560,3395
test4sub85of100,test4pub8of100,1,190,16,2669,560,3245
test4sub10of100,test4pub8of100,1,190,16,2671,558,3245
test4sub41of100,test4pub8of100,1,190,16,2671,558,3245
test4sub75of100,test4pub8of100,1,190,16,2674,555,3245
test4sub64of100,test4pub8of100,1,190,16,2674,554,3244
test4sub8of100,test4pub8of100,1,190,16,2677,551,3244
test4sub21of100,test4pub8of100,1,190,16,2677,551,3244
test4sub92of100,test4pub8of100,1,190,16,2679,549,3244
test4sub84of100,test4pub8of100,1,190,16,2679,549,3244
test4sub82of100,test4pub8of100,1,190,16,2682,547,3245
test4sub43of100,test4pub8of100,1,190,16,2682,546,3244
test4sub83of100,test4pub1of100,1,318,24,1396,3320,4740
test4sub61of100,test4pub8of100,1,190,16,2684,544,3244
test4sub52of100,test4pub2of100,1,190,10,4159,517,4686
test4sub5of100,test4pub2of100,1,190,10,1509,3190,4709
test4sub57of100,test4pub4of100,1,190,11,3132,507,3650
test4sub73of100,test4pub8of100,1,190,16,2723,505,3244
test4sub68of100,test4pub8of100,1,190,16,2724,504,3244
test4sub38of100,test4pub8of100,1,190,16,2726,502,3244
test4sub49of100,test4pub8of100,1,190,16,2726,502,3244
test4sub81of100,test4pub8of100,1,190,16,2728,500,3244
test4sub20of100,test4pub8of100,1,190,16,2729,500,3245
test4sub3of100,test4pub8of100,1,190,16,2731,497,3244
test4sub32of100,test4pub9of100,1,190,13,2626,497,3136
test4sub23of100,test4pub8of100,1,190,16,2733,495,3244
test4sub88of100,test4pub8of100,1,190,16,2733,495,3244
test4sub46of100,test4pub8of100,1,190,16,2736,493,3245
test4sub58of100,test4pub8of100,1,190,16,2738,490,3244
test4sub14of100,test4pub2of100,1,190,10,1426,3273,4709
test4sub36of100,test4pub1of100,1,318,24,1550,3208,4782
test4sub24of100,test4pub1of100,1,318,24,1553,3246,4823
test4sub89of100,test4pub9of100,1,190,13,3087,140,3240
test4sub22of100,test4pub9of100,1,190,13,3082,147,3242
test4sub90of100,test4pub3of100,1,190,14,4494,137,4645
test4sub72of100,test4pub2of100,1,190,10,4647,138,4795
test4sub86of100,test4pub10of100,1,191,16,2970,137,3123
test4sub35of100,test4pub10of100,1,191,16,2972,138,3126
test4sub76of100,test4pub10of100,1,191,16,2973,136,3125
test4sub45of100,test4pub10of100,1,191,16,2975,137,3128
test4sub33of100,test4pub10of100,1,191,16,2976,135,3127
test4sub63of100,test4pub10of100,1,191,16,2977,136,3129
test4sub70of100,test4pub4of100,1,190,11,3620,136,3767
test4sub91of100,test4pub10of100,1,191,16,2979,137,3132
test4sub42of100,test4pub10of100,1,191,16,2980,136,3132
test4sub2of100,test4pub10of100,1,191,16,2982,136,3134
test4sub40of100,test4pub10of100,1,191,16,2983,136,3135
test4sub26of100,test4pub9of100,1,190,13,3109,136,3258
test4sub59of100,test4pub7of100,1,190,18,3362,136,3516
test4sub69of100,test4pub10of100,1,191,16,2985,137,3138
test4sub96of100,test4pub10of100,1,191,16,2986,138,3140
test4sub78of100,test4pub10of100,1,191,16,2987,138,3141
test4sub77of100,test4pub5of100,1,190,32,3577,137,3746
test4sub19of100,test4pub10of100,1,191,16,2984,139,3139
test4sub71of100,test4pub9of100,1,190,13,3114,139,3266
test4sub27of100,test4pub9of100,1,190,13,3107,141,3261
test4sub15of100,test4pub10of100,1,191,16,2990,140,3146
test4sub99of100,test4pub10of100,1,191,16,2991,141,3148
test4sub7of100,test4pub10of100,1,191,16,2992,141,3149
test4sub54of100,test4pub10of100,1,191,16,2992,142,3150
test4sub74of100,test4pub2of100,1,190,10,4671,142,4823
test4sub11of100,test4pub10of100,1,191,16,2979,144,3139
test4sub17of100,test4pub10of100,1,191,16,2985,143,3144
test4sub53of100,test4pub6of100,1,190,14,3510,144,3668
test4sub16of100,test4pub10of100,1,191,16,2996,144,3156
test4sub56of100,test4pub9of100,1,190,13,3126,141,3280
test4sub65of100,test4pub9of100,1,190,13,3126,141,3280
test4sub30of100,test4pub8of100,1,190,16,3232,142,3390
test4sub44of100,test4pub7of100,1,190,18,3381,141,3540
test4sub55of100,test4pub8of100,1,190,16,3234,142,3392
test4sub4of100,test4pub10of100,1,191,16,2994,142,3152
test4sub97of100,test4pub9of100,1,190,13,3131,144,3288
test4sub60of100,test4pub9of100,1,190,13,3132,142,3287
test4sub95of100,test4pub9of100,1,190,13,3132,144,3289
test4sub18of100,test4pub9of100,1,190,13,3125,144,3282
test4sub34of100,test4pub7of100,1,190,18,3378,145,3541
test4sub29of100,test4pub9of100,1,190,13,3133,146,3292
test4sub31of100,test4pub8of100,1,190,16,3235,147,3398
test4sub67of100,test4pub8of100,1,190,16,3233,147,3396
test4sub39of100,test4pub10of100,1,191,16,3002,149,3167
test4sub12of100,test4pub8of100,1,190,16,3242,148,3406
test4sub85of100,test4pub9of100,1,190,13,3138,150,3301
test4sub10of100,test4pub9of100,1,190,13,3139,148,3300
test4sub75of100,test4pub9of100,1,190,13,3139,150,3302
test4sub64of100,test4pub9of100,1,190,13,3141,148,3302
test4sub21of100,test4pub9of100,1,190,13,3141,150,3304
test4sub92of100,test4pub9of100,1,190,13,3142,149,3304
test4sub84of100,test4pub9of100,1,190,13,3143,150,3306
test4sub82of100,test4pub9of100,1,190,13,3144,150,3307
test4sub83of100,test4pub2of100,1,190,10,4698,151,4859
test4sub61of100,test4pub9of100,1,190,13,3146,151,3310
test4sub5of100,test4pub3of100,1,190,14,4548,151,4713
test4sub52of100,test4pub1of100,1,318,24,4719,192,4935
test4sub57of100,test4pub3of100,1,190,14,4550,190,4754
test4sub73of100,test4pub9of100,1,190,13,3149,192,3354
test4sub68of100,test4pub9of100,1,190,13,3150,192,3355
test4sub38of100,test4pub9of100,1,190,13,3150,194,3357
test4sub49of100,test4pub9of100,1,190,13,3152,192,3357
test4sub81of100,test4pub9of100,1,190,13,3152,194,3359
test4sub32of100,test4pub10of100,1,191,16,3029,193,3238
test4sub23of100,test4pub9of100,1,190,13,3155,194,3362
test4sub88of100,test4pub9of100,1,190,13,3156,193,3362
test4sub46of100,test4pub9of100,1,190,13,3156,195,3364
test4sub3of100,test4pub9of100,1,190,13,3154,195,3362
test4sub58of100,test4pub9of100,1,190,13,3158,196,3367
test4sub20of100,test4pub9of100,1,190,13,3154,196,3363
test4sub14of100,test4pub4of100,1,190,11,3676,197,3884
test4sub43of100,test4pub9of100,1,190,13,3144,198,3355
test4sub24of100,test4pub2of100,1,190,10,4781,131,4922
test4sub89of100,test4pub10of100,1,191,16,3104,130,3250
test4sub22of100,test4pub10of100,1,191,16,3105,131,3252
test4sub90of100,test4pub6of100,1,190,14,3621,130,3765
test4sub72of100,test4pub1of100,1,318,24,4805,170,4999
test4sub86of100,test4pub11of100,1,191,13,2348,170,2531
test4sub76of100,test4pub11of100,1,191,13,2350,170,2533
test4sub35of100,test4pub11of100,1,191,13,2350,171,2534
test4sub33of100,test4pub11of100,1,191,13,2353,171,2537
test4sub45of100,test4pub11of100,1,191,13,2352,170,2535
test4sub42of100,test4pub11of100,1,191,13,2357,168,2538
test4sub91of100,test4pub11of100,1,191,13,2357,168,2538
test4sub2of100,test4pub11of100,1,191,13,2359,168,2540
test4sub40of100,test4pub11of100,1,191,13,2359,169,2541
test4sub59of100,test4pub8of100,1,190,16,3352,168,3536
test4sub26of100,test4pub10of100,1,191,16,3122,168,3306
test4sub69of100,test4pub11of100,1,191,13,2364,168,2545
test4sub96of100,test4pub11of100,1,191,13,2364,169,2546
test4sub77of100,test4pub3of100,1,190,14,4652,169,4835
test4sub78of100,test4pub11of100,1,191,13,2366,169,2548
test4sub71of100,test4pub10of100,1,191,16,3129,169,3314
test4sub19of100,test4pub11of100,1,191,13,2369,169,2551
test4sub15of100,test4pub11of100,1,191,13,2371,169,2553
test4sub27of100,test4pub10of100,1,191,16,3131,169,3316
test4sub100of100,test4pub2of100,1,190,10,1806,3175,4991
test4sub99of100,test4pub11of100,1,191,13,2373,170,2556
test4sub74of100,test4pub4of100,1,190,11,3777,169,3957
test4sub54of100,test4pub11of100,1,191,13,2376,169,2558
test4sub11of100,test4pub11of100,1,191,13,2378,170,2561
test4sub17of100,test4pub11of100,1,191,13,2379,170,2562
test4sub16of100,test4pub11of100,1,191,13,2381,169,2563
test4sub53of100,test4pub5of100,1,190,32,3730,169,3931
test4sub65of100,test4pub10of100,1,191,16,3143,169,3328
test4sub56of100,test4pub10of100,1,191,16,3143,169,3328
test4sub44of100,test4pub8of100,1,190,16,3376,169,3561
test4sub30of100,test4pub9of100,1,190,13,3271,169,3453
test4sub4of100,test4pub11of100,1,191,13,2388,169,2570
test4sub55of100,test4pub9of100,1,190,13,3273,169,3455
test4sub60of100,test4pub10of100,1,191,16,3150,169,3335
test4sub97of100,test4pub10of100,1,191,16,3150,169,3335
test4sub18of100,test4pub10of100,1,191,16,3153,169,3338
test4sub95of100,test4pub10of100,1,191,16,3153,168,3337
test4sub34of100,test4pub8of100,1,190,16,3385,168,3569
test4sub29of100,test4pub10of100,1,191,16,3155,169,3340
test4sub31of100,test4pub9of100,1,190,13,3282,169,3464
test4sub67of100,test4pub9of100,1,190,13,3283,168,3464
test4sub39of100,test4pub11of100,1,191,13,2401,167,2581
test4sub12of100,test4pub9of100,1,190,13,3286,167,3466
test4sub85of100,test4pub10of100,1,191,16,3163,168,3347
test4sub10of100,test4pub10of100,1,191,16,3163,168,3347
test4sub64of100,test4pub10of100,1,191,16,3166,168,3350
test4sub75of100,test4pub10of100,1,191,16,3165,168,3349
test4sub21of100,test4pub10of100,1,191,16,3168,168,3352
test4sub92of100,test4pub10of100,1,191,16,3168,167,3351
test4sub84of100,test4pub10of100,1,191,16,3170,168,3354
test4sub82of100,test4pub10of100,1,191,16,3170,168,3354
test4sub83of100,test4pub4of100,1,190,11,3813,168,3992
test4sub61of100,test4pub10of100,1,191,16,3173,169,3358
test4sub5of100,test4pub4of100,1,190,11,3816,168,3995
test4sub52of100,test4pub3of100,1,190,14,4741,128,4883
test4sub57of100,test4pub5of100,1,190,32,3805,129,3966
test4sub73of100,test4pub10of100,1,191,16,3218,129,3363
test4sub68of100,test4pub10of100,1,191,16,3218,130,3364
test4sub49of100,test4pub10of100,1,191,16,3221,131,3368
test4sub38of100,test4pub10of100,1,191,16,3220,132,3368
test4sub32of100,test4pub11of100,1,191,13,2463,131,2607
test4sub81of100,test4pub10of100,1,191,16,3223,131,3370
test4sub88of100,test4pub10of100,1,191,16,3226,131,3373
test4sub23of100,test4pub10of100,1,191,16,3225,131,3372
test4sub3of100,test4pub10of100,1,191,16,3228,130,3374
test4sub46of100,test4pub10of100,1,191,16,3228,131,3375
test4sub20of100,test4pub10of100,1,191,16,3231,131,3378
test4sub58of100,test4pub10of100,1,191,16,3230,131,3377
test4sub43of100,test4pub10of100,1,191,16,3233,130,3379
test4sub14of100,test4pub3of100,1,190,14,4759,130,4903
test4sub89of100,test4pub11of100,1,191,13,2475,130,2618
test4sub24of100,test4pub4of100,1,190,11,3876,131,4018
test4sub93of100,test4pub2of100,1,190,10,1914,3133,5057
test4sub90of100,test4pub5of100,1,190,32,3827,131,3990
test4sub22of100,test4pub11of100,1,191,13,2478,133,2624
test4sub72of100,test4pub3of100,1,190,14,4805,92,4911
test4sub86of100,test4pub12of100,1,191,11,2075,94,2180
test4sub76of100,test4pub12of100,1,191,11,2078,92,2181
test4sub45of100,test4pub12of100,1,191,11,2080,92,2183
test4sub33of100,test4pub12of100,1,191,11,2080,92,2183
test4sub42of100,test4pub12of100,1,191,11,2083,92,2186
test4sub91of100,test4pub12of100,1,191,11,2083,92,2186
test4sub2of100,test4pub12of100,1,191,11,2085,91,2187
test4sub40of100,test4pub12of100,1,191,11,2085,91,2187
test4sub59of100,test4pub9of100,1,190,13,3416,92,3521
test4sub26of100,test4pub11of100,1,191,13,2532,92,2637
test4sub69of100,test4pub12of100,1,191,11,2090,91,2192
test4sub96of100,test4pub12of100,1,191,11,2090,91,2192
test4sub77of100,test4pub6of100,1,190,14,3811,91,3916
test4sub78of100,test4pub12of100,1,191,11,2093,90,2194
test4sub71of100,test4pub11of100,1,191,13,2539,90,2642
test4sub19of100,test4pub12of100,1,191,11,2095,91,2197
test4sub15of100,test4pub12of100,1,191,11,2097,91,2199
test4sub27of100,test4pub11of100,1,191,13,2542,91,2646
test4sub100of100,test4pub3of100,1,190,14,4830,91,4935
test4sub99of100,test4pub12of100,1,191,11,2100,91,2202
test4sub74of100,test4pub5of100,1,190,32,3895,91,4018
test4sub54of100,test4pub12of100,1,191,11,2102,91,2204
test4sub11of100,test4pub12of100,1,191,11,2105,90,2206
test4sub17of100,test4pub12of100,1,191,11,2105,90,2206
test4sub53of100,test4pub7of100,1,190,18,3689,90,3797
test4sub16of100,test4pub12of100,1,191,11,2107,91,2209
test4sub56of100,test4pub11of100,1,191,13,2554,90,2657
test4sub65of100,test4pub11of100,1,191,13,2554,90,2657
test4sub30of100,test4pub10of100,1,191,16,3316,90,3422
test4sub44of100,test4pub9of100,1,190,13,3441,90,3544
test4sub4of100,test4pub12of100,1,191,11,2114,90,2215
test4sub55of100,test4pub10of100,1,191,16,3318,90,3424
test4sub97of100,test4pub11of100,1,191,13,2560,90,2663
test4sub60of100,test4pub11of100,1,191,13,2560,91,2664
test4sub18of100,test4pub11of100,1,191,13,2562,91,2666
test4sub95of100,test4pub11of100,1,191,13,2563,91,2667
test4sub29of100,test4pub11of100,1,191,13,2565,90,2668
test4sub34of100,test4pub9of100,1,190,13,3450,90,3553
test4sub67of100,test4pub10of100,1,191,16,3327,90,3433
test4sub31of100,test4pub10of100,1,191,16,3327,90,3433
test4sub39of100,test4pub12of100,1,191,11,2126,89,2226
test4sub12of100,test4pub10of100,1,191,16,3330,89,3435
test4sub85of100,test4pub11of100,1,191,13,2572,89,2674
test4sub10of100,test4pub11of100,1,191,13,2572,90,2675
test4sub75of100,test4pub11of100,1,191,13,2574,90,2677
test4sub64of100,test4pub11of100,1,191,13,2574,90,2677
test4sub21of100,test4pub11of100,1,191,13,2577,89,2679
test4sub92of100,test4pub11of100,1,191,13,2577,89,2679
test4sub84of100,test4pub11of100,1,191,13,2579,89,2681
test4sub82of100,test4pub11of100,1,191,13,2580,89,2682
test4sub83of100,test4pub3of100,1,190,14,4868,88,4970
test4sub61of100,test4pub11of100,1,191,13,2582,89,2684
test4sub5of100,test4pub5of100,1,190,32,3933,89,4054
test4sub52of100,test4pub4of100,1,190,11,3987,87,4085
test4sub57of100,test4pub6of100,1,190,14,3861,89,3964
test4sub73of100,test4pub11of100,1,191,13,2589,86,2688
test4sub68of100,test4pub11of100,1,191,13,2590,87,2690
test4sub49of100,test4pub11of100,1,191,13,2593,85,2691
test4sub38of100,test4pub11of100,1,191,13,2593,87,2693
test4sub32of100,test4pub12of100,1,191,11,2151,85,2247
test4sub81of100,test4pub11of100,1,191,13,2596,87,2696
test4sub88of100,test4pub11of100,1,191,13,2597,85,2695
test4sub23of100,test4pub11of100,1,191,13,2598,87,2698
test4sub3of100,test4pub11of100,1,191,13,2600,84,2697
test4sub46of100,test4pub11of100,1,191,13,2600,86,2699
test4sub20of100,test4pub11of100,1,191,13,2602,85,2700
test4sub58of100,test4pub11of100,1,191,13,2603,86,2702
test4sub43of100,test4pub11of100,1,191,13,2604,85,2702
test4sub14of100,test4pub5of100,1,190,32,3954,87,4073
test4sub89of100,test4pub12of100,1,191,11,2163,84,2258
test4sub24of100,test4pub3of100,1,190,14,4894,85,4993
test4sub93of100,test4pub4of100,1,190,11,4011,83,4105
test4sub90of100,test4pub7of100,1,190,18,3748,86,3852
test4sub22of100,test4pub12of100,1,191,11,2168,84,2263
test4sub72of100,test4pub4of100,1,190,11,4014,86,4111
test4sub86of100,test4pub13of100,1,191,10,1821,83,1914
test4sub76of100,test4pub13of100,1,191,10,1821,85,1916
test4sub45of100,test4pub13of100,1,191,10,1823,83,1916
test4sub33of100,test4pub13of100,1,191,10,1823,85,1918
test4sub42of100,test4pub13of100,1,191,10,1825,84,1919
test4sub91of100,test4pub13of100,1,191,10,1826,85,1921
test4sub2of100,test4pub13of100,1,191,10,1828,84,1922
test4sub40of100,test4pub13of100,1,191,10,1828,85,1923
test4sub59of100,test4pub10of100,1,191,16,3384,83,3483
test4sub26of100,test4pub12of100,1,191,11,2180,85,2276
test4sub69of100,test4pub13of100,1,191,10,1832,83,1925
test4sub96of100,test4pub13of100,1,191,10,1833,85,1928
test4sub77of100,test4pub7of100,1,190,18,3767,84,3869
test4sub78of100,test4pub13of100,1,191,10,1835,85,1930
test4sub19of100,test4pub13of100,1,191,10,1837,83,1930
test4sub71of100,test4pub12of100,1,191,11,2187,85,2283
test4sub27of100,test4pub12of100,1,191,11,2189,82,2282
test4sub15of100,test4pub13of100,1,191,10,1839,84,1933
test4sub100of100,test4pub4of100,1,190,11,4037,82,4130
test4sub99of100,test4pub13of100,1,191,10,1842,84,1936
test4sub54of100,test4pub13of100,1,191,10,1845,83,1938
test4sub74of100,test4pub3of100,1,190,14,4924,85,5023
test4sub11of100,test4pub13of100,1,191,10,1847,83,1940
test4sub17of100,test4pub13of100,1,191,10,1847,85,1942
test4sub16of100,test4pub13of100,1,191,10,1849,82,1941
test4sub53of100,test4pub8of100,1,190,16,3633,84,3733
test4sub56of100,test4pub12of100,1,191,11,2201,83,2295
test4sub65of100,test4pub12of100,1,191,11,2201,85,2297
test4sub30of100,test4pub11of100,1,191,13,2647,83,2743
test4sub44of100,test4pub10of100,1,191,16,3408,85,3509
test4sub4of100,test4pub13of100,1,191,10,1856,83,1949
test4sub55of100,test4pub11of100,1,191,13,2650,85,2748
test4sub60of100,test4pub12of100,1,191,11,2208,82,2301
test4sub97of100,test4pub12of100,1,191,11,2208,84,2303
test4sub95of100,test4pub12of100,1,191,11,2210,83,2304
test4sub18of100,test4pub12of100,1,191,11,2210,85,2306
test4sub34of100,test4pub10of100,1,191,16,3417,83,3516
test4sub29of100,test4pub12of100,1,191,11,2212,85,2308
test4sub67of100,test4pub11of100,1,191,13,2658,83,2754
test4sub31of100,test4pub11of100,1,191,13,2659,85,2757
test4sub39of100,test4pub13of100,1,191,10,1867,83,1960
test4sub12of100,test4pub11of100,1,191,13,2661,84,2758
test4sub85of100,test4pub12of100,1,191,11,2219,83,2313
test4sub10of100,test4pub12of100,1,191,11,2219,85,2315
test4sub64of100,test4pub12of100,1,191,11,2221,83,2315
test4sub75of100,test4pub12of100,1,191,11,2221,85,2317
test4sub92of100,test4pub12of100,1,191,11,2224,83,2318
test4sub21of100,test4pub12of100,1,191,11,2223,85,2319
test4sub82of100,test4pub12of100,1,191,11,2226,82,2319
test4sub84of100,test4pub12of100,1,191,11,2226,84,2321
test4sub83of100,test4pub5of100,1,190,32,4021,83,4136
test4sub61of100,test4pub12of100,1,191,11,2228,85,2324
test4sub5of100,test4pub6of100,1,190,14,3949,83,4046
test4sub52of100,test4pub5of100,1,190,32,4023,85,4140
test4sub57of100,test4pub7of100,1,190,18,3814,83,3915
test4sub73of100,test4pub12of100,1,191,11,2233,85,2329
test4sub68of100,test4pub12of100,1,191,11,2235,82,2328
test4sub49of100,test4pub12of100,1,191,11,2235,84,2330
test4sub38of100,test4pub12of100,1,191,11,2237,83,2331
test4sub32of100,test4pub13of100,1,191,10,1887,84,1981
test4sub81of100,test4pub12of100,1,191,11,2239,83,2333
test4sub88of100,test4pub12of100,1,191,11,2240,85,2336
test4sub23of100,test4pub12of100,1,191,11,2241,83,2335
test4sub3of100,test4pub12of100,1,191,11,2242,85,2338
test4sub20of100,test4pub12of100,1,191,11,2244,82,2337
test4sub46of100,test4pub12of100,1,191,11,2244,84,2339
test4sub58of100,test4pub12of100,1,191,11,2246,83,2340
test4sub43of100,test4pub12of100,1,191,11,2246,85,2342
test4sub89of100,test4pub13of100,1,191,10,1899,83,1992
test4sub14of100,test4pub6of100,1,190,14,3967,85,4066
test4sub93of100,test4pub3of100,1,190,14,4981,83,5078
test4sub24of100,test4pub5of100,1,190,32,4044,85,4161
test4sub90of100,test4pub8of100,1,190,16,3687,83,3786
test4sub22of100,test4pub13of100,1,191,10,1903,84,1997
test4sub86of100,test4pub14of100,1,191,11,1561,83,1655
test4sub72of100,test4pub5of100,1,190,32,4048,85,4165
test4sub76of100,test4pub14of100,1,191,11,1563,83,1657
test4sub45of100,test4pub14of100,1,191,11,1564,85,1660
test4sub33of100,test4pub14of100,1,191,11,1566,82,1659
test4sub42of100,test4pub14of100,1,191,11,1566,84,1661
test4sub2of100,test4pub14of100,1,191,11,1568,83,1662
test4sub91of100,test4pub14of100,1,191,11,1568,84,1663
test4sub40of100,test4pub14of100,1,191,11,1570,83,1664
test4sub59of100,test4pub11of100,1,191,13,2708,85,2806
test4sub69of100,test4pub14of100,1,191,11,1573,83,1667
test4sub26of100,test4pub13of100,1,191,10,1916,85,2011
test4sub96of100,test4pub14of100,1,191,11,1575,82,1668
test4sub77of100,test4pub8of100,1,190,16,3703,84,3803
test4sub78of100,test4pub14of100,1,191,11,1577,82,1670
test4sub19of100,test4pub14of100,1,191,11,1577,84,1672
test4sub71of100,test4pub13of100,1,191,10,1923,83,2016
test4sub27of100,test4pub13of100,1,191,10,1923,85,2018
test4sub15of100,test4pub14of100,1,191,11,1581,83,1675
test4sub100of100,test4pub5of100,1,190,32,4069,84,4185
test4sub54of100,test4pub14of100,1,191,11,1584,85,1680
test4sub99of100,test4pub14of100,1,191,11,1584,85,1680
test4sub11of100,test4pub14of100,1,191,11,1586,85,1682
test4sub74of100,test4pub6of100,1,190,14,3999,85,4098
test4sub17of100,test4pub14of100,1,191,11,1588,85,1684
test4sub16of100,test4pub14of100,1,191,11,1589,86,1686
test4sub53of100,test4pub9of100,1,190,13,3614,85,3712
test4sub56of100,test4pub13of100,1,191,10,1935,85,2030
test4sub65of100,test4pub13of100,1,191,10,1937,85,2032
test4sub30of100,test4pub12of100,1,191,11,2287,86,2384
test4sub4of100,test4pub14of100,1,191,11,1595,86,1692
test4sub44of100,test4pub11of100,1,191,13,2733,86,2832
test4sub55of100,test4pub12of100,1,191,11,2292,86,2389
test4sub60of100,test4pub13of100,1,191,10,1942,89,2041
test4sub97of100,test4pub13of100,1,191,10,1944,89,2043
test4sub95of100,test4pub13of100,1,191,10,1944,89,2043
test4sub34of100,test4pub11of100,1,191,13,2740,90,2843
test4sub18of100,test4pub13of100,1,191,10,1946,92,2048
test4sub29of100,test4pub13of100,1,191,10,1948,91,2049
test4sub67of100,test4pub12of100,1,191,11,2299,93,2403
test4sub39of100,test4pub14of100,1,191,11,1607,92,1710
test4sub31of100,test4pub12of100,1,191,11,2300,94,2405
test4sub12of100,test4pub12of100,1,191,11,2303,91,2405
test4sub85of100,test4pub13of100,1,191,10,1953,94,2057
test4sub64of100,test4pub13of100,1,191,10,1955,93,2058
test4sub10of100,test4pub13of100,1,191,10,1955,94,2059
test4sub52of100,test4pub6of100,1,190,14,4035,96,4145
test4sub5of100,test4pub7of100,1,190,18,3896,100,4014
test4sub61of100,test4pub13of100,1,191,10,1964,102,2076
test4sub83of100,test4pub6of100,1,190,14,4031,106,4151
test4sub82of100,test4pub13of100,1,191,10,1960,109,2079
test4sub21of100,test4pub13of100,1,191,10,1959,112,2081
test4sub92of100,test4pub13of100,1,191,10,1958,116,2084
test4sub75of100,test4pub13of100,1,191,10,1957,93,2060
test4sub84of100,test4pub13of100,1,191,10,1962,107,2079
test4sub57of100,test4pub8of100,1,190,16,3750,103,3869
test4sub68of100,test4pub13of100,1,191,10,1969,111,2090
test4sub73of100,test4pub13of100,1,191,10,1968,111,2089
test4sub38of100,test4pub13of100,1,191,10,1971,110,2091
test4sub49of100,test4pub13of100,1,191,10,1971,111,2092
test4sub32of100,test4pub14of100,1,191,11,1629,111,1751
test4sub81of100,test4pub13of100,1,191,10,1973,111,2094
test4sub88of100,test4pub13of100,1,191,10,1975,111,2096
test4sub23of100,test4pub13of100,1,191,10,1975,111,2096
test4sub3of100,test4pub13of100,1,191,10,1977,111,2098
test4sub20of100,test4pub13of100,1,191,10,1978,112,2100
test4sub46of100,test4pub13of100,1,191,10,1980,111,2101
test4sub58of100,test4pub13of100,1,191,10,1980,113,2103
test4sub43of100,test4pub13of100,1,191,10,1982,114,2106
test4sub89of100,test4pub14of100,1,191,11,1638,116,1765
test4sub93of100,test4pub5of100,1,190,32,4128,117,4277
test4sub14of100,test4pub7of100,1,190,18,3916,117,4051
test4sub24of100,test4pub6of100,1,190,14,4056,116,4186
test4sub90of100,test4pub9of100,1,190,13,3666,117,3796
test4sub86of100,test4pub15of100,1,191,11,1276,117,1404
test4sub22of100,test4pub14of100,1,191,11,1645,117,1773
test4sub72of100,test4pub6of100,1,190,14,4060,117,4191
test4sub76of100,test4pub15of100,1,191,11,1278,118,1407
test4sub45of100,test4pub15of100,1,191,11,1280,118,1409
test4sub33of100,test4pub15of100,1,191,11,1281,118,1410
test4sub42of100,test4pub15of100,1,191,11,1283,117,1411
test4sub2of100,test4pub15of100,1,191,11,1283,118,1412
test4sub91of100,test4pub15of100,1,191,11,1285,118,1414
test4sub40of100,test4pub15of100,1,191,11,1285,118,1414
test4sub59of100,test4pub12of100,1,191,11,2350,118,2479
test4sub69of100,test4pub15of100,1,191,11,1287,119,1417
test4sub96of100,test4pub15of100,1,191,11,1290,119,1420
test4sub26of100,test4pub14of100,1,191,11,1658,119,1788
test4sub77of100,test4pub9of100,1,190,13,3684,119,3816
test4sub78of100,test4pub15of100,1,191,11,1292,120,1423
test4sub71of100,test4pub14of100,1,191,11,1663,118,1792
test4sub19of100,test4pub15of100,1,191,11,1294,119,1424
test4sub100of100,test4pub6of100,1,190,14,4080,117,4211
test4sub27of100,test4pub14of100,1,191,11,1665,117,1793
test4sub15of100,test4pub15of100,1,191,11,1296,118,1425
test4sub54of100,test4pub15of100,1,191,11,1301,117,1429
test4sub99of100,test4pub15of100,1,191,11,1301,120,1432
test4sub11of100,test4pub15of100,1,191,11,1304,118,1433
test4sub74of100,test4pub7of100,1,190,18,3949,119,4086
test4sub17of100,test4pub15of100,1,191,11,1306,117,1434
test4sub16of100,test4pub15of100,1,191,11,1306,119,1436
test4sub56of100,test4pub14of100,1,191,11,1678,118,1807
test4sub53of100,test4pub10of100,1,191,16,3575,121,3712
test4sub65of100,test4pub14of100,1,191,11,1680,118,1809
test4sub30of100,test4pub13of100,1,191,10,2024,120,2154
test4sub44of100,test4pub12of100,1,191,11,2377,118,2506
test4sub4of100,test4pub15of100,1,191,11,1313,121,1445
test4sub55of100,test4pub13of100,1,191,10,2029,118,2157
test4sub60of100,test4pub14of100,1,191,11,1687,117,1815
test4sub97of100,test4pub14of100,1,191,11,1690,115,1816
test4sub95of100,test4pub14of100,1,191,11,1691,117,1819
test4sub34of100,test4pub12of100,1,191,11,2387,115,2513
test4sub29of100,test4pub14of100,1,191,11,1696,114,1821
test4sub18of100,test4pub14of100,1,191,11,1696,115,1822
test4sub39of100,test4pub15of100,1,191,11,1330,114,1455
test4sub67of100,test4pub13of100,1,191,10,2042,115,2167
test4sub31of100,test4pub13of100,1,191,10,2045,115,2170
test4sub12of100,test4pub13of100,1,191,10,2046,114,2170
test4sub85of100,test4pub14of100,1,191,11,1704,114,1829
test4sub64of100,test4pub14of100,1,191,11,1705,114,1830
test4sub10of100,test4pub14of100,1,191,11,1719,102,1832
test4sub52of100,test4pub7of100,1,190,18,3996,101,4115
test4sub5of100,test4pub8of100,1,190,16,3850,103,3969
test4sub61of100,test4pub14of100,1,191,11,1724,100,1835
test4sub83of100,test4pub7of100,1,190,18,4001,101,4120
test4sub82of100,test4pub14of100,1,191,11,1727,99,1837
test4sub21of100,test4pub14of100,1,191,11,1729,99,1839
test4sub92of100,test4pub14of100,1,191,11,1731,98,1840
test4sub75of100,test4pub14of100,1,191,11,1732,98,1841
test4sub84of100,test4pub14of100,1,191,11,1733,98,1842
test4sub57of100,test4pub9of100,1,190,13,3757,99,3869
test4sub68of100,test4pub14of100,1,191,11,1736,97,1844
test4sub73of100,test4pub14of100,1,191,11,1737,99,1847
test4sub38of100,test4pub14of100,1,191,11,1739,96,1846
test4sub49of100,test4pub14of100,1,191,11,1739,98,1848
test4sub81of100,test4pub14of100,1,191,11,1741,97,1849
test4sub32of100,test4pub15of100,1,191,11,1372,99,1482
test4sub23of100,test4pub14of100,1,191,11,1744,97,1852
test4sub88of100,test4pub14of100,1,191,11,1743,101,1855
test4sub3of100,test4pub14of100,1,191,11,1746,98,1855
test4sub20of100,test4pub14of100,1,191,11,1746,100,1857
test4sub46of100,test4pub14of100,1,191,11,1748,99,1858
test4sub58of100,test4pub14of100,1,191,11,1751,99,1861
test4sub43of100,test4pub14of100,1,191,11,1753,97,1861
test4sub89of100,test4pub15of100,1,191,11,1387,96,1494
test4sub14of100,test4pub8of100,1,190,16,3886,95,3997
test4sub93of100,test4pub6of100,1,190,14,4171,97,4282
test4sub24of100,test4pub7of100,1,190,18,4036,95,4149
test4sub90of100,test4pub10of100,1,191,16,3659,96,3771
test4sub22of100,test4pub15of100,1,191,11,1395,94,1500
test4sub86of100,test4pub16of100,1,191,16,944,96,1056
test4sub72of100,test4pub7of100,1,190,18,4042,94,4154
test4sub76of100,test4pub16of100,1,191,16,946,96,1058
test4sub33of100,test4pub16of100,1,191,16,948,96,1060
test4sub45of100,test4pub16of100,1,191,16,948,96,1060
test4sub42of100,test4pub16of100,1,191,16,950,96,1062
test4sub2of100,test4pub16of100,1,191,16,951,96,1063
test4sub91of100,test4pub16of100,1,191,16,953,96,1065
test4sub40of100,test4pub16of100,1,191,16,953,97,1066
test4sub59of100,test4pub13of100,1,191,10,2119,97,2226
test4sub69of100,test4pub16of100,1,191,16,956,98,1070
test4sub26of100,test4pub15of100,1,191,11,1409,99,1519
test4sub96of100,test4pub16of100,1,191,16,958,99,1073
test4sub77of100,test4pub10of100,1,191,16,3679,98,3793
test4sub78of100,test4pub16of100,1,191,16,961,98,1075
test4sub71of100,test4pub15of100,1,191,11,1414,98,1523
test4sub19of100,test4pub16of100,1,191,16,963,99,1078
test4sub100of100,test4pub7of100,1,190,18,4061,99,4178
test4sub27of100,test4pub15of100,1,191,11,1416,99,1526
test4sub15of100,test4pub16of100,1,191,16,967,99,1082
test4sub54of100,test4pub16of100,1,191,16,969,97,1082
test4sub99of100,test4pub16of100,1,191,16,971,97,1084
test4sub11of100,test4pub16of100,1,191,16,971,98,1085
test4sub74of100,test4pub8of100,1,190,16,3921,98,4035
test4sub17of100,test4pub16of100,1,191,16,974,98,1088
test4sub16of100,test4pub16of100,1,191,16,976,97,1089
test4sub56of100,test4pub15of100,1,191,11,1428,96,1535
test4sub53of100,test4pub11of100,1,191,13,2937,96,3046
test4sub65of100,test4pub15of100,1,191,11,1430,97,1538
test4sub30of100,test4pub14of100,1,191,11,1802,97,1910
test4sub44of100,test4pub13of100,1,191,10,2146,97,2253
test4sub55of100,test4pub14of100,1,191,11,1804,96,1911
test4sub4of100,test4pub16of100,1,191,16,984,96,1096
test4sub97of100,test4pub15of100,1,191,11,1438,95,1544
test4sub60of100,test4pub15of100,1,191,11,1438,95,1544
test4sub95of100,test4pub15of100,1,191,11,1440,95,1546
test4sub34of100,test4pub13of100,1,191,10,2154,95,2259
test4sub18of100,test4pub15of100,1,191,11,1443,95,1549
test4sub29of100,test4pub15of100,1,191,11,1443,95,1549
test4sub39of100,test4pub16of100,1,191,16,994,95,1105
test4sub67of100,test4pub14of100,1,191,11,1815,94,1920
test4sub12of100,test4pub14of100,1,191,11,1818,94,1923
test4sub31of100,test4pub14of100,1,191,11,1817,95,1923
test4sub64of100,test4pub15of100,1,191,11,1451,94,1556
test4sub85of100,test4pub15of100,1,191,11,1451,94,1556
test4sub10of100,test4pub15of100,1,191,11,1453,94,1558
test4sub52of100,test4pub8of100,1,190,16,3951,93,4060
test4sub5of100,test4pub9of100,1,190,13,3848,93,3954
test4sub61of100,test4pub15of100,1,191,11,1456,93,1560
test4sub1of100,test4pub4of100,1,190,11,1361,3099,4471
test4sub83of100,test4pub8of100,1,190,16,3955,94,4065
test4sub92of100,test4pub15of100,1,191,11,1461,93,1565
test4sub21of100,test4pub15of100,1,191,11,1461,93,1565
test4sub84of100,test4pub15of100,1,191,11,1463,93,1567
test4sub75of100,test4pub15of100,1,191,11,1463,93,1567
test4sub57of100,test4pub10of100,1,191,16,3732,93,3841
test4sub68of100,test4pub15of100,1,191,11,1465,94,1570
test4sub73of100,test4pub15of100,1,191,11,1467,94,1572
test4sub38of100,test4pub15of100,1,191,11,1468,94,1573
test4sub49of100,test4pub15of100,1,191,11,1470,94,1575
test4sub81of100,test4pub15of100,1,191,11,1470,96,1577
test4sub32of100,test4pub16of100,1,191,16,1022,95,1133
test4sub23of100,test4pub15of100,1,191,11,1473,96,1580
test4sub3of100,test4pub15of100,1,191,11,1476,93,1580
test4sub88of100,test4pub15of100,1,191,11,1476,95,1582
test4sub20of100,test4pub15of100,1,191,11,1478,93,1582
test4sub46of100,test4pub15of100,1,191,11,1479,94,1584
test4sub58of100,test4pub15of100,1,191,11,1482,92,1585
test4sub43of100,test4pub15of100,1,191,11,1483,93,1587
test4sub14of100,test4pub9of100,1,190,13,3877,91,3981
test4sub89of100,test4pub16of100,1,191,16,1034,93,1143
test4sub93of100,test4pub7of100,1,190,18,4132,91,4241
test4sub24of100,test4pub8of100,1,190,16,3985,92,4093
test4sub90of100,test4pub11of100,1,191,13,2997,93,3103
test4sub22of100,test4pub16of100,1,191,16,1039,95,1150
test4sub72of100,test4pub8of100,1,190,16,3989,96,4101
test4sub86of100,test4pub17of100,1,191,15,636,98,749
test4sub76of100,test4pub17of100,1,191,15,638,99,752
test4sub45of100,test4pub17of100,1,191,15,641,97,753
test4sub33of100,test4pub17of100,1,191,15,641,99,755
test4sub42of100,test4pub17of100,1,191,15,643,97,755
test4sub2of100,test4pub17of100,1,191,15,643,99,757
test4sub91of100,test4pub17of100,1,191,15,645,97,757
test4sub40of100,test4pub17of100,1,191,15,646,98,759
test4sub59of100,test4pub14of100,1,191,11,1874,97,1982
test4sub69of100,test4pub17of100,1,191,15,651,96,762
test4sub96of100,test4pub17of100,1,191,15,653,94,762
test4sub26of100,test4pub16of100,1,191,16,1058,96,1170
test4sub77of100,test4pub11of100,1,191,13,3019,94,3126
test4sub78of100,test4pub17of100,1,191,15,656,95,766
test4sub71of100,test4pub16of100,1,191,16,1063,94,1173
test4sub19of100,test4pub17of100,1,191,15,658,96,769
test4sub27of100,test4pub16of100,1,191,16,1065,94,1175
test4sub100of100,test4pub8of100,1,190,16,4013,95,4124
test4sub54of100,test4pub17of100,1,191,15,663,95,773
test4sub15of100,test4pub17of100,1,191,15,662,95,772
test4sub99of100,test4pub17of100,1,191,15,665,94,774
test4sub11of100,test4pub17of100,1,191,15,665,95,775
test4sub74of100,test4pub9of100,1,190,13,3915,95,4023
test4sub17of100,test4pub17of100,1,191,15,668,95,778
test4sub16of100,test4pub17of100,1,191,15,669,94,778
test4sub56of100,test4pub16of100,1,191,16,1075,95,1186
test4sub53of100,test4pub12of100,1,191,11,2591,92,2694
test4sub65of100,test4pub16of100,1,191,16,1077,96,1189
test4sub30of100,test4pub15of100,1,191,11,1530,94,1635
test4sub44of100,test4pub14of100,1,191,11,1899,96,2006
test4sub55of100,test4pub15of100,1,191,11,1532,95,1638
test4sub4of100,test4pub17of100,1,191,15,677,97,789
test4sub97of100,test4pub16of100,1,191,16,1084,95,1195
test4sub60of100,test4pub16of100,1,191,16,1084,96,1196
test4sub95of100,test4pub16of100,1,191,16,1086,95,1197
test4sub34of100,test4pub14of100,1,191,11,1906,96,2013
test4sub18of100,test4pub16of100,1,191,16,1088,95,1199
test4sub29of100,test4pub16of100,1,191,16,1088,97,1201
test4sub67of100,test4pub15of100,1,191,11,1542,95,1648
test4sub39of100,test4pub17of100,1,191,15,685,101,801
test4sub31of100,test4pub15of100,1,191,11,1544,101,1656
test4sub12of100,test4pub15of100,1,191,11,1544,101,1656
test4sub85of100,test4pub16of100,1,191,16,1095,101,1212
test4sub64of100,test4pub16of100,1,191,16,1095,103,1214
test4sub10of100,test4pub16of100,1,191,16,1097,101,1214
test4sub52of100,test4pub9of100,1,190,13,3940,103,4056
test4sub61of100,test4pub16of100,1,191,16,1100,101,1217
test4sub5of100,test4pub10of100,1,191,16,3818,103,3937
test4sub1of100,test4pub3of100,1,190,14,5346,101,5461
test4sub83of100,test4pub9of100,1,190,13,3945,103,4061
test4sub21of100,test4pub16of100,1,191,16,1105,101,1222
test4sub92of100,test4pub16of100,1,191,16,1104,103,1223
test4sub84of100,test4pub16of100,1,191,16,1107,101,1224
test4sub75of100,test4pub16of100,1,191,16,1107,103,1226
test4sub57of100,test4pub11of100,1,191,13,3067,101,3181
test4sub68of100,test4pub16of100,1,191,16,1109,103,1228
test4sub73of100,test4pub16of100,1,191,16,1111,101,1228
test4sub38of100,test4pub16of100,1,191,16,1112,102,1230
test4sub49of100,test4pub16of100,1,191,16,1114,100,1230
test4sub32of100,test4pub17of100,1,191,15,712,99,826
test4sub81of100,test4pub16of100,1,191,16,1117,100,1233
test4sub3of100,test4pub16of100,1,191,16,1120,100,1236
test4sub23of100,test4pub16of100,1,191,16,1119,100,1235
test4sub88of100,test4pub16of100,1,191,16,1121,100,1237
test4sub20of100,test4pub16of100,1,191,16,1122,100,1238
test4sub46of100,test4pub16of100,1,191,16,1124,99,1239
test4sub58of100,test4pub16of100,1,191,16,1124,99,1239
test4sub43of100,test4pub16of100,1,191,16,1126,99,1241
test4sub14of100,test4pub10of100,1,191,16,3844,100,3960
test4sub98of100,test4pub2of100,1,190,10,2517,3107,5634
test4sub89of100,test4pub17of100,1,191,15,723,100,838
test4sub24of100,test4pub9of100,1,190,13,3974,99,4086
test4sub90of100,test4pub12of100,1,191,11,2648,98,2757
test4sub22of100,test4pub17of100,1,191,15,731,96,842
test4sub72of100,test4pub9of100,1,190,13,3981,95,4089
test4sub86of100,test4pub18of100,1,191,16,280,94,390
test4sub45of100,test4pub18of100,1,191,16,283,92,391
test4sub76of100,test4pub18of100,1,191,16,282,93,391
test4sub33of100,test4pub18of100,1,191,16,285,90,391
test4sub42of100,test4pub18of100,1,191,16,285,91,392
test4sub2of100,test4pub18of100,1,191,16,287,89,392
test4sub91of100,test4pub18of100,1,191,16,288,90,394
test4sub59of100,test4pub15of100,1,191,11,1602,87,1700
test4sub40of100,test4pub18of100,1,191,16,290,88,394
test4sub69of100,test4pub18of100,1,191,16,292,86,394
test4sub96of100,test4pub18of100,1,191,16,293,87,396
test4sub77of100,test4pub12of100,1,191,11,2670,86,2767
test4sub26of100,test4pub17of100,1,191,15,750,86,851
test4sub78of100,test4pub18of100,1,191,16,297,86,399
test4sub71of100,test4pub17of100,1,191,15,753,86,854
test4sub27of100,test4pub17of100,1,191,15,756,84,855
test4sub100of100,test4pub9of100,1,190,13,4005,86,4104
test4sub54of100,test4pub18of100,1,191,16,303,84,403
test4sub15of100,test4pub18of100,1,191,16,303,84,403
test4sub99of100,test4pub18of100,1,191,16,305,83,404
test4sub11of100,test4pub18of100,1,191,16,305,83,404
test4sub74of100,test4pub10of100,1,191,16,3886,82,3984
test4sub56of100,test4pub17of100,1,191,15,765,80,860
test4sub53of100,test4pub13of100,1,191,10,2335,82,2427
test4sub16of100,test4pub18of100,1,191,16,311,80,407
test4sub65of100,test4pub17of100,1,191,15,769,80,864
test4sub30of100,test4pub16of100,1,191,16,1175,79,1270
test4sub44of100,test4pub15of100,1,191,11,1628,79,1718
test4sub55of100,test4pub16of100,1,191,16,1177,80,1273
test4sub4of100,test4pub18of100,1,191,16,318,79,413
test4sub97of100,test4pub17of100,1,191,15,775,79,869
test4sub60of100,test4pub17of100,1,191,15,777,79,871
test4sub95of100,test4pub17of100,1,191,15,777,79,871
test4sub34of100,test4pub15of100,1,191,11,1635,79,1725
test4sub18of100,test4pub17of100,1,191,15,779,80,874
test4sub29of100,test4pub17of100,1,191,15,781,80,876
test4sub67of100,test4pub16of100,1,191,16,1186,80,1282
test4sub39of100,test4pub18of100,1,191,16,332,75,423
test4sub12of100,test4pub16of100,1,191,16,1195,73,1284
test4sub17of100,test4pub18of100,1,191,16,335,73,424
test4sub31of100,test4pub16of100,1,191,16,1195,73,1284
test4sub85of100,test4pub17of100,1,191,15,793,75,883
test4sub64of100,test4pub17of100,1,191,15,794,73,882
test4sub10of100,test4pub17of100,1,191,15,795,75,885
test4sub61of100,test4pub17of100,1,191,15,797,73,885
test4sub52of100,test4pub10of100,1,191,16,3920,75,4011
test4sub1of100,test4pub6of100,1,190,14,4437,73,4524
test4sub5of100,test4pub11of100,1,191,13,3162,76,3251
test4sub21of100,test4pub17of100,1,191,15,802,74,891
test4sub83of100,test4pub10of100,1,191,16,3924,76,4016
test4sub84of100,test4pub17of100,1,191,15,804,76,895
test4sub92of100,test4pub17of100,1,191,15,804,76,895
test4sub75of100,test4pub17of100,1,191,15,806,75,896
test4sub57of100,test4pub12of100,1,191,11,2725,77,2813
test4sub73of100,test4pub17of100,1,191,15,809,77,901
test4sub68of100,test4pub17of100,1,191,15,808,78,901
test4sub49of100,test4pub17of100,1,191,15,811,78,904
test4sub38of100,test4pub17of100,1,191,15,811,80,906
test4sub81of100,test4pub17of100,1,191,15,813,79,907
test4sub32of100,test4pub18of100,1,191,16,357,79,452
test4sub23of100,test4pub17of100,1,191,15,815,78,908
test4sub3of100,test4pub17of100,1,191,15,815,80,910
test4sub88of100,test4pub17of100,1,191,15,817,80,912
test4sub20of100,test4pub17of100,1,191,15,818,80,913
test4sub46of100,test4pub17of100,1,191,15,819,80,914
test4sub58of100,test4pub17of100,1,191,15,820,80,915
test4sub43of100,test4pub17of100,1,191,15,822,80,917
test4sub14of100,test4pub11of100,1,191,13,3185,80,3278
test4sub98of100,test4pub3of100,1,190,14,5473,80,5567
test4sub89of100,test4pub18of100,1,191,16,369,80,465
test4sub24of100,test4pub10of100,1,191,16,3950,78,4044
test4sub90of100,test4pub13of100,1,191,10,2396,80,2486
test4sub22of100,test4pub18of100,1,191,16,373,79,468
test4sub72of100,test4pub10of100,1,191,16,3952,79,4047
test4sub59of100,test4pub16of100,1,191,16,1239,76,1331
test4sub77of100,test4pub13of100,1,191,10,2406,74,2490
test4sub26of100,test4pub18of100,1,191,16,382,75,473
test4sub71of100,test4pub18of100,1,191,16,384,73,473
test4sub27of100,test4pub18of100,1,191,16,385,73,474
test4sub100of100,test4pub10of100,1,191,16,3966,71,4053
test4sub74of100,test4pub11of100,1,191,13,3209,69,3291
test4sub56of100,test4pub18of100,1,191,16,390,70,476
test4sub53of100,test4pub14of100,1,191,11,2073,69,2153
test4sub30of100,test4pub17of100,1,191,15,851,69,935
test4sub65of100,test4pub18of100,1,191,16,394,69,479
test4sub44of100,test4pub16of100,1,191,16,1258,67,1341
test4sub55of100,test4pub17of100,1,191,15,853,69,937
test4sub97of100,test4pub18of100,1,191,16,399,68,483
test4sub60of100,test4pub18of100,1,191,16,401,67,484
test4sub95of100,test4pub18of100,1,191,16,402,68,486
test4sub34of100,test4pub16of100,1,191,16,1265,65,1346
test4sub18of100,test4pub18of100,1,191,16,404,66,486
test4sub67of100,test4pub17of100,1,191,15,862,64,941
test4sub29of100,test4pub18of100,1,191,16,406,65,487
test4sub12of100,test4pub17of100,1,191,15,865,63,943
test4sub31of100,test4pub17of100,1,191,15,866,64,945
test4sub85of100,test4pub18of100,1,191,16,412,62,490
test4sub64of100,test4pub18of100,1,191,16,413,63,492
test4sub10of100,test4pub18of100,1,191,16,415,61,492
test4sub61of100,test4pub18of100,1,191,16,415,62,493
test4sub1of100,test4pub5of100,1,190,32,4586,60,4678
test4sub52of100,test4pub11of100,1,191,13,3237,60,3310
test4sub21of100,test4pub18of100,1,191,16,420,59,495
test4sub5of100,test4pub12of100,1,191,11,2795,60,2866
test4sub83of100,test4pub11of100,1,191,13,3242,57,3312
test4sub84of100,test4pub18of100,1,191,16,425,57,498
test4sub75of100,test4pub18of100,1,191,16,426,57,499
test4sub57of100,test4pub13of100,1,191,10,2454,54,2518
test4sub68of100,test4pub18of100,1,191,16,431,53,500
test4sub73of100,test4pub18of100,1,191,16,431,54,501
test4sub19of100,test4pub18of100,1,191,16,433,52,501
test4sub49of100,test4pub18of100,1,191,16,435,51,502
test4sub38of100,test4pub18of100,1,191,16,435,51,502
test4sub81of100,test4pub18of100,1,191,16,437,50,503
test4sub23of100,test4pub18of100,1,191,16,438,49,503
test4sub3of100,test4pub18of100,1,191,16,440,48,504
test4sub88of100,test4pub18of100,1,191,16,442,46,504
test4sub20of100,test4pub18of100,1,191,16,443,47,506
test4sub58of100,test4pub18of100,1,191,16,445,44,505
test4sub46of100,test4pub18of100,1,191,16,445,44,505
test4sub14of100,test4pub12of100,1,191,11,2822,43,2876
test4sub43of100,test4pub18of100,1,191,16,447,43,506
test4sub98of100,test4pub5of100,1,190,32,4617,42,4691
test4sub24of100,test4pub11of100,1,191,13,3270,43,3326
test4sub90of100,test4pub14of100,1,191,11,2134,41,2186
test4sub72of100,test4pub11of100,1,191,13,3273,42,3328
test4sub77of100,test4pub14of100,1,191,11,2137,40,2188
test4sub59of100,test4pub17of100,1,191,15,912,42,969
test4sub100of100,test4pub11of100,1,191,13,3278,40,3331
test4sub74of100,test4pub12of100,1,191,11,2835,41,2887
test4sub53of100,test4pub15of100,1,191,11,1774,39,1824
test4sub30of100,test4pub18of100,1,191,16,464,39,519
test4sub44of100,test4pub17of100,1,191,15,922,38,975
test4sub55of100,test4pub18of100,1,191,16,468,37,521
test4sub34of100,test4pub17of100,1,191,15,926,36,977
test4sub67of100,test4pub18of100,1,191,16,472,36,524
test4sub12of100,test4pub18of100,1,191,16,473,35,524
test4sub31of100,test4pub18of100,1,191,16,476,34,526
test4sub52of100,test4pub12of100,1,191,11,2854,31,2896
test4sub1of100,test4pub7of100,1,190,18,4435,31,4484
test4sub5of100,test4pub13of100,1,191,10,2506,32,2548
test4sub83of100,test4pub12of100,1,191,11,2857,31,2899
test4sub57of100,test4pub14of100,1,191,11,2166,30,2207
test4sub14of100,test4pub13of100,1,191,10,2516,24,2550
test4sub98of100,test4pub4of100,1,190,11,4713,24,4748
test4sub24of100,test4pub12of100,1,191,11,2870,23,2904
test4sub90of100,test4pub15of100,1,191,11,1807,25,1843
test4sub72of100,test4pub12of100,1,191,11,2872,23,2906
test4sub77of100,test4pub15of100,1,191,11,1809,25,1845
test4sub82of100,test4pub15of100,1,191,11,1459,376,1846
test4sub59of100,test4pub18of100,1,191,16,500,24,540
test4sub100of100,test4pub12of100,1,191,11,2875,24,2910
test4sub74of100,test4pub13of100,1,191,10,2527,24,2561
test4sub53of100,test4pub16of100,1,191,16,1363,25,1404
test4sub44of100,test4pub18of100,1,191,16,505,24,545
test4sub34of100,test4pub18of100,1,191,16,507,22,545
test4sub52of100,test4pub13of100,1,191,10,2535,20,2565
test4sub1of100,test4pub8of100,1,190,16,4320,19,4355
test4sub92of100,test4pub18of100,1,191,16,512,20,548
test4sub5of100,test4pub14of100,1,191,11,2195,18,2224
test4sub83of100,test4pub13of100,1,191,10,2540,19,2569
test4sub57of100,test4pub15of100,1,191,11,1828,19,1858
test4sub14of100,test4pub14of100,1,191,11,2198,19,2228
test4sub98of100,test4pub6of100,1,190,14,4613,18,4645
test4sub24of100,test4pub13of100,1,191,10,2544,19,2573
test4sub90of100,test4pub16of100,1,191,16,1382,19,1417
test4sub72of100,test4pub13of100,1,191,10,2546,19,2575
test4sub77of100,test4pub16of100,1,191,16,1384,19,1419
test4sub82of100,test4pub16of100,1,191,16,1385,19,1420
test4sub100of100,test4pub13of100,1,191,10,2551,18,2579
test4sub74of100,test4pub14of100,1,191,11,2209,16,2236
test4sub53of100,test4pub17of100,1,191,15,984,18,1017
test4sub52of100,test4pub14of100,1,191,11,2212,16,2239
test4sub1of100,test4pub9of100,1,190,13,4235,18,4266
test4sub5of100,test4pub15of100,1,191,11,1846,18,1875
test4sub83of100,test4pub14of100,1,191,11,2215,20,2246
test4sub62of100,test4pub6of100,1,190,14,2706,1944,4664
test4sub57of100,test4pub16of100,1,191,16,1397,23,1436
test4sub14of100,test4pub15of100,1,191,11,1849,25,1885
test4sub98of100,test4pub7of100,1,190,18,4496,25,4539
test4sub24of100,test4pub14of100,1,191,11,2220,28,2259
test4sub90of100,test4pub17of100,1,191,15,997,29,1041
test4sub72of100,test4pub14of100,1,191,11,2222,31,2264
test4sub82of100,test4pub17of100,1,191,15,1000,32,1047
test4sub77of100,test4pub17of100,1,191,15,999,34,1048
test4sub100of100,test4pub14of100,1,191,11,2226,35,2272
test4sub74of100,test4pub15of100,1,191,11,1858,34,1903
test4sub53of100,test4pub18of100,1,191,16,548,34,598
test4sub52of100,test4pub15of100,1,191,11,1860,34,1905
test4sub1of100,test4pub10of100,1,191,16,4129,33,4178
test4sub5of100,test4pub16of100,1,191,16,1414,32,1462
test4sub83of100,test4pub15of100,1,191,11,1867,30,1908
test4sub62of100,test4pub7of100,1,190,18,4515,29,4562
test4sub57of100,test4pub17of100,1,191,15,1016,27,1058
test4sub14of100,test4pub16of100,1,191,16,1424,26,1466
test4sub98of100,test4pub8of100,1,190,16,4375,26,4417
test4sub24of100,test4pub15of100,1,191,11,1881,25,1917
test4sub90of100,test4pub18of100,1,191,16,571,26,613
test4sub72of100,test4pub15of100,1,191,11,1886,24,1921
test4sub82of100,test4pub18of100,1,191,16,576,25,617
test4sub77of100,test4pub18of100,1,191,16,579,23,618
test4sub74of100,test4pub16of100,1,191,16,1443,22,1481
test4sub100of100,test4pub15of100,1,191,11,1893,25,1929
test4sub52of100,test4pub16of100,1,191,16,1445,25,1486
test4sub1of100,test4pub11of100,1,191,13,3403,28,3444
test4sub5of100,test4pub17of100,1,191,15,1042,26,1083
test4sub83of100,test4pub16of100,1,191,16,1448,28,1492
test4sub57of100,test4pub18of100,1,191,16,589,26,631
test4sub62of100,test4pub8of100,1,190,16,4398,27,4441
test4sub14of100,test4pub17of100,1,191,15,1047,26,1088
test4sub98of100,test4pub9of100,1,190,13,4297,24,4334
test4sub24of100,test4pub16of100,1,191,16,1457,23,1496
test4sub72of100,test4pub16of100,1,191,16,1461,20,1497
test4sub74of100,test4pub17of100,1,191,15,1061,17,1093
test4sub100of100,test4pub16of100,1,191,16,1469,14,1499
test4sub52of100,test4pub17of100,1,191,15,1067,13,1095
test4sub1of100,test4pub12of100,1,191,11,2988,11,3010
test4sub5of100,test4pub18of100,1,191,16,613,13,642
test4sub83of100,test4pub17of100,1,191,15,1071,12,1098
test4sub62of100,test4pub9of100,1,190,13,4320,11,4344
test4sub98of100,test4pub10of100,1,191,16,4198,11,4225
test4sub14of100,test4pub18of100,1,191,16,618,12,646
test4sub72of100,test4pub17of100,1,191,15,1077,10,1102
test4sub24of100,test4pub17of100,1,191,15,1077,10,1102
test4sub74of100,test4pub18of100,1,191,16,623,9,648
test4sub100of100,test4pub17of100,1,191,15,1079,10,1104
test4sub1of100,test4pub13of100,1,191,10,2651,10,2671
test4sub52of100,test4pub18of100,1,191,16,625,10,651
test4sub83of100,test4pub18of100,1,191,16,628,8,652
test4sub62of100,test4pub10of100,1,191,16,4208,9,4233
test4sub98of100,test4pub11of100,1,191,13,3450,6,3469
test4sub24of100,test4pub18of100,1,191,16,633,8,657
test4sub100of100,test4pub18of100,1,191,16,634,8,658
test4sub1of100,test4pub14of100,1,191,11,2317,7,2335
test4sub62of100,test4pub11of100,1,191,13,3457,5,3475
test4sub15of100,test4pub19of100,1,191,32,7,6,45
test4sub98of100,test4pub12of100,1,191,11,3015,6,3032
test4sub89of100,test4pub19of100,1,191,32,10,6,48
test4sub62of100,test4pub12of100,1,191,11,3019,4,3034
test4sub1of100,test4pub15of100,1,191,11,1956,5,1972
test4sub98of100,test4pub13of100,1,191,10,2672,4,2686
test4sub1of100,test4pub16of100,1,191,16,1511,2,1529
test4sub62of100,test4pub13of100,1,191,10,2674,1,2685
test4sub1of100,test4pub17of100,1,191,15,1109,1,1125
test4sub98of100,test4pub14of100,1,191,11,2333,4,2348
test4sub62of100,test4pub14of100,1,191,11,2335,3,2349
test4sub1of100,test4pub18of100,1,191,16,656,1,673
test4sub98of100,test4pub15of100,1,191,11,1970,6,1987
test4sub16of100,test4pub19of100,1,191,32,31,1,64
test4sub62of100,test4pub15of100,1,191,11,1972,5,1988
test4sub98of100,test4pub16of100,1,191,16,1526,1,1543
test4sub62of100,test4pub16of100,1,191,16,1528,1,1545
test4sub98of100,test4pub17of100,1,191,15,1124,2,1141
test4sub62of100,test4pub17of100,1,191,15,1126,1,1142
test4sub98of100,test4pub18of100,1,191,16,670,1,687
test4sub62of100,test4pub18of100,1,191,16,673,1,690
test4sub53of100,test4pub19of100,1,191,32,52,1,85
test4sub83of100,test4pub19of100,1,191,32,54,1,87
test4sub98of100,test4pub19of100,1,191,32,56,1,89
test4sub81of100,test4pub19of100,1,191,32,59,1,92
test4sub99of100,test4pub19of100,1,191,32,70,1,103
test4sub46of100,test4pub19of100,1,191,32,71,1,104
test4sub44of100,test4pub19of100,1,191,32,78,1,111
test4sub12of100,test4pub19of100,1,191,32,84,1,117
test4sub29of100,test4pub19of100,1,191,32,99,1,132
test4sub1of100,test4pub19of100,1,191,32,101,1,134
test4sub54of100,test4pub19of100,1,191,32,113,1,146
test4sub52of100,test4pub19of100,1,191,32,115,1,148
test4sub39of100,test4pub19of100,1,191,32,116,3,151
test4sub19of100,test4pub19of100,1,191,32,118,2,152
test4sub68of100,test4pub19of100,1,191,32,121,3,156
test4sub57of100,test4pub19of100,1,191,32,122,2,156
test4sub56of100,test4pub19of100,1,191,32,123,2,157
test4sub18of100,test4pub19of100,1,191,32,123,2,157
test4sub76of100,test4pub19of100,1,191,32,134,1,167
test4sub26of100,test4pub19of100,1,191,32,144,1,177
test4sub75of100,test4pub19of100,1,191,32,146,1,179
test4sub21of100,test4pub19of100,1,191,32,146,1,179
test4sub27of100,test4pub19of100,1,191,32,151,1,184
test4sub17of100,test4pub19of100,1,191,32,160,1,193
test4sub60of100,test4pub19of100,1,191,32,163,1,196
test4sub5of100,test4pub19of100,1,191,32,163,1,196
test4sub84of100,test4pub19of100,1,191,32,173,2,207
test4sub90of100,test4pub19of100,1,191,32,175,1,208
test4sub33of100,test4pub19of100,1,191,32,176,1,209
test4sub73of100,test4pub19of100,1,191,32,192,12,236
test4sub85of100,test4pub19of100,1,191,32,183,15,230
test4sub32of100,test4pub19of100,1,191,32,194,13,239
test4sub22of100,test4pub19of100,1,191,32,196,11,239
test4sub92of100,test4pub19of100,1,191,32,197,11,240
test4sub45of100,test4pub19of100,1,191,32,197,11,240
test4sub11of100,test4pub19of100,1,191,32,198,11,241
test4sub86of100,test4pub19of100,1,191,32,199,10,241
test4sub64of100,test4pub19of100,1,191,32,201,8,241
test4sub74of100,test4pub19of100,1,191,32,203,7,242
test4sub10of100,test4pub19of100,1,191,32,203,7,242
test4sub67of100,test4pub19of100,1,191,32,206,4,242
test4sub77of100,test4pub19of100,1,191,32,220,2,254
test4sub31of100,test4pub19of100,1,191,32,220,12,264
test4sub65of100,test4pub19of100,1,191,32,222,11,265
test4sub61of100,test4pub19of100,1,191,32,222,12,266
test4sub40of100,test4pub19of100,1,191,32,225,10,267
test4sub2of100,test4pub19of100,1,191,32,227,10,269
test4sub95of100,test4pub19of100,1,191,32,226,10,268
test4sub3of100,test4pub19of100,1,191,32,228,10,270
test4sub71of100,test4pub19of100,1,191,32,234,4,270
test4sub91of100,test4pub19of100,1,191,32,244,6,282
test4sub30of100,test4pub19of100,1,191,32,245,7,284
test4sub96of100,test4pub19of100,1,191,32,246,6,284
test4sub88of100,test4pub19of100,1,191,32,247,5,284
test4sub20of100,test4pub19of100,1,191,32,249,4,285
test4sub59of100,test4pub19of100,1,191,32,255,1,288
test4sub14of100,test4pub19of100,1,191,32,255,2,289
test4sub43of100,test4pub19of100,1,191,32,262,2,296
test4sub34of100,test4pub19of100,1,191,32,262,3,297
test4sub55of100,test4pub19of100,1,191,32,264,3,299
test4sub23of100,test4pub19of100,1,191,32,266,2,300
test4sub69of100,test4pub19of100,1,191,32,266,3,301
test4sub38of100,test4pub19of100,1,191,32,279,4,315
test4sub24of100,test4pub19of100,1,191,32,280,3,315
test4sub62of100,test4pub19of100,1,191,32,280,4,316
test4sub58of100,test4pub19of100,1,191,32,281,3,316
test4sub82of100,test4pub19of100,1,191,32,281,4,317
test4sub4of100,test4pub19of100,1,191,32,288,0,320
test4sub49of100,test4pub19of100,1,191,32,298,1,331
test4sub42of100,test4pub19of100,1,191,32,307,1,340
test4sub35of100,test4pub12of100,1,191,11,2078,1240,3329
test4sub78of100,test4pub19of100,1,191,32,310,3,345
test4sub100of100,test4pub19of100,1,191,32,312,2,346
test4sub35of100,test4pub13of100,1,191,10,2969,3,2982
test4sub97of100,test4pub19of100,1,191,32,314,1,347
test4sub35of100,test4pub14of100,1,191,11,2629,1,2641
test4sub35of100,test4pub15of100,1,191,11,2262,1,2274
test4sub35of100,test4pub16of100,1,191,16,1813,1,1830
test4sub35of100,test4pub17of100,1,191,15,1410,1,1426
test4sub35of100,test4pub18of100,1,191,16,956,1,973
test4sub35of100,test4pub19of100,1,191,32,326,1,359
test4sub72of100,test4pub18of100,1,191,16,980,1,997
test4sub72of100,test4pub19of100,1,191,32,350,1,383
test4sub29of100,test4pub20of100,1,191,18,8,1,27
test4sub73of100,test4pub20of100,1,191,18,23,1,42
test4sub97of100,test4pub20of100,1,191,18,27,1,46
test4sub5of100,test4pub20of100,1,191,18,29,2,49
test4sub60of100,test4pub20of100,1,191,18,32,1,51
test4sub32of100,test4pub20of100,1,191,18,31,2,51
test4sub99of100,test4pub20of100,1,191,18,40,2,60
test4sub69of100,test4pub20of100,1,191,18,41,1,60
test4sub45of100,test4pub20of100,1,191,18,42,2,62
test4sub77of100,test4pub20of100,1,191,18,47,2,67
test4sub96of100,test4pub20of100,1,191,18,48,1,67
test4sub23of100,test4pub20of100,1,191,18,49,1,68
test4sub21of100,test4pub20of100,1,191,18,50,1,69
test4sub46of100,test4pub20of100,1,191,18,73,1,92
test4sub83of100,test4pub20of100,1,191,18,74,1,93
test4sub26of100,test4pub20of100,1,191,18,77,1,96
test4sub35of100,test4pub20of100,1,191,18,79,1,98
test4sub14of100,test4pub20of100,1,191,18,85,1,104
test4sub88of100,test4pub20of100,1,191,18,86,1,105
test4sub38of100,test4pub20of100,1,191,18,91,1,110
test4sub43of100,test4pub20of100,1,191,18,99,1,118
test4sub67of100,test4pub20of100,1,191,18,102,1,121
test4sub33of100,test4pub20of100,1,191,18,108,1,127
test4sub100of100,test4pub20of100,1,191,18,110,0,128
test4sub52of100,test4pub20of100,1,191,18,117,1,136
test4sub68of100,test4pub20of100,1,191,18,118,2,138
test4sub54of100,test4pub20of100,1,191,18,119,1,138
test4sub27of100,test4pub20of100,1,191,18,121,1,140
test4sub74of100,test4pub20of100,1,191,18,130,1,149
test4sub72of100,test4pub20of100,1,191,18,132,1,151
test4sub78of100,test4pub20of100,1,191,18,136,1,155
test4sub10of100,test4pub20of100,1,191,18,144,1,163
test4sub34of100,test4pub20of100,1,191,18,151,1,170
test4sub49of100,test4pub20of100,1,191,18,153,1,172
test4sub1of100,test4pub20of100,1,191,18,154,1,173
test4sub81of100,test4pub20of100,1,191,18,161,1,180
test4sub31of100,test4pub20of100,1,191,18,164,1,183
test4sub82of100,test4pub20of100,1,191,18,167,5,190
test4sub44of100,test4pub20of100,1,191,18,171,1,190
test4sub79of100,test4pub3of100,1,190,14,3452,3009,6475
test4sub79of100,test4pub5of100,1,190,32,5525,1,5558
test4sub92of100,test4pub20of100,1,191,18,175,2,195
test4sub79of100,test4pub6of100,1,190,14,5453,2,5469
test4sub24of100,test4pub20of100,1,191,18,177,2,197
test4sub11of100,test4pub20of100,1,191,18,173,5,196
test4sub79of100,test4pub7of100,1,190,18,5320,1,5339
test4sub79of100,test4pub8of100,1,190,16,5174,1,5191
test4sub79of100,test4pub9of100,1,190,13,5071,0,5084
test4sub79of100,test4pub10of100,1,191,16,4949,0,4965
test4sub79of100,test4pub11of100,1,191,13,4191,1,4205
test4sub79of100,test4pub12of100,1,191,11,3749,7,3767
test4sub61of100,test4pub20of100,1,191,18,197,3,218
test4sub17of100,test4pub20of100,1,191,18,198,3,219
test4sub79of100,test4pub13of100,1,191,10,3407,3,3420
test4sub79of100,test4pub14of100,1,191,11,3067,1,3079
test4sub53of100,test4pub20of100,1,191,18,207,1,226
test4sub30of100,test4pub20of100,1,191,18,209,1,228
test4sub79of100,test4pub15of100,1,191,11,2701,1,2713
test4sub79of100,test4pub16of100,1,191,16,2257,6,2279
test4sub91of100,test4pub20of100,1,191,18,218,3,239
test4sub79of100,test4pub17of100,1,191,15,1860,1,1876
test4sub79of100,test4pub18of100,1,191,16,1407,8,1431
test4sub79of100,test4pub19of100,1,191,32,784,1,817
test4sub79of100,test4pub20of100,1,191,18,236,1,255
test4sub15of100,test4pub20of100,1,191,18,252,1,271
test4sub85of100,test4pub20of100,1,191,18,255,1,274
test4sub20of100,test4pub20of100,1,191,18,256,2,276
test4sub16of100,test4pub20of100,1,191,18,258,2,278
test4sub39of100,test4pub20of100,1,191,18,257,2,277
test4sub48of100,test4pub3of100,1,190,14,2929,3621,6564
test4sub48of100,test4pub4of100,1,190,11,5666,1,5678
test4sub48of100,test4pub5of100,1,190,32,5616,1,5649
test4sub42of100,test4pub20of100,1,191,18,266,3,287
test4sub48of100,test4pub6of100,1,190,14,5545,2,5561
test4sub56of100,test4pub20of100,1,191,18,268,5,291
test4sub57of100,test4pub20of100,1,191,18,270,4,292
test4sub48of100,test4pub7of100,1,190,18,5412,2,5432
test4sub48of100,test4pub8of100,1,190,16,5268,1,5285
test4sub48of100,test4pub9of100,1,190,13,5165,1,5179
test4sub48of100,test4pub10of100,1,191,16,5042,1,5059
test4sub48of100,test4pub11of100,1,191,13,4284,1,4298
test4sub40of100,test4pub20of100,1,191,18,285,1,304
test4sub48of100,test4pub12of100,1,191,11,3843,1,3855
test4sub48of100,test4pub13of100,1,191,10,3496,1,3507
test4sub48of100,test4pub14of100,1,191,11,3154,1,3166
test4sub48of100,test4pub15of100,1,191,11,2787,1,2799
test4sub48of100,test4pub16of100,1,191,16,2338,1,2355
test4sub84of100,test4pub20of100,1,191,18,295,2,315
test4sub48of100,test4pub17of100,1,191,15,1935,1,1951
test4sub48of100,test4pub18of100,1,191,16,1482,1,1499
test4sub48of100,test4pub19of100,1,191,32,852,7,891
test4sub48of100,test4pub20of100,1,191,18,309,1,328
test4sub95of100,test4pub20of100,1,191,18,325,1,344
test4sub75of100,test4pub20of100,1,191,18,341,1,360
test4sub71of100,test4pub20of100,1,191,18,342,1,361
test4sub3of100,test4pub20of100,1,191,18,345,1,364
test4sub2of100,test4pub20of100,1,191,18,348,1,367
test4sub89of100,test4pub20of100,1,191,18,349,2,369
test4sub4of100,test4pub20of100,1,191,18,357,1,376
test4sub76of100,test4pub20of100,1,191,18,378,1,397
test4sub86of100,test4pub20of100,1,191,18,378,3,399
test4sub65of100,test4pub20of100,1,191,18,382,11,411
test4sub12of100,test4pub20of100,1,191,18,382,11,411
test4sub58of100,test4pub20of100,1,191,18,383,10,411
test4sub62of100,test4pub20of100,1,191,18,386,8,412
test4sub18of100,test4pub20of100,1,191,18,389,4,411
test4sub90of100,test4pub20of100,1,191,18,390,5,413
test4sub55of100,test4pub20of100,1,191,18,391,5,414
test4sub28of100,test4pub3of100,1,190,14,3405,3320,6739
test4sub98of100,test4pub20of100,1,191,18,436,3,457
test4sub64of100,test4pub20of100,1,191,18,434,5,457
test4sub28of100,test4pub4of100,1,190,11,5842,1,5854
test4sub28of100,test4pub5of100,1,190,32,5793,10,5835
test4sub22of100,test4pub20of100,1,191,18,452,4,474
test4sub19of100,test4pub20of100,1,191,18,451,5,474
test4sub28of100,test4pub6of100,1,190,14,5730,3,5747
test4sub28of100,test4pub7of100,1,190,18,5597,1,5616
test4sub28of100,test4pub8of100,1,190,16,5452,7,5475
test4sub28of100,test4pub9of100,1,190,13,5360,1,5374
test4sub28of100,test4pub10of100,1,191,16,5238,1,5255
test4sub28of100,test4pub11of100,1,191,13,4489,16,4518
test4sub59of100,test4pub20of100,1,191,18,489,17,524
test4sub28of100,test4pub12of100,1,191,11,4062,2,4075
test4sub28of100,test4pub13of100,1,191,10,3715,1,3726
test4sub28of100,test4pub14of100,1,191,11,3374,1,3386
test4sub28of100,test4pub15of100,1,191,11,3008,14,3033
test4sub28of100,test4pub16of100,1,191,16,2573,1,2590
test4sub28of100,test4pub17of100,1,191,15,2171,2,2188
test4sub28of100,test4pub18of100,1,191,16,1719,1,1736
test4sub28of100,test4pub19of100,1,191,32,1090,2,1124
test4sub28of100,test4pub20of100,1,191,18,542,9,569
test4sub10of100,test4pub21of100,1,191,21,6,3,30
test4sub78of100,test4pub21of100,1,191,21,9,4,34
test4sub65of100,test4pub21of100,1,191,21,12,4,37
test4sub92of100,test4pub21of100,1,191,21,13,4,38
test4sub90of100,test4pub21of100,1,191,21,14,5,40
test4sub31of100,test4pub21of100,1,191,21,18,8,47
test4sub77of100,test4pub21of100,1,191,21,19,9,49
test4sub28of100,test4pub21of100,1,191,21,21,14,56
test4sub75of100,test4pub21of100,1,191,21,27,12,60
test4sub30of100,test4pub21of100,1,191,21,28,12,61
test4sub48of100,test4pub21of100,1,191,21,30,14,65
test4sub53of100,test4pub21of100,1,191,21,31,14,66
test4sub4of100,test4pub21of100,1,191,21,33,13,67
test4sub76of100,test4pub21of100,1,191,21,34,13,68
test4sub84of100,test4pub21of100,1,191,21,35,13,69
test4sub32of100,test4pub21of100,1,191,21,37,14,72
test4sub52of100,test4pub21of100,1,191,21,38,14,73
test4sub1of100,test4pub21of100,1,191,21,41,11,73
test4sub29of100,test4pub21of100,1,191,21,41,12,74
test4sub3of100,test4pub21of100,1,191,21,43,11,75
test4sub60of100,test4pub21of100,1,191,21,45,10,76
test4sub91of100,test4pub21of100,1,191,21,48,7,76
test4sub43of100,test4pub21of100,1,191,21,50,6,77
test4sub23of100,test4pub21of100,1,191,21,50,12,83
test4sub49of100,test4pub21of100,1,191,21,54,9,84
test4sub14of100,test4pub21of100,1,191,21,60,4,85
test4sub21of100,test4pub21of100,1,191,21,61,3,85
test4sub73of100,test4pub21of100,1,191,21,62,3,86
test4sub88of100,test4pub21of100,1,191,21,94,4,119
test4sub39of100,test4pub21of100,1,191,21,96,2,119
test4sub47of100,test4pub8of100,1,190,16,2721,3003,5740
test4sub20of100,test4pub21of100,1,191,21,96,4,121
test4sub26of100,test4pub21of100,1,191,21,94,5,120
test4sub47of100,test4pub9of100,1,190,13,5621,2,5636
test4sub86of100,test4pub21of100,1,191,21,102,1,124
test4sub35of100,test4pub21of100,1,191,21,106,1,128
test4sub27of100,test4pub21of100,1,191,21,109,4,134
test4sub24of100,test4pub21of100,1,191,21,107,7,135
test4sub89of100,test4pub21of100,1,191,21,110,4,135
test4sub47of100,test4pub10of100,1,191,16,5500,10,5526
test4sub2of100,test4pub21of100,1,191,21,116,1,138
test4sub11of100,test4pub21of100,1,191,21,112,6,139
test4sub47of100,test4pub11of100,1,191,13,4752,1,4766
test4sub16of100,test4pub21of100,1,191,21,118,3,142
test4sub96of100,test4pub21of100,1,191,21,120,1,142
test4sub12of100,test4pub21of100,1,191,21,115,6,142
test4sub54of100,test4pub21of100,1,191,21,116,5,142
test4sub85of100,test4pub21of100,1,191,21,121,1,143
test4sub47of100,test4pub12of100,1,191,11,4315,1,4327
test4sub47of100,test4pub13of100,1,191,10,3969,15,3994
test4sub55of100,test4pub21of100,1,191,21,137,13,171
test4sub44of100,test4pub21of100,1,191,21,140,11,172
test4sub22of100,test4pub21of100,1,191,21,143,13,177
test4sub47of100,test4pub14of100,1,191,11,3641,15,3667
test4sub56of100,test4pub21of100,1,191,21,145,16,182
test4sub64of100,test4pub21of100,1,191,21,146,17,184
test4sub79of100,test4pub21of100,1,191,21,147,16,184
test4sub17of100,test4pub21of100,1,191,21,149,21,191
test4sub61of100,test4pub21of100,1,191,21,148,22,191
test4sub99of100,test4pub21of100,1,191,21,150,20,191
test4sub71of100,test4pub21of100,1,191,21,150,21,192
test4sub83of100,test4pub21of100,1,191,21,151,20,192
test4sub81of100,test4pub21of100,1,191,21,153,19,193
test4sub100of100,test4pub21of100,1,191,21,154,19,194
test4sub67of100,test4pub21of100,1,191,21,154,19,194
test4sub69of100,test4pub21of100,1,191,21,155,19,195
test4sub62of100,test4pub21of100,1,191,21,156,19,196
test4sub46of100,test4pub21of100,1,191,21,157,18,196
test4sub47of100,test4pub15of100,1,191,11,3289,15,3315
test4sub87of100,test4pub9of100,1,190,13,2674,3025,5712
test4sub47of100,test4pub16of100,1,191,16,2855,1,2872
test4sub87of100,test4pub10of100,1,191,16,5575,1,5592
test4sub47of100,test4pub17of100,1,191,15,2452,1,2468
test4sub87of100,test4pub11of100,1,191,13,4818,1,4832
test4sub47of100,test4pub18of100,1,191,16,1999,1,2016
test4sub47of100,test4pub19of100,1,191,32,1369,1,1402
test4sub87of100,test4pub12of100,1,191,11,4376,3,4390
test4sub47of100,test4pub20of100,1,191,18,821,11,850
test4sub87of100,test4pub13of100,1,191,10,4031,9,4050
test4sub87of100,test4pub14of100,1,191,11,3698,3,3712
test4sub68of100,test4pub21of100,1,191,21,200,5,226
test4sub40of100,test4pub21of100,1,191,21,202,5,228
test4sub57of100,test4pub21of100,1,191,21,202,6,229
test4sub19of100,test4pub21of100,1,191,21,205,3,229
test4sub87of100,test4pub15of100,1,191,11,3334,4,3349
test4sub87of100,test4pub16of100,1,191,16,2887,1,2904
test4sub95of100,test4pub21of100,1,191,21,212,2,235
test4sub72of100,test4pub21of100,1,191,21,214,2,237
test4sub98of100,test4pub21of100,1,191,21,217,2,240
test4sub18of100,test4pub21of100,1,191,21,215,7,243
test4sub38of100,test4pub21of100,1,191,21,216,9,246
test4sub82of100,test4pub21of100,1,191,21,219,17,257
test4sub42of100,test4pub21of100,1,191,21,221,16,258
test4sub5of100,test4pub21of100,1,191,21,221,17,259
test4sub15of100,test4pub21of100,1,191,21,222,15,258
test4sub34of100,test4pub21of100,1,191,21,224,13,258
test4sub59of100,test4pub21of100,1,191,21,224,13,258
test4sub97of100,test4pub21of100,1,191,21,226,13,260
test4sub33of100,test4pub21of100,1,191,21,223,13,257
test4sub45of100,test4pub21of100,1,191,21,227,13,261
test4sub47of100,test4pub21of100,1,191,21,228,13,262
test4sub58of100,test4pub21of100,1,191,21,223,13,257
test4sub74of100,test4pub21of100,1,191,21,229,13,263
test4sub87of100,test4pub17of100,1,191,15,2485,14,2514
test4sub87of100,test4pub18of100,1,191,16,2061,1,2078
test4sub87of100,test4pub19of100,1,191,32,1431,1,1464
test4sub87of100,test4pub20of100,1,191,18,883,1,902
test4sub87of100,test4pub21of100,1,191,21,251,1,273
test4sub54of100,test4pub22of100,1,191,15,8,1,24
test4sub14of100,test4pub22of100,1,191,15,11,1,27
test4sub35of100,test4pub22of100,1,191,15,14,1,30
test4sub59of100,test4pub22of100,1,191,15,22,1,38
test4sub85of100,test4pub22of100,1,191,15,20,3,38
test4sub92of100,test4pub22of100,1,191,15,24,1,40
test4sub97of100,test4pub22of100,1,191,15,26,1,42
test4sub74of100,test4pub22of100,1,191,15,28,3,46
test4sub61of100,test4pub22of100,1,191,15,29,4,48
test4sub82of100,test4pub22of100,1,191,15,30,4,49
test4sub58of100,test4pub22of100,1,191,15,32,2,49
test4sub38of100,test4pub22of100,1,191,15,32,2,49
test4sub56of100,test4pub22of100,1,191,15,45,1,61
test4sub62of100,test4pub22of100,1,191,15,47,1,63
test4sub48of100,test4pub22of100,1,191,15,46,2,63
test4sub20of100,test4pub22of100,1,191,15,54,1,70
test4sub47of100,test4pub22of100,1,191,15,56,4,75
test4sub49of100,test4pub22of100,1,191,15,58,3,76
test4sub88of100,test4pub22of100,1,191,15,57,5,77
test4sub68of100,test4pub22of100,1,191,15,58,4,77
test4sub78of100,test4pub22of100,1,191,15,59,4,78
test4sub2of100,test4pub22of100,1,191,15,60,4,79
test4sub23of100,test4pub22of100,1,191,15,62,7,84
test4sub1of100,test4pub22of100,1,191,15,64,6,85
test4sub76of100,test4pub22of100,1,191,15,66,5,86
test4sub45of100,test4pub22of100,1,191,15,67,6,88
test4sub18of100,test4pub22of100,1,191,15,68,7,90
test4sub81of100,test4pub22of100,1,191,15,69,6,90
test4sub57of100,test4pub22of100,1,191,15,71,4,90
test4sub83of100,test4pub22of100,1,191,15,73,3,91
test4sub55of100,test4pub22of100,1,191,15,74,4,93
test4sub4of100,test4pub22of100,1,191,15,75,5,95
test4sub24of100,test4pub22of100,1,191,15,77,4,96
test4sub32of100,test4pub22of100,1,191,15,79,5,99
test4sub10of100,test4pub22of100,1,191,15,80,4,99
test4sub84of100,test4pub22of100,1,191,15,82,3,100
test4sub99of100,test4pub22of100,1,191,15,83,3,101
test4sub67of100,test4pub22of100,1,191,15,86,8,109
test4sub96of100,test4pub22of100,1,191,15,88,6,109
test4sub19of100,test4pub22of100,1,191,15,92,4,111
test4sub89of100,test4pub22of100,1,191,15,99,1,115
test4sub3of100,test4pub22of100,1,191,15,102,3,120
test4sub17of100,test4pub22of100,1,191,15,101,3,119
test4sub44of100,test4pub22of100,1,191,15,103,4,122
test4sub91of100,test4pub22of100,1,191,15,105,3,123
test4sub34of100,test4pub22of100,1,191,15,105,5,125
test4sub100of100,test4pub22of100,1,191,15,107,4,126
test4sub90of100,test4pub22of100,1,191,15,103,10,128
test4sub86of100,test4pub22of100,1,191,15,108,7,130
test4sub29of100,test4pub22of100,1,191,15,110,6,131
test4sub73of100,test4pub22of100,1,191,15,112,8,135
test4sub77of100,test4pub22of100,1,191,15,112,9,136
test4sub21of100,test4pub22of100,1,191,15,112,17,144
test4sub11of100,test4pub22of100,1,191,15,115,15,145
test4sub43of100,test4pub22of100,1,191,15,116,16,147
test4sub69of100,test4pub22of100,1,191,15,118,16,149
test4sub27of100,test4pub22of100,1,191,15,119,15,149
test4sub64of100,test4pub22of100,1,191,15,119,16,150
test4sub40of100,test4pub22of100,1,191,15,121,15,151
test4sub30of100,test4pub22of100,1,191,15,122,15,152
test4sub39of100,test4pub22of100,1,191,15,123,15,153
test4sub22of100,test4pub22of100,1,191,15,124,15,154
test4sub53of100,test4pub22of100,1,191,15,124,15,154
test4sub26of100,test4pub22of100,1,191,15,125,15,155
test4sub87of100,test4pub22of100,1,191,15,125,16,156
test4sub72of100,test4pub22of100,1,191,15,126,17,158
test4sub52of100,test4pub22of100,1,191,15,127,17,159
test4sub15of100,test4pub22of100,1,191,15,127,17,159
test4sub42of100,test4pub22of100,1,191,15,128,17,160
test4sub46of100,test4pub22of100,1,191,15,127,18,160
test4sub75of100,test4pub22of100,1,191,15,131,15,161
test4sub60of100,test4pub22of100,1,191,15,133,15,163
test4sub41of100,test4pub9of100,1,190,13,3139,3004,6156
test4sub8of100,test4pub9of100,1,190,13,3141,3005,6159
test4sub37of100,test4pub8of100,1,190,16,3242,3005,6263
test4sub13of100,test4pub9of100,1,190,13,3137,3007,6157
test4sub8of100,test4pub10of100,1,191,16,6042,3,6061
test4sub37of100,test4pub9of100,1,190,13,6167,3,6183
test4sub13of100,test4pub10of100,1,191,16,6044,3,6063
test4sub41of100,test4pub10of100,1,191,16,6040,9,6065
test4sub8of100,test4pub11of100,1,191,13,5286,3,5302
test4sub37of100,test4pub10of100,1,191,16,6047,6,6069
test4sub8of100,test4pub12of100,1,191,11,4847,2,4860
test4sub13of100,test4pub11of100,1,191,13,5288,5,5306
test4sub41of100,test4pub11of100,1,191,13,5291,5,5309
test4sub8of100,test4pub13of100,1,191,10,4502,1,4513
test4sub37of100,test4pub11of100,1,191,13,5293,6,5312
test4sub8of100,test4pub14of100,1,191,11,4161,2,4174
test4sub13of100,test4pub12of100,1,191,11,4851,4,4866
test4sub36of100,test4pub2of100,1,190,10,4741,3007,7758
test4sub37of100,test4pub12of100,1,191,11,4857,2,4870
test4sub41of100,test4pub12of100,1,191,11,4854,4,4869
test4sub8of100,test4pub15of100,1,191,11,3796,8,3815
test4sub36of100,test4pub3of100,1,190,14,7605,9,7628
test4sub37of100,test4pub13of100,1,191,10,4526,10,4546
test4sub41of100,test4pub13of100,1,191,10,4527,11,4548
test4sub13of100,test4pub13of100,1,191,10,4509,12,4531
test4sub36of100,test4pub4of100,1,190,11,6731,8,6750
test4sub37of100,test4pub14of100,1,191,11,4193,8,4212
test4sub8of100,test4pub16of100,1,191,16,3370,14,3400
test4sub41of100,test4pub14of100,1,191,11,4195,10,4216
test4sub13of100,test4pub14of100,1,191,11,4198,9,4218
test4sub37of100,test4pub15of100,1,191,11,3833,8,3852
test4sub36of100,test4pub6of100,1,190,14,6613,11,6638
test4sub8of100,test4pub17of100,1,191,15,2979,9,3003
test4sub41of100,test4pub15of100,1,191,11,3837,10,3858
test4sub13of100,test4pub15of100,1,191,11,3840,9,3860
test4sub37of100,test4pub16of100,1,191,16,3391,9,3416
test4sub63of100,test4pub11of100,1,191,13,2355,3005,5373
test4sub70of100,test4pub3of100,1,190,14,4641,3005,7660
test4sub36of100,test4pub5of100,1,190,32,6700,9,6741
test4sub8of100,test4pub18of100,1,191,16,2534,17,2567
test4sub41of100,test4pub16of100,1,191,16,3397,17,3430
test4sub13of100,test4pub16of100,1,191,16,3399,17,3432
test4sub63of100,test4pub12of100,1,191,11,4917,16,4944
test4sub70of100,test4pub5of100,1,190,32,6710,16,6758
test4sub37of100,test4pub17of100,1,191,15,2997,20,3032
test4sub4of100,test4pub23of100,1,191,17,8,15,40
test4sub41of100,test4pub17of100,1,191,15,3010,13,3038
test4sub36of100,test4pub7of100,1,190,18,6500,25,6543
test4sub8of100,test4pub19of100,1,191,32,1920,17,1969
test4sub18of100,test4pub23of100,1,191,17,15,14,46
test4sub13of100,test4pub17of100,1,191,15,3013,14,3042
test4sub63of100,test4pub13of100,1,191,10,4585,15,4610
test4sub70of100,test4pub6of100,1,190,14,6654,17,6685
test4sub34of100,test4pub23of100,1,191,17,18,18,53
test4sub54of100,test4pub23of100,1,191,17,18,19,54
test4sub7of100,test4pub11of100,1,191,13,2374,3025,5412
test4sub46of100,test4pub23of100,1,191,17,20,21,58
test4sub37of100,test4pub18of100,1,191,16,2565,19,2600
test4sub41of100,test4pub18of100,1,191,16,2568,19,2603
test4sub8of100,test4pub20of100,1,191,18,1387,21,1426
test4sub36of100,test4pub8of100,1,190,16,6379,23,6418
test4sub23of100,test4pub23of100,1,191,17,28,33,78
test4sub47of100,test4pub23of100,1,191,17,29,33,79
test4sub13of100,test4pub18of100,1,191,16,2574,32,2622
test4sub26of100,test4pub23of100,1,191,17,32,35,84
test4sub62of100,test4pub23of100,1,191,17,34,35,86
test4sub63of100,test4pub14of100,1,191,11,4257,35,4303
test4sub70of100,test4pub7of100,1,190,18,6535,40,6593
test4sub43of100,test4pub23of100,1,191,17,39,38,94
test4sub7of100,test4pub12of100,1,191,11,4957,39,5007
test4sub57of100,test4pub23of100,1,191,17,40,40,97
test4sub22of100,test4pub23of100,1,191,17,40,41,98
test4sub37of100,test4pub19of100,1,191,32,1954,38,2024
test4sub33of100,test4pub22of100,1,191,15,408,42,465
test4sub41of100,test4pub19of100,1,191,32,1956,41,2029
test4sub2of100,test4pub23of100,1,191,17,48,41,106
test4sub8of100,test4pub21of100,1,191,21,776,40,837
test4sub90of100,test4pub23of100,1,191,17,52,39,108
test4sub32of100,test4pub23of100,1,191,17,53,42,112
test4sub36of100,test4pub9of100,1,190,13,6300,43,6356
test4sub97of100,test4pub23of100,1,191,17,61,44,122
test4sub74of100,test4pub23of100,1,191,17,61,45,123
test4sub68of100,test4pub23of100,1,191,17,63,44,124
test4sub13of100,test4pub19of100,1,191,32,1976,42,2050
test4sub81of100,test4pub23of100,1,191,17,65,44,126
test4sub17of100,test4pub23of100,1,191,17,66,44,127
test4sub45of100,test4pub23of100,1,191,17,66,44,127
test4sub86of100,test4pub23of100,1,191,17,67,45,129
test4sub89of100,test4pub23of100,1,191,17,70,41,128
test4sub87of100,test4pub23of100,1,191,17,71,48,136
test4sub63of100,test4pub15of100,1,191,11,3925,48,3984
test4sub39of100,test4pub23of100,1,191,17,72,54,143
test4sub53of100,test4pub23of100,1,191,17,72,54,143
test4sub20of100,test4pub23of100,1,191,17,73,53,143
test4sub11of100,test4pub23of100,1,191,17,74,53,144
test4sub70of100,test4pub8of100,1,190,16,6428,53,6497
test4sub85of100,test4pub23of100,1,191,17,77,54,148
test4sub7of100,test4pub13of100,1,191,10,4647,56,4713
test4sub21of100,test4pub23of100,1,191,17,121,37,175
test4sub33of100,test4pub23of100,1,191,17,121,39,177
test4sub24of100,test4pub23of100,1,191,17,118,41,176
test4sub91of100,test4pub23of100,1,191,17,118,41,176
test4sub38of100,test4pub23of100,1,191,17,112,48,177
test4sub58of100,test4pub23of100,1,191,17,108,52,177
test4sub13of100,test4pub20of100,1,191,18,1469,52,1539
test4sub96of100,test4pub23of100,1,191,17,105,57,179
test4sub72of100,test4pub23of100,1,191,17,103,59,179
test4sub30of100,test4pub23of100,1,191,17,104,59,180
test4sub44of100,test4pub23of100,1,191,17,103,63,183
test4sub36of100,test4pub10of100,1,191,16,6224,64,6304
test4sub49of100,test4pub23of100,1,191,17,101,66,184
test4sub82of100,test4pub23of100,1,191,17,100,69,186
test4sub59of100,test4pub23of100,1,191,17,99,69,185
test4sub75of100,test4pub23of100,1,191,17,93,74,184
test4sub92of100,test4pub23of100,1,191,17,94,75,186
test4sub35of100,test4pub23of100,1,191,17,93,76,186
test4sub8of100,test4pub22of100,1,191,15,457,79,551
test4sub48of100,test4pub23of100,1,191,17,90,81,188
test4sub41of100,test4pub20of100,1,191,18,1447,84,1549
test4sub99of100,test4pub23of100,1,191,17,84,88,189
test4sub37of100,test4pub20of100,1,191,18,1443,90,1551
test4sub61of100,test4pub23of100,1,191,17,85,87,189
test4sub14of100,test4pub23of100,1,191,17,83,91,191
test4sub69of100,test4pub23of100,1,191,17,122,54,193
test4sub88of100,test4pub23of100,1,191,17,122,54,193
test4sub64of100,test4pub23of100,1,191,17,121,54,192
test4sub55of100,test4pub23of100,1,191,17,124,55,196
test4sub63of100,test4pub16of100,1,191,16,3527,54,3597
test4sub1of100,test4pub23of100,1,191,17,125,55,197
test4sub56of100,test4pub23of100,1,191,17,128,53,198
test4sub70of100,test4pub9of100,1,190,13,6378,51,6442
test4sub40of100,test4pub23of100,1,191,17,131,52,200
test4sub73of100,test4pub23of100,1,191,17,133,51,201
test4sub77of100,test4pub23of100,1,191,17,133,52,202
test4sub27of100,test4pub23of100,1,191,17,134,51,202
test4sub42of100,test4pub23of100,1,191,17,135,50,202
test4sub7of100,test4pub14of100,1,191,11,4360,50,4421
test4sub52of100,test4pub23of100,1,191,17,137,29,183
test4sub78of100,test4pub23of100,1,191,17,160,29,206
test4sub13of100,test4pub21of100,1,191,21,887,29,937
test4sub16of100,test4pub22of100,1,191,15,530,26,571
test4sub36of100,test4pub11of100,1,191,13,5529,25,5567
test4sub8of100,test4pub23of100,1,191,17,170,24,211
test4sub10of100,test4pub23of100,1,191,17,171,24,212
test4sub41of100,test4pub21of100,1,191,21,898,23,942
test4sub95of100,test4pub22of100,1,191,15,539,25,579
test4sub37of100,test4pub21of100,1,191,21,900,24,945
test4sub84of100,test4pub23of100,1,191,17,176,24,217
test4sub63of100,test4pub17of100,1,191,15,3179,20,3214
test4sub70of100,test4pub10of100,1,191,16,6305,19,6340
test4sub7of100,test4pub15of100,1,191,11,4042,25,4078
test4sub19of100,test4pub23of100,1,191,17,187,27,231
test4sub13of100,test4pub22of100,1,191,15,557,23,595
test4sub16of100,test4pub23of100,1,191,17,191,25,233
test4sub36of100,test4pub12of100,1,191,11,5111,24,5146
test4sub41of100,test4pub22of100,1,191,15,563,23,601
test4sub37of100,test4pub22of100,1,191,15,565,22,602
test4sub95of100,test4pub23of100,1,191,17,199,24,240
test4sub63of100,test4pub18of100,1,191,16,2744,22,2782
test4sub25of100,test4pub3of100,1,190,14,2936,4937,7887
test4sub70of100,test4pub11of100,1,191,13,5565,22,5600
test4sub7of100,test4pub16of100,1,191,16,3617,14,3647
test4sub13of100,test4pub23of100,1,191,17,216,14,247
test4sub36of100,test4pub13of100,1,191,10,4787,12,4809
test4sub37of100,test4pub23of100,1,191,17,222,11,250
test4sub63of100,test4pub19of100,1,191,32,2135,10,2177
test4sub70of100,test4pub12of100,1,191,11,5145,9,5165
test4sub25of100,test4pub4of100,1,190,11,6990,11,7012
test4sub7of100,test4pub17of100,1,191,15,3228,9,3252
test4sub36of100,test4pub14of100,1,191,11,4456,9,4476
test4sub63of100,test4pub20of100,1,191,18,1595,8,1621
test4sub70of100,test4pub13of100,1,191,10,4805,10,4825
test4sub7of100,test4pub18of100,1,191,16,2783,9,2808
test4sub25of100,test4pub6of100,1,190,14,6877,11,6902
test4sub36of100,test4pub15of100,1,191,11,4097,18,4126
test4sub63of100,test4pub21of100,1,191,21,970,18,1009
test4sub98of100,test4pub22of100,1,191,15,612,18,645
test4sub70of100,test4pub14of100,1,191,11,4472,18,4501
test4sub7of100,test4pub19of100,1,191,32,2161,19,2212
test4sub25of100,test4pub5of100,1,190,32,6964,19,7015
test4sub36of100,test4pub16of100,1,191,16,3665,11,3692
test4sub63of100,test4pub22of100,1,191,15,630,11,656
test4sub79of100,test4pub22of100,1,191,15,632,10,657
test4sub98of100,test4pub23of100,1,191,17,266,10,293
test4sub70of100,test4pub15of100,1,191,11,4123,9,4143
test4sub7of100,test4pub20of100,1,191,18,1630,9,1657
test4sub25of100,test4pub7of100,1,190,18,6773,8,6799
test4sub36of100,test4pub17of100,1,191,15,3272,9,3296
test4sub63of100,test4pub23of100,1,191,17,275,8,300
test4sub79of100,test4pub23of100,1,191,17,277,7,301
test4sub70of100,test4pub16of100,1,191,16,3682,7,3705
test4sub7of100,test4pub21of100,1,191,21,1006,7,1034
test4sub25of100,test4pub8of100,1,190,16,6635,6,6657
test4sub36of100,test4pub18of100,1,191,16,2826,6,2848
test4sub70of100,test4pub17of100,1,191,15,3285,5,3305
test4sub7of100,test4pub22of100,1,191,15,654,5,674
test4sub36of100,test4pub19of100,1,191,32,2201,6,2239
test4sub25of100,test4pub9of100,1,190,13,6537,8,6558
test4sub70of100,test4pub18of100,1,191,16,2836,6,2858
test4sub7of100,test4pub23of100,1,191,17,295,5,317
test4sub36of100,test4pub20of100,1,191,18,1657,4,1679
test4sub25of100,test4pub10of100,1,191,16,6421,7,6444
test4sub70of100,test4pub19of100,1,191,32,2210,8,2250
test4sub36of100,test4pub21of100,1,191,21,1028,6,1055
test4sub65of100,test4pub22of100,1,191,15,672,6,693
test4sub70of100,test4pub20of100,1,191,18,1668,6,1692
test4sub25of100,test4pub11of100,1,191,13,5670,16,5699
test4sub36of100,test4pub22of100,1,191,15,676,14,705
test4sub3of100,test4pub23of100,1,191,17,312,14,343
test4sub100of100,test4pub23of100,1,191,17,313,14,344
test4sub65of100,test4pub23of100,1,191,17,314,13,344
test4sub70of100,test4pub21of100,1,191,21,1042,12,1075
test4sub25of100,test4pub12of100,1,191,11,5243,5,5259
test4sub36of100,test4pub23of100,1,191,17,325,5,347
test4sub70of100,test4pub22of100,1,191,15,695,2,712
test4sub25of100,test4pub13of100,1,191,10,4900,1,4911
test4sub70of100,test4pub23of100,1,191,17,333,1,351
test4sub31of100,test4pub22of100,1,191,15,702,1,718
test4sub25of100,test4pub14of100,1,191,11,4558,3,4572
test4sub25of100,test4pub15of100,1,191,11,4193,6,4210
test4sub31of100,test4pub23of100,1,191,17,341,5,363
test4sub25of100,test4pub16of100,1,191,16,3749,1,3766
test4sub67of100,test4pub23of100,1,191,17,349,1,367
test4sub25of100,test4pub17of100,1,191,15,3347,1,3363
test4sub25of100,test4pub18of100,1,191,16,2895,8,2919
test4sub71of100,test4pub22of100,1,191,15,724,2,741
test4sub71of100,test4pub23of100,1,191,17,361,1,379
test4sub25of100,test4pub19of100,1,191,32,2272,2,2306
test4sub25of100,test4pub20of100,1,191,18,1724,1,1743
test4sub25of100,test4pub21of100,1,191,21,1092,6,1119
test4sub25of100,test4pub22of100,1,191,15,739,1,755
test4sub25of100,test4pub23of100,1,191,17,375,9,401
test4sub28of100,test4pub22of100,1,191,15,751,1,767
test4sub28of100,test4pub23of100,1,191,17,387,5,409
test4sub15of100,test4pub23of100,1,191,17,389,4,410
test4sub55of100,test4pub24of100,1,191,18,8,2,28
test4sub1of100,test4pub24of100,1,191,18,6,5,29
test4sub100of100,test4pub24of100,1,191,18,8,3,29
test4sub99of100,test4pub24of100,1,191,18,11,2,31
test4sub17of100,test4pub24of100,1,191,18,13,1,32
test4sub68of100,test4pub24of100,1,191,18,10,4,32
test4sub38of100,test4pub24of100,1,191,18,16,1,35
test4sub33of100,test4pub24of100,1,191,18,24,1,43
test4sub27of100,test4pub24of100,1,191,18,26,1,45
test4sub36of100,test4pub24of100,1,191,18,34,1,53
test4sub14of100,test4pub24of100,1,191,18,35,2,55
test4sub12of100,test4pub22of100,1,191,15,796,2,813
test4sub84of100,test4pub24of100,1,191,18,32,4,54
test4sub41of100,test4pub23of100,1,191,17,433,1,451
test4sub23of100,test4pub24of100,1,191,18,40,2,60
test4sub31of100,test4pub24of100,1,191,18,42,0,60
test4sub16of100,test4pub24of100,1,191,18,42,2,62
test4sub63of100,test4pub24of100,1,191,18,44,2,64
test4sub43of100,test4pub24of100,1,191,18,47,0,65
test4sub89of100,test4pub24of100,1,191,18,46,2,66
test4sub88of100,test4pub24of100,1,191,18,49,4,71
test4sub26of100,test4pub24of100,1,191,18,53,2,73
test4sub67of100,test4pub24of100,1,191,18,51,4,73
test4sub77of100,test4pub24of100,1,191,18,60,3,81
test4sub47of100,test4pub24of100,1,191,18,60,4,82
test4sub91of100,test4pub24of100,1,191,18,58,6,82
test4sub2of100,test4pub24of100,1,191,18,63,3,84
test4sub59of100,test4pub24of100,1,191,18,62,3,83
test4sub90of100,test4pub24of100,1,191,18,80,1,99
test4sub13of100,test4pub24of100,1,191,18,82,4,104
test4sub83of100,test4pub23of100,1,191,17,477,5,499
test4sub54of100,test4pub24of100,1,191,18,85,4,107
test4sub73of100,test4pub24of100,1,191,18,85,5,108
test4sub4of100,test4pub24of100,1,191,18,85,5,108
test4sub65of100,test4pub24of100,1,191,18,93,8,119
test4sub52of100,test4pub24of100,1,191,18,94,15,127
test4sub12of100,test4pub23of100,1,191,17,490,15,522
test4sub78of100,test4pub24of100,1,191,18,98,16,132
test4sub35of100,test4pub24of100,1,191,18,99,16,133
test4sub21of100,test4pub24of100,1,191,18,99,20,137
test4sub61of100,test4pub24of100,1,191,18,99,21,138
test4sub18of100,test4pub24of100,1,191,18,101,30,149
test4sub28of100,test4pub24of100,1,191,18,101,30,149
test4sub37of100,test4pub24of100,1,191,18,102,31,151
test4sub15of100,test4pub24of100,1,191,18,103,31,152
test4sub53of100,test4pub24of100,1,191,18,103,31,152
test4sub81of100,test4pub24of100,1,191,18,105,31,154
test4sub97of100,test4pub24of100,1,191,18,106,33,157
test4sub20of100,test4pub24of100,1,191,18,107,34,159
test4sub10of100,test4pub24of100,1,191,18,106,34,158
test4sub22of100,test4pub24of100,1,191,18,108,35,161
test4sub70of100,test4pub24of100,1,191,18,109,35,162
test4sub42of100,test4pub24of100,1,191,18,109,37,164
test4sub86of100,test4pub24of100,1,191,18,111,36,165
test4sub3of100,test4pub24of100,1,191,18,112,36,166
test4sub12of100,test4pub24of100,1,191,18,112,37,167
test4sub25of100,test4pub24of100,1,191,18,116,34,168
test4sub95of100,test4pub24of100,1,191,18,117,35,170
test4sub62of100,test4pub24of100,1,191,18,118,34,170
test4sub76of100,test4pub23of100,1,191,17,513,35,565
test4sub64of100,test4pub24of100,1,191,18,123,31,172
test4sub19of100,test4pub24of100,1,191,18,124,31,173
test4sub24of100,test4pub24of100,1,191,18,127,29,174
test4sub85of100,test4pub24of100,1,191,18,127,30,175
test4sub57of100,test4pub24of100,1,191,18,128,30,176
test4sub7of100,test4pub24of100,1,191,18,129,30,177
test4sub87of100,test4pub24of100,1,191,18,130,30,178
test4sub75of100,test4pub24of100,1,191,18,132,29,179
test4sub96of100,test4pub24of100,1,191,18,138,24,180
test4sub69of100,test4pub24of100,1,191,18,138,25,181
test4sub8of100,test4pub24of100,1,191,18,143,21,182
test4sub48of100,test4pub24of100,1,191,18,144,21,183
test4sub83of100,test4pub24of100,1,191,18,146,23,187
test4sub44of100,test4pub24of100,1,191,18,163,6,187
test4sub60of100,test4pub23of100,1,191,17,561,3,581
test4sub76of100,test4pub24of100,1,191,18,167,4,189
test4sub60of100,test4pub24of100,1,191,18,184,1,203
test4sub58of100,test4pub24of100,1,191,18,190,2,210
test4sub72of100,test4pub24of100,1,191,18,201,1,220
test4sub93of100,test4pub8of100,1,190,16,4077,3008,7101
test4sub93of100,test4pub9of100,1,190,13,6980,1,6994
test4sub93of100,test4pub10of100,1,191,16,6857,1,6874
test4sub93of100,test4pub11of100,1,191,13,6099,1,6113
test4sub93of100,test4pub12of100,1,191,11,5657,1,5669
test4sub93of100,test4pub13of100,1,191,10,5309,1,5320
test4sub93of100,test4pub14of100,1,191,11,4967,1,4979
test4sub93of100,test4pub15of100,1,191,11,4600,1,4612
test4sub93of100,test4pub16of100,1,191,16,4151,1,4168
test4sub93of100,test4pub17of100,1,191,15,3748,1,3764
test4sub93of100,test4pub18of100,1,191,16,3294,1,3311
test4sub93of100,test4pub19of100,1,191,32,2664,1,2697
test4sub93of100,test4pub20of100,1,191,18,2115,1,2134
test4sub93of100,test4pub21of100,1,191,21,1483,0,1504
test4sub93of100,test4pub22of100,1,191,15,1125,0,1140
test4sub100of100,test4pub25of100,1,191,13,11,1,25
test4sub93of100,test4pub23of100,1,191,17,761,0,778
test4sub78of100,test4pub25of100,1,191,13,15,1,29
test4sub76of100,test4pub25of100,1,191,13,15,2,30
test4sub97of100,test4pub25of100,1,191,13,17,0,30
test4sub59of100,test4pub25of100,1,191,13,22,1,36
test4sub43of100,test4pub25of100,1,191,13,22,1,36
test4sub36of100,test4pub25of100,1,191,13,25,1,39
test4sub89of100,test4pub25of100,1,191,13,26,2,41
test4sub91of100,test4pub25of100,1,191,13,28,1,42
test4sub37of100,test4pub25of100,1,191,13,30,1,44
test4sub17of100,test4pub25of100,1,191,13,31,1,45
test4sub44of100,test4pub25of100,1,191,13,33,0,46
test4sub34of100,test4pub24of100,1,191,18,392,1,411
test4sub11of100,test4pub24of100,1,191,18,400,1,419
test4sub19of100,test4pub25of100,1,191,13,44,2,59
test4sub10of100,test4pub25of100,1,191,13,47,1,61
test4sub32of100,test4pub24of100,1,191,18,403,1,422
test4sub61of100,test4pub25of100,1,191,13,49,1,63
test4sub87of100,test4pub25of100,1,191,13,52,1,66
test4sub45of100,test4pub24of100,1,191,18,411,1,430
test4sub57of100,test4pub25of100,1,191,13,50,7,70
test4sub7of100,test4pub25of100,1,191,13,56,3,72
test4sub74of100,test4pub24of100,1,191,18,409,7,434
test4sub38of100,test4pub25of100,1,191,13,54,7,74
test4sub69of100,test4pub25of100,1,191,13,57,5,75
test4sub81of100,test4pub25of100,1,191,13,59,5,77
test4sub77of100,test4pub25of100,1,191,13,59,4,76
test4sub48of100,test4pub25of100,1,191,13,60,3,76
test4sub95of100,test4pub25of100,1,191,13,62,2,77
test4sub96of100,test4pub25of100,1,191,13,65,4,82
test4sub63of100,test4pub25of100,1,191,13,66,2,81
test4sub67of100,test4pub25of100,1,191,13,66,2,81
test4sub31of100,test4pub25of100,1,191,13,66,2,81
test4sub56of100,test4pub24of100,1,191,18,446,0,464
test4sub60of100,test4pub25of100,1,191,13,90,2,105
test4sub8of100,test4pub25of100,1,191,13,93,2,108
test4sub13of100,test4pub25of100,1,191,13,92,3,108
test4sub47of100,test4pub25of100,1,191,13,94,1,108
test4sub92of100,test4pub24of100,1,191,18,455,4,477
test4sub52of100,test4pub25of100,1,191,13,101,2,116
test4sub83of100,test4pub25of100,1,191,13,101,3,117
test4sub35of100,test4pub25of100,1,191,13,102,2,117
test4sub58of100,test4pub25of100,1,191,13,103,2,118
test4sub64of100,test4pub25of100,1,191,13,108,1,122
test4sub40of100,test4pub24of100,1,191,18,465,1,484
test4sub28of100,test4pub25of100,1,191,13,110,1,124
test4sub54of100,test4pub25of100,1,191,13,115,0,128
test4sub55of100,test4pub25of100,1,191,13,117,1,131
test4sub11of100,test4pub25of100,1,191,13,118,3,134
test4sub72of100,test4pub25of100,1,191,13,119,1,133
test4sub42of100,test4pub25of100,1,191,13,119,3,135
test4sub74of100,test4pub25of100,1,191,13,121,1,135
test4sub53of100,test4pub25of100,1,191,13,126,9,148
test4sub32of100,test4pub25of100,1,191,13,127,8,148
test4sub45of100,test4pub25of100,1,191,13,128,8,149
test4sub23of100,test4pub25of100,1,191,13,127,8,148
test4sub86of100,test4pub25of100,1,191,13,129,8,150
test4sub88of100,test4pub25of100,1,191,13,129,7,149
test4sub21of100,test4pub25of100,1,191,13,130,7,150
test4sub33of100,test4pub25of100,1,191,13,131,6,150
test4sub65of100,test4pub25of100,1,191,13,130,6,149
test4sub68of100,test4pub25of100,1,191,13,131,6,150
test4sub15of100,test4pub25of100,1,191,13,133,5,151
test4sub2of100,test4pub25of100,1,191,13,133,6,152
test4sub85of100,test4pub25of100,1,191,13,134,5,152
test4sub26of100,test4pub25of100,1,191,13,141,1,155
test4sub14of100,test4pub25of100,1,191,13,142,3,158
test4sub24of100,test4pub25of100,1,191,13,144,2,159
test4sub25of100,test4pub25of100,1,191,13,143,16,172
test4sub56of100,test4pub25of100,1,191,13,148,14,175
test4sub99of100,test4pub25of100,1,191,13,150,13,176
test4sub41of100,test4pub24of100,1,191,18,506,13,537
test4sub27of100,test4pub25of100,1,191,13,144,13,170
test4sub75of100,test4pub25of100,1,191,13,152,14,179
test4sub70of100,test4pub25of100,1,191,13,152,14,179
test4sub18of100,test4pub25of100,1,191,13,154,14,181
test4sub34of100,test4pub25of100,1,191,13,154,14,181
test4sub90of100,test4pub25of100,1,191,13,154,14,181
test4sub16of100,test4pub25of100,1,191,13,155,14,182
test4sub1of100,test4pub25of100,1,191,13,156,15,184
test4sub84of100,test4pub25of100,1,191,13,156,15,184
test4sub73of100,test4pub25of100,1,191,13,157,16,186
test4sub92of100,test4pub25of100,1,191,13,158,15,186
test4sub40of100,test4pub25of100,1,191,13,161,14,188
test4sub82of100,test4pub24of100,1,191,18,530,3,551
test4sub41of100,test4pub25of100,1,191,13,176,4,193
test4sub82of100,test4pub25of100,1,191,13,179,2,194
test4sub4of100,test4pub25of100,1,191,13,190,1,204
test4sub79of100,test4pub24of100,1,191,18,545,2,565
test4sub22of100,test4pub25of100,1,191,13,193,1,207
test4sub79of100,test4pub25of100,1,191,13,203,1,217
test4sub49of100,test4pub24of100,1,191,18,571,1,590
test4sub49of100,test4pub25of100,1,191,13,216,1,230
test4sub98of100,test4pub24of100,1,191,18,575,0,593
test4sub98of100,test4pub25of100,1,191,13,222,1,236
test4sub71of100,test4pub24of100,1,191,18,603,1,622
test4sub93of100,test4pub24of100,1,191,18,603,1,622
test4sub71of100,test4pub25of100,1,191,13,249,1,263
test4sub93of100,test4pub25of100,1,191,13,256,1,270
test4sub46of100,test4pub24of100,1,191,18,618,1,637
test4sub46of100,test4pub25of100,1,191,13,264,1,278
test4sub3of100,test4pub25of100,1,191,13,270,1,284
test4sub12of100,test4pub25of100,1,191,13,349,1,363
test4sub38of100,test4pub26of100,1,191,10,9,1,20
test4sub34of100,test4pub26of100,1,191,10,9,1,20
test4sub24of100,test4pub26of100,1,191,10,13,1,24
test4sub52of100,test4pub26of100,1,191,10,14,2,26
test4sub40of100,test4pub26of100,1,191,10,15,1,26
test4sub69of100,test4pub26of100,1,191,10,18,1,29
test4sub25of100,test4pub26of100,1,191,10,18,1,29
test4sub55of100,test4pub26of100,1,191,10,20,1,31
test4sub17of100,test4pub26of100,1,191,10,24,1,35
test4sub41of100,test4pub26of100,1,191,10,25,1,36
test4sub11of100,test4pub26of100,1,191,10,27,2,39
test4sub73of100,test4pub26of100,1,191,10,28,2,40
test4sub61of100,test4pub26of100,1,191,10,28,2,40
test4sub3of100,test4pub26of100,1,191,10,32,2,44
test4sub46of100,test4pub26of100,1,191,10,34,2,46
test4sub60of100,test4pub26of100,1,191,10,36,2,48
test4sub21of100,test4pub26of100,1,191,10,38,1,49
test4sub88of100,test4pub26of100,1,191,10,41,1,52
test4sub5of100,test4pub22of100,1,191,15,1577,3,1595
test4sub42of100,test4pub26of100,1,191,10,43,3,56
test4sub5of100,test4pub23of100,1,191,17,1215,2,1234
test4sub74of100,test4pub26of100,1,191,10,45,4,59
test4sub84of100,test4pub26of100,1,191,10,46,4,60
test4sub79of100,test4pub26of100,1,191,10,48,2,60
test4sub100of100,test4pub26of100,1,191,10,51,2,63
test4sub5of100,test4pub24of100,1,191,18,825,2,845
test4sub26of100,test4pub26of100,1,191,10,53,1,64
test4sub35of100,test4pub26of100,1,191,10,56,3,69
test4sub86of100,test4pub26of100,1,191,10,57,2,69
test4sub70of100,test4pub26of100,1,191,10,60,1,71
test4sub32of100,test4pub26of100,1,191,10,58,2,70
test4sub10of100,test4pub26of100,1,191,10,61,1,72
test4sub18of100,test4pub26of100,1,191,10,66,1,77
test4sub87of100,test4pub26of100,1,191,10,67,2,79
test4sub76of100,test4pub26of100,1,191,10,68,1,79
test4sub4of100,test4pub26of100,1,191,10,72,1,83
test4sub5of100,test4pub25of100,1,191,13,492,1,506
test4sub63of100,test4pub26of100,1,191,10,74,3,87
test4sub31of100,test4pub26of100,1,191,10,75,2,87
test4sub14of100,test4pub26of100,1,191,10,76,3,89
test4sub75of100,test4pub26of100,1,191,10,77,3,90
test4sub57of100,test4pub26of100,1,191,10,79,3,92
test4sub47of100,test4pub26of100,1,191,10,80,2,92
test4sub44of100,test4pub26of100,1,191,10,81,1,92
test4sub8of100,test4pub26of100,1,191,10,90,1,101
test4sub16of100,test4pub26of100,1,191,10,92,1,103
test4sub68of100,test4pub26of100,1,191,10,92,1,103
test4sub89of100,test4pub26of100,1,191,10,90,3,103
test4sub54of100,test4pub26of100,1,191,10,95,1,106
test4sub1of100,test4pub26of100,1,191,10,95,2,107
test4sub43of100,test4pub26of100,1,191,10,96,2,108
test4sub97of100,test4pub26of100,1,191,10,97,2,109
test4sub23of100,test4pub26of100,1,191,10,100,0,110
test4sub13of100,test4pub26of100,1,191,10,103,1,114
test4sub81of100,test4pub26of100,1,191,10,105,1,116
test4sub15of100,test4pub26of100,1,191,10,112,1,123
test4sub19of100,test4pub26of100,1,191,10,113,1,124
test4sub78of100,test4pub26of100,1,191,10,115,0,125
test4sub95of100,test4pub26of100,1,191,10,117,1,128
test4sub64of100,test4pub26of100,1,191,10,117,1,128
test4sub12of100,test4pub26of100,1,191,10,122,1,133
test4sub45of100,test4pub26of100,1,191,10,123,1,134
test4sub93of100,test4pub26of100,1,191,10,125,6,141
test4sub72of100,test4pub26of100,1,191,10,126,5,141
test4sub92of100,test4pub26of100,1,191,10,126,6,142
test4sub58of100,test4pub26of100,1,191,10,127,6,143
test4sub67of100,test4pub26of100,1,191,10,127,6,143
test4sub53of100,test4pub26of100,1,191,10,128,6,144
test4sub49of100,test4pub26of100,1,191,10,129,5,144
test4sub37of100,test4pub26of100,1,191,10,129,5,144
test4sub85of100,test4pub26of100,1,191,10,131,5,146
test4sub22of100,test4pub26of100,1,191,10,131,5,146
test4sub98of100,test4pub26of100,1,191,10,137,2,149
test4sub71of100,test4pub26of100,1,191,10,135,4,149
test4sub27of100,test4pub26of100,1,191,10,137,3,150
test4sub82of100,test4pub26of100,1,191,10,138,3,151
test4sub83of100,test4pub26of100,1,191,10,138,3,151
test4sub39of100,test4pub24of100,1,191,18,942,1,961
test4sub39of100,test4pub25of100,1,191,13,588,0,601
test4sub39of100,test4pub26of100,1,191,10,170,0,180
test4sub30of100,test4pub24of100,1,191,18,1011,1,1030
test4sub30of100,test4pub25of100,1,191,13,657,1,671
test4sub30of100,test4pub26of100,1,191,10,239,1,250
test4sub99of100,test4pub26of100,1,191,10,363,0,373
test4sub33of100,test4pub26of100,1,191,10,375,1,386
test4sub48of100,test4pub26of100,1,191,10,395,1,406
test4sub96of100,test4pub26of100,1,191,10,396,1,407
test4sub91of100,test4pub26of100,1,191,10,400,1,411
test4sub56of100,test4pub26of100,1,191,10,402,0,412
test4sub20of100,test4pub25of100,1,191,13,826,1,840
test4sub20of100,test4pub26of100,1,191,10,407,1,418
test4sub7of100,test4pub26of100,1,191,10,411,1,422
test4sub77of100,test4pub26of100,1,191,10,415,1,426
test4sub36of100,test4pub26of100,1,191,10,496,1,507
test4sub33of100,test4pub27of100,1,191,15,4,1,20
test4sub98of100,test4pub27of100,1,191,15,10,0,25
test4sub21of100,test4pub27of100,1,191,15,15,1,31
test4sub38of100,test4pub27of100,1,191,15,16,1,32
test4sub77of100,test4pub27of100,1,191,15,21,3,39
test4sub57of100,test4pub27of100,1,191,15,22,4,41
test4sub14of100,test4pub27of100,1,191,15,24,2,41
test4sub36of100,test4pub27of100,1,191,15,25,2,42
test4sub89of100,test4pub27of100,1,191,15,30,1,46
test4sub74of100,test4pub27of100,1,191,15,31,2,48
test4sub49of100,test4pub27of100,1,191,15,32,1,48
test4sub88of100,test4pub27of100,1,191,15,36,2,53
test4sub90of100,test4pub26of100,1,191,10,546,1,557
test4sub67of100,test4pub27of100,1,191,15,42,0,57
test4sub26of100,test4pub27of100,1,191,15,45,0,60
test4sub52of100,test4pub27of100,1,191,15,51,1,67
test4sub48of100,test4pub27of100,1,191,15,54,1,70
test4sub93of100,test4pub27of100,1,191,15,57,1,73
test4sub55of100,test4pub27of100,1,191,15,57,1,73
test4sub85of100,test4pub27of100,1,191,15,60,1,76
test4sub3of100,test4pub27of100,1,191,15,60,2,77
test4sub54of100,test4pub27of100,1,191,15,62,1,78
test4sub25of100,test4pub27of100,1,191,15,64,2,81
test4sub11of100,test4pub27of100,1,191,15,64,7,86
test4sub10of100,test4pub27of100,1,191,15,65,6,86
test4sub76of100,test4pub27of100,1,191,15,67,6,88
test4sub43of100,test4pub27of100,1,191,15,68,5,88
test4sub73of100,test4pub27of100,1,191,15,68,5,88
test4sub6of100,test4pub2of100,1,190,10,534,9021,9565
test4sub66of100,test4pub2of100,1,190,10,534,9021,9565
test4sub94of100,test4pub2of100,1,190,10,535,9022,9567
test4sub1of100,test4pub27of100,1,191,15,70,12,97
test4sub18of100,test4pub27of100,1,191,15,71,14,100
test4sub65of100,test4pub26of100,1,191,10,581,13,604
test4sub28of100,test4pub26of100,1,191,10,584,12,606
test4sub7of100,test4pub27of100,1,191,15,75,12,102
test4sub6of100,test4pub3of100,1,190,14,9404,10,9428
test4sub66of100,test4pub4of100,1,190,11,8520,11,8542
test4sub95of100,test4pub27of100,1,191,15,79,11,105
test4sub68of100,test4pub27of100,1,191,15,80,10,105
test4sub46of100,test4pub27of100,1,191,15,80,11,106
test4sub59of100,test4pub26of100,1,191,10,590,10,610
test4sub94of100,test4pub3of100,1,190,14,9409,9,9432
test4sub47of100,test4pub27of100,1,191,15,83,9,107
test4sub9of100,test4pub2of100,1,190,10,544,9028,9582
test4sub51of100,test4pub2of100,1,190,10,547,9030,9587
test4sub23of100,test4pub27of100,1,191,15,85,16,116
test4sub90of100,test4pub27of100,1,191,15,87,16,118
test4sub6of100,test4pub4of100,1,190,11,8531,14,8556
test4sub66of100,test4pub3of100,1,190,14,9416,14,9444
test4sub99of100,test4pub27of100,1,191,15,93,12,120
test4sub94of100,test4pub4of100,1,190,11,8534,12,8557
test4sub9of100,test4pub3of100,1,190,14,9422,12,9448
test4sub87of100,test4pub27of100,1,191,15,96,13,124
test4sub8of100,test4pub27of100,1,191,15,97,13,125
test4sub22of100,test4pub27of100,1,191,15,97,13,125
test4sub51of100,test4pub4of100,1,190,11,8541,11,8563
test4sub97of100,test4pub27of100,1,191,15,99,13,127
test4sub31of100,test4pub27of100,1,191,15,100,13,128
test4sub100of100,test4pub27of100,1,191,15,102,11,128
test4sub66of100,test4pub5of100,1,190,32,8494,10,8536
test4sub6of100,test4pub5of100,1,190,32,8494,11,8537
test4sub9of100,test4pub5of100,1,190,32,8497,11,8540
test4sub24of100,test4pub27of100,1,191,15,108,12,135
test4sub94of100,test4pub5of100,1,190,32,8497,11,8540
test4sub53of100,test4pub27of100,1,191,15,111,11,137
test4sub51of100,test4pub3of100,1,190,14,9439,14,9467
test4sub19of100,test4pub27of100,1,191,15,115,13,143
test4sub66of100,test4pub6of100,1,190,14,8431,15,8460
test4sub61of100,test4pub27of100,1,191,15,117,14,146
test4sub6of100,test4pub6of100,1,190,14,8433,14,8461
test4sub75of100,test4pub27of100,1,191,15,118,17,150
test4sub60of100,test4pub27of100,1,191,15,119,17,151
test4sub9of100,test4pub4of100,1,190,11,8561,18,8590
test4sub96of100,test4pub27of100,1,191,15,122,22,159
test4sub94of100,test4pub6of100,1,190,14,8437,23,8474
test4sub56of100,test4pub27of100,1,191,15,123,22,160
test4sub83of100,test4pub27of100,1,191,15,124,22,161
test4sub72of100,test4pub27of100,1,191,15,124,23,162
test4sub92of100,test4pub27of100,1,191,15,125,22,162
test4sub71of100,test4pub27of100,1,191,15,126,22,163
test4sub51of100,test4pub5of100,1,190,32,8517,21,8570
test4sub86of100,test4pub27of100,1,191,15,128,21,164
test4sub44of100,test4pub27of100,1,191,15,129,20,164
test4sub17of100,test4pub27of100,1,191,15,129,21,165
test4sub66of100,test4pub7of100,1,190,18,8311,19,8348
test4sub16of100,test4pub27of100,1,191,15,133,19,167
test4sub78of100,test4pub27of100,1,191,15,134,18,167
test4sub81of100,test4pub27of100,1,191,15,134,19,168
test4sub6of100,test4pub7of100,1,190,18,8312,19,8349
test4sub12of100,test4pub27of100,1,191,15,135,21,171
test4sub64of100,test4pub27of100,1,191,15,137,20,172
test4sub27of100,test4pub27of100,1,191,15,138,20,173
test4sub15of100,test4pub27of100,1,191,15,138,20,173
test4sub45of100,test4pub27of100,1,191,15,140,20,175
test4sub37of100,test4pub27of100,1,191,15,141,19,175
test4sub9of100,test4pub6of100,1,190,14,8456,20,8490
test4sub20of100,test4pub27of100,1,191,15,142,19,176
test4sub30of100,test4pub27of100,1,191,15,142,20,177
test4sub65of100,test4pub27of100,1,191,15,143,20,178
test4sub59of100,test4pub27of100,1,191,15,145,17,177
test4sub94of100,test4pub7of100,1,190,18,8325,16,8359
test4sub51of100,test4pub6of100,1,190,14,8465,14,8493
test4sub6of100,test4pub8of100,1,190,16,8186,10,8212
test4sub66of100,test4pub8of100,1,190,16,8183,8,8207
test4sub9of100,test4pub7of100,1,190,18,8340,6,8364
test4sub94of100,test4pub8of100,1,190,16,8195,4,8215
test4sub51of100,test4pub7of100,1,190,18,8343,5,8366
test4sub6of100,test4pub9of100,1,190,13,8092,4,8109
test4sub66of100,test4pub9of100,1,190,13,8093,6,8112
test4sub9of100,test4pub8of100,1,190,16,8200,4,8220
test4sub94of100,test4pub9of100,1,190,13,8095,6,8114
test4sub51of100,test4pub8of100,1,190,16,8202,5,8223
test4sub6of100,test4pub10of100,1,191,16,7973,5,7994
test4sub9of100,test4pub9of100,1,190,13,8100,4,8117
test4sub66of100,test4pub10of100,1,191,16,7975,6,7997
test4sub51of100,test4pub9of100,1,190,13,8103,3,8119
test4sub94of100,test4pub10of100,1,191,16,7977,5,7998
test4sub6of100,test4pub11of100,1,191,13,7220,3,7236
test4sub9of100,test4pub10of100,1,191,16,7980,5,8001
test4sub66of100,test4pub11of100,1,191,13,7222,4,7239
test4sub51of100,test4pub10of100,1,191,16,7983,5,8004
test4sub6of100,test4pub12of100,1,191,11,6781,4,6796
test4sub94of100,test4pub11of100,1,191,13,7224,6,7243
test4sub9of100,test4pub11of100,1,191,13,7227,3,7243
test4sub66of100,test4pub12of100,1,191,11,6783,5,6799
test4sub51of100,test4pub11of100,1,191,13,7229,3,7245
test4sub6of100,test4pub13of100,1,191,10,6435,5,6450
test4sub94of100,test4pub12of100,1,191,11,6787,4,6802
test4sub9of100,test4pub12of100,1,191,11,6787,4,6802
test4sub66of100,test4pub13of100,1,191,10,6440,2,6452
test4sub51of100,test4pub12of100,1,191,11,6790,1,6802
test4sub6of100,test4pub14of100,1,191,11,6199,2,6212
test4sub9of100,test4pub13of100,1,191,10,6544,2,6556
test4sub94of100,test4pub13of100,1,191,10,6544,4,6558
test4sub51of100,test4pub13of100,1,191,10,6544,4,6558
test4sub66of100,test4pub14of100,1,191,11,6200,7,6218
test4sub9of100,test4pub14of100,1,191,11,6205,4,6220
test4sub6of100,test4pub15of100,1,191,11,5834,5,5850
test4sub9of100,test4pub15of100,1,191,11,5841,8,5860
test4sub29of100,test4pub23of100,1,191,17,1995,2,2014
test4sub29of100,test4pub24of100,1,191,18,1606,1,1625
test4sub51of100,test4pub14of100,1,191,11,6207,20,6238
test4sub94of100,test4pub14of100,1,191,11,6207,21,6239
test4sub6of100,test4pub16of100,1,191,16,5390,19,5425
test4sub29of100,test4pub25of100,1,191,13,1252,3,1268
test4sub9of100,test4pub16of100,1,191,16,5401,10,5427
test4sub51of100,test4pub15of100,1,191,11,5859,5,5875
test4sub66of100,test4pub15of100,1,191,11,5840,5,5856
test4sub94of100,test4pub15of100,1,191,11,5861,6,5878
test4sub6of100,test4pub17of100,1,191,15,5005,6,5026
test4sub29of100,test4pub26of100,1,191,10,838,6,854
test4sub9of100,test4pub17of100,1,191,15,5009,4,5028
test4sub66of100,test4pub16of100,1,191,16,5415,5,5436
test4sub51of100,test4pub16of100,1,191,16,5414,6,5436
test4sub6of100,test4pub18of100,1,191,16,4557,6,4579
test4sub94of100,test4pub16of100,1,191,16,5417,6,5439
test4sub29of100,test4pub27of100,1,191,15,337,5,357
test4sub66of100,test4pub17of100,1,191,15,5016,5,5036
test4sub9of100,test4pub18of100,1,191,16,4559,5,4580
test4sub51of100,test4pub17of100,1,191,15,5018,5,5038
test4sub6of100,test4pub19of100,1,191,32,3931,4,3967
test4sub94of100,test4pub17of100,1,191,15,5020,5,5040
test4sub6of100,test4pub20of100,1,191,18,3385,1,3404
test4sub51of100,test4pub18of100,1,191,16,4568,2,4586
test4sub66of100,test4pub18of100,1,191,16,4566,4,4586
test4sub9of100,test4pub19of100,1,191,32,3934,3,3969
test4sub32of100,test4pub27of100,1,191,15,349,3,367
test4sub66of100,test4pub19of100,1,191,32,3941,5,3978
test4sub51of100,test4pub19of100,1,191,32,3940,4,3976
test4sub6of100,test4pub21of100,1,191,21,2754,5,2780
test4sub94of100,test4pub18of100,1,191,16,4569,7,4592
test4sub40of100,test4pub27of100,1,191,15,353,6,374
test4sub9of100,test4pub20of100,1,191,18,3390,9,3417
test4sub91of100,test4pub27of100,1,191,15,354,8,377
test4sub66of100,test4pub20of100,1,191,18,3395,6,3419
test4sub51of100,test4pub20of100,1,191,18,3396,7,3421
test4sub6of100,test4pub22of100,1,191,15,2404,6,2425
test4sub94of100,test4pub19of100,1,191,32,3951,4,3987
test4sub9of100,test4pub21of100,1,191,21,2767,6,2794
test4sub66of100,test4pub21of100,1,191,21,2769,6,2796
test4sub6of100,test4pub23of100,1,191,17,2045,3,2065
test4sub94of100,test4pub20of100,1,191,18,3406,6,3430
test4sub51of100,test4pub21of100,1,191,21,2771,6,2798
test4sub9of100,test4pub22of100,1,191,15,2413,6,2434
test4sub66of100,test4pub22of100,1,191,15,2415,7,2437
test4sub6of100,test4pub24of100,1,191,18,1656,8,1682
test4sub63of100,test4pub27of100,1,191,15,373,9,397
test4sub94of100,test4pub21of100,1,191,21,2778,8,2807
test4sub41of100,test4pub27of100,1,191,15,376,7,398
test4sub13of100,test4pub27of100,1,191,15,376,7,398
test4sub51of100,test4pub22of100,1,191,15,2420,8,2443
test4sub9of100,test4pub23of100,1,191,17,2054,8,2079
test4sub69of100,test4pub27of100,1,191,15,377,9,401
test4sub66of100,test4pub23of100,1,191,17,2058,8,2083
test4sub59of100,test4pub28of100,1,191,16,10,9,35
test4sub6of100,test4pub25of100,1,191,13,1309,8,1330
test4sub94of100,test4pub22of100,1,191,15,2428,6,2449
test4sub9of100,test4pub24of100,1,191,18,1671,5,1694
test4sub51of100,test4pub23of100,1,191,17,2064,6,2087
test4sub66of100,test4pub24of100,1,191,18,1673,4,1695
test4sub6of100,test4pub26of100,1,191,10,899,3,912
test4sub94of100,test4pub23of100,1,191,17,2069,4,2090
test4sub66of100,test4pub25of100,1,191,13,1322,2,1337
test4sub9of100,test4pub25of100,1,191,13,1321,2,1336
test4sub51of100,test4pub24of100,1,191,18,1677,3,1698
test4sub9of100,test4pub26of100,1,191,10,905,2,917
test4sub66of100,test4pub26of100,1,191,10,905,0,915
test4sub94of100,test4pub24of100,1,191,18,1680,2,1700
test4sub66of100,test4pub27of100,1,191,15,400,2,417
test4sub51of100,test4pub25of100,1,191,13,1326,3,1342
test4sub94of100,test4pub25of100,1,191,13,1329,1,1343
test4sub94of100,test4pub26of100,1,191,10,912,2,924
test4sub34of100,test4pub27of100,1,191,15,403,2,420
test4sub75of100,test4pub28of100,1,191,16,35,3,54
test4sub51of100,test4pub26of100,1,191,10,912,4,926
test4sub89of100,test4pub28of100,1,191,16,38,2,56
test4sub67of100,test4pub28of100,1,191,16,38,2,56
test4sub94of100,test4pub27of100,1,191,15,406,4,425
test4sub66of100,test4pub28of100,1,191,16,41,3,60
test4sub53of100,test4pub28of100,1,191,16,42,3,61
test4sub42of100,test4pub27of100,1,191,15,414,3,432
test4sub92of100,test4pub28of100,1,191,16,46,2,64
test4sub69of100,test4pub28of100,1,191,16,45,3,64
test4sub96of100,test4pub28of100,1,191,16,41,5,62
test4sub51of100,test4pub27of100,1,191,15,409,3,427
test4sub65of100,test4pub28of100,1,191,16,50,1,67
test4sub29of100,test4pub28of100,1,191,16,51,0,67
test4sub95of100,test4pub28of100,1,191,16,53,3,72
test4sub73of100,test4pub28of100,1,191,16,53,4,73
test4sub18of100,test4pub28of100,1,191,16,54,4,74
test4sub64of100,test4pub28of100,1,191,16,55,5,76
test4sub63of100,test4pub28of100,1,191,16,56,6,78
test4sub16of100,test4pub28of100,1,191,16,57,8,81
test4sub49of100,test4pub28of100,1,191,16,59,6,81
test4sub38of100,test4pub28of100,1,191,16,60,5,81
test4sub36of100,test4pub28of100,1,191,16,61,5,82
test4sub35of100,test4pub27of100,1,191,15,432,4,451
test4sub31of100,test4pub28of100,1,191,16,64,8,88
test4sub61of100,test4pub28of100,1,191,16,65,8,89
test4sub70of100,test4pub27of100,1,191,15,436,6,457
test4sub15of100,test4pub28of100,1,191,16,68,6,90
test4sub74of100,test4pub28of100,1,191,16,69,5,90
test4sub19of100,test4pub28of100,1,191,16,69,6,91
test4sub14of100,test4pub28of100,1,191,16,70,6,92
test4sub17of100,test4pub28of100,1,191,16,71,5,92
test4sub77of100,test4pub28of100,1,191,16,74,4,94
test4sub22of100,test4pub28of100,1,191,16,76,1,93
test4sub10of100,test4pub28of100,1,191,16,83,1,100
test4sub32of100,test4pub28of100,1,191,16,81,5,102
test4sub9of100,test4pub27of100,1,191,15,453,3,471
test4sub87of100,test4pub28of100,1,191,16,82,5,103
test4sub88of100,test4pub28of100,1,191,16,85,2,103
test4sub91of100,test4pub28of100,1,191,16,85,4,105
test4sub37of100,test4pub28of100,1,191,16,88,1,105
test4sub40of100,test4pub28of100,1,191,16,89,1,106
test4sub3of100,test4pub28of100,1,191,16,91,1,108
test4sub24of100,test4pub28of100,1,191,16,93,0,109
test4sub98of100,test4pub28of100,1,191,16,96,0,112
test4sub99of100,test4pub28of100,1,191,16,95,2,113
test4sub76of100,test4pub28of100,1,191,16,97,4,117
test4sub11of100,test4pub28of100,1,191,16,101,2,119
test4sub27of100,test4pub28of100,1,191,16,101,3,120
test4sub84of100,test4pub27of100,1,191,15,471,1,487
test4sub30of100,test4pub28of100,1,191,16,106,2,124
test4sub78of100,test4pub28of100,1,191,16,106,2,124
test4sub7of100,test4pub28of100,1,191,16,107,2,125
test4sub20of100,test4pub28of100,1,191,16,109,1,126
test4sub6of100,test4pub27of100,1,191,15,479,1,495
test4sub97of100,test4pub28of100,1,191,16,115,1,132
test4sub51of100,test4pub28of100,1,191,16,115,1,132
test4sub85of100,test4pub28of100,1,191,16,159,1,176
test4sub44of100,test4pub28of100,1,191,16,161,1,178
test4sub72of100,test4pub28of100,1,191,16,162,1,179
test4sub45of100,test4pub28of100,1,191,16,166,0,182
test4sub42of100,test4pub28of100,1,191,16,166,1,183
test4sub12of100,test4pub28of100,1,191,16,172,0,188
test4sub39of100,test4pub27of100,1,191,15,544,1,560
test4sub94of100,test4pub28of100,1,191,16,176,0,192
test4sub71of100,test4pub28of100,1,191,16,179,1,196
test4sub54of100,test4pub28of100,1,191,16,180,2,198
test4sub57of100,test4pub28of100,1,191,16,181,1,198
test4sub60of100,test4pub28of100,1,191,16,182,1,199
test4sub43of100,test4pub28of100,1,191,16,188,1,205
test4sub81of100,test4pub28of100,1,191,16,187,2,205
test4sub23of100,test4pub28of100,1,191,16,190,2,208
test4sub86of100,test4pub28of100,1,191,16,189,5,210
test4sub93of100,test4pub28of100,1,191,16,190,4,210
test4sub79of100,test4pub27of100,1,191,15,560,3,578
test4sub25of100,test4pub28of100,1,191,16,192,7,215
test4sub55of100,test4pub28of100,1,191,16,193,7,216
test4sub41of100,test4pub28of100,1,191,16,196,6,218
test4sub56of100,test4pub28of100,1,191,16,196,9,221
test4sub33of100,test4pub28of100,1,191,16,197,9,222
test4sub68of100,test4pub28of100,1,191,16,198,9,223
test4sub35of100,test4pub28of100,1,191,16,198,11,225
test4sub52of100,test4pub28of100,1,191,16,199,10,225
test4sub34of100,test4pub28of100,1,191,16,200,10,226
test4sub21of100,test4pub28of100,1,191,16,202,8,226
test4sub8of100,test4pub28of100,1,191,16,202,8,226
test4sub70of100,test4pub28of100,1,191,16,204,7,227
test4sub1of100,test4pub28of100,1,191,16,206,5,227
test4sub26of100,test4pub28of100,1,191,16,207,7,230
test4sub58of100,test4pub27of100,1,191,15,577,6,598
test4sub9of100,test4pub28of100,1,191,16,208,7,231
test4sub4of100,test4pub27of100,1,191,15,582,3,600
test4sub84of100,test4pub28of100,1,191,16,213,3,232
test4sub6of100,test4pub28of100,1,191,16,215,2,233
test4sub90of100,test4pub28of100,1,191,16,224,1,241
test4sub39of100,test4pub28of100,1,191,16,225,1,242
test4sub62of100,test4pub25of100,1,191,13,1525,1,1539
test4sub79of100,test4pub28of100,1,191,16,236,1,253
test4sub58of100,test4pub28of100,1,191,16,247,1,264
test4sub4of100,test4pub28of100,1,191,16,249,1,266
test4sub2of100,test4pub26of100,1,191,10,1128,1,1139
test4sub46of100,test4pub28of100,1,191,16,252,1,269
test4sub2of100,test4pub27of100,1,191,15,621,1,637
test4sub47of100,test4pub28of100,1,191,16,254,3,273
test4sub62of100,test4pub26of100,1,191,10,1134,2,1146
test4sub2of100,test4pub28of100,1,191,16,256,2,274
test4sub62of100,test4pub27of100,1,191,15,627,1,643
test4sub62of100,test4pub28of100,1,191,16,261,1,278
test4sub82of100,test4pub27of100,1,191,15,662,1,678
test4sub82of100,test4pub28of100,1,191,16,294,1,311
test4sub48of100,test4pub28of100,1,191,16,353,0,369
test4sub13of100,test4pub28of100,1,191,16,361,1,378
test4sub5of100,test4pub26of100,1,191,10,1255,1,1266
test4sub5of100,test4pub27of100,1,191,15,748,0,763
test4sub5of100,test4pub28of100,1,191,16,381,1,398
test4sub83of100,test4pub28of100,1,191,16,381,1,398
test4sub100of100,test4pub28of100,1,191,16,473,1,490
test4sub76of100,test4pub29of100,1,191,12,6,1,19
test4sub91of100,test4pub29of100,1,191,12,7,1,20
test4sub59of100,test4pub29of100,1,191,12,12,1,25
test4sub83of100,test4pub29of100,1,191,12,14,1,27
test4sub58of100,test4pub29of100,1,191,12,17,1,30
test4sub20of100,test4pub29of100,1,191,12,18,1,31
test4sub57of100,test4pub29of100,1,191,12,21,1,34
test4sub2of100,test4pub29of100,1,191,12,22,1,35
test4sub31of100,test4pub29of100,1,191,12,23,1,36
test4sub69of100,test4pub29of100,1,191,12,31,1,44
test4sub17of100,test4pub29of100,1,191,12,34,1,47
test4sub26of100,test4pub29of100,1,191,12,37,1,50
test4sub1of100,test4pub29of100,1,191,12,38,2,52
test4sub64of100,test4pub29of100,1,191,12,39,2,53
test4sub42of100,test4pub29of100,1,191,12,39,4,55
test4sub52of100,test4pub29of100,1,191,12,40,4,56
test4sub62of100,test4pub29of100,1,191,12,42,2,56
test4sub14of100,test4pub29of100,1,191,12,45,1,58
test4sub12of100,test4pub29of100,1,191,12,42,5,59
test4sub85of100,test4pub29of100,1,191,12,44,6,62
test4sub5of100,test4pub29of100,1,191,12,46,5,63
test4sub90of100,test4pub29of100,1,191,12,47,5,64
test4sub51of100,test4pub29of100,1,191,12,49,4,65
test4sub100of100,test4pub29of100,1,191,12,49,4,65
test4sub89of100,test4pub29of100,1,191,12,50,3,65
test4sub99of100,test4pub29of100,1,191,12,51,4,67
test4sub43of100,test4pub29of100,1,191,12,54,3,69
test4sub95of100,test4pub29of100,1,191,12,56,3,71
test4sub53of100,test4pub29of100,1,191,12,56,2,70
test4sub3of100,test4pub29of100,1,191,12,57,2,71
test4sub11of100,test4pub29of100,1,191,12,80,0,92
test4sub21of100,test4pub29of100,1,191,12,83,1,96
test4sub77of100,test4pub29of100,1,191,12,83,2,97
test4sub36of100,test4pub29of100,1,191,12,84,1,97
test4sub6of100,test4pub29of100,1,191,12,85,2,99
test4sub18of100,test4pub29of100,1,191,12,87,1,100
test4sub39of100,test4pub29of100,1,191,12,89,1,102
test4sub37of100,test4pub29of100,1,191,12,92,4,108
test4sub9of100,test4pub29of100,1,191,12,92,4,108
test4sub81of100,test4pub29of100,1,191,12,93,5,110
test4sub35of100,test4pub29of100,1,191,12,89,10,111
test4sub92of100,test4pub29of100,1,191,12,92,8,112
test4sub34of100,test4pub29of100,1,191,12,93,8,113
test4sub88of100,test4pub29of100,1,191,12,95,9,116
test4sub79of100,test4pub29of100,1,191,12,96,10,118
test4sub72of100,test4pub29of100,1,191,12,98,10,120
test4sub49of100,test4pub29of100,1,191,12,97,19,128
test4sub87of100,test4pub29of100,1,191,12,90,27,129
test4sub38of100,test4pub29of100,1,191,12,94,24,130
test4sub40of100,test4pub29of100,1,191,12,99,19,130
test4sub45of100,test4pub29of100,1,191,12,100,19,131
test4sub24of100,test4pub29of100,1,191,12,102,17,131
test4sub19of100,test4pub29of100,1,191,12,102,18,132
test4sub15of100,test4pub29of100,1,191,12,102,17,131
test4sub32of100,test4pub29of100,1,191,12,103,32,147
test4sub27of100,test4pub29of100,1,191,12,105,31,148
test4sub8of100,test4pub29of100,1,191,12,106,32,150
test4sub44of100,test4pub29of100,1,191,12,107,31,150
test4sub70of100,test4pub29of100,1,191,12,108,31,151
test4sub25of100,test4pub29of100,1,191,12,109,31,152
test4sub60of100,test4pub29of100,1,191,12,110,31,153
test4sub82of100,test4pub29of100,1,191,12,110,32,154
test4sub7of100,test4pub29of100,1,191,12,112,32,156
test4sub86of100,test4pub29of100,1,191,12,113,32,157
test4sub56of100,test4pub29of100,1,191,12,112,33,157
test4sub75of100,test4pub29of100,1,191,12,114,32,158
test4sub16of100,test4pub29of100,1,191,12,114,32,158
test4sub66of100,test4pub29of100,1,191,12,115,32,159
test4sub29of100,test4pub29of100,1,191,12,117,31,160
test4sub98of100,test4pub29of100,1,191,12,117,31,160
test4sub71of100,test4pub29of100,1,191,12,118,32,162
test4sub47of100,test4pub29of100,1,191,12,122,29,163
test4sub33of100,test4pub29of100,1,191,12,122,30,164
test4sub23of100,test4pub29of100,1,191,12,122,30,164
test4sub73of100,test4pub29of100,1,191,12,123,31,166
test4sub4of100,test4pub29of100,1,191,12,124,31,167
test4sub10of100,test4pub29of100,1,191,12,126,31,169
test4sub68of100,test4pub29of100,1,191,12,128,29,169
test4sub61of100,test4pub29of100,1,191,12,129,29,170
test4sub74of100,test4pub29of100,1,191,12,172,2,186
test4sub63of100,test4pub29of100,1,191,12,172,3,187
test4sub48of100,test4pub29of100,1,191,12,174,2,188
test4sub30of100,test4pub29of100,1,191,12,178,7,197
test4sub78of100,test4pub29of100,1,191,12,180,7,199
test4sub96of100,test4pub29of100,1,191,12,180,7,199
test4sub97of100,test4pub29of100,1,191,12,182,6,200
test4sub41of100,test4pub29of100,1,191,12,183,6,201
test4sub84of100,test4pub29of100,1,191,12,184,5,201
test4sub28of100,test4pub27of100,1,191,15,1041,1,1057
test4sub28of100,test4pub28of100,1,191,16,674,1,691
test4sub28of100,test4pub29of100,1,191,12,203,1,216
test4sub92of100,test4pub30of100,1,191,11,7,2,20
test4sub90of100,test4pub30of100,1,191,11,8,1,20
test4sub97of100,test4pub30of100,1,191,11,8,1,20
test4sub19of100,test4pub30of100,1,191,11,16,1,28
test4sub96of100,test4pub30of100,1,191,11,23,2,36
test4sub68of100,test4pub30of100,1,191,11,23,2,36
test4sub13of100,test4pub29of100,1,191,12,379,1,392
test4sub100of100,test4pub30of100,1,191,11,31,1,43
test4sub27of100,test4pub30of100,1,191,11,32,2,45
test4sub42of100,test4pub30of100,1,191,11,33,1,45
test4sub47of100,test4pub30of100,1,191,11,47,2,60
test4sub77of100,test4pub30of100,1,191,11,48,5,64
test4sub54of100,test4pub29of100,1,191,12,404,5,421
test4sub34of100,test4pub30of100,1,191,11,51,4,66
test4sub38of100,test4pub30of100,1,191,11,51,4,66
test4sub86of100,test4pub30of100,1,191,11,52,9,72
test4sub31of100,test4pub30of100,1,191,11,53,13,77
test4sub75of100,test4pub30of100,1,191,11,49,17,77
test4sub84of100,test4pub30of100,1,191,11,55,12,78
test4sub83of100,test4pub30of100,1,191,11,56,11,78
test4sub76of100,test4pub30of100,1,191,11,56,11,78
test4sub66of100,test4pub30of100,1,191,11,57,11,79
test4sub17of100,test4pub30of100,1,191,11,57,11,79
test4sub51of100,test4pub30of100,1,191,11,59,11,81
test4sub60of100,test4pub30of100,1,191,11,59,10,80
test4sub9of100,test4pub30of100,1,191,11,60,10,81
test4sub57of100,test4pub30of100,1,191,11,60,10,81
test4sub40of100,test4pub30of100,1,191,11,61,9,81
test4sub3of100,test4pub30of100,1,191,11,62,7,80
test4sub14of100,test4pub30of100,1,191,11,63,7,81
test4sub23of100,test4pub30of100,1,191,11,62,7,80
test4sub16of100,test4pub30of100,1,191,11,62,8,81
test4sub43of100,test4pub30of100,1,191,11,63,8,82
test4sub64of100,test4pub30of100,1,191,11,63,7,81
test4sub21of100,test4pub30of100,1,191,11,63,8,82
test4sub87of100,test4pub30of100,1,191,11,96,1,108
test4sub63of100,test4pub30of100,1,191,11,97,3,111
test4sub12of100,test4pub30of100,1,191,11,98,2,111
test4sub8of100,test4pub30of100,1,191,11,99,3,113
test4sub69of100,test4pub30of100,1,191,11,100,1,112
test4sub2of100,test4pub30of100,1,191,11,104,1,116
test4sub59of100,test4pub30of100,1,191,11,108,1,120
test4sub94of100,test4pub29of100,1,191,12,468,0,480
test4sub99of100,test4pub30of100,1,191,11,115,1,127
test4sub6of100,test4pub30of100,1,191,11,117,1,129
test4sub72of100,test4pub30of100,1,191,11,115,4,130
test4sub82of100,test4pub30of100,1,191,11,117,3,131
test4sub61of100,test4pub30of100,1,191,11,118,2,131
test4sub58of100,test4pub30of100,1,191,11,119,3,133
test4sub36of100,test4pub30of100,1,191,11,121,2,134
test4sub18of100,test4pub30of100,1,191,11,122,2,135
test4sub74of100,test4pub30of100,1,191,11,124,0,135
test4sub7of100,test4pub30of100,1,191,11,125,1,137
test4sub28of100,test4pub30of100,1,191,11,128,1,140
test4sub73of100,test4pub30of100,1,191,11,128,2,141
test4sub41of100,test4pub30of100,1,191,11,129,5,145
test4sub30of100,test4pub30of100,1,191,11,130,5,146
test4sub13of100,test4pub30of100,1,191,11,131,4,146
test4sub70of100,test4pub30of100,1,191,11,132,5,148
test4sub91of100,test4pub30of100,1,191,11,133,3,147
test4sub29of100,test4pub30of100,1,191,11,133,5,149
test4sub5of100,test4pub30of100,1,191,11,134,6,151
test4sub22of100,test4pub29of100,1,191,12,492,4,508
test4sub89of100,test4pub30of100,1,191,11,138,3,152
test4sub39of100,test4pub30of100,1,191,11,139,4,154
test4sub52of100,test4pub30of100,1,191,11,140,3,154
test4sub81of100,test4pub30of100,1,191,11,142,2,155
test4sub35of100,test4pub30of100,1,191,11,144,2,157
test4sub49of100,test4pub30of100,1,191,11,146,1,158
test4sub56of100,test4pub30of100,1,191,11,148,1,160
test4sub85of100,test4pub30of100,1,191,11,151,4,166
test4sub79of100,test4pub30of100,1,191,11,152,4,167
test4sub1of100,test4pub30of100,1,191,11,151,7,169
test4sub44of100,test4pub30of100,1,191,11,151,8,170
test4sub33of100,test4pub30of100,1,191,11,153,7,171
test4sub15of100,test4pub30of100,1,191,11,154,7,172
test4sub20of100,test4pub30of100,1,191,11,156,5,172
test4sub11of100,test4pub30of100,1,191,11,158,5,174
test4sub95of100,test4pub30of100,1,191,11,159,4,174
test4sub53of100,test4pub30of100,1,191,11,159,3,173
test4sub62of100,test4pub30of100,1,191,11,167,13,191
test4sub45of100,test4pub30of100,1,191,11,169,12,192
test4sub98of100,test4pub30of100,1,191,11,170,12,193
test4sub24of100,test4pub30of100,1,191,11,172,10,193
test4sub10of100,test4pub30of100,1,191,11,173,10,194
test4sub46of100,test4pub29of100,1,191,12,529,10,551
test4sub94of100,test4pub30of100,1,191,11,174,11,196
test4sub65of100,test4pub29of100,1,191,12,531,10,553
test4sub37of100,test4pub30of100,1,191,11,176,12,199
test4sub93of100,test4pub29of100,1,191,12,532,12,556
test4sub22of100,test4pub30of100,1,191,11,179,12,202
test4sub88of100,test4pub30of100,1,191,11,187,4,202
test4sub55of100,test4pub29of100,1,191,12,543,5,560
test4sub65of100,test4pub30of100,1,191,11,194,6,211
test4sub93of100,test4pub30of100,1,191,11,195,6,212
test4sub71of100,test4pub30of100,1,191,11,197,10,218
test4sub46of100,test4pub30of100,1,191,11,198,10,219
test4sub25of100,test4pub30of100,1,191,11,199,10,220
test4sub55of100,test4pub30of100,1,191,11,206,3,220
test4sub50of100,test4pub1of100,1,318,24,1941,9058,11023
test4sub80of100,test4pub1of100,1,318,24,1960,9079,11063
test4sub50of100,test4pub3of100,1,190,14,10829,39,10882
test4sub80of100,test4pub4of100,1,190,11,9984,1,9996
test4sub50of100,test4pub4of100,1,190,11,9985,2,9998
test4sub80of100,test4pub3of100,1,190,14,10871,1,10886
test4sub50of100,test4pub5of100,1,190,32,9935,1,9968
test4sub80of100,test4pub5of100,1,190,32,9937,0,9969
test4sub50of100,test4pub6of100,1,190,14,9863,1,9878
test4sub50of100,test4pub7of100,1,190,18,9728,1,9747
test4sub80of100,test4pub6of100,1,190,14,9865,1,9880
test4sub80of100,test4pub7of100,1,190,18,9730,1,9749
test4sub50of100,test4pub8of100,1,190,16,9582,1,9599
test4sub50of100,test4pub9of100,1,190,13,9479,1,9493
test4sub80of100,test4pub8of100,1,190,16,9584,1,9601
test4sub80of100,test4pub9of100,1,190,13,9482,1,9496
test4sub50of100,test4pub10of100,1,191,16,9357,1,9374
test4sub50of100,test4pub11of100,1,191,13,8599,7,8619
test4sub80of100,test4pub10of100,1,191,16,9359,7,9382
test4sub80of100,test4pub11of100,1,191,13,8607,0,8620
test4sub50of100,test4pub12of100,1,191,11,8163,1,8175
test4sub48of100,test4pub30of100,1,191,11,371,1,383
test4sub50of100,test4pub13of100,1,191,10,7815,2,7827
test4sub80of100,test4pub12of100,1,191,11,8165,1,8177
test4sub50of100,test4pub14of100,1,191,11,7474,1,7486
test4sub80of100,test4pub13of100,1,191,10,7819,1,7830
test4sub50of100,test4pub15of100,1,191,11,7107,1,7119
test4sub80of100,test4pub14of100,1,191,11,7476,1,7488
test4sub50of100,test4pub16of100,1,191,16,6658,8,6682
test4sub78of100,test4pub30of100,1,191,11,380,7,398
test4sub32of100,test4pub30of100,1,191,11,381,6,398
test4sub26of100,test4pub30of100,1,191,11,382,6,399
test4sub54of100,test4pub30of100,1,191,11,383,6,400
test4sub80of100,test4pub15of100,1,191,11,7110,6,7127
test4sub50of100,test4pub17of100,1,191,15,6262,2,6279
test4sub50of100,test4pub18of100,1,191,16,5809,1,5826
test4sub80of100,test4pub16of100,1,191,16,6670,1,6687
test4sub50of100,test4pub19of100,1,191,32,5179,1,5212
test4sub80of100,test4pub17of100,1,191,15,6268,2,6285
test4sub50of100,test4pub20of100,1,191,18,4631,1,4650
test4sub80of100,test4pub18of100,1,191,16,5814,1,5831
test4sub50of100,test4pub21of100,1,191,21,3999,1,4021
test4sub80of100,test4pub19of100,1,191,32,5184,1,5217
test4sub50of100,test4pub22of100,1,191,15,3641,6,3662
test4sub80of100,test4pub20of100,1,191,18,4636,6,4660
test4sub50of100,test4pub23of100,1,191,17,3282,1,3300
test4sub80of100,test4pub21of100,1,191,21,4009,2,4032
test4sub80of100,test4pub22of100,1,191,15,3651,0,3666
test4sub50of100,test4pub24of100,1,191,18,2891,1,2910
test4sub50of100,test4pub25of100,1,191,13,2537,1,2551
test4sub80of100,test4pub23of100,1,191,17,3287,1,3305
test4sub50of100,test4pub26of100,1,191,10,2119,9,2138
test4sub74of100,test4pub31of100,1,191,17,21,11,49
test4sub94of100,test4pub31of100,1,191,17,22,10,49
test4sub80of100,test4pub24of100,1,191,18,2895,11,2924
test4sub45of100,test4pub31of100,1,191,17,28,6,51
test4sub66of100,test4pub31of100,1,191,17,30,4,51
test4sub50of100,test4pub27of100,1,191,15,1620,5,1640
test4sub81of100,test4pub31of100,1,191,17,33,4,54
test4sub80of100,test4pub25of100,1,191,13,2554,3,2570
test4sub65of100,test4pub31of100,1,191,17,37,1,55
test4sub50of100,test4pub28of100,1,191,16,1258,2,1276
test4sub80of100,test4pub26of100,1,191,10,2138,2,2150
test4sub50of100,test4pub29of100,1,191,12,788,2,802
test4sub93of100,test4pub31of100,1,191,17,42,3,62
test4sub86of100,test4pub31of100,1,191,17,43,2,62
test4sub50of100,test4pub30of100,1,191,11,436,3,450
test4sub15of100,test4pub31of100,1,191,17,45,2,64
test4sub80of100,test4pub27of100,1,191,15,1632,4,1651
test4sub61of100,test4pub31of100,1,191,17,47,1,65
test4sub80of100,test4pub28of100,1,191,16,1270,1,1287
test4sub56of100,test4pub31of100,1,191,17,50,2,69
test4sub36of100,test4pub31of100,1,191,17,51,2,70
test4sub80of100,test4pub29of100,1,191,12,799,3,814
test4sub44of100,test4pub31of100,1,191,17,52,5,74
test4sub32of100,test4pub31of100,1,191,17,53,5,75
test4sub11of100,test4pub31of100,1,191,17,51,5,73
test4sub99of100,test4pub31of100,1,191,17,55,4,76
test4sub79of100,test4pub31of100,1,191,17,56,4,77
test4sub8of100,test4pub31of100,1,191,17,56,5,78
test4sub80of100,test4pub30of100,1,191,11,451,2,464
test4sub22of100,test4pub31of100,1,191,17,60,2,79
test4sub95of100,test4pub31of100,1,191,17,63,1,81
test4sub80of100,test4pub31of100,1,191,17,63,1,81
test4sub49of100,test4pub31of100,1,191,17,65,1,83
test4sub70of100,test4pub31of100,1,191,17,67,1,85
test4sub92of100,test4pub31of100,1,191,17,73,1,91
test4sub48of100,test4pub31of100,1,191,17,76,1,94
test4sub69of100,test4pub31of100,1,191,17,76,1,94
test4sub7of100,test4pub31of100,1,191,17,78,1,96
test4sub77of100,test4pub31of100,1,191,17,80,1,98
test4sub63of100,test4pub31of100,1,191,17,82,1,100
test4sub54of100,test4pub31of100,1,191,17,81,2,100
test4sub21of100,test4pub31of100,1,191,17,85,22,124
test4sub3of100,test4pub31of100,1,191,17,86,22,125
test4sub41of100,test4pub31of100,1,191,17,88,21,126
test4sub60of100,test4pub31of100,1,191,17,89,20,126
test4sub55of100,test4pub31of100,1,191,17,91,19,127
test4sub4of100,test4pub30of100,1,191,11,485,20,516
test4sub35of100,test4pub31of100,1,191,17,93,20,130
test4sub9of100,test4pub31of100,1,191,17,93,21,131
test4sub1of100,test4pub31of100,1,191,17,91,21,129
test4sub33of100,test4pub31of100,1,191,17,95,19,131
test4sub72of100,test4pub31of100,1,191,17,96,19,132
test4sub31of100,test4pub31of100,1,191,17,97,20,134
test4sub90of100,test4pub31of100,1,191,17,98,20,135
test4sub73of100,test4pub31of100,1,191,17,97,20,134
test4sub50of100,test4pub31of100,1,191,17,99,20,136
test4sub34of100,test4pub31of100,1,191,17,99,21,137
test4sub24of100,test4pub31of100,1,191,17,100,21,138
test4sub53of100,test4pub31of100,1,191,17,102,19,138
test4sub91of100,test4pub31of100,1,191,17,103,19,139
test4sub27of100,test4pub31of100,1,191,17,104,19,140
test4sub62of100,test4pub31of100,1,191,17,105,20,142
test4sub20of100,test4pub31of100,1,191,17,106,19,142
test4sub23of100,test4pub31of100,1,191,17,142,7,166
test4sub5of100,test4pub31of100,1,191,17,144,14,175
test4sub38of100,test4pub31of100,1,191,17,144,15,176
test4sub96of100,test4pub31of100,1,191,17,145,15,177
test4sub37of100,test4pub31of100,1,191,17,145,17,179
test4sub75of100,test4pub31of100,1,191,17,147,18,182
test4sub2of100,test4pub31of100,1,191,17,148,17,182
test4sub51of100,test4pub31of100,1,191,17,151,14,182
test4sub6of100,test4pub31of100,1,191,17,153,15,185
test4sub17of100,test4pub31of100,1,191,17,153,19,189
test4sub78of100,test4pub31of100,1,191,17,154,25,196
test4sub89of100,test4pub31of100,1,191,17,154,35,206
test4sub84of100,test4pub31of100,1,191,17,155,35,207
test4sub26of100,test4pub31of100,1,191,17,153,35,205
test4sub71of100,test4pub31of100,1,191,17,155,35,207
test4sub12of100,test4pub31of100,1,191,17,160,32,209
test4sub19of100,test4pub31of100,1,191,17,161,32,210
test4sub29of100,test4pub31of100,1,191,17,164,29,210
test4sub10of100,test4pub31of100,1,191,17,167,27,211
test4sub46of100,test4pub31of100,1,191,17,170,25,212
test4sub25of100,test4pub31of100,1,191,17,172,25,214
test4sub83of100,test4pub31of100,1,191,17,174,23,214
test4sub42of100,test4pub31of100,1,191,17,175,23,215
test4sub43of100,test4pub31of100,1,191,17,175,24,216
test4sub28of100,test4pub31of100,1,191,17,176,24,217
test4sub57of100,test4pub31of100,1,191,17,177,23,217
test4sub64of100,test4pub31of100,1,191,17,178,24,219
test4sub59of100,test4pub31of100,1,191,17,179,24,220
test4sub14of100,test4pub31of100,1,191,17,180,22,219
test4sub85of100,test4pub31of100,1,191,17,181,22,220
test4sub97of100,test4pub31of100,1,191,17,182,22,221
test4sub40of100,test4pub31of100,1,191,17,182,22,221
test4sub18of100,test4pub31of100,1,191,17,183,23,223
test4sub4of100,test4pub31of100,1,191,17,183,23,223
test4sub58of100,test4pub31of100,1,191,17,184,23,224
test4sub16of100,test4pub31of100,1,191,17,184,23,224
test4sub87of100,test4pub31of100,1,191,17,186,23,226
test4sub98of100,test4pub31of100,1,191,17,187,23,227
test4sub82of100,test4pub31of100,1,191,17,188,23,228
test4sub30of100,test4pub31of100,1,191,17,341,1,359
test4sub13of100,test4pub31of100,1,191,17,347,1,365
test4sub52of100,test4pub31of100,1,191,17,376,1,394
test4sub39of100,test4pub31of100,1,191,17,384,1,402
test4sub100of100,test4pub31of100,1,191,17,385,0,402
test4sub68of100,test4pub31of100,1,191,17,391,1,409
test4sub76of100,test4pub31of100,1,191,17,393,1,411
test4sub67of100,test4pub29of100,1,191,12,1152,0,1164
test4sub88of100,test4pub31of100,1,191,17,414,5,436
test4sub47of100,test4pub31of100,1,191,17,424,2,443
test4sub67of100,test4pub30of100,1,191,11,806,14,831
test4sub67of100,test4pub31of100,1,191,17,428,6,451
test4sub38of100,test4pub32of100,1,191,15,7,1,23
test4sub96of100,test4pub32of100,1,191,15,9,1,25
test4sub81of100,test4pub32of100,1,191,15,8,3,26
test4sub44of100,test4pub32of100,1,191,15,11,1,27
test4sub54of100,test4pub32of100,1,191,15,13,1,29
test4sub90of100,test4pub32of100,1,191,15,21,1,37
test4sub93of100,test4pub32of100,1,191,15,26,1,42
test4sub47of100,test4pub32of100,1,191,15,27,2,44
test4sub15of100,test4pub32of100,1,191,15,29,1,45
test4sub16of100,test4pub32of100,1,191,15,28,3,46
test4sub60of100,test4pub32of100,1,191,15,30,2,47
test4sub52of100,test4pub32of100,1,191,15,32,1,48
test4sub28of100,test4pub32of100,1,191,15,34,0,49
test4sub86of100,test4pub32of100,1,191,15,37,1,53
test4sub40of100,test4pub32of100,1,191,15,38,1,54
test4sub84of100,test4pub32of100,1,191,15,37,3,55
test4sub67of100,test4pub32of100,1,191,15,39,1,55
test4sub55of100,test4pub32of100,1,191,15,42,1,58
test4sub3of100,test4pub32of100,1,191,15,54,1,70
test4sub68of100,test4pub32of100,1,191,15,56,4,75
test4sub17of100,test4pub32of100,1,191,15,57,4,76
test4sub76of100,test4pub32of100,1,191,15,57,4,76
test4sub24of100,test4pub32of100,1,191,15,58,3,76
test4sub51of100,test4pub32of100,1,191,15,58,4,77
test4sub27of100,test4pub32of100,1,191,15,60,3,78
test4sub63of100,test4pub32of100,1,191,15,60,3,78
test4sub57of100,test4pub32of100,1,191,15,64,4,83
test4sub5of100,test4pub32of100,1,191,15,65,3,83
test4sub18of100,test4pub32of100,1,191,15,65,4,84
test4sub66of100,test4pub32of100,1,191,15,66,3,84
test4sub25of100,test4pub32of100,1,191,15,68,2,85
test4sub39of100,test4pub32of100,1,191,15,74,2,91
test4sub46of100,test4pub32of100,1,191,15,75,3,93
test4sub20of100,test4pub32of100,1,191,15,74,4,93
test4sub98of100,test4pub32of100,1,191,15,76,5,96
test4sub45of100,test4pub32of100,1,191,15,77,5,97
test4sub77of100,test4pub32of100,1,191,15,78,4,97
test4sub95of100,test4pub32of100,1,191,15,77,4,96
test4sub2of100,test4pub32of100,1,191,15,79,4,98
test4sub92of100,test4pub32of100,1,191,15,80,3,98
test4sub62of100,test4pub32of100,1,191,15,80,3,98
test4sub43of100,test4pub32of100,1,191,15,118,1,134
test4sub100of100,test4pub32of100,1,191,15,119,0,134
test4sub61of100,test4pub32of100,1,191,15,122,1,138
test4sub12of100,test4pub32of100,1,191,15,128,0,143
test4sub73of100,test4pub32of100,1,191,15,128,1,144
test4sub71of100,test4pub32of100,1,191,15,131,0,146
test4sub37of100,test4pub32of100,1,191,15,135,5,155
test4sub70of100,test4pub32of100,1,191,15,136,4,155
test4sub31of100,test4pub32of100,1,191,15,136,5,156
test4sub53of100,test4pub32of100,1,191,15,135,8,158
test4sub74of100,test4pub32of100,1,191,15,137,6,158
test4sub21of100,test4pub32of100,1,191,15,137,6,158
test4sub75of100,test4pub32of100,1,191,15,138,7,160
test4sub79of100,test4pub32of100,1,191,15,139,6,160
test4sub85of100,test4pub32of100,1,191,15,141,3,159
test4sub42of100,test4pub32of100,1,191,15,142,3,160
test4sub41of100,test4pub32of100,1,191,15,143,5,163
test4sub11of100,test4pub32of100,1,191,15,146,3,164
test4sub36of100,test4pub32of100,1,191,15,148,2,165
test4sub14of100,test4pub32of100,1,191,15,147,4,166
test4sub59of100,test4pub32of100,1,191,15,148,3,166
test4sub8of100,test4pub32of100,1,191,15,149,4,168
test4sub6of100,test4pub32of100,1,191,15,151,6,172
test4sub69of100,test4pub32of100,1,191,15,153,6,174
test4sub78of100,test4pub32of100,1,191,15,153,5,173
test4sub97of100,test4pub32of100,1,191,15,154,6,175
test4sub91of100,test4pub32of100,1,191,15,155,6,176
test4sub23of100,test4pub32of100,1,191,15,156,7,178
test4sub56of100,test4pub32of100,1,191,15,156,8,179
test4sub87of100,test4pub32of100,1,191,15,158,8,181
test4sub13of100,test4pub32of100,1,191,15,159,7,181
test4sub99of100,test4pub32of100,1,191,15,160,8,183
test4sub89of100,test4pub32of100,1,191,15,161,9,185
test4sub26of100,test4pub32of100,1,191,15,162,9,186
test4sub49of100,test4pub32of100,1,191,15,163,8,186
test4sub58of100,test4pub32of100,1,191,15,164,8,187
test4sub22of100,test4pub32of100,1,191,15,165,7,187
test4sub32of100,test4pub32of100,1,191,15,168,7,190
test4sub34of100,test4pub32of100,1,191,15,169,7,191
test4sub4of100,test4pub32of100,1,191,15,170,8,193
test4sub82of100,test4pub32of100,1,191,15,172,7,194
test4sub88of100,test4pub32of100,1,191,15,174,7,196
test4sub65of100,test4pub32of100,1,191,15,177,5,197
test4sub50of100,test4pub32of100,1,191,15,177,5,197
test4sub94of100,test4pub32of100,1,191,15,177,5,197
test4sub1of100,test4pub32of100,1,191,15,175,8,198
test4sub30of100,test4pub32of100,1,191,15,178,6,199
test4sub7of100,test4pub32of100,1,191,15,179,5,199
test4sub9of100,test4pub32of100,1,191,15,173,11,199
test4sub80of100,test4pub32of100,1,191,15,181,4,200
test4sub10of100,test4pub32of100,1,191,15,182,3,200
test4sub83of100,test4pub32of100,1,191,15,362,1,378
test4sub33of100,test4pub32of100,1,191,15,373,1,389
test4sub48of100,test4pub32of100,1,191,15,377,1,393
test4sub19of100,test4pub32of100,1,191,15,397,1,413
test4sub72of100,test4pub32of100,1,191,15,398,1,414
test4sub35of100,test4pub32of100,1,191,15,405,1,421
test4sub64of100,test4pub32of100,1,191,15,435,1,451
test4sub100of100,test4pub33of100,1,191,11,6,1,18
test4sub51of100,test4pub33of100,1,191,11,12,1,24
test4sub4of100,test4pub33of100,1,191,11,14,1,26
test4sub87of100,test4pub33of100,1,191,11,15,1,27
test4sub6of100,test4pub33of100,1,191,11,18,0,29
test4sub28of100,test4pub33of100,1,191,11,20,0,31
test4sub86of100,test4pub33of100,1,191,11,24,1,36
test4sub34of100,test4pub33of100,1,191,11,24,2,37
test4sub47of100,test4pub33of100,1,191,11,25,1,37
test4sub89of100,test4pub33of100,1,191,11,28,1,40
test4sub62of100,test4pub33of100,1,191,11,28,2,41
test4sub72of100,test4pub33of100,1,191,11,29,3,43
test4sub5of100,test4pub33of100,1,191,11,31,4,46
test4sub10of100,test4pub33of100,1,191,11,31,4,46
test4sub13of100,test4pub33of100,1,191,11,33,3,47
test4sub65of100,test4pub33of100,1,191,11,34,2,47
test4sub71of100,test4pub33of100,1,191,11,34,2,47
test4sub54of100,test4pub33of100,1,191,11,40,1,52
test4sub42of100,test4pub33of100,1,191,11,46,1,58
test4sub40of100,test4pub33of100,1,191,11,48,0,59
test4sub82of100,test4pub33of100,1,191,11,50,0,61
test4sub3of100,test4pub33of100,1,191,11,56,1,68
test4sub95of100,test4pub33of100,1,191,11,56,1,68
test4sub79of100,test4pub33of100,1,191,11,66,3,80
test4sub19of100,test4pub33of100,1,191,11,66,2,79
test4sub59of100,test4pub33of100,1,191,11,67,1,79
test4sub25of100,test4pub33of100,1,191,11,76,1,88
test4sub2of100,test4pub33of100,1,191,11,79,5,95
test4sub39of100,test4pub33of100,1,191,11,79,5,95
test4sub63of100,test4pub33of100,1,191,11,81,5,97
test4sub27of100,test4pub33of100,1,191,11,81,4,96
test4sub55of100,test4pub33of100,1,191,11,82,5,98
test4sub84of100,test4pub33of100,1,191,11,82,5,98
test4sub56of100,test4pub33of100,1,191,11,82,8,101
test4sub85of100,test4pub33of100,1,191,11,82,18,111
test4sub1of100,test4pub33of100,1,191,11,83,22,116
test4sub96of100,test4pub33of100,1,191,11,89,17,117
test4sub77of100,test4pub33of100,1,191,11,89,18,118
test4sub33of100,test4pub33of100,1,191,11,90,17,118
test4sub37of100,test4pub33of100,1,191,11,92,15,118
test4sub61of100,test4pub33of100,1,191,11,93,15,119
test4sub38of100,test4pub33of100,1,191,11,95,13,119
test4sub24of100,test4pub33of100,1,191,11,95,14,120
test4sub97of100,test4pub33of100,1,191,11,96,13,120
test4sub21of100,test4pub33of100,1,191,11,97,14,122
test4sub32of100,test4pub33of100,1,191,11,97,14,122
test4sub18of100,test4pub33of100,1,191,11,98,15,124
test4sub81of100,test4pub33of100,1,191,11,97,16,124
test4sub75of100,test4pub33of100,1,191,11,98,16,125
test4sub11of100,test4pub33of100,1,191,11,100,14,125
test4sub66of100,test4pub33of100,1,191,11,101,14,126
test4sub9of100,test4pub33of100,1,191,11,100,13,124
test4sub68of100,test4pub33of100,1,191,11,100,14,125
test4sub57of100,test4pub33of100,1,191,11,104,13,128
test4sub76of100,test4pub33of100,1,191,11,105,11,127
test4sub15of100,test4pub33of100,1,191,11,106,12,129
test4sub92of100,test4pub33of100,1,191,11,150,1,162
test4sub94of100,test4pub33of100,1,191,11,152,4,167
test4sub41of100,test4pub33of100,1,191,11,153,6,170
test4sub8of100,test4pub33of100,1,191,11,155,6,172
test4sub88of100,test4pub33of100,1,191,11,156,4,171
test4sub74of100,test4pub33of100,1,191,11,155,10,176
test4sub83of100,test4pub33of100,1,191,11,157,9,177
test4sub36of100,test4pub33of100,1,191,11,158,10,179
test4sub58of100,test4pub33of100,1,191,11,159,10,180
test4sub20of100,test4pub33of100,1,191,11,160,10,181
test4sub44of100,test4pub33of100,1,191,11,162,8,181
test4sub99of100,test4pub33of100,1,191,11,162,8,181
test4sub49of100,test4pub33of100,1,191,11,163,8,182
test4sub22of100,test4pub33of100,1,191,11,164,24,199
test4sub31of100,test4pub33of100,1,191,11,166,22,199
test4sub91of100,test4pub33of100,1,191,11,167,22,200
test4sub60of100,test4pub33of100,1,191,11,168,21,200
test4sub23of100,test4pub33of100,1,191,11,166,22,199
test4sub7of100,test4pub33of100,1,191,11,172,19,202
test4sub67of100,test4pub33of100,1,191,11,172,18,201
test4sub45of100,test4pub33of100,1,191,11,173,19,203
test4sub50of100,test4pub33of100,1,191,11,174,17,202
test4sub48of100,test4pub33of100,1,191,11,176,16,203
test4sub35of100,test4pub33of100,1,191,11,177,16,204
test4sub43of100,test4pub33of100,1,191,11,174,16,201
test4sub78of100,test4pub33of100,1,191,11,178,15,204
test4sub30of100,test4pub33of100,1,191,11,178,15,204
test4sub26of100,test4pub33of100,1,191,11,179,15,205
test4sub93of100,test4pub33of100,1,191,11,180,14,205
test4sub17of100,test4pub33of100,1,191,11,178,14,203
test4sub14of100,test4pub33of100,1,191,11,180,14,205
test4sub90of100,test4pub33of100,1,191,11,181,13,205
test4sub69of100,test4pub33of100,1,191,11,182,14,207
test4sub73of100,test4pub33of100,1,191,11,180,13,204
test4sub16of100,test4pub33of100,1,191,11,182,14,207
test4sub52of100,test4pub33of100,1,191,11,349,1,361
test4sub53of100,test4pub33of100,1,191,11,353,1,365
test4sub70of100,test4pub33of100,1,191,11,355,0,366
test4sub3of100,test4pub34of100,1,191,14,7,1,22
test4sub64of100,test4pub33of100,1,191,11,375,2,388
test4sub98of100,test4pub33of100,1,191,11,375,2,388
test4sub6of100,test4pub34of100,1,191,14,12,3,29
test4sub66of100,test4pub34of100,1,191,14,15,2,31
test4sub30of100,test4pub34of100,1,191,14,16,1,31
test4sub17of100,test4pub34of100,1,191,14,20,1,35
test4sub46of100,test4pub33of100,1,191,11,392,1,404
test4sub62of100,test4pub34of100,1,191,14,30,1,45
test4sub88of100,test4pub34of100,1,191,14,33,1,48
test4sub44of100,test4pub34of100,1,191,14,34,1,49
test4sub1of100,test4pub34of100,1,191,14,37,6,57
test4sub47of100,test4pub34of100,1,191,14,38,6,58
test4sub57of100,test4pub34of100,1,191,14,40,5,59
test4sub96of100,test4pub34of100,1,191,14,40,6,60
test4sub69of100,test4pub34of100,1,191,14,41,6,61
test4sub16of100,test4pub34of100,1,191,14,42,7,63
test4sub91of100,test4pub34of100,1,191,14,45,8,67
test4sub79of100,test4pub34of100,1,191,14,46,8,68
test4sub75of100,test4pub34of100,1,191,14,48,7,69
test4sub72of100,test4pub34of100,1,191,14,49,7,70
test4sub25of100,test4pub34of100,1,191,14,50,7,71
test4sub23of100,test4pub34of100,1,191,14,51,7,72
test4sub52of100,test4pub34of100,1,191,14,53,6,73
test4sub67of100,test4pub34of100,1,191,14,56,3,73
test4sub5of100,test4pub34of100,1,191,14,63,2,79
test4sub86of100,test4pub34of100,1,191,14,64,2,80
test4sub77of100,test4pub34of100,1,191,14,67,2,83
test4sub9of100,test4pub34of100,1,191,14,69,6,89
test4sub59of100,test4pub34of100,1,191,14,70,6,90
test4sub87of100,test4pub34of100,1,191,14,71,6,91
test4sub100of100,test4pub34of100,1,191,14,72,5,91
test4sub80of100,test4pub33of100,1,191,11,437,5,453
test4sub8of100,test4pub34of100,1,191,14,74,5,93
test4sub21of100,test4pub34of100,1,191,14,74,4,92
test4sub73of100,test4pub34of100,1,191,14,85,1,100
test4sub12of100,test4pub33of100,1,191,11,449,2,462
test4sub13of100,test4pub34of100,1,191,14,95,1,110
test4sub85of100,test4pub34of100,1,191,14,99,5,118
test4sub60of100,test4pub34of100,1,191,14,99,8,121
test4sub99of100,test4pub34of100,1,191,14,100,7,121
test4sub81of100,test4pub34of100,1,191,14,101,6,121
test4sub49of100,test4pub34of100,1,191,14,102,6,122
test4sub54of100,test4pub34of100,1,191,14,103,6,123
test4sub14of100,test4pub34of100,1,191,14,104,5,123
test4sub58of100,test4pub34of100,1,191,14,104,8,126
test4sub46of100,test4pub34of100,1,191,14,105,17,136
test4sub39of100,test4pub34of100,1,191,14,105,18,137
test4sub90of100,test4pub34of100,1,191,14,106,17,137
test4sub42of100,test4pub34of100,1,191,14,109,15,138
test4sub94of100,test4pub34of100,1,191,14,110,15,139
test4sub38of100,test4pub34of100,1,191,14,111,15,140
test4sub2of100,test4pub34of100,1,191,14,111,15,140
test4sub10of100,test4pub34of100,1,191,14,112,15,141
test4sub40of100,test4pub34of100,1,191,14,114,13,141
test4sub53of100,test4pub34of100,1,191,14,114,14,142
test4sub33of100,test4pub34of100,1,191,14,114,14,142
test4sub78of100,test4pub34of100,1,191,14,115,14,143
test4sub71of100,test4pub34of100,1,191,14,116,14,144
test4sub50of100,test4pub34of100,1,191,14,116,13,143
test4sub61of100,test4pub34of100,1,191,14,117,14,145
test4sub68of100,test4pub34of100,1,191,14,117,13,144
test4sub63of100,test4pub34of100,1,191,14,118,13,145
test4sub22of100,test4pub34of100,1,191,14,118,12,144
test4sub35of100,test4pub34of100,1,191,14,119,12,145
test4sub48of100,test4pub34of100,1,191,14,120,11,145
test4sub84of100,test4pub34of100,1,191,14,121,10,145
test4sub28of100,test4pub34of100,1,191,14,124,8,146
test4sub74of100,test4pub34of100,1,191,14,125,7,146
test4sub32of100,test4pub34of100,1,191,14,126,6,146
test4sub45of100,test4pub34of100,1,191,14,134,1,149
test4sub18of100,test4pub34of100,1,191,14,143,1,158
test4sub97of100,test4pub34of100,1,191,14,143,5,162
test4sub51of100,test4pub34of100,1,191,14,145,4,163
test4sub92of100,test4pub34of100,1,191,14,145,4,163
test4sub20of100,test4pub34of100,1,191,14,146,4,164
test4sub34of100,test4pub34of100,1,191,14,146,4,164
test4sub98of100,test4pub34of100,1,191,14,147,4,165
test4sub95of100,test4pub34of100,1,191,14,148,4,166
test4sub15of100,test4pub34of100,1,191,14,147,4,165
test4sub4of100,test4pub34of100,1,191,14,162,1,177
test4sub76of100,test4pub34of100,1,191,14,163,1,178
test4sub37of100,test4pub34of100,1,191,14,165,1,180
test4sub12of100,test4pub34of100,1,191,14,166,1,181
test4sub29of100,test4pub32of100,1,191,15,1075,1,1091
test4sub29of100,test4pub33of100,1,191,11,581,1,593
test4sub29of100,test4pub34of100,1,191,14,219,0,233
test4sub27of100,test4pub34of100,1,191,14,321,0,335
test4sub83of100,test4pub34of100,1,191,14,337,1,352
test4sub56of100,test4pub34of100,1,191,14,350,1,365
test4sub36of100,test4pub34of100,1,191,14,357,1,372
test4sub19of100,test4pub34of100,1,191,14,357,1,372
test4sub64of100,test4pub34of100,1,191,14,362,2,378
test4sub43of100,test4pub34of100,1,191,14,363,1,378
test4sub31of100,test4pub34of100,1,191,14,362,3,379
test4sub70of100,test4pub34of100,1,191,14,363,2,379
test4sub7of100,test4pub34of100,1,191,14,366,1,381
test4sub26of100,test4pub34of100,1,191,14,366,1,381
test4sub11of100,test4pub34of100,1,191,14,371,1,386
test4sub93of100,test4pub34of100,1,191,14,372,1,387
test4sub89of100,test4pub34of100,1,191,14,373,1,388
test4sub41of100,test4pub34of100,1,191,14,377,1,392
test4sub24of100,test4pub34of100,1,191,14,380,1,395
test4sub65of100,test4pub34of100,1,191,14,381,0,395
test4sub55of100,test4pub34of100,1,191,14,406,1,421
test4sub82of100,test4pub34of100,1,191,14,425,1,440
test4sub80of100,test4pub34of100,1,191,14,750,1,765
test4sub28of100,test4pub35of100,1,191,19,10,1,30
test4sub92of100,test4pub35of100,1,191,19,10,1,30
test4sub71of100,test4pub35of100,1,191,19,18,0,37
test4sub61of100,test4pub35of100,1,191,19,18,1,38
test4sub25of100,test4pub35of100,1,191,19,24,1,44
test4sub9of100,test4pub35of100,1,191,19,25,2,46
test4sub85of100,test4pub35of100,1,191,19,26,2,47
test4sub80of100,test4pub35of100,1,191,19,26,4,49
test4sub29of100,test4pub35of100,1,191,19,28,3,50
test4sub62of100,test4pub35of100,1,191,19,30,1,50
test4sub48of100,test4pub35of100,1,191,19,32,1,52
test4sub45of100,test4pub35of100,1,191,19,33,3,55
test4sub98of100,test4pub35of100,1,191,19,34,3,56
test4sub46of100,test4pub35of100,1,191,19,35,3,57
test4sub84of100,test4pub35of100,1,191,19,37,2,58
test4sub55of100,test4pub35of100,1,191,19,38,2,59
test4sub94of100,test4pub35of100,1,191,19,39,1,59
test4sub5of100,test4pub35of100,1,191,19,46,1,66
test4sub22of100,test4pub35of100,1,191,19,47,2,68
test4sub38of100,test4pub35of100,1,191,19,48,2,69
test4sub37of100,test4pub35of100,1,191,19,49,2,70
test4sub67of100,test4pub35of100,1,191,19,49,2,70
test4sub99of100,test4pub35of100,1,191,19,52,1,72
test4sub32of100,test4pub35of100,1,191,19,52,2,73
test4sub64of100,test4pub35of100,1,191,19,53,2,74
test4sub70of100,test4pub35of100,1,191,19,54,1,74
test4sub50of100,test4pub35of100,1,191,19,58,0,77
test4sub15of100,test4pub35of100,1,191,19,72,1,92
test4sub75of100,test4pub35of100,1,191,19,74,1,94
test4sub68of100,test4pub35of100,1,191,19,75,1,95
test4sub65of100,test4pub35of100,1,191,19,75,1,95
test4sub3of100,test4pub35of100,1,191,19,80,1,100
test4sub27of100,test4pub35of100,1,191,19,80,2,101
test4sub74of100,test4pub35of100,1,191,19,81,5,105
test4sub81of100,test4pub35of100,1,191,19,82,4,105
test4sub40of100,test4pub35of100,1,191,19,83,4,106
test4sub89of100,test4pub35of100,1,191,19,85,3,107
test4sub91of100,test4pub35of100,1,191,19,83,5,107
test4sub53of100,test4pub35of100,1,191,19,85,4,108
test4sub73of100,test4pub35of100,1,191,19,87,2,108
test4sub19of100,test4pub35of100,1,191,19,86,4,109
test4sub13of100,test4pub35of100,1,191,19,91,1,111
test4sub66of100,test4pub35of100,1,191,19,92,1,112
test4sub56of100,test4pub35of100,1,191,19,95,0,114
test4sub58of100,test4pub35of100,1,191,19,104,3,126
test4sub14of100,test4pub35of100,1,191,19,104,3,126
test4sub54of100,test4pub35of100,1,191,19,105,2,126
test4sub20of100,test4pub35of100,1,191,19,105,2,126
test4sub87of100,test4pub35of100,1,191,19,108,0,127
test4sub12of100,test4pub35of100,1,191,19,111,3,133
test4sub41of100,test4pub35of100,1,191,19,111,3,133
test4sub97of100,test4pub35of100,1,191,19,112,2,133
test4sub76of100,test4pub35of100,1,191,19,112,2,133
test4sub72of100,test4pub35of100,1,191,19,113,2,134
test4sub8of100,test4pub35of100,1,191,19,138,3,160
test4sub10of100,test4pub35of100,1,191,19,139,3,161
test4sub88of100,test4pub35of100,1,191,19,138,5,162
test4sub49of100,test4pub35of100,1,191,19,140,5,164
test4sub44of100,test4pub35of100,1,191,19,141,4,164
test4sub63of100,test4pub35of100,1,191,19,142,8,169
test4sub79of100,test4pub35of100,1,191,19,146,5,170
test4sub57of100,test4pub35of100,1,191,19,147,6,172
test4sub42of100,test4pub35of100,1,191,19,147,9,175
test4sub6of100,test4pub35of100,1,191,19,147,9,175
test4sub83of100,test4pub35of100,1,191,19,152,6,177
test4sub95of100,test4pub35of100,1,191,19,148,10,177
test4sub23of100,test4pub35of100,1,191,19,149,10,178
test4sub43of100,test4pub35of100,1,191,19,152,7,178
test4sub7of100,test4pub35of100,1,191,19,141,17,177
test4sub21of100,test4pub35of100,1,191,19,145,15,179
test4sub59of100,test4pub35of100,1,191,19,146,14,179
test4sub11of100,test4pub35of100,1,191,19,148,8,175
test4sub18of100,test4pub35of100,1,191,19,155,7,181
test4sub24of100,test4pub35of100,1,191,19,154,6,179
test4sub100of100,test4pub35of100,1,191,19,156,7,182
test4sub82of100,test4pub35of100,1,191,19,152,6,177
test4sub69of100,test4pub35of100,1,191,19,157,7,183
test4sub33of100,test4pub35of100,1,191,19,327,0,346
test4sub36of100,test4pub35of100,1,191,19,332,1,352
test4sub52of100,test4pub35of100,1,191,19,332,1,352
test4sub47of100,test4pub35of100,1,191,19,338,2,359
test4sub93of100,test4pub35of100,1,191,19,339,3,361
test4sub17of100,test4pub35of100,1,191,19,340,1,360
test4sub96of100,test4pub35of100,1,191,19,340,1,360
test4sub60of100,test4pub35of100,1,191,19,344,1,364
test4sub26of100,test4pub35of100,1,191,19,346,2,367
test4sub30of100,test4pub35of100,1,191,19,347,2,368
test4sub34of100,test4pub35of100,1,191,19,348,1,368
test4sub1of100,test4pub35of100,1,191,19,354,3,376
test4sub51of100,test4pub35of100,1,191,19,354,3,376
test4sub77of100,test4pub35of100,1,191,19,355,1,375
test4sub35of100,test4pub35of100,1,191,19,362,1,382
test4sub78of100,test4pub35of100,1,191,19,379,0,398
test4sub4of100,test4pub35of100,1,191,19,380,3,402
test4sub31of100,test4pub35of100,1,191,19,382,3,404
test4sub86of100,test4pub35of100,1,191,19,383,1,403
test4sub2of100,test4pub35of100,1,191,19,387,1,407
test4sub16of100,test4pub35of100,1,191,19,390,1,410
test4sub90of100,test4pub35of100,1,191,19,394,1,414
test4sub39of100,test4pub35of100,1,191,19,396,1,416
test4sub73of100,test4pub36of100,1,191,17,7,0,24
test4sub72of100,test4pub36of100,1,191,17,10,1,28
test4sub25of100,test4pub36of100,1,191,17,16,0,33
test4sub13of100,test4pub36of100,1,191,17,22,1,40
test4sub44of100,test4pub36of100,1,191,17,23,1,41
test4sub63of100,test4pub36of100,1,191,17,24,2,43
test4sub57of100,test4pub36of100,1,191,17,27,1,45
test4sub14of100,test4pub36of100,1,191,17,29,4,50
test4sub23of100,test4pub36of100,1,191,17,29,3,49
test4sub61of100,test4pub36of100,1,191,17,30,2,49
test4sub84of100,test4pub36of100,1,191,17,31,2,50
test4sub43of100,test4pub36of100,1,191,17,40,1,58
test4sub98of100,test4pub36of100,1,191,17,44,1,62
test4sub60of100,test4pub36of100,1,191,17,45,4,66
test4sub12of100,test4pub36of100,1,191,17,44,4,65
test4sub34of100,test4pub36of100,1,191,17,47,2,66
test4sub45of100,test4pub36of100,1,191,17,48,5,70
test4sub91of100,test4pub36of100,1,191,17,49,5,71
test4sub49of100,test4pub36of100,1,191,17,50,4,71
test4sub26of100,test4pub36of100,1,191,17,52,4,73
test4sub36of100,test4pub36of100,1,191,17,51,5,73
test4sub6of100,test4pub36of100,1,191,17,52,4,73
test4sub35of100,test4pub36of100,1,191,17,53,4,74
test4sub53of100,test4pub36of100,1,191,17,54,3,74
test4sub77of100,test4pub36of100,1,191,17,58,2,77
test4sub11of100,test4pub36of100,1,191,17,59,1,77
test4sub87of100,test4pub36of100,1,191,17,62,1,80
test4sub5of100,test4pub36of100,1,191,17,65,1,83
test4sub92of100,test4pub36of100,1,191,17,71,0,88
test4sub80of100,test4pub36of100,1,191,17,72,1,90
test4sub70of100,test4pub36of100,1,191,17,74,0,91
test4sub19of100,test4pub36of100,1,191,17,78,1,96
test4sub96of100,test4pub36of100,1,191,17,77,2,96
test4sub76of100,test4pub36of100,1,191,17,79,1,97
test4sub51of100,test4pub36of100,1,191,17,85,1,103
test4sub65of100,test4pub36of100,1,191,17,93,2,112
test4sub20of100,test4pub36of100,1,191,17,94,1,112
test4sub95of100,test4pub36of100,1,191,17,97,0,114
test4sub75of100,test4pub36of100,1,191,17,99,1,117
test4sub15of100,test4pub36of100,1,191,17,101,1,119
test4sub18of100,test4pub36of100,1,191,17,103,1,121
test4sub66of100,test4pub36of100,1,191,17,102,3,122
test4sub1of100,test4pub36of100,1,191,17,105,1,123
test4sub4of100,test4pub36of100,1,191,17,106,1,124
test4sub94of100,test4pub36of100,1,191,17,107,1,125
test4sub9of100,test4pub36of100,1,191,17,109,1,127
test4sub48of100,test4pub36of100,1,191,17,110,2,129
test4sub37of100,test4pub36of100,1,191,17,111,5,133
test4sub46of100,test4pub36of100,1,191,17,113,3,133
test4sub90of100,test4pub36of100,1,191,17,113,3,133
test4sub100of100,test4pub36of100,1,191,17,114,3,134
test4sub88of100,test4pub36of100,1,191,17,115,3,135
test4sub42of100,test4pub36of100,1,191,17,115,5,137
test4sub54of100,test4pub36of100,1,191,17,118,2,137
test4sub33of100,test4pub36of100,1,191,17,119,2,138
test4sub79of100,test4pub36of100,1,191,17,125,1,143
test4sub38of100,test4pub36of100,1,191,17,125,2,144
test4sub24of100,test4pub36of100,1,191,17,128,1,146
test4sub30of100,test4pub36of100,1,191,17,129,1,147
test4sub74of100,test4pub36of100,1,191,17,131,4,152
test4sub47of100,test4pub36of100,1,191,17,131,4,152
test4sub29of100,test4pub36of100,1,191,17,132,4,153
test4sub2of100,test4pub36of100,1,191,17,133,3,153
test4sub69of100,test4pub36of100,1,191,17,133,7,157
test4sub31of100,test4pub36of100,1,191,17,135,9,161
test4sub41of100,test4pub36of100,1,191,17,136,12,165
test4sub59of100,test4pub36of100,1,191,17,138,10,165
test4sub85of100,test4pub36of100,1,191,17,138,11,166
test4sub78of100,test4pub36of100,1,191,17,139,11,167
test4sub16of100,test4pub36of100,1,191,17,140,10,167
test4sub17of100,test4pub36of100,1,191,17,140,10,167
test4sub56of100,test4pub36of100,1,191,17,142,9,168
test4sub8of100,test4pub36of100,1,191,17,142,9,168
test4sub62of100,test4pub36of100,1,191,17,143,8,168
test4sub32of100,test4pub36of100,1,191,17,144,7,168
test4sub3of100,test4pub36of100,1,191,17,144,8,169
test4sub28of100,test4pub36of100,1,191,17,146,7,170
test4sub93of100,test4pub36of100,1,191,17,146,6,169
test4sub58of100,test4pub36of100,1,191,17,147,6,170
test4sub46of100,test4pub37of100,1,191,16,12,3,31
test4sub75of100,test4pub37of100,1,191,16,12,4,32
test4sub96of100,test4pub37of100,1,191,16,14,4,34
test4sub69of100,test4pub37of100,1,191,16,14,4,34
test4sub87of100,test4pub37of100,1,191,16,15,4,35
test4sub33of100,test4pub37of100,1,191,16,17,6,39
test4sub56of100,test4pub37of100,1,191,16,18,6,40
test4sub86of100,test4pub36of100,1,191,17,356,6,379
test4sub97of100,test4pub36of100,1,191,17,356,7,380
test4sub34of100,test4pub37of100,1,191,16,21,6,43
test4sub31of100,test4pub37of100,1,191,16,15,13,44
test4sub41of100,test4pub37of100,1,191,16,19,9,44
test4sub24of100,test4pub37of100,1,191,16,22,7,45
test4sub47of100,test4pub37of100,1,191,16,23,6,45
test4sub15of100,test4pub37of100,1,191,16,24,5,45
test4sub52of100,test4pub36of100,1,191,17,362,3,382
test4sub37of100,test4pub37of100,1,191,16,26,4,46
test4sub95of100,test4pub37of100,1,191,16,41,4,61
test4sub66of100,test4pub37of100,1,191,16,43,4,63
test4sub51of100,test4pub37of100,1,191,16,44,3,63
test4sub10of100,test4pub36of100,1,191,17,380,3,400
test4sub8of100,test4pub37of100,1,191,16,43,4,63
test4sub67of100,test4pub36of100,1,191,17,380,4,401
test4sub3of100,test4pub37of100,1,191,16,41,7,64
test4sub83of100,test4pub36of100,1,191,17,381,3,401
test4sub4of100,test4pub37of100,1,191,16,56,1,73
test4sub92of100,test4pub37of100,1,191,16,59,1,76
test4sub65of100,test4pub37of100,1,191,16,65,4,85
test4sub53of100,test4pub37of100,1,191,16,66,3,85
test4sub55of100,test4pub36of100,1,191,17,403,3,423
test4sub22of100,test4pub36of100,1,191,17,428,2,447
test4sub64of100,test4pub36of100,1,191,17,428,3,448
test4sub99of100,test4pub36of100,1,191,17,430,5,452
test4sub97of100,test4pub37of100,1,191,16,97,3,116
test4sub13of100,test4pub37of100,1,191,16,102,0,118
test4sub5of100,test4pub37of100,1,191,16,104,7,127
test4sub63of100,test4pub37of100,1,191,16,104,8,128
test4sub30of100,test4pub37of100,1,191,16,105,8,129
test4sub72of100,test4pub37of100,1,191,16,106,8,130
test4sub49of100,test4pub37of100,1,191,16,106,8,130
test4sub42of100,test4pub37of100,1,191,16,107,7,130
test4sub84of100,test4pub37of100,1,191,16,107,7,130
test4sub52of100,test4pub37of100,1,191,16,109,5,130
test4sub26of100,test4pub37of100,1,191,16,111,4,131
test4sub27of100,test4pub36of100,1,191,17,448,4,469
test4sub100of100,test4pub37of100,1,191,16,116,2,134
test4sub35of100,test4pub37of100,1,191,16,118,1,135
test4sub60of100,test4pub37of100,1,191,16,117,3,136
test4sub2of100,test4pub37of100,1,191,16,120,2,138
test4sub50of100,test4pub36of100,1,191,17,457,3,477
test4sub81of100,test4pub36of100,1,191,17,461,1,479
test4sub16of100,test4pub37of100,1,191,16,126,1,143
test4sub76of100,test4pub37of100,1,191,16,130,1,147
test4sub44of100,test4pub37of100,1,191,16,131,2,149
test4sub25of100,test4pub37of100,1,191,16,130,1,147
test4sub17of100,test4pub37of100,1,191,16,135,0,151
test4sub21of100,test4pub36of100,1,191,17,477,1,495
test4sub39of100,test4pub36of100,1,191,17,479,0,496
test4sub68of100,test4pub36of100,1,191,17,481,1,499
test4sub89of100,test4pub36of100,1,191,17,483,5,505
test4sub61of100,test4pub37of100,1,191,16,149,5,170
test4sub45of100,test4pub37of100,1,191,16,150,5,171
test4sub10of100,test4pub37of100,1,191,16,149,5,170
test4sub71of100,test4pub36of100,1,191,17,487,3,507
test4sub7of100,test4pub36of100,1,191,17,487,4,508
test4sub67of100,test4pub37of100,1,191,16,153,2,171
test4sub48of100,test4pub37of100,1,191,16,175,1,192
test4sub19of100,test4pub37of100,1,191,16,176,2,194
test4sub62of100,test4pub37of100,1,191,16,177,1,194
test4sub40of100,test4pub36of100,1,191,17,513,2,532
test4sub11of100,test4pub37of100,1,191,16,180,2,198
test4sub78of100,test4pub37of100,1,191,16,181,2,199
test4sub94of100,test4pub37of100,1,191,16,182,7,205
test4sub1of100,test4pub37of100,1,191,16,185,6,207
test4sub43of100,test4pub37of100,1,191,16,184,6,206
test4sub83of100,test4pub37of100,1,191,16,186,7,209
test4sub73of100,test4pub37of100,1,191,16,187,6,209
test4sub36of100,test4pub37of100,1,191,16,188,6,210
test4sub88of100,test4pub37of100,1,191,16,186,9,211
test4sub93of100,test4pub37of100,1,191,16,187,10,213
test4sub57of100,test4pub37of100,1,191,16,189,10,215
test4sub85of100,test4pub37of100,1,191,16,185,9,210
test4sub55of100,test4pub37of100,1,191,16,192,7,215
test4sub70of100,test4pub37of100,1,191,16,192,7,215
test4sub54of100,test4pub37of100,1,191,16,195,5,216
test4sub98of100,test4pub37of100,1,191,16,196,6,218
test4sub14of100,test4pub37of100,1,191,16,198,8,222
test4sub18of100,test4pub37of100,1,191,16,200,7,223
test4sub29of100,test4pub37of100,1,191,16,202,7,225
test4sub74of100,test4pub37of100,1,191,16,203,5,224
test4sub77of100,test4pub37of100,1,191,16,204,4,224
test4sub80of100,test4pub37of100,1,191,16,204,5,225
test4sub38of100,test4pub37of100,1,191,16,206,4,226
test4sub82of100,test4pub36of100,1,191,17,542,3,562
test4sub23of100,test4pub37of100,1,191,16,214,5,235
test4sub58of100,test4pub37of100,1,191,16,215,4,235
test4sub6of100,test4pub37of100,1,191,16,215,4,235
test4sub86of100,test4pub37of100,1,191,16,216,5,237
test4sub28of100,test4pub37of100,1,191,16,217,5,238
test4sub79of100,test4pub37of100,1,191,16,217,5,238
test4sub12of100,test4pub37of100,1,191,16,214,16,246
test4sub90of100,test4pub37of100,1,191,16,218,13,247
test4sub20of100,test4pub37of100,1,191,16,219,12,247
test4sub32of100,test4pub37of100,1,191,16,225,13,254
test4sub89of100,test4pub37of100,1,191,16,226,13,255
test4sub21of100,test4pub37of100,1,191,16,225,16,257
test4sub9of100,test4pub37of100,1,191,16,224,16,256
test4sub64of100,test4pub37of100,1,191,16,223,17,256
test4sub22of100,test4pub37of100,1,191,16,222,18,256
test4sub27of100,test4pub37of100,1,191,16,226,14,256
test4sub71of100,test4pub37of100,1,191,16,227,14,257
test4sub59of100,test4pub37of100,1,191,16,224,14,254
test4sub99of100,test4pub37of100,1,191,16,224,15,255
test4sub81of100,test4pub37of100,1,191,16,226,15,257
test4sub50of100,test4pub37of100,1,191,16,226,14,256
test4sub40of100,test4pub37of100,1,191,16,230,15,261
test4sub91of100,test4pub37of100,1,191,16,369,1,386
test4sub68of100,test4pub37of100,1,191,16,429,1,446
test4sub39of100,test4pub37of100,1,191,16,433,1,450
test4sub39of100,test4pub38of100,1,191,11,19,1,31
test4sub87of100,test4pub38of100,1,191,11,24,1,36
test4sub7of100,test4pub37of100,1,191,16,454,0,470
test4sub62of100,test4pub38of100,1,191,11,31,1,43
test4sub27of100,test4pub38of100,1,191,11,31,1,43
test4sub66of100,test4pub38of100,1,191,11,36,1,48
test4sub81of100,test4pub38of100,1,191,11,41,2,54
test4sub49of100,test4pub38of100,1,191,11,42,2,55
test4sub51of100,test4pub38of100,1,191,11,42,2,55
test4sub16of100,test4pub38of100,1,191,11,41,4,56
test4sub9of100,test4pub38of100,1,191,11,43,2,56
test4sub43of100,test4pub38of100,1,191,11,48,1,60
test4sub53of100,test4pub38of100,1,191,11,49,1,61
test4sub99of100,test4pub38of100,1,191,11,51,2,64
test4sub18of100,test4pub38of100,1,191,11,52,1,64
test4sub83of100,test4pub38of100,1,191,11,54,2,67
test4sub61of100,test4pub38of100,1,191,11,55,3,69
test4sub52of100,test4pub38of100,1,191,11,56,2,69
test4sub20of100,test4pub38of100,1,191,11,57,2,70
test4sub14of100,test4pub38of100,1,191,11,69,1,81
test4sub100of100,test4pub38of100,1,191,11,69,1,81
test4sub73of100,test4pub38of100,1,191,11,70,1,82
test4sub21of100,test4pub38of100,1,191,11,72,0,83
test4sub32of100,test4pub38of100,1,191,11,74,1,86
test4sub77of100,test4pub38of100,1,191,11,75,1,87
test4sub10of100,test4pub38of100,1,191,11,77,1,89
test4sub85of100,test4pub38of100,1,191,11,81,3,95
test4sub13of100,test4pub38of100,1,191,11,82,6,99
test4sub56of100,test4pub38of100,1,191,11,83,6,100
test4sub1of100,test4pub38of100,1,191,11,84,9,104
test4sub3of100,test4pub38of100,1,191,11,83,10,104
test4sub57of100,test4pub38of100,1,191,11,84,10,105
test4sub36of100,test4pub38of100,1,191,11,86,8,105
test4sub37of100,test4pub38of100,1,191,11,86,9,106
test4sub47of100,test4pub38of100,1,191,11,87,11,109
test4sub41of100,test4pub38of100,1,191,11,88,11,110
test4sub84of100,test4pub38of100,1,191,11,89,10,110
test4sub26of100,test4pub38of100,1,191,11,89,11,111
test4sub90of100,test4pub38of100,1,191,11,90,11,112
test4sub11of100,test4pub38of100,1,191,11,91,12,114
test4sub60of100,test4pub38of100,1,191,11,92,11,114
test4sub46of100,test4pub38of100,1,191,11,94,10,115
test4sub97of100,test4pub38of100,1,191,11,96,8,115
test4sub78of100,test4pub38of100,1,191,11,97,8,116
test4sub55of100,test4pub38of100,1,191,11,98,8,117
test4sub2of100,test4pub38of100,1,191,11,98,7,116
test4sub64of100,test4pub38of100,1,191,11,100,5,116
test4sub95of100,test4pub38of100,1,191,11,102,5,118
test4sub58of100,test4pub38of100,1,191,11,103,4,118
test4sub22of100,test4pub38of100,1,191,11,111,2,124
test4sub28of100,test4pub38of100,1,191,11,112,2,125
test4sub79of100,test4pub38of100,1,191,11,115,1,127
test4sub29of100,test4pub38of100,1,191,11,114,2,127
test4sub75of100,test4pub38of100,1,191,11,118,2,131
test4sub68of100,test4pub38of100,1,191,11,120,1,132
test4sub4of100,test4pub38of100,1,191,11,123,1,135
test4sub5of100,test4pub38of100,1,191,11,123,1,135
test4sub69of100,test4pub38of100,1,191,11,127,1,139
test4sub92of100,test4pub38of100,1,191,11,127,10,148
test4sub6of100,test4pub38of100,1,191,11,129,9,149
test4sub31of100,test4pub38of100,1,191,11,129,9,149
test4sub38of100,test4pub38of100,1,191,11,130,9,150
test4sub40of100,test4pub38of100,1,191,11,130,16,157
test4sub42of100,test4pub38of100,1,191,11,131,15,157
test4sub23of100,test4pub38of100,1,191,11,132,16,159
test4sub35of100,test4pub38of100,1,191,11,132,17,160
test4sub25of100,test4pub38of100,1,191,11,134,16,161
test4sub15of100,test4pub38of100,1,191,11,134,16,161
test4sub88of100,test4pub38of100,1,191,11,135,16,162
test4sub19of100,test4pub38of100,1,191,11,135,15,161
test4sub96of100,test4pub38of100,1,191,11,136,16,163
test4sub17of100,test4pub38of100,1,191,11,136,15,162
test4sub54of100,test4pub38of100,1,191,11,139,12,162
test4sub76of100,test4pub38of100,1,191,11,140,12,163
test4sub98of100,test4pub38of100,1,191,11,141,12,164
test4sub12of100,test4pub38of100,1,191,11,142,12,165
test4sub44of100,test4pub38of100,1,191,11,143,11,165
test4sub63of100,test4pub38of100,1,191,11,143,11,165
test4sub70of100,test4pub38of100,1,191,11,144,10,165
test4sub80of100,test4pub38of100,1,191,11,144,10,165
test4sub24of100,test4pub38of100,1,191,11,145,9,165
test4sub89of100,test4pub38of100,1,191,11,145,10,166
test4sub71of100,test4pub38of100,1,191,11,146,9,166
test4sub33of100,test4pub38of100,1,191,11,148,8,167
test4sub82of100,test4pub37of100,1,191,16,714,1,731
test4sub82of100,test4pub38of100,1,191,11,290,1,302
test4sub35of100,test4pub39of100,1,191,13,8,0,21
test4sub72of100,test4pub38of100,1,191,11,347,1,359
test4sub93of100,test4pub38of100,1,191,11,353,1,365
test4sub100of100,test4pub39of100,1,191,13,18,0,31
test4sub97of100,test4pub39of100,1,191,13,22,1,36
test4sub41of100,test4pub39of100,1,191,13,27,1,41
test4sub74of100,test4pub38of100,1,191,11,371,1,383
test4sub30of100,test4pub38of100,1,191,11,372,1,384
test4sub40of100,test4pub39of100,1,191,13,35,1,49
test4sub93of100,test4pub39of100,1,191,13,36,2,51
test4sub86of100,test4pub38of100,1,191,11,376,2,389
test4sub34of100,test4pub38of100,1,191,11,377,2,390
test4sub15of100,test4pub39of100,1,191,13,40,2,55
test4sub59of100,test4pub38of100,1,191,11,379,2,392
test4sub65of100,test4pub38of100,1,191,11,380,2,393
test4sub96of100,test4pub39of100,1,191,13,43,1,57
test4sub6of100,test4pub39of100,1,191,13,48,1,62
test4sub19of100,test4pub39of100,1,191,13,48,2,63
test4sub60of100,test4pub39of100,1,191,13,50,1,64
test4sub42of100,test4pub39of100,1,191,13,51,1,65
test4sub37of100,test4pub39of100,1,191,13,56,2,71
test4sub11of100,test4pub39of100,1,191,13,56,2,71
test4sub7of100,test4pub38of100,1,191,11,395,1,407
test4sub91of100,test4pub38of100,1,191,11,399,1,411
test4sub63of100,test4pub39of100,1,191,13,62,4,79
test4sub81of100,test4pub39of100,1,191,13,63,3,79
test4sub79of100,test4pub39of100,1,191,13,64,4,81
test4sub45of100,test4pub38of100,1,191,11,403,3,417
test4sub26of100,test4pub39of100,1,191,13,67,3,83
test4sub3of100,test4pub39of100,1,191,13,65,4,82
test4sub18of100,test4pub39of100,1,191,13,69,2,84
test4sub67of100,test4pub38of100,1,191,11,399,8,418
test4sub90of100,test4pub39of100,1,191,13,65,5,83
test4sub39of100,test4pub39of100,1,191,13,72,1,86
test4sub13of100,test4pub39of100,1,191,13,83,1,97
test4sub31of100,test4pub39of100,1,191,13,85,1,99
test4sub57of100,test4pub39of100,1,191,13,86,1,100
test4sub38of100,test4pub39of100,1,191,13,91,1,105
test4sub49of100,test4pub39of100,1,191,13,94,1,108
test4sub70of100,test4pub39of100,1,191,13,95,1,109
test4sub17of100,test4pub39of100,1,191,13,93,2,108
test4sub61of100,test4pub39of100,1,191,13,100,1,114
test4sub94of100,test4pub38of100,1,191,11,439,1,451
test4sub48of100,test4pub38of100,1,191,11,440,2,453
test4sub73of100,test4pub39of100,1,191,13,103,2,118
test4sub80of100,test4pub39of100,1,191,13,103,4,120
test4sub9of100,test4pub39of100,1,191,13,105,3,121
test4sub58of100,test4pub39of100,1,191,13,106,7,126
test4sub36of100,test4pub39of100,1,191,13,107,7,127
test4sub22of100,test4pub39of100,1,191,13,109,5,127
test4sub8of100,test4pub38of100,1,191,11,447,6,464
test4sub98of100,test4pub39of100,1,191,13,110,7,130
test4sub32of100,test4pub39of100,1,191,13,111,6,130
test4sub16of100,test4pub39of100,1,191,13,112,4,129
test4sub12of100,test4pub39of100,1,191,13,113,5,131
test4sub74of100,test4pub39of100,1,191,13,115,2,130
test4sub24of100,test4pub39of100,1,191,13,118,5,136
test4sub88of100,test4pub39of100,1,191,13,119,11,143
test4sub72of100,test4pub39of100,1,191,13,119,11,143
test4sub53of100,test4pub39of100,1,191,13,120,11,144
test4sub43of100,test4pub39of100,1,191,13,121,10,144
test4sub87of100,test4pub39of100,1,191,13,122,13,148
test4sub28of100,test4pub39of100,1,191,13,122,17,152
test4sub66of100,test4pub39of100,1,191,13,123,17,153
test4sub10of100,test4pub39of100,1,191,13,124,16,153
test4sub27of100,test4pub39of100,1,191,13,126,14,153
test4sub23of100,test4pub39of100,1,191,13,126,15,154
test4sub29of100,test4pub39of100,1,191,13,127,15,155
test4sub1of100,test4pub39of100,1,191,13,127,15,155
test4sub68of100,test4pub39of100,1,191,13,128,15,156
test4sub7of100,test4pub39of100,1,191,13,129,14,156
test4sub44of100,test4pub39of100,1,191,13,129,15,157
test4sub92of100,test4pub39of100,1,191,13,133,11,157
test4sub83of100,test4pub39of100,1,191,13,133,11,157
test4sub46of100,test4pub39of100,1,191,13,135,11,159
test4sub21of100,test4pub39of100,1,191,13,136,10,159
test4sub78of100,test4pub39of100,1,191,13,136,9,158
test4sub47of100,test4pub39of100,1,191,13,136,10,159
test4sub71of100,test4pub39of100,1,191,13,138,9,160
test4sub99of100,test4pub39of100,1,191,13,139,8,160
test4sub67of100,test4pub39of100,1,191,13,142,6,161
test4sub91of100,test4pub39of100,1,191,13,149,1,163
test4sub45of100,test4pub39of100,1,191,13,149,2,164
test4sub94of100,test4pub39of100,1,191,13,151,1,165
test4sub5of100,test4pub39of100,1,191,13,155,1,169
test4sub33of100,test4pub39of100,1,191,13,305,1,319
test4sub77of100,test4pub39of100,1,191,13,328,1,342
test4sub25of100,test4pub39of100,1,191,13,329,1,343
test4sub4of100,test4pub39of100,1,191,13,330,1,344
test4sub56of100,test4pub39of100,1,191,13,334,0,347
test4sub34of100,test4pub39of100,1,191,13,338,1,352
test4sub52of100,test4pub39of100,1,191,13,340,0,353
test4sub30of100,test4pub39of100,1,191,13,341,1,355
test4sub84of100,test4pub39of100,1,191,13,346,2,361
test4sub65of100,test4pub39of100,1,191,13,347,2,362
test4sub86of100,test4pub39of100,1,191,13,348,1,362
test4sub20of100,test4pub39of100,1,191,13,353,1,367
test4sub69of100,test4pub39of100,1,191,13,356,1,370
test4sub14of100,test4pub39of100,1,191,13,360,2,375
test4sub54of100,test4pub39of100,1,191,13,360,3,376
test4sub2of100,test4pub39of100,1,191,13,361,2,376
test4sub51of100,test4pub39of100,1,191,13,362,1,376
test4sub59of100,test4pub39of100,1,191,13,364,1,378
test4sub95of100,test4pub39of100,1,191,13,367,2,382
test4sub75of100,test4pub39of100,1,191,13,365,3,381
test4sub76of100,test4pub39of100,1,191,13,366,1,380
test4sub64of100,test4pub39of100,1,191,13,365,2,380
test4sub85of100,test4pub39of100,1,191,13,371,1,385
test4sub89of100,test4pub39of100,1,191,13,375,1,389
test4sub62of100,test4pub39of100,1,191,13,376,1,390
test4sub55of100,test4pub39of100,1,191,13,379,1,393
test4sub82of100,test4pub39of100,1,191,13,380,1,394
test4sub45of100,test4pub40of100,1,191,14,6,1,21
test4sub74of100,test4pub40of100,1,191,14,6,1,21
test4sub2of100,test4pub40of100,1,191,14,11,1,26
test4sub3of100,test4pub40of100,1,191,14,12,2,28
test4sub55of100,test4pub40of100,1,191,14,12,2,28
test4sub88of100,test4pub40of100,1,191,14,13,1,28
test4sub81of100,test4pub40of100,1,191,14,17,1,32
test4sub82of100,test4pub40of100,1,191,14,20,1,35
test4sub78of100,test4pub40of100,1,191,14,21,3,38
test4sub100of100,test4pub40of100,1,191,14,23,3,40
test4sub76of100,test4pub40of100,1,191,14,22,4,40
test4sub31of100,test4pub40of100,1,191,14,23,3,40
test4sub38of100,test4pub40of100,1,191,14,25,3,42
test4sub15of100,test4pub40of100,1,191,14,25,4,43
test4sub61of100,test4pub40of100,1,191,14,28,1,43
test4sub35of100,test4pub40of100,1,191,14,28,2,44
test4sub54of100,test4pub40of100,1,191,14,35,1,50
test4sub84of100,test4pub40of100,1,191,14,36,1,51
test4sub95of100,test4pub40of100,1,191,14,38,1,53
test4sub46of100,test4pub40of100,1,191,14,39,2,55
test4sub94of100,test4pub40of100,1,191,14,41,2,57
test4sub9of100,test4pub40of100,1,191,14,41,1,56
test4sub29of100,test4pub40of100,1,191,14,46,1,61
test4sub20of100,test4pub40of100,1,191,14,47,2,63
test4sub33of100,test4pub40of100,1,191,14,48,4,66
test4sub17of100,test4pub40of100,1,191,14,50,4,68
test4sub89of100,test4pub40of100,1,191,14,50,7,71
test4sub14of100,test4pub40of100,1,191,14,51,7,72
test4sub67of100,test4pub40of100,1,191,14,51,8,73
test4sub69of100,test4pub40of100,1,191,14,52,7,73
test4sub56of100,test4pub40of100,1,191,14,54,7,75
test4sub21of100,test4pub40of100,1,191,14,55,6,75
test4sub32of100,test4pub40of100,1,191,14,55,5,74
test4sub7of100,test4pub40of100,1,191,14,55,6,75
test4sub51of100,test4pub40of100,1,191,14,56,7,77
test4sub80of100,test4pub40of100,1,191,14,57,7,78
test4sub98of100,test4pub40of100,1,191,14,59,6,79
test4sub64of100,test4pub40of100,1,191,14,62,2,78
test4sub13of100,test4pub40of100,1,191,14,62,3,79
test4sub86of100,test4pub40of100,1,191,14,63,2,79
test4sub5of100,test4pub40of100,1,191,14,66,2,82
test4sub96of100,test4pub40of100,1,191,14,68,2,84
test4sub39of100,test4pub40of100,1,191,14,67,4,85
test4sub58of100,test4pub40of100,1,191,14,70,3,87
test4sub91of100,test4pub40of100,1,191,14,70,3,87
test4sub53of100,test4pub40of100,1,191,14,71,3,88
test4sub43of100,test4pub40of100,1,191,14,73,3,90
test4sub87of100,test4pub40of100,1,191,14,74,1,89
test4sub99of100,test4pub40of100,1,191,14,77,1,92
test4sub68of100,test4pub40of100,1,191,14,81,1,96
test4sub18of100,test4pub40of100,1,191,14,81,3,98
test4sub62of100,test4pub40of100,1,191,14,82,4,100
test4sub44of100,test4pub40of100,1,191,14,83,3,100
test4sub11of100,test4pub40of100,1,191,14,85,2,101
test4sub16of100,test4pub40of100,1,191,14,85,2,101
test4sub73of100,test4pub40of100,1,191,14,89,0,103
test4sub93of100,test4pub40of100,1,191,14,92,0,106
test4sub27of100,test4pub40of100,1,191,14,92,1,107
test4sub28of100,test4pub40of100,1,191,14,95,1,110
test4sub34of100,test4pub40of100,1,191,14,96,0,110
test4sub40of100,test4pub40of100,1,191,14,101,1,116
test4sub83of100,test4pub40of100,1,191,14,102,4,120
test4sub72of100,test4pub40of100,1,191,14,103,3,120
test4sub63of100,test4pub40of100,1,191,14,103,4,121
test4sub10of100,test4pub40of100,1,191,14,104,3,121
test4sub85of100,test4pub40of100,1,191,14,105,4,123
test4sub6of100,test4pub40of100,1,191,14,106,4,124
test4sub30of100,test4pub40of100,1,191,14,108,6,128
test4sub52of100,test4pub40of100,1,191,14,110,5,129
test4sub90of100,test4pub40of100,1,191,14,110,4,128
test4sub22of100,test4pub40of100,1,191,14,111,4,129
test4sub26of100,test4pub40of100,1,191,14,111,3,128
test4sub66of100,test4pub40of100,1,191,14,111,3,128
test4sub47of100,test4pub40of100,1,191,14,113,6,133
test4sub65of100,test4pub40of100,1,191,14,113,3,130
test4sub79of100,test4pub40of100,1,191,14,117,6,137
test4sub92of100,test4pub40of100,1,191,14,118,7,139
test4sub37of100,test4pub40of100,1,191,14,118,7,139
test4sub70of100,test4pub40of100,1,191,14,119,6,139
test4sub49of100,test4pub40of100,1,191,14,119,6,139
test4sub97of100,test4pub40of100,1,191,14,120,6,140
test4sub42of100,test4pub40of100,1,191,14,122,5,141
test4sub41of100,test4pub40of100,1,191,14,122,5,141
test4sub71of100,test4pub40of100,1,191,14,123,4,141
test4sub24of100,test4pub40of100,1,191,14,125,3,142
test4sub48of100,test4pub39of100,1,191,13,605,1,619
test4sub48of100,test4pub40of100,1,191,14,172,1,187
test4sub8of100,test4pub39of100,1,191,13,622,1,636
test4sub8of100,test4pub40of100,1,191,14,190,1,205
test4sub50of100,test4pub38of100,1,191,11,971,1,983
test4sub50of100,test4pub39of100,1,191,13,638,1,652
test4sub50of100,test4pub40of100,1,191,14,205,1,220
test4sub77of100,test4pub40of100,1,191,14,311,1,326
test4sub4of100,test4pub40of100,1,191,14,319,1,334
test4sub59of100,test4pub40of100,1,191,14,326,1,341
test4sub23of100,test4pub40of100,1,191,14,333,0,347
test4sub12of100,test4pub40of100,1,191,14,343,1,358
test4sub57of100,test4pub40of100,1,191,14,345,1,360
test4sub75of100,test4pub40of100,1,191,14,355,2,371
test4sub73of100,test4pub41of100,1,191,11,12,2,25
test4sub90of100,test4pub41of100,1,191,11,14,1,26
test4sub72of100,test4pub41of100,1,191,11,15,1,27
test4sub25of100,test4pub40of100,1,191,14,361,1,376
test4sub35of100,test4pub41of100,1,191,11,20,1,32
test4sub38of100,test4pub41of100,1,191,11,20,1,32
test4sub7of100,test4pub41of100,1,191,11,25,0,36
test4sub28of100,test4pub41of100,1,191,11,30,0,41
test4sub19of100,test4pub40of100,1,191,14,378,2,394
test4sub1of100,test4pub40of100,1,191,14,379,2,395
test4sub36of100,test4pub40of100,1,191,14,380,2,396
test4sub16of100,test4pub41of100,1,191,11,38,3,52
test4sub18of100,test4pub41of100,1,191,11,39,3,53
test4sub23of100,test4pub41of100,1,191,11,40,4,55
test4sub54of100,test4pub41of100,1,191,11,40,5,56
test4sub60of100,test4pub40of100,1,191,14,385,4,403
test4sub34of100,test4pub41of100,1,191,11,43,2,56
test4sub22of100,test4pub41of100,1,191,11,43,3,57
test4sub45of100,test4pub41of100,1,191,11,50,0,61
test4sub10of100,test4pub41of100,1,191,11,53,1,65
test4sub66of100,test4pub41of100,1,191,11,54,2,67
test4sub21of100,test4pub41of100,1,191,11,54,2,67
test4sub52of100,test4pub41of100,1,191,11,56,1,68
test4sub64of100,test4pub41of100,1,191,11,60,2,73
test4sub55of100,test4pub41of100,1,191,11,60,2,73
test4sub44of100,test4pub41of100,1,191,11,61,2,74
test4sub11of100,test4pub41of100,1,191,11,61,2,74
test4sub26of100,test4pub41of100,1,191,11,64,1,76
test4sub75of100,test4pub41of100,1,191,11,67,1,79
test4sub63of100,test4pub41of100,1,191,11,67,1,79
test4sub3of100,test4pub41of100,1,191,11,71,1,83
test4sub17of100,test4pub41of100,1,191,11,86,1,98
test4sub53of100,test4pub41of100,1,191,11,86,1,98
test4sub95of100,test4pub41of100,1,191,11,91,2,104
test4sub83of100,test4pub41of100,1,191,11,91,2,104
test4sub13of100,test4pub41of100,1,191,11,93,3,107
test4sub61of100,test4pub41of100,1,191,11,95,2,108
test4sub99of100,test4pub41of100,1,191,11,95,2,108
test4sub78of100,test4pub41of100,1,191,11,120,10,141
test4sub37of100,test4pub41of100,1,191,11,120,10,141
test4sub56of100,test4pub41of100,1,191,11,122,10,143
test4sub50of100,test4pub41of100,1,191,11,123,20,154
test4sub98of100,test4pub41of100,1,191,11,123,20,154
test4sub85of100,test4pub41of100,1,191,11,124,20,155
test4sub19of100,test4pub41of100,1,191,11,125,20,156
test4sub82of100,test4pub41of100,1,191,11,125,21,157
test4sub74of100,test4pub41of100,1,191,11,126,19,156
test4sub39of100,test4pub41of100,1,191,11,126,19,156
test4sub89of100,test4pub41of100,1,191,11,127,20,158
test4sub86of100,test4pub41of100,1,191,11,127,19,157
test4sub68of100,test4pub41of100,1,191,11,128,20,159
test4sub9of100,test4pub41of100,1,191,11,128,22,161
test4sub5of100,test4pub41of100,1,191,11,129,22,162
test4sub41of100,test4pub41of100,1,191,11,133,18,162
test4sub60of100,test4pub41of100,1,191,11,134,18,163
test4sub30of100,test4pub41of100,1,191,11,134,19,164
test4sub20of100,test4pub41of100,1,191,11,135,17,163
test4sub88of100,test4pub41of100,1,191,11,135,17,163
test4sub96of100,test4pub41of100,1,191,11,136,17,164
test4sub51of100,test4pub41of100,1,191,11,137,16,164
test4sub62of100,test4pub41of100,1,191,11,137,16,164
test4sub15of100,test4pub41of100,1,191,11,138,16,165
test4sub79of100,test4pub41of100,1,191,11,138,16,165
test4sub70of100,test4pub41of100,1,191,11,139,15,165
test4sub31of100,test4pub41of100,1,191,11,140,14,165
test4sub33of100,test4pub41of100,1,191,11,140,15,166
test4sub8of100,test4pub41of100,1,191,11,136,14,161
test4sub40of100,test4pub41of100,1,191,11,140,14,165
test4sub93of100,test4pub41of100,1,191,11,140,15,166
test4sub12of100,test4pub41of100,1,191,11,148,9,168
test4sub97of100,test4pub41of100,1,191,11,149,8,168
test4sub27of100,test4pub41of100,1,191,11,149,9,169
test4sub2of100,test4pub41of100,1,191,11,150,8,169
test4sub48of100,test4pub41of100,1,191,11,323,1,335
test4sub49of100,test4pub41of100,1,191,11,327,1,339
test4sub76of100,test4pub41of100,1,191,11,328,1,340
test4sub25of100,test4pub41of100,1,191,11,332,0,343
test4sub100of100,test4pub41of100,1,191,11,332,1,344
test4sub36of100,test4pub41of100,1,191,11,335,1,347
test4sub91of100,test4pub41of100,1,191,11,339,1,351
test4sub69of100,test4pub41of100,1,191,11,342,2,355
test4sub14of100,test4pub41of100,1,191,11,342,2,355
test4sub4of100,test4pub41of100,1,191,11,343,1,355
test4sub71of100,test4pub41of100,1,191,11,349,1,361
test4sub6of100,test4pub41of100,1,191,11,350,2,363
test4sub65of100,test4pub41of100,1,191,11,351,2,364
test4sub1of100,test4pub41of100,1,191,11,351,6,368
test4sub87of100,test4pub41of100,1,191,11,355,3,369
test4sub92of100,test4pub41of100,1,191,11,356,3,370
test4sub81of100,test4pub41of100,1,191,11,354,5,370
test4sub46of100,test4pub41of100,1,191,11,356,4,371
test4sub43of100,test4pub41of100,1,191,11,357,3,371
test4sub84of100,test4pub41of100,1,191,11,357,3,371
test4sub77of100,test4pub41of100,1,191,11,365,1,377
test4sub80of100,test4pub41of100,1,191,11,366,1,378
test4sub32of100,test4pub41of100,1,191,11,369,1,381
test4sub67of100,test4pub41of100,1,191,11,370,5,386
test4sub94of100,test4pub41of100,1,191,11,371,6,388
test4sub58of100,test4pub41of100,1,191,11,371,4,386
test4sub24of100,test4pub41of100,1,191,11,372,4,387
test4sub42of100,test4pub41of100,1,191,11,373,4,388
test4sub47of100,test4pub41of100,1,191,11,374,4,389
test4sub57of100,test4pub41of100,1,191,11,375,3,389
test4sub59of100,test4pub41of100,1,191,11,379,1,391
test4sub29of100,test4pub41of100,1,191,11,391,1,403
test4sub61of100,test4pub42of100,1,191,14,5,1,20
test4sub8of100,test4pub42of100,1,191,14,6,1,21
test4sub19of100,test4pub42of100,1,191,14,12,1,27
test4sub68of100,test4pub42of100,1,191,14,14,0,28
test4sub38of100,test4pub42of100,1,191,14,19,1,34
test4sub69of100,test4pub42of100,1,191,14,20,1,35
test4sub1of100,test4pub42of100,1,191,14,24,1,39
test4sub95of100,test4pub42of100,1,191,14,28,1,43
test4sub45of100,test4pub42of100,1,191,14,31,1,46
test4sub67of100,test4pub42of100,1,191,14,31,1,46
test4sub76of100,test4pub42of100,1,191,14,36,1,51
test4sub89of100,test4pub42of100,1,191,14,38,0,52
test4sub97of100,test4pub42of100,1,191,14,48,1,63
test4sub62of100,test4pub42of100,1,191,14,48,1,63
test4sub50of100,test4pub42of100,1,191,14,51,1,66
test4sub79of100,test4pub42of100,1,191,14,52,1,67
test4sub23of100,test4pub42of100,1,191,14,53,3,70
test4sub20of100,test4pub42of100,1,191,14,55,1,70
test4sub18of100,test4pub42of100,1,191,14,55,1,70
test4sub84of100,test4pub42of100,1,191,14,54,3,71
test4sub91of100,test4pub42of100,1,191,14,62,1,77
test4sub33of100,test4pub42of100,1,191,14,66,2,82
test4sub87of100,test4pub42of100,1,191,14,66,3,83
test4sub21of100,test4pub42of100,1,191,14,67,2,83
test4sub15of100,test4pub42of100,1,191,14,67,4,85
test4sub51of100,test4pub42of100,1,191,14,68,3,85
test4sub41of100,test4pub42of100,1,191,14,70,1,85
test4sub27of100,test4pub42of100,1,191,14,76,0,90
test4sub73of100,test4pub42of100,1,191,14,79,1,94
test4sub14of100,test4pub42of100,1,191,14,79,1,94
test4sub3of100,test4pub42of100,1,191,14,85,1,100
test4sub56of100,test4pub42of100,1,191,14,88,1,103
test4sub4of100,test4pub42of100,1,191,14,89,1,104
test4sub78of100,test4pub42of100,1,191,14,96,0,110
test4sub66of100,test4pub42of100,1,191,14,96,1,111
test4sub96of100,test4pub42of100,1,191,14,99,1,114
test4sub72of100,test4pub42of100,1,191,14,106,1,121
test4sub94of100,test4pub42of100,1,191,14,106,1,121
test4sub92of100,test4pub42of100,1,191,14,109,1,124
test4sub90of100,test4pub42of100,1,191,14,108,1,123
test4sub11of100,test4pub42of100,1,191,14,111,6,131
test4sub100of100,test4pub42of100,1,191,14,112,5,131
test4sub44of100,test4pub42of100,1,191,14,112,4,130
test4sub6of100,test4pub42of100,1,191,14,113,4,131
test4sub34of100,test4pub42of100,1,191,14,113,4,131
test4sub86of100,test4pub42of100,1,191,14,114,3,131
test4sub39of100,test4pub42of100,1,191,14,114,3,131
test4sub58of100,test4pub42of100,1,191,14,115,4,133
test4sub36of100,test4pub42of100,1,191,14,115,3,132
test4sub7of100,test4pub42of100,1,191,14,125,2,141
test4sub63of100,test4pub42of100,1,191,14,125,3,142
test4sub29of100,test4pub42of100,1,191,14,126,1,141
test4sub48of100,test4pub42of100,1,191,14,129,0,143
test4sub28of100,test4pub42of100,1,191,14,131,1,146
test4sub57of100,test4pub42of100,1,191,14,132,1,147
test4sub81of100,test4pub42of100,1,191,14,134,10,158
test4sub80of100,test4pub42of100,1,191,14,135,9,158
test4sub99of100,test4pub42of100,1,191,14,135,10,159
test4sub42of100,test4pub42of100,1,191,14,137,9,160
test4sub17of100,test4pub42of100,1,191,14,137,9,160
test4sub64of100,test4pub42of100,1,191,14,138,8,160
test4sub88of100,test4pub42of100,1,191,14,138,8,160
test4sub49of100,test4pub42of100,1,191,14,139,8,161
test4sub54of100,test4pub42of100,1,191,14,139,8,161
test4sub32of100,test4pub42of100,1,191,14,140,8,162
test4sub9of100,test4pub42of100,1,191,14,142,8,164
test4sub60of100,test4pub42of100,1,191,14,141,9,164
test4sub37of100,test4pub42of100,1,191,14,143,7,164
test4sub30of100,test4pub42of100,1,191,14,143,8,165
test4sub70of100,test4pub42of100,1,191,14,144,10,168
test4sub93of100,test4pub42of100,1,191,14,148,8,170
test4sub47of100,test4pub42of100,1,191,14,149,8,171
test4sub55of100,test4pub42of100,1,191,14,152,5,171
test4sub83of100,test4pub42of100,1,191,14,153,6,173
test4sub59of100,test4pub42of100,1,191,14,154,6,174
test4sub13of100,test4pub42of100,1,191,14,155,5,174
test4sub85of100,test4pub42of100,1,191,14,156,5,175
test4sub74of100,test4pub42of100,1,191,14,158,3,175
test4sub26of100,test4pub42of100,1,191,14,159,2,175
test4sub77of100,test4pub42of100,1,191,14,159,2,175
test4sub82of100,test4pub42of100,1,191,14,344,2,360
test4sub46of100,test4pub42of100,1,191,14,345,1,360
test4sub25of100,test4pub42of100,1,191,14,346,1,361
test4sub10of100,test4pub42of100,1,191,14,348,1,363
test4sub35of100,test4pub42of100,1,191,14,350,1,365
test4sub43of100,test4pub42of100,1,191,14,353,1,368
test4sub98of100,test4pub42of100,1,191,14,355,2,371
test4sub31of100,test4pub42of100,1,191,14,355,1,370
test4sub53of100,test4pub42of100,1,191,14,356,1,371
test4sub52of100,test4pub42of100,1,191,14,357,1,372
test4sub2of100,test4pub42of100,1,191,14,360,1,375
test4sub71of100,test4pub42of100,1,191,14,367,0,381
test4sub22of100,test4pub42of100,1,191,14,374,2,390
test4sub12of100,test4pub42of100,1,191,14,374,1,389
test4sub65of100,test4pub42of100,1,191,14,376,4,394
test4sub27of100,test4pub43of100,1,191,15,24,3,42
test4sub15of100,test4pub43of100,1,191,15,24,4,43
test4sub40of100,test4pub42of100,1,191,14,379,3,396
test4sub75of100,test4pub42of100,1,191,14,380,3,397
test4sub24of100,test4pub42of100,1,191,14,381,2,397
test4sub92of100,test4pub43of100,1,191,15,30,1,46
test4sub16of100,test4pub42of100,1,191,14,386,1,401
test4sub63of100,test4pub43of100,1,191,15,38,1,54
test4sub29of100,test4pub43of100,1,191,15,38,1,54
test4sub64of100,test4pub43of100,1,191,15,40,2,57
test4sub41of100,test4pub43of100,1,191,15,41,1,57
test4sub2of100,test4pub43of100,1,191,15,43,1,59
test4sub5of100,test4pub42of100,1,191,14,401,1,416
test4sub95of100,test4pub43of100,1,191,15,50,1,66
test4sub35of100,test4pub43of100,1,191,15,52,1,68
test4sub37of100,test4pub43of100,1,191,15,53,2,70
test4sub76of100,test4pub43of100,1,191,15,54,1,70
test4sub55of100,test4pub43of100,1,191,15,60,1,76
test4sub7of100,test4pub43of100,1,191,15,61,2,78
test4sub88of100,test4pub43of100,1,191,15,62,4,81
test4sub87of100,test4pub43of100,1,191,15,63,4,82
test4sub50of100,test4pub43of100,1,191,15,64,4,83
test4sub9of100,test4pub43of100,1,191,15,65,6,86
test4sub74of100,test4pub43of100,1,191,15,66,5,86
test4sub82of100,test4pub43of100,1,191,15,66,5,86
test4sub99of100,test4pub43of100,1,191,15,68,4,87
test4sub51of100,test4pub43of100,1,191,15,69,3,87
test4sub65of100,test4pub43of100,1,191,15,70,3,88
test4sub36of100,test4pub43of100,1,191,15,73,1,89
test4sub73of100,test4pub43of100,1,191,15,75,1,91
test4sub13of100,test4pub43of100,1,191,15,94,1,110
test4sub84of100,test4pub43of100,1,191,15,93,1,109
test4sub93of100,test4pub43of100,1,191,15,96,1,112
test4sub20of100,test4pub43of100,1,191,15,98,1,114
test4sub12of100,test4pub43of100,1,191,15,98,1,114
test4sub30of100,test4pub43of100,1,191,15,102,1,118
test4sub48of100,test4pub43of100,1,191,15,107,1,123
test4sub75of100,test4pub43of100,1,191,15,112,0,127
test4sub19of100,test4pub43of100,1,191,15,116,1,132
test4sub86of100,test4pub43of100,1,191,15,118,1,134
test4sub70of100,test4pub43of100,1,191,15,120,2,137
test4sub94of100,test4pub43of100,1,191,15,121,2,138
test4sub91of100,test4pub43of100,1,191,15,122,1,138
test4sub53of100,test4pub43of100,1,191,15,125,1,141
test4sub4of100,test4pub43of100,1,191,15,125,1,141
test4sub81of100,test4pub43of100,1,191,15,129,1,145
test4sub17of100,test4pub43of100,1,191,15,130,2,147
test4sub66of100,test4pub43of100,1,191,15,131,1,147
test4sub45of100,test4pub43of100,1,191,15,134,1,150
test4sub56of100,test4pub43of100,1,191,15,137,2,154
test4sub16of100,test4pub43of100,1,191,15,136,4,155
test4sub78of100,test4pub43of100,1,191,15,137,4,156
test4sub71of100,test4pub43of100,1,191,15,140,7,162
test4sub61of100,test4pub43of100,1,191,15,138,16,169
test4sub98of100,test4pub43of100,1,191,15,140,15,170
test4sub11of100,test4pub43of100,1,191,15,141,15,171
test4sub44of100,test4pub43of100,1,191,15,143,16,174
test4sub67of100,test4pub43of100,1,191,15,142,17,174
test4sub42of100,test4pub43of100,1,191,15,144,17,176
test4sub5of100,test4pub43of100,1,191,15,145,15,175
test4sub24of100,test4pub43of100,1,191,15,146,16,177
test4sub14of100,test4pub43of100,1,191,15,145,16,176
test4sub59of100,test4pub43of100,1,191,15,146,17,178
test4sub21of100,test4pub43of100,1,191,15,149,13,177
test4sub26of100,test4pub43of100,1,191,15,150,13,178
test4sub8of100,test4pub43of100,1,191,15,147,16,178
test4sub58of100,test4pub43of100,1,191,15,148,16,179
test4sub40of100,test4pub43of100,1,191,15,150,14,179
test4sub83of100,test4pub43of100,1,191,15,151,15,181
test4sub28of100,test4pub43of100,1,191,15,151,14,180
test4sub57of100,test4pub43of100,1,191,15,152,14,181
test4sub6of100,test4pub43of100,1,191,15,152,14,181
test4sub80of100,test4pub43of100,1,191,15,153,14,182
test4sub96of100,test4pub43of100,1,191,15,151,13,179
test4sub10of100,test4pub43of100,1,191,15,154,14,183
test4sub3of100,test4pub43of100,1,191,15,155,12,182
test4sub90of100,test4pub43of100,1,191,15,144,12,171
test4sub25of100,test4pub43of100,1,191,15,159,14,188
test4sub32of100,test4pub43of100,1,191,15,160,12,187
test4sub47of100,test4pub43of100,1,191,15,157,14,186
test4sub62of100,test4pub43of100,1,191,15,168,10,193
test4sub52of100,test4pub43of100,1,191,15,170,9,194
test4sub22of100,test4pub43of100,1,191,15,174,10,199
test4sub60of100,test4pub43of100,1,191,15,176,11,202
test4sub38of100,test4pub43of100,1,191,15,170,8,193
test4sub89of100,test4pub43of100,1,191,15,175,12,202
test4sub34of100,test4pub43of100,1,191,15,175,16,206
test4sub18of100,test4pub43of100,1,191,15,174,16,205
test4sub46of100,test4pub43of100,1,191,15,173,17,205
test4sub33of100,test4pub43of100,1,191,15,171,20,206
test4sub1of100,test4pub43of100,1,191,15,171,21,207
test4sub77of100,test4pub43of100,1,191,15,348,1,364
test4sub100of100,test4pub43of100,1,191,15,363,1,379
test4sub69of100,test4pub43of100,1,191,15,364,1,380
test4sub49of100,test4pub43of100,1,191,15,372,1,388
test4sub97of100,test4pub43of100,1,191,15,378,1,394
test4sub31of100,test4pub43of100,1,191,15,386,1,402
test4sub39of100,test4pub43of100,1,191,15,396,2,413
test4sub43of100,test4pub43of100,1,191,15,397,4,416
test4sub23of100,test4pub43of100,1,191,15,398,5,418
test4sub72of100,test4pub43of100,1,191,15,399,5,419
test4sub68of100,test4pub43of100,1,191,15,400,5,420
test4sub79of100,test4pub43of100,1,191,15,401,4,420
test4sub85of100,test4pub43of100,1,191,15,402,3,420
test4sub54of100,test4pub43of100,1,191,15,403,2,420
test4sub28of100,test4pub44of100,1,191,22,3,1,26
test4sub13of100,test4pub44of100,1,191,22,6,1,29
test4sub56of100,test4pub44of100,1,191,22,7,1,30
test4sub20of100,test4pub44of100,1,191,22,13,1,36
test4sub73of100,test4pub44of100,1,191,22,16,1,39
test4sub77of100,test4pub44of100,1,191,22,26,0,48
test4sub4of100,test4pub44of100,1,191,22,26,1,49
test4sub94of100,test4pub44of100,1,191,22,32,1,55
test4sub54of100,test4pub44of100,1,191,22,37,0,59
test4sub89of100,test4pub44of100,1,191,22,39,1,62
test4sub53of100,test4pub44of100,1,191,22,48,2,72
test4sub90of100,test4pub44of100,1,191,22,49,6,77
test4sub1of100,test4pub44of100,1,191,22,50,5,77
test4sub63of100,test4pub44of100,1,191,22,50,8,80
test4sub19of100,test4pub44of100,1,191,22,52,7,81
test4sub3of100,test4pub44of100,1,191,22,52,6,80
test4sub85of100,test4pub44of100,1,191,22,53,6,81
test4sub52of100,test4pub44of100,1,191,22,53,6,81
test4sub74of100,test4pub44of100,1,191,22,54,5,81
test4sub81of100,test4pub44of100,1,191,22,56,4,82
test4sub86of100,test4pub44of100,1,191,22,56,4,82
test4sub71of100,test4pub44of100,1,191,22,56,5,83
test4sub22of100,test4pub44of100,1,191,22,57,4,83
test4sub67of100,test4pub44of100,1,191,22,67,1,90
test4sub18of100,test4pub44of100,1,191,22,66,1,89
test4sub51of100,test4pub44of100,1,191,22,69,0,91
test4sub61of100,test4pub44of100,1,191,22,77,1,100
test4sub69of100,test4pub44of100,1,191,22,77,2,101
test4sub6of100,test4pub44of100,1,191,22,78,3,103
test4sub9of100,test4pub44of100,1,191,22,81,3,106
test4sub55of100,test4pub44of100,1,191,22,80,3,105
test4sub24of100,test4pub44of100,1,191,22,82,2,106
test4sub16of100,test4pub44of100,1,191,22,83,2,107
test4sub32of100,test4pub44of100,1,191,22,95,1,118
test4sub84of100,test4pub44of100,1,191,22,97,1,120
test4sub98of100,test4pub44of100,1,191,22,97,1,120
test4sub47of100,test4pub44of100,1,191,22,105,1,128
test4sub96of100,test4pub44of100,1,191,22,106,2,130
test4sub17of100,test4pub44of100,1,191,22,107,1,130
test4sub27of100,test4pub44of100,1,191,22,109,1,132
test4sub8of100,test4pub44of100,1,191,22,110,1,133
test4sub88of100,test4pub44of100,1,191,22,112,1,135
test4sub36of100,test4pub44of100,1,191,22,113,1,136
test4sub95of100,test4pub44of100,1,191,22,142,1,165
test4sub83of100,test4pub44of100,1,191,22,143,1,166
test4sub10of100,test4pub44of100,1,191,22,148,1,171
test4sub39of100,test4pub44of100,1,191,22,148,2,172
test4sub2of100,test4pub44of100,1,191,22,150,1,173
test4sub58of100,test4pub44of100,1,191,22,152,1,175
test4sub57of100,test4pub44of100,1,191,22,152,1,175
test4sub43of100,test4pub44of100,1,191,22,163,1,186
test4sub91of100,test4pub44of100,1,191,22,164,1,187
test4sub46of100,test4pub44of100,1,191,22,166,1,189
test4sub100of100,test4pub44of100,1,191,22,167,3,192
test4sub66of100,test4pub44of100,1,191,22,168,3,193
test4sub49of100,test4pub44of100,1,191,22,169,3,194
test4sub68of100,test4pub44of100,1,191,22,170,3,195
test4sub31of100,test4pub44of100,1,191,22,170,3,195
test4sub92of100,test4pub44of100,1,191,22,172,2,196
test4sub21of100,test4pub44of100,1,191,22,175,1,198
test4sub26of100,test4pub44of100,1,191,22,175,1,198
test4sub25of100,test4pub44of100,1,191,22,180,0,202
test4sub48of100,test4pub44of100,1,191,22,201,4,227
test4sub72of100,test4pub44of100,1,191,22,202,3,227
test4sub87of100,test4pub44of100,1,191,22,202,8,232
test4sub41of100,test4pub44of100,1,191,22,203,8,233
test4sub33of100,test4pub44of100,1,191,22,205,9,236
test4sub30of100,test4pub44of100,1,191,22,207,9,238
test4sub82of100,test4pub44of100,1,191,22,208,9,239
test4sub59of100,test4pub44of100,1,191,22,209,8,239
test4sub78of100,test4pub44of100,1,191,22,210,8,240
test4sub44of100,test4pub44of100,1,191,22,211,8,241
test4sub97of100,test4pub44of100,1,191,22,213,6,241
test4sub93of100,test4pub44of100,1,191,22,213,7,242
test4sub75of100,test4pub44of100,1,191,22,217,4,243
test4sub38of100,test4pub44of100,1,191,22,222,0,244
test4sub65of100,test4pub44of100,1,191,22,224,1,247
test4sub37of100,test4pub44of100,1,191,22,234,1,257
test4sub11of100,test4pub44of100,1,191,22,237,3,262
test4sub70of100,test4pub44of100,1,191,22,239,3,264
test4sub45of100,test4pub44of100,1,191,22,240,3,265
test4sub80of100,test4pub44of100,1,191,22,241,1,264
test4sub35of100,test4pub44of100,1,191,22,247,1,270
test4sub50of100,test4pub44of100,1,191,22,248,4,274
test4sub7of100,test4pub44of100,1,191,22,249,3,274
test4sub5of100,test4pub44of100,1,191,22,250,3,275
test4sub29of100,test4pub44of100,1,191,22,250,4,276
test4sub60of100,test4pub44of100,1,191,22,255,1,278
test4sub14of100,test4pub44of100,1,191,22,258,4,284
test4sub62of100,test4pub44of100,1,191,22,259,3,284
test4sub64of100,test4pub44of100,1,191,22,260,3,285
test4sub12of100,test4pub44of100,1,191,22,260,3,285
test4sub23of100,test4pub44of100,1,191,22,262,2,286
test4sub42of100,test4pub44of100,1,191,22,265,1,288
test4sub76of100,test4pub44of100,1,191,22,269,1,292
test4sub40of100,test4pub44of100,1,191,22,268,2,292
test4sub99of100,test4pub44of100,1,191,22,271,1,294
test4sub15of100,test4pub44of100,1,191,22,273,2,297
test4sub34of100,test4pub44of100,1,191,22,274,3,299
test4sub79of100,test4pub44of100,1,191,22,275,2,299
test4sub81of100,test4pub45of100,1,191,19,7,0,26
test4sub99of100,test4pub45of100,1,191,19,15,0,34
test4sub58of100,test4pub45of100,1,191,19,21,1,41
test4sub52of100,test4pub45of100,1,191,19,21,2,42
test4sub48of100,test4pub45of100,1,191,19,23,1,43
test4sub54of100,test4pub45of100,1,191,19,24,1,44
test4sub5of100,test4pub45of100,1,191,19,33,1,53
test4sub55of100,test4pub45of100,1,191,19,33,1,53
test4sub21of100,test4pub45of100,1,191,19,37,1,57
test4sub8of100,test4pub45of100,1,191,19,37,1,57
test4sub2of100,test4pub45of100,1,191,19,39,1,59
test4sub15of100,test4pub45of100,1,191,19,41,1,61
test4sub45of100,test4pub45of100,1,191,19,40,2,61
test4sub34of100,test4pub45of100,1,191,19,47,1,67
test4sub74of100,test4pub45of100,1,191,19,50,2,71
test4sub38of100,test4pub45of100,1,191,19,51,2,72
test4sub31of100,test4pub45of100,1,191,19,51,3,73
test4sub10of100,test4pub45of100,1,191,19,53,2,74
test4sub78of100,test4pub45of100,1,191,19,53,2,74
test4sub4of100,test4pub45of100,1,191,19,63,1,83
test4sub6of100,test4pub45of100,1,191,19,64,2,85
test4sub97of100,test4pub45of100,1,191,19,65,2,86
test4sub19of100,test4pub45of100,1,191,19,65,3,87
test4sub57of100,test4pub45of100,1,191,19,66,2,87
test4sub35of100,test4pub45of100,1,191,19,67,1,87
test4sub36of100,test4pub45of100,1,191,19,78,2,99
test4sub64of100,test4pub45of100,1,191,19,80,1,100
test4sub11of100,test4pub45of100,1,191,19,80,1,100
test4sub63of100,test4pub45of100,1,191,19,84,0,103
test4sub60of100,test4pub45of100,1,191,19,86,1,106
test4sub49of100,test4pub45of100,1,191,19,89,2,110
test4sub37of100,test4pub45of100,1,191,19,90,3,112
test4sub89of100,test4pub45of100,1,191,19,91,4,114
test4sub72of100,test4pub45of100,1,191,19,91,3,113
test4sub51of100,test4pub45of100,1,191,19,93,2,114
test4sub46of100,test4pub45of100,1,191,19,93,2,114
test4sub70of100,test4pub45of100,1,191,19,100,1,120
test4sub96of100,test4pub45of100,1,191,19,102,1,122
test4sub25of100,test4pub45of100,1,191,19,104,2,125
test4sub47of100,test4pub45of100,1,191,19,105,3,127
test4sub28of100,test4pub45of100,1,191,19,105,9,133
test4sub86of100,test4pub45of100,1,191,19,106,9,134
test4sub42of100,test4pub45of100,1,191,19,107,8,134
test4sub94of100,test4pub45of100,1,191,19,108,9,136
test4sub23of100,test4pub45of100,1,191,19,108,8,135
test4sub76of100,test4pub45of100,1,191,19,110,7,136
test4sub98of100,test4pub45of100,1,191,19,110,7,136
test4sub95of100,test4pub45of100,1,191,19,112,6,137
test4sub91of100,test4pub45of100,1,191,19,112,6,137
test4sub69of100,test4pub45of100,1,191,19,113,6,138
test4sub85of100,test4pub45of100,1,191,19,113,5,137
test4sub40of100,test4pub45of100,1,191,19,114,5,138
test4sub80of100,test4pub45of100,1,191,19,128,1,148
test4sub93of100,test4pub45of100,1,191,19,129,1,149
test4sub20of100,test4pub45of100,1,191,19,132,1,152
test4sub87of100,test4pub45of100,1,191,19,135,0,154
test4sub1of100,test4pub45of100,1,191,19,137,1,157
test4sub32of100,test4pub45of100,1,191,19,173,1,193
test4sub66of100,test4pub45of100,1,191,19,175,0,194
test4sub75of100,test4pub45of100,1,191,19,178,1,198
test4sub33of100,test4pub45of100,1,191,19,180,1,200
test4sub79of100,test4pub45of100,1,191,19,181,2,202
test4sub61of100,test4pub45of100,1,191,19,183,2,204
test4sub12of100,test4pub45of100,1,191,19,184,3,206
test4sub71of100,test4pub45of100,1,191,19,185,3,207
test4sub30of100,test4pub45of100,1,191,19,186,4,209
test4sub29of100,test4pub45of100,1,191,19,186,4,209
test4sub24of100,test4pub45of100,1,191,19,188,3,210
test4sub59of100,test4pub45of100,1,191,19,189,4,212
test4sub50of100,test4pub45of100,1,191,19,192,1,212
test4sub43of100,test4pub45of100,1,191,19,192,2,213
test4sub100of100,test4pub45of100,1,191,19,196,2,217
test4sub62of100,test4pub45of100,1,191,19,197,7,223
test4sub44of100,test4pub45of100,1,191,19,198,7,224
test4sub13of100,test4pub45of100,1,191,19,198,8,225
test4sub68of100,test4pub45of100,1,191,19,199,8,226
test4sub27of100,test4pub45of100,1,191,19,200,7,226
test4sub26of100,test4pub45of100,1,191,19,200,8,227
test4sub84of100,test4pub45of100,1,191,19,201,7,227
test4sub67of100,test4pub45of100,1,191,19,202,8,229
test4sub56of100,test4pub45of100,1,191,19,202,7,228
test4sub39of100,test4pub45of100,1,191,19,203,6,228
test4sub65of100,test4pub45of100,1,191,19,204,6,229
test4sub22of100,test4pub45of100,1,191,19,206,5,230
test4sub90of100,test4pub45of100,1,191,19,207,3,229
test4sub82of100,test4pub45of100,1,191,19,238,1,258
test4sub16of100,test4pub45of100,1,191,19,239,1,259
test4sub7of100,test4pub45of100,1,191,19,240,1,260
test4sub53of100,test4pub45of100,1,191,19,244,1,264
test4sub41of100,test4pub45of100,1,191,19,244,2,265
test4sub18of100,test4pub45of100,1,191,19,246,2,267
test4sub14of100,test4pub45of100,1,191,19,249,2,270
test4sub83of100,test4pub45of100,1,191,19,250,2,271
test4sub92of100,test4pub45of100,1,191,19,250,2,271
test4sub77of100,test4pub45of100,1,191,19,249,3,271
test4sub3of100,test4pub45of100,1,191,19,247,6,272
test4sub73of100,test4pub45of100,1,191,19,247,3,269
test4sub9of100,test4pub45of100,1,191,19,332,1,352
test4sub88of100,test4pub45of100,1,191,19,340,1,360
test4sub17of100,test4pub45of100,1,191,19,344,1,364
test4sub90of100,test4pub46of100,1,191,18,4,1,23
test4sub93of100,test4pub46of100,1,191,18,5,1,24
test4sub49of100,test4pub46of100,1,191,18,13,4,35
test4sub96of100,test4pub46of100,1,191,18,15,3,36
test4sub74of100,test4pub46of100,1,191,18,15,5,38
test4sub57of100,test4pub46of100,1,191,18,16,4,38
test4sub12of100,test4pub46of100,1,191,18,17,5,40
test4sub8of100,test4pub46of100,1,191,18,18,3,39
test4sub37of100,test4pub46of100,1,191,18,19,3,40
test4sub69of100,test4pub46of100,1,191,18,17,3,38
test4sub55of100,test4pub46of100,1,191,18,38,1,57
test4sub80of100,test4pub46of100,1,191,18,38,3,59
test4sub30of100,test4pub46of100,1,191,18,39,2,59
test4sub1of100,test4pub46of100,1,191,18,40,2,60
test4sub44of100,test4pub46of100,1,191,18,43,1,62
test4sub100of100,test4pub46of100,1,191,18,44,1,63
test4sub91of100,test4pub46of100,1,191,18,56,1,75
test4sub62of100,test4pub46of100,1,191,18,58,0,76
test4sub39of100,test4pub46of100,1,191,18,66,1,85
test4sub54of100,test4pub46of100,1,191,18,72,1,91
test4sub13of100,test4pub46of100,1,191,18,73,1,92
test4sub16of100,test4pub46of100,1,191,18,75,1,94
test4sub10of100,test4pub46of100,1,191,18,76,3,97
test4sub51of100,test4pub46of100,1,191,18,77,2,97
test4sub31of100,test4pub46of100,1,191,18,78,2,98
test4sub4of100,test4pub46of100,1,191,18,77,4,99
test4sub75of100,test4pub46of100,1,191,18,80,3,101
test4sub67of100,test4pub46of100,1,191,18,81,1,100
test4sub66of100,test4pub46of100,1,191,18,107,2,127
test4sub83of100,test4pub46of100,1,191,18,108,1,127
test4sub61of100,test4pub46of100,1,191,18,107,3,128
test4sub84of100,test4pub46of100,1,191,18,108,2,128
test4sub23of100,test4pub46of100,1,191,18,112,1,131
test4sub56of100,test4pub46of100,1,191,18,113,16,147
test4sub97of100,test4pub46of100,1,191,18,114,16,148
test4sub60of100,test4pub46of100,1,191,18,114,16,148
test4sub99of100,test4pub46of100,1,191,18,115,15,148
test4sub95of100,test4pub46of100,1,191,18,116,16,150
test4sub43of100,test4pub46of100,1,191,18,117,14,149
test4sub92of100,test4pub46of100,1,191,18,118,14,150
test4sub38of100,test4pub46of100,1,191,18,119,14,151
test4sub78of100,test4pub46of100,1,191,18,119,15,152
test4sub48of100,test4pub46of100,1,191,18,117,17,152
test4sub82of100,test4pub46of100,1,191,18,120,18,156
test4sub14of100,test4pub46of100,1,191,18,120,18,156
test4sub11of100,test4pub46of100,1,191,18,121,18,157
test4sub24of100,test4pub46of100,1,191,18,121,17,156
test4sub21of100,test4pub46of100,1,191,18,122,17,157
test4sub63of100,test4pub46of100,1,191,18,117,17,152
test4sub40of100,test4pub46of100,1,191,18,121,16,155
test4sub88of100,test4pub46of100,1,191,18,124,16,158
test4sub33of100,test4pub46of100,1,191,18,121,16,155
test4sub6of100,test4pub46of100,1,191,18,125,16,159
test4sub7of100,test4pub46of100,1,191,18,126,15,159
test4sub77of100,test4pub46of100,1,191,18,126,15,159
test4sub65of100,test4pub46of100,1,191,18,128,14,160
test4sub89of100,test4pub46of100,1,191,18,128,15,161
test4sub9of100,test4pub46of100,1,191,18,128,13,159
test4sub76of100,test4pub46of100,1,191,18,129,13,160
test4sub71of100,test4pub46of100,1,191,18,133,10,161
test4sub68of100,test4pub46of100,1,191,18,135,8,161
test4sub59of100,test4pub46of100,1,191,18,135,8,161
test4sub36of100,test4pub46of100,1,191,18,136,9,163
test4sub52of100,test4pub46of100,1,191,18,137,8,163
test4sub72of100,test4pub46of100,1,191,18,153,1,172
test4sub18of100,test4pub46of100,1,191,18,155,1,174
test4sub29of100,test4pub46of100,1,191,18,155,2,175
test4sub26of100,test4pub46of100,1,191,18,156,2,176
test4sub27of100,test4pub46of100,1,191,18,158,2,178
test4sub34of100,test4pub46of100,1,191,18,160,1,179
test4sub73of100,test4pub46of100,1,191,18,163,0,181
test4sub50of100,test4pub46of100,1,191,18,163,1,182
test4sub28of100,test4pub46of100,1,191,18,164,1,183
test4sub53of100,test4pub46of100,1,191,18,177,1,196
test4sub19of100,test4pub46of100,1,191,18,177,1,196
test4sub3of100,test4pub46of100,1,191,18,185,3,206
test4sub98of100,test4pub46of100,1,191,18,186,3,207
test4sub85of100,test4pub46of100,1,191,18,187,3,208
test4sub64of100,test4pub46of100,1,191,18,187,2,207
test4sub87of100,test4pub46of100,1,191,18,188,3,209
test4sub22of100,test4pub46of100,1,191,18,190,8,216
test4sub94of100,test4pub46of100,1,191,18,191,8,217
test4sub45of100,test4pub46of100,1,191,18,192,7,217
test4sub46of100,test4pub46of100,1,191,18,192,8,218
test4sub35of100,test4pub46of100,1,191,18,193,7,218
test4sub41of100,test4pub46of100,1,191,18,194,7,219
test4sub15of100,test4pub46of100,1,191,18,194,7,219
test4sub79of100,test4pub46of100,1,191,18,195,7,220
test4sub42of100,test4pub46of100,1,191,18,195,7,220
test4sub81of100,test4pub46of100,1,191,18,196,6,220
test4sub17of100,test4pub46of100,1,191,18,197,5,220
test4sub58of100,test4pub46of100,1,191,18,198,5,221
test4sub2of100,test4pub46of100,1,191,18,334,1,353
test4sub25of100,test4pub46of100,1,191,18,350,1,369
test4sub47of100,test4pub46of100,1,191,18,351,0,369
test4sub20of100,test4pub46of100,1,191,18,352,1,371
test4sub32of100,test4pub46of100,1,191,18,363,2,383
test4sub86of100,test4pub46of100,1,191,18,365,1,384
test4sub5of100,test4pub46of100,1,191,18,378,1,397
test4sub70of100,test4pub46of100,1,191,18,390,1,409
test4sub52of100,test4pub47of100,1,191,10,9,0,19
test4sub5of100,test4pub47of100,1,191,10,11,0,21
test4sub60of100,test4pub47of100,1,191,10,13,1,24
test4sub27of100,test4pub47of100,1,191,10,18,2,30
test4sub3of100,test4pub47of100,1,191,10,19,2,31
test4sub6of100,test4pub47of100,1,191,10,20,2,32
test4sub22of100,test4pub47of100,1,191,10,24,1,35
test4sub13of100,test4pub47of100,1,191,10,28,1,39
test4sub9of100,test4pub47of100,1,191,10,30,2,42
test4sub92of100,test4pub47of100,1,191,10,31,4,45
test4sub4of100,test4pub47of100,1,191,10,33,4,47
test4sub29of100,test4pub47of100,1,191,10,32,7,49
test4sub14of100,test4pub47of100,1,191,10,33,6,49
test4sub82of100,test4pub47of100,1,191,10,34,5,49
test4sub98of100,test4pub47of100,1,191,10,36,4,50
test4sub57of100,test4pub47of100,1,191,10,37,3,50
test4sub97of100,test4pub47of100,1,191,10,38,3,51
test4sub68of100,test4pub47of100,1,191,10,39,3,52
test4sub43of100,test4pub47of100,1,191,10,43,1,54
test4sub90of100,test4pub47of100,1,191,10,44,1,55
test4sub96of100,test4pub47of100,1,191,10,50,1,61
test4sub67of100,test4pub47of100,1,191,10,54,1,65
test4sub1of100,test4pub47of100,1,191,10,53,2,65
test4sub88of100,test4pub47of100,1,191,10,55,1,66
test4sub76of100,test4pub47of100,1,191,10,74,1,85
test4sub65of100,test4pub47of100,1,191,10,78,2,90
test4sub20of100,test4pub47of100,1,191,10,78,4,92
test4sub45of100,test4pub47of100,1,191,10,80,5,95
test4sub73of100,test4pub47of100,1,191,10,80,6,96
test4sub78of100,test4pub47of100,1,191,10,81,5,96
test4sub28of100,test4pub47of100,1,191,10,83,4,97
test4sub70of100,test4pub47of100,1,191,10,82,5,97
test4sub19of100,test4pub47of100,1,191,10,83,4,97
test4sub95of100,test4pub47of100,1,191,10,84,3,97
test4sub83of100,test4pub47of100,1,191,10,85,3,98
test4sub46of100,test4pub47of100,1,191,10,90,1,101
test4sub32of100,test4pub47of100,1,191,10,90,4,104
test4sub35of100,test4pub47of100,1,191,10,91,6,107
test4sub85of100,test4pub47of100,1,191,10,92,9,111
test4sub59of100,test4pub47of100,1,191,10,93,9,112
test4sub99of100,test4pub47of100,1,191,10,94,9,113
test4sub49of100,test4pub47of100,1,191,10,93,9,112
test4sub50of100,test4pub47of100,1,191,10,96,8,114
test4sub30of100,test4pub47of100,1,191,10,97,7,114
test4sub25of100,test4pub47of100,1,191,10,97,7,114
test4sub56of100,test4pub47of100,1,191,10,99,6,115
test4sub53of100,test4pub47of100,1,191,10,98,6,114
test4sub40of100,test4pub47of100,1,191,10,100,6,116
test4sub94of100,test4pub47of100,1,191,10,100,6,116
test4sub37of100,test4pub47of100,1,191,10,101,6,117
test4sub8of100,test4pub47of100,1,191,10,162,1,173
test4sub91of100,test4pub47of100,1,191,10,163,1,174
test4sub64of100,test4pub47of100,1,191,10,165,2,177
test4sub58of100,test4pub47of100,1,191,10,166,2,178
test4sub26of100,test4pub47of100,1,191,10,167,2,179
test4sub61of100,test4pub47of100,1,191,10,167,1,178
test4sub75of100,test4pub47of100,1,191,10,170,1,181
test4sub51of100,test4pub47of100,1,191,10,170,1,181
test4sub39of100,test4pub47of100,1,191,10,174,2,186
test4sub41of100,test4pub47of100,1,191,10,174,10,194
test4sub42of100,test4pub47of100,1,191,10,175,11,196
test4sub72of100,test4pub47of100,1,191,10,176,10,196
test4sub33of100,test4pub47of100,1,191,10,177,11,198
test4sub44of100,test4pub47of100,1,191,10,177,11,198
test4sub17of100,test4pub47of100,1,191,10,178,11,199
test4sub15of100,test4pub47of100,1,191,10,178,11,199
test4sub12of100,test4pub47of100,1,191,10,179,10,199
test4sub80of100,test4pub47of100,1,191,10,179,11,200
test4sub7of100,test4pub47of100,1,191,10,180,10,200
test4sub24of100,test4pub47of100,1,191,10,181,9,200
test4sub62of100,test4pub47of100,1,191,10,181,10,201
test4sub74of100,test4pub47of100,1,191,10,182,9,201
test4sub86of100,test4pub47of100,1,191,10,183,9,202
test4sub54of100,test4pub47of100,1,191,10,184,8,202
test4sub100of100,test4pub47of100,1,191,10,185,7,202
test4sub79of100,test4pub47of100,1,191,10,186,7,203
test4sub47of100,test4pub47of100,1,191,10,324,0,334
test4sub2of100,test4pub47of100,1,191,10,332,1,343
test4sub31of100,test4pub47of100,1,191,10,340,1,351
test4sub89of100,test4pub47of100,1,191,10,344,1,355
test4sub55of100,test4pub47of100,1,191,10,346,1,357
test4sub87of100,test4pub47of100,1,191,10,351,0,361
test4sub18of100,test4pub47of100,1,191,10,357,1,368
test4sub63of100,test4pub47of100,1,191,10,358,1,369
test4sub38of100,test4pub47of100,1,191,10,359,1,370
test4sub69of100,test4pub47of100,1,191,10,359,1,370
test4sub23of100,test4pub47of100,1,191,10,362,1,373
test4sub84of100,test4pub47of100,1,191,10,362,2,374
test4sub77of100,test4pub47of100,1,191,10,364,1,375
test4sub36of100,test4pub47of100,1,191,10,367,1,378
test4sub10of100,test4pub47of100,1,191,10,367,1,378
test4sub71of100,test4pub47of100,1,191,10,370,0,380
test4sub34of100,test4pub47of100,1,191,10,386,1,397
test4sub16of100,test4pub47of100,1,191,10,387,1,398
test4sub81of100,test4pub47of100,1,191,10,388,2,400
test4sub11of100,test4pub47of100,1,191,10,389,1,400
test4sub93of100,test4pub47of100,1,191,10,396,2,408
test4sub21of100,test4pub47of100,1,191,10,396,2,408
test4sub48of100,test4pub47of100,1,191,10,397,1,408
test4sub66of100,test4pub47of100,1,191,10,397,2,409
test4sub84of100,test4pub48of100,1,191,13,12,1,26
test4sub94of100,test4pub48of100,1,191,13,17,1,31
test4sub87of100,test4pub48of100,1,191,13,18,1,32
test4sub41of100,test4pub48of100,1,191,13,22,1,36
test4sub13of100,test4pub48of100,1,191,13,24,1,38
test4sub59of100,test4pub48of100,1,191,13,27,1,41
test4sub48of100,test4pub48of100,1,191,13,28,1,42
test4sub5of100,test4pub48of100,1,191,13,33,1,47
test4sub88of100,test4pub48of100,1,191,13,47,1,61
test4sub17of100,test4pub48of100,1,191,13,48,3,64
test4sub3of100,test4pub48of100,1,191,13,49,3,65
test4sub23of100,test4pub48of100,1,191,13,49,4,66
test4sub82of100,test4pub48of100,1,191,13,50,3,66
test4sub14of100,test4pub48of100,1,191,13,52,1,66
test4sub52of100,test4pub48of100,1,191,13,55,0,68
test4sub61of100,test4pub48of100,1,191,13,57,1,71
test4sub72of100,test4pub48of100,1,191,13,63,3,79
test4sub86of100,test4pub48of100,1,191,13,64,2,79
test4sub76of100,test4pub48of100,1,191,13,64,2,79
test4sub55of100,test4pub48of100,1,191,13,65,1,79
test4sub79of100,test4pub48of100,1,191,13,74,0,87
test4sub68of100,test4pub48of100,1,191,13,76,1,90
test4sub34of100,test4pub48of100,1,191,13,80,0,93
test4sub83of100,test4pub48of100,1,191,13,85,1,99
test4sub46of100,test4pub48of100,1,191,13,87,1,101
test4sub30of100,test4pub48of100,1,191,13,90,1,104
test4sub66of100,test4pub48of100,1,191,13,95,1,109
test4sub9of100,test4pub48of100,1,191,13,97,1,111
test4sub80of100,test4pub48of100,1,191,13,102,1,116
test4sub20of100,test4pub48of100,1,191,13,103,1,117
test4sub63of100,test4pub48of100,1,191,13,114,1,128
test4sub37of100,test4pub48of100,1,191,13,116,1,130
test4sub54of100,test4pub48of100,1,191,13,115,3,131
test4sub89of100,test4pub48of100,1,191,13,117,2,132
test4sub62of100,test4pub48of100,1,191,13,141,1,155
test4sub4of100,test4pub48of100,1,191,13,142,1,156
test4sub67of100,test4pub48of100,1,191,13,144,1,158
test4sub70of100,test4pub48of100,1,191,13,143,3,159
test4sub77of100,test4pub48of100,1,191,13,145,4,162
test4sub22of100,test4pub48of100,1,191,13,146,4,163
test4sub11of100,test4pub48of100,1,191,13,148,4,165
test4sub33of100,test4pub48of100,1,191,13,149,4,166
test4sub6of100,test4pub48of100,1,191,13,149,4,166
test4sub26of100,test4pub48of100,1,191,13,150,5,168
test4sub81of100,test4pub48of100,1,191,13,152,4,169
test4sub28of100,test4pub48of100,1,191,13,154,3,170
test4sub31of100,test4pub48of100,1,191,13,157,1,171
test4sub19of100,test4pub48of100,1,191,13,155,4,172
test4sub15of100,test4pub48of100,1,191,13,156,3,172
test4sub27of100,test4pub48of100,1,191,13,158,2,173
test4sub18of100,test4pub48of100,1,191,13,162,1,176
test4sub75of100,test4pub48of100,1,191,13,162,1,176
test4sub49of100,test4pub48of100,1,191,13,185,1,199
test4sub12of100,test4pub48of100,1,191,13,187,1,201
test4sub43of100,test4pub48of100,1,191,13,193,1,207
test4sub73of100,test4pub48of100,1,191,13,192,1,206
test4sub98of100,test4pub48of100,1,191,13,195,1,209
test4sub51of100,test4pub48of100,1,191,13,198,2,213
test4sub99of100,test4pub48of100,1,191,13,199,2,214
test4sub45of100,test4pub48of100,1,191,13,200,3,216
test4sub60of100,test4pub48of100,1,191,13,201,2,216
test4sub47of100,test4pub48of100,1,191,13,202,1,216
test4sub90of100,test4pub48of100,1,191,13,209,1,223
test4sub57of100,test4pub48of100,1,191,13,210,1,224
test4sub8of100,test4pub48of100,1,191,13,211,1,225
test4sub95of100,test4pub48of100,1,191,13,213,3,229
test4sub50of100,test4pub48of100,1,191,13,214,4,231
test4sub96of100,test4pub48of100,1,191,13,214,5,232
test4sub64of100,test4pub48of100,1,191,13,216,5,234
test4sub44of100,test4pub48of100,1,191,13,216,6,235
test4sub91of100,test4pub48of100,1,191,13,218,8,239
test4sub7of100,test4pub48of100,1,191,13,218,8,239
test4sub56of100,test4pub48of100,1,191,13,220,7,240
test4sub78of100,test4pub48of100,1,191,13,222,5,240
test4sub85of100,test4pub48of100,1,191,13,222,6,241
test4sub58of100,test4pub48of100,1,191,13,223,5,241
test4sub25of100,test4pub48of100,1,191,13,223,6,242
test4sub24of100,test4pub48of100,1,191,13,224,5,242
test4sub2of100,test4pub48of100,1,191,13,225,4,242
test4sub32of100,test4pub48of100,1,191,13,226,4,243
test4sub74of100,test4pub48of100,1,191,13,252,1,266
test4sub38of100,test4pub48of100,1,191,13,258,2,273
test4sub93of100,test4pub48of100,1,191,13,258,5,276
test4sub36of100,test4pub48of100,1,191,13,259,4,276
test4sub69of100,test4pub48of100,1,191,13,259,5,277
test4sub65of100,test4pub48of100,1,191,13,260,4,277
test4sub100of100,test4pub48of100,1,191,13,262,3,278
test4sub16of100,test4pub48of100,1,191,13,262,3,278
test4sub21of100,test4pub48of100,1,191,13,268,1,282
test4sub1of100,test4pub48of100,1,191,13,279,1,293
test4sub29of100,test4pub48of100,1,191,13,279,1,293
test4sub71of100,test4pub48of100,1,191,13,286,1,300
test4sub53of100,test4pub48of100,1,191,13,287,1,301
test4sub35of100,test4pub48of100,1,191,13,290,1,304
test4sub39of100,test4pub48of100,1,191,13,307,1,321
test4sub97of100,test4pub48of100,1,191,13,310,1,324
test4sub42of100,test4pub48of100,1,191,13,318,1,332
test4sub92of100,test4pub48of100,1,191,13,318,1,332
test4sub40of100,test4pub48of100,1,191,13,320,0,333
test4sub10of100,test4pub48of100,1,191,13,326,1,340
test4sub65of100,test4pub49of100,1,191,16,5,1,22
test4sub88of100,test4pub49of100,1,191,16,7,1,24
test4sub83of100,test4pub49of100,1,191,16,16,1,33
test4sub82of100,test4pub49of100,1,191,16,17,2,35
test4sub30of100,test4pub49of100,1,191,16,18,1,35
test4sub20of100,test4pub49of100,1,191,16,20,0,36
test4sub43of100,test4pub49of100,1,191,16,28,1,45
test4sub66of100,test4pub49of100,1,191,16,29,1,46
test4sub74of100,test4pub49of100,1,191,16,32,1,49
test4sub53of100,test4pub49of100,1,191,16,32,2,50
test4sub29of100,test4pub49of100,1,191,16,34,1,51
test4sub10of100,test4pub49of100,1,191,16,33,3,52
test4sub70of100,test4pub49of100,1,191,16,35,1,52
test4sub93of100,test4pub49of100,1,191,16,48,1,65
test4sub80of100,test4pub49of100,1,191,16,49,2,67
test4sub32of100,test4pub49of100,1,191,16,51,2,69
test4sub85of100,test4pub49of100,1,191,16,51,3,70
test4sub84of100,test4pub49of100,1,191,16,52,4,72
test4sub26of100,test4pub49of100,1,191,16,53,3,72
test4sub25of100,test4pub49of100,1,191,16,54,3,73
test4sub23of100,test4pub49of100,1,191,16,55,2,73
test4sub28of100,test4pub49of100,1,191,16,58,3,77
test4sub18of100,test4pub49of100,1,191,16,59,3,78
test4sub69of100,test4pub49of100,1,191,16,59,4,79
test4sub47of100,test4pub49of100,1,191,16,60,4,80
test4sub79of100,test4pub49of100,1,191,16,61,3,80
test4sub62of100,test4pub49of100,1,191,16,63,2,81
test4sub52of100,test4pub49of100,1,191,16,68,1,85
test4sub3of100,test4pub49of100,1,191,16,70,0,86
test4sub49of100,test4pub49of100,1,191,16,69,2,87
test4sub15of100,test4pub49of100,1,191,16,73,0,89
test4sub97of100,test4pub49of100,1,191,16,74,1,91
test4sub13of100,test4pub49of100,1,191,16,75,0,91
test4sub55of100,test4pub49of100,1,191,16,79,1,96
test4sub31of100,test4pub49of100,1,191,16,79,2,97
test4sub87of100,test4pub49of100,1,191,16,81,1,98
test4sub58of100,test4pub49of100,1,191,16,83,1,100
test4sub99of100,test4pub49of100,1,191,16,83,1,100
test4sub14of100,test4pub49of100,1,191,16,88,5,109
test4sub4of100,test4pub49of100,1,191,16,89,5,110
test4sub34of100,test4pub49of100,1,191,16,90,4,110
test4sub35of100,test4pub49of100,1,191,16,90,4,110
test4sub100of100,test4pub49of100,1,191,16,91,5,112
test4sub11of100,test4pub49of100,1,191,16,92,5,113
test4sub12of100,test4pub49of100,1,191,16,92,6,114
test4sub6of100,test4pub49of100,1,191,16,93,5,114
test4sub91of100,test4pub49of100,1,191,16,96,3,115
test4sub1of100,test4pub49of100,1,191,16,98,2,116
test4sub63of100,test4pub49of100,1,191,16,100,1,117
test4sub96of100,test4pub49of100,1,191,16,99,3,118
test4sub81of100,test4pub49of100,1,191,16,102,2,120
test4sub94of100,test4pub49of100,1,191,16,103,1,120
test4sub75of100,test4pub49of100,1,191,16,103,2,121
test4sub73of100,test4pub49of100,1,191,16,106,2,124
test4sub9of100,test4pub49of100,1,191,16,107,3,126
test4sub36of100,test4pub49of100,1,191,16,108,1,125
test4sub77of100,test4pub49of100,1,191,16,109,3,128
test4sub19of100,test4pub49of100,1,191,16,111,2,129
test4sub51of100,test4pub49of100,1,191,16,111,2,129
test4sub46of100,test4pub49of100,1,191,16,113,1,130
test4sub38of100,test4pub49of100,1,191,16,115,3,134
test4sub37of100,test4pub49of100,1,191,16,117,4,137
test4sub57of100,test4pub49of100,1,191,16,117,5,138
test4sub67of100,test4pub49of100,1,191,16,116,6,138
test4sub78of100,test4pub49of100,1,191,16,118,5,139
test4sub33of100,test4pub49of100,1,191,16,119,6,141
test4sub27of100,test4pub49of100,1,191,16,120,6,142
test4sub98of100,test4pub49of100,1,191,16,121,12,149
test4sub92of100,test4pub49of100,1,191,16,122,12,150
test4sub41of100,test4pub49of100,1,191,16,124,11,151
test4sub50of100,test4pub49of100,1,191,16,125,12,153
test4sub76of100,test4pub49of100,1,191,16,126,10,152
test4sub54of100,test4pub49of100,1,191,16,127,10,153
test4sub56of100,test4pub49of100,1,191,16,128,9,153
test4sub90of100,test4pub49of100,1,191,16,130,7,153
test4sub95of100,test4pub49of100,1,191,16,130,8,154
test4sub86of100,test4pub49of100,1,191,16,131,7,154
test4sub8of100,test4pub49of100,1,191,16,131,7,154
test4sub68of100,test4pub49of100,1,191,16,132,7,155
test4sub16of100,test4pub49of100,1,191,16,133,7,156
test4sub44of100,test4pub49of100,1,191,16,134,5,155
test4sub89of100,test4pub49of100,1,191,16,135,5,156
test4sub42of100,test4pub49of100,1,191,16,144,3,163
test4sub2of100,test4pub49of100,1,191,16,144,4,164
test4sub71of100,test4pub49of100,1,191,16,146,4,166
test4sub17of100,test4pub49of100,1,191,16,146,4,166
test4sub60of100,test4pub49of100,1,191,16,147,3,166
test4sub64of100,test4pub49of100,1,191,16,148,3,167
test4sub45of100,test4pub49of100,1,191,16,149,2,167
test4sub2of100,test4pub50of100,1,191,10,9,1,20
test4sub47of100,test4pub50of100,1,191,10,10,3,23
test4sub11of100,test4pub50of100,1,191,10,11,2,23
test4sub71of100,test4pub50of100,1,191,10,13,1,24
test4sub72of100,test4pub49of100,1,191,16,371,1,388
test4sub37of100,test4pub50of100,1,191,10,26,1,37
test4sub48of100,test4pub49of100,1,191,16,380,2,398
test4sub5of100,test4pub49of100,1,191,16,381,2,399
test4sub33of100,test4pub50of100,1,191,10,29,4,43
test4sub59of100,test4pub49of100,1,191,16,384,3,403
test4sub13of100,test4pub50of100,1,191,10,32,2,44
test4sub76of100,test4pub50of100,1,191,10,32,3,45
test4sub35of100,test4pub50of100,1,191,10,33,2,45
test4sub74of100,test4pub50of100,1,191,10,38,1,49
test4sub72of100,test4pub50of100,1,191,10,45,1,56
test4sub83of100,test4pub50of100,1,191,10,46,1,57
test4sub25of100,test4pub50of100,1,191,10,50,1,61
test4sub63of100,test4pub50of100,1,191,10,51,1,62
test4sub23of100,test4pub50of100,1,191,10,53,1,64
test4sub66of100,test4pub50of100,1,191,10,57,1,68
test4sub60of100,test4pub50of100,1,191,10,60,1,71
test4sub64of100,test4pub50of100,1,191,10,60,2,72
test4sub22of100,test4pub49of100,1,191,16,415,1,432
test4sub38of100,test4pub50of100,1,191,10,62,1,73
test4sub24of100,test4pub49of100,1,191,16,419,5,440
test4sub99of100,test4pub50of100,1,191,10,65,6,81
test4sub61of100,test4pub49of100,1,191,16,420,6,442
test4sub73of100,test4pub50of100,1,191,10,67,7,84
test4sub3of100,test4pub50of100,1,191,10,68,7,85
test4sub8of100,test4pub50of100,1,191,10,69,7,86
test4sub97of100,test4pub50of100,1,191,10,69,8,87
test4sub4of100,test4pub50of100,1,191,10,71,6,87
test4sub58of100,test4pub50of100,1,191,10,73,6,89
test4sub77of100,test4pub50of100,1,191,10,74,21,105
test4sub89of100,test4pub50of100,1,191,10,75,20,105
test4sub56of100,test4pub50of100,1,191,10,73,23,106
test4sub91of100,test4pub50of100,1,191,10,79,5,94
test4sub87of100,test4pub50of100,1,191,10,89,8,107
test4sub50of100,test4pub50of100,1,191,10,90,10,110
test4sub21of100,test4pub49of100,1,191,16,445,9,470
test4sub69of100,test4pub50of100,1,191,10,91,10,111
test4sub81of100,test4pub50of100,1,191,10,92,9,111
test4sub85of100,test4pub50of100,1,191,10,93,9,112
test4sub90of100,test4pub50of100,1,191,10,94,8,112
test4sub94of100,test4pub50of100,1,191,10,94,10,114
test4sub17of100,test4pub50of100,1,191,10,95,9,114
test4sub93of100,test4pub50of100,1,191,10,97,8,115
test4sub67of100,test4pub50of100,1,191,10,79,8,97
test4sub9of100,test4pub50of100,1,191,10,98,8,116
test4sub70of100,test4pub50of100,1,191,10,99,7,116
test4sub52of100,test4pub50of100,1,191,10,103,4,117
test4sub49of100,test4pub50of100,1,191,10,100,8,118
test4sub18of100,test4pub50of100,1,191,10,103,4,117
test4sub20of100,test4pub50of100,1,191,10,109,1,120
test4sub12of100,test4pub50of100,1,191,10,108,2,120
test4sub100of100,test4pub50of100,1,191,10,109,1,120
test4sub7of100,test4pub49of100,1,191,16,465,2,483
test4sub44of100,test4pub50of100,1,191,10,113,3,126
test4sub62of100,test4pub50of100,1,191,10,114,1,125
test4sub41of100,test4pub50of100,1,191,10,116,1,127
test4sub79of100,test4pub50of100,1,191,10,119,0,129
test4sub88of100,test4pub50of100,1,191,10,121,0,131
test4sub96of100,test4pub50of100,1,191,10,123,0,133
test4sub98of100,test4pub50of100,1,191,10,124,3,137
test4sub22of100,test4pub50of100,1,191,10,126,3,139
test4sub48of100,test4pub50of100,1,191,10,126,2,138
test4sub46of100,test4pub50of100,1,191,10,127,5,142
test4sub30of100,test4pub50of100,1,191,10,129,4,143
test4sub24of100,test4pub50of100,1,191,10,130,3,143
test4sub95of100,test4pub50of100,1,191,10,131,4,145
test4sub31of100,test4pub50of100,1,191,10,132,5,147
test4sub54of100,test4pub50of100,1,191,10,133,5,148
test4sub82of100,test4pub50of100,1,191,10,134,5,149
test4sub80of100,test4pub50of100,1,191,10,136,5,151
test4sub26of100,test4pub50of100,1,191,10,137,7,154
test4sub43of100,test4pub50of100,1,191,10,138,6,154
test4sub65of100,test4pub50of100,1,191,10,139,5,154
test4sub36of100,test4pub50of100,1,191,10,140,5,155
test4sub68of100,test4pub50of100,1,191,10,141,6,157
test4sub19of100,test4pub50of100,1,191,10,143,4,157
test4sub32of100,test4pub50of100,1,191,10,144,5,159
test4sub6of100,test4pub50of100,1,191,10,146,2,158
test4sub34of100,test4pub50of100,1,191,10,150,1,161
test4sub16of100,test4pub50of100,1,191,10,150,1,161
test4sub21of100,test4pub50of100,1,191,10,153,3,166
test4sub27of100,test4pub50of100,1,191,10,153,3,166
test4sub14of100,test4pub50of100,1,191,10,154,2,166
test4sub42of100,test4pub50of100,1,191,10,154,3,167
test4sub39of100,test4pub49of100,1,191,16,508,2,526
test4sub7of100,test4pub50of100,1,191,10,160,1,171
test4sub39of100,test4pub50of100,1,191,10,174,1,185
test4sub93of100,test4pub51of100,1,191,15,6,1,22
test4sub52of100,test4pub51of100,1,191,15,8,1,24
test4sub35of100,test4pub51of100,1,191,15,12,1,28
test4sub57of100,test4pub50of100,1,191,10,352,1,363
test4sub55of100,test4pub50of100,1,191,10,355,2,367
test4sub54of100,test4pub51of100,1,191,15,26,1,42
test4sub94of100,test4pub51of100,1,191,15,27,1,43
test4sub25of100,test4pub51of100,1,191,15,33,1,49
test4sub33of100,test4pub51of100,1,191,15,34,1,50
test4sub74of100,test4pub51of100,1,191,15,36,1,52
test4sub36of100,test4pub51of100,1,191,15,36,3,54
test4sub44of100,test4pub51of100,1,191,15,37,2,54
test4sub20of100,test4pub51of100,1,191,15,39,2,56
test4sub7of100,test4pub51of100,1,191,15,39,3,57
test4sub6of100,test4pub51of100,1,191,15,41,1,57
test4sub31of100,test4pub51of100,1,191,15,44,1,60
test4sub68of100,test4pub51of100,1,191,15,45,1,61
test4sub84of100,test4pub50of100,1,191,10,390,1,401
test4sub48of100,test4pub51of100,1,191,15,60,3,78
test4sub4of100,test4pub51of100,1,191,15,62,1,78
test4sub50of100,test4pub51of100,1,191,15,63,2,80
test4sub95of100,test4pub51of100,1,191,15,62,3,80
test4sub59of100,test4pub50of100,1,191,10,394,2,406
test4sub72of100,test4pub51of100,1,191,15,70,1,86
test4sub12of100,test4pub51of100,1,191,15,70,1,86
test4sub100of100,test4pub51of100,1,191,15,79,1,95
test4sub14of100,test4pub51of100,1,191,15,81,1,97
test4sub3of100,test4pub51of100,1,191,15,82,1,98
test4sub10of100,test4pub50of100,1,191,10,413,1,424
test4sub11of100,test4pub51of100,1,191,15,85,2,102
test4sub5of100,test4pub50of100,1,191,10,416,1,427
test4sub76of100,test4pub51of100,1,191,15,89,1,105
test4sub63of100,test4pub51of100,1,191,15,100,1,116
test4sub30of100,test4pub51of100,1,191,15,102,1,118
test4sub24of100,test4pub51of100,1,191,15,102,1,118
test4sub19of100,test4pub51of100,1,191,15,106,1,122
test4sub27of100,test4pub51of100,1,191,15,129,1,145
test4sub8of100,test4pub51of100,1,191,15,129,1,145
test4sub86of100,test4pub50of100,1,191,10,462,1,473
test4sub16of100,test4pub51of100,1,191,15,136,1,152
test4sub83of100,test4pub51of100,1,191,15,137,1,153
test4sub51of100,test4pub50of100,1,191,10,469,0,479
test4sub17of100,test4pub51of100,1,191,15,142,2,159
test4sub15of100,test4pub50of100,1,191,10,473,3,486
test4sub42of100,test4pub51of100,1,191,15,144,2,161
test4sub64of100,test4pub51of100,1,191,15,145,1,161
test4sub89of100,test4pub51of100,1,191,15,155,1,171
test4sub34of100,test4pub51of100,1,191,15,157,3,175
test4sub28of100,test4pub50of100,1,191,10,488,2,500
test4sub96of100,test4pub51of100,1,191,15,160,1,176
test4sub57of100,test4pub51of100,1,191,15,163,1,179
test4sub18of100,test4pub51of100,1,191,15,164,2,181
test4sub55of100,test4pub51of100,1,191,15,165,1,181
test4sub84of100,test4pub51of100,1,191,15,167,1,183
test4sub60of100,test4pub51of100,1,191,15,168,1,184
test4sub99of100,test4pub51of100,1,191,15,170,1,186
test4sub37of100,test4pub51of100,1,191,15,172,0,187
test4sub23of100,test4pub51of100,1,191,15,173,1,189
test4sub49of100,test4pub51of100,1,191,15,179,1,195
test4sub97of100,test4pub51of100,1,191,15,188,0,203
test4sub61of100,test4pub50of100,1,191,10,519,2,531
test4sub78of100,test4pub50of100,1,191,10,520,1,531
test4sub59of100,test4pub51of100,1,191,15,208,1,224
test4sub1of100,test4pub50of100,1,191,10,538,3,551
test4sub88of100,test4pub51of100,1,191,15,209,2,226
test4sub70of100,test4pub51of100,1,191,15,210,2,227
test4sub81of100,test4pub51of100,1,191,15,210,1,226
test4sub85of100,test4pub51of100,1,191,15,223,1,239
test4sub67of100,test4pub51of100,1,191,15,226,1,242
test4sub21of100,test4pub51of100,1,191,15,226,2,243
test4sub75of100,test4pub50of100,1,191,10,557,1,568
test4sub58of100,test4pub51of100,1,191,15,237,1,253
test4sub41of100,test4pub51of100,1,191,15,237,2,254
test4sub62of100,test4pub51of100,1,191,15,244,1,260
test4sub91of100,test4pub51of100,1,191,15,248,1,264
test4sub45of100,test4pub50of100,1,191,10,584,1,595
test4sub77of100,test4pub51of100,1,191,15,259,1,275
test4sub53of100,test4pub50of100,1,191,10,592,1,603
test4sub73of100,test4pub51of100,1,191,15,263,1,279
test4sub32of100,test4pub51of100,1,191,15,270,1,286
test4sub80of100,test4pub51of100,1,191,15,275,0,290
test4sub43of100,test4pub51of100,1,191,15,277,1,293
test4sub46of100,test4pub51of100,1,191,15,277,2,294
test4sub98of100,test4pub51of100,1,191,15,278,2,295
test4sub71of100,test4pub51of100,1,191,15,298,1,314
test4sub90of100,test4pub51of100,1,191,15,298,2,315
test4sub69of100,test4pub51of100,1,191,15,299,1,315
test4sub2of100,test4pub51of100,1,191,15,311,1,327
test4sub66of100,test4pub51of100,1,191,15,313,1,329
test4sub5of100,test4pub51of100,1,191,15,313,1,329
test4sub13of100,test4pub51of100,1,191,15,321,1,337
test4sub22of100,test4pub51of100,1,191,15,322,1,338
test4sub29of100,test4pub50of100,1,191,10,658,2,670
test4sub10of100,test4pub51of100,1,191,15,328,3,346
test4sub9of100,test4pub51of100,1,191,15,330,3,348
test4sub65of100,test4pub51of100,1,191,15,331,1,347
test4sub56of100,test4pub51of100,1,191,15,334,1,350
test4sub47of100,test4pub51of100,1,191,15,341,1,357
test4sub87of100,test4pub51of100,1,191,15,347,3,365
test4sub82of100,test4pub51of100,1,191,15,348,2,365
test4sub26of100,test4pub51of100,1,191,15,349,2,366
test4sub38of100,test4pub51of100,1,191,15,357,1,373
test4sub39of100,test4pub51of100,1,191,15,357,1,373
test4sub79of100,test4pub51of100,1,191,15,366,1,382
test4sub92of100,test4pub50of100,1,191,10,697,2,709
test4sub86of100,test4pub51of100,1,191,15,371,1,387
test4sub51of100,test4pub51of100,1,191,15,377,4,396
test4sub15of100,test4pub51of100,1,191,15,379,6,400
test4sub28of100,test4pub51of100,1,191,15,379,7,401
test4sub61of100,test4pub51of100,1,191,15,380,5,400
test4sub78of100,test4pub51of100,1,191,15,383,3,401
test4sub1of100,test4pub51of100,1,191,15,385,5,405
test4sub75of100,test4pub51of100,1,191,15,388,2,405
test4sub45of100,test4pub51of100,1,191,15,389,3,407
test4sub53of100,test4pub51of100,1,191,15,390,1,406
test4sub29of100,test4pub51of100,1,191,15,396,1,412
test4sub92of100,test4pub51of100,1,191,15,399,0,414
test4sub40of100,test4pub49of100,1,191,16,1162,0,1178
test4sub40of100,test4pub50of100,1,191,10,811,1,822
test4sub40of100,test4pub51of100,1,191,15,483,0,498
test4sub100of100,test4pub52of100,1,191,18,5,1,24
test4sub37of100,test4pub52of100,1,191,18,7,0,25
test4sub30of100,test4pub52of100,1,191,18,10,0,28
test4sub94of100,test4pub52of100,1,191,18,14,1,33
test4sub10of100,test4pub52of100,1,191,18,15,1,34
test4sub61of100,test4pub52of100,1,191,18,20,1,39
test4sub4of100,test4pub52of100,1,191,18,21,1,40
test4sub51of100,test4pub52of100,1,191,18,24,1,43
test4sub99of100,test4pub52of100,1,191,18,29,1,48
test4sub33of100,test4pub52of100,1,191,18,30,0,48
test4sub98of100,test4pub52of100,1,191,18,34,1,53
test4sub93of100,test4pub52of100,1,191,18,34,1,53
test4sub46of100,test4pub52of100,1,191,18,36,2,56
test4sub97of100,test4pub52of100,1,191,18,37,2,57
test4sub50of100,test4pub52of100,1,191,18,37,3,58
test4sub26of100,test4pub52of100,1,191,18,39,1,58
test4sub12of100,test4pub52of100,1,191,18,54,1,73
test4sub63of100,test4pub52of100,1,191,18,56,2,76
test4sub67of100,test4pub52of100,1,191,18,57,2,77
test4sub27of100,test4pub52of100,1,191,18,58,4,80
test4sub43of100,test4pub52of100,1,191,18,57,5,80
test4sub78of100,test4pub52of100,1,191,18,59,5,82
test4sub54of100,test4pub52of100,1,191,18,60,4,82
test4sub80of100,test4pub52of100,1,191,18,61,3,82
test4sub84of100,test4pub52of100,1,191,18,63,2,83
test4sub35of100,test4pub52of100,1,191,18,64,4,86
test4sub18of100,test4pub52of100,1,191,18,66,4,88
test4sub17of100,test4pub52of100,1,191,18,67,5,90
test4sub1of100,test4pub52of100,1,191,18,68,7,93
test4sub86of100,test4pub52of100,1,191,18,67,6,91
test4sub90of100,test4pub52of100,1,191,18,70,8,96
test4sub70of100,test4pub52of100,1,191,18,71,8,97
test4sub49of100,test4pub52of100,1,191,18,72,9,99
test4sub47of100,test4pub52of100,1,191,18,73,7,98
test4sub95of100,test4pub52of100,1,191,18,75,5,98
test4sub72of100,test4pub52of100,1,191,18,76,5,99
test4sub81of100,test4pub52of100,1,191,18,76,5,99
test4sub44of100,test4pub52of100,1,191,18,77,4,99
test4sub8of100,test4pub52of100,1,191,18,78,4,100
test4sub64of100,test4pub52of100,1,191,18,79,3,100
test4sub96of100,test4pub52of100,1,191,18,88,1,107
test4sub89of100,test4pub52of100,1,191,18,89,3,110
test4sub16of100,test4pub52of100,1,191,18,90,1,109
test4sub82of100,test4pub52of100,1,191,18,92,1,111
test4sub53of100,test4pub52of100,1,191,18,93,1,112
test4sub15of100,test4pub52of100,1,191,18,95,1,114
test4sub92of100,test4pub52of100,1,191,18,94,2,114
test4sub91of100,test4pub52of100,1,191,18,98,1,117
test4sub21of100,test4pub52of100,1,191,18,100,1,119
test4sub11of100,test4pub52of100,1,191,18,106,1,125
test4sub38of100,test4pub52of100,1,191,18,106,2,126
test4sub85of100,test4pub52of100,1,191,18,108,1,127
test4sub73of100,test4pub52of100,1,191,18,110,1,129
test4sub34of100,test4pub52of100,1,191,18,115,1,134
test4sub62of100,test4pub52of100,1,191,18,116,0,134
test4sub58of100,test4pub52of100,1,191,18,121,1,140
test4sub36of100,test4pub52of100,1,191,18,122,4,144
test4sub25of100,test4pub52of100,1,191,18,123,5,146
test4sub5of100,test4pub52of100,1,191,18,124,6,148
test4sub77of100,test4pub52of100,1,191,18,125,4,147
test4sub22of100,test4pub52of100,1,191,18,125,5,148
test4sub42of100,test4pub52of100,1,191,18,126,4,148
test4sub55of100,test4pub52of100,1,191,18,128,4,150
test4sub48of100,test4pub52of100,1,191,18,127,4,149
test4sub87of100,test4pub52of100,1,191,18,129,3,150
test4sub19of100,test4pub52of100,1,191,18,134,1,153
test4sub76of100,test4pub52of100,1,191,18,132,3,153
test4sub65of100,test4pub52of100,1,191,18,133,3,154
test4sub56of100,test4pub52of100,1,191,18,135,2,155
test4sub69of100,test4pub52of100,1,191,18,136,5,159
test4sub14of100,test4pub52of100,1,191,18,138,4,160
test4sub75of100,test4pub52of100,1,191,18,139,4,161
test4sub52of100,test4pub52of100,1,191,18,139,4,161
test4sub45of100,test4pub52of100,1,191,18,141,4,163
test4sub29of100,test4pub52of100,1,191,18,141,4,163
test4sub60of100,test4pub52of100,1,191,18,142,2,162
test4sub68of100,test4pub52of100,1,191,18,179,1,198
test4sub7of100,test4pub52of100,1,191,18,182,1,201
test4sub74of100,test4pub52of100,1,191,18,187,1,206
test4sub79of100,test4pub52of100,1,191,18,190,0,208
test4sub32of100,test4pub52of100,1,191,18,191,2,211
test4sub39of100,test4pub52of100,1,191,18,190,4,212
test4sub40of100,test4pub52of100,1,191,18,193,2,213
test4sub23of100,test4pub52of100,1,191,18,193,4,215
test4sub59of100,test4pub52of100,1,191,18,194,2,214
test4sub88of100,test4pub52of100,1,191,18,196,1,215
test4sub31of100,test4pub52of100,1,191,18,201,1,220
test4sub57of100,test4pub52of100,1,191,18,200,2,220
test4sub9of100,test4pub52of100,1,191,18,203,1,222
test4sub71of100,test4pub52of100,1,191,18,204,1,223
test4sub24of100,test4pub52of100,1,191,18,207,2,227
test4sub3of100,test4pub52of100,1,191,18,208,1,227
test4sub20of100,test4pub52of100,1,191,18,353,1,372
test4sub83of100,test4pub52of100,1,191,18,361,1,380
test4sub6of100,test4pub52of100,1,191,18,369,1,388
test4sub41of100,test4pub52of100,1,191,18,385,1,404
test4sub71of100,test4pub53of100,1,191,12,7,1,20
test4sub93of100,test4pub53of100,1,191,12,9,0,21
test4sub64of100,test4pub53of100,1,191,12,18,1,31
test4sub17of100,test4pub53of100,1,191,12,19,2,33
test4sub47of100,test4pub53of100,1,191,12,20,1,33
test4sub52of100,test4pub53of100,1,191,12,29,1,42
test4sub95of100,test4pub53of100,1,191,12,31,1,44
test4sub3of100,test4pub53of100,1,191,12,33,1,46
test4sub79of100,test4pub53of100,1,191,12,38,1,51
test4sub97of100,test4pub53of100,1,191,12,38,1,51
test4sub77of100,test4pub53of100,1,191,12,41,1,54
test4sub63of100,test4pub53of100,1,191,12,42,1,55
test4sub11of100,test4pub53of100,1,191,12,43,1,56
test4sub18of100,test4pub53of100,1,191,12,60,3,75
test4sub81of100,test4pub53of100,1,191,12,60,4,76
test4sub65of100,test4pub53of100,1,191,12,62,4,78
test4sub4of100,test4pub53of100,1,191,12,62,4,78
test4sub96of100,test4pub53of100,1,191,12,63,4,79
test4sub90of100,test4pub53of100,1,191,12,64,2,78
test4sub34of100,test4pub53of100,1,191,12,66,2,80
test4sub42of100,test4pub53of100,1,191,12,68,1,81
test4sub27of100,test4pub53of100,1,191,12,79,0,91
test4sub7of100,test4pub53of100,1,191,12,81,0,93
test4sub22of100,test4pub53of100,1,191,12,82,2,96
test4sub66of100,test4pub52of100,1,191,18,469,2,489
test4sub74of100,test4pub53of100,1,191,12,83,2,97
test4sub12of100,test4pub53of100,1,191,12,85,2,99
test4sub51of100,test4pub53of100,1,191,12,89,1,102
test4sub99of100,test4pub53of100,1,191,12,103,1,116
test4sub50of100,test4pub53of100,1,191,12,103,1,116
test4sub70of100,test4pub53of100,1,191,12,108,1,121
test4sub14of100,test4pub53of100,1,191,12,109,2,123
test4sub68of100,test4pub53of100,1,191,12,110,1,123
test4sub30of100,test4pub53of100,1,191,12,121,1,134
test4sub5of100,test4pub53of100,1,191,12,123,2,137
test4sub57of100,test4pub53of100,1,191,12,124,4,140
test4sub39of100,test4pub53of100,1,191,12,121,9,142
test4sub73of100,test4pub53of100,1,191,12,122,9,143
test4sub45of100,test4pub53of100,1,191,12,124,8,144
test4sub23of100,test4pub53of100,1,191,12,125,8,145
test4sub8of100,test4pub53of100,1,191,12,127,7,146
test4sub89of100,test4pub53of100,1,191,12,128,7,147
test4sub62of100,test4pub53of100,1,191,12,128,7,147
test4sub85of100,test4pub53of100,1,191,12,127,7,146
test4sub75of100,test4pub53of100,1,191,12,130,5,147
test4sub13of100,test4pub52of100,1,191,18,518,5,541
test4sub80of100,test4pub53of100,1,191,12,130,4,146
test4sub36of100,test4pub53of100,1,191,12,133,3,148
test4sub43of100,test4pub53of100,1,191,12,146,1,159
test4sub41of100,test4pub53of100,1,191,12,147,1,160
test4sub29of100,test4pub53of100,1,191,12,149,1,162
test4sub15of100,test4pub53of100,1,191,12,151,1,164
test4sub28of100,test4pub52of100,1,191,18,540,1,559
test4sub1of100,test4pub53of100,1,191,12,154,1,167
test4sub6of100,test4pub53of100,1,191,12,155,5,172
test4sub87of100,test4pub53of100,1,191,12,157,5,174
test4sub33of100,test4pub53of100,1,191,12,157,5,174
test4sub56of100,test4pub53of100,1,191,12,158,4,174
test4sub58of100,test4pub53of100,1,191,12,159,4,175
test4sub35of100,test4pub53of100,1,191,12,159,6,177
test4sub61of100,test4pub53of100,1,191,12,160,5,177
test4sub40of100,test4pub53of100,1,191,12,162,3,177
test4sub88of100,test4pub53of100,1,191,12,164,2,178
test4sub2of100,test4pub52of100,1,191,18,551,2,571
test4sub67of100,test4pub53of100,1,191,12,175,1,188
test4sub59of100,test4pub53of100,1,191,12,178,1,191
test4sub60of100,test4pub53of100,1,191,12,179,2,193
test4sub19of100,test4pub53of100,1,191,12,180,1,193
test4sub49of100,test4pub53of100,1,191,12,183,0,195
test4sub20of100,test4pub53of100,1,191,12,184,1,197
test4sub69of100,test4pub53of100,1,191,12,189,0,201
test4sub76of100,test4pub53of100,1,191,12,190,3,205
test4sub31of100,test4pub53of100,1,191,12,191,1,204
test4sub53of100,test4pub53of100,1,191,12,191,2,205
test4sub83of100,test4pub53of100,1,191,12,199,1,212
test4sub91of100,test4pub53of100,1,191,12,201,6,219
test4sub10of100,test4pub53of100,1,191,12,201,7,220
test4sub98of100,test4pub53of100,1,191,12,203,8,223
test4sub82of100,test4pub53of100,1,191,12,203,9,224
test4sub72of100,test4pub53of100,1,191,12,204,8,224
test4sub55of100,test4pub53of100,1,191,12,204,8,224
test4sub84of100,test4pub53of100,1,191,12,205,7,224
test4sub100of100,test4pub53of100,1,191,12,206,8,226
test4sub54of100,test4pub53of100,1,191,12,206,7,225
test4sub66of100,test4pub53of100,1,191,12,207,6,225
test4sub9of100,test4pub53of100,1,191,12,208,6,226
test4sub16of100,test4pub53of100,1,191,12,210,4,226
test4sub94of100,test4pub53of100,1,191,12,210,4,226
test4sub21of100,test4pub53of100,1,191,12,241,2,255
test4sub25of100,test4pub53of100,1,191,12,242,2,256
test4sub32of100,test4pub53of100,1,191,12,243,2,257
test4sub86of100,test4pub53of100,1,191,12,247,5,264
test4sub78of100,test4pub53of100,1,191,12,248,9,269
test4sub46of100,test4pub53of100,1,191,12,249,7,268
test4sub44of100,test4pub53of100,1,191,12,250,7,269
test4sub48of100,test4pub53of100,1,191,12,249,8,269
test4sub24of100,test4pub53of100,1,191,12,251,6,269
test4sub37of100,test4pub53of100,1,191,12,252,7,271
test4sub26of100,test4pub53of100,1,191,12,252,6,270
test4sub28of100,test4pub53of100,1,191,12,253,6,271
test4sub38of100,test4pub53of100,1,191,12,254,5,271
test4sub2of100,test4pub53of100,1,191,12,254,5,271
test4sub13of100,test4pub53of100,1,191,12,253,6,271
test4sub92of100,test4pub53of100,1,191,12,255,5,272
test4sub55of100,test4pub54of100,1,191,11,7,1,19
test4sub69of100,test4pub54of100,1,191,11,16,1,28
test4sub76of100,test4pub54of100,1,191,11,17,1,29
test4sub35of100,test4pub54of100,1,191,11,21,1,33
test4sub30of100,test4pub54of100,1,191,11,25,0,36
test4sub79of100,test4pub54of100,1,191,11,29,1,41
test4sub6of100,test4pub54of100,1,191,11,34,1,46
test4sub13of100,test4pub54of100,1,191,11,34,2,47
test4sub86of100,test4pub54of100,1,191,11,41,1,53
test4sub39of100,test4pub54of100,1,191,11,44,1,56
test4sub29of100,test4pub54of100,1,191,11,47,1,59
test4sub80of100,test4pub54of100,1,191,11,48,1,60
test4sub75of100,test4pub54of100,1,191,11,51,2,64
test4sub15of100,test4pub54of100,1,191,11,52,2,65
test4sub90of100,test4pub54of100,1,191,11,53,3,67
test4sub34of100,test4pub54of100,1,191,11,53,3,67
test4sub83of100,test4pub54of100,1,191,11,55,1,67
test4sub36of100,test4pub54of100,1,191,11,57,4,72
test4sub41of100,test4pub54of100,1,191,11,59,4,74
test4sub82of100,test4pub54of100,1,191,11,59,3,73
test4sub52of100,test4pub54of100,1,191,11,60,2,73
test4sub66of100,test4pub54of100,1,191,11,61,2,74
test4sub25of100,test4pub54of100,1,191,11,71,1,83
test4sub37of100,test4pub54of100,1,191,11,72,1,84
test4sub65of100,test4pub54of100,1,191,11,79,1,91
test4sub70of100,test4pub54of100,1,191,11,80,1,92
test4sub46of100,test4pub54of100,1,191,11,82,0,93
test4sub94of100,test4pub54of100,1,191,11,82,7,100
test4sub32of100,test4pub54of100,1,191,11,83,6,100
test4sub48of100,test4pub54of100,1,191,11,85,6,102
test4sub85of100,test4pub54of100,1,191,11,84,6,101
test4sub99of100,test4pub54of100,1,191,11,86,5,102
test4sub61of100,test4pub54of100,1,191,11,86,7,104
test4sub45of100,test4pub54of100,1,191,11,87,6,104
test4sub5of100,test4pub54of100,1,191,11,86,7,104
test4sub56of100,test4pub54of100,1,191,11,88,6,105
test4sub23of100,test4pub54of100,1,191,11,89,6,106
test4sub21of100,test4pub54of100,1,191,11,91,4,106
test4sub100of100,test4pub54of100,1,191,11,93,3,107
test4sub2of100,test4pub54of100,1,191,11,96,1,108
test4sub51of100,test4pub54of100,1,191,11,98,0,109
test4sub42of100,test4pub54of100,1,191,11,113,1,125
test4sub14of100,test4pub54of100,1,191,11,115,1,127
test4sub1of100,test4pub54of100,1,191,11,118,2,131
test4sub93of100,test4pub54of100,1,191,11,120,2,133
test4sub8of100,test4pub54of100,1,191,11,121,2,134
test4sub50of100,test4pub54of100,1,191,11,122,1,134
test4sub92of100,test4pub54of100,1,191,11,127,2,140
test4sub53of100,test4pub54of100,1,191,11,128,2,141
test4sub28of100,test4pub54of100,1,191,11,129,1,141
test4sub58of100,test4pub54of100,1,191,11,129,2,142
test4sub18of100,test4pub54of100,1,191,11,132,1,144
test4sub98of100,test4pub54of100,1,191,11,137,1,149
test4sub27of100,test4pub54of100,1,191,11,138,0,149
test4sub91of100,test4pub54of100,1,191,11,140,2,153
test4sub68of100,test4pub54of100,1,191,11,141,3,155
test4sub54of100,test4pub54of100,1,191,11,142,4,157
test4sub88of100,test4pub54of100,1,191,11,140,6,157
test4sub73of100,test4pub54of100,1,191,11,142,5,158
test4sub87of100,test4pub54of100,1,191,11,143,5,159
test4sub59of100,test4pub54of100,1,191,11,144,6,161
test4sub40of100,test4pub54of100,1,191,11,146,3,160
test4sub64of100,test4pub54of100,1,191,11,147,2,160
test4sub63of100,test4pub54of100,1,191,11,148,2,161
test4sub38of100,test4pub54of100,1,191,11,154,1,166
test4sub7of100,test4pub54of100,1,191,11,154,2,167
test4sub60of100,test4pub54of100,1,191,11,154,1,166
test4sub44of100,test4pub54of100,1,191,11,167,1,179
test4sub47of100,test4pub54of100,1,191,11,168,2,181
test4sub19of100,test4pub54of100,1,191,11,169,2,182
test4sub89of100,test4pub54of100,1,191,11,171,6,188
test4sub31of100,test4pub54of100,1,191,11,171,7,189
test4sub78of100,test4pub54of100,1,191,11,170,8,189
test4sub12of100,test4pub54of100,1,191,11,174,9,194
test4sub22of100,test4pub54of100,1,191,11,169,15,195
test4sub67of100,test4pub54of100,1,191,11,173,11,195
test4sub3of100,test4pub54of100,1,191,11,174,11,196
test4sub20of100,test4pub54of100,1,191,11,175,10,196
test4sub57of100,test4pub54of100,1,191,11,176,10,197
test4sub81of100,test4pub54of100,1,191,11,177,10,198
test4sub95of100,test4pub54of100,1,191,11,178,9,198
test4sub11of100,test4pub54of100,1,191,11,175,7,193
test4sub71of100,test4pub54of100,1,191,11,180,6,197
test4sub24of100,test4pub54of100,1,191,11,180,7,198
test4sub4of100,test4pub54of100,1,191,11,176,7,194
test4sub72of100,test4pub54of100,1,191,11,181,7,199
test4sub10of100,test4pub54of100,1,191,11,182,6,199
test4sub43of100,test4pub54of100,1,191,11,183,6,200
test4sub31of100,test4pub55of100,1,191,14,6,1,21
test4sub98of100,test4pub55of100,1,191,14,7,1,22
test4sub63of100,test4pub55of100,1,191,14,11,1,26
test4sub15of100,test4pub55of100,1,191,14,11,1,26
test4sub84of100,test4pub54of100,1,191,11,379,1,391
test4sub21of100,test4pub55of100,1,191,14,20,0,34
test4sub53of100,test4pub55of100,1,191,14,22,1,37
test4sub83of100,test4pub55of100,1,191,14,23,1,38
test4sub97of100,test4pub54of100,1,191,11,392,1,404
test4sub33of100,test4pub54of100,1,191,11,393,1,405
test4sub74of100,test4pub54of100,1,191,11,398,1,410
test4sub94of100,test4pub55of100,1,191,14,38,1,53
test4sub60of100,test4pub55of100,1,191,14,48,1,63
test4sub73of100,test4pub55of100,1,191,14,49,3,66
test4sub77of100,test4pub54of100,1,191,11,412,3,426
test4sub52of100,test4pub55of100,1,191,14,50,6,70
test4sub17of100,test4pub54of100,1,191,11,413,4,428
test4sub67of100,test4pub55of100,1,191,14,53,5,72
test4sub65of100,test4pub55of100,1,191,14,54,4,72
test4sub5of100,test4pub55of100,1,191,14,53,4,71
test4sub96of100,test4pub54of100,1,191,11,416,5,432
test4sub70of100,test4pub55of100,1,191,14,57,2,73
test4sub56of100,test4pub55of100,1,191,14,57,3,74
test4sub49of100,test4pub54of100,1,191,11,429,1,441
test4sub71of100,test4pub55of100,1,191,14,71,2,87
test4sub16of100,test4pub54of100,1,191,11,431,2,444
test4sub36of100,test4pub55of100,1,191,14,72,4,90
test4sub32of100,test4pub55of100,1,191,14,74,3,91
test4sub58of100,test4pub55of100,1,191,14,71,3,88
test4sub64of100,test4pub55of100,1,191,14,75,2,91
test4sub10of100,test4pub55of100,1,191,14,75,2,91
test4sub33of100,test4pub55of100,1,191,14,79,1,94
test4sub20of100,test4pub55of100,1,191,14,79,1,94
test4sub4of100,test4pub55of100,1,191,14,83,1,98
test4sub47of100,test4pub55of100,1,191,14,83,6,103
test4sub42of100,test4pub55of100,1,191,14,84,8,106
test4sub66of100,test4pub55of100,1,191,14,86,8,108
test4sub99of100,test4pub55of100,1,191,14,87,8,109
test4sub34of100,test4pub55of100,1,191,14,87,7,108
test4sub6of100,test4pub55of100,1,191,14,86,10,110
test4sub68of100,test4pub55of100,1,191,14,88,9,111
test4sub54of100,test4pub55of100,1,191,14,88,8,110
test4sub50of100,test4pub55of100,1,191,14,88,9,111
test4sub62of100,test4pub54of100,1,191,11,452,7,470
test4sub90of100,test4pub55of100,1,191,14,91,6,111
test4sub59of100,test4pub55of100,1,191,14,92,6,112
test4sub82of100,test4pub55of100,1,191,14,94,4,112
test4sub37of100,test4pub55of100,1,191,14,95,3,112
test4sub7of100,test4pub55of100,1,191,14,115,2,131
test4sub24of100,test4pub55of100,1,191,14,115,3,132
test4sub100of100,test4pub55of100,1,191,14,116,1,131
test4sub69of100,test4pub55of100,1,191,14,121,1,136
test4sub61of100,test4pub55of100,1,191,14,120,6,140
test4sub14of100,test4pub55of100,1,191,14,123,4,141
test4sub55of100,test4pub55of100,1,191,14,124,3,141
test4sub48of100,test4pub55of100,1,191,14,125,4,143
test4sub8of100,test4pub55of100,1,191,14,126,4,144
test4sub3of100,test4pub55of100,1,191,14,126,3,143
test4sub74of100,test4pub55of100,1,191,14,131,3,148
test4sub79of100,test4pub55of100,1,191,14,131,13,158
test4sub51of100,test4pub55of100,1,191,14,133,13,160
test4sub41of100,test4pub55of100,1,191,14,136,14,164
test4sub46of100,test4pub55of100,1,191,14,137,14,165
test4sub35of100,test4pub55of100,1,191,14,137,15,166
test4sub23of100,test4pub55of100,1,191,14,139,16,169
test4sub17of100,test4pub55of100,1,191,14,140,15,169
test4sub84of100,test4pub55of100,1,191,14,140,16,170
test4sub27of100,test4pub55of100,1,191,14,141,15,170
test4sub18of100,test4pub55of100,1,191,14,141,16,171
test4sub12of100,test4pub55of100,1,191,14,142,16,172
test4sub75of100,test4pub55of100,1,191,14,143,15,172
test4sub89of100,test4pub55of100,1,191,14,143,15,172
test4sub29of100,test4pub55of100,1,191,14,146,14,174
test4sub25of100,test4pub55of100,1,191,14,148,13,175
test4sub45of100,test4pub55of100,1,191,14,148,14,176
test4sub22of100,test4pub55of100,1,191,14,149,13,176
test4sub43of100,test4pub55of100,1,191,14,149,14,177
test4sub87of100,test4pub55of100,1,191,14,153,12,179
test4sub62of100,test4pub55of100,1,191,14,154,12,180
test4sub26of100,test4pub54of100,1,191,11,523,3,537
test4sub26of100,test4pub55of100,1,191,14,175,1,190
test4sub95of100,test4pub55of100,1,191,14,340,1,355
test4sub4of100,test4pub56of100,1,191,11,12,1,24
test4sub63of100,test4pub56of100,1,191,11,14,1,26
test4sub75of100,test4pub56of100,1,191,11,13,2,26
test4sub33of100,test4pub56of100,1,191,11,18,1,30
test4sub34of100,test4pub56of100,1,191,11,21,1,33
test4sub15of100,test4pub56of100,1,191,11,22,1,34
test4sub74of100,test4pub56of100,1,191,11,23,1,35
test4sub30of100,test4pub55of100,1,191,14,361,0,375
test4sub96of100,test4pub55of100,1,191,14,363,1,378
test4sub27of100,test4pub56of100,1,191,11,29,0,40
test4sub99of100,test4pub56of100,1,191,11,30,4,45
test4sub48of100,test4pub56of100,1,191,11,32,3,46
test4sub90of100,test4pub56of100,1,191,11,32,2,45
test4sub69of100,test4pub56of100,1,191,11,33,3,47
test4sub22of100,test4pub56of100,1,191,11,41,2,54
test4sub43of100,test4pub56of100,1,191,11,42,1,54
test4sub76of100,test4pub55of100,1,191,14,380,2,396
test4sub35of100,test4pub56of100,1,191,11,45,3,59
test4sub24of100,test4pub56of100,1,191,11,46,2,59
test4sub7of100,test4pub56of100,1,191,11,47,2,60
test4sub57of100,test4pub55of100,1,191,14,385,0,399
test4sub93of100,test4pub55of100,1,191,14,387,1,402
test4sub11of100,test4pub55of100,1,191,14,387,1,402
test4sub66of100,test4pub56of100,1,191,11,57,1,69
test4sub97of100,test4pub55of100,1,191,14,392,2,408
test4sub10of100,test4pub56of100,1,191,11,60,1,72
test4sub37of100,test4pub56of100,1,191,11,59,1,71
test4sub94of100,test4pub56of100,1,191,11,64,1,76
test4sub17of100,test4pub56of100,1,191,11,68,0,79
test4sub50of100,test4pub56of100,1,191,11,71,2,84
test4sub32of100,test4pub56of100,1,191,11,71,5,87
test4sub19of100,test4pub55of100,1,191,14,407,6,427
test4sub77of100,test4pub55of100,1,191,14,408,5,427
test4sub72of100,test4pub55of100,1,191,14,409,5,428
test4sub64of100,test4pub56of100,1,191,11,76,4,91
test4sub8of100,test4pub56of100,1,191,11,76,4,91
test4sub98of100,test4pub56of100,1,191,11,77,4,92
test4sub16of100,test4pub55of100,1,191,14,412,4,430
test4sub73of100,test4pub56of100,1,191,11,80,2,93
test4sub87of100,test4pub56of100,1,191,11,81,1,93
test4sub20of100,test4pub56of100,1,191,11,86,1,98
test4sub96of100,test4pub56of100,1,191,11,86,1,98
test4sub13of100,test4pub55of100,1,191,14,425,2,441
test4sub82of100,test4pub56of100,1,191,11,90,3,104
test4sub26of100,test4pub56of100,1,191,11,91,1,103
test4sub80of100,test4pub55of100,1,191,14,432,1,447
test4sub41of100,test4pub56of100,1,191,11,98,4,113
test4sub91of100,test4pub55of100,1,191,14,435,3,452
test4sub30of100,test4pub56of100,1,191,11,100,5,116
test4sub85of100,test4pub55of100,1,191,14,436,4,454
test4sub88of100,test4pub55of100,1,191,14,436,3,453
test4sub3of100,test4pub56of100,1,191,11,102,3,116
test4sub81of100,test4pub55of100,1,191,14,438,2,454
test4sub62of100,test4pub56of100,1,191,11,108,5,124
test4sub44of100,test4pub55of100,1,191,14,444,4,462
test4sub89of100,test4pub56of100,1,191,11,108,6,125
test4sub36of100,test4pub56of100,1,191,11,109,5,125
test4sub47of100,test4pub56of100,1,191,11,111,3,125
test4sub84of100,test4pub56of100,1,191,11,111,3,125
test4sub40of100,test4pub55of100,1,191,14,447,4,465
test4sub54of100,test4pub56of100,1,191,11,109,3,123
test4sub42of100,test4pub56of100,1,191,11,111,3,125
test4sub28of100,test4pub55of100,1,191,14,453,1,468
test4sub65of100,test4pub56of100,1,191,11,126,1,138
test4sub67of100,test4pub56of100,1,191,11,126,1,138
test4sub70of100,test4pub56of100,1,191,11,128,1,140
test4sub60of100,test4pub56of100,1,191,11,139,1,151
test4sub58of100,test4pub56of100,1,191,11,140,7,158
test4sub29of100,test4pub56of100,1,191,11,141,7,159
test4sub6of100,test4pub56of100,1,191,11,142,7,160
test4sub57of100,test4pub56of100,1,191,11,143,7,161
test4sub93of100,test4pub56of100,1,191,11,143,7,161
test4sub83of100,test4pub56of100,1,191,11,144,7,162
test4sub12of100,test4pub56of100,1,191,11,145,7,163
test4sub52of100,test4pub56of100,1,191,11,145,7,163
test4sub5of100,test4pub56of100,1,191,11,146,7,164
test4sub76of100,test4pub56of100,1,191,11,146,6,163
test4sub11of100,test4pub56of100,1,191,11,142,11,164
test4sub59of100,test4pub56of100,1,191,11,146,7,164
test4sub97of100,test4pub56of100,1,191,11,147,8,166
test4sub55of100,test4pub56of100,1,191,11,150,5,166
test4sub19of100,test4pub56of100,1,191,11,154,2,167
test4sub92of100,test4pub55of100,1,191,14,490,2,506
test4sub80of100,test4pub56of100,1,191,11,158,1,170
test4sub91of100,test4pub56of100,1,191,11,158,5,174
test4sub85of100,test4pub56of100,1,191,11,159,6,176
test4sub88of100,test4pub56of100,1,191,11,160,5,176
test4sub81of100,test4pub56of100,1,191,11,161,5,177
test4sub44of100,test4pub56of100,1,191,11,162,4,177
test4sub40of100,test4pub56of100,1,191,11,163,4,178
test4sub28of100,test4pub56of100,1,191,11,164,3,178
test4sub39of100,test4pub55of100,1,191,14,500,2,516
test4sub92of100,test4pub56of100,1,191,11,180,0,191
test4sub39of100,test4pub56of100,1,191,11,182,1,194
test4sub49of100,test4pub55of100,1,191,14,646,1,661
test4sub49of100,test4pub56of100,1,191,11,314,1,326
test4sub31of100,test4pub56of100,1,191,11,340,0,351
test4sub95of100,test4pub56of100,1,191,11,344,1,356
test4sub23of100,test4pub56of100,1,191,11,348,1,360
test4sub68of100,test4pub56of100,1,191,11,362,1,374
test4sub25of100,test4pub56of100,1,191,11,364,1,376
test4sub18of100,test4pub56of100,1,191,11,368,1,380
test4sub100of100,test4pub56of100,1,191,11,373,1,385
test4sub14of100,test4pub56of100,1,191,11,373,1,385
test4sub45of100,test4pub56of100,1,191,11,381,0,392
test4sub77of100,test4pub56of100,1,191,11,384,1,396
test4sub71of100,test4pub56of100,1,191,11,384,2,397
test4sub72of100,test4pub56of100,1,191,11,386,1,398
test4sub79of100,test4pub56of100,1,191,11,390,1,402
test4sub56of100,test4pub56of100,1,191,11,393,1,405
test4sub61of100,test4pub56of100,1,191,11,395,1,407
test4sub16of100,test4pub56of100,1,191,11,396,0,407
test4sub21of100,test4pub56of100,1,191,11,404,0,415
test4sub53of100,test4pub56of100,1,191,11,412,1,424
test4sub46of100,test4pub56of100,1,191,11,412,1,424
test4sub51of100,test4pub56of100,1,191,11,420,1,432
test4sub9of100,test4pub54of100,1,191,11,1198,1,1210
test4sub9of100,test4pub55of100,1,191,14,839,1,854
test4sub9of100,test4pub56of100,1,191,11,505,1,517
test4sub87of100,test4pub57of100,1,191,12,15,0,27
test4sub85of100,test4pub57of100,1,191,12,22,1,35
test4sub95of100,test4pub57of100,1,191,12,27,1,40
test4sub99of100,test4pub57of100,1,191,12,28,1,41
test4sub32of100,test4pub57of100,1,191,12,30,1,43
test4sub88of100,test4pub57of100,1,191,12,33,1,46
test4sub90of100,test4pub57of100,1,191,12,35,1,48
test4sub9of100,test4pub57of100,1,191,12,39,1,52
test4sub94of100,test4pub57of100,1,191,12,43,1,56
test4sub3of100,test4pub57of100,1,191,12,43,1,56
test4sub17of100,test4pub57of100,1,191,12,45,1,58
test4sub79of100,test4pub57of100,1,191,12,48,1,61
test4sub4of100,test4pub57of100,1,191,12,49,1,62
test4sub37of100,test4pub57of100,1,191,12,50,1,63
test4sub14of100,test4pub57of100,1,191,12,51,1,64
test4sub19of100,test4pub57of100,1,191,12,53,1,66
test4sub10of100,test4pub57of100,1,191,12,55,1,68
test4sub46of100,test4pub57of100,1,191,12,57,1,70
test4sub34of100,test4pub57of100,1,191,12,58,1,71
test4sub80of100,test4pub57of100,1,191,12,56,3,71
test4sub16of100,test4pub57of100,1,191,12,62,0,74
test4sub5of100,test4pub57of100,1,191,12,63,1,76
test4sub98of100,test4pub57of100,1,191,12,65,1,78
test4sub43of100,test4pub57of100,1,191,12,65,1,78
test4sub58of100,test4pub57of100,1,191,12,69,0,81
test4sub84of100,test4pub57of100,1,191,12,72,1,85
test4sub11of100,test4pub57of100,1,191,12,75,1,88
test4sub92of100,test4pub57of100,1,191,12,77,5,94
test4sub75of100,test4pub57of100,1,191,12,77,4,93
test4sub6of100,test4pub57of100,1,191,12,78,4,94
test4sub39of100,test4pub57of100,1,191,12,79,3,94
test4sub15of100,test4pub57of100,1,191,12,80,4,96
test4sub26of100,test4pub57of100,1,191,12,81,4,97
test4sub81of100,test4pub57of100,1,191,12,83,2,97
test4sub50of100,test4pub57of100,1,191,12,86,0,98
test4sub35of100,test4pub57of100,1,191,12,85,3,100
test4sub12of100,test4pub57of100,1,191,12,88,1,101
test4sub72of100,test4pub57of100,1,191,12,103,1,116
test4sub59of100,test4pub57of100,1,191,12,104,1,117
test4sub53of100,test4pub57of100,1,191,12,107,1,120
test4sub89of100,test4pub57of100,1,191,12,130,1,143
test4sub18of100,test4pub57of100,1,191,12,131,1,144
test4sub65of100,test4pub57of100,1,191,12,132,1,145
test4sub83of100,test4pub57of100,1,191,12,139,1,152
test4sub38of100,test4pub55of100,1,191,14,993,2,1009
test4sub56of100,test4pub57of100,1,191,12,140,4,156
test4sub60of100,test4pub57of100,1,191,12,142,2,156
test4sub41of100,test4pub57of100,1,191,12,142,3,157
test4sub55of100,test4pub57of100,1,191,12,145,1,158
test4sub31of100,test4pub57of100,1,191,12,145,2,159
test4sub74of100,test4pub57of100,1,191,12,146,2,160
test4sub38of100,test4pub56of100,1,191,11,661,1,673
test4sub57of100,test4pub57of100,1,191,12,149,1,162
test4sub24of100,test4pub57of100,1,191,12,150,0,162
test4sub61of100,test4pub57of100,1,191,12,154,1,167
test4sub30of100,test4pub57of100,1,191,12,157,1,170
test4sub71of100,test4pub57of100,1,191,12,169,4,185
test4sub66of100,test4pub57of100,1,191,12,170,5,187
test4sub69of100,test4pub57of100,1,191,12,171,7,190
test4sub23of100,test4pub57of100,1,191,12,171,8,191
test4sub8of100,test4pub57of100,1,191,12,173,7,192
test4sub68of100,test4pub57of100,1,191,12,172,8,192
test4sub100of100,test4pub57of100,1,191,12,174,6,192
test4sub77of100,test4pub57of100,1,191,12,175,7,194
test4sub25of100,test4pub57of100,1,191,12,176,5,193
test4sub7of100,test4pub57of100,1,191,12,177,4,193
test4sub45of100,test4pub57of100,1,191,12,178,4,194
test4sub54of100,test4pub57of100,1,191,12,177,3,192
test4sub70of100,test4pub57of100,1,191,12,203,4,219
test4sub62of100,test4pub57of100,1,191,12,204,3,219
test4sub36of100,test4pub57of100,1,191,12,205,3,220
test4sub76of100,test4pub57of100,1,191,12,206,3,221
test4sub49of100,test4pub57of100,1,191,12,206,5,223
test4sub63of100,test4pub57of100,1,191,12,208,4,224
test4sub82of100,test4pub57of100,1,191,12,209,3,224
test4sub40of100,test4pub57of100,1,191,12,210,2,224
test4sub93of100,test4pub57of100,1,191,12,211,2,225
test4sub29of100,test4pub57of100,1,191,12,223,0,235
test4sub91of100,test4pub57of100,1,191,12,224,1,237
test4sub27of100,test4pub57of100,1,191,12,225,1,238
test4sub20of100,test4pub57of100,1,191,12,227,1,240
test4sub51of100,test4pub57of100,1,191,12,239,2,253
test4sub96of100,test4pub57of100,1,191,12,240,3,255
test4sub52of100,test4pub57of100,1,191,12,239,4,255
test4sub22of100,test4pub57of100,1,191,12,241,5,258
test4sub67of100,test4pub57of100,1,191,12,242,3,257
test4sub73of100,test4pub57of100,1,191,12,244,1,257
test4sub47of100,test4pub57of100,1,191,12,244,2,258
test4sub44of100,test4pub57of100,1,191,12,256,1,269
test4sub48of100,test4pub57of100,1,191,12,257,1,270
test4sub97of100,test4pub57of100,1,191,12,262,1,275
test4sub28of100,test4pub57of100,1,191,12,262,1,275
test4sub42of100,test4pub57of100,1,191,12,266,1,279
test4sub21of100,test4pub57of100,1,191,12,266,2,280
test4sub64of100,test4pub57of100,1,191,12,276,1,289
test4sub33of100,test4pub57of100,1,191,12,276,2,290
test4sub38of100,test4pub57of100,1,191,12,278,2,292
test4sub78of100,test4pub55of100,1,191,14,1131,1,1146
test4sub1of100,test4pub55of100,1,191,14,1133,1,1148
test4sub2of100,test4pub55of100,1,191,14,1134,1,1149
test4sub86of100,test4pub55of100,1,191,14,1140,1,1155
test4sub13of100,test4pub56of100,1,191,11,816,1,828
test4sub78of100,test4pub56of100,1,191,11,817,1,829
test4sub2of100,test4pub56of100,1,191,11,819,2,832
test4sub78of100,test4pub57of100,1,191,12,302,3,317
test4sub1of100,test4pub56of100,1,191,11,820,3,834
test4sub13of100,test4pub57of100,1,191,12,301,3,316
test4sub86of100,test4pub56of100,1,191,11,821,2,834
test4sub2of100,test4pub57of100,1,191,12,305,2,319
test4sub1of100,test4pub57of100,1,191,12,307,1,320
test4sub86of100,test4pub57of100,1,191,12,308,1,321
test4sub93of100,test4pub58of100,1,191,12,10,1,23
test4sub13of100,test4pub58of100,1,191,12,9,1,22
test4sub64of100,test4pub58of100,1,191,12,16,1,29
test4sub51of100,test4pub58of100,1,191,12,23,1,36
test4sub17of100,test4pub58of100,1,191,12,25,4,41
test4sub30of100,test4pub58of100,1,191,12,25,4,41
test4sub84of100,test4pub58of100,1,191,12,26,5,43
test4sub81of100,test4pub58of100,1,191,12,26,5,43
test4sub82of100,test4pub58of100,1,191,12,28,4,44
test4sub98of100,test4pub58of100,1,191,12,28,4,44
test4sub48of100,test4pub58of100,1,191,12,30,2,44
test4sub23of100,test4pub58of100,1,191,12,44,1,57
test4sub25of100,test4pub58of100,1,191,12,44,1,57
test4sub40of100,test4pub58of100,1,191,12,51,0,63
test4sub38of100,test4pub58of100,1,191,12,55,1,68
test4sub41of100,test4pub58of100,1,191,12,62,1,75
test4sub69of100,test4pub58of100,1,191,12,67,1,80
test4sub89of100,test4pub58of100,1,191,12,68,2,82
test4sub39of100,test4pub58of100,1,191,12,70,2,84
test4sub26of100,test4pub58of100,1,191,12,76,1,89
test4sub1of100,test4pub58of100,1,191,12,78,1,91
test4sub6of100,test4pub58of100,1,191,12,82,1,95
test4sub87of100,test4pub58of100,1,191,12,84,1,97
test4sub58of100,test4pub58of100,1,191,12,85,2,99
test4sub68of100,test4pub58of100,1,191,12,86,2,100
test4sub24of100,test4pub58of100,1,191,12,86,3,101
test4sub63of100,test4pub58of100,1,191,12,87,3,102
test4sub32of100,test4pub58of100,1,191,12,88,2,102
test4sub9of100,test4pub58of100,1,191,12,91,2,105
test4sub27of100,test4pub58of100,1,191,12,93,3,108
test4sub21of100,test4pub58of100,1,191,12,91,6,109
test4sub31of100,test4pub58of100,1,191,12,92,6,110
test4sub85of100,test4pub58of100,1,191,12,94,6,112
test4sub44of100,test4pub58of100,1,191,12,95,5,112
test4sub80of100,test4pub58of100,1,191,12,95,5,112
test4sub92of100,test4pub58of100,1,191,12,97,3,112
test4sub88of100,test4pub58of100,1,191,12,97,3,112
test4sub72of100,test4pub58of100,1,191,12,98,3,113
test4sub77of100,test4pub58of100,1,191,12,104,1,117
test4sub16of100,test4pub58of100,1,191,12,106,2,120
test4sub18of100,test4pub58of100,1,191,12,107,2,121
test4sub29of100,test4pub58of100,1,191,12,108,2,122
test4sub55of100,test4pub58of100,1,191,12,110,2,124
test4sub4of100,test4pub58of100,1,191,12,111,1,124
test4sub71of100,test4pub58of100,1,191,12,111,4,127
test4sub33of100,test4pub58of100,1,191,12,113,2,127
test4sub54of100,test4pub58of100,1,191,12,114,3,129
test4sub5of100,test4pub58of100,1,191,12,115,1,128
test4sub96of100,test4pub58of100,1,191,12,117,1,130
test4sub59of100,test4pub58of100,1,191,12,132,1,145
test4sub50of100,test4pub58of100,1,191,12,157,3,172
test4sub12of100,test4pub58of100,1,191,12,157,3,172
test4sub22of100,test4pub58of100,1,191,12,158,3,173
test4sub60of100,test4pub58of100,1,191,12,159,3,174
test4sub62of100,test4pub58of100,1,191,12,160,2,174
test4sub37of100,test4pub58of100,1,191,12,160,3,175
test4sub47of100,test4pub58of100,1,191,12,164,1,177
test4sub43of100,test4pub58of100,1,191,12,164,1,177
test4sub61of100,test4pub58of100,1,191,12,169,1,182
test4sub49of100,test4pub58of100,1,191,12,171,2,185
test4sub86of100,test4pub58of100,1,191,12,173,6,191
test4sub74of100,test4pub58of100,1,191,12,173,9,194
test4sub95of100,test4pub58of100,1,191,12,175,8,195
test4sub28of100,test4pub58of100,1,191,12,175,9,196
test4sub73of100,test4pub58of100,1,191,12,176,8,196
test4sub76of100,test4pub58of100,1,191,12,176,7,195
test4sub66of100,test4pub58of100,1,191,12,177,8,197
test4sub99of100,test4pub58of100,1,191,12,175,9,196
test4sub2of100,test4pub58of100,1,191,12,178,9,199
test4sub79of100,test4pub58of100,1,191,12,178,9,199
test4sub20of100,test4pub58of100,1,191,12,180,8,200
test4sub19of100,test4pub58of100,1,191,12,181,7,200
test4sub75of100,test4pub58of100,1,191,12,181,7,200
test4sub65of100,test4pub58of100,1,191,12,182,7,201
test4sub53of100,test4pub58of100,1,191,12,185,3,200
test4sub10of100,test4pub58of100,1,191,12,185,4,201
test4sub3of100,test4pub58of100,1,191,12,206,0,218
test4sub57of100,test4pub58of100,1,191,12,208,1,221
test4sub45of100,test4pub58of100,1,191,12,208,1,221
test4sub15of100,test4pub58of100,1,191,12,211,1,224
test4sub97of100,test4pub58of100,1,191,12,212,2,226
test4sub94of100,test4pub58of100,1,191,12,213,1,226
test4sub67of100,test4pub58of100,1,191,12,216,3,231
test4sub52of100,test4pub58of100,1,191,12,217,2,231
test4sub34of100,test4pub58of100,1,191,12,218,2,232
test4sub83of100,test4pub58of100,1,191,12,218,2,232
test4sub100of100,test4pub58of100,1,191,12,218,3,233
test4sub78of100,test4pub58of100,1,191,12,215,5,232
test4sub14of100,test4pub58of100,1,191,12,216,5,233
test4sub7of100,test4pub58of100,1,191,12,350,1,363
test4sub35of100,test4pub58of100,1,191,12,354,1,367
test4sub90of100,test4pub58of100,1,191,12,359,1,372
test4sub46of100,test4pub58of100,1,191,12,370,1,383
test4sub11of100,test4pub58of100,1,191,12,370,2,384
test4sub36of100,test4pub58of100,1,191,12,378,2,392
test4sub8of100,test4pub58of100,1,191,12,379,2,393
test4sub70of100,test4pub58of100,1,191,12,384,1,397
test4sub91of100,test4pub58of100,1,191,12,390,11,413
test4sub42of100,test4pub58of100,1,191,12,391,11,414
test4sub56of100,test4pub58of100,1,191,12,392,11,415
test4sub99of100,test4pub59of100,1,191,14,5,1,20
test4sub10of100,test4pub59of100,1,191,14,8,1,23
test4sub67of100,test4pub59of100,1,191,14,10,1,25
test4sub55of100,test4pub59of100,1,191,14,14,1,29
test4sub54of100,test4pub59of100,1,191,14,20,1,35
test4sub16of100,test4pub59of100,1,191,14,26,1,41
test4sub32of100,test4pub59of100,1,191,14,34,1,49
test4sub65of100,test4pub59of100,1,191,14,35,0,49
test4sub37of100,test4pub59of100,1,191,14,36,1,51
test4sub56of100,test4pub59of100,1,191,14,37,1,52
test4sub79of100,test4pub59of100,1,191,14,60,1,75
test4sub88of100,test4pub59of100,1,191,14,65,1,80
test4sub74of100,test4pub59of100,1,191,14,66,0,80
test4sub2of100,test4pub59of100,1,191,14,67,1,82
test4sub35of100,test4pub59of100,1,191,14,70,1,85
test4sub22of100,test4pub59of100,1,191,14,71,1,86
test4sub80of100,test4pub59of100,1,191,14,80,1,95
test4sub78of100,test4pub59of100,1,191,14,87,1,102
test4sub18of100,test4pub59of100,1,191,14,88,1,103
test4sub1of100,test4pub59of100,1,191,14,95,1,110
test4sub94of100,test4pub59of100,1,191,14,96,1,111
test4sub62of100,test4pub59of100,1,191,14,97,1,112
test4sub14of100,test4pub59of100,1,191,14,100,1,115
test4sub39of100,test4pub59of100,1,191,14,107,3,124
test4sub71of100,test4pub59of100,1,191,14,107,2,123
test4sub96of100,test4pub59of100,1,191,14,108,3,125
test4sub82of100,test4pub59of100,1,191,14,109,3,126
test4sub42of100,test4pub59of100,1,191,14,111,3,128
test4sub91of100,test4pub59of100,1,191,14,112,1,127
test4sub8of100,test4pub59of100,1,191,14,116,1,131
test4sub89of100,test4pub59of100,1,191,14,117,1,132
test4sub21of100,test4pub59of100,1,191,14,125,1,140
test4sub25of100,test4pub59of100,1,191,14,126,2,142
test4sub51of100,test4pub59of100,1,191,14,127,1,142
test4sub98of100,test4pub59of100,1,191,14,133,1,148
test4sub49of100,test4pub59of100,1,191,14,133,1,148
test4sub93of100,test4pub59of100,1,191,14,137,1,152
test4sub23of100,test4pub59of100,1,191,14,147,1,162
test4sub83of100,test4pub59of100,1,191,14,148,1,163
test4sub47of100,test4pub59of100,1,191,14,155,3,172
test4sub97of100,test4pub59of100,1,191,14,156,4,174
test4sub66of100,test4pub59of100,1,191,14,157,2,173
test4sub45of100,test4pub59of100,1,191,14,157,3,174
test4sub59of100,test4pub59of100,1,191,14,158,2,174
test4sub30of100,test4pub59of100,1,191,14,158,2,174
test4sub90of100,test4pub59of100,1,191,14,164,6,184
test4sub81of100,test4pub59of100,1,191,14,163,8,185
test4sub57of100,test4pub59of100,1,191,14,165,6,185
test4sub4of100,test4pub59of100,1,191,14,165,7,186
test4sub7of100,test4pub59of100,1,191,14,166,6,186
test4sub17of100,test4pub59of100,1,191,14,167,6,187
test4sub48of100,test4pub59of100,1,191,14,168,6,188
test4sub6of100,test4pub59of100,1,191,14,168,5,187
test4sub28of100,test4pub59of100,1,191,14,169,4,187
test4sub69of100,test4pub59of100,1,191,14,170,4,188
test4sub31of100,test4pub59of100,1,191,14,170,4,188
test4sub72of100,test4pub59of100,1,191,14,202,1,217
test4sub92of100,test4pub59of100,1,191,14,204,1,219
test4sub11of100,test4pub59of100,1,191,14,203,2,219
test4sub77of100,test4pub59of100,1,191,14,214,1,229
test4sub61of100,test4pub59of100,1,191,14,225,1,240
test4sub15of100,test4pub59of100,1,191,14,225,1,240
test4sub33of100,test4pub59of100,1,191,14,253,0,267
test4sub44of100,test4pub59of100,1,191,14,256,1,271
test4sub70of100,test4pub59of100,1,191,14,257,2,273
test4sub73of100,test4pub59of100,1,191,14,258,1,273
test4sub64of100,test4pub59of100,1,191,14,259,1,274
test4sub26of100,test4pub59of100,1,191,14,268,1,283
test4sub19of100,test4pub59of100,1,191,14,272,1,287
test4sub100of100,test4pub59of100,1,191,14,275,1,290
test4sub86of100,test4pub59of100,1,191,14,281,0,295
test4sub84of100,test4pub59of100,1,191,14,284,1,299
test4sub68of100,test4pub59of100,1,191,14,287,1,302
test4sub50of100,test4pub59of100,1,191,14,288,1,303
test4sub95of100,test4pub59of100,1,191,14,292,0,306
test4sub41of100,test4pub59of100,1,191,14,300,1,315
test4sub29of100,test4pub59of100,1,191,14,316,1,331
test4sub24of100,test4pub59of100,1,191,14,317,4,335
test4sub58of100,test4pub59of100,1,191,14,319,4,337
test4sub12of100,test4pub59of100,1,191,14,318,3,335
test4sub46of100,test4pub59of100,1,191,14,318,3,335
test4sub43of100,test4pub59of100,1,191,14,320,3,337
test4sub5of100,test4pub59of100,1,191,14,319,5,338
test4sub76of100,test4pub59of100,1,191,14,322,3,339
test4sub38of100,test4pub59of100,1,191,14,325,1,340
test4sub13of100,test4pub59of100,1,191,14,339,1,354
test4sub85of100,test4pub59of100,1,191,14,340,1,355
test4sub63of100,test4pub59of100,1,191,14,342,1,357
test4sub34of100,test4pub59of100,1,191,14,351,1,366
test4sub52of100,test4pub59of100,1,191,14,354,1,369
test4sub53of100,test4pub59of100,1,191,14,364,1,379
test4sub75of100,test4pub59of100,1,191,14,385,1,400
test4sub87of100,test4pub59of100,1,191,14,386,0,400
test4sub60of100,test4pub59of100,1,191,14,391,2,407
test4sub3of100,test4pub59of100,1,191,14,392,2,408
test4sub27of100,test4pub59of100,1,191,14,393,2,409
test4sub20of100,test4pub59of100,1,191,14,394,2,410
test4sub9of100,test4pub59of100,1,191,14,395,2,411
test4sub36of100,test4pub59of100,1,191,14,398,1,413
test4sub40of100,test4pub59of100,1,191,14,397,2,413
test4sub8of100,test4pub60of100,1,191,10,9,3,22
test4sub66of100,test4pub60of100,1,191,10,11,2,23
test4sub80of100,test4pub60of100,1,191,10,11,3,24
test4sub17of100,test4pub60of100,1,191,10,12,1,23
test4sub75of100,test4pub60of100,1,191,10,19,1,30
test4sub82of100,test4pub60of100,1,191,10,20,0,30
test4sub41of100,test4pub60of100,1,191,10,22,1,33
test4sub13of100,test4pub60of100,1,191,10,28,1,39
test4sub1of100,test4pub60of100,1,191,10,29,1,40
test4sub72of100,test4pub60of100,1,191,10,32,0,42
test4sub42of100,test4pub60of100,1,191,10,33,1,44
test4sub43of100,test4pub60of100,1,191,10,35,1,46
test4sub78of100,test4pub60of100,1,191,10,36,2,48
test4sub52of100,test4pub60of100,1,191,10,37,1,48
test4sub36of100,test4pub60of100,1,191,10,37,2,49
test4sub49of100,test4pub60of100,1,191,10,45,3,58
test4sub15of100,test4pub60of100,1,191,10,46,2,58
test4sub33of100,test4pub60of100,1,191,10,46,3,59
test4sub89of100,test4pub60of100,1,191,10,47,2,59
test4sub92of100,test4pub60of100,1,191,10,48,2,60
test4sub29of100,test4pub60of100,1,191,10,52,1,63
test4sub73of100,test4pub60of100,1,191,10,53,1,64
test4sub94of100,test4pub60of100,1,191,10,55,0,65
test4sub50of100,test4pub60of100,1,191,10,55,1,66
test4sub91of100,test4pub60of100,1,191,10,57,1,68
test4sub27of100,test4pub60of100,1,191,10,59,3,72
test4sub90of100,test4pub60of100,1,191,10,60,2,72
test4sub56of100,test4pub60of100,1,191,10,61,3,74
test4sub7of100,test4pub60of100,1,191,10,61,2,73
test4sub28of100,test4pub60of100,1,191,10,62,1,73
test4sub32of100,test4pub60of100,1,191,10,72,1,83
test4sub5of100,test4pub60of100,1,191,10,72,1,83
test4sub2of100,test4pub60of100,1,191,10,81,0,91
test4sub35of100,test4pub60of100,1,191,10,84,0,94
test4sub51of100,test4pub60of100,1,191,10,84,1,95
test4sub23of100,test4pub60of100,1,191,10,93,1,104
test4sub68of100,test4pub60of100,1,191,10,95,1,106
test4sub58of100,test4pub60of100,1,191,10,96,1,107
test4sub26of100,test4pub60of100,1,191,10,98,1,109
test4sub96of100,test4pub60of100,1,191,10,99,1,110
test4sub48of100,test4pub60of100,1,191,10,104,1,115
test4sub65of100,test4pub60of100,1,191,10,105,3,118
test4sub88of100,test4pub60of100,1,191,10,106,4,120
test4sub11of100,test4pub60of100,1,191,10,107,4,121
test4sub95of100,test4pub60of100,1,191,10,108,4,122
test4sub18of100,test4pub60of100,1,191,10,108,3,121
test4sub62of100,test4pub60of100,1,191,10,110,2,122
test4sub83of100,test4pub60of100,1,191,10,110,2,122
test4sub100of100,test4pub60of100,1,191,10,115,4,129
test4sub79of100,test4pub60of100,1,191,10,116,5,131
test4sub3of100,test4pub60of100,1,191,10,117,4,131
test4sub44of100,test4pub60of100,1,191,10,118,2,130
test4sub98of100,test4pub60of100,1,191,10,118,3,131
test4sub77of100,test4pub60of100,1,191,10,119,2,131
test4sub93of100,test4pub60of100,1,191,10,123,2,135
test4sub34of100,test4pub60of100,1,191,10,122,3,135
test4sub55of100,test4pub60of100,1,191,10,124,1,135
test4sub4of100,test4pub60of100,1,191,10,127,1,138
test4sub37of100,test4pub60of100,1,191,10,129,1,140
test4sub70of100,test4pub60of100,1,191,10,129,3,142
test4sub85of100,test4pub60of100,1,191,10,128,4,142
test4sub59of100,test4pub60of100,1,191,10,130,3,143
test4sub99of100,test4pub60of100,1,191,10,132,3,145
test4sub57of100,test4pub60of100,1,191,10,134,4,148
test4sub16of100,test4pub60of100,1,191,10,136,5,151
test4sub38of100,test4pub60of100,1,191,10,136,8,154
test4sub61of100,test4pub60of100,1,191,10,137,9,156
test4sub74of100,test4pub60of100,1,191,10,138,8,156
test4sub60of100,test4pub60of100,1,191,10,139,7,156
test4sub47of100,test4pub60of100,1,191,10,140,7,157
test4sub40of100,test4pub60of100,1,191,10,141,5,156
test4sub81of100,test4pub60of100,1,191,10,141,6,157
test4sub63of100,test4pub60of100,1,191,10,142,5,157
test4sub19of100,test4pub60of100,1,191,10,143,5,158
test4sub10of100,test4pub60of100,1,191,10,144,4,158
test4sub76of100,test4pub60of100,1,191,10,144,4,158
test4sub54of100,test4pub60of100,1,191,10,340,0,350
test4sub71of100,test4pub60of100,1,191,10,361,1,372
test4sub69of100,test4pub60of100,1,191,10,364,1,375
test4sub30of100,test4pub60of100,1,191,10,368,0,378
test4sub21of100,test4pub60of100,1,191,10,371,1,382
test4sub97of100,test4pub60of100,1,191,10,371,1,382
test4sub31of100,test4pub60of100,1,191,10,375,1,386
test4sub67of100,test4pub60of100,1,191,10,383,2,395
test4sub14of100,test4pub60of100,1,191,10,385,1,396
test4sub6of100,test4pub60of100,1,191,10,384,2,396
test4sub84of100,test4pub60of100,1,191,10,390,0,400
test4sub25of100,test4pub60of100,1,191,10,392,0,402
test4sub22of100,test4pub60of100,1,191,10,394,0,404
test4sub45of100,test4pub60of100,1,191,10,392,3,405
test4sub64of100,test4pub60of100,1,191,10,404,0,414
test4sub39of100,test4pub60of100,1,191,10,404,1,415
test4sub24of100,test4pub60of100,1,191,10,428,0,438
test4sub46of100,test4pub60of100,1,191,10,436,0,446
test4sub12of100,test4pub60of100,1,191,10,444,1,455
test4sub86of100,test4pub60of100,1,191,10,472,0,482
test4sub87of100,test4pub60of100,1,191,10,512,1,523
test4sub53of100,test4pub60of100,1,191,10,520,1,531
test4sub20of100,test4pub60of100,1,191,10,560,1,571
test4sub9of100,test4pub60of100,1,191,10,584,1,595
test4sub8of100,test4pub61of100,1,191,18,3,1,22
test4sub75of100,test4pub61of100,1,191,18,7,1,26
test4sub1of100,test4pub61of100,1,191,18,9,1,28
test4sub91of100,test4pub61of100,1,191,18,12,0,30
test4sub32of100,test4pub61of100,1,191,18,17,1,36
test4sub14of100,test4pub61of100,1,191,18,17,1,36
test4sub9of100,test4pub61of100,1,191,18,19,1,38
test4sub37of100,test4pub61of100,1,191,18,22,1,41
test4sub19of100,test4pub61of100,1,191,18,23,1,42
test4sub73of100,test4pub61of100,1,191,18,26,1,45
test4sub100of100,test4pub61of100,1,191,18,30,1,49
test4sub34of100,test4pub61of100,1,191,18,31,2,51
test4sub57of100,test4pub61of100,1,191,18,32,1,51
test4sub43of100,test4pub61of100,1,191,18,36,1,55
test4sub45of100,test4pub61of100,1,191,18,42,1,61
test4sub98of100,test4pub61of100,1,191,18,44,1,63
test4sub89of100,test4pub61of100,1,191,18,50,1,69
test4sub52of100,test4pub61of100,1,191,18,53,1,72
test4sub53of100,test4pub61of100,1,191,18,54,1,73
test4sub33of100,test4pub61of100,1,191,18,60,0,78
test4sub54of100,test4pub61of100,1,191,18,62,1,81
test4sub68of100,test4pub61of100,1,191,18,64,1,83
test4sub87of100,test4pub61of100,1,191,18,65,5,88
test4sub84of100,test4pub61of100,1,191,18,67,3,88
test4sub80of100,test4pub61of100,1,191,18,67,3,88
test4sub40of100,test4pub61of100,1,191,18,68,3,89
test4sub88of100,test4pub61of100,1,191,18,68,3,89
test4sub90of100,test4pub61of100,1,191,18,70,2,90
test4sub60of100,test4pub61of100,1,191,18,73,1,92
test4sub97of100,test4pub61of100,1,191,18,74,5,97
test4sub39of100,test4pub61of100,1,191,18,75,4,97
test4sub11of100,test4pub61of100,1,191,18,76,4,98
test4sub20of100,test4pub61of100,1,191,18,77,3,98
test4sub44of100,test4pub61of100,1,191,18,78,3,99
test4sub78of100,test4pub61of100,1,191,18,78,4,100
test4sub62of100,test4pub61of100,1,191,18,82,1,101
test4sub7of100,test4pub61of100,1,191,18,87,1,106
test4sub77of100,test4pub61of100,1,191,18,89,1,108
test4sub61of100,test4pub61of100,1,191,18,88,6,112
test4sub12of100,test4pub61of100,1,191,18,89,6,113
test4sub18of100,test4pub61of100,1,191,18,92,4,114
test4sub74of100,test4pub61of100,1,191,18,92,4,114
test4sub55of100,test4pub61of100,1,191,18,90,10,118
test4sub17of100,test4pub61of100,1,191,18,91,9,118
test4sub49of100,test4pub61of100,1,191,18,92,9,119
test4sub3of100,test4pub61of100,1,191,18,95,10,123
test4sub67of100,test4pub61of100,1,191,18,97,8,123
test4sub2of100,test4pub61of100,1,191,18,97,8,123
test4sub24of100,test4pub61of100,1,191,18,98,8,124
test4sub27of100,test4pub61of100,1,191,18,99,7,124
test4sub42of100,test4pub61of100,1,191,18,99,8,125
test4sub93of100,test4pub61of100,1,191,18,94,13,125
test4sub65of100,test4pub61of100,1,191,18,102,6,126
test4sub99of100,test4pub61of100,1,191,18,103,6,127
test4sub51of100,test4pub61of100,1,191,18,103,5,126
test4sub69of100,test4pub61of100,1,191,18,104,4,126
test4sub71of100,test4pub61of100,1,191,18,105,5,128
test4sub83of100,test4pub61of100,1,191,18,148,1,167
test4sub50of100,test4pub61of100,1,191,18,147,2,167
test4sub41of100,test4pub61of100,1,191,18,149,1,168
test4sub28of100,test4pub61of100,1,191,18,154,1,173
test4sub29of100,test4pub61of100,1,191,18,155,2,175
test4sub48of100,test4pub61of100,1,191,18,156,4,178
test4sub63of100,test4pub61of100,1,191,18,158,3,179
test4sub79of100,test4pub61of100,1,191,18,158,3,179
test4sub56of100,test4pub61of100,1,191,18,159,3,180
test4sub5of100,test4pub61of100,1,191,18,160,4,182
test4sub4of100,test4pub61of100,1,191,18,160,5,183
test4sub25of100,test4pub61of100,1,191,18,163,2,183
test4sub23of100,test4pub61of100,1,191,18,164,2,184
test4sub92of100,test4pub61of100,1,191,18,164,2,184
test4sub13of100,test4pub61of100,1,191,18,196,1,215
test4sub47of100,test4pub61of100,1,191,18,196,1,215
test4sub35of100,test4pub61of100,1,191,18,197,1,216
test4sub22of100,test4pub61of100,1,191,18,199,2,219
test4sub64of100,test4pub61of100,1,191,18,201,1,220
test4sub76of100,test4pub61of100,1,191,18,200,3,221
test4sub59of100,test4pub61of100,1,191,18,203,1,222
test4sub95of100,test4pub61of100,1,191,18,203,1,222
test4sub38of100,test4pub61of100,1,191,18,207,1,226
test4sub21of100,test4pub61of100,1,191,18,214,1,233
test4sub36of100,test4pub61of100,1,191,18,213,1,232
test4sub85of100,test4pub61of100,1,191,18,216,1,235
test4sub46of100,test4pub61of100,1,191,18,217,0,235
test4sub66of100,test4pub61of100,1,191,18,219,1,238
test4sub82of100,test4pub61of100,1,191,18,220,1,239
test4sub16of100,test4pub61of100,1,191,18,222,1,241
test4sub72of100,test4pub61of100,1,191,18,224,1,243
test4sub81of100,test4pub61of100,1,191,18,222,5,245
test4sub10of100,test4pub61of100,1,191,18,224,3,245
test4sub70of100,test4pub61of100,1,191,18,225,3,246
test4sub26of100,test4pub61of100,1,191,18,226,2,246
test4sub86of100,test4pub61of100,1,191,18,229,1,248
test4sub30of100,test4pub61of100,1,191,18,323,1,342
test4sub6of100,test4pub61of100,1,191,18,323,1,342
test4sub94of100,test4pub61of100,1,191,18,332,0,350
test4sub96of100,test4pub61of100,1,191,18,339,0,357
test4sub31of100,test4pub61of100,1,191,18,344,0,362
test4sub15of100,test4pub61of100,1,191,18,355,1,374
test4sub58of100,test4pub61of100,1,191,18,407,1,426
test4sub84of100,test4pub62of100,1,191,10,8,1,19
test4sub34of100,test4pub62of100,1,191,10,13,0,23
test4sub90of100,test4pub62of100,1,191,10,14,1,25
test4sub1of100,test4pub62of100,1,191,10,15,2,27
test4sub85of100,test4pub62of100,1,191,10,17,2,29
test4sub27of100,test4pub62of100,1,191,10,18,1,29
test4sub18of100,test4pub62of100,1,191,10,20,1,31
test4sub68of100,test4pub62of100,1,191,10,23,1,34
test4sub60of100,test4pub62of100,1,191,10,29,0,39
test4sub9of100,test4pub62of100,1,191,10,40,3,53
test4sub39of100,test4pub62of100,1,191,10,41,3,54
test4sub20of100,test4pub62of100,1,191,10,42,2,54
test4sub6of100,test4pub62of100,1,191,10,41,3,54
test4sub67of100,test4pub62of100,1,191,10,43,1,54
test4sub94of100,test4pub62of100,1,191,10,50,3,63
test4sub65of100,test4pub62of100,1,191,10,50,2,62
test4sub71of100,test4pub62of100,1,191,10,51,1,62
test4sub82of100,test4pub62of100,1,191,10,51,2,63
test4sub37of100,test4pub62of100,1,191,10,82,1,93
test4sub98of100,test4pub62of100,1,191,10,83,2,95
test4sub46of100,test4pub62of100,1,191,10,84,2,96
test4sub69of100,test4pub62of100,1,191,10,84,4,98
test4sub49of100,test4pub62of100,1,191,10,86,3,99
test4sub13of100,test4pub62of100,1,191,10,87,4,101
test4sub38of100,test4pub62of100,1,191,10,88,3,101
test4sub78of100,test4pub62of100,1,191,10,89,3,102
test4sub83of100,test4pub62of100,1,191,10,90,2,102
test4sub22of100,test4pub62of100,1,191,10,91,2,103
test4sub44of100,test4pub62of100,1,191,10,94,1,105
test4sub73of100,test4pub62of100,1,191,10,97,1,108
test4sub41of100,test4pub62of100,1,191,10,97,2,109
test4sub51of100,test4pub62of100,1,191,10,100,1,111
test4sub56of100,test4pub62of100,1,191,10,102,4,116
test4sub7of100,test4pub62of100,1,191,10,104,3,117
test4sub47of100,test4pub62of100,1,191,10,105,6,121
test4sub16of100,test4pub62of100,1,191,10,105,7,122
test4sub97of100,test4pub62of100,1,191,10,106,7,123
test4sub91of100,test4pub62of100,1,191,10,105,8,123
test4sub28of100,test4pub62of100,1,191,10,109,6,125
test4sub43of100,test4pub62of100,1,191,10,110,6,126
test4sub48of100,test4pub62of100,1,191,10,111,7,128
test4sub61of100,test4pub62of100,1,191,10,112,5,127
test4sub21of100,test4pub62of100,1,191,10,115,5,130
test4sub87of100,test4pub62of100,1,191,10,116,4,130
test4sub55of100,test4pub62of100,1,191,10,118,3,131
test4sub88of100,test4pub62of100,1,191,10,118,3,131
test4sub64of100,test4pub62of100,1,191,10,119,3,132
test4sub4of100,test4pub62of100,1,191,10,120,3,133
test4sub54of100,test4pub62of100,1,191,10,122,1,133
test4sub100of100,test4pub62of100,1,191,10,161,1,172
test4sub59of100,test4pub62of100,1,191,10,162,2,174
test4sub35of100,test4pub62of100,1,191,10,163,1,174
test4sub57of100,test4pub62of100,1,191,10,166,1,177
test4sub11of100,test4pub62of100,1,191,10,168,1,179
test4sub74of100,test4pub62of100,1,191,10,169,3,182
test4sub32of100,test4pub62of100,1,191,10,171,2,183
test4sub79of100,test4pub62of100,1,191,10,170,3,183
test4sub31of100,test4pub62of100,1,191,10,171,6,187
test4sub23of100,test4pub62of100,1,191,10,174,4,188
test4sub62of100,test4pub62of100,1,191,10,175,4,189
test4sub3of100,test4pub62of100,1,191,10,176,3,189
test4sub12of100,test4pub62of100,1,191,10,176,4,190
test4sub89of100,test4pub62of100,1,191,10,177,3,190
test4sub36of100,test4pub62of100,1,191,10,177,4,191
test4sub86of100,test4pub62of100,1,191,10,181,2,193
test4sub96of100,test4pub62of100,1,191,10,184,1,195
test4sub25of100,test4pub62of100,1,191,10,186,1,197
test4sub93of100,test4pub62of100,1,191,10,200,1,211
test4sub29of100,test4pub62of100,1,191,10,199,2,211
test4sub52of100,test4pub62of100,1,191,10,203,1,214
test4sub45of100,test4pub62of100,1,191,10,201,3,214
test4sub5of100,test4pub62of100,1,191,10,202,2,214
test4sub19of100,test4pub62of100,1,191,10,202,1,213
test4sub77of100,test4pub62of100,1,191,10,207,1,218
test4sub10of100,test4pub62of100,1,191,10,210,1,221
test4sub42of100,test4pub62of100,1,191,10,208,7,225
test4sub76of100,test4pub62of100,1,191,10,209,6,225
test4sub17of100,test4pub62of100,1,191,10,210,6,226
test4sub33of100,test4pub62of100,1,191,10,212,4,226
test4sub40of100,test4pub62of100,1,191,10,213,4,227
test4sub99of100,test4pub62of100,1,191,10,213,4,227
test4sub92of100,test4pub62of100,1,191,10,214,3,227
test4sub8of100,test4pub62of100,1,191,10,215,4,229
test4sub81of100,test4pub62of100,1,191,10,219,7,236
test4sub72of100,test4pub62of100,1,191,10,221,11,242
test4sub70of100,test4pub62of100,1,191,10,221,12,243
test4sub63of100,test4pub62of100,1,191,10,222,11,243
test4sub24of100,test4pub62of100,1,191,10,222,12,244
test4sub30of100,test4pub62of100,1,191,10,224,11,245
test4sub80of100,test4pub62of100,1,191,10,225,10,245
test4sub15of100,test4pub62of100,1,191,10,226,9,245
test4sub14of100,test4pub62of100,1,191,10,225,11,246
test4sub66of100,test4pub62of100,1,191,10,226,10,246
test4sub2of100,test4pub62of100,1,191,10,227,9,246
test4sub95of100,test4pub62of100,1,191,10,228,8,246
test4sub50of100,test4pub62of100,1,191,10,229,9,248
test4sub26of100,test4pub62of100,1,191,10,229,8,247
test4sub53of100,test4pub62of100,1,191,10,230,7,247
test4sub58of100,test4pub62of100,1,191,10,231,7,248
test4sub75of100,test4pub62of100,1,191,10,232,6,248
test4sub81of100,test4pub63of100,1,191,15,4,1,20
test4sub49of100,test4pub63of100,1,191,15,6,1,22
test4sub95of100,test4pub63of100,1,191,15,7,1,23
test4sub48of100,test4pub63of100,1,191,15,13,2,30
test4sub34of100,test4pub63of100,1,191,15,13,2,30
test4sub36of100,test4pub63of100,1,191,15,14,2,31
test4sub58of100,test4pub63of100,1,191,15,19,1,35
test4sub91of100,test4pub63of100,1,191,15,24,1,40
test4sub92of100,test4pub63of100,1,191,15,25,1,41
test4sub85of100,test4pub63of100,1,191,15,26,1,42
test4sub39of100,test4pub63of100,1,191,15,29,1,45
test4sub69of100,test4pub63of100,1,191,15,29,3,47
test4sub51of100,test4pub63of100,1,191,15,30,2,47
test4sub76of100,test4pub63of100,1,191,15,32,2,49
test4sub33of100,test4pub63of100,1,191,15,36,1,52
test4sub29of100,test4pub63of100,1,191,15,37,2,54
test4sub45of100,test4pub63of100,1,191,15,39,2,56
test4sub99of100,test4pub63of100,1,191,15,40,2,57
test4sub7of100,test4pub63of100,1,191,15,41,1,57
test4sub62of100,test4pub63of100,1,191,15,44,1,60
test4sub27of100,test4pub63of100,1,191,15,45,1,61
test4sub42of100,test4pub63of100,1,191,15,46,4,65
test4sub66of100,test4pub63of100,1,191,15,47,3,65
test4sub30of100,test4pub63of100,1,191,15,49,1,65
test4sub88of100,test4pub63of100,1,191,15,72,1,88
test4sub13of100,test4pub63of100,1,191,15,64,4,83
test4sub90of100,test4pub63of100,1,191,15,75,2,92
test4sub26of100,test4pub63of100,1,191,15,65,1,81
test4sub63of100,test4pub63of100,1,191,15,77,2,94
test4sub65of100,test4pub63of100,1,191,15,78,0,93
test4sub96of100,test4pub63of100,1,191,15,81,1,97
test4sub100of100,test4pub63of100,1,191,15,83,2,100
test4sub32of100,test4pub63of100,1,191,15,83,1,99
test4sub70of100,test4pub63of100,1,191,15,89,0,104
test4sub56of100,test4pub63of100,1,191,15,91,1,107
test4sub97of100,test4pub63of100,1,191,15,89,5,109
test4sub75of100,test4pub63of100,1,191,15,91,3,109
test4sub24of100,test4pub63of100,1,191,15,92,3,110
test4sub93of100,test4pub63of100,1,191,15,93,1,109
test4sub84of100,test4pub63of100,1,191,15,98,1,114
test4sub78of100,test4pub63of100,1,191,15,100,0,115
test4sub74of100,test4pub63of100,1,191,15,103,0,118
test4sub94of100,test4pub63of100,1,191,15,104,1,120
test4sub35of100,test4pub63of100,1,191,15,105,2,122
test4sub5of100,test4pub63of100,1,191,15,106,1,122
test4sub31of100,test4pub63of100,1,191,15,109,1,125
test4sub8of100,test4pub63of100,1,191,15,110,2,127
test4sub50of100,test4pub63of100,1,191,15,111,6,132
test4sub77of100,test4pub63of100,1,191,15,112,7,134
test4sub2of100,test4pub63of100,1,191,15,112,10,137
test4sub20of100,test4pub63of100,1,191,15,114,10,139
test4sub4of100,test4pub63of100,1,191,15,115,10,140
test4sub12of100,test4pub63of100,1,191,15,115,11,141
test4sub98of100,test4pub63of100,1,191,15,116,15,146
test4sub17of100,test4pub63of100,1,191,15,117,14,146
test4sub80of100,test4pub63of100,1,191,15,118,14,147
test4sub59of100,test4pub63of100,1,191,15,119,12,146
test4sub86of100,test4pub63of100,1,191,15,120,12,147
test4sub67of100,test4pub63of100,1,191,15,120,13,148
test4sub41of100,test4pub63of100,1,191,15,121,13,149
test4sub64of100,test4pub63of100,1,191,15,121,14,150
test4sub16of100,test4pub63of100,1,191,15,122,12,149
test4sub61of100,test4pub63of100,1,191,15,123,11,149
test4sub28of100,test4pub63of100,1,191,15,124,10,149
test4sub87of100,test4pub63of100,1,191,15,125,10,150
test4sub40of100,test4pub63of100,1,191,15,126,9,150
test4sub43of100,test4pub63of100,1,191,15,128,9,152
test4sub11of100,test4pub63of100,1,191,15,127,9,151
test4sub19of100,test4pub63of100,1,191,15,129,8,152
test4sub22of100,test4pub63of100,1,191,15,128,9,152
test4sub46of100,test4pub63of100,1,191,15,128,8,151
test4sub9of100,test4pub63of100,1,191,15,133,4,152
test4sub71of100,test4pub63of100,1,191,15,180,1,196
test4sub14of100,test4pub63of100,1,191,15,182,0,197
test4sub23of100,test4pub63of100,1,191,15,181,4,200
test4sub18of100,test4pub63of100,1,191,15,183,2,200
test4sub6of100,test4pub63of100,1,191,15,184,1,200
test4sub68of100,test4pub63of100,1,191,15,187,3,205
test4sub83of100,test4pub63of100,1,191,15,187,3,205
test4sub37of100,test4pub63of100,1,191,15,188,2,205
test4sub3of100,test4pub63of100,1,191,15,188,5,208
test4sub44of100,test4pub63of100,1,191,15,190,4,209
test4sub38of100,test4pub63of100,1,191,15,191,4,210
test4sub55of100,test4pub63of100,1,191,15,192,4,211
test4sub72of100,test4pub63of100,1,191,15,194,3,212
test4sub60of100,test4pub63of100,1,191,15,196,2,213
test4sub79of100,test4pub63of100,1,191,15,196,1,212
test4sub54of100,test4pub63of100,1,191,15,332,1,348
test4sub82of100,test4pub63of100,1,191,15,351,1,367
test4sub47of100,test4pub63of100,1,191,15,355,1,371
test4sub1of100,test4pub63of100,1,191,15,357,0,372
test4sub25of100,test4pub63of100,1,191,15,356,2,373
test4sub57of100,test4pub63of100,1,191,15,361,1,377
test4sub73of100,test4pub63of100,1,191,15,365,1,381
test4sub21of100,test4pub63of100,1,191,15,371,1,387
test4sub89of100,test4pub63of100,1,191,15,372,1,388
test4sub15of100,test4pub63of100,1,191,15,377,1,393
test4sub10of100,test4pub63of100,1,191,15,378,1,394
test4sub45of100,test4pub64of100,1,191,10,9,1,20
test4sub73of100,test4pub64of100,1,191,10,9,2,21
test4sub55of100,test4pub64of100,1,191,10,14,1,25
test4sub91of100,test4pub64of100,1,191,10,15,1,26
test4sub53of100,test4pub63of100,1,191,15,449,1,465
test4sub36of100,test4pub64of100,1,191,10,26,1,37
test4sub38of100,test4pub64of100,1,191,10,27,1,38
test4sub32of100,test4pub64of100,1,191,10,29,1,40
test4sub86of100,test4pub64of100,1,191,10,31,0,41
test4sub24of100,test4pub64of100,1,191,10,31,2,43
test4sub9of100,test4pub64of100,1,191,10,32,1,43
test4sub57of100,test4pub64of100,1,191,10,37,1,48
test4sub62of100,test4pub64of100,1,191,10,43,2,55
test4sub65of100,test4pub64of100,1,191,10,43,3,56
test4sub19of100,test4pub64of100,1,191,10,44,1,55
test4sub28of100,test4pub64of100,1,191,10,48,2,60
test4sub52of100,test4pub63of100,1,191,15,478,2,495
test4sub96of100,test4pub64of100,1,191,10,50,1,61
test4sub64of100,test4pub64of100,1,191,10,57,1,68
test4sub87of100,test4pub64of100,1,191,10,61,1,72
test4sub54of100,test4pub64of100,1,191,10,62,1,73
test4sub2of100,test4pub64of100,1,191,10,65,0,75
test4sub53of100,test4pub64of100,1,191,10,68,1,79
test4sub5of100,test4pub64of100,1,191,10,70,1,81
test4sub67of100,test4pub64of100,1,191,10,72,1,83
test4sub68of100,test4pub64of100,1,191,10,73,3,86
test4sub22of100,test4pub64of100,1,191,10,74,3,87
test4sub82of100,test4pub64of100,1,191,10,74,3,87
test4sub46of100,test4pub64of100,1,191,10,75,2,87
test4sub81of100,test4pub64of100,1,191,10,76,3,89
test4sub1of100,test4pub64of100,1,191,10,79,1,90
test4sub61of100,test4pub64of100,1,191,10,81,1,92
test4sub63of100,test4pub64of100,1,191,10,81,2,93
test4sub26of100,test4pub64of100,1,191,10,82,2,94
test4sub34of100,test4pub64of100,1,191,10,84,1,95
test4sub10of100,test4pub64of100,1,191,10,88,1,99
test4sub77of100,test4pub64of100,1,191,10,97,0,107
test4sub74of100,test4pub64of100,1,191,10,99,0,109
test4sub66of100,test4pub64of100,1,191,10,104,1,115
test4sub98of100,test4pub64of100,1,191,10,106,0,116
test4sub39of100,test4pub64of100,1,191,10,108,1,119
test4sub70of100,test4pub64of100,1,191,10,110,1,121
test4sub16of100,test4pub64of100,1,191,10,111,1,122
test4sub97of100,test4pub64of100,1,191,10,112,2,124
test4sub3of100,test4pub64of100,1,191,10,116,1,127
test4sub47of100,test4pub64of100,1,191,10,116,2,128
test4sub58of100,test4pub64of100,1,191,10,119,1,130
test4sub23of100,test4pub64of100,1,191,10,118,1,129
test4sub99of100,test4pub64of100,1,191,10,118,3,131
test4sub27of100,test4pub64of100,1,191,10,121,1,132
test4sub80of100,test4pub64of100,1,191,10,124,1,135
test4sub44of100,test4pub64of100,1,191,10,127,1,138
test4sub42of100,test4pub64of100,1,191,10,133,2,145
test4sub71of100,test4pub64of100,1,191,10,133,6,149
test4sub4of100,test4pub64of100,1,191,10,134,6,150
test4sub35of100,test4pub64of100,1,191,10,135,7,152
test4sub31of100,test4pub64of100,1,191,10,136,6,152
test4sub33of100,test4pub64of100,1,191,10,158,0,168
test4sub59of100,test4pub64of100,1,191,10,162,1,173
test4sub84of100,test4pub64of100,1,191,10,163,3,176
test4sub79of100,test4pub64of100,1,191,10,164,3,177
test4sub37of100,test4pub64of100,1,191,10,165,5,180
test4sub92of100,test4pub64of100,1,191,10,166,6,182
test4sub29of100,test4pub64of100,1,191,10,167,5,182
test4sub90of100,test4pub64of100,1,191,10,168,5,183
test4sub13of100,test4pub64of100,1,191,10,167,6,183
test4sub95of100,test4pub64of100,1,191,10,171,3,184
test4sub11of100,test4pub64of100,1,191,10,169,6,185
test4sub43of100,test4pub64of100,1,191,10,171,4,185
test4sub72of100,test4pub64of100,1,191,10,172,4,186
test4sub52of100,test4pub64of100,1,191,10,172,4,186
test4sub8of100,test4pub64of100,1,191,10,322,1,333
test4sub93of100,test4pub64of100,1,191,10,328,0,338
test4sub56of100,test4pub64of100,1,191,10,330,1,341
test4sub83of100,test4pub64of100,1,191,10,330,1,341
test4sub51of100,test4pub64of100,1,191,10,338,1,349
test4sub89of100,test4pub64of100,1,191,10,339,2,351
test4sub69of100,test4pub64of100,1,191,10,341,1,352
test4sub30of100,test4pub64of100,1,191,10,344,1,355
test4sub15of100,test4pub64of100,1,191,10,343,1,354
test4sub25of100,test4pub64of100,1,191,10,343,2,355
test4sub88of100,test4pub64of100,1,191,10,351,1,362
test4sub6of100,test4pub64of100,1,191,10,354,1,365
test4sub85of100,test4pub64of100,1,191,10,360,1,371
test4sub48of100,test4pub64of100,1,191,10,361,1,372
test4sub41of100,test4pub64of100,1,191,10,362,2,374
test4sub49of100,test4pub64of100,1,191,10,363,1,374
test4sub14of100,test4pub64of100,1,191,10,364,2,376
test4sub94of100,test4pub64of100,1,191,10,366,1,377
test4sub21of100,test4pub64of100,1,191,10,370,2,382
test4sub18of100,test4pub64of100,1,191,10,371,1,382
test4sub17of100,test4pub64of100,1,191,10,373,1,384
test4sub7of100,test4pub64of100,1,191,10,374,0,384
test4sub50of100,test4pub64of100,1,191,10,385,0,395
test4sub12of100,test4pub64of100,1,191,10,387,0,397
test4sub78of100,test4pub64of100,1,191,10,391,1,402
test4sub60of100,test4pub64of100,1,191,10,392,1,403
test4sub76of100,test4pub64of100,1,191,10,397,0,407
test4sub100of100,test4pub64of100,1,191,10,406,1,417
test4sub18of100,test4pub65of100,1,191,11,5,1,17
test4sub29of100,test4pub65of100,1,191,11,7,1,19
test4sub88of100,test4pub65of100,1,191,11,10,1,22
test4sub27of100,test4pub65of100,1,191,11,19,1,31
test4sub78of100,test4pub65of100,1,191,11,28,1,40
test4sub100of100,test4pub65of100,1,191,11,29,1,41
test4sub79of100,test4pub65of100,1,191,11,33,1,45
test4sub52of100,test4pub65of100,1,191,11,34,2,47
test4sub50of100,test4pub65of100,1,191,11,35,1,47
test4sub60of100,test4pub65of100,1,191,11,39,1,51
test4sub13of100,test4pub65of100,1,191,11,42,1,54
test4sub28of100,test4pub65of100,1,191,11,45,1,57
test4sub83of100,test4pub65of100,1,191,11,45,2,58
test4sub66of100,test4pub65of100,1,191,11,46,5,62
test4sub99of100,test4pub65of100,1,191,11,48,3,62
test4sub61of100,test4pub65of100,1,191,11,49,3,63
test4sub15of100,test4pub65of100,1,191,11,50,2,63
test4sub5of100,test4pub65of100,1,191,11,51,1,63
test4sub46of100,test4pub65of100,1,191,11,53,3,67
test4sub20of100,test4pub64of100,1,191,10,480,3,493
test4sub85of100,test4pub65of100,1,191,11,54,3,68
test4sub87of100,test4pub65of100,1,191,11,56,2,69
test4sub10of100,test4pub65of100,1,191,11,56,3,70
test4sub65of100,test4pub65of100,1,191,11,60,1,72
test4sub40of100,test4pub64of100,1,191,10,488,3,501
test4sub14of100,test4pub65of100,1,191,11,63,4,78
test4sub68of100,test4pub65of100,1,191,11,63,5,79
test4sub22of100,test4pub65of100,1,191,11,65,5,81
test4sub75of100,test4pub64of100,1,191,10,491,4,505
test4sub9of100,test4pub65of100,1,191,11,66,4,81
test4sub54of100,test4pub65of100,1,191,11,67,3,81
test4sub64of100,test4pub65of100,1,191,11,69,2,82
test4sub44of100,test4pub65of100,1,191,11,73,1,85
test4sub53of100,test4pub65of100,1,191,11,71,9,91
test4sub4of100,test4pub65of100,1,191,11,73,9,93
test4sub57of100,test4pub65of100,1,191,11,74,7,92
test4sub42of100,test4pub65of100,1,191,11,75,7,93
test4sub30of100,test4pub65of100,1,191,11,76,7,94
test4sub23of100,test4pub65of100,1,191,11,77,7,95
test4sub33of100,test4pub65of100,1,191,11,77,6,94
test4sub1of100,test4pub65of100,1,191,11,78,6,95
test4sub56of100,test4pub65of100,1,191,11,79,6,96
test4sub32of100,test4pub65of100,1,191,11,77,6,94
test4sub2of100,test4pub65of100,1,191,11,81,3,95
test4sub71of100,test4pub65of100,1,191,11,86,2,99
test4sub8of100,test4pub65of100,1,191,11,86,3,100
test4sub59of100,test4pub65of100,1,191,11,87,2,100
test4sub98of100,test4pub65of100,1,191,11,88,1,100
test4sub47of100,test4pub65of100,1,191,11,92,1,104
test4sub35of100,test4pub65of100,1,191,11,92,3,106
test4sub49of100,test4pub65of100,1,191,11,93,2,106
test4sub38of100,test4pub65of100,1,191,11,94,1,106
test4sub62of100,test4pub65of100,1,191,11,98,1,110
test4sub70of100,test4pub65of100,1,191,11,103,1,115
test4sub69of100,test4pub65of100,1,191,11,103,1,115
test4sub63of100,test4pub65of100,1,191,11,104,0,115
test4sub41of100,test4pub65of100,1,191,11,107,1,119
test4sub81of100,test4pub65of100,1,191,11,109,2,122
test4sub48of100,test4pub65of100,1,191,11,109,3,123
test4sub16of100,test4pub65of100,1,191,11,110,3,124
test4sub21of100,test4pub65of100,1,191,11,111,3,125
test4sub20of100,test4pub65of100,1,191,11,113,8,132
test4sub24of100,test4pub65of100,1,191,11,116,7,134
test4sub97of100,test4pub65of100,1,191,11,117,6,134
test4sub95of100,test4pub65of100,1,191,11,117,7,135
test4sub94of100,test4pub65of100,1,191,11,118,6,135
test4sub11of100,test4pub65of100,1,191,11,125,2,138
test4sub72of100,test4pub65of100,1,191,11,124,5,140
test4sub55of100,test4pub65of100,1,191,11,123,4,138
test4sub75of100,test4pub65of100,1,191,11,124,5,140
test4sub40of100,test4pub65of100,1,191,11,122,5,138
test4sub77of100,test4pub65of100,1,191,11,119,7,137
test4sub26of100,test4pub65of100,1,191,11,122,5,138
test4sub43of100,test4pub65of100,1,191,11,121,5,137
test4sub80of100,test4pub65of100,1,191,11,119,6,136
test4sub19of100,test4pub65of100,1,191,11,120,7,138
test4sub6of100,test4pub65of100,1,191,11,130,7,148
test4sub76of100,test4pub65of100,1,191,11,120,8,139
test4sub84of100,test4pub65of100,1,191,11,134,3,148
test4sub25of100,test4pub65of100,1,191,11,135,2,148
test4sub89of100,test4pub65of100,1,191,11,323,1,335
test4sub7of100,test4pub65of100,1,191,11,328,0,339
test4sub67of100,test4pub65of100,1,191,11,338,1,350
test4sub93of100,test4pub65of100,1,191,11,344,1,356
test4sub90of100,test4pub65of100,1,191,11,351,1,363
test4sub39of100,test4pub65of100,1,191,11,353,0,364
test4sub34of100,test4pub65of100,1,191,11,360,1,372
test4sub82of100,test4pub65of100,1,191,11,362,1,374
test4sub86of100,test4pub65of100,1,191,11,366,1,378
test4sub51of100,test4pub65of100,1,191,11,367,1,379
test4sub45of100,test4pub65of100,1,191,11,369,0,380
test4sub37of100,test4pub65of100,1,191,11,371,1,383
test4sub91of100,test4pub65of100,1,191,11,373,1,385
test4sub96of100,test4pub65of100,1,191,11,374,1,386
test4sub74of100,test4pub65of100,1,191,11,376,1,388
test4sub31of100,test4pub65of100,1,191,11,378,1,390
test4sub17of100,test4pub65of100,1,191,11,382,1,394
test4sub73of100,test4pub65of100,1,191,11,387,1,399
test4sub58of100,test4pub65of100,1,191,11,389,1,401
test4sub92of100,test4pub65of100,1,191,11,392,1,404
test4sub12of100,test4pub65of100,1,191,11,398,1,410
test4sub36of100,test4pub65of100,1,191,11,401,0,412
test4sub3of100,test4pub65of100,1,191,11,444,0,455
test4sub70of100,test4pub66of100,1,191,11,3,1,15
test4sub72of100,test4pub66of100,1,191,11,3,1,15
test4sub93of100,test4pub66of100,1,191,11,10,0,21
test4sub63of100,test4pub66of100,1,191,11,10,1,22
test4sub55of100,test4pub66of100,1,191,11,14,2,27
test4sub84of100,test4pub66of100,1,191,11,16,1,28
test4sub21of100,test4pub66of100,1,191,11,22,1,34
test4sub6of100,test4pub66of100,1,191,11,23,1,35
test4sub100of100,test4pub66of100,1,191,11,26,1,38
test4sub60of100,test4pub66of100,1,191,11,27,3,41
test4sub48of100,test4pub66of100,1,191,11,28,5,44
test4sub24of100,test4pub66of100,1,191,11,28,5,44
test4sub18of100,test4pub66of100,1,191,11,29,6,46
test4sub26of100,test4pub66of100,1,191,11,31,5,47
test4sub11of100,test4pub66of100,1,191,11,32,6,49
test4sub12of100,test4pub66of100,1,191,11,32,6,49
test4sub35of100,test4pub66of100,1,191,11,33,6,50
test4sub29of100,test4pub66of100,1,191,11,34,5,50
test4sub86of100,test4pub66of100,1,191,11,36,4,51
test4sub34of100,test4pub66of100,1,191,11,37,4,52
test4sub71of100,test4pub66of100,1,191,11,38,3,52
test4sub47of100,test4pub66of100,1,191,11,43,1,55
test4sub92of100,test4pub66of100,1,191,11,45,1,57
test4sub50of100,test4pub66of100,1,191,11,47,1,59
test4sub46of100,test4pub66of100,1,191,11,48,4,63
test4sub3of100,test4pub66of100,1,191,11,49,3,63
test4sub59of100,test4pub66of100,1,191,11,50,4,65
test4sub88of100,test4pub66of100,1,191,11,51,3,65
test4sub44of100,test4pub66of100,1,191,11,51,4,66
test4sub82of100,test4pub66of100,1,191,11,55,1,67
test4sub54of100,test4pub66of100,1,191,11,59,0,70
test4sub4of100,test4pub66of100,1,191,11,59,2,72
test4sub5of100,test4pub66of100,1,191,11,60,2,73
test4sub23of100,test4pub66of100,1,191,11,61,3,75
test4sub75of100,test4pub66of100,1,191,11,62,3,76
test4sub66of100,test4pub66of100,1,191,11,63,2,76
test4sub73of100,test4pub66of100,1,191,11,64,1,76
test4sub40of100,test4pub66of100,1,191,11,68,1,80
test4sub67of100,test4pub66of100,1,191,11,71,2,84
test4sub31of100,test4pub66of100,1,191,11,72,2,85
test4sub80of100,test4pub66of100,1,191,11,73,2,86
test4sub61of100,test4pub66of100,1,191,11,73,1,85
test4sub7of100,test4pub66of100,1,191,11,79,1,91
test4sub94of100,test4pub66of100,1,191,11,81,0,92
test4sub49of100,test4pub66of100,1,191,11,85,1,97
test4sub37of100,test4pub66of100,1,191,11,85,3,99
test4sub43of100,test4pub66of100,1,191,11,86,3,100
test4sub36of100,test4pub66of100,1,191,11,87,2,100
test4sub33of100,test4pub66of100,1,191,11,88,1,100
test4sub53of100,test4pub66of100,1,191,11,93,1,105
test4sub42of100,test4pub66of100,1,191,11,95,1,107
test4sub79of100,test4pub66of100,1,191,11,94,4,109
test4sub17of100,test4pub66of100,1,191,11,97,3,111
test4sub9of100,test4pub66of100,1,191,11,98,3,112
test4sub98of100,test4pub66of100,1,191,11,99,2,112
test4sub76of100,test4pub66of100,1,191,11,100,1,112
test4sub32of100,test4pub66of100,1,191,11,102,1,114
test4sub8of100,test4pub66of100,1,191,11,102,1,114
test4sub65of100,test4pub66of100,1,191,11,105,1,117
test4sub68of100,test4pub66of100,1,191,11,105,1,117
test4sub22of100,test4pub66of100,1,191,11,107,1,119
test4sub25of100,test4pub66of100,1,191,11,107,2,120
test4sub2of100,test4pub66of100,1,191,11,108,1,120
test4sub27of100,test4pub66of100,1,191,11,112,1,124
test4sub39of100,test4pub66of100,1,191,11,115,3,129
test4sub57of100,test4pub66of100,1,191,11,115,4,130
test4sub30of100,test4pub66of100,1,191,11,116,4,131
test4sub16of100,test4pub66of100,1,191,11,116,4,131
test4sub78of100,test4pub66of100,1,191,11,118,3,132
test4sub51of100,test4pub66of100,1,191,11,118,3,132
test4sub38of100,test4pub66of100,1,191,11,120,2,133
test4sub41of100,test4pub66of100,1,191,11,124,1,136
test4sub97of100,test4pub66of100,1,191,11,127,0,138
test4sub45of100,test4pub66of100,1,191,11,128,1,140
test4sub81of100,test4pub66of100,1,191,11,136,2,149
test4sub19of100,test4pub66of100,1,191,11,136,2,149
test4sub74of100,test4pub66of100,1,191,11,137,1,149
test4sub69of100,test4pub66of100,1,191,11,138,2,151
test4sub77of100,test4pub66of100,1,191,11,140,1,152
test4sub83of100,test4pub66of100,1,191,11,143,1,155
test4sub62of100,test4pub66of100,1,191,11,144,1,156
test4sub85of100,test4pub66of100,1,191,11,151,1,163
test4sub1of100,test4pub66of100,1,191,11,151,2,164
test4sub20of100,test4pub66of100,1,191,11,153,1,165
test4sub91of100,test4pub66of100,1,191,11,334,1,346
test4sub15of100,test4pub66of100,1,191,11,346,1,358
test4sub10of100,test4pub66of100,1,191,11,347,1,359
test4sub56of100,test4pub66of100,1,191,11,350,1,362
test4sub89of100,test4pub66of100,1,191,11,355,1,367
test4sub99of100,test4pub66of100,1,191,11,358,1,370
test4sub14of100,test4pub66of100,1,191,11,359,1,371
test4sub90of100,test4pub66of100,1,191,11,362,1,374
test4sub87of100,test4pub66of100,1,191,11,374,1,386
test4sub96of100,test4pub66of100,1,191,11,380,1,392
test4sub28of100,test4pub66of100,1,191,11,395,0,406
test4sub58of100,test4pub66of100,1,191,11,396,1,408
test4sub13of100,test4pub66of100,1,191,11,397,1,409
test4sub64of100,test4pub66of100,1,191,11,399,1,411
test4sub95of100,test4pub66of100,1,191,11,406,0,417
test4sub52of100,test4pub66of100,1,191,11,428,1,440
test4sub20of100,test4pub67of100,1,191,10,6,1,17
test4sub30of100,test4pub67of100,1,191,10,7,1,18
test4sub41of100,test4pub67of100,1,191,10,11,0,21
test4sub76of100,test4pub67of100,1,191,10,11,1,22
test4sub59of100,test4pub67of100,1,191,10,16,1,27
test4sub78of100,test4pub67of100,1,191,10,18,0,28
test4sub52of100,test4pub67of100,1,191,10,17,2,29
test4sub56of100,test4pub67of100,1,191,10,23,1,34
test4sub55of100,test4pub67of100,1,191,10,25,1,36
test4sub54of100,test4pub67of100,1,191,10,38,1,49
test4sub43of100,test4pub67of100,1,191,10,42,1,53
test4sub29of100,test4pub67of100,1,191,10,43,4,57
test4sub4of100,test4pub67of100,1,191,10,44,8,62
test4sub22of100,test4pub67of100,1,191,10,45,7,62
test4sub13of100,test4pub67of100,1,191,10,45,8,63
test4sub71of100,test4pub67of100,1,191,10,47,7,64
test4sub94of100,test4pub67of100,1,191,10,48,7,65
test4sub18of100,test4pub67of100,1,191,10,48,6,64
test4sub81of100,test4pub67of100,1,191,10,49,7,66
test4sub35of100,test4pub67of100,1,191,10,50,6,66
test4sub14of100,test4pub67of100,1,191,10,50,8,68
test4sub17of100,test4pub67of100,1,191,10,51,7,68
test4sub27of100,test4pub67of100,1,191,10,51,18,79
test4sub85of100,test4pub67of100,1,191,10,53,17,80
test4sub15of100,test4pub67of100,1,191,10,56,24,90
test4sub97of100,test4pub67of100,1,191,10,57,23,90
test4sub51of100,test4pub67of100,1,191,10,58,22,90
test4sub12of100,test4pub67of100,1,191,10,60,21,91
test4sub2of100,test4pub67of100,1,191,10,61,21,92
test4sub61of100,test4pub67of100,1,191,10,63,21,94
test4sub50of100,test4pub67of100,1,191,10,63,21,94
test4sub64of100,test4pub67of100,1,191,10,64,20,94
test4sub73of100,test4pub67of100,1,191,10,64,21,95
test4sub3of100,test4pub67of100,1,191,10,65,35,110
test4sub86of100,test4pub67of100,1,191,10,65,34,109
test4sub37of100,test4pub67of100,1,191,10,67,34,111
test4sub31of100,test4pub67of100,1,191,10,68,34,112
test4sub95of100,test4pub67of100,1,191,10,72,31,113
test4sub38of100,test4pub67of100,1,191,10,72,32,114
test4sub79of100,test4pub67of100,1,191,10,73,32,115
test4sub84of100,test4pub67of100,1,191,10,74,31,115
test4sub5of100,test4pub67of100,1,191,10,75,31,116
test4sub23of100,test4pub67of100,1,191,10,77,30,117
test4sub75of100,test4pub67of100,1,191,10,78,31,119
test4sub57of100,test4pub67of100,1,191,10,87,23,120
test4sub62of100,test4pub67of100,1,191,10,88,22,120
test4sub80of100,test4pub67of100,1,191,10,89,22,121
test4sub77of100,test4pub67of100,1,191,10,90,22,122
test4sub58of100,test4pub67of100,1,191,10,90,21,121
test4sub32of100,test4pub67of100,1,191,10,91,21,122
test4sub74of100,test4pub67of100,1,191,10,92,20,122
test4sub82of100,test4pub67of100,1,191,10,94,18,122
test4sub39of100,test4pub67of100,1,191,10,95,18,123
test4sub34of100,test4pub67of100,1,191,10,96,18,124
test4sub72of100,test4pub67of100,1,191,10,96,17,123
test4sub45of100,test4pub67of100,1,191,10,97,17,124
test4sub25of100,test4pub67of100,1,191,10,98,17,125
test4sub26of100,test4pub67of100,1,191,10,97,18,125
test4sub42of100,test4pub67of100,1,191,10,101,14,125
test4sub69of100,test4pub67of100,1,191,10,102,13,125
test4sub91of100,test4pub67of100,1,191,10,103,14,127
test4sub63of100,test4pub67of100,1,191,10,104,12,126
test4sub7of100,test4pub67of100,1,191,10,105,11,126
test4sub83of100,test4pub67of100,1,191,10,107,10,127
test4sub66of100,test4pub67of100,1,191,10,108,9,127
test4sub100of100,test4pub67of100,1,191,10,108,9,127
test4sub10of100,test4pub67of100,1,191,10,109,9,128
test4sub67of100,test4pub67of100,1,191,10,149,1,160
test4sub1of100,test4pub67of100,1,191,10,150,2,162
test4sub60of100,test4pub67of100,1,191,10,151,1,162
test4sub96of100,test4pub67of100,1,191,10,157,1,168
test4sub21of100,test4pub67of100,1,191,10,158,2,170
test4sub8of100,test4pub67of100,1,191,10,159,1,170
test4sub89of100,test4pub67of100,1,191,10,162,1,173
test4sub24of100,test4pub67of100,1,191,10,162,2,174
test4sub49of100,test4pub67of100,1,191,10,161,7,178
test4sub33of100,test4pub67of100,1,191,10,164,4,178
test4sub47of100,test4pub67of100,1,191,10,165,3,178
test4sub6of100,test4pub67of100,1,191,10,166,8,184
test4sub68of100,test4pub67of100,1,191,10,165,11,186
test4sub16of100,test4pub67of100,1,191,10,166,11,187
test4sub48of100,test4pub67of100,1,191,10,168,9,187
test4sub99of100,test4pub67of100,1,191,10,169,9,188
test4sub87of100,test4pub67of100,1,191,10,169,8,187
test4sub11of100,test4pub67of100,1,191,10,171,7,188
test4sub19of100,test4pub67of100,1,191,10,172,7,189
test4sub53of100,test4pub67of100,1,191,10,173,7,190
test4sub28of100,test4pub67of100,1,191,10,175,5,190
test4sub36of100,test4pub67of100,1,191,10,175,5,190
test4sub90of100,test4pub67of100,1,191,10,304,1,315
test4sub88of100,test4pub67of100,1,191,10,321,1,332
test4sub93of100,test4pub67of100,1,191,10,330,2,342
test4sub92of100,test4pub67of100,1,191,10,330,2,342
test4sub65of100,test4pub67of100,1,191,10,344,1,355
test4sub98of100,test4pub67of100,1,191,10,348,1,359
test4sub70of100,test4pub67of100,1,191,10,354,0,364
test4sub44of100,test4pub67of100,1,191,10,356,1,367
test4sub46of100,test4pub67of100,1,191,10,368,1,379
test4sub40of100,test4pub67of100,1,191,10,373,0,383
test4sub9of100,test4pub67of100,1,191,10,396,1,407
test4sub12of100,test4pub68of100,1,191,12,4,1,17
test4sub50of100,test4pub68of100,1,191,12,10,2,24
test4sub82of100,test4pub68of100,1,191,12,13,1,26
test4sub51of100,test4pub68of100,1,191,12,12,2,26
test4sub61of100,test4pub68of100,1,191,12,17,2,31
test4sub35of100,test4pub68of100,1,191,12,18,3,33
test4sub84of100,test4pub68of100,1,191,12,19,2,33
test4sub90of100,test4pub68of100,1,191,12,22,0,34
test4sub77of100,test4pub68of100,1,191,12,26,1,39
test4sub45of100,test4pub68of100,1,191,12,33,1,46
test4sub83of100,test4pub68of100,1,191,12,32,2,46
test4sub85of100,test4pub68of100,1,191,12,38,2,52
test4sub28of100,test4pub68of100,1,191,12,36,3,51
test4sub42of100,test4pub68of100,1,191,12,41,2,55
test4sub36of100,test4pub68of100,1,191,12,41,10,63
test4sub78of100,test4pub68of100,1,191,12,41,12,65
test4sub86of100,test4pub68of100,1,191,12,43,10,65
test4sub4of100,test4pub68of100,1,191,12,44,9,65
test4sub58of100,test4pub68of100,1,191,12,44,10,66
test4sub89of100,test4pub68of100,1,191,12,45,10,67
test4sub43of100,test4pub68of100,1,191,12,47,8,67
test4sub1of100,test4pub68of100,1,191,12,47,10,69
test4sub27of100,test4pub68of100,1,191,12,39,19,70
test4sub20of100,test4pub68of100,1,191,12,46,14,72
test4sub68of100,test4pub68of100,1,191,12,49,11,72
test4sub63of100,test4pub68of100,1,191,12,50,10,72
test4sub39of100,test4pub68of100,1,191,12,50,11,73
test4sub100of100,test4pub68of100,1,191,12,51,11,74
test4sub41of100,test4pub68of100,1,191,12,57,7,76
test4sub26of100,test4pub68of100,1,191,12,64,1,77
test4sub46of100,test4pub68of100,1,191,12,76,8,96
test4sub94of100,test4pub68of100,1,191,12,77,8,97
test4sub71of100,test4pub68of100,1,191,12,77,9,98
test4sub10of100,test4pub68of100,1,191,12,82,5,99
test4sub62of100,test4pub68of100,1,191,12,78,11,101
test4sub55of100,test4pub68of100,1,191,12,79,11,102
test4sub59of100,test4pub68of100,1,191,12,81,9,102
test4sub97of100,test4pub68of100,1,191,12,83,10,105
test4sub98of100,test4pub68of100,1,191,12,84,9,105
test4sub22of100,test4pub68of100,1,191,12,75,22,109
test4sub96of100,test4pub68of100,1,191,12,86,13,111
test4sub95of100,test4pub68of100,1,191,12,88,12,112
test4sub75of100,test4pub68of100,1,191,12,89,13,114
test4sub16of100,test4pub68of100,1,191,12,92,9,113
test4sub57of100,test4pub68of100,1,191,12,94,9,115
test4sub92of100,test4pub68of100,1,191,12,95,9,116
test4sub74of100,test4pub68of100,1,191,12,96,7,115
test4sub69of100,test4pub68of100,1,191,12,99,5,116
test4sub8of100,test4pub68of100,1,191,12,104,2,118
test4sub32of100,test4pub68of100,1,191,12,108,2,122
test4sub70of100,test4pub68of100,1,191,12,112,1,125
test4sub25of100,test4pub68of100,1,191,12,115,2,129
test4sub79of100,test4pub68of100,1,191,12,116,2,130
test4sub31of100,test4pub68of100,1,191,12,118,6,136
test4sub29of100,test4pub68of100,1,191,12,119,7,138
test4sub76of100,test4pub68of100,1,191,12,120,5,137
test4sub18of100,test4pub68of100,1,191,12,120,5,137
test4sub81of100,test4pub68of100,1,191,12,121,6,139
test4sub13of100,test4pub68of100,1,191,12,122,7,141
test4sub15of100,test4pub68of100,1,191,12,122,7,141
test4sub3of100,test4pub68of100,1,191,12,123,7,142
test4sub40of100,test4pub68of100,1,191,12,123,8,143
test4sub37of100,test4pub68of100,1,191,12,127,4,143
test4sub7of100,test4pub68of100,1,191,12,128,11,151
test4sub33of100,test4pub68of100,1,191,12,129,11,152
test4sub91of100,test4pub68of100,1,191,12,133,15,160
test4sub49of100,test4pub68of100,1,191,12,135,15,162
test4sub72of100,test4pub68of100,1,191,12,135,22,169
test4sub67of100,test4pub68of100,1,191,12,136,22,170
test4sub93of100,test4pub68of100,1,191,12,136,22,170
test4sub24of100,test4pub68of100,1,191,12,137,22,171
test4sub87of100,test4pub68of100,1,191,12,137,22,171
test4sub47of100,test4pub68of100,1,191,12,138,21,171
test4sub56of100,test4pub68of100,1,191,12,138,21,171
test4sub65of100,test4pub68of100,1,191,12,141,20,173
test4sub64of100,test4pub68of100,1,191,12,142,20,174
test4sub19of100,test4pub68of100,1,191,12,143,19,174
test4sub14of100,test4pub68of100,1,191,12,144,20,176
test4sub44of100,test4pub68of100,1,191,12,145,19,176
test4sub48of100,test4pub68of100,1,191,12,146,18,176
test4sub11of100,test4pub68of100,1,191,12,147,17,176
test4sub60of100,test4pub68of100,1,191,12,148,17,177
test4sub9of100,test4pub68of100,1,191,12,196,4,212
test4sub17of100,test4pub68of100,1,191,12,198,3,213
test4sub2of100,test4pub68of100,1,191,12,199,3,214
test4sub6of100,test4pub68of100,1,191,12,196,6,214
test4sub53of100,test4pub68of100,1,191,12,199,2,213
test4sub5of100,test4pub68of100,1,191,12,199,4,215
test4sub54of100,test4pub68of100,1,191,12,194,8,214
test4sub66of100,test4pub68of100,1,191,12,197,7,216
test4sub88of100,test4pub68of100,1,191,12,328,2,342
test4sub30of100,test4pub68of100,1,191,12,330,1,343
test4sub73of100,test4pub68of100,1,191,12,327,1,340
test4sub34of100,test4pub68of100,1,191,12,342,1,355
test4sub23of100,test4pub68of100,1,191,12,347,0,359
test4sub99of100,test4pub68of100,1,191,12,346,1,359
test4sub21of100,test4pub68of100,1,191,12,358,1,371
test4sub52of100,test4pub68of100,1,191,12,362,1,375
test4sub80of100,test4pub68of100,1,191,12,363,2,377
test4sub38of100,test4pub68of100,1,191,12,406,2,420
test4sub4of100,test4pub69of100,1,191,16,8,1,25
test4sub71of100,test4pub69of100,1,191,16,10,1,27
test4sub7of100,test4pub69of100,1,191,16,18,0,34
test4sub57of100,test4pub69of100,1,191,16,20,1,37
test4sub60of100,test4pub69of100,1,191,16,26,1,43
test4sub13of100,test4pub69of100,1,191,16,30,1,47
test4sub62of100,test4pub69of100,1,191,16,30,2,48
test4sub52of100,test4pub69of100,1,191,16,35,1,52
test4sub85of100,test4pub69of100,1,191,16,35,1,52
test4sub63of100,test4pub69of100,1,191,16,35,2,53
test4sub87of100,test4pub69of100,1,191,16,43,1,60
test4sub31of100,test4pub69of100,1,191,16,46,1,63
test4sub26of100,test4pub69of100,1,191,16,50,1,67
test4sub83of100,test4pub69of100,1,191,16,53,1,70
test4sub18of100,test4pub69of100,1,191,16,59,1,76
test4sub56of100,test4pub69of100,1,191,16,61,1,78
test4sub15of100,test4pub69of100,1,191,16,64,1,81
test4sub16of100,test4pub69of100,1,191,16,66,1,83
test4sub98of100,test4pub69of100,1,191,16,64,3,83
test4sub75of100,test4pub69of100,1,191,16,65,2,83
test4sub14of100,test4pub69of100,1,191,16,62,6,84
test4sub46of100,test4pub69of100,1,191,16,69,1,86
test4sub58of100,test4pub69of100,1,191,16,73,2,91
test4sub11of100,test4pub69of100,1,191,16,75,2,93
test4sub47of100,test4pub69of100,1,191,16,75,1,92
test4sub51of100,test4pub69of100,1,191,16,74,3,93
test4sub65of100,test4pub69of100,1,191,16,77,1,94
test4sub89of100,test4pub69of100,1,191,16,81,0,97
test4sub28of100,test4pub69of100,1,191,16,80,2,98
test4sub80of100,test4pub69of100,1,191,16,84,6,106
test4sub8of100,test4pub69of100,1,191,16,86,4,106
test4sub48of100,test4pub69of100,1,191,16,84,7,107
test4sub74of100,test4pub69of100,1,191,16,88,4,108
test4sub84of100,test4pub69of100,1,191,16,88,4,108
test4sub41of100,test4pub69of100,1,191,16,82,10,108
test4sub49of100,test4pub69of100,1,191,16,85,9,110
test4sub50of100,test4pub69of100,1,191,16,85,9,110
test4sub37of100,test4pub69of100,1,191,16,86,8,110
test4sub10of100,test4pub69of100,1,191,16,87,7,110
test4sub45of100,test4pub69of100,1,191,16,89,7,112
test4sub77of100,test4pub69of100,1,191,16,88,7,111
test4sub54of100,test4pub69of100,1,191,16,94,7,117
test4sub32of100,test4pub69of100,1,191,16,97,6,119
test4sub72of100,test4pub69of100,1,191,16,98,4,118
test4sub55of100,test4pub69of100,1,191,16,95,7,118
test4sub12of100,test4pub69of100,1,191,16,100,2,118
test4sub30of100,test4pub69of100,1,191,16,99,4,119
test4sub79of100,test4pub69of100,1,191,16,93,10,119
test4sub67of100,test4pub69of100,1,191,16,126,2,144
test4sub96of100,test4pub69of100,1,191,16,124,3,143
test4sub92of100,test4pub69of100,1,191,16,125,3,144
test4sub86of100,test4pub69of100,1,191,16,127,1,144
test4sub76of100,test4pub69of100,1,191,16,135,2,153
test4sub73of100,test4pub69of100,1,191,16,135,7,158
test4sub22of100,test4pub69of100,1,191,16,133,10,159
test4sub3of100,test4pub69of100,1,191,16,136,7,159
test4sub91of100,test4pub69of100,1,191,16,139,6,161
test4sub42of100,test4pub69of100,1,191,16,140,7,163
test4sub53of100,test4pub69of100,1,191,16,141,6,163
test4sub34of100,test4pub69of100,1,191,16,142,7,165
test4sub24of100,test4pub69of100,1,191,16,144,5,165
test4sub1of100,test4pub69of100,1,191,16,146,2,164
test4sub68of100,test4pub69of100,1,191,16,151,8,175
test4sub27of100,test4pub69of100,1,191,16,152,8,176
test4sub6of100,test4pub69of100,1,191,16,154,8,178
test4sub95of100,test4pub69of100,1,191,16,155,8,179
test4sub100of100,test4pub69of100,1,191,16,156,8,180
test4sub17of100,test4pub69of100,1,191,16,158,6,180
test4sub38of100,test4pub69of100,1,191,16,159,7,182
test4sub5of100,test4pub69of100,1,191,16,162,4,182
test4sub25of100,test4pub69of100,1,191,16,169,6,191
test4sub23of100,test4pub69of100,1,191,16,169,6,191
test4sub9of100,test4pub69of100,1,191,16,170,6,192
test4sub43of100,test4pub69of100,1,191,16,171,5,192
test4sub19of100,test4pub69of100,1,191,16,179,16,211
test4sub64of100,test4pub69of100,1,191,16,178,18,212
test4sub40of100,test4pub69of100,1,191,16,178,20,214
test4sub20of100,test4pub69of100,1,191,16,182,5,203
test4sub21of100,test4pub69of100,1,191,16,177,27,220
test4sub36of100,test4pub69of100,1,191,16,174,30,220
test4sub99of100,test4pub69of100,1,191,16,173,32,221
test4sub33of100,test4pub69of100,1,191,16,181,27,224
test4sub69of100,test4pub69of100,1,191,16,200,9,225
test4sub35of100,test4pub69of100,1,191,16,201,9,226
test4sub90of100,test4pub69of100,1,191,16,202,8,226
test4sub66of100,test4pub69of100,1,191,16,202,9,227
test4sub88of100,test4pub69of100,1,191,16,200,12,228
test4sub94of100,test4pub69of100,1,191,16,203,14,233
test4sub81of100,test4pub69of100,1,191,16,203,15,234
test4sub29of100,test4pub69of100,1,191,16,204,15,235
test4sub59of100,test4pub69of100,1,191,16,204,14,234
test4sub78of100,test4pub69of100,1,191,16,204,15,235
test4sub93of100,test4pub69of100,1,191,16,205,14,235
test4sub2of100,test4pub69of100,1,191,16,206,14,236
test4sub70of100,test4pub69of100,1,191,16,206,15,237
test4sub44of100,test4pub69of100,1,191,16,205,15,236
test4sub97of100,test4pub69of100,1,191,16,376,175,567
test4sub50of100,test4pub70of100,1,191,16,70,3,89
test4sub93of100,test4pub70of100,1,191,16,69,6,91
test4sub5of100,test4pub70of100,1,191,16,68,7,91
test4sub64of100,test4pub70of100,1,191,16,68,7,91
test4sub54of100,test4pub70of100,1,191,16,67,7,90
test4sub16of100,test4pub70of100,1,191,16,66,8,90
test4sub61of100,test4pub69of100,1,191,16,324,234,574
test4sub82of100,test4pub69of100,1,191,16,325,234,575
test4sub39of100,test4pub69of100,1,191,16,374,189,579
test4sub88of100,test4pub70of100,1,191,16,69,15,100
test4sub75of100,test4pub70of100,1,191,16,10,15,41
test4sub65of100,test4pub70of100,1,191,16,66,16,98
test4sub35of100,test4pub70of100,1,191,16,66,16,98
test4sub22of100,test4pub70of100,1,191,16,63,15,94
test4sub6of100,test4pub70of100,1,191,16,62,16,94
test4sub72of100,test4pub70of100,1,191,16,62,17,95
test4sub9of100,test4pub70of100,1,191,16,61,16,93
test4sub63of100,test4pub70of100,1,191,16,61,17,94
test4sub68of100,test4pub70of100,1,191,16,53,16,85
test4sub96of100,test4pub70of100,1,191,16,48,16,80
test4sub77of100,test4pub70of100,1,191,16,75,25,116
test4sub86of100,test4pub70of100,1,191,16,47,25,88
test4sub73of100,test4pub70of100,1,191,16,44,26,86
test4sub52of100,test4pub70of100,1,191,16,41,25,82
test4sub32of100,test4pub70of100,1,191,16,41,25,82
test4sub11of100,test4pub70of100,1,191,16,40,26,82
test4sub7of100,test4pub70of100,1,191,16,35,25,76
test4sub29of100,test4pub70of100,1,191,16,30,26,72
test4sub47of100,test4pub70of100,1,191,16,29,26,71
test4sub48of100,test4pub70of100,1,191,16,27,26,69
test4sub92of100,test4pub70of100,1,191,16,24,26,66
test4sub2of100,test4pub70of100,1,191,16,22,27,65
test4sub27of100,test4pub70of100,1,191,16,21,26,63
test4sub38of100,test4pub70of100,1,191,16,17,27,60
test4sub17of100,test4pub70of100,1,191,16,15,26,57
test4sub55of100,test4pub70of100,1,191,16,11,27,54
test4sub1of100,test4pub70of100,1,191,16,67,27,110
test4sub85of100,test4pub70of100,1,191,16,48,29,93
test4sub70of100,test4pub70of100,1,191,16,83,29,128
test4sub21of100,test4pub70of100,1,191,16,85,35,136
test4sub94of100,test4pub70of100,1,191,16,86,34,136
test4sub39of100,test4pub70of100,1,191,16,86,35,137
test4sub10of100,test4pub70of100,1,191,16,110,12,138
test4sub79of100,test4pub70of100,1,191,16,110,18,144
test4sub44of100,test4pub70of100,1,191,16,111,18,145
test4sub81of100,test4pub70of100,1,191,16,114,17,147
test4sub62of100,test4pub70of100,1,191,16,115,17,148
test4sub30of100,test4pub70of100,1,191,16,115,25,156
test4sub14of100,test4pub70of100,1,191,16,116,25,157
test4sub87of100,test4pub70of100,1,191,16,117,25,158
test4sub67of100,test4pub70of100,1,191,16,118,24,158
test4sub95of100,test4pub70of100,1,191,16,119,25,160
test4sub99of100,test4pub70of100,1,191,16,119,25,160
test4sub66of100,test4pub70of100,1,191,16,119,25,160
test4sub46of100,test4pub70of100,1,191,16,123,26,165
test4sub36of100,test4pub70of100,1,191,16,124,25,165
test4sub25of100,test4pub70of100,1,191,16,124,26,166
test4sub41of100,test4pub70of100,1,191,16,125,25,166
test4sub33of100,test4pub70of100,1,191,16,126,24,166
test4sub57of100,test4pub70of100,1,191,16,127,25,168
test4sub18of100,test4pub70of100,1,191,16,127,25,168
test4sub89of100,test4pub70of100,1,191,16,126,25,167
test4sub78of100,test4pub70of100,1,191,16,128,24,168
test4sub12of100,test4pub70of100,1,191,16,128,25,169
test4sub84of100,test4pub70of100,1,191,16,131,23,170
test4sub83of100,test4pub70of100,1,191,16,133,21,170
test4sub31of100,test4pub70of100,1,191,16,134,21,171
test4sub40of100,test4pub70of100,1,191,16,134,21,171
test4sub49of100,test4pub70of100,1,191,16,135,29,180
test4sub61of100,test4pub70of100,1,191,16,135,30,181
test4sub74of100,test4pub70of100,1,191,16,136,30,182
test4sub19of100,test4pub70of100,1,191,16,135,30,181
test4sub100of100,test4pub70of100,1,191,16,138,30,184
test4sub71of100,test4pub70of100,1,191,16,138,30,184
test4sub28of100,test4pub70of100,1,191,16,139,29,184
test4sub76of100,test4pub70of100,1,191,16,139,30,185
test4sub98of100,test4pub70of100,1,191,16,139,29,184
test4sub97of100,test4pub70of100,1,191,16,140,30,186
test4sub56of100,test4pub70of100,1,191,16,322,1,339
test4sub51of100,test4pub70of100,1,191,16,330,1,347
test4sub45of100,test4pub70of100,1,191,16,335,1,352
test4sub37of100,test4pub70of100,1,191,16,339,1,356
test4sub82of100,test4pub70of100,1,191,16,348,1,365
test4sub58of100,test4pub70of100,1,191,16,346,4,366
test4sub90of100,test4pub70of100,1,191,16,345,7,368
test4sub4of100,test4pub70of100,1,191,16,343,10,369
test4sub45of100,test4pub71of100,1,191,22,10,3,35
test4sub13of100,test4pub70of100,1,191,16,352,3,371
test4sub34of100,test4pub70of100,1,191,16,352,2,370
test4sub9of100,test4pub71of100,1,191,22,19,1,42
test4sub60of100,test4pub70of100,1,191,16,370,2,388
test4sub91of100,test4pub70of100,1,191,16,370,4,390
test4sub82of100,test4pub71of100,1,191,22,30,4,56
test4sub74of100,test4pub71of100,1,191,22,32,3,57
test4sub43of100,test4pub70of100,1,191,16,373,5,394
test4sub26of100,test4pub70of100,1,191,16,368,10,394
test4sub42of100,test4pub70of100,1,191,16,369,10,395
test4sub3of100,test4pub70of100,1,191,16,366,13,395
test4sub80of100,test4pub70of100,1,191,16,375,4,395
test4sub6of100,test4pub71of100,1,191,22,37,2,61
test4sub61of100,test4pub71of100,1,191,22,40,1,63
test4sub20of100,test4pub70of100,1,191,16,384,2,402
test4sub15of100,test4pub70of100,1,191,16,385,1,402
test4sub8of100,test4pub70of100,1,191,16,394,1,411
test4sub92of100,test4pub71of100,1,191,22,56,3,81
test4sub1of100,test4pub71of100,1,191,22,54,6,82
test4sub73of100,test4pub71of100,1,191,22,55,5,82
test4sub18of100,test4pub71of100,1,191,22,58,4,84
test4sub52of100,test4pub71of100,1,191,22,57,5,84
test4sub53of100,test4pub70of100,1,191,16,400,4,420
test4sub41of100,test4pub71of100,1,191,22,62,2,86
test4sub31of100,test4pub71of100,1,191,22,61,3,86
test4sub90of100,test4pub71of100,1,191,22,63,1,86
test4sub23of100,test4pub70of100,1,191,16,415,0,431
test4sub66of100,test4pub71of100,1,191,22,75,1,98
test4sub69of100,test4pub70of100,1,191,16,414,3,433
test4sub86of100,test4pub71of100,1,191,22,85,1,108
test4sub51of100,test4pub71of100,1,191,22,94,0,116
test4sub3of100,test4pub71of100,1,191,22,94,1,117
test4sub77of100,test4pub71of100,1,191,22,100,1,123
test4sub84of100,test4pub71of100,1,191,22,100,2,124
test4sub46of100,test4pub71of100,1,191,22,101,1,124
test4sub30of100,test4pub71of100,1,191,22,101,3,126
test4sub24of100,test4pub70of100,1,191,16,445,2,463
test4sub59of100,test4pub70of100,1,191,16,445,2,463
test4sub28of100,test4pub71of100,1,191,22,105,2,129
test4sub38of100,test4pub71of100,1,191,22,106,1,129
test4sub57of100,test4pub71of100,1,191,22,107,1,130
test4sub68of100,test4pub71of100,1,191,22,113,1,136
test4sub19of100,test4pub71of100,1,191,22,115,1,138
test4sub36of100,test4pub71of100,1,191,22,116,3,141
test4sub47of100,test4pub71of100,1,191,22,118,2,142
test4sub100of100,test4pub71of100,1,191,22,117,9,148
test4sub33of100,test4pub71of100,1,191,22,118,8,148
test4sub97of100,test4pub71of100,1,191,22,118,8,148
test4sub64of100,test4pub71of100,1,191,22,120,8,150
test4sub34of100,test4pub71of100,1,191,22,120,10,152
test4sub26of100,test4pub71of100,1,191,22,122,9,153
test4sub55of100,test4pub71of100,1,191,22,123,9,154
test4sub50of100,test4pub71of100,1,191,22,123,10,155
test4sub98of100,test4pub71of100,1,191,22,123,11,156
test4sub71of100,test4pub71of100,1,191,22,124,12,158
test4sub95of100,test4pub71of100,1,191,22,125,11,158
test4sub12of100,test4pub71of100,1,191,22,127,11,160
test4sub58of100,test4pub71of100,1,191,22,128,10,160
test4sub20of100,test4pub71of100,1,191,22,128,10,160
test4sub60of100,test4pub71of100,1,191,22,130,9,161
test4sub42of100,test4pub71of100,1,191,22,130,11,163
test4sub91of100,test4pub71of100,1,191,22,134,9,165
test4sub88of100,test4pub71of100,1,191,22,134,9,165
test4sub78of100,test4pub71of100,1,191,22,136,9,167
test4sub5of100,test4pub71of100,1,191,22,138,6,166
test4sub29of100,test4pub71of100,1,191,22,140,5,167
test4sub25of100,test4pub71of100,1,191,22,139,5,166
test4sub48of100,test4pub71of100,1,191,22,141,4,167
test4sub53of100,test4pub71of100,1,191,22,142,3,167
test4sub49of100,test4pub71of100,1,191,22,142,4,168
test4sub93of100,test4pub71of100,1,191,22,143,4,169
test4sub32of100,test4pub71of100,1,191,22,147,3,172
test4sub79of100,test4pub71of100,1,191,22,148,4,174
test4sub13of100,test4pub71of100,1,191,22,148,4,174
test4sub10of100,test4pub71of100,1,191,22,149,3,174
test4sub72of100,test4pub71of100,1,191,22,150,3,175
test4sub65of100,test4pub71of100,1,191,22,151,2,175
test4sub24of100,test4pub71of100,1,191,22,158,1,181
test4sub59of100,test4pub71of100,1,191,22,159,1,182
test4sub7of100,test4pub71of100,1,191,22,310,1,333
test4sub37of100,test4pub71of100,1,191,22,313,1,336
test4sub2of100,test4pub71of100,1,191,22,322,1,345
test4sub80of100,test4pub71of100,1,191,22,324,0,346
test4sub94of100,test4pub71of100,1,191,22,326,2,350
test4sub4of100,test4pub71of100,1,191,22,327,1,350
test4sub17of100,test4pub71of100,1,191,22,336,1,359
test4sub43of100,test4pub71of100,1,191,22,341,1,364
test4sub99of100,test4pub71of100,1,191,22,345,0,367
test4sub40of100,test4pub71of100,1,191,22,350,1,373
test4sub16of100,test4pub71of100,1,191,22,350,1,373
test4sub11of100,test4pub71of100,1,191,22,355,1,378
test4sub15of100,test4pub71of100,1,191,22,362,1,385
test4sub14of100,test4pub71of100,1,191,22,362,2,386
test4sub54of100,test4pub71of100,1,191,22,364,0,386
test4sub96of100,test4pub71of100,1,191,22,363,2,387
test4sub35of100,test4pub71of100,1,191,22,374,1,397
test4sub39of100,test4pub71of100,1,191,22,375,1,398
test4sub56of100,test4pub71of100,1,191,22,383,1,406
test4sub76of100,test4pub71of100,1,191,22,385,1,408
test4sub85of100,test4pub71of100,1,191,22,386,1,409
test4sub8of100,test4pub71of100,1,191,22,387,1,410
test4sub22of100,test4pub71of100,1,191,22,396,0,418
test4sub89of100,test4pub71of100,1,191,22,396,1,419
test4sub62of100,test4pub71of100,1,191,22,397,2,421
test4sub75of100,test4pub71of100,1,191,22,399,1,422
test4sub27of100,test4pub71of100,1,191,22,403,1,426
test4sub67of100,test4pub71of100,1,191,22,405,1,428
test4sub83of100,test4pub71of100,1,191,22,406,1,429
test4sub21of100,test4pub71of100,1,191,22,407,1,430
test4sub44of100,test4pub71of100,1,191,22,424,1,447
test4sub63of100,test4pub71of100,1,191,22,425,1,448
test4sub87of100,test4pub71of100,1,191,22,428,1,451
test4sub70of100,test4pub71of100,1,191,22,428,1,451
test4sub81of100,test4pub71of100,1,191,22,429,1,452
test4sub5of100,test4pub72of100,1,191,13,5,1,19
test4sub94of100,test4pub72of100,1,191,13,14,1,28
test4sub58of100,test4pub72of100,1,191,13,17,0,30
test4sub93of100,test4pub72of100,1,191,13,20,1,34
test4sub53of100,test4pub72of100,1,191,13,22,1,36
test4sub34of100,test4pub72of100,1,191,13,27,1,41
test4sub90of100,test4pub72of100,1,191,13,32,1,46
test4sub63of100,test4pub72of100,1,191,13,33,1,47
test4sub51of100,test4pub72of100,1,191,13,35,0,48
test4sub78of100,test4pub72of100,1,191,13,42,1,56
test4sub2of100,test4pub72of100,1,191,13,43,1,57
test4sub9of100,test4pub72of100,1,191,13,45,0,58
test4sub11of100,test4pub72of100,1,191,13,47,1,61
test4sub81of100,test4pub72of100,1,191,13,48,4,65
test4sub82of100,test4pub72of100,1,191,13,49,3,65
test4sub86of100,test4pub72of100,1,191,13,50,3,66
test4sub66of100,test4pub72of100,1,191,13,51,3,67
test4sub36of100,test4pub72of100,1,191,13,52,2,67
test4sub50of100,test4pub72of100,1,191,13,59,0,72
test4sub40of100,test4pub72of100,1,191,13,75,0,88
test4sub44of100,test4pub72of100,1,191,13,79,2,94
test4sub99of100,test4pub72of100,1,191,13,79,2,94
test4sub13of100,test4pub72of100,1,191,13,80,2,95
test4sub95of100,test4pub72of100,1,191,13,81,3,97
test4sub91of100,test4pub72of100,1,191,13,82,1,96
test4sub25of100,test4pub72of100,1,191,13,84,0,97
test4sub45of100,test4pub72of100,1,191,13,90,2,105
test4sub52of100,test4pub72of100,1,191,13,91,2,106
test4sub74of100,test4pub72of100,1,191,13,94,1,108
test4sub41of100,test4pub72of100,1,191,13,94,1,108
test4sub28of100,test4pub72of100,1,191,13,97,1,111
test4sub67of100,test4pub72of100,1,191,13,99,4,116
test4sub24of100,test4pub72of100,1,191,13,99,4,116
test4sub29of100,test4pub72of100,1,191,13,99,5,117
test4sub57of100,test4pub72of100,1,191,13,100,4,117
test4sub31of100,test4pub72of100,1,191,13,97,8,118
test4sub77of100,test4pub72of100,1,191,13,98,7,118
test4sub61of100,test4pub72of100,1,191,13,101,5,119
test4sub65of100,test4pub72of100,1,191,13,102,4,119
test4sub12of100,test4pub72of100,1,191,13,104,3,120
test4sub83of100,test4pub72of100,1,191,13,107,3,123
test4sub39of100,test4pub72of100,1,191,13,109,2,124
test4sub47of100,test4pub72of100,1,191,13,110,2,125
test4sub85of100,test4pub72of100,1,191,13,111,1,125
test4sub10of100,test4pub72of100,1,191,13,114,0,127
test4sub84of100,test4pub72of100,1,191,13,117,0,130
test4sub88of100,test4pub72of100,1,191,13,117,1,131
test4sub1of100,test4pub72of100,1,191,13,117,1,131
test4sub27of100,test4pub72of100,1,191,13,127,1,141
test4sub54of100,test4pub72of100,1,191,13,152,1,166
test4sub48of100,test4pub72of100,1,191,13,153,1,167
test4sub100of100,test4pub72of100,1,191,13,157,1,171
test4sub33of100,test4pub72of100,1,191,13,158,1,172
test4sub43of100,test4pub72of100,1,191,13,161,1,175
test4sub3of100,test4pub72of100,1,191,13,161,1,175
test4sub68of100,test4pub72of100,1,191,13,166,1,180
test4sub16of100,test4pub72of100,1,191,13,171,0,184
test4sub15of100,test4pub72of100,1,191,13,172,0,185
test4sub46of100,test4pub72of100,1,191,13,174,0,187
test4sub32of100,test4pub72of100,1,191,13,176,1,190
test4sub62of100,test4pub72of100,1,191,13,176,1,190
test4sub38of100,test4pub72of100,1,191,13,182,2,197
test4sub97of100,test4pub72of100,1,191,13,183,1,197
test4sub20of100,test4pub72of100,1,191,13,183,2,198
test4sub98of100,test4pub72of100,1,191,13,184,1,198
test4sub71of100,test4pub72of100,1,191,13,188,3,204
test4sub59of100,test4pub72of100,1,191,13,188,11,212
test4sub56of100,test4pub72of100,1,191,13,189,14,216
test4sub96of100,test4pub72of100,1,191,13,189,14,216
test4sub49of100,test4pub72of100,1,191,13,190,14,217
test4sub73of100,test4pub72of100,1,191,13,191,13,217
test4sub42of100,test4pub72of100,1,191,13,192,13,218
test4sub26of100,test4pub72of100,1,191,13,193,14,220
test4sub22of100,test4pub72of100,1,191,13,193,14,220
test4sub19of100,test4pub72of100,1,191,13,193,14,220
test4sub80of100,test4pub72of100,1,191,13,194,14,221
test4sub89of100,test4pub72of100,1,191,13,195,14,222
test4sub18of100,test4pub72of100,1,191,13,195,15,223
test4sub7of100,test4pub72of100,1,191,13,196,15,224
test4sub76of100,test4pub72of100,1,191,13,197,15,225
test4sub55of100,test4pub72of100,1,191,13,198,14,225
test4sub70of100,test4pub72of100,1,191,13,200,13,226
test4sub72of100,test4pub72of100,1,191,13,200,13,226
test4sub21of100,test4pub72of100,1,191,13,200,14,227
test4sub87of100,test4pub72of100,1,191,13,201,13,227
test4sub14of100,test4pub72of100,1,191,13,226,5,244
test4sub60of100,test4pub72of100,1,191,13,227,4,244
test4sub8of100,test4pub72of100,1,191,13,227,5,245
test4sub75of100,test4pub72of100,1,191,13,228,5,246
test4sub17of100,test4pub72of100,1,191,13,229,5,247
test4sub35of100,test4pub72of100,1,191,13,228,5,246
test4sub6of100,test4pub72of100,1,191,13,230,4,247
test4sub64of100,test4pub72of100,1,191,13,232,2,247
test4sub4of100,test4pub72of100,1,191,13,360,1,374
test4sub37of100,test4pub72of100,1,191,13,365,1,379
test4sub30of100,test4pub72of100,1,191,13,369,1,383
test4sub92of100,test4pub72of100,1,191,13,373,1,387
test4sub79of100,test4pub72of100,1,191,13,378,1,392
test4sub23of100,test4pub71of100,1,191,22,949,0,971
test4sub23of100,test4pub72of100,1,191,13,402,1,416
test4sub69of100,test4pub71of100,1,191,22,954,0,976
test4sub69of100,test4pub72of100,1,191,13,407,5,425
test4sub20of100,test4pub73of100,1,191,17,6,1,24
test4sub67of100,test4pub73of100,1,191,17,7,1,25
test4sub48of100,test4pub73of100,1,191,17,14,1,32
test4sub37of100,test4pub73of100,1,191,17,15,1,33
test4sub13of100,test4pub73of100,1,191,17,18,1,36
test4sub42of100,test4pub73of100,1,191,17,24,2,43
test4sub26of100,test4pub73of100,1,191,17,23,3,43
test4sub64of100,test4pub73of100,1,191,17,25,2,44
test4sub34of100,test4pub73of100,1,191,17,26,1,44
test4sub17of100,test4pub73of100,1,191,17,33,0,50
test4sub54of100,test4pub73of100,1,191,17,33,2,52
test4sub72of100,test4pub73of100,1,191,17,35,1,53
test4sub79of100,test4pub73of100,1,191,17,38,1,56
test4sub33of100,test4pub73of100,1,191,17,43,1,61
test4sub63of100,test4pub73of100,1,191,17,43,2,62
test4sub39of100,test4pub73of100,1,191,17,46,3,66
test4sub51of100,test4pub73of100,1,191,17,46,4,67
test4sub43of100,test4pub73of100,1,191,17,47,4,68
test4sub29of100,test4pub73of100,1,191,17,47,7,71
test4sub40of100,test4pub73of100,1,191,17,47,7,71
test4sub41of100,test4pub73of100,1,191,17,48,7,72
test4sub2of100,test4pub73of100,1,191,17,51,4,72
test4sub70of100,test4pub73of100,1,191,17,51,5,73
test4sub30of100,test4pub73of100,1,191,17,52,4,73
test4sub45of100,test4pub73of100,1,191,17,53,5,75
test4sub3of100,test4pub73of100,1,191,17,61,1,79
test4sub46of100,test4pub73of100,1,191,17,63,1,81
test4sub75of100,test4pub73of100,1,191,17,67,2,86
test4sub61of100,test4pub73of100,1,191,17,68,2,87
test4sub49of100,test4pub73of100,1,191,17,68,4,89
test4sub92of100,test4pub73of100,1,191,17,70,3,90
test4sub57of100,test4pub73of100,1,191,17,73,2,92
test4sub85of100,test4pub73of100,1,191,17,76,2,95
test4sub58of100,test4pub73of100,1,191,17,76,3,96
test4sub86of100,test4pub73of100,1,191,17,76,4,97
test4sub7of100,test4pub73of100,1,191,17,81,3,101
test4sub53of100,test4pub73of100,1,191,17,99,0,116
test4sub71of100,test4pub73of100,1,191,17,100,0,117
test4sub38of100,test4pub73of100,1,191,17,104,1,122
test4sub65of100,test4pub73of100,1,191,17,106,2,125
test4sub74of100,test4pub73of100,1,191,17,107,2,126
test4sub36of100,test4pub73of100,1,191,17,108,2,127
test4sub50of100,test4pub73of100,1,191,17,115,1,133
test4sub76of100,test4pub73of100,1,191,17,127,1,145
test4sub62of100,test4pub73of100,1,191,17,131,1,149
test4sub89of100,test4pub73of100,1,191,17,131,2,150
test4sub93of100,test4pub73of100,1,191,17,132,4,153
test4sub91of100,test4pub73of100,1,191,17,133,5,155
test4sub6of100,test4pub73of100,1,191,17,134,5,156
test4sub96of100,test4pub73of100,1,191,17,135,6,158
test4sub80of100,test4pub73of100,1,191,17,136,8,161
test4sub68of100,test4pub73of100,1,191,17,139,7,163
test4sub78of100,test4pub73of100,1,191,17,139,7,163
test4sub4of100,test4pub73of100,1,191,17,141,7,165
test4sub97of100,test4pub73of100,1,191,17,141,6,164
test4sub52of100,test4pub73of100,1,191,17,143,5,165
test4sub95of100,test4pub73of100,1,191,17,144,5,166
test4sub19of100,test4pub73of100,1,191,17,145,7,169
test4sub59of100,test4pub73of100,1,191,17,145,7,169
test4sub94of100,test4pub73of100,1,191,17,146,6,169
test4sub1of100,test4pub73of100,1,191,17,148,7,172
test4sub31of100,test4pub73of100,1,191,17,149,6,172
test4sub87of100,test4pub73of100,1,191,17,150,7,174
test4sub83of100,test4pub73of100,1,191,17,151,6,174
test4sub10of100,test4pub73of100,1,191,17,151,6,174
test4sub99of100,test4pub73of100,1,191,17,153,4,174
test4sub16of100,test4pub73of100,1,191,17,154,3,174
test4sub28of100,test4pub73of100,1,191,17,154,4,175
test4sub5of100,test4pub73of100,1,191,17,155,4,176
test4sub66of100,test4pub73of100,1,191,17,155,4,176
test4sub56of100,test4pub73of100,1,191,17,340,1,358
test4sub12of100,test4pub73of100,1,191,17,344,1,362
test4sub90of100,test4pub73of100,1,191,17,348,1,366
test4sub32of100,test4pub73of100,1,191,17,358,0,375
test4sub27of100,test4pub73of100,1,191,17,359,1,377
test4sub47of100,test4pub73of100,1,191,17,360,1,378
test4sub9of100,test4pub73of100,1,191,17,361,1,379
test4sub11of100,test4pub73of100,1,191,17,363,1,381
test4sub82of100,test4pub73of100,1,191,17,363,1,381
test4sub35of100,test4pub73of100,1,191,17,365,2,384
test4sub73of100,test4pub73of100,1,191,17,366,1,384
test4sub57of100,test4pub74of100,1,191,11,20,1,32
test4sub69of100,test4pub73of100,1,191,17,373,1,391
test4sub54of100,test4pub74of100,1,191,11,32,1,44
test4sub51of100,test4pub74of100,1,191,11,38,1,50
test4sub48of100,test4pub74of100,1,191,11,40,2,53
test4sub44of100,test4pub73of100,1,191,17,393,2,412
test4sub79of100,test4pub74of100,1,191,11,41,1,53
test4sub14of100,test4pub73of100,1,191,17,394,1,412
test4sub60of100,test4pub73of100,1,191,17,408,0,425
test4sub88of100,test4pub73of100,1,191,17,408,1,426
test4sub46of100,test4pub74of100,1,191,11,63,2,76
test4sub66of100,test4pub74of100,1,191,11,64,2,77
test4sub98of100,test4pub73of100,1,191,17,418,1,436
test4sub77of100,test4pub73of100,1,191,17,426,3,446
test4sub8of100,test4pub73of100,1,191,17,427,5,449
test4sub23of100,test4pub73of100,1,191,17,427,5,449
test4sub86of100,test4pub74of100,1,191,11,75,5,91
test4sub75of100,test4pub74of100,1,191,11,76,5,92
test4sub24of100,test4pub73of100,1,191,17,429,5,451
test4sub81of100,test4pub73of100,1,191,17,430,4,451
test4sub84of100,test4pub73of100,1,191,17,433,2,452
test4sub92of100,test4pub74of100,1,191,11,87,1,99
test4sub36of100,test4pub74of100,1,191,11,90,1,102
test4sub85of100,test4pub74of100,1,191,11,90,2,103
test4sub6of100,test4pub74of100,1,191,11,91,2,104
test4sub43of100,test4pub74of100,1,191,11,93,1,105
test4sub22of100,test4pub73of100,1,191,17,449,2,468
test4sub55of100,test4pub73of100,1,191,17,449,2,468
test4sub25of100,test4pub73of100,1,191,17,450,2,469
test4sub29of100,test4pub74of100,1,191,11,122,0,133
test4sub26of100,test4pub74of100,1,191,11,123,0,134
test4sub37of100,test4pub74of100,1,191,11,124,1,136
test4sub100of100,test4pub73of100,1,191,17,484,1,502
test4sub21of100,test4pub73of100,1,191,17,486,0,503
test4sub15of100,test4pub73of100,1,191,17,490,0,507
test4sub5of100,test4pub74of100,1,191,11,143,2,156
test4sub83of100,test4pub74of100,1,191,11,144,2,157
test4sub32of100,test4pub74of100,1,191,11,145,2,158
test4sub59of100,test4pub74of100,1,191,11,143,4,158
test4sub76of100,test4pub74of100,1,191,11,144,3,158
test4sub94of100,test4pub74of100,1,191,11,146,3,160
test4sub12of100,test4pub74of100,1,191,11,150,1,162
test4sub18of100,test4pub73of100,1,191,17,504,2,523
test4sub3of100,test4pub74of100,1,191,11,152,1,164
test4sub65of100,test4pub74of100,1,191,11,152,2,165
test4sub11of100,test4pub74of100,1,191,11,155,1,167
test4sub1of100,test4pub74of100,1,191,11,156,2,169
test4sub91of100,test4pub74of100,1,191,11,157,1,169
test4sub61of100,test4pub74of100,1,191,11,163,1,175
test4sub58of100,test4pub74of100,1,191,11,165,0,176
test4sub35of100,test4pub74of100,1,191,11,166,0,177
test4sub78of100,test4pub74of100,1,191,11,172,0,183
test4sub90of100,test4pub74of100,1,191,11,172,1,184
test4sub52of100,test4pub74of100,1,191,11,187,0,198
test4sub97of100,test4pub74of100,1,191,11,190,2,203
test4sub63of100,test4pub74of100,1,191,11,190,2,203
test4sub60of100,test4pub74of100,1,191,11,191,3,205
test4sub93of100,test4pub74of100,1,191,11,192,2,205
test4sub20of100,test4pub74of100,1,191,11,193,4,208
test4sub9of100,test4pub74of100,1,191,11,194,1,206
test4sub31of100,test4pub74of100,1,191,11,194,2,207
test4sub69of100,test4pub74of100,1,191,11,195,2,208
test4sub56of100,test4pub74of100,1,191,11,197,1,209
test4sub99of100,test4pub74of100,1,191,11,218,1,230
test4sub39of100,test4pub74of100,1,191,11,219,2,232
test4sub49of100,test4pub74of100,1,191,11,220,3,234
test4sub47of100,test4pub74of100,1,191,11,221,7,239
test4sub98of100,test4pub74of100,1,191,11,222,6,239
test4sub64of100,test4pub74of100,1,191,11,223,6,240
test4sub19of100,test4pub74of100,1,191,11,222,6,239
test4sub40of100,test4pub74of100,1,191,11,224,8,243
test4sub34of100,test4pub74of100,1,191,11,225,8,244
test4sub88of100,test4pub74of100,1,191,11,226,7,244
test4sub77of100,test4pub74of100,1,191,11,227,7,245
test4sub95of100,test4pub74of100,1,191,11,225,9,245
test4sub96of100,test4pub74of100,1,191,11,226,9,246
test4sub17of100,test4pub74of100,1,191,11,227,8,246
test4sub70of100,test4pub74of100,1,191,11,230,7,248
test4sub23of100,test4pub74of100,1,191,11,231,6,248
test4sub10of100,test4pub74of100,1,191,11,232,4,247
test4sub89of100,test4pub74of100,1,191,11,234,2,247
test4sub72of100,test4pub74of100,1,191,11,240,1,252
test4sub16of100,test4pub74of100,1,191,11,246,1,258
test4sub28of100,test4pub74of100,1,191,11,247,0,258
test4sub24of100,test4pub74of100,1,191,11,250,2,263
test4sub38of100,test4pub74of100,1,191,11,251,2,264
test4sub81of100,test4pub74of100,1,191,11,251,1,263
test4sub44of100,test4pub74of100,1,191,11,274,1,286
test4sub84of100,test4pub74of100,1,191,11,276,0,287
test4sub30of100,test4pub74of100,1,191,11,277,2,290
test4sub50of100,test4pub74of100,1,191,11,278,1,290
test4sub62of100,test4pub74of100,1,191,11,280,4,295
test4sub71of100,test4pub74of100,1,191,11,280,5,296
test4sub8of100,test4pub74of100,1,191,11,281,5,297
test4sub67of100,test4pub74of100,1,191,11,282,6,299
test4sub80of100,test4pub74of100,1,191,11,282,10,303
test4sub42of100,test4pub74of100,1,191,11,283,8,302
test4sub4of100,test4pub74of100,1,191,11,283,11,305
test4sub87of100,test4pub74of100,1,191,11,284,10,305
test4sub22of100,test4pub74of100,1,191,11,285,10,306
test4sub25of100,test4pub74of100,1,191,11,286,10,307
test4sub55of100,test4pub74of100,1,191,11,286,11,308
test4sub2of100,test4pub74of100,1,191,11,288,9,308
test4sub14of100,test4pub74of100,1,191,11,288,9,308
test4sub45of100,test4pub74of100,1,191,11,289,9,309
test4sub73of100,test4pub74of100,1,191,11,289,8,308
test4sub41of100,test4pub74of100,1,191,11,290,9,310
test4sub68of100,test4pub74of100,1,191,11,290,8,309
test4sub27of100,test4pub74of100,1,191,11,290,8,309
test4sub82of100,test4pub74of100,1,191,11,293,7,311
test4sub18of100,test4pub74of100,1,191,11,293,7,311
test4sub15of100,test4pub74of100,1,191,11,294,6,311
test4sub7of100,test4pub74of100,1,191,11,369,1,381
test4sub13of100,test4pub74of100,1,191,11,370,0,381
test4sub74of100,test4pub74of100,1,191,11,383,1,395
test4sub33of100,test4pub74of100,1,191,11,391,1,403
test4sub53of100,test4pub74of100,1,191,11,393,1,405
test4sub100of100,test4pub74of100,1,191,11,439,1,451
test4sub21of100,test4pub74of100,1,191,11,439,1,451
test4sub11of100,test4pub75of100,1,191,10,13,0,23
test4sub46of100,test4pub75of100,1,191,10,18,1,29
test4sub67of100,test4pub75of100,1,191,10,18,0,28
test4sub9of100,test4pub75of100,1,191,10,21,0,31
test4sub82of100,test4pub75of100,1,191,10,22,1,33
test4sub68of100,test4pub75of100,1,191,10,30,1,41
test4sub98of100,test4pub75of100,1,191,10,33,1,44
test4sub16of100,test4pub75of100,1,191,10,38,2,50
test4sub3of100,test4pub75of100,1,191,10,39,3,52
test4sub59of100,test4pub75of100,1,191,10,40,5,55
test4sub36of100,test4pub75of100,1,191,10,40,5,55
test4sub32of100,test4pub75of100,1,191,10,41,4,55
test4sub45of100,test4pub75of100,1,191,10,43,3,56
test4sub70of100,test4pub75of100,1,191,10,57,1,68
test4sub47of100,test4pub75of100,1,191,10,59,2,71
test4sub69of100,test4pub75of100,1,191,10,60,1,71
test4sub72of100,test4pub75of100,1,191,10,65,1,76
test4sub23of100,test4pub75of100,1,191,10,67,1,78
test4sub87of100,test4pub75of100,1,191,10,76,1,87
test4sub40of100,test4pub75of100,1,191,10,78,1,89
test4sub58of100,test4pub75of100,1,191,10,79,1,90
test4sub95of100,test4pub75of100,1,191,10,82,3,95
test4sub30of100,test4pub75of100,1,191,10,84,3,97
test4sub65of100,test4pub75of100,1,191,10,85,3,98
test4sub54of100,test4pub75of100,1,191,10,85,4,99
test4sub81of100,test4pub75of100,1,191,10,90,1,101
test4sub86of100,test4pub75of100,1,191,10,94,1,105
test4sub29of100,test4pub75of100,1,191,10,95,2,107
test4sub63of100,test4pub75of100,1,191,10,96,1,107
test4sub15of100,test4pub75of100,1,191,10,96,3,109
test4sub88of100,test4pub75of100,1,191,10,98,1,109
test4sub66of100,test4pub75of100,1,191,10,98,1,109
test4sub12of100,test4pub75of100,1,191,10,101,1,112
test4sub85of100,test4pub75of100,1,191,10,104,1,115
test4sub8of100,test4pub75of100,1,191,10,105,1,116
test4sub93of100,test4pub75of100,1,191,10,106,1,117
test4sub33of100,test4pub75of100,1,191,10,109,1,120
test4sub28of100,test4pub75of100,1,191,10,108,1,119
test4sub76of100,test4pub75of100,1,191,10,117,2,129
test4sub10of100,test4pub75of100,1,191,10,116,3,129
test4sub84of100,test4pub75of100,1,191,10,118,3,131
test4sub24of100,test4pub75of100,1,191,10,118,3,131
test4sub25of100,test4pub75of100,1,191,10,119,2,131
test4sub22of100,test4pub75of100,1,191,10,120,1,131
test4sub79of100,test4pub75of100,1,191,10,125,1,136
test4sub4of100,test4pub75of100,1,191,10,125,1,136
test4sub35of100,test4pub75of100,1,191,10,131,1,142
test4sub94of100,test4pub75of100,1,191,10,132,1,143
test4sub61of100,test4pub75of100,1,191,10,135,1,146
test4sub60of100,test4pub75of100,1,191,10,135,1,146
test4sub78of100,test4pub75of100,1,191,10,137,1,148
test4sub71of100,test4pub75of100,1,191,10,175,1,186
test4sub75of100,test4pub75of100,1,191,10,176,1,187
test4sub80of100,test4pub75of100,1,191,10,177,2,189
test4sub52of100,test4pub75of100,1,191,10,177,3,190
test4sub14of100,test4pub75of100,1,191,10,178,1,189
test4sub17of100,test4pub75of100,1,191,10,186,1,197
test4sub91of100,test4pub75of100,1,191,10,189,1,200
test4sub1of100,test4pub75of100,1,191,10,189,1,200
test4sub74of100,test4pub75of100,1,191,10,190,1,201
test4sub92of100,test4pub75of100,1,191,10,195,0,205
test4sub62of100,test4pub75of100,1,191,10,197,1,208
test4sub6of100,test4pub75of100,1,191,10,197,1,208
test4sub21of100,test4pub75of100,1,191,10,198,5,213
test4sub100of100,test4pub75of100,1,191,10,199,3,212
test4sub2of100,test4pub75of100,1,191,10,200,3,213
test4sub77of100,test4pub75of100,1,191,10,200,3,213
test4sub5of100,test4pub75of100,1,191,10,201,2,213
test4sub83of100,test4pub75of100,1,191,10,201,3,214
test4sub55of100,test4pub75of100,1,191,10,210,1,221
test4sub18of100,test4pub75of100,1,191,10,221,1,232
test4sub31of100,test4pub75of100,1,191,10,222,2,234
test4sub42of100,test4pub75of100,1,191,10,223,5,238
test4sub43of100,test4pub75of100,1,191,10,225,4,239
test4sub73of100,test4pub75of100,1,191,10,225,5,240
test4sub20of100,test4pub75of100,1,191,10,226,5,241
test4sub48of100,test4pub75of100,1,191,10,226,5,241
test4sub38of100,test4pub75of100,1,191,10,227,4,241
test4sub97of100,test4pub75of100,1,191,10,224,7,241
test4sub39of100,test4pub75of100,1,191,10,228,3,241
test4sub13of100,test4pub75of100,1,191,10,229,3,242
test4sub99of100,test4pub75of100,1,191,10,237,1,248
test4sub89of100,test4pub75of100,1,191,10,238,0,248
test4sub44of100,test4pub75of100,1,191,10,242,0,252
test4sub51of100,test4pub75of100,1,191,10,256,1,267
test4sub56of100,test4pub75of100,1,191,10,262,1,273
test4sub41of100,test4pub75of100,1,191,10,263,1,274
test4sub64of100,test4pub75of100,1,191,10,271,1,282
test4sub37of100,test4pub75of100,1,191,10,272,0,282
test4sub53of100,test4pub75of100,1,191,10,273,2,285
test4sub26of100,test4pub75of100,1,191,10,274,1,285
test4sub34of100,test4pub75of100,1,191,10,274,1,285
test4sub96of100,test4pub75of100,1,191,10,280,1,291
test4sub27of100,test4pub75of100,1,191,10,281,2,293
test4sub50of100,test4pub75of100,1,191,10,282,2,294
test4sub19of100,test4pub75of100,1,191,10,282,2,294
test4sub57of100,test4pub75of100,1,191,10,283,2,295
test4sub49of100,test4pub75of100,1,191,10,285,1,296
test4sub90of100,test4pub75of100,1,191,10,288,0,298
test4sub7of100,test4pub75of100,1,191,10,311,1,322
test4sub10of100,test4pub76of100,1,191,13,7,1,21
test4sub80of100,test4pub76of100,1,191,13,8,1,22
test4sub92of100,test4pub76of100,1,191,13,13,0,26
test4sub69of100,test4pub76of100,1,191,13,34,0,47
test4sub82of100,test4pub76of100,1,191,13,36,13,62
test4sub94of100,test4pub76of100,1,191,13,36,14,63
test4sub81of100,test4pub76of100,1,191,13,45,7,65
test4sub23of100,test4pub76of100,1,191,13,46,8,67
test4sub12of100,test4pub76of100,1,191,13,46,8,67
test4sub93of100,test4pub76of100,1,191,13,37,7,57
test4sub74of100,test4pub76of100,1,191,13,50,4,67
test4sub83of100,test4pub76of100,1,191,13,50,5,68
test4sub30of100,test4pub76of100,1,191,13,45,10,68
test4sub76of100,test4pub76of100,1,191,13,47,10,70
test4sub37of100,test4pub76of100,1,191,13,48,8,69
test4sub86of100,test4pub76of100,1,191,13,49,8,70
test4sub3of100,test4pub76of100,1,191,13,51,5,69
test4sub59of100,test4pub76of100,1,191,13,53,5,71
test4sub9of100,test4pub76of100,1,191,13,77,1,91
test4sub62of100,test4pub76of100,1,191,13,79,1,93
test4sub43of100,test4pub76of100,1,191,13,81,1,95
test4sub95of100,test4pub76of100,1,191,13,80,5,98
test4sub71of100,test4pub76of100,1,191,13,85,3,101
test4sub70of100,test4pub76of100,1,191,13,87,1,101
test4sub97of100,test4pub76of100,1,191,13,103,2,118
test4sub52of100,test4pub76of100,1,191,13,104,2,119
test4sub89of100,test4pub76of100,1,191,13,105,1,119
test4sub60of100,test4pub76of100,1,191,13,108,1,122
test4sub51of100,test4pub76of100,1,191,13,108,2,123
test4sub22of100,test4pub76of100,1,191,13,109,2,124
test4sub84of100,test4pub76of100,1,191,13,110,1,124
test4sub47of100,test4pub76of100,1,191,13,114,1,128
test4sub78of100,test4pub76of100,1,191,13,119,1,133
test4sub55of100,test4pub76of100,1,191,13,120,11,144
test4sub54of100,test4pub76of100,1,191,13,121,11,145
test4sub7of100,test4pub76of100,1,191,13,121,11,145
test4sub31of100,test4pub76of100,1,191,13,122,11,146
test4sub72of100,test4pub76of100,1,191,13,123,10,146
test4sub1of100,test4pub76of100,1,191,13,124,9,146
test4sub14of100,test4pub76of100,1,191,13,125,10,148
test4sub36of100,test4pub76of100,1,191,13,124,10,147
test4sub53of100,test4pub76of100,1,191,13,126,9,148
test4sub73of100,test4pub76of100,1,191,13,125,10,148
test4sub4of100,test4pub76of100,1,191,13,127,9,149
test4sub49of100,test4pub76of100,1,191,13,127,9,149
test4sub90of100,test4pub76of100,1,191,13,128,11,152
test4sub44of100,test4pub76of100,1,191,13,129,10,152
test4sub99of100,test4pub76of100,1,191,13,129,10,152
test4sub17of100,test4pub76of100,1,191,13,128,10,151
test4sub2of100,test4pub76of100,1,191,13,130,10,153
test4sub58of100,test4pub76of100,1,191,13,130,10,153
test4sub77of100,test4pub76of100,1,191,13,131,10,154
test4sub24of100,test4pub76of100,1,191,13,131,9,153
test4sub91of100,test4pub76of100,1,191,13,137,5,155
test4sub87of100,test4pub76of100,1,191,13,137,4,154
test4sub48of100,test4pub76of100,1,191,13,138,4,155
test4sub5of100,test4pub76of100,1,191,13,149,1,163
test4sub19of100,test4pub76of100,1,191,13,184,1,198
test4sub21of100,test4pub76of100,1,191,13,185,1,199
test4sub20of100,test4pub76of100,1,191,13,186,3,202
test4sub61of100,test4pub76of100,1,191,13,187,3,203
test4sub63of100,test4pub76of100,1,191,13,187,2,202
test4sub13of100,test4pub76of100,1,191,13,188,2,203
test4sub56of100,test4pub76of100,1,191,13,188,2,203
test4sub64of100,test4pub76of100,1,191,13,186,3,202
test4sub57of100,test4pub76of100,1,191,13,201,1,215
test4sub79of100,test4pub76of100,1,191,13,203,1,217
test4sub100of100,test4pub76of100,1,191,13,204,1,218
test4sub39of100,test4pub76of100,1,191,13,205,0,218
test4sub16of100,test4pub76of100,1,191,13,208,1,222
test4sub29of100,test4pub76of100,1,191,13,210,1,224
test4sub35of100,test4pub76of100,1,191,13,210,2,225
test4sub66of100,test4pub76of100,1,191,13,213,1,227
test4sub34of100,test4pub76of100,1,191,13,212,2,227
test4sub42of100,test4pub76of100,1,191,13,219,1,233
test4sub26of100,test4pub76of100,1,191,13,218,1,232
test4sub68of100,test4pub76of100,1,191,13,224,1,238
test4sub67of100,test4pub76of100,1,191,13,226,1,240
test4sub96of100,test4pub76of100,1,191,13,225,3,241
test4sub88of100,test4pub76of100,1,191,13,226,3,242
test4sub65of100,test4pub76of100,1,191,13,224,2,239
test4sub40of100,test4pub76of100,1,191,13,227,3,243
test4sub8of100,test4pub76of100,1,191,13,228,2,243
test4sub11of100,test4pub76of100,1,191,13,325,1,339
test4sub85of100,test4pub76of100,1,191,13,346,1,360
test4sub75of100,test4pub76of100,1,191,13,346,1,360
test4sub46of100,test4pub76of100,1,191,13,348,0,361
test4sub32of100,test4pub76of100,1,191,13,350,0,363
test4sub33of100,test4pub76of100,1,191,13,363,1,377
test4sub45of100,test4pub76of100,1,191,13,372,2,387
test4sub25of100,test4pub76of100,1,191,13,373,1,387
test4sub6of100,test4pub76of100,1,191,13,374,1,388
test4sub15of100,test4pub76of100,1,191,13,378,0,391
test4sub28of100,test4pub76of100,1,191,13,379,0,392
test4sub18of100,test4pub76of100,1,191,13,391,1,405
test4sub98of100,test4pub76of100,1,191,13,391,1,405
test4sub41of100,test4pub76of100,1,191,13,409,0,422
test4sub50of100,test4pub76of100,1,191,13,449,1,463
test4sub38of100,test4pub76of100,1,191,13,454,1,468
test4sub27of100,test4pub76of100,1,191,13,470,1,484
test4sub24of100,test4pub77of100,1,191,13,18,1,32
test4sub27of100,test4pub77of100,1,191,13,21,0,34
test4sub8of100,test4pub77of100,1,191,13,23,1,37
test4sub7of100,test4pub77of100,1,191,13,25,1,39
test4sub68of100,test4pub77of100,1,191,13,29,0,42
test4sub48of100,test4pub77of100,1,191,13,30,1,44
test4sub99of100,test4pub77of100,1,191,13,31,1,45
test4sub89of100,test4pub77of100,1,191,13,39,1,53
test4sub81of100,test4pub77of100,1,191,13,41,1,55
test4sub97of100,test4pub77of100,1,191,13,42,1,56
test4sub42of100,test4pub77of100,1,191,13,48,1,62
test4sub64of100,test4pub77of100,1,191,13,52,1,66
test4sub17of100,test4pub77of100,1,191,13,53,2,68
test4sub6of100,test4pub77of100,1,191,13,54,3,70
test4sub32of100,test4pub77of100,1,191,13,55,2,70
test4sub87of100,test4pub77of100,1,191,13,56,2,71
test4sub73of100,test4pub77of100,1,191,13,66,1,80
test4sub61of100,test4pub77of100,1,191,13,67,1,81
test4sub9of100,test4pub77of100,1,191,13,75,1,89
test4sub10of100,test4pub77of100,1,191,13,75,1,89
test4sub82of100,test4pub77of100,1,191,13,81,1,95
test4sub69of100,test4pub77of100,1,191,13,84,1,98
test4sub23of100,test4pub77of100,1,191,13,86,1,100
test4sub12of100,test4pub77of100,1,191,13,87,1,101
test4sub21of100,test4pub77of100,1,191,13,89,1,103
test4sub2of100,test4pub77of100,1,191,13,91,1,105
test4sub33of100,test4pub77of100,1,191,13,92,1,106
test4sub39of100,test4pub77of100,1,191,13,95,0,108
test4sub22of100,test4pub77of100,1,191,13,97,1,111
test4sub60of100,test4pub77of100,1,191,13,98,2,113
test4sub35of100,test4pub77of100,1,191,13,99,2,114
test4sub14of100,test4pub77of100,1,191,13,100,0,113
test4sub18of100,test4pub77of100,1,191,13,102,2,117
test4sub55of100,test4pub77of100,1,191,13,103,2,118
test4sub76of100,test4pub77of100,1,191,13,104,2,119
test4sub30of100,test4pub77of100,1,191,13,104,1,118
test4sub67of100,test4pub77of100,1,191,13,107,1,121
test4sub20of100,test4pub77of100,1,191,13,108,1,122
test4sub53of100,test4pub77of100,1,191,13,115,1,129
test4sub26of100,test4pub77of100,1,191,13,120,1,134
test4sub3of100,test4pub77of100,1,191,13,121,2,136
test4sub59of100,test4pub77of100,1,191,13,121,2,136
test4sub92of100,test4pub77of100,1,191,13,123,1,137
test4sub47of100,test4pub77of100,1,191,13,123,1,137
test4sub29of100,test4pub77of100,1,191,13,129,1,143
test4sub37of100,test4pub77of100,1,191,13,129,2,144
test4sub93of100,test4pub77of100,1,191,13,130,2,145
test4sub70of100,test4pub77of100,1,191,13,131,3,147
test4sub41of100,test4pub77of100,1,191,13,132,3,148
test4sub15of100,test4pub77of100,1,191,13,133,3,149
test4sub25of100,test4pub77of100,1,191,13,134,2,149
test4sub88of100,test4pub77of100,1,191,13,134,5,152
test4sub1of100,test4pub77of100,1,191,13,136,2,151
test4sub36of100,test4pub77of100,1,191,13,138,2,153
test4sub44of100,test4pub77of100,1,191,13,140,1,154
test4sub40of100,test4pub77of100,1,191,13,141,1,155
test4sub5of100,test4pub77of100,1,191,13,143,1,157
test4sub80of100,test4pub77of100,1,191,13,145,1,159
test4sub90of100,test4pub77of100,1,191,13,140,7,160
test4sub65of100,test4pub77of100,1,191,13,146,2,161
test4sub16of100,test4pub77of100,1,191,13,146,2,161
test4sub19of100,test4pub77of100,1,191,13,144,4,161
test4sub91of100,test4pub77of100,1,191,13,143,6,162
test4sub49of100,test4pub77of100,1,191,13,150,1,164
test4sub45of100,test4pub77of100,1,191,13,151,3,167
test4sub56of100,test4pub77of100,1,191,13,153,5,171
test4sub66of100,test4pub77of100,1,191,13,151,7,171
test4sub28of100,test4pub77of100,1,191,13,153,5,171
test4sub11of100,test4pub77of100,1,191,13,154,4,171
test4sub58of100,test4pub77of100,1,191,13,154,4,171
test4sub79of100,test4pub77of100,1,191,13,154,4,171
test4sub38of100,test4pub77of100,1,191,13,155,4,172
test4sub84of100,test4pub77of100,1,191,13,156,4,173
test4sub98of100,test4pub77of100,1,191,13,157,3,173
test4sub54of100,test4pub77of100,1,191,13,363,1,377
test4sub63of100,test4pub77of100,1,191,13,369,1,383
test4sub75of100,test4pub77of100,1,191,13,373,1,387
test4sub46of100,test4pub77of100,1,191,13,373,0,386
test4sub85of100,test4pub77of100,1,191,13,375,0,388
test4sub72of100,test4pub77of100,1,191,13,379,1,393
test4sub74of100,test4pub77of100,1,191,13,381,0,394
test4sub94of100,test4pub77of100,1,191,13,383,2,398
test4sub95of100,test4pub77of100,1,191,13,385,1,399
test4sub83of100,test4pub77of100,1,191,13,386,1,400
test4sub51of100,test4pub77of100,1,191,13,393,1,407
test4sub100of100,test4pub77of100,1,191,13,395,1,409
test4sub78of100,test4pub77of100,1,191,13,393,5,411
test4sub13of100,test4pub77of100,1,191,13,396,2,411
test4sub43of100,test4pub77of100,1,191,13,403,1,417
test4sub57of100,test4pub77of100,1,191,13,406,1,420
test4sub86of100,test4pub77of100,1,191,13,409,4,426
test4sub77of100,test4pub77of100,1,191,13,411,3,427
test4sub4of100,test4pub77of100,1,191,13,411,6,430
test4sub52of100,test4pub77of100,1,191,13,412,5,430
test4sub62of100,test4pub77of100,1,191,13,415,3,431
test4sub71of100,test4pub77of100,1,191,13,422,1,436
test4sub31of100,test4pub77of100,1,191,13,426,1,440
test4sub96of100,test4pub77of100,1,191,13,444,0,457
test4sub50of100,test4pub77of100,1,191,13,468,1,482
test4sub34of100,test4pub77of100,1,191,13,492,1,506
test4sub45of100,test4pub78of100,1,191,11,5,1,17
test4sub94of100,test4pub78of100,1,191,11,9,1,21
test4sub85of100,test4pub78of100,1,191,11,12,0,23
test4sub30of100,test4pub78of100,1,191,11,17,1,29
test4sub63of100,test4pub78of100,1,191,11,18,2,31
test4sub48of100,test4pub78of100,1,191,11,19,1,31
test4sub25of100,test4pub78of100,1,191,11,22,1,34
test4sub76of100,test4pub78of100,1,191,11,23,1,35
test4sub14of100,test4pub78of100,1,191,11,47,1,59
test4sub97of100,test4pub78of100,1,191,11,48,0,59
test4sub80of100,test4pub78of100,1,191,11,55,0,66
test4sub32of100,test4pub78of100,1,191,11,56,0,67
test4sub77of100,test4pub78of100,1,191,11,58,1,70
test4sub5of100,test4pub78of100,1,191,11,59,0,70
test4sub29of100,test4pub78of100,1,191,11,63,1,75
test4sub43of100,test4pub78of100,1,191,11,64,1,76
test4sub56of100,test4pub78of100,1,191,11,66,1,78
test4sub28of100,test4pub78of100,1,191,11,67,1,79
test4sub88of100,test4pub78of100,1,191,11,66,4,81
test4sub50of100,test4pub78of100,1,191,11,68,4,83
test4sub60of100,test4pub78of100,1,191,11,68,4,83
test4sub15of100,test4pub78of100,1,191,11,70,3,84
test4sub39of100,test4pub78of100,1,191,11,71,3,85
test4sub19of100,test4pub78of100,1,191,11,71,3,85
test4sub75of100,test4pub78of100,1,191,11,72,2,85
test4sub13of100,test4pub78of100,1,191,11,109,2,122
test4sub71of100,test4pub78of100,1,191,11,110,2,123
test4sub98of100,test4pub78of100,1,191,11,114,0,125
test4sub36of100,test4pub78of100,1,191,11,114,1,126
test4sub61of100,test4pub78of100,1,191,11,117,2,130
test4sub34of100,test4pub78of100,1,191,11,118,2,131
test4sub70of100,test4pub78of100,1,191,11,120,2,133
test4sub59of100,test4pub78of100,1,191,11,127,0,138
test4sub17of100,test4pub78of100,1,191,11,129,2,142
test4sub10of100,test4pub78of100,1,191,11,130,2,143
test4sub21of100,test4pub78of100,1,191,11,130,6,147
test4sub100of100,test4pub78of100,1,191,11,133,4,148
test4sub92of100,test4pub78of100,1,191,11,134,3,148
test4sub69of100,test4pub78of100,1,191,11,134,4,149
test4sub4of100,test4pub78of100,1,191,11,135,4,150
test4sub40of100,test4pub78of100,1,191,11,143,1,155
test4sub72of100,test4pub78of100,1,191,11,146,1,158
test4sub67of100,test4pub78of100,1,191,11,149,2,162
test4sub55of100,test4pub78of100,1,191,11,151,2,164
test4sub65of100,test4pub78of100,1,191,11,151,2,164
test4sub51of100,test4pub78of100,1,191,11,152,1,164
test4sub49of100,test4pub78of100,1,191,11,154,1,166
test4sub58of100,test4pub78of100,1,191,11,160,1,172
test4sub81of100,test4pub78of100,1,191,11,160,2,173
test4sub99of100,test4pub78of100,1,191,11,161,1,173
test4sub12of100,test4pub78of100,1,191,11,167,1,179
test4sub24of100,test4pub78of100,1,191,11,168,1,180
test4sub82of100,test4pub78of100,1,191,11,170,1,182
test4sub18of100,test4pub78of100,1,191,11,171,2,184
test4sub66of100,test4pub78of100,1,191,11,172,2,185
test4sub42of100,test4pub78of100,1,191,11,173,1,185
test4sub87of100,test4pub78of100,1,191,11,173,1,185
test4sub73of100,test4pub78of100,1,191,11,177,1,189
test4sub95of100,test4pub78of100,1,191,11,187,3,201
test4sub54of100,test4pub78of100,1,191,11,187,4,202
test4sub83of100,test4pub78of100,1,191,11,188,5,204
test4sub37of100,test4pub78of100,1,191,11,189,5,205
test4sub84of100,test4pub78of100,1,191,11,190,7,208
test4sub44of100,test4pub78of100,1,191,11,189,8,208
test4sub89of100,test4pub78of100,1,191,11,191,7,209
test4sub6of100,test4pub78of100,1,191,11,192,9,212
test4sub46of100,test4pub78of100,1,191,11,192,11,214
test4sub86of100,test4pub78of100,1,191,11,193,10,214
test4sub38of100,test4pub78of100,1,191,11,194,10,215
test4sub64of100,test4pub78of100,1,191,11,195,10,216
test4sub3of100,test4pub78of100,1,191,11,196,10,217
test4sub27of100,test4pub78of100,1,191,11,196,10,217
test4sub96of100,test4pub78of100,1,191,11,197,11,219
test4sub52of100,test4pub78of100,1,191,11,198,9,218
test4sub26of100,test4pub78of100,1,191,11,199,9,219
test4sub79of100,test4pub78of100,1,191,11,200,9,220
test4sub22of100,test4pub78of100,1,191,11,201,8,220
test4sub2of100,test4pub78of100,1,191,11,202,7,220
test4sub31of100,test4pub78of100,1,191,11,201,8,220
test4sub16of100,test4pub78of100,1,191,11,202,7,220
test4sub57of100,test4pub78of100,1,191,11,204,6,221
test4sub35of100,test4pub78of100,1,191,11,205,5,221
test4sub91of100,test4pub78of100,1,191,11,206,4,221
test4sub11of100,test4pub78of100,1,191,11,340,0,351
test4sub7of100,test4pub78of100,1,191,11,348,1,360
test4sub47of100,test4pub78of100,1,191,11,356,2,369
test4sub9of100,test4pub78of100,1,191,11,357,1,369
test4sub93of100,test4pub78of100,1,191,11,364,0,375
test4sub74of100,test4pub78of100,1,191,11,376,1,388
test4sub23of100,test4pub78of100,1,191,11,385,1,397
test4sub33of100,test4pub78of100,1,191,11,385,1,397
test4sub78of100,test4pub78of100,1,191,11,390,0,401
test4sub62of100,test4pub78of100,1,191,11,398,0,409
test4sub53of100,test4pub78of100,1,191,11,398,1,410
test4sub41of100,test4pub78of100,1,191,11,403,1,415
test4sub1of100,test4pub78of100,1,191,11,403,1,415
test4sub20of100,test4pub78of100,1,191,11,410,1,422
test4sub8of100,test4pub78of100,1,191,11,410,1,422
test4sub68of100,test4pub78of100,1,191,11,412,1,424
test4sub90of100,test4pub78of100,1,191,11,436,1,448
test4sub22of100,test4pub79of100,1,191,14,5,1,20
test4sub46of100,test4pub79of100,1,191,14,11,1,26
test4sub38of100,test4pub79of100,1,191,14,12,1,27
test4sub70of100,test4pub79of100,1,191,14,13,1,28
test4sub96of100,test4pub79of100,1,191,14,16,1,31
test4sub31of100,test4pub79of100,1,191,14,16,1,31
test4sub53of100,test4pub79of100,1,191,14,15,2,31
test4sub98of100,test4pub79of100,1,191,14,22,1,37
test4sub90of100,test4pub79of100,1,191,14,31,0,45
test4sub86of100,test4pub79of100,1,191,14,34,1,49
test4sub100of100,test4pub79of100,1,191,14,35,0,49
test4sub83of100,test4pub79of100,1,191,14,46,1,61
test4sub74of100,test4pub79of100,1,191,14,52,1,67
test4sub10of100,test4pub79of100,1,191,14,56,0,70
test4sub44of100,test4pub79of100,1,191,14,59,1,74
test4sub16of100,test4pub79of100,1,191,14,63,0,77
test4sub5of100,test4pub79of100,1,191,14,69,2,85
test4sub33of100,test4pub79of100,1,191,14,70,2,86
test4sub27of100,test4pub79of100,1,191,14,72,1,87
test4sub79of100,test4pub79of100,1,191,14,73,1,88
test4sub50of100,test4pub79of100,1,191,14,74,1,89
test4sub82of100,test4pub79of100,1,191,14,76,1,91
test4sub62of100,test4pub79of100,1,191,14,76,0,90
test4sub39of100,test4pub79of100,1,191,14,81,1,96
test4sub97of100,test4pub79of100,1,191,14,82,3,99
test4sub61of100,test4pub79of100,1,191,14,83,2,99
test4sub41of100,test4pub79of100,1,191,14,84,2,100
test4sub11of100,test4pub79of100,1,191,14,88,1,103
test4sub99of100,test4pub79of100,1,191,14,88,1,103
test4sub14of100,test4pub79of100,1,191,14,90,0,104
test4sub95of100,test4pub79of100,1,191,14,91,2,107
test4sub80of100,test4pub79of100,1,191,14,92,1,107
test4sub69of100,test4pub79of100,1,191,14,92,2,108
test4sub49of100,test4pub79of100,1,191,14,94,1,109
test4sub55of100,test4pub79of100,1,191,14,96,1,111
test4sub20of100,test4pub79of100,1,191,14,106,0,120
test4sub66of100,test4pub79of100,1,191,14,108,1,123
test4sub34of100,test4pub79of100,1,191,14,110,2,126
test4sub72of100,test4pub79of100,1,191,14,110,2,126
test4sub75of100,test4pub79of100,1,191,14,111,2,127
test4sub3of100,test4pub79of100,1,191,14,113,1,128
test4sub4of100,test4pub79of100,1,191,14,113,2,129
test4sub88of100,test4pub79of100,1,191,14,115,2,131
test4sub52of100,test4pub79of100,1,191,14,116,1,131
test4sub28of100,test4pub79of100,1,191,14,121,1,136
test4sub65of100,test4pub79of100,1,191,14,124,1,139
test4sub8of100,test4pub79of100,1,191,14,127,1,142
test4sub23of100,test4pub79of100,1,191,14,131,1,146
test4sub7of100,test4pub79of100,1,191,14,134,1,149
test4sub51of100,test4pub79of100,1,191,14,134,1,149
test4sub15of100,test4pub79of100,1,191,14,136,1,151
test4sub26of100,test4pub79of100,1,191,14,136,1,151
test4sub93of100,test4pub79of100,1,191,14,139,1,154
test4sub87of100,test4pub79of100,1,191,14,140,3,157
test4sub18of100,test4pub79of100,1,191,14,140,3,157
test4sub54of100,test4pub79of100,1,191,14,142,3,159
test4sub43of100,test4pub79of100,1,191,14,142,3,159
test4sub77of100,test4pub79of100,1,191,14,143,4,161
test4sub35of100,test4pub79of100,1,191,14,142,4,160
test4sub94of100,test4pub79of100,1,191,14,145,1,160
test4sub63of100,test4pub79of100,1,191,14,151,0,165
test4sub76of100,test4pub79of100,1,191,14,154,1,169
test4sub2of100,test4pub79of100,1,191,14,154,1,169
test4sub67of100,test4pub79of100,1,191,14,154,2,170
test4sub12of100,test4pub79of100,1,191,14,157,0,171
test4sub9of100,test4pub79of100,1,191,14,158,2,174
test4sub73of100,test4pub79of100,1,191,14,159,0,173
test4sub6of100,test4pub79of100,1,191,14,163,1,178
test4sub57of100,test4pub79of100,1,191,14,163,0,177
test4sub40of100,test4pub79of100,1,191,14,168,0,182
test4sub30of100,test4pub79of100,1,191,14,346,1,361
test4sub47of100,test4pub79of100,1,191,14,346,1,361
test4sub45of100,test4pub79of100,1,191,14,353,1,368
test4sub81of100,test4pub79of100,1,191,14,355,1,370
test4sub36of100,test4pub79of100,1,191,14,366,1,381
test4sub58of100,test4pub79of100,1,191,14,366,2,382
test4sub92of100,test4pub79of100,1,191,14,367,2,383
test4sub78of100,test4pub79of100,1,191,14,369,1,384
test4sub59of100,test4pub79of100,1,191,14,369,2,385
test4sub24of100,test4pub79of100,1,191,14,370,1,385
test4sub25of100,test4pub79of100,1,191,14,372,1,387
test4sub91of100,test4pub79of100,1,191,14,376,1,391
test4sub13of100,test4pub79of100,1,191,14,377,1,392
test4sub1of100,test4pub79of100,1,191,14,382,1,397
test4sub85of100,test4pub79of100,1,191,14,383,1,398
test4sub32of100,test4pub79of100,1,191,14,403,1,418
test4sub48of100,test4pub79of100,1,191,14,403,2,419
test4sub19of100,test4pub79of100,1,191,14,404,1,419
test4sub21of100,test4pub79of100,1,191,14,410,1,425
test4sub60of100,test4pub79of100,1,191,14,410,2,426
test4sub17of100,test4pub79of100,1,191,14,411,2,427
test4sub84of100,test4pub79of100,1,191,14,412,2,428
test4sub68of100,test4pub79of100,1,191,14,413,2,429
test4sub56of100,test4pub79of100,1,191,14,416,1,431
test4sub71of100,test4pub79of100,1,191,14,416,2,432
test4sub29of100,test4pub79of100,1,191,14,417,1,432
test4sub64of100,test4pub79of100,1,191,14,427,1,442
test4sub37of100,test4pub79of100,1,191,14,435,1,450
test4sub76of100,test4pub80of100,1,191,11,23,1,35
test4sub75of100,test4pub80of100,1,191,11,24,1,36
test4sub42of100,test4pub79of100,1,191,14,442,0,456
test4sub68of100,test4pub80of100,1,191,11,33,1,45
test4sub89of100,test4pub79of100,1,191,14,450,3,467
test4sub49of100,test4pub80of100,1,191,11,34,4,49
test4sub97of100,test4pub80of100,1,191,11,35,5,51
test4sub28of100,test4pub80of100,1,191,11,36,6,53
test4sub37of100,test4pub80of100,1,191,11,37,6,54
test4sub14of100,test4pub80of100,1,191,11,38,5,54
test4sub81of100,test4pub80of100,1,191,11,39,4,54
test4sub46of100,test4pub80of100,1,191,11,40,4,55
test4sub60of100,test4pub80of100,1,191,11,40,3,54
test4sub90of100,test4pub80of100,1,191,11,42,3,56
test4sub78of100,test4pub80of100,1,191,11,54,1,66
test4sub86of100,test4pub80of100,1,191,11,55,1,67
test4sub20of100,test4pub80of100,1,191,11,54,2,67
test4sub47of100,test4pub80of100,1,191,11,56,2,69
test4sub30of100,test4pub80of100,1,191,11,63,1,75
test4sub38of100,test4pub80of100,1,191,11,64,0,75
test4sub99of100,test4pub80of100,1,191,11,70,1,82
test4sub34of100,test4pub80of100,1,191,11,71,2,84
test4sub9of100,test4pub80of100,1,191,11,71,1,83
test4sub51of100,test4pub80of100,1,191,11,74,1,86
test4sub59of100,test4pub80of100,1,191,11,75,1,87
test4sub80of100,test4pub80of100,1,191,11,76,1,88
test4sub64of100,test4pub80of100,1,191,11,78,1,90
test4sub35of100,test4pub80of100,1,191,11,81,1,93
test4sub15of100,test4pub80of100,1,191,11,82,1,94
test4sub89of100,test4pub80of100,1,191,11,97,1,109
test4sub27of100,test4pub80of100,1,191,11,98,3,112
test4sub57of100,test4pub80of100,1,191,11,98,3,112
test4sub19of100,test4pub80of100,1,191,11,99,3,113
test4sub71of100,test4pub80of100,1,191,11,101,2,114
test4sub83of100,test4pub80of100,1,191,11,103,1,115
test4sub7of100,test4pub80of100,1,191,11,124,1,136
test4sub73of100,test4pub80of100,1,191,11,125,2,138
test4sub42of100,test4pub80of100,1,191,11,126,1,138
test4sub56of100,test4pub80of100,1,191,11,133,1,145
test4sub40of100,test4pub80of100,1,191,11,133,2,146
test4sub41of100,test4pub80of100,1,191,11,134,1,146
test4sub11of100,test4pub80of100,1,191,11,136,1,148
test4sub100of100,test4pub80of100,1,191,11,136,1,148
test4sub91of100,test4pub80of100,1,191,11,163,0,174
test4sub5of100,test4pub80of100,1,191,11,169,1,181
test4sub31of100,test4pub80of100,1,191,11,170,1,182
test4sub67of100,test4pub80of100,1,191,11,169,2,182
test4sub85of100,test4pub80of100,1,191,11,172,1,184
test4sub3of100,test4pub80of100,1,191,11,173,0,184
test4sub48of100,test4pub80of100,1,191,11,183,1,195
test4sub98of100,test4pub80of100,1,191,11,184,0,195
test4sub53of100,test4pub80of100,1,191,11,185,1,197
test4sub72of100,test4pub80of100,1,191,11,187,1,199
test4sub17of100,test4pub80of100,1,191,11,188,1,200
test4sub87of100,test4pub80of100,1,191,11,199,1,211
test4sub63of100,test4pub80of100,1,191,11,200,2,213
test4sub88of100,test4pub80of100,1,191,11,201,0,212
test4sub32of100,test4pub80of100,1,191,11,213,0,224
test4sub6of100,test4pub80of100,1,191,11,222,1,234
test4sub70of100,test4pub80of100,1,191,11,223,2,236
test4sub18of100,test4pub80of100,1,191,11,224,1,236
test4sub43of100,test4pub80of100,1,191,11,230,1,242
test4sub92of100,test4pub80of100,1,191,11,231,2,244
test4sub22of100,test4pub80of100,1,191,11,232,1,244
test4sub23of100,test4pub80of100,1,191,11,261,1,273
test4sub95of100,test4pub80of100,1,191,11,262,2,275
test4sub65of100,test4pub80of100,1,191,11,263,1,275
test4sub66of100,test4pub80of100,1,191,11,265,1,277
test4sub12of100,test4pub80of100,1,191,11,268,1,280
test4sub50of100,test4pub80of100,1,191,11,270,2,283
test4sub29of100,test4pub80of100,1,191,11,271,1,283
test4sub84of100,test4pub80of100,1,191,11,272,2,285
test4sub54of100,test4pub80of100,1,191,11,291,1,303
test4sub21of100,test4pub80of100,1,191,11,293,1,305
test4sub4of100,test4pub80of100,1,191,11,294,2,307
test4sub16of100,test4pub80of100,1,191,11,295,1,307
test4sub13of100,test4pub80of100,1,191,11,299,3,313
test4sub33of100,test4pub80of100,1,191,11,301,3,315
test4sub82of100,test4pub80of100,1,191,11,302,3,316
test4sub44of100,test4pub80of100,1,191,11,300,8,319
test4sub45of100,test4pub80of100,1,191,11,304,5,320
test4sub2of100,test4pub80of100,1,191,11,305,5,321
test4sub1of100,test4pub80of100,1,191,11,305,6,322
test4sub79of100,test4pub80of100,1,191,11,306,6,323
test4sub25of100,test4pub80of100,1,191,11,307,7,325
test4sub36of100,test4pub80of100,1,191,11,307,8,326
test4sub93of100,test4pub80of100,1,191,11,308,8,327
test4sub77of100,test4pub80of100,1,191,11,313,3,327
test4sub96of100,test4pub80of100,1,191,11,313,4,328
test4sub74of100,test4pub80of100,1,191,11,315,3,329
test4sub8of100,test4pub80of100,1,191,11,324,2,337
test4sub26of100,test4pub80of100,1,191,11,324,1,336
test4sub58of100,test4pub80of100,1,191,11,325,1,337
test4sub52of100,test4pub80of100,1,191,11,354,1,366
test4sub55of100,test4pub80of100,1,191,11,354,2,367
test4sub94of100,test4pub80of100,1,191,11,357,1,369
test4sub10of100,test4pub80of100,1,191,11,356,2,369
test4sub24of100,test4pub80of100,1,191,11,365,1,377
test4sub61of100,test4pub80of100,1,191,11,368,0,379
test4sub39of100,test4pub80of100,1,191,11,369,2,382
test4sub62of100,test4pub80of100,1,191,11,370,1,382
test4sub69of100,test4pub80of100,1,191,11,376,0,387
test4sub22of100,test4pub81of100,1,191,30,5,1,36
test4sub64of100,test4pub81of100,1,191,30,12,1,43
test4sub13of100,test4pub81of100,1,191,30,16,1,47
test4sub1of100,test4pub81of100,1,191,30,16,1,47
test4sub23of100,test4pub81of100,1,191,30,17,1,48
test4sub9of100,test4pub81of100,1,191,30,23,1,54
test4sub93of100,test4pub81of100,1,191,30,29,1,60
test4sub10of100,test4pub81of100,1,191,30,31,1,62
test4sub16of100,test4pub81of100,1,191,30,31,1,62
test4sub75of100,test4pub81of100,1,191,30,34,1,65
test4sub17of100,test4pub81of100,1,191,30,39,1,70
test4sub66of100,test4pub81of100,1,191,30,44,2,76
test4sub27of100,test4pub81of100,1,191,30,45,2,77
test4sub100of100,test4pub81of100,1,191,30,45,3,78
test4sub91of100,test4pub81of100,1,191,30,44,4,78
test4sub70of100,test4pub81of100,1,191,30,46,2,78
test4sub42of100,test4pub81of100,1,191,30,48,1,79
test4sub63of100,test4pub81of100,1,191,30,50,2,82
test4sub20of100,test4pub81of100,1,191,30,51,1,82
test4sub45of100,test4pub81of100,1,191,30,52,2,84
test4sub58of100,test4pub81of100,1,191,30,52,2,84
test4sub86of100,test4pub81of100,1,191,30,54,0,84
test4sub40of100,test4pub81of100,1,191,30,56,1,87
test4sub28of100,test4pub81of100,1,191,30,59,1,90
test4sub92of100,test4pub81of100,1,191,30,59,2,91
test4sub67of100,test4pub81of100,1,191,30,60,2,92
test4sub65of100,test4pub81of100,1,191,30,59,3,92
test4sub73of100,test4pub81of100,1,191,30,62,1,93
test4sub69of100,test4pub81of100,1,191,30,67,1,98
test4sub24of100,test4pub81of100,1,191,30,68,2,100
test4sub46of100,test4pub81of100,1,191,30,69,1,100
test4sub36of100,test4pub81of100,1,191,30,69,2,101
test4sub47of100,test4pub81of100,1,191,30,71,3,104
test4sub83of100,test4pub81of100,1,191,30,73,2,105
test4sub14of100,test4pub81of100,1,191,30,72,3,105
test4sub81of100,test4pub81of100,1,191,30,72,2,104
test4sub95of100,test4pub81of100,1,191,30,74,3,107
test4sub61of100,test4pub81of100,1,191,30,75,2,107
test4sub39of100,test4pub81of100,1,191,30,77,0,107
test4sub54of100,test4pub81of100,1,191,30,81,0,111
test4sub49of100,test4pub81of100,1,191,30,81,1,112
test4sub44of100,test4pub81of100,1,191,30,82,0,112
test4sub12of100,test4pub81of100,1,191,30,87,1,118
test4sub48of100,test4pub81of100,1,191,30,92,1,123
test4sub29of100,test4pub81of100,1,191,30,93,0,123
test4sub43of100,test4pub81of100,1,191,30,95,0,125
test4sub8of100,test4pub81of100,1,191,30,95,1,126
test4sub62of100,test4pub81of100,1,191,30,101,1,132
test4sub41of100,test4pub81of100,1,191,30,101,2,133
test4sub77of100,test4pub81of100,1,191,30,103,1,134
test4sub3of100,test4pub81of100,1,191,30,103,1,134
test4sub31of100,test4pub81of100,1,191,30,106,0,136
test4sub50of100,test4pub81of100,1,191,30,106,1,137
test4sub71of100,test4pub81of100,1,191,30,112,1,143
test4sub56of100,test4pub81of100,1,191,30,113,3,146
test4sub72of100,test4pub81of100,1,191,30,114,4,148
test4sub32of100,test4pub81of100,1,191,30,115,3,148
test4sub74of100,test4pub81of100,1,191,30,115,3,148
test4sub7of100,test4pub81of100,1,191,30,116,3,149
test4sub55of100,test4pub81of100,1,191,30,116,2,148
test4sub60of100,test4pub81of100,1,191,30,117,3,150
test4sub57of100,test4pub81of100,1,191,30,161,2,193
test4sub52of100,test4pub81of100,1,191,30,163,6,199
test4sub99of100,test4pub81of100,1,191,30,164,5,199
test4sub11of100,test4pub81of100,1,191,30,165,10,205
test4sub15of100,test4pub81of100,1,191,30,166,14,210
test4sub4of100,test4pub81of100,1,191,30,167,14,211
test4sub82of100,test4pub81of100,1,191,30,167,17,214
test4sub33of100,test4pub81of100,1,191,30,169,16,215
test4sub53of100,test4pub81of100,1,191,30,171,16,217
test4sub21of100,test4pub81of100,1,191,30,172,15,217
test4sub89of100,test4pub81of100,1,191,30,173,15,218
test4sub90of100,test4pub81of100,1,191,30,173,15,218
test4sub6of100,test4pub81of100,1,191,30,175,15,220
test4sub26of100,test4pub81of100,1,191,30,176,14,220
test4sub84of100,test4pub81of100,1,191,30,177,14,221
test4sub76of100,test4pub81of100,1,191,30,178,14,222
test4sub35of100,test4pub81of100,1,191,30,178,14,222
test4sub19of100,test4pub81of100,1,191,30,181,11,222
test4sub38of100,test4pub81of100,1,191,30,182,10,222
test4sub30of100,test4pub81of100,1,191,30,184,10,224
test4sub94of100,test4pub81of100,1,191,30,227,1,258
test4sub85of100,test4pub81of100,1,191,30,229,1,260
test4sub37of100,test4pub81of100,1,191,30,230,2,262
test4sub5of100,test4pub81of100,1,191,30,230,1,261
test4sub34of100,test4pub81of100,1,191,30,231,2,263
test4sub98of100,test4pub81of100,1,191,30,233,0,263
test4sub88of100,test4pub81of100,1,191,30,234,3,267
test4sub51of100,test4pub81of100,1,191,30,235,2,267
test4sub80of100,test4pub81of100,1,191,30,236,3,269
test4sub68of100,test4pub81of100,1,191,30,239,1,270
test4sub25of100,test4pub81of100,1,191,30,241,1,272
test4sub97of100,test4pub81of100,1,191,30,241,1,272
test4sub2of100,test4pub81of100,1,191,30,243,1,274
test4sub87of100,test4pub81of100,1,191,30,247,3,280
test4sub18of100,test4pub81of100,1,191,30,247,2,279
test4sub78of100,test4pub81of100,1,191,30,248,3,281
test4sub79of100,test4pub81of100,1,191,30,248,2,280
test4sub59of100,test4pub81of100,1,191,30,252,0,282
test4sub96of100,test4pub81of100,1,191,30,256,1,287
test4sub31of100,test4pub82of100,1,191,13,7,1,21
test4sub30of100,test4pub82of100,1,191,13,9,0,22
test4sub82of100,test4pub82of100,1,191,13,38,1,52
test4sub29of100,test4pub82of100,1,191,13,39,2,54
test4sub91of100,test4pub82of100,1,191,13,40,1,54
test4sub53of100,test4pub82of100,1,191,13,42,1,56
test4sub23of100,test4pub82of100,1,191,13,45,1,59
test4sub16of100,test4pub82of100,1,191,13,56,1,70
test4sub27of100,test4pub82of100,1,191,13,56,1,70
test4sub49of100,test4pub82of100,1,191,13,58,1,72
test4sub65of100,test4pub82of100,1,191,13,60,0,73
test4sub55of100,test4pub82of100,1,191,13,62,1,76
test4sub10of100,test4pub82of100,1,191,13,64,1,78
test4sub56of100,test4pub82of100,1,191,13,64,1,78
test4sub19of100,test4pub82of100,1,191,13,66,1,80
test4sub45of100,test4pub82of100,1,191,13,66,1,80
test4sub78of100,test4pub82of100,1,191,13,70,0,83
test4sub47of100,test4pub82of100,1,191,13,71,1,85
test4sub40of100,test4pub82of100,1,191,13,72,1,86
test4sub17of100,test4pub82of100,1,191,13,79,1,93
test4sub38of100,test4pub82of100,1,191,13,80,0,93
test4sub95of100,test4pub82of100,1,191,13,84,1,98
test4sub68of100,test4pub82of100,1,191,13,85,1,99
test4sub50of100,test4pub82of100,1,191,13,87,1,101
test4sub36of100,test4pub82of100,1,191,13,88,1,102
test4sub75of100,test4pub82of100,1,191,13,90,1,104
test4sub1of100,test4pub82of100,1,191,13,91,1,105
test4sub25of100,test4pub82of100,1,191,13,92,1,106
test4sub81of100,test4pub82of100,1,191,13,93,1,107
test4sub76of100,test4pub82of100,1,191,13,96,1,110
test4sub6of100,test4pub82of100,1,191,13,99,2,114
test4sub93of100,test4pub82of100,1,191,13,100,3,116
test4sub3of100,test4pub82of100,1,191,13,101,2,116
test4sub5of100,test4pub82of100,1,191,13,97,11,121
test4sub21of100,test4pub82of100,1,191,13,98,12,123
test4sub83of100,test4pub82of100,1,191,13,99,11,123
test4sub58of100,test4pub82of100,1,191,13,100,10,123
test4sub94of100,test4pub82of100,1,191,13,101,10,124
test4sub57of100,test4pub82of100,1,191,13,103,9,125
test4sub2of100,test4pub82of100,1,191,13,104,7,124
test4sub15of100,test4pub82of100,1,191,13,99,7,119
test4sub26of100,test4pub82of100,1,191,13,104,8,125
test4sub72of100,test4pub82of100,1,191,13,100,8,121
test4sub80of100,test4pub82of100,1,191,13,105,8,126
test4sub60of100,test4pub82of100,1,191,13,107,8,128
test4sub32of100,test4pub82of100,1,191,13,108,8,129
test4sub70of100,test4pub82of100,1,191,13,109,8,130
test4sub71of100,test4pub82of100,1,191,13,110,7,130
test4sub52of100,test4pub82of100,1,191,13,113,4,130
test4sub62of100,test4pub82of100,1,191,13,115,3,131
test4sub34of100,test4pub82of100,1,191,13,116,6,135
test4sub24of100,test4pub82of100,1,191,13,118,6,137
test4sub42of100,test4pub82of100,1,191,13,119,6,138
test4sub88of100,test4pub82of100,1,191,13,119,5,137
test4sub84of100,test4pub82of100,1,191,13,120,6,139
test4sub74of100,test4pub82of100,1,191,13,120,7,140
test4sub11of100,test4pub82of100,1,191,13,121,7,141
test4sub46of100,test4pub82of100,1,191,13,122,5,140
test4sub89of100,test4pub82of100,1,191,13,123,5,141
test4sub99of100,test4pub82of100,1,191,13,124,5,142
test4sub73of100,test4pub82of100,1,191,13,125,3,141
test4sub7of100,test4pub82of100,1,191,13,127,3,143
test4sub43of100,test4pub82of100,1,191,13,138,0,151
test4sub66of100,test4pub82of100,1,191,13,138,1,152
test4sub37of100,test4pub82of100,1,191,13,141,1,155
test4sub9of100,test4pub82of100,1,191,13,141,3,157
test4sub18of100,test4pub82of100,1,191,13,142,4,159
test4sub22of100,test4pub82of100,1,191,13,143,4,160
test4sub100of100,test4pub82of100,1,191,13,144,3,160
test4sub13of100,test4pub82of100,1,191,13,144,3,160
test4sub97of100,test4pub82of100,1,191,13,145,3,161
test4sub33of100,test4pub82of100,1,191,13,146,3,162
test4sub35of100,test4pub82of100,1,191,13,147,2,162
test4sub8of100,test4pub82of100,1,191,13,198,1,212
test4sub39of100,test4pub82of100,1,191,13,199,1,213
test4sub48of100,test4pub82of100,1,191,13,340,1,354
test4sub85of100,test4pub82of100,1,191,13,353,1,367
test4sub28of100,test4pub82of100,1,191,13,354,1,368
test4sub86of100,test4pub82of100,1,191,13,356,1,370
test4sub90of100,test4pub82of100,1,191,13,356,1,370
test4sub51of100,test4pub82of100,1,191,13,366,1,380
test4sub20of100,test4pub82of100,1,191,13,366,1,380
test4sub63of100,test4pub82of100,1,191,13,367,0,380
test4sub14of100,test4pub82of100,1,191,13,374,1,388
test4sub92of100,test4pub82of100,1,191,13,375,1,389
test4sub64of100,test4pub82of100,1,191,13,375,1,389
test4sub41of100,test4pub82of100,1,191,13,378,1,392
test4sub59of100,test4pub82of100,1,191,13,384,1,398
test4sub67of100,test4pub82of100,1,191,13,399,0,412
test4sub98of100,test4pub82of100,1,191,13,406,0,419
test4sub77of100,test4pub82of100,1,191,13,408,1,422
test4sub87of100,test4pub82of100,1,191,13,414,1,428
test4sub12of100,test4pub82of100,1,191,13,431,0,444
test4sub79of100,test4pub82of100,1,191,13,443,1,457
test4sub4of100,test4pub82of100,1,191,13,469,1,483
test4sub69of100,test4pub82of100,1,191,13,487,1,501
test4sub89of100,test4pub83of100,1,191,15,10,1,26
test4sub84of100,test4pub83of100,1,191,15,12,0,27
test4sub6of100,test4pub83of100,1,191,15,16,1,32
test4sub24of100,test4pub83of100,1,191,15,19,0,34
test4sub29of100,test4pub83of100,1,191,15,23,1,39
test4sub39of100,test4pub83of100,1,191,15,23,1,39
test4sub51of100,test4pub83of100,1,191,15,25,0,40
test4sub96of100,test4pub82of100,1,191,13,518,1,532
test4sub41of100,test4pub83of100,1,191,15,32,1,48
test4sub21of100,test4pub83of100,1,191,15,35,1,51
test4sub3of100,test4pub83of100,1,191,15,35,2,52
test4sub14of100,test4pub83of100,1,191,15,37,2,54
test4sub72of100,test4pub83of100,1,191,15,37,1,53
test4sub99of100,test4pub83of100,1,191,15,38,2,55
test4sub4of100,test4pub83of100,1,191,15,41,1,57
test4sub88of100,test4pub83of100,1,191,15,43,1,59
test4sub48of100,test4pub83of100,1,191,15,44,1,60
test4sub2of100,test4pub83of100,1,191,15,45,1,61
test4sub35of100,test4pub83of100,1,191,15,46,1,62
test4sub27of100,test4pub83of100,1,191,15,47,0,62
test4sub95of100,test4pub83of100,1,191,15,50,0,65
test4sub18of100,test4pub83of100,1,191,15,53,2,70
test4sub11of100,test4pub83of100,1,191,15,54,2,71
test4sub73of100,test4pub83of100,1,191,15,55,1,71
test4sub38of100,test4pub83of100,1,191,15,55,2,72
test4sub34of100,test4pub83of100,1,191,15,53,4,72
test4sub85of100,test4pub83of100,1,191,15,55,4,74
test4sub13of100,test4pub83of100,1,191,15,58,1,74
test4sub77of100,test4pub83of100,1,191,15,59,1,75
test4sub23of100,test4pub83of100,1,191,15,61,5,81
test4sub45of100,test4pub83of100,1,191,15,62,4,81
test4sub46of100,test4pub83of100,1,191,15,62,4,81
test4sub31of100,test4pub83of100,1,191,15,63,4,82
test4sub56of100,test4pub83of100,1,191,15,63,4,82
test4sub58of100,test4pub83of100,1,191,15,64,3,82
test4sub20of100,test4pub83of100,1,191,15,65,3,83
test4sub17of100,test4pub83of100,1,191,15,100,0,115
test4sub42of100,test4pub83of100,1,191,15,106,2,123
test4sub69of100,test4pub83of100,1,191,15,106,3,124
test4sub98of100,test4pub83of100,1,191,15,107,6,128
test4sub28of100,test4pub83of100,1,191,15,108,6,129
test4sub97of100,test4pub83of100,1,191,15,109,4,128
test4sub55of100,test4pub83of100,1,191,15,107,4,126
test4sub76of100,test4pub83of100,1,191,15,110,5,130
test4sub66of100,test4pub83of100,1,191,15,111,6,132
test4sub49of100,test4pub83of100,1,191,15,110,6,131
test4sub92of100,test4pub83of100,1,191,15,112,7,134
test4sub37of100,test4pub83of100,1,191,15,112,7,134
test4sub80of100,test4pub83of100,1,191,15,111,6,132
test4sub90of100,test4pub83of100,1,191,15,115,4,134
test4sub25of100,test4pub83of100,1,191,15,116,3,134
test4sub78of100,test4pub83of100,1,191,15,117,3,135
test4sub50of100,test4pub83of100,1,191,15,116,4,135
test4sub94of100,test4pub83of100,1,191,15,121,3,139
test4sub70of100,test4pub83of100,1,191,15,122,3,140
test4sub63of100,test4pub83of100,1,191,15,122,3,140
test4sub93of100,test4pub83of100,1,191,15,122,3,140
test4sub12of100,test4pub83of100,1,191,15,121,4,140
test4sub9of100,test4pub83of100,1,191,15,123,9,147
test4sub87of100,test4pub83of100,1,191,15,124,8,147
test4sub81of100,test4pub83of100,1,191,15,126,7,148
test4sub91of100,test4pub83of100,1,191,15,127,6,148
test4sub43of100,test4pub83of100,1,191,15,128,5,148
test4sub15of100,test4pub83of100,1,191,15,128,6,149
test4sub57of100,test4pub83of100,1,191,15,129,5,149
test4sub47of100,test4pub83of100,1,191,15,130,5,150
test4sub64of100,test4pub83of100,1,191,15,130,5,150
test4sub30of100,test4pub83of100,1,191,15,129,5,149
test4sub82of100,test4pub83of100,1,191,15,131,5,151
test4sub26of100,test4pub83of100,1,191,15,132,5,152
test4sub5of100,test4pub83of100,1,191,15,170,1,186
test4sub7of100,test4pub83of100,1,191,15,171,1,187
test4sub59of100,test4pub83of100,1,191,15,173,1,189
test4sub60of100,test4pub83of100,1,191,15,174,4,193
test4sub22of100,test4pub83of100,1,191,15,175,3,193
test4sub10of100,test4pub83of100,1,191,15,175,5,195
test4sub53of100,test4pub83of100,1,191,15,177,4,196
test4sub1of100,test4pub83of100,1,191,15,177,5,197
test4sub32of100,test4pub83of100,1,191,15,176,12,203
test4sub40of100,test4pub83of100,1,191,15,177,8,200
test4sub19of100,test4pub83of100,1,191,15,179,12,206
test4sub65of100,test4pub83of100,1,191,15,182,10,207
test4sub67of100,test4pub83of100,1,191,15,183,10,208
test4sub71of100,test4pub83of100,1,191,15,183,9,207
test4sub33of100,test4pub83of100,1,191,15,184,10,209
test4sub68of100,test4pub83of100,1,191,15,184,10,209
test4sub100of100,test4pub83of100,1,191,15,182,9,206
test4sub79of100,test4pub83of100,1,191,15,185,10,210
test4sub75of100,test4pub83of100,1,191,15,185,9,209
test4sub36of100,test4pub83of100,1,191,15,187,9,211
test4sub52of100,test4pub83of100,1,191,15,187,9,211
test4sub62of100,test4pub83of100,1,191,15,181,14,210
test4sub86of100,test4pub83of100,1,191,15,188,8,211
test4sub16of100,test4pub83of100,1,191,15,188,8,211
test4sub83of100,test4pub83of100,1,191,15,189,7,211
test4sub96of100,test4pub83of100,1,191,15,190,7,212
test4sub8of100,test4pub83of100,1,191,15,190,7,212
test4sub74of100,test4pub83of100,1,191,15,191,6,212
test4sub44of100,test4pub82of100,1,191,13,749,0,762
test4sub44of100,test4pub83of100,1,191,15,263,1,279
test4sub61of100,test4pub82of100,1,191,13,781,0,794
test4sub61of100,test4pub83of100,1,191,15,295,1,311
test4sub54of100,test4pub82of100,1,191,13,841,1,855
test4sub54of100,test4pub83of100,1,191,15,355,1,371
test4sub76of100,test4pub84of100,1,191,16,6,0,22
test4sub83of100,test4pub84of100,1,191,16,8,1,25
test4sub60of100,test4pub84of100,1,191,16,18,1,35
test4sub96of100,test4pub84of100,1,191,16,21,0,37
test4sub7of100,test4pub84of100,1,191,16,23,0,39
test4sub20of100,test4pub84of100,1,191,16,24,1,41
test4sub13of100,test4pub84of100,1,191,16,25,0,41
test4sub89of100,test4pub84of100,1,191,16,27,1,44
test4sub21of100,test4pub84of100,1,191,16,28,1,45
test4sub1of100,test4pub84of100,1,191,16,28,2,46
test4sub26of100,test4pub84of100,1,191,16,32,1,49
test4sub14of100,test4pub84of100,1,191,16,33,1,50
test4sub50of100,test4pub84of100,1,191,16,38,0,54
test4sub84of100,test4pub84of100,1,191,16,40,1,57
test4sub39of100,test4pub84of100,1,191,16,40,2,58
test4sub70of100,test4pub84of100,1,191,16,41,2,59
test4sub97of100,test4pub84of100,1,191,16,41,3,60
test4sub32of100,test4pub84of100,1,191,16,43,1,60
test4sub9of100,test4pub84of100,1,191,16,44,1,61
test4sub87of100,test4pub84of100,1,191,16,47,2,65
test4sub5of100,test4pub84of100,1,191,16,47,2,65
test4sub16of100,test4pub84of100,1,191,16,48,2,66
test4sub8of100,test4pub84of100,1,191,16,47,3,66
test4sub4of100,test4pub84of100,1,191,16,49,2,67
test4sub6of100,test4pub84of100,1,191,16,50,2,68
test4sub11of100,test4pub84of100,1,191,16,55,1,72
test4sub12of100,test4pub84of100,1,191,16,55,3,74
test4sub92of100,test4pub84of100,1,191,16,56,2,74
test4sub85of100,test4pub84of100,1,191,16,57,2,75
test4sub77of100,test4pub84of100,1,191,16,58,1,75
test4sub62of100,test4pub84of100,1,191,16,63,2,81
test4sub19of100,test4pub84of100,1,191,16,63,2,81
test4sub63of100,test4pub84of100,1,191,16,64,1,81
test4sub73of100,test4pub84of100,1,191,16,65,2,83
test4sub52of100,test4pub84of100,1,191,16,66,2,84
test4sub72of100,test4pub84of100,1,191,16,68,4,88
test4sub28of100,test4pub84of100,1,191,16,70,4,90
test4sub49of100,test4pub84of100,1,191,16,69,4,89
test4sub59of100,test4pub84of100,1,191,16,72,2,90
test4sub100of100,test4pub84of100,1,191,16,71,3,90
test4sub95of100,test4pub84of100,1,191,16,71,2,89
test4sub55of100,test4pub84of100,1,191,16,118,2,136
test4sub36of100,test4pub84of100,1,191,16,119,2,137
test4sub99of100,test4pub84of100,1,191,16,120,2,138
test4sub35of100,test4pub84of100,1,191,16,121,2,139
test4sub54of100,test4pub84of100,1,191,16,121,1,138
test4sub15of100,test4pub84of100,1,191,16,124,0,140
test4sub33of100,test4pub84of100,1,191,16,123,2,141
test4sub93of100,test4pub84of100,1,191,16,125,2,143
test4sub61of100,test4pub84of100,1,191,16,126,0,142
test4sub27of100,test4pub84of100,1,191,16,128,1,145
test4sub30of100,test4pub84of100,1,191,16,131,0,147
test4sub46of100,test4pub84of100,1,191,16,131,2,149
test4sub88of100,test4pub84of100,1,191,16,137,1,154
test4sub98of100,test4pub84of100,1,191,16,140,0,156
test4sub65of100,test4pub84of100,1,191,16,144,1,161
test4sub10of100,test4pub84of100,1,191,16,147,0,163
test4sub91of100,test4pub84of100,1,191,16,149,0,165
test4sub57of100,test4pub84of100,1,191,16,149,1,166
test4sub78of100,test4pub84of100,1,191,16,151,1,168
test4sub53of100,test4pub84of100,1,191,16,152,1,169
test4sub48of100,test4pub84of100,1,191,16,153,2,171
test4sub82of100,test4pub84of100,1,191,16,154,1,171
test4sub3of100,test4pub84of100,1,191,16,154,4,174
test4sub29of100,test4pub84of100,1,191,16,155,5,176
test4sub34of100,test4pub84of100,1,191,16,157,5,178
test4sub25of100,test4pub84of100,1,191,16,157,4,177
test4sub47of100,test4pub84of100,1,191,16,158,3,177
test4sub42of100,test4pub84of100,1,191,16,159,4,179
test4sub45of100,test4pub84of100,1,191,16,161,4,181
test4sub74of100,test4pub84of100,1,191,16,163,1,180
test4sub94of100,test4pub84of100,1,191,16,163,1,180
test4sub40of100,test4pub84of100,1,191,16,166,0,182
test4sub17of100,test4pub84of100,1,191,16,169,0,185
test4sub23of100,test4pub84of100,1,191,16,171,3,190
test4sub22of100,test4pub84of100,1,191,16,172,3,191
test4sub37of100,test4pub84of100,1,191,16,173,2,191
test4sub79of100,test4pub84of100,1,191,16,173,2,191
test4sub56of100,test4pub84of100,1,191,16,204,3,223
test4sub43of100,test4pub84of100,1,191,16,204,5,225
test4sub41of100,test4pub84of100,1,191,16,206,5,227
test4sub44of100,test4pub84of100,1,191,16,207,4,227
test4sub18of100,test4pub84of100,1,191,16,207,7,230
test4sub64of100,test4pub84of100,1,191,16,209,8,233
test4sub80of100,test4pub84of100,1,191,16,206,11,233
test4sub2of100,test4pub84of100,1,191,16,211,7,234
test4sub66of100,test4pub84of100,1,191,16,212,7,235
test4sub67of100,test4pub84of100,1,191,16,208,11,235
test4sub51of100,test4pub84of100,1,191,16,208,11,235
test4sub71of100,test4pub84of100,1,191,16,210,12,238
test4sub38of100,test4pub84of100,1,191,16,212,10,238
test4sub58of100,test4pub84of100,1,191,16,212,10,238
test4sub75of100,test4pub84of100,1,191,16,213,10,239
test4sub69of100,test4pub84of100,1,191,16,215,9,240
test4sub81of100,test4pub84of100,1,191,16,216,8,240
test4sub24of100,test4pub84of100,1,191,16,218,7,241
test4sub31of100,test4pub84of100,1,191,16,218,6,240
test4sub90of100,test4pub84of100,1,191,16,220,5,241
test4sub86of100,test4pub84of100,1,191,16,220,5,241
test4sub68of100,test4pub84of100,1,191,16,221,4,241
test4sub76of100,test4pub85of100,1,191,14,12,0,26
test4sub33of100,test4pub85of100,1,191,14,14,1,29
test4sub10of100,test4pub85of100,1,191,14,16,1,31
test4sub24of100,test4pub85of100,1,191,14,17,2,33
test4sub17of100,test4pub85of100,1,191,14,18,2,34
test4sub15of100,test4pub85of100,1,191,14,19,0,33
test4sub32of100,test4pub85of100,1,191,14,23,1,38
test4sub92of100,test4pub85of100,1,191,14,31,1,46
test4sub4of100,test4pub85of100,1,191,14,31,2,47
test4sub97of100,test4pub85of100,1,191,14,32,1,47
test4sub60of100,test4pub85of100,1,191,14,38,1,53
test4sub99of100,test4pub85of100,1,191,14,40,1,55
test4sub21of100,test4pub85of100,1,191,14,41,1,56
test4sub94of100,test4pub85of100,1,191,14,43,1,58
test4sub74of100,test4pub85of100,1,191,14,43,1,58
test4sub77of100,test4pub85of100,1,191,14,49,0,63
test4sub9of100,test4pub85of100,1,191,14,54,1,69
test4sub86of100,test4pub85of100,1,191,14,57,0,71
test4sub55of100,test4pub85of100,1,191,14,59,1,74
test4sub95of100,test4pub85of100,1,191,14,61,0,75
test4sub100of100,test4pub85of100,1,191,14,63,1,78
test4sub47of100,test4pub85of100,1,191,14,68,1,83
test4sub64of100,test4pub85of100,1,191,14,71,1,86
test4sub1of100,test4pub85of100,1,191,14,75,1,90
test4sub81of100,test4pub85of100,1,191,14,76,1,91
test4sub73of100,test4pub85of100,1,191,14,79,2,95
test4sub57of100,test4pub85of100,1,191,14,79,2,95
test4sub61of100,test4pub85of100,1,191,14,80,2,96
test4sub41of100,test4pub85of100,1,191,14,81,3,98
test4sub75of100,test4pub85of100,1,191,14,83,3,100
test4sub43of100,test4pub85of100,1,191,14,83,2,99
test4sub68of100,test4pub85of100,1,191,14,91,1,106
test4sub52of100,test4pub85of100,1,191,14,96,4,114
test4sub49of100,test4pub85of100,1,191,14,97,6,117
test4sub14of100,test4pub85of100,1,191,14,98,6,118
test4sub3of100,test4pub85of100,1,191,14,98,9,121
test4sub23of100,test4pub85of100,1,191,14,99,10,123
test4sub78of100,test4pub85of100,1,191,14,101,9,124
test4sub27of100,test4pub85of100,1,191,14,102,9,125
test4sub84of100,test4pub85of100,1,191,14,104,8,126
test4sub48of100,test4pub85of100,1,191,14,104,9,127
test4sub46of100,test4pub85of100,1,191,14,105,12,131
test4sub54of100,test4pub85of100,1,191,14,105,13,132
test4sub62of100,test4pub85of100,1,191,14,106,16,136
test4sub45of100,test4pub85of100,1,191,14,109,15,138
test4sub69of100,test4pub85of100,1,191,14,110,15,139
test4sub35of100,test4pub85of100,1,191,14,111,14,139
test4sub12of100,test4pub85of100,1,191,14,114,12,140
test4sub5of100,test4pub85of100,1,191,14,115,11,140
test4sub83of100,test4pub85of100,1,191,14,114,16,144
test4sub36of100,test4pub85of100,1,191,14,117,17,148
test4sub42of100,test4pub85of100,1,191,14,120,15,149
test4sub13of100,test4pub85of100,1,191,14,121,14,149
test4sub79of100,test4pub85of100,1,191,14,124,12,150
test4sub53of100,test4pub85of100,1,191,14,122,14,150
test4sub51of100,test4pub85of100,1,191,14,126,11,151
test4sub89of100,test4pub85of100,1,191,14,128,11,153
test4sub58of100,test4pub85of100,1,191,14,130,10,154
test4sub44of100,test4pub85of100,1,191,14,130,9,153
test4sub16of100,test4pub85of100,1,191,14,131,9,154
test4sub70of100,test4pub85of100,1,191,14,131,9,154
test4sub50of100,test4pub85of100,1,191,14,133,7,154
test4sub59of100,test4pub85of100,1,191,14,133,7,154
test4sub18of100,test4pub85of100,1,191,14,134,7,155
test4sub19of100,test4pub85of100,1,191,14,134,7,155
test4sub98of100,test4pub85of100,1,191,14,137,4,155
test4sub65of100,test4pub85of100,1,191,14,138,4,156
test4sub56of100,test4pub85of100,1,191,14,144,0,158
test4sub87of100,test4pub85of100,1,191,14,144,3,161
test4sub88of100,test4pub85of100,1,191,14,145,3,162
test4sub93of100,test4pub85of100,1,191,14,146,3,163
test4sub82of100,test4pub85of100,1,191,14,147,3,164
test4sub96of100,test4pub85of100,1,191,14,147,3,164
test4sub34of100,test4pub85of100,1,191,14,148,2,164
test4sub7of100,test4pub85of100,1,191,14,332,1,347
test4sub30of100,test4pub85of100,1,191,14,332,1,347
test4sub85of100,test4pub85of100,1,191,14,352,1,367
test4sub91of100,test4pub85of100,1,191,14,360,1,375
test4sub20of100,test4pub85of100,1,191,14,361,0,375
test4sub63of100,test4pub85of100,1,191,14,366,1,381
test4sub6of100,test4pub85of100,1,191,14,369,1,384
test4sub72of100,test4pub85of100,1,191,14,373,0,387
test4sub11of100,test4pub85of100,1,191,14,376,0,390
test4sub29of100,test4pub85of100,1,191,14,380,0,394
test4sub28of100,test4pub85of100,1,191,14,380,1,395
test4sub80of100,test4pub85of100,1,191,14,384,1,399
test4sub90of100,test4pub85of100,1,191,14,385,0,399
test4sub71of100,test4pub85of100,1,191,14,389,1,404
test4sub31of100,test4pub85of100,1,191,14,389,0,403
test4sub37of100,test4pub85of100,1,191,14,393,1,408
test4sub66of100,test4pub85of100,1,191,14,398,1,413
test4sub40of100,test4pub85of100,1,191,14,398,1,413
test4sub25of100,test4pub85of100,1,191,14,401,1,416
test4sub67of100,test4pub85of100,1,191,14,406,0,420
test4sub2of100,test4pub85of100,1,191,14,410,0,424
test4sub26of100,test4pub85of100,1,191,14,412,0,426
test4sub22of100,test4pub85of100,1,191,14,415,1,430
test4sub38of100,test4pub85of100,1,191,14,414,1,429
test4sub8of100,test4pub85of100,1,191,14,421,1,436
test4sub39of100,test4pub85of100,1,191,14,440,1,455
test4sub99of100,test4pub86of100,1,191,16,13,0,29
test4sub7of100,test4pub86of100,1,191,16,14,0,30
test4sub63of100,test4pub86of100,1,191,16,15,0,31
test4sub40of100,test4pub86of100,1,191,16,19,0,35
test4sub12of100,test4pub86of100,1,191,16,22,1,39
test4sub22of100,test4pub86of100,1,191,16,22,1,39
test4sub10of100,test4pub86of100,1,191,16,24,1,41
test4sub85of100,test4pub86of100,1,191,16,27,1,44
test4sub15of100,test4pub86of100,1,191,16,27,1,44
test4sub13of100,test4pub86of100,1,191,16,31,1,48
test4sub72of100,test4pub86of100,1,191,16,34,1,51
test4sub8of100,test4pub86of100,1,191,16,34,3,53
test4sub50of100,test4pub86of100,1,191,16,35,2,53
test4sub33of100,test4pub86of100,1,191,16,37,2,55
test4sub19of100,test4pub86of100,1,191,16,46,1,63
test4sub28of100,test4pub86of100,1,191,16,47,1,64
test4sub45of100,test4pub86of100,1,191,16,52,1,69
test4sub69of100,test4pub86of100,1,191,16,52,2,70
test4sub37of100,test4pub86of100,1,191,16,54,1,71
test4sub2of100,test4pub86of100,1,191,16,58,1,75
test4sub20of100,test4pub86of100,1,191,16,59,1,76
test4sub97of100,test4pub86of100,1,191,16,60,2,78
test4sub1of100,test4pub86of100,1,191,16,61,2,79
test4sub24of100,test4pub86of100,1,191,16,62,1,79
test4sub26of100,test4pub86of100,1,191,16,68,1,85
test4sub56of100,test4pub86of100,1,191,16,70,1,87
test4sub41of100,test4pub86of100,1,191,16,72,0,88
test4sub92of100,test4pub86of100,1,191,16,74,2,92
test4sub88of100,test4pub86of100,1,191,16,75,2,93
test4sub91of100,test4pub86of100,1,191,16,78,0,94
test4sub65of100,test4pub86of100,1,191,16,82,1,99
test4sub68of100,test4pub86of100,1,191,16,86,0,102
test4sub51of100,test4pub86of100,1,191,16,89,1,106
test4sub34of100,test4pub86of100,1,191,16,90,2,108
test4sub43of100,test4pub86of100,1,191,16,91,5,112
test4sub74of100,test4pub86of100,1,191,16,92,4,112
test4sub39of100,test4pub86of100,1,191,16,92,4,112
test4sub54of100,test4pub86of100,1,191,16,92,5,113
test4sub83of100,test4pub86of100,1,191,16,93,4,113
test4sub31of100,test4pub86of100,1,191,16,94,4,114
test4sub32of100,test4pub86of100,1,191,16,95,6,117
test4sub46of100,test4pub86of100,1,191,16,97,4,117
test4sub93of100,test4pub86of100,1,191,16,99,2,117
test4sub90of100,test4pub86of100,1,191,16,100,1,117
test4sub96of100,test4pub86of100,1,191,16,100,2,118
test4sub52of100,test4pub86of100,1,191,16,105,1,122
test4sub48of100,test4pub86of100,1,191,16,105,1,122
test4sub17of100,test4pub86of100,1,191,16,107,2,125
test4sub18of100,test4pub86of100,1,191,16,108,3,127
test4sub81of100,test4pub86of100,1,191,16,108,4,128
test4sub75of100,test4pub86of100,1,191,16,109,2,127
test4sub14of100,test4pub86of100,1,191,16,109,2,127
test4sub77of100,test4pub86of100,1,191,16,110,2,128
test4sub100of100,test4pub86of100,1,191,16,135,1,152
test4sub76of100,test4pub86of100,1,191,16,137,0,153
test4sub98of100,test4pub86of100,1,191,16,136,7,159
test4sub87of100,test4pub86of100,1,191,16,137,6,159
test4sub42of100,test4pub86of100,1,191,16,137,6,159
test4sub67of100,test4pub86of100,1,191,16,138,5,159
test4sub71of100,test4pub86of100,1,191,16,140,4,160
test4sub38of100,test4pub86of100,1,191,16,141,4,161
test4sub6of100,test4pub86of100,1,191,16,141,3,160
test4sub55of100,test4pub86of100,1,191,16,142,4,162
test4sub23of100,test4pub86of100,1,191,16,170,1,187
test4sub61of100,test4pub86of100,1,191,16,176,1,193
test4sub3of100,test4pub86of100,1,191,16,177,2,195
test4sub4of100,test4pub86of100,1,191,16,178,1,195
test4sub80of100,test4pub86of100,1,191,16,180,3,199
test4sub27of100,test4pub86of100,1,191,16,180,6,202
test4sub64of100,test4pub86of100,1,191,16,181,6,203
test4sub78of100,test4pub86of100,1,191,16,181,6,203
test4sub49of100,test4pub86of100,1,191,16,182,6,204
test4sub70of100,test4pub86of100,1,191,16,183,6,205
test4sub44of100,test4pub86of100,1,191,16,184,6,206
test4sub35of100,test4pub86of100,1,191,16,184,5,205
test4sub5of100,test4pub86of100,1,191,16,184,5,205
test4sub79of100,test4pub86of100,1,191,16,185,5,206
test4sub9of100,test4pub86of100,1,191,16,186,4,206
test4sub47of100,test4pub86of100,1,191,16,188,3,207
test4sub66of100,test4pub86of100,1,191,16,195,2,213
test4sub60of100,test4pub86of100,1,191,16,195,4,215
test4sub62of100,test4pub86of100,1,191,16,196,4,216
test4sub59of100,test4pub86of100,1,191,16,197,5,218
test4sub36of100,test4pub86of100,1,191,16,197,8,221
test4sub29of100,test4pub86of100,1,191,16,199,7,222
test4sub57of100,test4pub86of100,1,191,16,199,9,224
test4sub82of100,test4pub86of100,1,191,16,200,9,225
test4sub53of100,test4pub86of100,1,191,16,200,8,224
test4sub89of100,test4pub86of100,1,191,16,202,8,226
test4sub73of100,test4pub86of100,1,191,16,203,6,225
test4sub11of100,test4pub86of100,1,191,16,203,7,226
test4sub95of100,test4pub86of100,1,191,16,204,6,226
test4sub84of100,test4pub86of100,1,191,16,205,6,227
test4sub86of100,test4pub86of100,1,191,16,205,6,227
test4sub58of100,test4pub86of100,1,191,16,207,5,228
test4sub25of100,test4pub86of100,1,191,16,207,5,228
test4sub94of100,test4pub86of100,1,191,16,208,4,228
test4sub30of100,test4pub86of100,1,191,16,345,0,361
test4sub21of100,test4pub86of100,1,191,16,377,1,394
test4sub16of100,test4pub86of100,1,191,16,393,1,410
test4sub24of100,test4pub87of100,1,191,11,6,1,18
test4sub62of100,test4pub87of100,1,191,11,12,0,23
test4sub48of100,test4pub87of100,1,191,11,16,1,28
test4sub44of100,test4pub87of100,1,191,11,19,1,31
test4sub26of100,test4pub87of100,1,191,11,21,0,32
test4sub35of100,test4pub87of100,1,191,11,22,1,34
test4sub50of100,test4pub87of100,1,191,11,24,1,36
test4sub66of100,test4pub87of100,1,191,11,25,3,39
test4sub76of100,test4pub87of100,1,191,11,26,3,40
test4sub70of100,test4pub87of100,1,191,11,26,3,40
test4sub88of100,test4pub87of100,1,191,11,27,4,42
test4sub71of100,test4pub87of100,1,191,11,28,4,43
test4sub33of100,test4pub87of100,1,191,11,28,3,42
test4sub13of100,test4pub87of100,1,191,11,30,2,43
test4sub86of100,test4pub87of100,1,191,11,30,2,43
test4sub38of100,test4pub87of100,1,191,11,35,0,46
test4sub82of100,test4pub87of100,1,191,11,36,1,48
test4sub72of100,test4pub87of100,1,191,11,38,0,49
test4sub42of100,test4pub87of100,1,191,11,50,1,62
test4sub97of100,test4pub87of100,1,191,11,51,1,63
test4sub41of100,test4pub87of100,1,191,11,53,1,65
test4sub2of100,test4pub87of100,1,191,11,55,1,67
test4sub25of100,test4pub87of100,1,191,11,57,1,69
test4sub43of100,test4pub87of100,1,191,11,58,2,71
test4sub55of100,test4pub87of100,1,191,11,59,1,71
test4sub96of100,test4pub87of100,1,191,11,61,2,74
test4sub100of100,test4pub87of100,1,191,11,61,1,73
test4sub78of100,test4pub87of100,1,191,11,69,1,81
test4sub17of100,test4pub87of100,1,191,11,69,3,83
test4sub11of100,test4pub87of100,1,191,11,71,3,85
test4sub46of100,test4pub87of100,1,191,11,71,3,85
test4sub84of100,test4pub87of100,1,191,11,70,4,85
test4sub37of100,test4pub87of100,1,191,11,72,2,85
test4sub80of100,test4pub87of100,1,191,11,73,1,85
test4sub49of100,test4pub87of100,1,191,11,77,1,89
test4sub36of100,test4pub87of100,1,191,11,77,1,89
test4sub67of100,test4pub87of100,1,191,11,80,2,93
test4sub5of100,test4pub87of100,1,191,11,79,2,92
test4sub59of100,test4pub87of100,1,191,11,81,2,94
test4sub16of100,test4pub87of100,1,191,11,81,2,94
test4sub20of100,test4pub87of100,1,191,11,84,1,96
test4sub58of100,test4pub87of100,1,191,11,84,2,97
test4sub94of100,test4pub87of100,1,191,11,85,1,97
test4sub14of100,test4pub87of100,1,191,11,89,1,101
test4sub29of100,test4pub87of100,1,191,11,91,0,102
test4sub6of100,test4pub87of100,1,191,11,92,1,104
test4sub15of100,test4pub87of100,1,191,11,96,1,108
test4sub91of100,test4pub87of100,1,191,11,96,1,108
test4sub93of100,test4pub87of100,1,191,11,98,1,110
test4sub10of100,test4pub87of100,1,191,11,99,1,111
test4sub21of100,test4pub87of100,1,191,11,100,1,112
test4sub32of100,test4pub87of100,1,191,11,101,2,114
test4sub40of100,test4pub87of100,1,191,11,102,1,114
test4sub63of100,test4pub87of100,1,191,11,103,2,116
test4sub54of100,test4pub87of100,1,191,11,103,1,115
test4sub22of100,test4pub87of100,1,191,11,107,1,119
test4sub56of100,test4pub87of100,1,191,11,108,1,120
test4sub53of100,test4pub87of100,1,191,11,109,1,121
test4sub3of100,test4pub87of100,1,191,11,111,0,122
test4sub27of100,test4pub87of100,1,191,11,116,0,127
test4sub34of100,test4pub87of100,1,191,11,118,1,130
test4sub45of100,test4pub87of100,1,191,11,118,3,132
test4sub75of100,test4pub87of100,1,191,11,119,2,132
test4sub51of100,test4pub87of100,1,191,11,120,2,133
test4sub39of100,test4pub87of100,1,191,11,121,3,135
test4sub61of100,test4pub87of100,1,191,11,122,1,134
test4sub79of100,test4pub87of100,1,191,11,126,1,138
test4sub95of100,test4pub87of100,1,191,11,128,2,141
test4sub18of100,test4pub87of100,1,191,11,129,2,142
test4sub90of100,test4pub87of100,1,191,11,130,3,144
test4sub12of100,test4pub87of100,1,191,11,132,2,145
test4sub65of100,test4pub87of100,1,191,11,132,3,146
test4sub69of100,test4pub87of100,1,191,11,133,3,147
test4sub98of100,test4pub87of100,1,191,11,134,1,146
test4sub77of100,test4pub87of100,1,191,11,135,2,148
test4sub9of100,test4pub87of100,1,191,11,137,0,148
test4sub92of100,test4pub87of100,1,191,11,140,1,152
test4sub81of100,test4pub87of100,1,191,11,141,0,152
test4sub7of100,test4pub87of100,1,191,11,143,1,155
test4sub30of100,test4pub87of100,1,191,11,329,1,341
test4sub85of100,test4pub87of100,1,191,11,329,1,341
test4sub31of100,test4pub87of100,1,191,11,343,1,355
test4sub87of100,test4pub87of100,1,191,11,353,1,365
test4sub8of100,test4pub87of100,1,191,11,354,1,366
test4sub68of100,test4pub87of100,1,191,11,357,1,369
test4sub83of100,test4pub87of100,1,191,11,366,1,378
test4sub60of100,test4pub87of100,1,191,11,368,1,380
test4sub28of100,test4pub87of100,1,191,11,373,1,385
test4sub1of100,test4pub87of100,1,191,11,375,1,387
test4sub57of100,test4pub87of100,1,191,11,380,0,391
test4sub73of100,test4pub87of100,1,191,11,382,1,394
test4sub47of100,test4pub87of100,1,191,11,383,1,395
test4sub89of100,test4pub87of100,1,191,11,384,1,396
test4sub23of100,test4pub87of100,1,191,11,394,1,406
test4sub99of100,test4pub87of100,1,191,11,395,1,407
test4sub19of100,test4pub87of100,1,191,11,396,1,408
test4sub74of100,test4pub87of100,1,191,11,400,1,412
test4sub64of100,test4pub87of100,1,191,11,400,1,412
test4sub52of100,test4pub87of100,1,191,11,409,0,420
test4sub4of100,test4pub87of100,1,191,11,417,1,429
test4sub21of100,test4pub88of100,1,191,12,5,0,17
test4sub41of100,test4pub88of100,1,191,12,6,1,19
test4sub8of100,test4pub88of100,1,191,12,8,1,21
test4sub49of100,test4pub88of100,1,191,12,17,1,30
test4sub91of100,test4pub88of100,1,191,12,17,1,30
test4sub53of100,test4pub88of100,1,191,12,21,1,34
test4sub52of100,test4pub88of100,1,191,12,25,1,38
test4sub20of100,test4pub88of100,1,191,12,31,1,44
test4sub99of100,test4pub88of100,1,191,12,31,1,44
test4sub56of100,test4pub88of100,1,191,12,35,1,48
test4sub34of100,test4pub88of100,1,191,12,37,1,50
test4sub82of100,test4pub88of100,1,191,12,36,2,50
test4sub94of100,test4pub88of100,1,191,12,66,1,79
test4sub54of100,test4pub88of100,1,191,12,66,2,80
test4sub83of100,test4pub88of100,1,191,12,67,1,80
test4sub62of100,test4pub88of100,1,191,12,69,0,81
test4sub84of100,test4pub88of100,1,191,12,74,1,87
test4sub30of100,test4pub88of100,1,191,12,83,1,96
test4sub27of100,test4pub88of100,1,191,12,86,1,99
test4sub13of100,test4pub88of100,1,191,12,92,1,105
test4sub32of100,test4pub88of100,1,191,12,99,0,111
test4sub43of100,test4pub88of100,1,191,12,104,0,116
test4sub44of100,test4pub88of100,1,191,12,108,1,121
test4sub5of100,test4pub88of100,1,191,12,109,1,122
test4sub60of100,test4pub88of100,1,191,12,116,7,135
test4sub1of100,test4pub88of100,1,191,12,117,7,136
test4sub78of100,test4pub88of100,1,191,12,118,6,136
test4sub58of100,test4pub88of100,1,191,12,118,7,137
test4sub86of100,test4pub88of100,1,191,12,119,8,139
test4sub16of100,test4pub88of100,1,191,12,119,8,139
test4sub66of100,test4pub88of100,1,191,12,120,8,140
test4sub67of100,test4pub88of100,1,191,12,121,8,141
test4sub17of100,test4pub88of100,1,191,12,122,9,143
test4sub18of100,test4pub88of100,1,191,12,122,9,143
test4sub89of100,test4pub88of100,1,191,12,123,9,144
test4sub4of100,test4pub88of100,1,191,12,126,6,144
test4sub26of100,test4pub88of100,1,191,12,127,6,145
test4sub7of100,test4pub88of100,1,191,12,129,6,147
test4sub69of100,test4pub88of100,1,191,12,129,5,146
test4sub68of100,test4pub88of100,1,191,12,130,5,147
test4sub35of100,test4pub88of100,1,191,12,131,4,147
test4sub74of100,test4pub88of100,1,191,12,133,3,148
test4sub48of100,test4pub88of100,1,191,12,134,4,150
test4sub95of100,test4pub88of100,1,191,12,138,4,154
test4sub57of100,test4pub88of100,1,191,12,136,6,154
test4sub23of100,test4pub88of100,1,191,12,138,4,154
test4sub72of100,test4pub88of100,1,191,12,139,6,157
test4sub6of100,test4pub88of100,1,191,12,139,7,158
test4sub28of100,test4pub88of100,1,191,12,140,7,159
test4sub46of100,test4pub88of100,1,191,12,141,7,160
test4sub33of100,test4pub88of100,1,191,12,141,7,160
test4sub80of100,test4pub88of100,1,191,12,143,7,162
test4sub50of100,test4pub88of100,1,191,12,143,7,162
test4sub51of100,test4pub88of100,1,191,12,144,8,164
test4sub85of100,test4pub88of100,1,191,12,145,9,166
test4sub71of100,test4pub88of100,1,191,12,146,8,166
test4sub40of100,test4pub88of100,1,191,12,148,6,166
test4sub2of100,test4pub88of100,1,191,12,149,5,166
test4sub45of100,test4pub88of100,1,191,12,149,6,167
test4sub22of100,test4pub88of100,1,191,12,152,4,168
test4sub73of100,test4pub88of100,1,191,12,152,4,168
test4sub15of100,test4pub88of100,1,191,12,155,1,168
test4sub75of100,test4pub88of100,1,191,12,162,1,175
test4sub93of100,test4pub88of100,1,191,12,163,1,176
test4sub76of100,test4pub88of100,1,191,12,333,1,346
test4sub3of100,test4pub88of100,1,191,12,339,1,352
test4sub90of100,test4pub88of100,1,191,12,341,0,353
test4sub97of100,test4pub88of100,1,191,12,343,0,355
test4sub12of100,test4pub88of100,1,191,12,348,1,361
test4sub9of100,test4pub88of100,1,191,12,350,1,363
test4sub31of100,test4pub88of100,1,191,12,352,2,366
test4sub63of100,test4pub88of100,1,191,12,353,3,368
test4sub70of100,test4pub88of100,1,191,12,353,2,367
test4sub98of100,test4pub88of100,1,191,12,355,2,369
test4sub64of100,test4pub88of100,1,191,12,357,1,370
test4sub65of100,test4pub88of100,1,191,12,359,0,371
test4sub29of100,test4pub88of100,1,191,12,365,1,378
test4sub81of100,test4pub88of100,1,191,12,366,0,378
test4sub38of100,test4pub88of100,1,191,12,378,1,391
test4sub42of100,test4pub88of100,1,191,12,381,1,394
test4sub14of100,test4pub88of100,1,191,12,381,1,394
test4sub10of100,test4pub88of100,1,191,12,383,1,396
test4sub24of100,test4pub88of100,1,191,12,386,3,401
test4sub77of100,test4pub88of100,1,191,12,386,4,402
test4sub37of100,test4pub88of100,1,191,12,387,3,402
test4sub11of100,test4pub88of100,1,191,12,388,3,403
test4sub55of100,test4pub88of100,1,191,12,388,3,403
test4sub36of100,test4pub88of100,1,191,12,389,2,403
test4sub100of100,test4pub88of100,1,191,12,393,3,408
test4sub39of100,test4pub88of100,1,191,12,394,2,408
test4sub19of100,test4pub88of100,1,191,12,395,2,409
test4sub88of100,test4pub88of100,1,191,12,395,2,409
test4sub92of100,test4pub88of100,1,191,12,399,1,412
test4sub47of100,test4pub88of100,1,191,12,399,1,412
test4sub87of100,test4pub88of100,1,191,12,403,1,416
test4sub25of100,test4pub88of100,1,191,12,414,0,426
test4sub79of100,test4pub88of100,1,191,12,418,0,430
test4sub96of100,test4pub88of100,1,191,12,420,1,433
test4sub59of100,test4pub88of100,1,191,12,421,1,434
test4sub61of100,test4pub88of100,1,191,12,422,0,434
test4sub12of100,test4pub89of100,1,191,17,5,1,23
test4sub24of100,test4pub89of100,1,191,17,11,0,28
test4sub8of100,test4pub89of100,1,191,17,14,0,31
test4sub79of100,test4pub89of100,1,191,17,16,0,33
test4sub67of100,test4pub89of100,1,191,17,20,1,38
test4sub21of100,test4pub89of100,1,191,17,23,1,41
test4sub28of100,test4pub89of100,1,191,17,26,1,44
test4sub13of100,test4pub89of100,1,191,17,27,2,46
test4sub1of100,test4pub89of100,1,191,17,29,1,47
test4sub56of100,test4pub89of100,1,191,17,31,1,49
test4sub60of100,test4pub89of100,1,191,17,37,2,56
test4sub18of100,test4pub89of100,1,191,17,38,0,55
test4sub43of100,test4pub89of100,1,191,17,41,1,59
test4sub23of100,test4pub89of100,1,191,17,42,1,60
test4sub7of100,test4pub89of100,1,191,17,44,1,62
test4sub52of100,test4pub89of100,1,191,17,49,1,67
test4sub26of100,test4pub89of100,1,191,17,49,1,67
test4sub30of100,test4pub89of100,1,191,17,50,2,69
test4sub75of100,test4pub89of100,1,191,17,52,1,70
test4sub4of100,test4pub89of100,1,191,17,58,0,75
test4sub85of100,test4pub89of100,1,191,17,60,2,79
test4sub57of100,test4pub89of100,1,191,17,61,1,79
test4sub35of100,test4pub89of100,1,191,17,63,0,80
test4sub88of100,test4pub89of100,1,191,17,68,1,86
test4sub91of100,test4pub89of100,1,191,17,68,1,86
test4sub10of100,test4pub89of100,1,191,17,71,0,88
test4sub6of100,test4pub89of100,1,191,17,71,2,90
test4sub45of100,test4pub89of100,1,191,17,73,2,92
test4sub61of100,test4pub89of100,1,191,17,73,2,92
test4sub96of100,test4pub89of100,1,191,17,74,1,92
test4sub22of100,test4pub89of100,1,191,17,105,1,123
test4sub48of100,test4pub89of100,1,191,17,107,0,124
test4sub42of100,test4pub89of100,1,191,17,108,1,126
test4sub33of100,test4pub89of100,1,191,17,112,1,130
test4sub99of100,test4pub89of100,1,191,17,114,1,132
test4sub69of100,test4pub89of100,1,191,17,115,1,133
test4sub16of100,test4pub89of100,1,191,17,117,1,135
test4sub31of100,test4pub89of100,1,191,17,119,1,137
test4sub89of100,test4pub89of100,1,191,17,121,1,139
test4sub73of100,test4pub89of100,1,191,17,122,1,140
test4sub9of100,test4pub89of100,1,191,17,126,1,144
test4sub98of100,test4pub89of100,1,191,17,126,2,145
test4sub29of100,test4pub89of100,1,191,17,127,1,145
test4sub100of100,test4pub89of100,1,191,17,128,1,146
test4sub41of100,test4pub89of100,1,191,17,133,1,151
test4sub77of100,test4pub89of100,1,191,17,133,1,151
test4sub15of100,test4pub89of100,1,191,17,136,1,154
test4sub71of100,test4pub89of100,1,191,17,136,3,156
test4sub19of100,test4pub89of100,1,191,17,137,2,156
test4sub82of100,test4pub89of100,1,191,17,139,2,158
test4sub94of100,test4pub89of100,1,191,17,138,5,160
test4sub86of100,test4pub89of100,1,191,17,139,5,161
test4sub44of100,test4pub89of100,1,191,17,140,3,160
test4sub76of100,test4pub89of100,1,191,17,141,3,161
test4sub2of100,test4pub89of100,1,191,17,142,2,161
test4sub80of100,test4pub89of100,1,191,17,145,2,164
test4sub50of100,test4pub89of100,1,191,17,145,2,164
test4sub14of100,test4pub89of100,1,191,17,147,1,165
test4sub78of100,test4pub89of100,1,191,17,147,2,166
test4sub37of100,test4pub89of100,1,191,17,149,2,168
test4sub58of100,test4pub89of100,1,191,17,150,3,170
test4sub65of100,test4pub89of100,1,191,17,151,3,171
test4sub47of100,test4pub89of100,1,191,17,151,3,171
test4sub92of100,test4pub89of100,1,191,17,152,3,172
test4sub97of100,test4pub89of100,1,191,17,153,2,172
test4sub55of100,test4pub89of100,1,191,17,155,0,172
test4sub39of100,test4pub89of100,1,191,17,158,1,176
test4sub17of100,test4pub89of100,1,191,17,159,2,178
test4sub36of100,test4pub89of100,1,191,17,160,1,178
test4sub90of100,test4pub89of100,1,191,17,160,2,179
test4sub40of100,test4pub89of100,1,191,17,161,1,179
test4sub63of100,test4pub89of100,1,191,17,165,1,183
test4sub59of100,test4pub89of100,1,191,17,167,1,185
test4sub62of100,test4pub89of100,1,191,17,170,2,189
test4sub70of100,test4pub89of100,1,191,17,170,2,189
test4sub74of100,test4pub89of100,1,191,17,171,2,190
test4sub11of100,test4pub89of100,1,191,17,171,2,190
test4sub27of100,test4pub89of100,1,191,17,173,1,191
test4sub34of100,test4pub89of100,1,191,17,174,1,192
test4sub20of100,test4pub89of100,1,191,17,354,0,371
test4sub66of100,test4pub89of100,1,191,17,365,0,382
test4sub83of100,test4pub89of100,1,191,17,375,1,393
test4sub3of100,test4pub89of100,1,191,17,376,1,394
test4sub51of100,test4pub89of100,1,191,17,380,0,397
test4sub64of100,test4pub89of100,1,191,17,386,1,404
test4sub38of100,test4pub89of100,1,191,17,387,0,404
test4sub46of100,test4pub89of100,1,191,17,389,1,407
test4sub8of100,test4pub90of100,1,191,17,23,1,41
test4sub81of100,test4pub89of100,1,191,17,391,1,409
test4sub70of100,test4pub90of100,1,191,17,32,1,50
test4sub55of100,test4pub90of100,1,191,17,33,1,51
test4sub68of100,test4pub89of100,1,191,17,401,3,421
test4sub72of100,test4pub89of100,1,191,17,409,1,427
test4sub87of100,test4pub89of100,1,191,17,421,1,439
test4sub88of100,test4pub90of100,1,191,17,64,1,82
test4sub80of100,test4pub90of100,1,191,17,64,2,83
test4sub42of100,test4pub90of100,1,191,17,65,2,84
test4sub53of100,test4pub89of100,1,191,17,433,1,451
test4sub32of100,test4pub89of100,1,191,17,437,0,454
test4sub90of100,test4pub90of100,1,191,17,71,1,89
test4sub16of100,test4pub90of100,1,191,17,72,1,90
test4sub54of100,test4pub89of100,1,191,17,441,1,459
test4sub49of100,test4pub89of100,1,191,17,448,1,466
test4sub5of100,test4pub89of100,1,191,17,448,1,466
test4sub47of100,test4pub90of100,1,191,17,87,0,104
test4sub69of100,test4pub90of100,1,191,17,90,2,109
test4sub11of100,test4pub90of100,1,191,17,91,1,109
test4sub17of100,test4pub90of100,1,191,17,95,0,112
test4sub95of100,test4pub89of100,1,191,17,462,1,480
test4sub92of100,test4pub90of100,1,191,17,97,0,114
test4sub18of100,test4pub90of100,1,191,17,98,1,116
test4sub25of100,test4pub89of100,1,191,17,471,1,489
test4sub93of100,test4pub89of100,1,191,17,472,1,490
test4sub57of100,test4pub90of100,1,191,17,106,1,124
test4sub76of100,test4pub90of100,1,191,17,108,1,126
test4sub33of100,test4pub90of100,1,191,17,108,1,126
test4sub82of100,test4pub90of100,1,191,17,112,1,130
test4sub68of100,test4pub90of100,1,191,17,126,2,145
test4sub81of100,test4pub90of100,1,191,17,126,4,147
test4sub78of100,test4pub90of100,1,191,17,127,3,147
test4sub64of100,test4pub90of100,1,191,17,127,4,148
test4sub84of100,test4pub89of100,1,191,17,495,3,515
test4sub94of100,test4pub90of100,1,191,17,130,1,148
test4sub9of100,test4pub90of100,1,191,17,135,1,153
test4sub79of100,test4pub90of100,1,191,17,136,1,154
test4sub73of100,test4pub90of100,1,191,17,139,1,157
test4sub96of100,test4pub90of100,1,191,17,149,0,166
test4sub46of100,test4pub90of100,1,191,17,151,1,169
test4sub75of100,test4pub90of100,1,191,17,152,1,170
test4sub56of100,test4pub90of100,1,191,17,162,0,179
test4sub7of100,test4pub90of100,1,191,17,162,1,180
test4sub15of100,test4pub90of100,1,191,17,166,1,184
test4sub35of100,test4pub90of100,1,191,17,167,2,186
test4sub24of100,test4pub90of100,1,191,17,168,3,188
test4sub98of100,test4pub90of100,1,191,17,168,4,189
test4sub22of100,test4pub90of100,1,191,17,169,4,190
test4sub31of100,test4pub90of100,1,191,17,170,3,190
test4sub14of100,test4pub90of100,1,191,17,171,3,191
test4sub87of100,test4pub90of100,1,191,17,172,2,191
test4sub74of100,test4pub90of100,1,191,17,176,1,194
test4sub50of100,test4pub90of100,1,191,17,178,1,196
test4sub10of100,test4pub90of100,1,191,17,180,1,198
test4sub27of100,test4pub90of100,1,191,17,181,0,198
test4sub38of100,test4pub90of100,1,191,17,189,1,207
test4sub34of100,test4pub90of100,1,191,17,192,1,210
test4sub52of100,test4pub90of100,1,191,17,194,1,212
test4sub77of100,test4pub90of100,1,191,17,195,1,213
test4sub40of100,test4pub90of100,1,191,17,196,2,215
test4sub58of100,test4pub90of100,1,191,17,197,1,215
test4sub4of100,test4pub90of100,1,191,17,198,1,216
test4sub53of100,test4pub90of100,1,191,17,200,0,217
test4sub2of100,test4pub90of100,1,191,17,214,1,232
test4sub99of100,test4pub90of100,1,191,17,226,0,243
test4sub62of100,test4pub90of100,1,191,17,229,1,247
test4sub21of100,test4pub90of100,1,191,17,229,3,249
test4sub37of100,test4pub90of100,1,191,17,230,2,249
test4sub60of100,test4pub90of100,1,191,17,231,2,250
test4sub86of100,test4pub90of100,1,191,17,231,1,249
test4sub28of100,test4pub90of100,1,191,17,236,1,254
test4sub65of100,test4pub90of100,1,191,17,244,1,262
test4sub44of100,test4pub90of100,1,191,17,244,2,263
test4sub13of100,test4pub90of100,1,191,17,245,1,263
test4sub32of100,test4pub90of100,1,191,17,254,0,271
test4sub59of100,test4pub90of100,1,191,17,255,1,273
test4sub12of100,test4pub90of100,1,191,17,261,0,278
test4sub71of100,test4pub90of100,1,191,17,262,1,280
test4sub61of100,test4pub90of100,1,191,17,263,0,280
test4sub91of100,test4pub90of100,1,191,17,265,0,282
test4sub39of100,test4pub90of100,1,191,17,265,1,283
test4sub97of100,test4pub90of100,1,191,17,275,1,293
test4sub29of100,test4pub90of100,1,191,17,282,0,299
test4sub48of100,test4pub90of100,1,191,17,289,2,308
test4sub5of100,test4pub90of100,1,191,17,289,2,308
test4sub3of100,test4pub90of100,1,191,17,290,1,308
test4sub49of100,test4pub90of100,1,191,17,291,1,309
test4sub41of100,test4pub90of100,1,191,17,292,1,310
test4sub45of100,test4pub90of100,1,191,17,304,1,322
test4sub89of100,test4pub90of100,1,191,17,305,1,323
test4sub100of100,test4pub90of100,1,191,17,308,1,326
test4sub63of100,test4pub90of100,1,191,17,315,1,333
test4sub30of100,test4pub90of100,1,191,17,321,1,339
test4sub72of100,test4pub90of100,1,191,17,334,0,351
test4sub1of100,test4pub90of100,1,191,17,339,1,357
test4sub83of100,test4pub90of100,1,191,17,340,1,358
test4sub51of100,test4pub90of100,1,191,17,346,1,364
test4sub23of100,test4pub90of100,1,191,17,349,0,366
test4sub26of100,test4pub90of100,1,191,17,350,0,367
test4sub19of100,test4pub90of100,1,191,17,359,1,377
test4sub20of100,test4pub90of100,1,191,17,366,1,384
test4sub95of100,test4pub90of100,1,191,17,377,1,395
test4sub36of100,test4pub90of100,1,191,17,384,1,402
test4sub43of100,test4pub90of100,1,191,17,390,1,408
test4sub54of100,test4pub90of100,1,191,17,390,1,408
test4sub67of100,test4pub90of100,1,191,17,396,1,414
test4sub85of100,test4pub90of100,1,191,17,401,1,419
test4sub66of100,test4pub90of100,1,191,17,402,1,420
test4sub6of100,test4pub90of100,1,191,17,403,0,420
test4sub25of100,test4pub90of100,1,191,17,403,1,421
test4sub93of100,test4pub90of100,1,191,17,405,0,422
test4sub84of100,test4pub90of100,1,191,17,409,1,427
test4sub35of100,test4pub91of100,1,191,11,7,1,19
test4sub36of100,test4pub91of100,1,191,11,11,0,22
test4sub16of100,test4pub91of100,1,191,11,13,1,25
test4sub61of100,test4pub91of100,1,191,11,17,1,29
test4sub1of100,test4pub91of100,1,191,11,20,1,32
test4sub75of100,test4pub91of100,1,191,11,22,1,34
test4sub66of100,test4pub91of100,1,191,11,24,2,37
test4sub52of100,test4pub91of100,1,191,11,24,1,36
test4sub45of100,test4pub91of100,1,191,11,25,1,37
test4sub30of100,test4pub91of100,1,191,11,32,2,45
test4sub95of100,test4pub91of100,1,191,11,34,1,46
test4sub12of100,test4pub91of100,1,191,11,38,1,50
test4sub62of100,test4pub91of100,1,191,11,39,1,51
test4sub69of100,test4pub91of100,1,191,11,40,0,51
test4sub94of100,test4pub91of100,1,191,11,46,0,57
test4sub93of100,test4pub91of100,1,191,11,51,1,63
test4sub29of100,test4pub91of100,1,191,11,53,1,65
test4sub32of100,test4pub91of100,1,191,11,53,4,68
test4sub74of100,test4pub91of100,1,191,11,54,3,68
test4sub19of100,test4pub91of100,1,191,11,55,2,68
test4sub48of100,test4pub91of100,1,191,11,56,2,69
test4sub14of100,test4pub91of100,1,191,11,56,2,69
test4sub76of100,test4pub91of100,1,191,11,59,1,71
test4sub40of100,test4pub91of100,1,191,11,64,1,76
test4sub85of100,test4pub91of100,1,191,11,65,2,78
test4sub3of100,test4pub91of100,1,191,11,66,1,78
test4sub17of100,test4pub91of100,1,191,11,76,1,88
test4sub72of100,test4pub91of100,1,191,11,78,1,90
test4sub91of100,test4pub91of100,1,191,11,77,2,90
test4sub80of100,test4pub91of100,1,191,11,84,1,96
test4sub38of100,test4pub91of100,1,191,11,84,0,95
test4sub41of100,test4pub91of100,1,191,11,86,2,99
test4sub11of100,test4pub91of100,1,191,11,87,2,100
test4sub50of100,test4pub91of100,1,191,11,87,1,99
test4sub7of100,test4pub91of100,1,191,11,90,1,102
test4sub71of100,test4pub91of100,1,191,11,90,1,102
test4sub34of100,test4pub91of100,1,191,11,91,1,103
test4sub99of100,test4pub91of100,1,191,11,97,0,108
test4sub58of100,test4pub91of100,1,191,11,103,1,115
test4sub23of100,test4pub91of100,1,191,11,119,3,133
test4sub81of100,test4pub91of100,1,191,11,120,3,134
test4sub83of100,test4pub91of100,1,191,11,121,3,135
test4sub31of100,test4pub91of100,1,191,11,122,4,137
test4sub100of100,test4pub91of100,1,191,11,119,7,137
test4sub88of100,test4pub91of100,1,191,11,120,8,139
test4sub68of100,test4pub91of100,1,191,11,122,10,143
test4sub46of100,test4pub91of100,1,191,11,122,10,143
test4sub4of100,test4pub91of100,1,191,11,124,8,143
test4sub60of100,test4pub91of100,1,191,11,124,8,143
test4sub28of100,test4pub91of100,1,191,11,126,7,144
test4sub33of100,test4pub91of100,1,191,11,127,6,144
test4sub21of100,test4pub91of100,1,191,11,128,6,145
test4sub22of100,test4pub91of100,1,191,11,129,6,146
test4sub2of100,test4pub91of100,1,191,11,129,5,145
test4sub37of100,test4pub91of100,1,191,11,130,4,145
test4sub97of100,test4pub91of100,1,191,11,130,5,146
test4sub51of100,test4pub91of100,1,191,11,131,5,147
test4sub53of100,test4pub91of100,1,191,11,131,5,147
test4sub25of100,test4pub91of100,1,191,11,140,1,152
test4sub20of100,test4pub91of100,1,191,11,140,4,155
test4sub54of100,test4pub91of100,1,191,11,141,2,154
test4sub6of100,test4pub91of100,1,191,11,142,3,156
test4sub79of100,test4pub91of100,1,191,11,142,3,156
test4sub73of100,test4pub91of100,1,191,11,142,3,156
test4sub92of100,test4pub91of100,1,191,11,141,3,155
test4sub98of100,test4pub91of100,1,191,11,330,1,342
test4sub83of100,test4pub92of100,1,191,13,11,1,25
test4sub64of100,test4pub91of100,1,191,11,339,1,351
test4sub71of100,test4pub92of100,1,191,13,17,1,31
test4sub24of100,test4pub91of100,1,191,11,343,1,355
test4sub69of100,test4pub92of100,1,191,13,17,1,31
test4sub38of100,test4pub92of100,1,191,13,19,1,33
test4sub25of100,test4pub92of100,1,191,13,20,1,34
test4sub65of100,test4pub91of100,1,191,11,351,1,363
test4sub42of100,test4pub91of100,1,191,11,355,0,366
test4sub56of100,test4pub91of100,1,191,11,359,1,371
test4sub77of100,test4pub91of100,1,191,11,363,1,375
test4sub100of100,test4pub92of100,1,191,13,38,1,52
test4sub37of100,test4pub92of100,1,191,13,39,2,54
test4sub8of100,test4pub91of100,1,191,11,367,2,380
test4sub32of100,test4pub92of100,1,191,13,40,1,54
test4sub11of100,test4pub92of100,1,191,13,42,1,56
test4sub35of100,test4pub92of100,1,191,13,43,1,57
test4sub87of100,test4pub91of100,1,191,11,371,1,383
test4sub57of100,test4pub91of100,1,191,11,371,3,385
test4sub91of100,test4pub92of100,1,191,13,46,2,61
test4sub95of100,test4pub92of100,1,191,13,47,2,62
test4sub45of100,test4pub92of100,1,191,13,48,2,63
test4sub13of100,test4pub91of100,1,191,11,377,2,390
test4sub18of100,test4pub91of100,1,191,11,378,2,391
test4sub88of100,test4pub92of100,1,191,13,51,2,66
test4sub59of100,test4pub91of100,1,191,11,379,3,393
test4sub15of100,test4pub91of100,1,191,11,380,3,394
test4sub4of100,test4pub92of100,1,191,13,54,2,69
test4sub68of100,test4pub92of100,1,191,13,55,2,70
test4sub2of100,test4pub92of100,1,191,13,56,2,71
test4sub21of100,test4pub92of100,1,191,13,68,0,81
test4sub75of100,test4pub92of100,1,191,13,70,0,83
test4sub17of100,test4pub92of100,1,191,13,72,3,88
test4sub10of100,test4pub91of100,1,191,11,400,3,414
test4sub96of100,test4pub91of100,1,191,11,400,2,413
test4sub70of100,test4pub91of100,1,191,11,401,2,414
test4sub47of100,test4pub91of100,1,191,11,401,3,415
test4sub90of100,test4pub91of100,1,191,11,402,2,415
test4sub74of100,test4pub92of100,1,191,13,79,1,93
test4sub29of100,test4pub92of100,1,191,13,78,3,94
test4sub78of100,test4pub91of100,1,191,11,407,1,419
test4sub5of100,test4pub91of100,1,191,11,407,1,419
test4sub82of100,test4pub91of100,1,191,11,410,1,422
test4sub1of100,test4pub92of100,1,191,13,84,1,98
test4sub16of100,test4pub92of100,1,191,13,87,0,100
test4sub66of100,test4pub92of100,1,191,13,92,2,107
test4sub60of100,test4pub92of100,1,191,13,92,2,107
test4sub7of100,test4pub92of100,1,191,13,93,1,107
test4sub44of100,test4pub91of100,1,191,11,421,2,434
test4sub55of100,test4pub91of100,1,191,11,423,1,435
test4sub34of100,test4pub92of100,1,191,13,97,2,112
test4sub9of100,test4pub91of100,1,191,11,425,1,437
test4sub52of100,test4pub92of100,1,191,13,99,1,113
test4sub22of100,test4pub92of100,1,191,13,106,1,120
test4sub93of100,test4pub92of100,1,191,13,107,1,121
test4sub73of100,test4pub92of100,1,191,13,108,1,122
test4sub56of100,test4pub92of100,1,191,13,110,0,123
test4sub3of100,test4pub92of100,1,191,13,112,1,126
test4sub31of100,test4pub92of100,1,191,13,112,3,128
test4sub49of100,test4pub91of100,1,191,11,441,4,456
test4sub99of100,test4pub92of100,1,191,13,114,4,131
test4sub76of100,test4pub92of100,1,191,13,115,4,132
test4sub23of100,test4pub92of100,1,191,13,116,3,132
test4sub81of100,test4pub92of100,1,191,13,116,4,133
test4sub27of100,test4pub91of100,1,191,11,444,6,461
test4sub87of100,test4pub92of100,1,191,13,117,7,137
test4sub62of100,test4pub92of100,1,191,13,117,6,136
test4sub42of100,test4pub92of100,1,191,13,120,5,138
test4sub51of100,test4pub92of100,1,191,13,121,4,138
test4sub57of100,test4pub92of100,1,191,13,121,4,138
test4sub18of100,test4pub92of100,1,191,13,122,4,139
test4sub59of100,test4pub92of100,1,191,13,122,4,139
test4sub64of100,test4pub92of100,1,191,13,124,4,141
test4sub15of100,test4pub92of100,1,191,13,128,1,142
test4sub28of100,test4pub92of100,1,191,13,127,1,141
test4sub94of100,test4pub92of100,1,191,13,134,0,147
test4sub80of100,test4pub92of100,1,191,13,135,2,150
test4sub46of100,test4pub92of100,1,191,13,136,2,151
test4sub48of100,test4pub92of100,1,191,13,136,2,151
test4sub98of100,test4pub92of100,1,191,13,137,2,152
test4sub61of100,test4pub92of100,1,191,13,138,0,151
test4sub65of100,test4pub92of100,1,191,13,138,2,153
test4sub70of100,test4pub92of100,1,191,13,141,2,156
test4sub90of100,test4pub92of100,1,191,13,142,2,157
test4sub26of100,test4pub91of100,1,191,11,469,2,482
test4sub5of100,test4pub92of100,1,191,13,143,1,157
test4sub84of100,test4pub91of100,1,191,11,480,1,492
test4sub44of100,test4pub92of100,1,191,13,153,2,168
test4sub55of100,test4pub92of100,1,191,13,154,1,168
test4sub9of100,test4pub92of100,1,191,13,155,1,169
test4sub72of100,test4pub92of100,1,191,13,158,1,172
test4sub49of100,test4pub92of100,1,191,13,159,2,174
test4sub43of100,test4pub91of100,1,191,11,487,2,500
test4sub36of100,test4pub92of100,1,191,13,419,1,433
test4sub27of100,test4pub92of100,1,191,13,161,1,175
test4sub85of100,test4pub92of100,1,191,13,173,1,187
test4sub67of100,test4pub91of100,1,191,11,533,1,545
test4sub8of100,test4pub92of100,1,191,13,323,1,337
test4sub14of100,test4pub92of100,1,191,13,339,0,352
test4sub79of100,test4pub92of100,1,191,13,343,0,356
test4sub33of100,test4pub92of100,1,191,13,350,1,364
test4sub40of100,test4pub92of100,1,191,13,352,0,365
test4sub24of100,test4pub92of100,1,191,13,359,1,373
test4sub12of100,test4pub92of100,1,191,13,360,1,374
test4sub58of100,test4pub92of100,1,191,13,364,1,378
test4sub97of100,test4pub92of100,1,191,13,364,1,378
test4sub92of100,test4pub92of100,1,191,13,366,1,380
test4sub41of100,test4pub92of100,1,191,13,369,1,383
test4sub77of100,test4pub92of100,1,191,13,372,1,386
test4sub50of100,test4pub92of100,1,191,13,383,0,396
test4sub13of100,test4pub92of100,1,191,13,387,1,401
test4sub53of100,test4pub92of100,1,191,13,395,1,409
test4sub10of100,test4pub92of100,1,191,13,395,1,409
test4sub20of100,test4pub92of100,1,191,13,403,0,416
test4sub26of100,test4pub92of100,1,191,13,420,3,436
test4sub84of100,test4pub92of100,1,191,13,421,3,437
test4sub43of100,test4pub92of100,1,191,13,422,2,437
test4sub67of100,test4pub92of100,1,191,13,423,2,438
test4sub30of100,test4pub92of100,1,191,13,428,0,441
test4sub54of100,test4pub92of100,1,191,13,443,0,456
test4sub19of100,test4pub92of100,1,191,13,471,1,485
test4sub55of100,test4pub93of100,1,191,14,7,1,22
test4sub75of100,test4pub93of100,1,191,14,10,1,25
test4sub54of100,test4pub93of100,1,191,14,10,1,25
test4sub70of100,test4pub93of100,1,191,14,15,1,30
test4sub71of100,test4pub93of100,1,191,14,16,1,31
test4sub53of100,test4pub93of100,1,191,14,17,2,33
test4sub64of100,test4pub93of100,1,191,14,17,1,32
test4sub29of100,test4pub93of100,1,191,14,21,0,35
test4sub79of100,test4pub93of100,1,191,14,21,1,36
test4sub97of100,test4pub93of100,1,191,14,24,0,38
test4sub65of100,test4pub93of100,1,191,14,26,0,40
test4sub4of100,test4pub93of100,1,191,14,28,1,43
test4sub22of100,test4pub93of100,1,191,14,30,1,45
test4sub48of100,test4pub93of100,1,191,14,37,1,52
test4sub67of100,test4pub93of100,1,191,14,38,2,54
test4sub25of100,test4pub93of100,1,191,14,39,1,54
test4sub88of100,test4pub93of100,1,191,14,40,1,55
test4sub16of100,test4pub93of100,1,191,14,40,1,55
test4sub21of100,test4pub93of100,1,191,14,43,2,59
test4sub10of100,test4pub93of100,1,191,14,44,2,60
test4sub26of100,test4pub93of100,1,191,14,46,1,61
test4sub6of100,test4pub92of100,1,191,13,526,1,540
test4sub37of100,test4pub93of100,1,191,14,48,2,64
test4sub32of100,test4pub93of100,1,191,14,50,1,65
test4sub31of100,test4pub93of100,1,191,14,50,2,66
test4sub35of100,test4pub93of100,1,191,14,52,1,67
test4sub66of100,test4pub93of100,1,191,14,53,2,69
test4sub7of100,test4pub93of100,1,191,14,54,1,69
test4sub13of100,test4pub93of100,1,191,14,64,1,79
test4sub61of100,test4pub93of100,1,191,14,68,0,82
test4sub93of100,test4pub93of100,1,191,14,69,1,84
test4sub92of100,test4pub93of100,1,191,14,70,2,86
test4sub45of100,test4pub93of100,1,191,14,71,3,88
test4sub57of100,test4pub93of100,1,191,14,72,2,88
test4sub1of100,test4pub93of100,1,191,14,73,1,88
test4sub68of100,test4pub93of100,1,191,14,74,2,90
test4sub85of100,test4pub93of100,1,191,14,78,1,93
test4sub81of100,test4pub93of100,1,191,14,82,0,96
test4sub36of100,test4pub93of100,1,191,14,84,0,98
test4sub9of100,test4pub93of100,1,191,14,83,2,99
test4sub46of100,test4pub93of100,1,191,14,87,1,102
test4sub84of100,test4pub93of100,1,191,14,87,7,108
test4sub14of100,test4pub93of100,1,191,14,91,3,108
test4sub73of100,test4pub93of100,1,191,14,92,2,108
test4sub24of100,test4pub93of100,1,191,14,93,2,109
test4sub80of100,test4pub93of100,1,191,14,99,1,114
test4sub30of100,test4pub93of100,1,191,14,99,24,137
test4sub34of100,test4pub93of100,1,191,14,110,13,137
test4sub19of100,test4pub93of100,1,191,14,112,13,139
test4sub51of100,test4pub93of100,1,191,14,113,13,140
test4sub44of100,test4pub93of100,1,191,14,113,13,140
test4sub52of100,test4pub93of100,1,191,14,114,14,142
test4sub87of100,test4pub93of100,1,191,14,114,15,143
test4sub38of100,test4pub93of100,1,191,14,115,15,144
test4sub33of100,test4pub93of100,1,191,14,114,16,144
test4sub72of100,test4pub93of100,1,191,14,115,16,145
test4sub18of100,test4pub93of100,1,191,14,116,17,147
test4sub17of100,test4pub93of100,1,191,14,116,16,146
test4sub6of100,test4pub93of100,1,191,14,117,17,148
test4sub40of100,test4pub93of100,1,191,14,117,17,148
test4sub3of100,test4pub93of100,1,191,14,118,18,150
test4sub76of100,test4pub93of100,1,191,14,118,18,150
test4sub15of100,test4pub93of100,1,191,14,119,19,152
test4sub91of100,test4pub93of100,1,191,14,119,18,151
test4sub62of100,test4pub93of100,1,191,14,120,19,153
test4sub100of100,test4pub93of100,1,191,14,119,19,152
test4sub43of100,test4pub93of100,1,191,14,121,19,154
test4sub74of100,test4pub93of100,1,191,14,158,0,172
test4sub41of100,test4pub93of100,1,191,14,161,0,175
test4sub60of100,test4pub93of100,1,191,14,167,1,182
test4sub49of100,test4pub93of100,1,191,14,169,2,185
test4sub83of100,test4pub93of100,1,191,14,170,2,186
test4sub58of100,test4pub93of100,1,191,14,169,4,187
test4sub42of100,test4pub93of100,1,191,14,170,4,188
test4sub98of100,test4pub93of100,1,191,14,171,3,188
test4sub94of100,test4pub93of100,1,191,14,168,8,190
test4sub27of100,test4pub93of100,1,191,14,172,3,189
test4sub95of100,test4pub93of100,1,191,14,173,3,190
test4sub90of100,test4pub93of100,1,191,14,174,3,191
test4sub86of100,test4pub91of100,1,191,11,983,0,994
test4sub47of100,test4pub92of100,1,191,13,672,2,687
test4sub96of100,test4pub92of100,1,191,13,673,1,687
test4sub47of100,test4pub93of100,1,191,14,196,3,213
test4sub82of100,test4pub92of100,1,191,13,675,3,691
test4sub78of100,test4pub92of100,1,191,13,675,3,691
test4sub96of100,test4pub93of100,1,191,14,198,3,215
test4sub86of100,test4pub92of100,1,191,13,676,4,693
test4sub82of100,test4pub93of100,1,191,14,200,2,216
test4sub78of100,test4pub93of100,1,191,14,201,2,217
test4sub86of100,test4pub93of100,1,191,14,203,0,217
test4sub39of100,test4pub91of100,1,191,11,1022,1,1034
test4sub39of100,test4pub92of100,1,191,13,697,1,711
test4sub39of100,test4pub93of100,1,191,14,220,1,235
test4sub63of100,test4pub91of100,1,191,11,1090,1,1102
test4sub63of100,test4pub92of100,1,191,13,766,1,780
test4sub63of100,test4pub93of100,1,191,14,289,0,303
test4sub77of100,test4pub93of100,1,191,14,332,1,347
test4sub56of100,test4pub93of100,1,191,14,334,0,348
test4sub8of100,test4pub93of100,1,191,14,335,0,349
test4sub69of100,test4pub93of100,1,191,14,340,2,356
test4sub50of100,test4pub93of100,1,191,14,341,2,357
test4sub12of100,test4pub93of100,1,191,14,342,2,358
test4sub11of100,test4pub93of100,1,191,14,346,1,361
test4sub89of100,test4pub91of100,1,191,11,1159,0,1170
test4sub59of100,test4pub93of100,1,191,14,357,2,373
test4sub28of100,test4pub93of100,1,191,14,357,2,373
test4sub5of100,test4pub93of100,1,191,14,368,1,383
test4sub99of100,test4pub93of100,1,191,14,370,1,385
test4sub66of100,test4pub94of100,1,191,18,17,2,37
test4sub89of100,test4pub92of100,1,191,13,849,1,863
test4sub89of100,test4pub93of100,1,191,14,373,1,388
test4sub43of100,test4pub94of100,1,191,18,22,1,41
test4sub42of100,test4pub94of100,1,191,18,26,1,45
test4sub71of100,test4pub94of100,1,191,18,27,1,46
test4sub78of100,test4pub94of100,1,191,18,29,1,48
test4sub35of100,test4pub94of100,1,191,18,30,1,49
test4sub41of100,test4pub94of100,1,191,18,33,1,52
test4sub6of100,test4pub94of100,1,191,18,34,1,53
test4sub2of100,test4pub93of100,1,191,14,387,2,403
test4sub30of100,test4pub94of100,1,191,18,38,0,56
test4sub63of100,test4pub94of100,1,191,18,39,0,57
test4sub64of100,test4pub94of100,1,191,18,40,1,59
test4sub37of100,test4pub94of100,1,191,18,52,1,71
test4sub33of100,test4pub94of100,1,191,18,56,1,75
test4sub11of100,test4pub94of100,1,191,18,57,1,76
test4sub73of100,test4pub94of100,1,191,18,61,1,80
test4sub54of100,test4pub94of100,1,191,18,63,1,82
test4sub65of100,test4pub94of100,1,191,18,64,3,85
test4sub67of100,test4pub94of100,1,191,18,64,3,85
test4sub88of100,test4pub94of100,1,191,18,65,3,86
test4sub1of100,test4pub94of100,1,191,18,66,3,87
test4sub100of100,test4pub94of100,1,191,18,66,4,88
test4sub84of100,test4pub94of100,1,191,18,64,5,87
test4sub70of100,test4pub94of100,1,191,18,68,3,89
test4sub90of100,test4pub94of100,1,191,18,69,2,89
test4sub2of100,test4pub94of100,1,191,18,72,1,91
test4sub7of100,test4pub94of100,1,191,18,76,0,94
test4sub39of100,test4pub94of100,1,191,18,79,0,97
test4sub83of100,test4pub94of100,1,191,18,81,1,100
test4sub40of100,test4pub94of100,1,191,18,81,2,101
test4sub82of100,test4pub94of100,1,191,18,82,1,101
test4sub5of100,test4pub94of100,1,191,18,91,2,111
test4sub9of100,test4pub94of100,1,191,18,92,2,112
test4sub50of100,test4pub94of100,1,191,18,94,7,119
test4sub44of100,test4pub94of100,1,191,18,94,8,120
test4sub20of100,test4pub93of100,1,191,14,449,7,470
test4sub51of100,test4pub94of100,1,191,18,95,7,120
test4sub74of100,test4pub94of100,1,191,18,94,7,119
test4sub79of100,test4pub94of100,1,191,18,97,7,122
test4sub58of100,test4pub94of100,1,191,18,98,7,123
test4sub45of100,test4pub94of100,1,191,18,98,8,124
test4sub36of100,test4pub94of100,1,191,18,96,8,122
test4sub53of100,test4pub94of100,1,191,18,95,8,121
test4sub18of100,test4pub94of100,1,191,18,99,8,125
test4sub22of100,test4pub94of100,1,191,18,100,7,125
test4sub31of100,test4pub94of100,1,191,18,101,7,126
test4sub98of100,test4pub94of100,1,191,18,102,7,127
test4sub16of100,test4pub94of100,1,191,18,103,5,126
test4sub4of100,test4pub94of100,1,191,18,105,5,128
test4sub38of100,test4pub94of100,1,191,18,109,1,128
test4sub89of100,test4pub94of100,1,191,18,114,0,132
test4sub76of100,test4pub94of100,1,191,18,114,1,133
test4sub93of100,test4pub94of100,1,191,18,116,1,135
test4sub75of100,test4pub94of100,1,191,18,117,1,136
test4sub13of100,test4pub94of100,1,191,18,119,1,138
test4sub99of100,test4pub94of100,1,191,18,120,2,140
test4sub55of100,test4pub94of100,1,191,18,121,0,139
test4sub92of100,test4pub94of100,1,191,18,126,1,145
test4sub24of100,test4pub94of100,1,191,18,131,1,150
test4sub96of100,test4pub94of100,1,191,18,131,1,150
test4sub77of100,test4pub94of100,1,191,18,134,1,153
test4sub21of100,test4pub94of100,1,191,18,134,2,154
test4sub48of100,test4pub94of100,1,191,18,135,3,156
test4sub81of100,test4pub94of100,1,191,18,136,3,157
test4sub14of100,test4pub94of100,1,191,18,138,2,158
test4sub85of100,test4pub94of100,1,191,18,137,6,161
test4sub17of100,test4pub94of100,1,191,18,139,7,164
test4sub56of100,test4pub94of100,1,191,18,140,6,164
test4sub61of100,test4pub94of100,1,191,18,141,7,166
test4sub15of100,test4pub94of100,1,191,18,141,8,167
test4sub87of100,test4pub94of100,1,191,18,142,8,168
test4sub94of100,test4pub94of100,1,191,18,143,9,170
test4sub23of100,test4pub93of100,1,191,14,498,8,520
test4sub28of100,test4pub94of100,1,191,18,145,10,173
test4sub91of100,test4pub94of100,1,191,18,145,11,174
test4sub34of100,test4pub94of100,1,191,18,146,14,178
test4sub26of100,test4pub94of100,1,191,18,147,14,179
test4sub27of100,test4pub94of100,1,191,18,148,13,179
test4sub68of100,test4pub94of100,1,191,18,152,10,180
test4sub32of100,test4pub94of100,1,191,18,153,10,181
test4sub95of100,test4pub94of100,1,191,18,154,8,180
test4sub3of100,test4pub94of100,1,191,18,154,9,181
test4sub8of100,test4pub94of100,1,191,18,155,9,182
test4sub49of100,test4pub94of100,1,191,18,155,8,181
test4sub12of100,test4pub94of100,1,191,18,157,8,183
test4sub72of100,test4pub94of100,1,191,18,158,6,182
test4sub97of100,test4pub94of100,1,191,18,159,5,182
test4sub29of100,test4pub94of100,1,191,18,160,5,183
test4sub19of100,test4pub94of100,1,191,18,160,5,183
test4sub62of100,test4pub94of100,1,191,18,159,5,182
test4sub23of100,test4pub94of100,1,191,18,177,1,196
test4sub10of100,test4pub94of100,1,191,18,367,1,386
test4sub69of100,test4pub94of100,1,191,18,372,1,391
test4sub60of100,test4pub94of100,1,191,18,380,1,399
test4sub80of100,test4pub94of100,1,191,18,383,1,402
test4sub46of100,test4pub94of100,1,191,18,385,1,404
test4sub52of100,test4pub94of100,1,191,18,386,1,405
test4sub59of100,test4pub94of100,1,191,18,389,1,408
test4sub47of100,test4pub94of100,1,191,18,391,1,410
test4sub57of100,test4pub94of100,1,191,18,404,1,423
test4sub86of100,test4pub94of100,1,191,18,406,1,425
test4sub44of100,test4pub95of100,1,191,10,6,1,17
test4sub70of100,test4pub95of100,1,191,10,8,1,19
test4sub96of100,test4pub95of100,1,191,10,18,0,28
test4sub98of100,test4pub95of100,1,191,10,20,0,30
test4sub65of100,test4pub95of100,1,191,10,22,0,32
test4sub78of100,test4pub95of100,1,191,10,24,1,35
test4sub24of100,test4pub95of100,1,191,10,27,1,38
test4sub52of100,test4pub95of100,1,191,10,29,2,41
test4sub93of100,test4pub95of100,1,191,10,30,2,42
test4sub40of100,test4pub95of100,1,191,10,30,1,41
test4sub9of100,test4pub95of100,1,191,10,30,2,42
test4sub22of100,test4pub95of100,1,191,10,35,2,47
test4sub7of100,test4pub95of100,1,191,10,35,3,48
test4sub21of100,test4pub95of100,1,191,10,36,2,48
test4sub30of100,test4pub95of100,1,191,10,36,2,48
test4sub94of100,test4pub95of100,1,191,10,37,2,49
test4sub4of100,test4pub95of100,1,191,10,37,3,50
test4sub68of100,test4pub95of100,1,191,10,40,3,53
test4sub66of100,test4pub95of100,1,191,10,41,3,54
test4sub11of100,test4pub95of100,1,191,10,42,3,55
test4sub51of100,test4pub95of100,1,191,10,43,3,56
test4sub61of100,test4pub95of100,1,191,10,43,3,56
test4sub39of100,test4pub95of100,1,191,10,45,3,58
test4sub45of100,test4pub95of100,1,191,10,45,2,57
test4sub64of100,test4pub95of100,1,191,10,47,2,59
test4sub81of100,test4pub95of100,1,191,10,52,0,62
test4sub28of100,test4pub95of100,1,191,10,52,2,64
test4sub25of100,test4pub94of100,1,191,18,484,2,504
test4sub34of100,test4pub95of100,1,191,10,55,1,66
test4sub15of100,test4pub95of100,1,191,10,56,2,68
test4sub17of100,test4pub95of100,1,191,10,58,1,69
test4sub67of100,test4pub95of100,1,191,10,62,1,73
test4sub76of100,test4pub95of100,1,191,10,64,0,74
test4sub73of100,test4pub95of100,1,191,10,67,1,78
test4sub57of100,test4pub95of100,1,191,10,69,0,79
test4sub26of100,test4pub95of100,1,191,10,68,2,80
test4sub53of100,test4pub95of100,1,191,10,71,2,83
test4sub92of100,test4pub95of100,1,191,10,71,2,83
test4sub95of100,test4pub95of100,1,191,10,73,0,83
test4sub50of100,test4pub95of100,1,191,10,75,1,86
test4sub84of100,test4pub95of100,1,191,10,76,1,87
test4sub75of100,test4pub95of100,1,191,10,83,0,93
test4sub88of100,test4pub95of100,1,191,10,83,1,94
test4sub71of100,test4pub95of100,1,191,10,85,1,96
test4sub58of100,test4pub95of100,1,191,10,85,2,97
test4sub54of100,test4pub95of100,1,191,10,86,1,97
test4sub5of100,test4pub95of100,1,191,10,99,1,110
test4sub48of100,test4pub95of100,1,191,10,99,1,110
test4sub63of100,test4pub95of100,1,191,10,102,1,113
test4sub62of100,test4pub95of100,1,191,10,103,1,114
test4sub31of100,test4pub95of100,1,191,10,105,0,115
test4sub37of100,test4pub95of100,1,191,10,108,0,118
test4sub29of100,test4pub95of100,1,191,10,108,1,119
test4sub43of100,test4pub95of100,1,191,10,108,2,120
test4sub6of100,test4pub95of100,1,191,10,110,3,123
test4sub90of100,test4pub95of100,1,191,10,111,3,124
test4sub85of100,test4pub95of100,1,191,10,112,6,128
test4sub16of100,test4pub95of100,1,191,10,112,6,128
test4sub18of100,test4pub95of100,1,191,10,113,13,136
test4sub46of100,test4pub95of100,1,191,10,115,19,144
test4sub12of100,test4pub95of100,1,191,10,116,19,145
test4sub13of100,test4pub95of100,1,191,10,117,18,145
test4sub35of100,test4pub95of100,1,191,10,120,15,145
test4sub74of100,test4pub95of100,1,191,10,120,16,146
test4sub33of100,test4pub95of100,1,191,10,115,17,142
test4sub2of100,test4pub95of100,1,191,10,121,17,148
test4sub72of100,test4pub95of100,1,191,10,121,18,149
test4sub86of100,test4pub95of100,1,191,10,122,17,149
test4sub42of100,test4pub95of100,1,191,10,124,17,151
test4sub97of100,test4pub95of100,1,191,10,124,18,152
test4sub14of100,test4pub95of100,1,191,10,125,16,151
test4sub8of100,test4pub95of100,1,191,10,125,17,152
test4sub38of100,test4pub95of100,1,191,10,126,18,154
test4sub80of100,test4pub95of100,1,191,10,127,18,155
test4sub91of100,test4pub95of100,1,191,10,128,16,154
test4sub69of100,test4pub95of100,1,191,10,129,17,156
test4sub1of100,test4pub95of100,1,191,10,130,17,157
test4sub32of100,test4pub95of100,1,191,10,131,16,157
test4sub89of100,test4pub95of100,1,191,10,131,16,157
test4sub82of100,test4pub95of100,1,191,10,132,17,159
test4sub41of100,test4pub95of100,1,191,10,131,17,158
test4sub55of100,test4pub95of100,1,191,10,133,17,160
test4sub25of100,test4pub95of100,1,191,10,137,14,161
test4sub20of100,test4pub94of100,1,191,18,713,0,731
test4sub20of100,test4pub95of100,1,191,10,285,1,296
test4sub97of100,test4pub96of100,1,191,12,6,1,19
test4sub42of100,test4pub96of100,1,191,12,13,1,26
test4sub17of100,test4pub96of100,1,191,12,25,1,38
test4sub11of100,test4pub96of100,1,191,12,26,0,38
test4sub61of100,test4pub96of100,1,191,12,38,1,51
test4sub34of100,test4pub96of100,1,191,12,39,1,52
test4sub12of100,test4pub96of100,1,191,12,40,1,53
test4sub7of100,test4pub96of100,1,191,12,43,1,56
test4sub98of100,test4pub96of100,1,191,12,48,1,61
test4sub9of100,test4pub96of100,1,191,12,51,0,63
test4sub44of100,test4pub96of100,1,191,12,57,1,70
test4sub4of100,test4pub96of100,1,191,12,57,1,70
test4sub82of100,test4pub96of100,1,191,12,61,1,74
test4sub53of100,test4pub96of100,1,191,12,61,2,75
test4sub87of100,test4pub95of100,1,191,10,361,1,372
test4sub73of100,test4pub96of100,1,191,12,65,1,78
test4sub72of100,test4pub96of100,1,191,12,66,2,80
test4sub10of100,test4pub95of100,1,191,10,366,2,378
test4sub77of100,test4pub95of100,1,191,10,367,1,378
test4sub66of100,test4pub96of100,1,191,12,70,1,83
test4sub84of100,test4pub96of100,1,191,12,72,1,85
test4sub55of100,test4pub96of100,1,191,12,72,1,85
test4sub46of100,test4pub96of100,1,191,12,75,2,89
test4sub18of100,test4pub96of100,1,191,12,76,3,91
test4sub65of100,test4pub96of100,1,191,12,77,2,91
test4sub37of100,test4pub96of100,1,191,12,77,2,91
test4sub47of100,test4pub95of100,1,191,10,380,2,392
test4sub79of100,test4pub95of100,1,191,10,380,4,394
test4sub54of100,test4pub96of100,1,191,12,82,7,101
test4sub78of100,test4pub96of100,1,191,12,83,11,106
test4sub15of100,test4pub96of100,1,191,12,84,12,108
test4sub59of100,test4pub95of100,1,191,10,384,14,408
test4sub56of100,test4pub95of100,1,191,10,384,14,408
test4sub93of100,test4pub96of100,1,191,12,86,13,111
test4sub2of100,test4pub96of100,1,191,12,87,13,112
test4sub14of100,test4pub96of100,1,191,12,88,12,112
test4sub41of100,test4pub96of100,1,191,12,88,13,113
test4sub70of100,test4pub96of100,1,191,12,89,12,113
test4sub25of100,test4pub96of100,1,191,12,89,12,113
test4sub71of100,test4pub96of100,1,191,12,89,12,113
test4sub51of100,test4pub96of100,1,191,12,90,11,113
test4sub49of100,test4pub95of100,1,191,10,389,12,411
test4sub50of100,test4pub96of100,1,191,12,91,11,114
test4sub68of100,test4pub96of100,1,191,12,92,10,114
test4sub89of100,test4pub96of100,1,191,12,92,10,114
test4sub57of100,test4pub96of100,1,191,12,94,10,116
test4sub96of100,test4pub96of100,1,191,12,94,10,116
test4sub99of100,test4pub95of100,1,191,10,395,8,413
test4sub80of100,test4pub96of100,1,191,12,96,8,116
test4sub20of100,test4pub96of100,1,191,12,97,7,116
test4sub30of100,test4pub96of100,1,191,12,98,7,117
test4sub27of100,test4pub95of100,1,191,10,397,7,414
test4sub76of100,test4pub96of100,1,191,12,120,1,133
test4sub81of100,test4pub96of100,1,191,12,124,0,136
test4sub21of100,test4pub96of100,1,191,12,125,1,138
test4sub58of100,test4pub96of100,1,191,12,126,2,140
test4sub8of100,test4pub96of100,1,191,12,126,3,141
test4sub88of100,test4pub96of100,1,191,12,128,6,146
test4sub75of100,test4pub96of100,1,191,12,128,9,149
test4sub39of100,test4pub96of100,1,191,12,129,9,150
test4sub83of100,test4pub95of100,1,191,10,429,8,447
test4sub1of100,test4pub96of100,1,191,12,131,7,150
test4sub100of100,test4pub95of100,1,191,10,430,8,448
test4sub60of100,test4pub95of100,1,191,10,431,7,448
test4sub35of100,test4pub96of100,1,191,12,133,7,152
test4sub38of100,test4pub96of100,1,191,12,133,10,155
test4sub31of100,test4pub96of100,1,191,12,134,10,156
test4sub6of100,test4pub96of100,1,191,12,135,13,160
test4sub85of100,test4pub96of100,1,191,12,133,13,158
test4sub48of100,test4pub96of100,1,191,12,136,13,161
test4sub22of100,test4pub96of100,1,191,12,136,13,161
test4sub92of100,test4pub96of100,1,191,12,137,12,161
test4sub90of100,test4pub96of100,1,191,12,137,12,161
test4sub45of100,test4pub96of100,1,191,12,140,10,162
test4sub91of100,test4pub96of100,1,191,12,141,9,162
test4sub74of100,test4pub96of100,1,191,12,142,8,162
test4sub5of100,test4pub96of100,1,191,12,143,8,163
test4sub13of100,test4pub96of100,1,191,12,143,8,163
test4sub23of100,test4pub95of100,1,191,10,443,7,460
test4sub3of100,test4pub95of100,1,191,10,445,6,461
test4sub19of100,test4pub95of100,1,191,10,444,6,460
test4sub86of100,test4pub96of100,1,191,12,147,6,165
test4sub69of100,test4pub96of100,1,191,12,147,6,165
test4sub10of100,test4pub96of100,1,191,12,147,5,164
test4sub77of100,test4pub96of100,1,191,12,196,1,209
test4sub43of100,test4pub96of100,1,191,12,197,1,210
test4sub64of100,test4pub96of100,1,191,12,199,1,212
test4sub29of100,test4pub96of100,1,191,12,199,1,212
test4sub59of100,test4pub96of100,1,191,12,200,0,212
test4sub56of100,test4pub96of100,1,191,12,204,1,217
test4sub16of100,test4pub96of100,1,191,12,206,1,219
test4sub62of100,test4pub96of100,1,191,12,206,2,220
test4sub49of100,test4pub96of100,1,191,12,207,1,220
test4sub24of100,test4pub96of100,1,191,12,208,2,222
test4sub52of100,test4pub96of100,1,191,12,209,2,223
test4sub94of100,test4pub96of100,1,191,12,211,1,224
test4sub40of100,test4pub96of100,1,191,12,213,1,226
test4sub36of100,test4pub95of100,1,191,10,513,1,524
test4sub32of100,test4pub96of100,1,191,12,219,1,232
test4sub33of100,test4pub96of100,1,191,12,218,1,231
test4sub28of100,test4pub96of100,1,191,12,222,0,234
test4sub63of100,test4pub96of100,1,191,12,224,1,237
test4sub99of100,test4pub96of100,1,191,12,225,0,237
test4sub27of100,test4pub96of100,1,191,12,226,1,239
test4sub95of100,test4pub96of100,1,191,12,227,1,240
test4sub83of100,test4pub96of100,1,191,12,228,1,241
test4sub100of100,test4pub96of100,1,191,12,230,1,243
test4sub26of100,test4pub96of100,1,191,12,233,1,246
test4sub60of100,test4pub96of100,1,191,12,235,1,248
test4sub23of100,test4pub96of100,1,191,12,236,1,249
test4sub19of100,test4pub96of100,1,191,12,238,1,251
test4sub3of100,test4pub96of100,1,191,12,239,0,251
test4sub36of100,test4pub96of100,1,191,12,251,0,263
test4sub67of100,test4pub96of100,1,191,12,254,1,267
test4sub32of100,test4pub97of100,1,191,16,4,1,21
test4sub80of100,test4pub97of100,1,191,16,5,1,22
test4sub51of100,test4pub97of100,1,191,16,8,1,25
test4sub22of100,test4pub97of100,1,191,16,9,1,26
test4sub49of100,test4pub97of100,1,191,16,12,0,28
test4sub36of100,test4pub97of100,1,191,16,15,0,31
test4sub82of100,test4pub97of100,1,191,16,16,1,33
test4sub1of100,test4pub97of100,1,191,16,22,0,38
test4sub83of100,test4pub97of100,1,191,16,24,0,40
test4sub55of100,test4pub97of100,1,191,16,26,0,42
test4sub16of100,test4pub97of100,1,191,16,27,1,44
test4sub86of100,test4pub97of100,1,191,16,29,0,45
test4sub13of100,test4pub97of100,1,191,16,32,1,49
test4sub98of100,test4pub97of100,1,191,16,34,1,51
test4sub33of100,test4pub97of100,1,191,16,34,1,51
test4sub8of100,test4pub97of100,1,191,16,37,2,55
test4sub48of100,test4pub97of100,1,191,16,37,4,57
test4sub20of100,test4pub97of100,1,191,16,38,4,58
test4sub61of100,test4pub97of100,1,191,16,39,3,58
test4sub76of100,test4pub97of100,1,191,16,40,4,60
test4sub52of100,test4pub97of100,1,191,16,40,3,59
test4sub9of100,test4pub97of100,1,191,16,43,1,60
test4sub3of100,test4pub97of100,1,191,16,46,1,63
test4sub37of100,test4pub97of100,1,191,16,46,0,62
test4sub11of100,test4pub97of100,1,191,16,51,1,68
test4sub60of100,test4pub97of100,1,191,16,51,2,69
test4sub10of100,test4pub97of100,1,191,16,52,1,69
test4sub68of100,test4pub97of100,1,191,16,57,4,77
test4sub4of100,test4pub97of100,1,191,16,63,0,79
test4sub94of100,test4pub97of100,1,191,16,66,0,82
test4sub96of100,test4pub97of100,1,191,16,67,1,84
test4sub73of100,test4pub97of100,1,191,16,68,0,84
test4sub5of100,test4pub97of100,1,191,16,78,2,96
test4sub99of100,test4pub97of100,1,191,16,78,2,96
test4sub2of100,test4pub97of100,1,191,16,79,2,97
test4sub91of100,test4pub97of100,1,191,16,79,3,98
test4sub41of100,test4pub97of100,1,191,16,81,1,98
test4sub38of100,test4pub97of100,1,191,16,81,1,98
test4sub81of100,test4pub97of100,1,191,16,84,1,101
test4sub57of100,test4pub97of100,1,191,16,89,2,107
test4sub50of100,test4pub97of100,1,191,16,90,1,107
test4sub7of100,test4pub97of100,1,191,16,90,2,108
test4sub27of100,test4pub97of100,1,191,16,91,2,109
test4sub34of100,test4pub97of100,1,191,16,93,2,111
test4sub28of100,test4pub97of100,1,191,16,93,2,111
test4sub30of100,test4pub97of100,1,191,16,95,2,113
test4sub63of100,test4pub97of100,1,191,16,95,1,112
test4sub69of100,test4pub97of100,1,191,16,102,1,119
test4sub42of100,test4pub97of100,1,191,16,103,1,120
test4sub66of100,test4pub97of100,1,191,16,106,0,122
test4sub95of100,test4pub97of100,1,191,16,113,0,129
test4sub74of100,test4pub97of100,1,191,16,113,1,130
test4sub12of100,test4pub97of100,1,191,16,118,1,135
test4sub90of100,test4pub97of100,1,191,16,118,2,136
test4sub24of100,test4pub97of100,1,191,16,119,2,137
test4sub89of100,test4pub97of100,1,191,16,120,2,138
test4sub71of100,test4pub97of100,1,191,16,123,2,141
test4sub84of100,test4pub97of100,1,191,16,124,2,142
test4sub64of100,test4pub97of100,1,191,16,125,2,143
test4sub67of100,test4pub97of100,1,191,16,126,2,144
test4sub39of100,test4pub97of100,1,191,16,127,1,144
test4sub21of100,test4pub97of100,1,191,16,129,1,146
test4sub6of100,test4pub97of100,1,191,16,131,0,147
test4sub77of100,test4pub97of100,1,191,16,135,2,153
test4sub31of100,test4pub97of100,1,191,16,136,2,154
test4sub65of100,test4pub97of100,1,191,16,136,2,154
test4sub72of100,test4pub97of100,1,191,16,137,2,155
test4sub14of100,test4pub97of100,1,191,16,139,1,156
test4sub35of100,test4pub97of100,1,191,16,140,1,157
test4sub79of100,test4pub96of100,1,191,12,589,1,602
test4sub79of100,test4pub97of100,1,191,16,165,1,182
test4sub87of100,test4pub96of100,1,191,12,599,1,612
test4sub87of100,test4pub97of100,1,191,16,176,1,193
test4sub92of100,test4pub97of100,1,191,16,307,1,324
test4sub46of100,test4pub97of100,1,191,16,317,0,333
test4sub15of100,test4pub97of100,1,191,16,326,1,343
test4sub97of100,test4pub97of100,1,191,16,329,0,345
test4sub59of100,test4pub97of100,1,191,16,334,2,352
test4sub56of100,test4pub97of100,1,191,16,334,1,351
test4sub62of100,test4pub97of100,1,191,16,338,1,355
test4sub78of100,test4pub97of100,1,191,16,350,1,367
test4sub17of100,test4pub97of100,1,191,16,352,2,370
test4sub88of100,test4pub97of100,1,191,16,351,2,369
test4sub19of100,test4pub97of100,1,191,16,353,1,370
test4sub44of100,test4pub97of100,1,191,16,355,1,372
test4sub75of100,test4pub97of100,1,191,16,362,1,379
test4sub53of100,test4pub97of100,1,191,16,365,0,381
test4sub93of100,test4pub97of100,1,191,16,369,1,386
test4sub40of100,test4pub97of100,1,191,16,376,1,393
test4sub45of100,test4pub97of100,1,191,16,379,0,395
test4sub26of100,test4pub97of100,1,191,16,383,1,400
test4sub18of100,test4pub97of100,1,191,16,388,0,404
test4sub100of100,test4pub97of100,1,191,16,391,1,408
test4sub70of100,test4pub97of100,1,191,16,393,1,410
test4sub58of100,test4pub97of100,1,191,16,393,1,410
test4sub23of100,test4pub97of100,1,191,16,402,1,419
test4sub29of100,test4pub97of100,1,191,16,402,1,419
test4sub85of100,test4pub97of100,1,191,16,405,1,422
test4sub54of100,test4pub97of100,1,191,16,407,0,423
test4sub25of100,test4pub97of100,1,191,16,413,0,429
test4sub43of100,test4pub97of100,1,191,16,425,1,442
test4sub30of100,test4pub98of100,1,191,10,12,1,23
test4sub46of100,test4pub98of100,1,191,10,18,1,29
test4sub63of100,test4pub98of100,1,191,10,20,0,30
test4sub22of100,test4pub98of100,1,191,10,22,1,33
test4sub97of100,test4pub98of100,1,191,10,26,1,37
test4sub80of100,test4pub98of100,1,191,10,27,0,37
test4sub20of100,test4pub98of100,1,191,10,34,1,45
test4sub71of100,test4pub98of100,1,191,10,35,2,47
test4sub24of100,test4pub98of100,1,191,10,36,2,48
test4sub40of100,test4pub98of100,1,191,10,37,1,48
test4sub96of100,test4pub98of100,1,191,10,40,0,50
test4sub48of100,test4pub98of100,1,191,10,42,1,53
test4sub52of100,test4pub98of100,1,191,10,41,2,53
test4sub50of100,test4pub98of100,1,191,10,52,3,65
test4sub54of100,test4pub98of100,1,191,10,54,2,66
test4sub83of100,test4pub98of100,1,191,10,54,2,66
test4sub74of100,test4pub98of100,1,191,10,55,3,68
test4sub79of100,test4pub98of100,1,191,10,54,3,67
test4sub85of100,test4pub98of100,1,191,10,56,2,68
test4sub15of100,test4pub98of100,1,191,10,68,0,78
test4sub35of100,test4pub98of100,1,191,10,70,1,81
test4sub18of100,test4pub98of100,1,191,10,72,1,83
test4sub16of100,test4pub98of100,1,191,10,73,2,85
test4sub19of100,test4pub98of100,1,191,10,74,2,86
test4sub23of100,test4pub98of100,1,191,10,75,1,86
test4sub1of100,test4pub98of100,1,191,10,76,3,89
test4sub88of100,test4pub98of100,1,191,10,78,2,90
test4sub2of100,test4pub98of100,1,191,10,78,3,91
test4sub95of100,test4pub98of100,1,191,10,80,2,92
test4sub94of100,test4pub98of100,1,191,10,80,3,93
test4sub90of100,test4pub98of100,1,191,10,81,2,93
test4sub25of100,test4pub98of100,1,191,10,82,2,94
test4sub12of100,test4pub98of100,1,191,10,84,2,96
test4sub41of100,test4pub98of100,1,191,10,87,1,98
test4sub6of100,test4pub98of100,1,191,10,94,1,105
test4sub39of100,test4pub98of100,1,191,10,96,1,107
test4sub4of100,test4pub98of100,1,191,10,96,3,109
test4sub53of100,test4pub98of100,1,191,10,97,1,108
test4sub66of100,test4pub98of100,1,191,10,98,1,109
test4sub38of100,test4pub98of100,1,191,10,109,1,120
test4sub8of100,test4pub98of100,1,191,10,124,1,135
test4sub64of100,test4pub98of100,1,191,10,124,0,134
test4sub26of100,test4pub98of100,1,191,10,128,1,139
test4sub98of100,test4pub98of100,1,191,10,128,1,139
test4sub11of100,test4pub98of100,1,191,10,132,1,143
test4sub17of100,test4pub98of100,1,191,10,140,2,152
test4sub36of100,test4pub98of100,1,191,10,140,4,154
test4sub21of100,test4pub98of100,1,191,10,141,3,154
test4sub99of100,test4pub98of100,1,191,10,142,3,155
test4sub87of100,test4pub98of100,1,191,10,143,4,157
test4sub59of100,test4pub98of100,1,191,10,145,2,157
test4sub5of100,test4pub98of100,1,191,10,145,2,157
test4sub65of100,test4pub98of100,1,191,10,146,2,158
test4sub75of100,test4pub98of100,1,191,10,162,5,177
test4sub81of100,test4pub98of100,1,191,10,163,7,180
test4sub45of100,test4pub98of100,1,191,10,164,7,181
test4sub10of100,test4pub98of100,1,191,10,164,7,181
test4sub32of100,test4pub98of100,1,191,10,165,6,181
test4sub68of100,test4pub98of100,1,191,10,166,6,182
test4sub67of100,test4pub98of100,1,191,10,166,6,182
test4sub57of100,test4pub98of100,1,191,10,167,5,182
test4sub76of100,test4pub98of100,1,191,10,168,6,184
test4sub86of100,test4pub98of100,1,191,10,169,6,185
test4sub56of100,test4pub98of100,1,191,10,169,7,186
test4sub13of100,test4pub98of100,1,191,10,171,6,187
test4sub100of100,test4pub98of100,1,191,10,174,3,187
test4sub9of100,test4pub98of100,1,191,10,175,2,187
test4sub14of100,test4pub98of100,1,191,10,183,0,193
test4sub69of100,test4pub98of100,1,191,10,187,0,197
test4sub70of100,test4pub98of100,1,191,10,219,1,230
test4sub92of100,test4pub98of100,1,191,10,220,2,232
test4sub28of100,test4pub98of100,1,191,10,220,3,233
test4sub62of100,test4pub98of100,1,191,10,221,3,234
test4sub78of100,test4pub98of100,1,191,10,222,3,235
test4sub60of100,test4pub98of100,1,191,10,224,2,236
test4sub43of100,test4pub98of100,1,191,10,225,1,236
test4sub51of100,test4pub98of100,1,191,10,228,1,239
test4sub44of100,test4pub98of100,1,191,10,228,1,239
test4sub89of100,test4pub98of100,1,191,10,234,3,247
test4sub55of100,test4pub98of100,1,191,10,234,3,247
test4sub61of100,test4pub98of100,1,191,10,235,3,248
test4sub42of100,test4pub98of100,1,191,10,235,3,248
test4sub31of100,test4pub98of100,1,191,10,236,2,248
test4sub49of100,test4pub98of100,1,191,10,239,1,250
test4sub34of100,test4pub98of100,1,191,10,240,2,252
test4sub72of100,test4pub98of100,1,191,10,241,1,252
test4sub58of100,test4pub98of100,1,191,10,241,2,253
test4sub3of100,test4pub98of100,1,191,10,243,1,254
test4sub77of100,test4pub98of100,1,191,10,248,1,259
test4sub27of100,test4pub98of100,1,191,10,248,1,259
test4sub37of100,test4pub98of100,1,191,10,249,2,261
test4sub7of100,test4pub98of100,1,191,10,251,1,262
test4sub73of100,test4pub98of100,1,191,10,251,2,263
test4sub33of100,test4pub98of100,1,191,10,252,1,263
test4sub29of100,test4pub98of100,1,191,10,253,2,265
test4sub93of100,test4pub98of100,1,191,10,265,1,276
test4sub91of100,test4pub98of100,1,191,10,265,1,276
test4sub84of100,test4pub98of100,1,191,10,267,1,278
test4sub82of100,test4pub98of100,1,191,10,270,1,281
test4sub47of100,test4pub96of100,1,191,12,1237,1,1250
test4sub47of100,test4pub97of100,1,191,16,813,1,830
test4sub47of100,test4pub98of100,1,191,10,322,1,333
test4sub77of100,test4pub99of100,1,191,11,4,1,16
test4sub56of100,test4pub99of100,1,191,11,7,1,19
test4sub4of100,test4pub99of100,1,191,11,7,1,19
test4sub99of100,test4pub99of100,1,191,11,10,1,22
test4sub61of100,test4pub99of100,1,191,11,12,0,23
test4sub72of100,test4pub99of100,1,191,11,15,1,27
test4sub54of100,test4pub99of100,1,191,11,15,0,26
test4sub65of100,test4pub99of100,1,191,11,20,1,32
test4sub39of100,test4pub99of100,1,191,11,21,0,32
test4sub93of100,test4pub99of100,1,191,11,24,1,36
test4sub81of100,test4pub99of100,1,191,11,26,1,38
test4sub67of100,test4pub99of100,1,191,11,27,0,38
test4sub100of100,test4pub99of100,1,191,11,32,1,44
test4sub79of100,test4pub99of100,1,191,11,36,0,47
test4sub21of100,test4pub99of100,1,191,11,43,1,55
test4sub7of100,test4pub99of100,1,191,11,47,0,58
test4sub80of100,test4pub99of100,1,191,11,51,1,63
test4sub18of100,test4pub99of100,1,191,11,55,0,66
test4sub60of100,test4pub99of100,1,191,11,56,2,69
test4sub74of100,test4pub99of100,1,191,11,57,2,70
test4sub24of100,test4pub99of100,1,191,11,57,2,70
test4sub2of100,test4pub99of100,1,191,11,60,1,72
test4sub6of100,test4pub99of100,1,191,11,61,1,73
test4sub66of100,test4pub99of100,1,191,11,65,0,76
test4sub68of100,test4pub99of100,1,191,11,69,1,81
test4sub50of100,test4pub99of100,1,191,11,70,1,82
test4sub27of100,test4pub99of100,1,191,11,72,1,84
test4sub45of100,test4pub99of100,1,191,11,76,0,87
test4sub32of100,test4pub99of100,1,191,11,78,0,89
test4sub96of100,test4pub99of100,1,191,11,82,0,93
test4sub73of100,test4pub99of100,1,191,11,82,1,94
test4sub98of100,test4pub99of100,1,191,11,85,2,98
test4sub94of100,test4pub99of100,1,191,11,86,2,99
test4sub14of100,test4pub99of100,1,191,11,86,2,99
test4sub41of100,test4pub99of100,1,191,11,87,1,99
test4sub52of100,test4pub99of100,1,191,11,91,1,103
test4sub28of100,test4pub99of100,1,191,11,94,1,106
test4sub92of100,test4pub99of100,1,191,11,96,1,108
test4sub47of100,test4pub99of100,1,191,11,95,1,107
test4sub9of100,test4pub99of100,1,191,11,98,2,111
test4sub90of100,test4pub99of100,1,191,11,100,1,112
test4sub1of100,test4pub99of100,1,191,11,100,12,123
test4sub78of100,test4pub99of100,1,191,11,104,8,123
test4sub29of100,test4pub99of100,1,191,11,105,7,123
test4sub75of100,test4pub99of100,1,191,11,106,7,124
test4sub97of100,test4pub99of100,1,191,11,107,9,127
test4sub26of100,test4pub99of100,1,191,11,109,9,129
test4sub89of100,test4pub99of100,1,191,11,111,7,129
test4sub16of100,test4pub99of100,1,191,11,116,3,130
test4sub57of100,test4pub99of100,1,191,11,117,2,130
test4sub49of100,test4pub99of100,1,191,11,124,1,136
test4sub37of100,test4pub99of100,1,191,11,130,3,144
test4sub55of100,test4pub99of100,1,191,11,131,4,146
test4sub69of100,test4pub99of100,1,191,11,132,3,146
test4sub22of100,test4pub99of100,1,191,11,129,7,147
test4sub17of100,test4pub99of100,1,191,11,133,3,147
test4sub87of100,test4pub99of100,1,191,11,134,5,150
test4sub11of100,test4pub99of100,1,191,11,132,5,148
test4sub44of100,test4pub99of100,1,191,11,135,6,152
test4sub30of100,test4pub99of100,1,191,11,137,3,151
test4sub86of100,test4pub99of100,1,191,11,138,3,152
test4sub43of100,test4pub99of100,1,191,11,138,3,152
test4sub19of100,test4pub99of100,1,191,11,140,2,153
test4sub10of100,test4pub99of100,1,191,11,144,1,156
test4sub15of100,test4pub99of100,1,191,11,146,2,159
test4sub88of100,test4pub99of100,1,191,11,146,3,160
test4sub82of100,test4pub99of100,1,191,11,147,3,161
test4sub76of100,test4pub99of100,1,191,11,145,6,162
test4sub38of100,test4pub99of100,1,191,11,147,4,162
test4sub5of100,test4pub99of100,1,191,11,148,4,163
test4sub20of100,test4pub99of100,1,191,11,149,2,162
test4sub59of100,test4pub99of100,1,191,11,154,0,165
test4sub46of100,test4pub99of100,1,191,11,157,1,169
test4sub31of100,test4pub99of100,1,191,11,157,1,169
test4sub40of100,test4pub99of100,1,191,11,161,2,174
test4sub12of100,test4pub99of100,1,191,11,161,4,176
test4sub25of100,test4pub99of100,1,191,11,162,3,176
test4sub3of100,test4pub99of100,1,191,11,163,3,177
test4sub91of100,test4pub99of100,1,191,11,164,2,177
test4sub33of100,test4pub99of100,1,191,11,164,1,176
test4sub48of100,test4pub99of100,1,191,11,169,1,181
test4sub36of100,test4pub99of100,1,191,11,169,0,180
test4sub42of100,test4pub99of100,1,191,11,170,2,183
test4sub64of100,test4pub99of100,1,191,11,171,1,183
test4sub8of100,test4pub99of100,1,191,11,172,2,185
test4sub35of100,test4pub99of100,1,191,11,182,1,194
test4sub13of100,test4pub99of100,1,191,11,190,2,203
test4sub70of100,test4pub99of100,1,191,11,191,2,204
test4sub85of100,test4pub99of100,1,191,11,190,4,205
test4sub71of100,test4pub99of100,1,191,11,192,2,205
test4sub83of100,test4pub99of100,1,191,11,191,2,204
test4sub53of100,test4pub99of100,1,191,11,191,3,205
test4sub62of100,test4pub99of100,1,191,11,197,2,210
test4sub51of100,test4pub99of100,1,191,11,197,4,212
test4sub23of100,test4pub99of100,1,191,11,197,4,212
test4sub63of100,test4pub99of100,1,191,11,198,4,213
test4sub58of100,test4pub99of100,1,191,11,198,4,213
test4sub34of100,test4pub99of100,1,191,11,199,4,214
test4sub95of100,test4pub99of100,1,191,11,201,8,220
test4sub84of100,test4pub99of100,1,191,11,201,8,220
test4sub81of100,test4pub100of100,1,192,14,8,0,22
test4sub40of100,test4pub100of100,1,192,14,10,1,25
test4sub94of100,test4pub100of100,1,192,14,12,0,26
test4sub68of100,test4pub100of100,1,192,14,16,1,31
test4sub44of100,test4pub100of100,1,192,14,17,1,32
test4sub27of100,test4pub100of100,1,192,14,28,1,43
test4sub38of100,test4pub100of100,1,192,14,34,2,50
test4sub24of100,test4pub100of100,1,192,14,35,1,50
test4sub70of100,test4pub100of100,1,192,14,36,1,51
test4sub58of100,test4pub100of100,1,192,14,39,1,54
test4sub51of100,test4pub100of100,1,192,14,40,0,54
test4sub93of100,test4pub100of100,1,192,14,40,1,55
test4sub19of100,test4pub100of100,1,192,14,45,0,59
test4sub36of100,test4pub100of100,1,192,14,50,0,64
test4sub39of100,test4pub100of100,1,192,14,51,1,66
test4sub84of100,test4pub100of100,1,192,14,54,1,69
test4sub7of100,test4pub100of100,1,192,14,55,2,71
test4sub46of100,test4pub100of100,1,192,14,56,1,71
test4sub25of100,test4pub100of100,1,192,14,58,1,73
test4sub30of100,test4pub100of100,1,192,14,62,3,79
test4sub8of100,test4pub100of100,1,192,14,62,3,79
test4sub2of100,test4pub100of100,1,192,14,63,4,81
test4sub89of100,test4pub100of100,1,192,14,63,3,80
test4sub13of100,test4pub100of100,1,192,14,64,2,80
test4sub92of100,test4pub100of100,1,192,14,64,3,81
test4sub50of100,test4pub100of100,1,192,14,65,2,81
test4sub61of100,test4pub100of100,1,192,14,95,1,110
test4sub35of100,test4pub100of100,1,192,14,96,2,112
test4sub87of100,test4pub100of100,1,192,14,97,3,114
test4sub16of100,test4pub100of100,1,192,14,97,3,114
test4sub10of100,test4pub100of100,1,192,14,98,3,115
test4sub82of100,test4pub100of100,1,192,14,99,2,115
test4sub47of100,test4pub100of100,1,192,14,102,1,117
test4sub14of100,test4pub100of100,1,192,14,105,2,121
test4sub64of100,test4pub100of100,1,192,14,106,1,121
test4sub65of100,test4pub100of100,1,192,14,109,0,123
test4sub28of100,test4pub100of100,1,192,14,112,1,127
test4sub66of100,test4pub100of100,1,192,14,118,1,133
test4sub88of100,test4pub100of100,1,192,14,120,1,135
test4sub57of100,test4pub100of100,1,192,14,121,0,135
test4sub15of100,test4pub100of100,1,192,14,131,1,146
test4sub100of100,test4pub100of100,1,192,14,132,1,147
test4sub26of100,test4pub100of100,1,192,14,132,1,147
test4sub33of100,test4pub100of100,1,192,14,134,1,149
test4sub85of100,test4pub100of100,1,192,14,146,1,161
test4sub23of100,test4pub100of100,1,192,14,147,1,162
test4sub1of100,test4pub100of100,1,192,14,150,1,165
test4sub90of100,test4pub100of100,1,192,14,151,2,167
test4sub17of100,test4pub100of100,1,192,14,151,1,166
test4sub21of100,test4pub100of100,1,192,14,152,1,167
test4sub60of100,test4pub100of100,1,192,14,154,1,169
test4sub80of100,test4pub100of100,1,192,14,174,1,189
test4sub31of100,test4pub100of100,1,192,14,177,1,192
test4sub52of100,test4pub100of100,1,192,14,178,1,193
test4sub9of100,test4pub100of100,1,192,14,179,1,194
test4sub72of100,test4pub100of100,1,192,14,181,1,196
test4sub29of100,test4pub100of100,1,192,14,181,4,199
test4sub69of100,test4pub100of100,1,192,14,182,4,200
test4sub34of100,test4pub100of100,1,192,14,183,4,201
test4sub5of100,test4pub100of100,1,192,14,183,4,201
test4sub42of100,test4pub100of100,1,192,14,184,4,202
test4sub97of100,test4pub100of100,1,192,14,185,3,202
test4sub77of100,test4pub100of100,1,192,14,186,3,203
test4sub62of100,test4pub100of100,1,192,14,187,3,204
test4sub45of100,test4pub100of100,1,192,14,194,1,209
test4sub78of100,test4pub100of100,1,192,14,195,3,212
test4sub59of100,test4pub100of100,1,192,14,195,2,211
test4sub79of100,test4pub100of100,1,192,14,196,1,211
test4sub76of100,test4pub100of100,1,192,14,197,2,213
test4sub83of100,test4pub100of100,1,192,14,211,1,226
test4sub63of100,test4pub100of100,1,192,14,212,1,227
test4sub18of100,test4pub100of100,1,192,14,214,1,229
test4sub74of100,test4pub100of100,1,192,14,217,0,231
test4sub48of100,test4pub100of100,1,192,14,219,1,234
test4sub98of100,test4pub100of100,1,192,14,219,1,234
test4sub12of100,test4pub100of100,1,192,14,249,1,264
test4sub11of100,test4pub100of100,1,192,14,249,1,264
test4sub32of100,test4pub100of100,1,192,14,250,1,265
test4sub4of100,test4pub100of100,1,192,14,253,1,268
test4sub49of100,test4pub100of100,1,192,14,254,2,270
test4sub71of100,test4pub100of100,1,192,14,255,1,270
test4sub20of100,test4pub100of100,1,192,14,255,2,271
test4sub22of100,test4pub100of100,1,192,14,255,2,271
test4sub95of100,test4pub100of100,1,192,14,259,1,274
test4sub99of100,test4pub100of100,1,192,14,260,1,275
test4sub37of100,test4pub100of100,1,192,14,262,0,276
test4sub3of100,test4pub100of100,1,192,14,261,2,277
test4sub41of100,test4pub100of100,1,192,14,265,1,280
test4sub86of100,test4pub100of100,1,192,14,265,1,280
test4sub53of100,test4pub100of100,1,192,14,277,1,292
test4sub43of100,test4pub100of100,1,192,14,278,1,293
test4sub6of100,test4pub100of100,1,192,14,281,3,298
test4sub96of100,test4pub100of100,1,192,14,282,3,299
test4sub54of100,test4pub100of100,1,192,14,282,4,300
test4sub55of100,test4pub100of100,1,192,14,283,4,301
test4sub75of100,test4pub100of100,1,192,14,283,3,300
test4sub91of100,test4pub100of100,1,192,14,284,2,300
test4sub56of100,test4pub100of100,1,192,14,285,2,301
test4sub73of100,test4pub100of100,1,192,14,290,1,305
test4sub67of100,test4pub100of100,1,192,14,291,1,306
test4sub48of100,test4pub1of100,10,1469,25,8,38,71
test4sub32of100,test4pub1of100,10,1469,25,11,77,113
test4sub5of100,test4pub1of100,10,1469,25,15,111,151
test4sub1of100,test4pub1of100,10,1469,25,20,147,192
test4sub14of100,test4pub1of100,10,1469,25,26,180,231
test4sub11of100,test4pub1of100,10,1469,25,34,212,271
test4sub59of100,test4pub1of100,10,1469,25,36,250,311
test4sub34of100,test4pub1of100,10,1469,25,38,288,351
test4sub17of100,test4pub1of100,10,1469,25,44,322,391
test4sub44of100,test4pub1of100,10,1469,25,52,355,432
test4sub66of100,test4pub1of100,10,1469,25,61,385,471
test4sub6of100,test4pub1of100,10,1469,25,66,421,512
test4sub9of100,test4pub1of100,10,1469,25,76,450,551
test4sub94of100,test4pub1of100,10,1469,25,86,481,592
test4sub54of100,test4pub1of100,10,1469,25,87,519,631
test4sub51of100,test4pub1of100,10,1469,25,94,552,671
test4sub40of100,test4pub1of100,10,1469,25,95,591,711
test4sub96of100,test4pub1of100,10,1469,25,98,628,751
test4sub62of100,test4pub1of100,10,1469,25,99,668,792
test4sub19of100,test4pub1of100,10,1469,25,102,705,832
test4sub77of100,test4pub1of100,10,1469,25,103,743,871
test4sub78of100,test4pub1of100,10,1469,25,104,783,912
test4sub65of100,test4pub1of100,10,1469,25,106,821,952
test4sub15of100,test4pub1of100,10,1469,25,106,860,991
test4sub99of100,test4pub1of100,10,1469,25,111,895,1031
test4sub33of100,test4pub1of100,10,1469,25,115,932,1072
test4sub45of100,test4pub1of100,10,1469,25,116,970,1111
test4sub63of100,test4pub1of100,10,1469,25,122,1005,1152
test4sub83of100,test4pub1of100,10,1469,25,165,1001,1191
test4sub30of100,test4pub2of100,10,191,18,141,1000,1159
test4sub50of100,test4pub2of100,10,191,18,142,1000,1160
test4sub89of100,test4pub2of100,10,191,18,143,1000,1161
test4sub81of100,test4pub2of100,10,191,18,143,1001,1162
test4sub55of100,test4pub1of100,10,1469,25,171,1039,1235
test4sub5of100,test4pub2of100,10,191,18,146,1039,1203
test4sub86of100,test4pub2of100,10,191,18,146,1039,1203
test4sub97of100,test4pub2of100,10,191,18,147,1040,1205
test4sub24of100,test4pub1of100,10,1469,25,186,1065,1276
test4sub80of100,test4pub2of100,10,191,18,166,1059,1243
test4sub100of100,test4pub1of100,10,1469,25,199,1092,1316
test4sub8of100,test4pub2of100,10,191,18,180,1085,1283
test4sub28of100,test4pub2of100,10,191,18,183,1084,1285
test4sub72of100,test4pub2of100,10,191,18,190,1077,1285
test4sub52of100,test4pub2of100,10,191,18,193,1075,1286
test4sub21of100,test4pub1of100,10,1469,25,224,1111,1360
test4sub84of100,test4pub2of100,10,191,18,200,1109,1327
test4sub67of100,test4pub1of100,10,1469,25,230,1145,1400
test4sub38of100,test4pub1of100,10,1469,25,231,1184,1440
test4sub46of100,test4pub2of100,10,191,18,209,1179,1406
test4sub20of100,test4pub2of100,10,191,18,213,1177,1408
test4sub47of100,test4pub1of100,10,1469,25,243,1211,1479
test4sub25of100,test4pub1of100,10,1469,25,245,1249,1519
test4sub53of100,test4pub1of100,10,1469,25,254,1280,1559
test4sub48of100,test4pub2of100,10,191,18,243,1265,1526
test4sub18of100,test4pub1of100,10,1469,25,272,1302,1599
test4sub60of100,test4pub1of100,10,1469,25,281,1334,1640
test4sub59of100,test4pub2of100,10,191,18,262,1327,1607
test4sub42of100,test4pub1of100,10,1469,25,347,1308,1680
test4sub22of100,test4pub1of100,10,1469,25,348,1347,1720
test4sub4of100,test4pub1of100,10,1469,25,360,1374,1759
test4sub13of100,test4pub2of100,10,191,18,338,1371,1727
test4sub17of100,test4pub2of100,10,191,18,341,1369,1728
test4sub12of100,test4pub2of100,10,191,18,342,1370,1730
test4sub14of100,test4pub2of100,10,191,18,347,1366,1731
test4sub27of100,test4pub2of100,10,191,18,351,1362,1731
test4sub85of100,test4pub2of100,10,191,18,353,1361,1732
test4sub57of100,test4pub1of100,10,1469,25,379,1399,1803
test4sub92of100,test4pub1of100,10,1469,25,386,1433,1844
test4sub1of100,test4pub2of100,10,191,18,385,1408,1811
test4sub90of100,test4pub2of100,10,191,18,386,1409,1813
test4sub75of100,test4pub2of100,10,191,18,387,1407,1812
test4sub61of100,test4pub1of100,10,1469,25,415,1448,1888
test4sub44of100,test4pub2of100,10,191,18,398,1438,1854
test4sub88of100,test4pub2of100,10,191,18,399,1440,1857
test4sub39of100,test4pub1of100,10,1469,25,428,1475,1928
test4sub58of100,test4pub2of100,10,191,18,409,1468,1895
test4sub16of100,test4pub1of100,10,1469,25,436,1506,1967
test4sub70of100,test4pub1of100,10,1469,25,436,1546,2007
test4sub73of100,test4pub1of100,10,1469,25,439,1584,2048
test4sub66of100,test4pub2of100,10,191,18,421,1575,2014
test4sub74of100,test4pub1of100,10,1469,25,449,1613,2087
test4sub69of100,test4pub1of100,10,1469,25,450,1653,2128
test4sub29of100,test4pub2of100,10,191,18,430,1646,2094
test4sub11of100,test4pub2of100,10,191,18,430,1648,2096
test4sub35of100,test4pub1of100,10,1469,25,457,1685,2167
test4sub2of100,test4pub1of100,10,1469,25,461,1721,2207
test4sub87of100,test4pub1of100,10,1469,25,468,1754,2247
test4sub6of100,test4pub2of100,10,191,18,461,1736,2215
test4sub9of100,test4pub2of100,10,191,18,501,1697,2216
test4sub94of100,test4pub2of100,10,191,18,541,1657,2216
test4sub54of100,test4pub2of100,10,191,18,581,1619,2218
test4sub76of100,test4pub1of100,10,1469,25,658,1608,2291
test4sub3of100,test4pub2of100,10,191,18,460,1783,2261
test4sub96of100,test4pub2of100,10,191,18,701,1544,2263
test4sub62of100,test4pub2of100,10,191,18,741,1505,2264
test4sub78of100,test4pub2of100,10,191,18,861,1386,2265
test4sub65of100,test4pub2of100,10,191,18,901,1347,2266
test4sub68of100,test4pub1of100,10,1469,25,935,1379,2339
test4sub15of100,test4pub2of100,10,191,18,941,1347,2306
test4sub32of100,test4pub2of100,10,191,18,942,1349,2309
test4sub99of100,test4pub2of100,10,191,18,981,1309,2308
test4sub33of100,test4pub2of100,10,191,18,1021,1271,2310
test4sub45of100,test4pub2of100,10,191,18,1061,1231,2310
test4sub63of100,test4pub2of100,10,191,18,1101,1192,2311
test4sub83of100,test4pub2of100,10,191,18,1141,1153,2312
test4sub50of100,test4pub1of100,10,1469,25,1169,1189,2383
test4sub89of100,test4pub1of100,10,1469,25,1169,1229,2423
test4sub81of100,test4pub1of100,10,1469,25,1171,1267,2463
test4sub19of100,test4pub2of100,10,191,18,948,1464,2430
test4sub55of100,test4pub2of100,10,191,18,1185,1229,2432
test4sub86of100,test4pub1of100,10,1469,25,1212,1266,2503
test4sub97of100,test4pub1of100,10,1469,25,1214,1304,2543
test4sub24of100,test4pub2of100,10,191,18,1225,1267,2510
test4sub80of100,test4pub1of100,10,1469,25,1252,1307,2584
test4sub100of100,test4pub2of100,10,191,18,1265,1267,2550
test4sub8of100,test4pub1of100,10,1469,25,1292,1307,2624
test4sub28of100,test4pub1of100,10,1469,25,1293,1345,2663
test4sub52of100,test4pub1of100,10,1469,25,1294,1384,2703
test4sub21of100,test4pub2of100,10,191,18,1309,1344,2671
test4sub84of100,test4pub1of100,10,1469,25,1335,1383,2743
test4sub5of100,test4pub3of100,10,191,10,1168,1371,2549
test4sub67of100,test4pub2of100,10,191,18,1349,1345,2712
test4sub95of100,test4pub2of100,10,191,18,1378,1319,2715
test4sub38of100,test4pub2of100,10,191,18,1389,1307,2714
test4sub46of100,test4pub1of100,10,1469,25,1416,1347,2788
test4sub20of100,test4pub1of100,10,1469,25,1417,1385,2827
test4sub47of100,test4pub2of100,10,191,18,1429,1347,2794
test4sub25of100,test4pub2of100,10,191,18,1469,1309,2796
test4sub53of100,test4pub2of100,10,191,18,1509,1269,2796
test4sub72of100,test4pub1of100,10,1469,25,1566,1280,2871
test4sub18of100,test4pub2of100,10,191,18,1549,1271,2838
test4sub60of100,test4pub2of100,10,191,18,1589,1233,2840
test4sub34of100,test4pub2of100,10,191,18,1392,1431,2841
test4sub42of100,test4pub2of100,10,191,18,1629,1194,2841
test4sub22of100,test4pub2of100,10,191,18,1669,1155,2842
test4sub4of100,test4pub2of100,10,191,18,1710,1116,2844
test4sub13of100,test4pub1of100,10,1469,25,1736,1154,2915
test4sub17of100,test4pub4of100,10,191,11,766,1153,1930
test4sub14of100,test4pub4of100,10,191,11,768,1153,1932
test4sub27of100,test4pub1of100,10,1469,25,1740,1190,2955
test4sub85of100,test4pub1of100,10,1469,25,1742,1228,2995
test4sub48of100,test4pub3of100,10,191,10,1356,1435,2801
test4sub57of100,test4pub2of100,10,191,18,1753,1193,2964
test4sub92of100,test4pub2of100,10,191,18,1793,1153,2964
test4sub1of100,test4pub4of100,10,191,11,848,1153,2012
test4sub90of100,test4pub1of100,10,1469,25,1821,1193,3039
test4sub75of100,test4pub1of100,10,1469,25,1822,1233,3080
test4sub61of100,test4pub2of100,10,191,18,1837,1191,3046
test4sub44of100,test4pub3of100,10,191,10,1684,1193,2887
test4sub88of100,test4pub1of100,10,1469,25,1865,1229,3119
test4sub39of100,test4pub2of100,10,191,18,1877,1192,3087
test4sub16of100,test4pub2of100,10,191,18,1917,1153,3088
test4sub93of100,test4pub1of100,10,1469,25,473,2661,3159
test4sub70of100,test4pub2of100,10,191,18,1957,1151,3126
test4sub73of100,test4pub2of100,10,191,18,1997,1113,3128
test4sub66of100,test4pub4of100,10,191,11,1052,1113,2176
test4sub74of100,test4pub2of100,10,191,18,2037,1075,3130
test4sub69of100,test4pub2of100,10,191,18,2077,1035,3130
test4sub29of100,test4pub1of100,10,1469,25,2104,1075,3204
test4sub11of100,test4pub4of100,10,191,11,1133,1073,2217
test4sub35of100,test4pub2of100,10,191,18,2117,1038,3173
test4sub2of100,test4pub2of100,10,191,18,2157,998,3173
test4sub87of100,test4pub2of100,10,191,18,2197,959,3174
test4sub6of100,test4pub4of100,10,191,11,1252,959,2222
test4sub94of100,test4pub3of100,10,191,10,2046,959,3015
test4sub9of100,test4pub3of100,10,191,10,2045,960,3015
test4sub54of100,test4pub4of100,10,191,11,1255,959,2225
test4sub76of100,test4pub2of100,10,191,18,2242,920,3180
test4sub3of100,test4pub1of100,10,1469,25,2270,956,3251
test4sub96of100,test4pub4of100,10,191,11,1300,954,2265
test4sub62of100,test4pub3of100,10,191,10,2093,955,3058
test4sub78of100,test4pub4of100,10,191,11,1303,954,2268
test4sub65of100,test4pub3of100,10,191,10,2096,955,3061
test4sub68of100,test4pub2of100,10,191,18,2289,915,3222
test4sub32of100,test4pub4of100,10,191,11,1345,914,2270
test4sub99of100,test4pub4of100,10,191,11,1345,915,2271
test4sub33of100,test4pub3of100,10,191,10,2139,915,3064
test4sub45of100,test4pub3of100,10,191,10,2139,915,3064
test4sub63of100,test4pub3of100,10,191,10,2141,915,3066
test4sub83of100,test4pub4of100,10,191,11,1349,916,2276
test4sub50of100,test4pub3of100,10,191,10,2179,879,3068
test4sub89of100,test4pub4of100,10,191,11,1427,839,2277
test4sub81of100,test4pub3of100,10,191,10,2259,801,3070
test4sub19of100,test4pub4of100,10,191,11,1468,801,2280
test4sub55of100,test4pub3of100,10,191,10,2261,802,3073
test4sub86of100,test4pub4of100,10,191,11,1507,763,2281
test4sub97of100,test4pub3of100,10,191,10,2340,725,3075
test4sub24of100,test4pub4of100,10,191,11,1548,725,2284
test4sub91of100,test4pub1of100,10,1469,25,1888,1398,3311
test4sub80of100,test4pub4of100,10,191,11,1587,728,2326
test4sub15of100,test4pub3of100,10,191,10,2136,973,3119
test4sub8of100,test4pub3of100,10,191,10,2419,690,3119
test4sub28of100,test4pub3of100,10,191,10,2459,651,3120
test4sub52of100,test4pub3of100,10,191,10,2499,612,3121
test4sub21of100,test4pub3of100,10,191,10,2500,614,3124
test4sub84of100,test4pub4of100,10,191,11,1748,574,2333
test4sub5of100,test4pub4of100,10,191,11,1748,575,2334
test4sub67of100,test4pub4of100,10,191,11,1750,574,2335
test4sub95of100,test4pub1of100,10,1469,25,2723,611,3359
test4sub38of100,test4pub3of100,10,191,10,2544,610,3164
test4sub46of100,test4pub4of100,10,191,11,1791,573,2375
test4sub20of100,test4pub3of100,10,191,10,2623,533,3166
test4sub25of100,test4pub3of100,10,191,10,2625,533,3168
test4sub53of100,test4pub3of100,10,191,10,2626,533,3169
test4sub72of100,test4pub3of100,10,191,10,2667,493,3170
test4sub18of100,test4pub4of100,10,191,11,1876,493,2380
test4sub60of100,test4pub4of100,10,191,11,1877,492,2380
test4sub34of100,test4pub3of100,10,191,10,2669,493,3172
test4sub42of100,test4pub4of100,10,191,11,1879,493,2383
test4sub22of100,test4pub4of100,10,191,11,1879,493,2383
test4sub4of100,test4pub4of100,10,191,11,1880,493,2384
test4sub13of100,test4pub4of100,10,191,11,1919,454,2384
test4sub17of100,test4pub3of100,10,191,10,2713,455,3178
test4sub14of100,test4pub3of100,10,191,10,2713,454,3177
test4sub27of100,test4pub4of100,10,191,11,1959,417,2387
test4sub85of100,test4pub3of100,10,191,10,2791,378,3179
test4sub48of100,test4pub4of100,10,191,11,2000,379,2390
test4sub57of100,test4pub4of100,10,191,11,2001,377,2389
test4sub92of100,test4pub4of100,10,191,11,2001,379,2391
test4sub1of100,test4pub3of100,10,191,10,2795,378,3183
test4sub47of100,test4pub3of100,10,191,10,2624,551,3185
test4sub90of100,test4pub4of100,10,191,11,2044,339,2394
test4sub75of100,test4pub3of100,10,191,10,2875,300,3185
test4sub44of100,test4pub4of100,10,191,11,2085,299,2395
test4sub88of100,test4pub4of100,10,191,11,2124,262,2397
test4sub39of100,test4pub4of100,10,191,11,2124,261,2396
test4sub16of100,test4pub3of100,10,191,10,2917,262,3189
test4sub93of100,test4pub2of100,10,191,18,3109,224,3351
test4sub70of100,test4pub4of100,10,191,11,2164,225,2400
test4sub73of100,test4pub3of100,10,191,10,2957,224,3191
test4sub66of100,test4pub3of100,10,191,10,2958,225,3193
test4sub74of100,test4pub4of100,10,191,11,2167,223,2401
test4sub69of100,test4pub4of100,10,191,11,2168,225,2404
test4sub29of100,test4pub4of100,10,191,11,2207,185,2403
test4sub11of100,test4pub3of100,10,191,10,3000,187,3197
test4sub2of100,test4pub3of100,10,191,10,3002,184,3196
test4sub35of100,test4pub3of100,10,191,10,3002,186,3198
test4sub6of100,test4pub3of100,10,191,10,3004,184,3198
test4sub87of100,test4pub4of100,10,191,11,2212,186,2409
test4sub94of100,test4pub4of100,10,191,11,2214,185,2410
test4sub9of100,test4pub4of100,10,191,11,2214,185,2410
test4sub76of100,test4pub3of100,10,191,10,3008,185,3203
test4sub54of100,test4pub3of100,10,191,10,3008,187,3205
test4sub3of100,test4pub4of100,10,191,11,2255,147,2413
test4sub96of100,test4pub5of100,10,191,17,2168,148,2333
test4sub62of100,test4pub4of100,10,191,11,2257,147,2415
test4sub78of100,test4pub3of100,10,191,10,3049,148,3207
test4sub100of100,test4pub3of100,10,191,10,2380,818,3208
test4sub65of100,test4pub4of100,10,191,11,2259,149,2419
test4sub32of100,test4pub5of100,10,191,17,2173,147,2337
test4sub99of100,test4pub3of100,10,191,10,3053,147,3210
test4sub33of100,test4pub4of100,10,191,11,2263,146,2420
test4sub45of100,test4pub4of100,10,191,11,2263,147,2421
test4sub63of100,test4pub4of100,10,191,11,2265,146,2422
test4sub83of100,test4pub3of100,10,191,10,3058,146,3214
test4sub50of100,test4pub4of100,10,191,11,2267,145,2423
test4sub89of100,test4pub3of100,10,191,10,3060,146,3216
test4sub81of100,test4pub4of100,10,191,11,2269,145,2425
test4sub19of100,test4pub3of100,10,191,10,3061,146,3217
test4sub86of100,test4pub3of100,10,191,10,3063,144,3217
test4sub55of100,test4pub4of100,10,191,11,2271,146,2428
test4sub24of100,test4pub3of100,10,191,10,3065,144,3219
test4sub97of100,test4pub4of100,10,191,11,2273,146,2430
test4sub61of100,test4pub4of100,10,191,11,2084,336,2431
test4sub91of100,test4pub2of100,10,191,18,3261,105,3384
test4sub80of100,test4pub3of100,10,191,10,3108,104,3222
test4sub15of100,test4pub4of100,10,191,11,2318,105,2434
test4sub28of100,test4pub4of100,10,191,11,2319,103,2433
test4sub52of100,test4pub4of100,10,191,11,2320,104,2435
test4sub21of100,test4pub4of100,10,191,11,2322,102,2435
test4sub84of100,test4pub5of100,10,191,17,2234,103,2354
test4sub5of100,test4pub5of100,10,191,17,2236,103,2356
test4sub67of100,test4pub3of100,10,191,10,3116,103,3229
test4sub38of100,test4pub4of100,10,191,11,2364,64,2439
test4sub95of100,test4pub4of100,10,191,11,2363,66,2440
test4sub20of100,test4pub5of100,10,191,17,2278,65,2360
test4sub46of100,test4pub3of100,10,191,10,3157,66,3233
test4sub53of100,test4pub4of100,10,191,11,2368,65,2444
test4sub25of100,test4pub4of100,10,191,11,2367,66,2444
test4sub72of100,test4pub4of100,10,191,11,2369,65,2445
test4sub18of100,test4pub3of100,10,191,10,3161,66,3237
test4sub34of100,test4pub4of100,10,191,11,2371,65,2447
test4sub60of100,test4pub3of100,10,191,10,3163,67,3240
test4sub42of100,test4pub3of100,10,191,10,3164,65,3239
test4sub22of100,test4pub3of100,10,191,10,3165,67,3242
test4sub13of100,test4pub3of100,10,191,10,3166,65,3241
test4sub4of100,test4pub3of100,10,191,10,3166,67,3243
test4sub14of100,test4pub5of100,10,191,17,2288,65,2370
test4sub17of100,test4pub5of100,10,191,17,2288,67,2372
test4sub27of100,test4pub5of100,10,191,17,2290,66,2373
test4sub85of100,test4pub4of100,10,191,11,2378,68,2457
test4sub48of100,test4pub5of100,10,191,17,2291,66,2374
test4sub57of100,test4pub5of100,10,191,17,2292,68,2377
test4sub92of100,test4pub3of100,10,191,10,3173,66,3249
test4sub1of100,test4pub5of100,10,191,17,2293,68,2378
test4sub47of100,test4pub4of100,10,191,11,2383,67,2461
test4sub90of100,test4pub3of100,10,191,10,3175,69,3254
test4sub75of100,test4pub4of100,10,191,11,2385,67,2463
test4sub44of100,test4pub5of100,10,191,17,2297,68,2382
test4sub39of100,test4pub3of100,10,191,10,3178,67,3255
test4sub88of100,test4pub3of100,10,191,10,3178,68,3256
test4sub16of100,test4pub4of100,10,191,11,2388,67,2466
test4sub93of100,test4pub4of100,10,191,11,2388,68,2467
test4sub73of100,test4pub4of100,10,191,11,2390,68,2469
test4sub70of100,test4pub3of100,10,191,10,3182,69,3261
test4sub74of100,test4pub5of100,10,191,17,2304,67,2388
test4sub66of100,test4pub5of100,10,191,17,2304,69,2390
test4sub29of100,test4pub3of100,10,191,10,3186,67,3263
test4sub69of100,test4pub3of100,10,191,10,3185,68,3263
test4sub2of100,test4pub4of100,10,191,11,2396,67,2474
test4sub11of100,test4pub5of100,10,191,17,2307,68,2392
test4sub35of100,test4pub4of100,10,191,11,2397,66,2474
test4sub6of100,test4pub5of100,10,191,17,2310,68,2395
test4sub87of100,test4pub3of100,10,191,10,3191,66,3267
test4sub94of100,test4pub5of100,10,191,17,2311,68,2396
test4sub9of100,test4pub5of100,10,191,17,2313,66,2396
test4sub76of100,test4pub4of100,10,191,11,2401,68,2480
test4sub54of100,test4pub5of100,10,191,17,2315,66,2398
test4sub3of100,test4pub3of100,10,191,10,3195,68,3273
test4sub96of100,test4pub3of100,10,191,10,3197,67,3274
test4sub62of100,test4pub5of100,10,191,17,2317,68,2402
test4sub78of100,test4pub5of100,10,191,17,2318,67,2402
test4sub100of100,test4pub4of100,10,191,11,2407,68,2486
test4sub32of100,test4pub3of100,10,191,10,3200,68,3278
test4sub65of100,test4pub5of100,10,191,17,2320,69,2406
test4sub33of100,test4pub5of100,10,191,17,2322,68,2407
test4sub99of100,test4pub5of100,10,191,17,2322,69,2408
test4sub45of100,test4pub5of100,10,191,17,2323,68,2408
test4sub63of100,test4pub5of100,10,191,17,2324,69,2410
test4sub50of100,test4pub5of100,10,191,17,2325,69,2411
test4sub83of100,test4pub5of100,10,191,17,2325,71,2413
test4sub89of100,test4pub5of100,10,191,17,2327,69,2413
test4sub81of100,test4pub5of100,10,191,17,2327,71,2415
test4sub19of100,test4pub5of100,10,191,17,2328,69,2414
test4sub86of100,test4pub5of100,10,191,17,2329,71,2417
test4sub24of100,test4pub5of100,10,191,17,2330,69,2416
test4sub55of100,test4pub5of100,10,191,17,2330,71,2418
test4sub97of100,test4pub5of100,10,191,17,2332,70,2419
test4sub61of100,test4pub3of100,10,191,10,3212,70,3292
test4sub80of100,test4pub5of100,10,191,17,2334,70,2421
test4sub91of100,test4pub4of100,10,191,11,2422,71,2504
test4sub15of100,test4pub5of100,10,191,17,2335,70,2422
test4sub28of100,test4pub5of100,10,191,17,2336,71,2424
test4sub21of100,test4pub5of100,10,191,17,2337,70,2424
test4sub52of100,test4pub5of100,10,191,17,2337,71,2425
test4sub84of100,test4pub3of100,10,191,10,3219,70,3299
test4sub5of100,test4pub6of100,10,191,11,1901,72,1984
test4sub38of100,test4pub5of100,10,191,17,2341,70,2428
test4sub67of100,test4pub5of100,10,191,17,2340,72,2429
test4sub95of100,test4pub3of100,10,191,10,3222,70,3302
test4sub20of100,test4pub4of100,10,191,11,2431,72,2514
test4sub46of100,test4pub5of100,10,191,17,2344,70,2431
test4sub53of100,test4pub5of100,10,191,17,2345,71,2433
test4sub25of100,test4pub5of100,10,191,17,2347,71,2435
test4sub72of100,test4pub5of100,10,191,17,2347,73,2437
test4sub18of100,test4pub5of100,10,191,17,2348,71,2436
test4sub34of100,test4pub5of100,10,191,17,2348,73,2438
test4sub60of100,test4pub5of100,10,191,17,2350,71,2438
test4sub42of100,test4pub5of100,10,191,17,2350,73,2440
test4sub22of100,test4pub5of100,10,191,17,2352,72,2441
test4sub13of100,test4pub5of100,10,191,17,2352,73,2442
test4sub4of100,test4pub5of100,10,191,17,2354,71,2442
test4sub14of100,test4pub6of100,10,191,11,1916,72,1999
test4sub17of100,test4pub6of100,10,191,11,1918,72,2001
test4sub27of100,test4pub3of100,10,191,10,3236,73,3319
test4sub85of100,test4pub5of100,10,191,17,2358,71,2446
test4sub48of100,test4pub6of100,10,191,11,1920,73,2004
test4sub92of100,test4pub5of100,10,191,17,2361,71,2449
test4sub57of100,test4pub3of100,10,191,10,3240,74,3324
test4sub47of100,test4pub5of100,10,191,17,2362,72,2451
test4sub1of100,test4pub6of100,10,191,11,1924,74,2009
test4sub90of100,test4pub5of100,10,191,17,2364,73,2454
test4sub75of100,test4pub5of100,10,191,17,2364,75,2456
test4sub39of100,test4pub5of100,10,191,17,2366,72,2455
test4sub44of100,test4pub6of100,10,191,11,1928,74,2013
test4sub16of100,test4pub5of100,10,191,17,2368,72,2457
test4sub88of100,test4pub5of100,10,191,17,2368,74,2459
test4sub73of100,test4pub5of100,10,191,17,2370,73,2460
test4sub93of100,test4pub3of100,10,191,10,3250,74,3334
test4sub74of100,test4pub3of100,10,191,10,3252,73,3335
test4sub70of100,test4pub5of100,10,191,17,2371,74,2462
test4sub66of100,test4pub6of100,10,191,11,1935,73,2019
test4sub29of100,test4pub5of100,10,191,17,2373,74,2464
test4sub2of100,test4pub5of100,10,191,17,2375,73,2465
test4sub69of100,test4pub5of100,10,191,17,2375,75,2467
test4sub35of100,test4pub5of100,10,191,17,2377,73,2467
test4sub11of100,test4pub6of100,10,191,11,1938,75,2024
test4sub6of100,test4pub6of100,10,191,11,1940,73,2024
test4sub87of100,test4pub5of100,10,191,17,2379,75,2471
test4sub94of100,test4pub6of100,10,191,11,1942,73,2026
test4sub9of100,test4pub6of100,10,191,11,1943,75,2029
test4sub76of100,test4pub5of100,10,191,17,2382,75,2474
test4sub54of100,test4pub6of100,10,191,11,1945,75,2031
test4sub3of100,test4pub5of100,10,191,17,2384,74,2475
test4sub96of100,test4pub6of100,10,191,11,1946,75,2032
test4sub62of100,test4pub6of100,10,191,11,1948,78,2037
test4sub78of100,test4pub6of100,10,191,11,1948,77,2036
test4sub100of100,test4pub5of100,10,191,17,2388,78,2483
test4sub32of100,test4pub6of100,10,191,11,1950,77,2038
test4sub65of100,test4pub6of100,10,191,11,1952,78,2041
test4sub33of100,test4pub6of100,10,191,11,1952,78,2041
test4sub99of100,test4pub6of100,10,191,11,1953,77,2041
test4sub45of100,test4pub6of100,10,191,11,1954,77,2042
test4sub63of100,test4pub6of100,10,191,11,1956,77,2044
test4sub50of100,test4pub6of100,10,191,11,1956,77,2044
test4sub83of100,test4pub6of100,10,191,11,1958,77,2046
test4sub89of100,test4pub6of100,10,191,11,1958,76,2045
test4sub81of100,test4pub6of100,10,191,11,1960,76,2047
test4sub19of100,test4pub6of100,10,191,11,1960,76,2047
test4sub86of100,test4pub6of100,10,191,11,1962,76,2049
test4sub24of100,test4pub6of100,10,191,11,1963,76,2050
test4sub55of100,test4pub6of100,10,191,11,1964,75,2050
test4sub97of100,test4pub6of100,10,191,11,1964,76,2051
test4sub61of100,test4pub5of100,10,191,17,2404,76,2497
test4sub80of100,test4pub6of100,10,191,11,1966,76,2053
test4sub91of100,test4pub3of100,10,191,10,3286,76,3372
test4sub15of100,test4pub6of100,10,191,11,1968,75,2054
test4sub28of100,test4pub6of100,10,191,11,1970,78,2059
test4sub21of100,test4pub6of100,10,191,11,1970,78,2059
test4sub52of100,test4pub6of100,10,191,11,1971,77,2059
test4sub84of100,test4pub6of100,10,191,11,1972,78,2061
test4sub5of100,test4pub7of100,10,191,17,1687,77,1781
test4sub38of100,test4pub6of100,10,191,11,1973,77,2061
test4sub67of100,test4pub6of100,10,191,11,1975,77,2063
test4sub95of100,test4pub5of100,10,191,17,2414,77,2508
test4sub20of100,test4pub6of100,10,191,11,1977,76,2064
test4sub46of100,test4pub6of100,10,191,11,1978,77,2066
test4sub53of100,test4pub6of100,10,191,11,1980,76,2067
test4sub25of100,test4pub6of100,10,191,11,1980,76,2067
test4sub72of100,test4pub6of100,10,191,11,1982,76,2069
test4sub18of100,test4pub6of100,10,191,11,1982,75,2068
test4sub34of100,test4pub6of100,10,191,11,1984,75,2070
test4sub60of100,test4pub6of100,10,191,11,1985,75,2071
test4sub42of100,test4pub6of100,10,191,11,1986,75,2072
test4sub22of100,test4pub6of100,10,191,11,1987,75,2073
test4sub13of100,test4pub6of100,10,191,11,1988,76,2075
test4sub4of100,test4pub6of100,10,191,11,1988,76,2075
test4sub14of100,test4pub7of100,10,191,17,1704,76,1797
test4sub17of100,test4pub7of100,10,191,17,1704,76,1797
test4sub27of100,test4pub6of100,10,191,11,1992,76,2079
test4sub85of100,test4pub6of100,10,191,11,1993,76,2080
test4sub48of100,test4pub7of100,10,191,17,1708,75,1800
test4sub92of100,test4pub6of100,10,191,11,1995,74,2080
test4sub10of100,test4pub1of100,10,1469,25,488,3118,3631
test4sub57of100,test4pub6of100,10,191,11,1997,112,2120
test4sub1of100,test4pub7of100,10,191,17,1713,111,1841
test4sub90of100,test4pub6of100,10,191,11,2000,111,2122
test4sub75of100,test4pub6of100,10,191,11,2001,111,2123
test4sub39of100,test4pub6of100,10,191,11,2001,111,2123
test4sub16of100,test4pub6of100,10,191,11,2003,110,2124
test4sub44of100,test4pub7of100,10,191,17,1717,111,1845
test4sub88of100,test4pub6of100,10,191,11,2005,110,2126
test4sub73of100,test4pub6of100,10,191,11,2005,112,2128
test4sub93of100,test4pub5of100,10,191,17,2445,110,2572
test4sub74of100,test4pub6of100,10,191,11,2007,112,2130
test4sub70of100,test4pub6of100,10,191,11,2009,111,2131
test4sub66of100,test4pub7of100,10,191,17,1723,112,1852
test4sub2of100,test4pub6of100,10,191,11,2011,110,2132
test4sub29of100,test4pub6of100,10,191,11,2010,112,2133
test4sub82of100,test4pub1of100,10,1469,25,502,3157,3684
test4sub35of100,test4pub6of100,10,191,11,2013,149,2173
test4sub69of100,test4pub6of100,10,191,11,2012,151,2174
test4sub11of100,test4pub7of100,10,191,17,1728,149,1894
test4sub87of100,test4pub6of100,10,191,11,2016,149,2176
test4sub94of100,test4pub7of100,10,191,17,1731,149,1897
test4sub9of100,test4pub7of100,10,191,17,1732,148,1897
test4sub41of100,test4pub1of100,10,1469,25,512,3191,3728
test4sub76of100,test4pub6of100,10,191,11,2020,185,2216
test4sub96of100,test4pub7of100,10,191,17,1736,184,1937
test4sub3of100,test4pub6of100,10,191,11,2022,185,2218
test4sub78of100,test4pub7of100,10,191,17,1741,182,1940
test4sub62of100,test4pub7of100,10,191,17,1740,182,1939
test4sub23of100,test4pub1of100,10,1469,25,521,3226,3772
test4sub100of100,test4pub6of100,10,191,11,2028,220,2259
test4sub65of100,test4pub7of100,10,191,17,1744,220,1981
test4sub33of100,test4pub7of100,10,191,17,1744,220,1981
test4sub99of100,test4pub7of100,10,191,17,1746,220,1983
test4sub45of100,test4pub7of100,10,191,17,1746,220,1983
test4sub63of100,test4pub7of100,10,191,17,1748,219,1984
test4sub50of100,test4pub7of100,10,191,17,1748,220,1985
test4sub37of100,test4pub1of100,10,1469,25,529,3269,3823
test4sub49of100,test4pub1of100,10,1469,25,528,3311,3864
test4sub19of100,test4pub7of100,10,191,17,1752,305,2074
test4sub81of100,test4pub7of100,10,191,17,1751,306,2074
test4sub24of100,test4pub7of100,10,191,17,1753,304,2074
test4sub86of100,test4pub7of100,10,191,17,1753,306,2076
test4sub55of100,test4pub7of100,10,191,17,1755,305,2077
test4sub97of100,test4pub7of100,10,191,17,1755,305,2077
test4sub61of100,test4pub6of100,10,191,11,2043,306,2360
test4sub80of100,test4pub7of100,10,191,17,1757,306,2080
test4sub91of100,test4pub5of100,10,191,17,2482,306,2805
test4sub15of100,test4pub7of100,10,191,17,1759,306,2082
test4sub28of100,test4pub7of100,10,191,17,1762,304,2083
test4sub21of100,test4pub7of100,10,191,17,1762,304,2083
test4sub52of100,test4pub7of100,10,191,17,1764,304,2085
test4sub84of100,test4pub7of100,10,191,17,1764,305,2086
test4sub5of100,test4pub9of100,10,191,16,1588,304,1908
test4sub38of100,test4pub7of100,10,191,17,1766,304,2087
test4sub67of100,test4pub7of100,10,191,17,1767,304,2088
test4sub95of100,test4pub6of100,10,191,11,2053,304,2368
test4sub20of100,test4pub7of100,10,191,17,1769,305,2091
test4sub46of100,test4pub7of100,10,191,17,1769,305,2091
test4sub68of100,test4pub4of100,10,191,11,2259,627,2897
test4sub25of100,test4pub7of100,10,191,17,1771,305,2093
test4sub18of100,test4pub7of100,10,191,17,1773,304,2094
test4sub72of100,test4pub7of100,10,191,17,1773,304,2094
test4sub34of100,test4pub7of100,10,191,17,1774,304,2095
test4sub60of100,test4pub7of100,10,191,17,1775,304,2096
test4sub22of100,test4pub7of100,10,191,17,1776,304,2097
test4sub42of100,test4pub7of100,10,191,17,1776,304,2097
test4sub4of100,test4pub7of100,10,191,17,1779,303,2099
test4sub13of100,test4pub7of100,10,191,17,1779,303,2099
test4sub17of100,test4pub9of100,10,191,16,1604,303,1923
test4sub14of100,test4pub9of100,10,191,16,1604,304,1924
test4sub27of100,test4pub7of100,10,191,17,1783,303,2103
test4sub85of100,test4pub7of100,10,191,17,1783,303,2103
test4sub48of100,test4pub8of100,10,191,17,1657,303,1977
test4sub92of100,test4pub7of100,10,191,17,1785,303,2105
test4sub57of100,test4pub7of100,10,191,17,1824,265,2106
test4sub10of100,test4pub2of100,10,191,18,3581,266,3865
test4sub1of100,test4pub8of100,10,191,17,1698,265,1980
test4sub90of100,test4pub7of100,10,191,17,1826,266,2109
test4sub75of100,test4pub7of100,10,191,17,1827,265,2109
test4sub39of100,test4pub7of100,10,191,17,1827,265,2109
test4sub44of100,test4pub8of100,10,191,17,1702,266,1985
test4sub16of100,test4pub7of100,10,191,17,1829,266,2112
test4sub98of100,test4pub1of100,10,1469,25,612,3307,3944
test4sub73of100,test4pub7of100,10,191,17,1832,302,2151
test4sub93of100,test4pub6of100,10,191,11,2119,304,2434
test4sub74of100,test4pub7of100,10,191,17,1834,303,2154
test4sub70of100,test4pub7of100,10,191,17,1834,304,2155
test4sub66of100,test4pub8of100,10,191,17,1708,303,2028
test4sub2of100,test4pub7of100,10,191,17,1836,306,2159
test4sub29of100,test4pub7of100,10,191,17,1837,304,2158
test4sub71of100,test4pub1of100,10,1469,25,643,3324,3992
test4sub82of100,test4pub2of100,10,191,18,3634,306,3958
test4sub79of100,test4pub1of100,10,1469,25,658,3348,4031
test4sub11of100,test4pub8of100,10,191,17,1751,344,2112
test4sub69of100,test4pub7of100,10,191,17,1878,346,2241
test4sub87of100,test4pub7of100,10,191,17,1880,345,2242
test4sub9of100,test4pub8of100,10,191,17,1755,344,2116
test4sub26of100,test4pub1of100,10,1469,25,667,3383,4075
test4sub76of100,test4pub7of100,10,191,17,1920,348,2285
test4sub3of100,test4pub7of100,10,191,17,1921,347,2285
test4sub96of100,test4pub8of100,10,191,17,1794,347,2158
test4sub78of100,test4pub8of100,10,191,17,1796,347,2160
test4sub62of100,test4pub8of100,10,191,17,1796,348,2161
test4sub43of100,test4pub2of100,10,191,18,463,3567,4048
test4sub23of100,test4pub2of100,10,191,18,3721,309,4048
test4sub65of100,test4pub10of100,10,192,10,1746,309,2065
test4sub99of100,test4pub10of100,10,192,10,1747,310,2067
test4sub63of100,test4pub8of100,10,191,17,1840,310,2167
test4sub50of100,test4pub9of100,10,191,16,1791,311,2118
test4sub45of100,test4pub8of100,10,191,17,1869,282,2168
test4sub37of100,test4pub2of100,10,191,18,3774,265,4057
test4sub49of100,test4pub2of100,10,191,18,3813,225,4056
test4sub19of100,test4pub8of100,10,191,17,1930,225,2172
test4sub81of100,test4pub8of100,10,191,17,1931,224,2172
test4sub24of100,test4pub8of100,10,191,17,1932,226,2175
test4sub86of100,test4pub8of100,10,191,17,1933,226,2176
test4sub55of100,test4pub8of100,10,191,17,1934,227,2178
test4sub97of100,test4pub8of100,10,191,17,1935,229,2181
test4sub80of100,test4pub8of100,10,191,17,1937,230,2184
test4sub61of100,test4pub7of100,10,191,17,2064,232,2313
test4sub15of100,test4pub8of100,10,191,17,1939,232,2188
test4sub91of100,test4pub6of100,10,191,11,2351,234,2596
test4sub83of100,test4pub7of100,10,191,17,1749,550,2316
test4sub28of100,test4pub8of100,10,191,17,1940,233,2190
test4sub21of100,test4pub9of100,10,191,16,1890,234,2140
test4sub52of100,test4pub9of100,10,191,16,1892,234,2142
test4sub84of100,test4pub8of100,10,191,17,1942,235,2194
test4sub5of100,test4pub8of100,10,191,17,1943,234,2194
test4sub38of100,test4pub8of100,10,191,17,1944,234,2195
test4sub95of100,test4pub7of100,10,191,17,2072,234,2323
test4sub67of100,test4pub9of100,10,191,16,1895,234,2145
test4sub46of100,test4pub9of100,10,191,16,1897,234,2147
test4sub20of100,test4pub8of100,10,191,17,1947,234,2198
test4sub25of100,test4pub8of100,10,191,17,1949,235,2201
test4sub68of100,test4pub3of100,10,191,10,3680,234,3924
test4sub72of100,test4pub8of100,10,191,17,1951,235,2203
test4sub18of100,test4pub8of100,10,191,17,1950,235,2202
test4sub34of100,test4pub9of100,10,191,16,1902,235,2153
test4sub60of100,test4pub9of100,10,191,16,1903,235,2154
test4sub22of100,test4pub9of100,10,191,16,1904,235,2155
test4sub42of100,test4pub8of100,10,191,17,1954,235,2206
test4sub40of100,test4pub2of100,10,191,18,988,3112,4118
test4sub9of100,test4pub9of100,10,191,16,2050,117,2183
test4sub69of100,test4pub8of100,10,191,17,2098,119,2234
test4sub87of100,test4pub8of100,10,191,17,2098,120,2235
test4sub11of100,test4pub9of100,10,191,16,2046,123,2185
test4sub79of100,test4pub2of100,10,191,18,3981,124,4123
test4sub26of100,test4pub2of100,10,191,18,4026,80,4124
test4sub82of100,test4pub4of100,10,191,11,2996,165,3172
test4sub71of100,test4pub2of100,10,191,18,3941,165,4124
test4sub2of100,test4pub8of100,10,191,17,2015,207,2239
test4sub29of100,test4pub9of100,10,191,16,1966,206,2188
test4sub66of100,test4pub9of100,10,191,16,1962,212,2190
test4sub70of100,test4pub9of100,10,191,16,1962,213,2191
test4sub74of100,test4pub8of100,10,191,17,2010,215,2242
test4sub73of100,test4pub9of100,10,191,16,1959,218,2193
test4sub98of100,test4pub2of100,10,191,18,3893,218,4129
test4sub44of100,test4pub10of100,10,192,10,1876,259,2145
test4sub16of100,test4pub8of100,10,191,17,1969,259,2245
test4sub93of100,test4pub7of100,10,191,17,2137,216,2370
test4sub75of100,test4pub8of100,10,191,17,1966,262,2245
test4sub39of100,test4pub9of100,10,191,16,1917,263,2196
test4sub1of100,test4pub10of100,10,192,10,1873,266,2149
test4sub90of100,test4pub8of100,10,191,17,1965,266,2248
test4sub57of100,test4pub9of100,10,191,16,1913,268,2197
test4sub10of100,test4pub4of100,10,191,11,2902,269,3182
test4sub85of100,test4pub8of100,10,191,17,1960,273,2250
test4sub3of100,test4pub8of100,10,191,17,2142,88,2247
test4sub27of100,test4pub8of100,10,191,17,1959,274,2250
test4sub14of100,test4pub8of100,10,191,17,1958,277,2252
test4sub4of100,test4pub8of100,10,191,17,1956,278,2251
test4sub48of100,test4pub9of100,10,191,16,1911,271,2198
test4sub92of100,test4pub9of100,10,191,16,1911,271,2198
test4sub13of100,test4pub9of100,10,191,16,1906,278,2200
test4sub17of100,test4pub8of100,10,191,17,1958,277,2252
test4sub96of100,test4pub9of100,10,191,16,2093,96,2205
test4sub78of100,test4pub9of100,10,191,16,2095,96,2207
test4sub62of100,test4pub9of100,10,191,16,2095,96,2207
test4sub23of100,test4pub3of100,10,191,10,3878,95,3983
test4sub43of100,test4pub1of100,10,1469,25,4058,136,4219
test4sub65of100,test4pub8of100,10,191,17,2149,135,2301
test4sub99of100,test4pub8of100,10,191,17,2150,135,2302
test4sub50of100,test4pub8of100,10,191,17,2152,133,2302
test4sub45of100,test4pub9of100,10,191,16,2103,134,2253
test4sub37of100,test4pub3of100,10,191,10,3885,133,4028
test4sub49of100,test4pub4of100,10,191,11,3093,134,3238
test4sub19of100,test4pub9of100,10,191,16,2106,132,2254
test4sub81of100,test4pub10of100,10,192,10,2064,134,2208
test4sub24of100,test4pub9of100,10,191,16,2108,132,2256
test4sub86of100,test4pub9of100,10,191,16,2110,131,2257
test4sub55of100,test4pub9of100,10,191,16,2113,130,2259
test4sub97of100,test4pub9of100,10,191,16,2115,128,2259
test4sub80of100,test4pub9of100,10,191,16,2117,126,2259
test4sub61of100,test4pub8of100,10,191,17,2169,126,2312
test4sub15of100,test4pub9of100,10,191,16,2121,124,2261
test4sub91of100,test4pub7of100,10,191,17,2300,125,2442
test4sub83of100,test4pub8of100,10,191,17,2173,124,2314
test4sub28of100,test4pub9of100,10,191,16,2125,124,2265
test4sub21of100,test4pub8of100,10,191,17,2175,124,2316
test4sub52of100,test4pub8of100,10,191,17,2177,125,2319
test4sub84of100,test4pub9of100,10,191,16,2127,125,2268
test4sub38of100,test4pub9of100,10,191,16,2129,124,2269
test4sub5of100,test4pub10of100,10,192,10,2086,125,2221
test4sub95of100,test4pub8of100,10,191,17,2180,124,2321
test4sub67of100,test4pub10of100,10,192,10,2088,124,2222
test4sub46of100,test4pub8of100,10,191,17,2182,124,2323
test4sub20of100,test4pub9of100,10,191,16,2132,124,2272
test4sub25of100,test4pub10of100,10,192,10,2092,124,2226
test4sub68of100,test4pub5of100,10,191,17,3035,124,3176
test4sub72of100,test4pub9of100,10,191,16,2136,124,2276
test4sub18of100,test4pub9of100,10,191,16,2136,124,2276
test4sub41of100,test4pub2of100,10,191,18,3677,519,4214
test4sub34of100,test4pub8of100,10,191,17,2188,124,2329
test4sub60of100,test4pub8of100,10,191,17,2188,126,2331
test4sub40of100,test4pub3of100,10,191,10,3946,99,4055
test4sub22of100,test4pub8of100,10,191,17,2190,101,2308
test4sub42of100,test4pub9of100,10,191,16,2166,100,2282
test4sub9of100,test4pub10of100,10,192,10,2125,101,2236
test4sub69of100,test4pub10of100,10,192,10,2126,101,2237
test4sub87of100,test4pub10of100,10,192,10,2127,102,2239
test4sub11of100,test4pub10of100,10,192,10,2128,102,2240
test4sub79of100,test4pub4of100,10,191,11,3160,102,3273
test4sub26of100,test4pub3of100,10,191,10,3952,103,4065
test4sub71of100,test4pub3of100,10,191,10,3953,103,4066
test4sub82of100,test4pub5of100,10,191,17,3073,104,3194
test4sub29of100,test4pub8of100,10,191,17,2224,105,2346
test4sub66of100,test4pub10of100,10,192,10,2133,105,2248
test4sub74of100,test4pub10of100,10,192,10,2134,105,2249
test4sub70of100,test4pub8of100,10,191,17,2226,106,2349
test4sub2of100,test4pub9of100,10,191,16,2173,106,2295
test4sub73of100,test4pub8of100,10,191,17,2227,105,2349
test4sub98of100,test4pub3of100,10,191,10,3958,107,4075
test4sub44of100,test4pub9of100,10,191,16,2178,107,2301
test4sub16of100,test4pub9of100,10,191,16,2178,108,2302
test4sub75of100,test4pub9of100,10,191,16,2179,109,2304
test4sub93of100,test4pub8of100,10,191,17,2229,110,2356
test4sub39of100,test4pub10of100,10,192,10,2138,108,2256
test4sub7of100,test4pub1of100,10,1469,25,1138,3153,4316
test4sub90of100,test4pub9of100,10,191,16,2181,148,2345
test4sub1of100,test4pub9of100,10,191,16,2181,150,2347
test4sub57of100,test4pub8of100,10,191,17,2232,149,2398
test4sub85of100,test4pub9of100,10,191,16,2183,149,2348
test4sub14of100,test4pub10of100,10,192,10,2143,148,2301
test4sub4of100,test4pub9of100,10,191,16,2185,149,2350
test4sub27of100,test4pub9of100,10,191,16,2185,149,2350
test4sub48of100,test4pub10of100,10,192,10,2144,150,2304
test4sub3of100,test4pub10of100,10,192,10,2142,151,2303
test4sub92of100,test4pub10of100,10,192,10,2145,152,2307
test4sub13of100,test4pub10of100,10,192,10,2145,152,2307
test4sub17of100,test4pub10of100,10,192,10,2146,152,2308
test4sub96of100,test4pub10of100,10,192,10,2149,150,2309
test4sub78of100,test4pub10of100,10,192,10,2149,152,2311
test4sub62of100,test4pub10of100,10,192,10,2150,150,2310
test4sub23of100,test4pub4of100,10,191,11,3182,152,3345
test4sub30of100,test4pub1of100,10,1469,25,1168,3175,4368
test4sub43of100,test4pub4of100,10,191,11,3223,148,3382
test4sub99of100,test4pub9of100,10,191,16,2236,148,2400
test4sub50of100,test4pub10of100,10,192,10,2194,148,2352
test4sub45of100,test4pub10of100,10,192,10,2196,148,2354
test4sub37of100,test4pub4of100,10,191,11,3227,148,3386
test4sub49of100,test4pub3of100,10,191,10,4020,148,4178
test4sub19of100,test4pub10of100,10,192,10,2198,149,2357
test4sub81of100,test4pub9of100,10,191,16,2241,149,2406
test4sub24of100,test4pub10of100,10,192,10,2199,149,2358
test4sub86of100,test4pub10of100,10,192,10,2201,150,2361
test4sub55of100,test4pub10of100,10,192,10,2201,151,2362
test4sub97of100,test4pub10of100,10,192,10,2202,150,2362
test4sub80of100,test4pub10of100,10,192,10,2203,151,2364
test4sub61of100,test4pub9of100,10,191,16,2246,151,2413
test4sub15of100,test4pub10of100,10,192,10,2205,151,2366
test4sub91of100,test4pub9of100,10,191,16,2248,151,2415
test4sub83of100,test4pub10of100,10,192,10,2207,151,2368
test4sub28of100,test4pub10of100,10,192,10,2208,151,2369
test4sub21of100,test4pub10of100,10,192,10,2208,151,2369
test4sub52of100,test4pub10of100,10,192,10,2210,152,2372
test4sub84of100,test4pub10of100,10,192,10,2210,151,2371
test4sub38of100,test4pub10of100,10,192,10,2212,152,2374
test4sub5of100,test4pub11of100,10,192,11,2093,152,2256
test4sub95of100,test4pub9of100,10,191,16,2255,152,2423
test4sub67of100,test4pub8of100,10,191,17,2306,152,2475
test4sub46of100,test4pub10of100,10,192,10,2215,151,2376
test4sub20of100,test4pub10of100,10,192,10,2216,151,2377
test4sub25of100,test4pub9of100,10,191,16,2259,151,2426
test4sub68of100,test4pub6of100,10,191,11,2722,151,2884
test4sub72of100,test4pub10of100,10,192,10,2219,152,2381
test4sub18of100,test4pub10of100,10,192,10,2219,151,2380
test4sub41of100,test4pub3of100,10,191,10,4044,151,4205
test4sub34of100,test4pub10of100,10,192,10,2222,151,2383
test4sub94of100,test4pub8of100,10,191,17,1753,713,2483
test4sub60of100,test4pub10of100,10,192,10,2223,150,2383
test4sub42of100,test4pub10of100,10,192,10,2225,150,2385
test4sub22of100,test4pub10of100,10,192,10,2225,150,2385
test4sub9of100,test4pub11of100,10,192,11,2108,151,2270
test4sub69of100,test4pub9of100,10,191,16,2270,150,2436
test4sub87of100,test4pub9of100,10,191,16,2272,148,2436
test4sub11of100,test4pub11of100,10,192,11,2112,149,2272
test4sub79of100,test4pub3of100,10,191,10,4056,148,4214
test4sub26of100,test4pub4of100,10,191,11,3264,147,3422
test4sub71of100,test4pub4of100,10,191,11,3266,148,3425
test4sub82of100,test4pub3of100,10,191,10,4058,147,4215
test4sub29of100,test4pub10of100,10,192,10,2237,147,2394
test4sub66of100,test4pub11of100,10,192,11,2119,147,2277
test4sub74of100,test4pub9of100,10,191,16,2282,147,2445
test4sub70of100,test4pub10of100,10,192,10,2240,147,2397
test4sub2of100,test4pub10of100,10,192,10,2241,146,2397
test4sub73of100,test4pub10of100,10,192,10,2242,147,2399
test4sub98of100,test4pub4of100,10,191,11,3274,146,3431
test4sub44of100,test4pub11of100,10,192,11,2125,146,2282
test4sub16of100,test4pub10of100,10,192,10,2245,145,2400
test4sub75of100,test4pub10of100,10,192,10,2246,146,2402
test4sub93of100,test4pub9of100,10,191,16,2289,145,2450
test4sub39of100,test4pub8of100,10,191,17,2340,145,2502
test4sub6of100,test4pub7of100,10,191,17,1728,885,2630
test4sub7of100,test4pub2of100,10,191,18,4265,106,4389
test4sub90of100,test4pub10of100,10,192,10,2289,107,2406
test4sub1of100,test4pub11of100,10,192,11,2171,106,2288
test4sub14of100,test4pub11of100,10,192,11,2173,106,2290
test4sub85of100,test4pub10of100,10,192,10,2292,106,2408
test4sub27of100,test4pub10of100,10,192,10,2294,106,2410
test4sub4of100,test4pub10of100,10,192,10,2294,107,2411
test4sub48of100,test4pub11of100,10,192,11,2176,106,2293
test4sub3of100,test4pub9of100,10,191,16,2338,107,2461
test4sub13of100,test4pub8of100,10,191,17,2390,106,2513
test4sub92of100,test4pub8of100,10,191,17,2389,107,2513
test4sub17of100,test4pub11of100,10,192,11,2180,106,2297
test4sub96of100,test4pub11of100,10,192,11,2181,106,2298
test4sub62of100,test4pub11of100,10,192,11,2182,106,2299
test4sub78of100,test4pub11of100,10,192,11,2182,106,2299
test4sub23of100,test4pub5of100,10,191,17,3246,106,3369
test4sub30of100,test4pub3of100,10,191,10,4163,69,4242
test4sub43of100,test4pub5of100,10,191,17,3284,70,3371
test4sub99of100,test4pub11of100,10,192,11,2224,68,2303
test4sub50of100,test4pub11of100,10,192,11,2224,70,2305
test4sub45of100,test4pub11of100,10,192,11,2226,69,2306
test4sub37of100,test4pub5of100,10,191,17,3288,70,3375
test4sub49of100,test4pub5of100,10,191,17,3290,69,3376
test4sub19of100,test4pub11of100,10,192,11,2229,68,2308
test4sub24of100,test4pub11of100,10,192,11,2231,68,2310
test4sub81of100,test4pub11of100,10,192,11,2230,68,2309
test4sub86of100,test4pub11of100,10,192,11,2233,68,2312
test4sub55of100,test4pub11of100,10,192,11,2233,67,2311
test4sub97of100,test4pub11of100,10,192,11,2235,68,2314
test4sub80of100,test4pub11of100,10,192,11,2235,67,2313
test4sub61of100,test4pub10of100,10,192,10,2356,67,2433
test4sub15of100,test4pub11of100,10,192,11,2238,67,2316
test4sub91of100,test4pub10of100,10,192,10,2358,67,2435
test4sub83of100,test4pub9of100,10,191,16,2400,67,2483
test4sub28of100,test4pub11of100,10,192,11,2241,67,2319
test4sub21of100,test4pub11of100,10,192,11,2242,67,2320
test4sub52of100,test4pub11of100,10,192,11,2243,67,2321
test4sub84of100,test4pub11of100,10,192,11,2244,67,2322
test4sub38of100,test4pub11of100,10,192,11,2245,66,2322
test4sub5of100,test4pub13of100,10,192,11,1942,67,2020
test4sub95of100,test4pub10of100,10,192,10,2366,67,2443
test4sub67of100,test4pub11of100,10,192,11,2247,68,2326
test4sub20of100,test4pub11of100,10,192,11,2249,67,2327
test4sub46of100,test4pub11of100,10,192,11,2248,68,2327
test4sub25of100,test4pub11of100,10,192,11,2250,67,2328
test4sub68of100,test4pub7of100,10,191,17,2588,68,2673
test4sub72of100,test4pub11of100,10,192,11,2252,67,2330
test4sub18of100,test4pub11of100,10,192,11,2252,68,2331
test4sub41of100,test4pub4of100,10,191,11,3404,68,3483
test4sub34of100,test4pub11of100,10,192,11,2254,69,2334
test4sub94of100,test4pub9of100,10,191,16,2416,68,2500
test4sub60of100,test4pub11of100,10,192,11,2256,68,2335
test4sub22of100,test4pub11of100,10,192,11,2257,68,2336
test4sub42of100,test4pub11of100,10,192,11,2257,68,2336
test4sub9of100,test4pub13of100,10,192,11,1955,68,2034
test4sub69of100,test4pub11of100,10,192,11,2259,68,2338
test4sub11of100,test4pub13of100,10,192,11,1957,69,2037
test4sub87of100,test4pub11of100,10,192,11,2261,69,2341
test4sub26of100,test4pub5of100,10,191,17,3324,69,3410
test4sub79of100,test4pub5of100,10,191,17,3324,69,3410
test4sub82of100,test4pub6of100,10,191,11,2888,69,2968
test4sub71of100,test4pub5of100,10,191,17,3326,69,3412
test4sub29of100,test4pub11of100,10,192,11,2266,69,2346
test4sub66of100,test4pub12of100,10,191,9,1980,69,2058
test4sub74of100,test4pub11of100,10,192,11,2268,70,2349
test4sub70of100,test4pub11of100,10,192,11,2268,69,2348
test4sub2of100,test4pub11of100,10,192,11,2270,70,2351
test4sub73of100,test4pub11of100,10,192,11,2270,71,2352
test4sub98of100,test4pub5of100,10,191,17,3333,71,3421
test4sub44of100,test4pub12of100,10,191,9,1985,71,2065
test4sub16of100,test4pub11of100,10,192,11,2273,72,2356
test4sub75of100,test4pub11of100,10,192,11,2273,72,2356
test4sub39of100,test4pub11of100,10,192,11,2275,72,2358
test4sub93of100,test4pub10of100,10,192,10,2393,72,2475
test4sub6of100,test4pub8of100,10,191,17,2487,72,2576
test4sub7of100,test4pub3of100,10,191,10,4218,72,4300
test4sub90of100,test4pub11of100,10,192,11,2277,72,2360
test4sub1of100,test4pub12of100,10,191,9,1992,73,2074
test4sub14of100,test4pub13of100,10,192,11,1975,72,2058
test4sub85of100,test4pub11of100,10,192,11,2279,72,2362
test4sub4of100,test4pub11of100,10,192,11,2282,72,2365
test4sub27of100,test4pub11of100,10,192,11,2282,72,2365
test4sub48of100,test4pub12of100,10,191,9,1998,72,2079
test4sub3of100,test4pub11of100,10,192,11,2284,71,2366
test4sub92of100,test4pub11of100,10,192,11,2286,71,2368
test4sub13of100,test4pub11of100,10,192,11,2286,72,2369
test4sub17of100,test4pub12of100,10,191,9,2001,71,2081
test4sub96of100,test4pub12of100,10,191,9,2002,71,2082
test4sub78of100,test4pub13of100,10,192,11,1986,71,2068
test4sub62of100,test4pub12of100,10,191,9,2003,71,2083
test4sub30of100,test4pub4of100,10,191,11,3441,70,3522
test4sub23of100,test4pub6of100,10,191,11,2915,71,2997
test4sub99of100,test4pub12of100,10,191,9,2007,70,2086
test4sub43of100,test4pub3of100,10,191,10,4235,71,4316
test4sub50of100,test4pub12of100,10,191,9,2009,70,2088
test4sub37of100,test4pub6of100,10,191,11,2920,69,3000
test4sub19of100,test4pub12of100,10,191,9,2012,69,2090
test4sub49of100,test4pub6of100,10,191,11,2922,70,3003
test4sub81of100,test4pub12of100,10,191,9,2013,70,2092
test4sub24of100,test4pub12of100,10,191,9,2013,70,2092
test4sub86of100,test4pub13of100,10,192,11,1997,70,2078
test4sub55of100,test4pub13of100,10,192,11,1997,70,2078
test4sub97of100,test4pub12of100,10,191,9,2017,71,2097
test4sub80of100,test4pub12of100,10,191,9,2017,70,2096
test4sub61of100,test4pub11of100,10,192,11,2305,70,2386
test4sub15of100,test4pub13of100,10,192,11,2001,70,2082
test4sub91of100,test4pub8of100,10,191,17,2518,70,2605
test4sub83of100,test4pub11of100,10,192,11,2307,70,2388
test4sub28of100,test4pub12of100,10,191,9,2023,70,2102
test4sub21of100,test4pub13of100,10,192,11,2005,70,2086
test4sub52of100,test4pub13of100,10,192,11,2007,70,2088
test4sub84of100,test4pub12of100,10,191,9,2025,70,2104
test4sub38of100,test4pub13of100,10,192,11,2009,71,2091
test4sub5of100,test4pub12of100,10,191,9,2027,70,2106
test4sub95of100,test4pub11of100,10,192,11,2314,71,2396
test4sub67of100,test4pub12of100,10,191,9,2029,71,2109
test4sub51of100,test4pub2of100,10,191,18,1407,3077,4502
test4sub20of100,test4pub12of100,10,191,9,2031,71,2111
test4sub46of100,test4pub12of100,10,191,9,2031,72,2112
test4sub25of100,test4pub13of100,10,192,11,2015,71,2097
test4sub68of100,test4pub9of100,10,191,16,2480,71,2567
test4sub72of100,test4pub13of100,10,192,11,2017,71,2099
test4sub18of100,test4pub12of100,10,191,9,2035,72,2116
test4sub41of100,test4pub5of100,10,191,17,3385,71,3473
test4sub34of100,test4pub12of100,10,191,9,2037,72,2118
test4sub94of100,test4pub10of100,10,192,10,2443,71,2524
test4sub60of100,test4pub12of100,10,191,9,2039,73,2121
test4sub22of100,test4pub12of100,10,191,9,2040,71,2120
test4sub42of100,test4pub12of100,10,191,9,2041,73,2123
test4sub9of100,test4pub12of100,10,191,9,2042,71,2122
test4sub69of100,test4pub13of100,10,192,11,2025,73,2109
test4sub11of100,test4pub12of100,10,191,9,2044,71,2124
test4sub87of100,test4pub12of100,10,191,9,2045,73,2127
test4sub26of100,test4pub6of100,10,191,11,2956,72,3039
test4sub79of100,test4pub6of100,10,191,11,2956,73,3040
test4sub82of100,test4pub7of100,10,191,17,2672,72,2761
test4sub71of100,test4pub6of100,10,191,11,2959,74,3044
test4sub76of100,test4pub8of100,10,191,17,2141,479,2637
test4sub29of100,test4pub13of100,10,192,11,2032,73,2116
test4sub74of100,test4pub12of100,10,191,9,2052,72,2133
test4sub70of100,test4pub12of100,10,191,9,2053,72,2134
test4sub2of100,test4pub13of100,10,192,11,2037,72,2120
test4sub73of100,test4pub13of100,10,192,11,2037,73,2121
test4sub98of100,test4pub6of100,10,191,11,2967,71,3049
test4sub44of100,test4pub14of100,10,192,10,2000,73,2083
test4sub16of100,test4pub12of100,10,191,9,2059,72,2140
test4sub75of100,test4pub12of100,10,191,9,2060,73,2142
test4sub39of100,test4pub12of100,10,191,9,2061,72,2142
test4sub93of100,test4pub11of100,10,192,11,2348,74,2433
test4sub6of100,test4pub9of100,10,191,16,2510,72,2598
test4sub7of100,test4pub4of100,10,191,11,3499,73,3583
test4sub90of100,test4pub12of100,10,191,9,2065,73,2147
test4sub1of100,test4pub13of100,10,192,11,2047,75,2133
test4sub14of100,test4pub12of100,10,191,9,2066,73,2148
test4sub85of100,test4pub13of100,10,192,11,2049,74,2134
test4sub27of100,test4pub12of100,10,191,9,2069,73,2151
test4sub4of100,test4pub12of100,10,191,9,2068,74,2151
test4sub48of100,test4pub13of100,10,192,11,2052,73,2136
test4sub3of100,test4pub13of100,10,192,11,2052,74,2137
test4sub92of100,test4pub13of100,10,192,11,2054,74,2139
test4sub13of100,test4pub13of100,10,192,11,2054,76,2141
test4sub17of100,test4pub14of100,10,192,10,2016,74,2100
test4sub96of100,test4pub13of100,10,192,11,2056,76,2143
test4sub78of100,test4pub12of100,10,191,9,2075,74,2158
test4sub62of100,test4pub13of100,10,192,11,2057,75,2143
test4sub30of100,test4pub5of100,10,191,17,3425,75,3517
test4sub23of100,test4pub7of100,10,191,17,2701,75,2793
test4sub99of100,test4pub14of100,10,192,10,2022,75,2107
test4sub43of100,test4pub6of100,10,191,11,2989,76,3076
test4sub50of100,test4pub13of100,10,192,11,2062,75,2148
test4sub37of100,test4pub7of100,10,191,17,2705,76,2798
test4sub19of100,test4pub13of100,10,192,11,2064,75,2150
test4sub49of100,test4pub7of100,10,191,17,2706,77,2800
test4sub81of100,test4pub13of100,10,192,11,2066,75,2152
test4sub24of100,test4pub13of100,10,192,11,2066,77,2154
test4sub77of100,test4pub2of100,10,191,18,1467,3076,4561
test4sub86of100,test4pub12of100,10,191,9,2086,77,2172
test4sub97of100,test4pub13of100,10,192,11,2070,75,2156
test4sub80of100,test4pub13of100,10,192,11,2071,77,2159
test4sub61of100,test4pub12of100,10,191,9,2090,75,2174
test4sub15of100,test4pub12of100,10,191,9,2091,76,2176
test4sub91of100,test4pub11of100,10,192,11,2378,75,2464
test4sub83of100,test4pub13of100,10,192,11,2074,77,2162
test4sub28of100,test4pub13of100,10,192,11,2076,75,2162
test4sub21of100,test4pub12of100,10,191,9,2094,77,2180
test4sub52of100,test4pub12of100,10,191,9,2096,77,2182
test4sub84of100,test4pub14of100,10,192,10,2040,77,2127
test4sub38of100,test4pub12of100,10,191,9,2098,76,2183
test4sub5of100,test4pub14of100,10,192,10,2042,78,2130
test4sub95of100,test4pub13of100,10,192,11,2082,77,2170
test4sub67of100,test4pub13of100,10,192,11,2083,78,2172
test4sub51of100,test4pub4of100,10,191,11,3538,76,3625
test4sub20of100,test4pub13of100,10,192,11,2085,78,2174
test4sub46of100,test4pub13of100,10,192,11,2086,76,2173
test4sub25of100,test4pub12of100,10,191,9,2104,78,2191
test4sub68of100,test4pub8of100,10,191,17,2603,77,2697
test4sub72of100,test4pub12of100,10,191,9,2106,78,2193
test4sub18of100,test4pub13of100,10,192,11,2090,76,2177
test4sub41of100,test4pub6of100,10,191,11,3018,77,3106
test4sub34of100,test4pub13of100,10,192,11,2092,76,2179
test4sub94of100,test4pub11of100,10,192,11,2396,77,2484
test4sub60of100,test4pub13of100,10,192,11,2094,76,2181
test4sub22of100,test4pub13of100,10,192,11,2095,77,2183
test4sub42of100,test4pub13of100,10,192,11,2096,76,2183
test4sub9of100,test4pub14of100,10,192,10,2058,77,2145
test4sub69of100,test4pub12of100,10,191,9,2116,75,2200
test4sub11of100,test4pub14of100,10,192,10,2060,76,2146
test4sub87of100,test4pub13of100,10,192,11,2101,75,2187
test4sub26of100,test4pub7of100,10,191,17,2743,76,2836
test4sub79of100,test4pub7of100,10,191,17,2745,75,2837
test4sub82of100,test4pub8of100,10,191,17,2618,76,2711
test4sub71of100,test4pub7of100,10,191,17,2747,74,2838
test4sub76of100,test4pub9of100,10,191,16,2570,76,2662
test4sub29of100,test4pub12of100,10,191,9,2125,75,2209
test4sub74of100,test4pub13of100,10,192,11,2107,75,2193
test4sub70of100,test4pub13of100,10,192,11,2109,75,2195
test4sub2of100,test4pub14of100,10,192,10,2071,75,2156
test4sub73of100,test4pub12of100,10,191,9,2129,74,2212
test4sub98of100,test4pub7of100,10,191,17,2754,74,2845
test4sub44of100,test4pub13of100,10,192,11,2114,74,2199
test4sub16of100,test4pub13of100,10,192,11,2114,74,2199
test4sub75of100,test4pub13of100,10,192,11,2116,75,2202
test4sub39of100,test4pub13of100,10,192,11,2116,74,2201
test4sub93of100,test4pub13of100,10,192,11,2118,74,2203
test4sub6of100,test4pub10of100,10,192,10,2541,74,2625
test4sub7of100,test4pub5of100,10,191,17,3486,75,3578
test4sub90of100,test4pub13of100,10,192,11,2120,74,2205
test4sub1of100,test4pub14of100,10,192,10,2083,74,2167
test4sub14of100,test4pub14of100,10,192,10,2083,75,2168
test4sub85of100,test4pub12of100,10,191,9,2142,74,2225
test4sub27of100,test4pub13of100,10,192,11,2124,75,2210
test4sub4of100,test4pub13of100,10,192,11,2126,74,2211
test4sub48of100,test4pub14of100,10,192,10,2087,75,2172
test4sub3of100,test4pub12of100,10,191,9,2146,74,2229
test4sub92of100,test4pub12of100,10,191,9,2146,74,2229
test4sub13of100,test4pub12of100,10,191,9,2148,74,2231
test4sub17of100,test4pub13of100,10,192,11,2130,74,2215
test4sub96of100,test4pub14of100,10,192,10,2093,73,2176
test4sub78of100,test4pub14of100,10,192,10,2093,74,2177
test4sub62of100,test4pub14of100,10,192,10,2095,73,2178
test4sub30of100,test4pub6of100,10,191,11,3062,74,3147
test4sub23of100,test4pub8of100,10,191,17,2651,73,2741
test4sub99of100,test4pub13of100,10,192,11,2136,73,2220
test4sub43of100,test4pub7of100,10,191,17,2779,72,2868
test4sub50of100,test4pub14of100,10,192,10,2099,73,2182
test4sub37of100,test4pub8of100,10,191,17,2655,72,2744
test4sub19of100,test4pub14of100,10,192,10,2101,72,2183
test4sub49of100,test4pub8of100,10,191,17,2657,71,2745
test4sub81of100,test4pub14of100,10,192,10,2104,73,2187
test4sub24of100,test4pub14of100,10,192,10,2105,71,2186
test4sub77of100,test4pub4of100,10,191,11,3599,73,3683
test4sub86of100,test4pub14of100,10,192,10,2107,71,2188
test4sub97of100,test4pub14of100,10,192,10,2108,73,2191
test4sub80of100,test4pub14of100,10,192,10,2109,71,2190
test4sub61of100,test4pub13of100,10,192,11,2148,73,2232
test4sub15of100,test4pub14of100,10,192,10,2111,73,2194
test4sub91of100,test4pub12of100,10,191,9,2168,73,2250
test4sub83of100,test4pub12of100,10,191,9,2170,73,2252
test4sub28of100,test4pub14of100,10,192,10,2114,74,2198
test4sub21of100,test4pub14of100,10,192,10,2115,73,2198
test4sub52of100,test4pub14of100,10,192,10,2116,73,2199
test4sub84of100,test4pub13of100,10,192,11,2156,73,2240
test4sub38of100,test4pub14of100,10,192,10,2118,72,2200
test4sub5of100,test4pub15of100,10,192,10,2010,72,2092
test4sub95of100,test4pub12of100,10,191,9,2177,72,2258
test4sub67of100,test4pub14of100,10,192,10,2122,72,2204
test4sub51of100,test4pub3of100,10,191,10,4407,72,4489
test4sub20of100,test4pub14of100,10,192,10,2124,71,2205
test4sub46of100,test4pub14of100,10,192,10,2125,72,2207
test4sub25of100,test4pub14of100,10,192,10,2126,71,2207
test4sub68of100,test4pub10of100,10,192,10,2589,71,2670
test4sub72of100,test4pub14of100,10,192,10,2128,71,2209
test4sub18of100,test4pub14of100,10,192,10,2128,72,2210
test4sub41of100,test4pub7of100,10,191,17,2811,73,2901
test4sub34of100,test4pub14of100,10,192,10,2130,72,2212
test4sub94of100,test4pub13of100,10,192,11,2171,72,2254
test4sub60of100,test4pub14of100,10,192,10,2132,73,2215
test4sub22of100,test4pub14of100,10,192,10,2133,72,2215
test4sub42of100,test4pub14of100,10,192,10,2134,72,2216
test4sub9of100,test4pub15of100,10,192,10,2026,72,2108
test4sub69of100,test4pub14of100,10,192,10,2136,72,2218
test4sub11of100,test4pub15of100,10,192,10,2027,72,2109
test4sub87of100,test4pub14of100,10,192,10,2138,72,2220
test4sub26of100,test4pub8of100,10,191,17,2693,72,2782
test4sub79of100,test4pub9of100,10,191,16,2644,72,2732
test4sub82of100,test4pub9of100,10,191,16,2645,72,2733
test4sub71of100,test4pub8of100,10,191,17,2696,72,2785
test4sub29of100,test4pub14of100,10,192,10,2143,72,2225
test4sub74of100,test4pub14of100,10,192,10,2144,71,2225
test4sub70of100,test4pub14of100,10,192,10,2146,72,2228
test4sub2of100,test4pub12of100,10,191,9,2203,72,2284
test4sub73of100,test4pub14of100,10,192,10,2147,71,2228
test4sub98of100,test4pub9of100,10,191,16,2652,72,2740
test4sub44of100,test4pub15of100,10,192,10,2040,70,2120
test4sub16of100,test4pub14of100,10,192,10,2150,70,2230
test4sub75of100,test4pub14of100,10,192,10,2152,71,2233
test4sub39of100,test4pub14of100,10,192,10,2152,70,2232
test4sub93of100,test4pub12of100,10,191,9,2211,70,2290
test4sub6of100,test4pub11of100,10,192,11,2498,70,2579
test4sub7of100,test4pub6of100,10,191,11,3123,70,3204
test4sub90of100,test4pub14of100,10,192,10,2156,70,2236
test4sub59of100,test4pub4of100,10,191,11,644,3078,3733
test4sub1of100,test4pub15of100,10,192,10,2048,71,2129
test4sub14of100,test4pub15of100,10,192,10,2049,70,2129
test4sub85of100,test4pub14of100,10,192,10,2160,71,2241
test4sub27of100,test4pub15of100,10,192,10,2051,70,2131
test4sub4of100,test4pub14of100,10,192,10,2161,70,2241
test4sub48of100,test4pub15of100,10,192,10,2053,71,2134
test4sub3of100,test4pub15of100,10,192,10,2053,71,2134
test4sub92of100,test4pub14of100,10,192,10,2165,71,2246
test4sub13of100,test4pub14of100,10,192,10,2165,71,2246
test4sub96of100,test4pub15of100,10,192,10,2057,71,2138
test4sub17of100,test4pub15of100,10,192,10,2057,71,2138
test4sub62of100,test4pub15of100,10,192,10,2058,70,2138
test4sub78of100,test4pub15of100,10,192,10,2058,71,2139
test4sub23of100,test4pub9of100,10,191,16,2674,70,2760
test4sub43of100,test4pub8of100,10,191,17,2725,70,2812
test4sub50of100,test4pub15of100,10,192,10,2063,69,2142
test4sub37of100,test4pub9of100,10,191,16,2677,69,2762
test4sub19of100,test4pub15of100,10,192,10,2065,70,2145
test4sub49of100,test4pub9of100,10,191,16,2679,69,2764
test4sub81of100,test4pub15of100,10,192,10,2067,69,2146
test4sub24of100,test4pub15of100,10,192,10,2067,69,2146
test4sub77of100,test4pub5of100,10,191,17,3584,68,3669
test4sub86of100,test4pub15of100,10,192,10,2069,69,2148
test4sub97of100,test4pub16of100,10,192,10,1987,68,2065
test4sub80of100,test4pub15of100,10,192,10,2071,68,2149
test4sub61of100,test4pub14of100,10,192,10,2184,68,2262
test4sub15of100,test4pub15of100,10,192,10,2075,67,2152
test4sub91of100,test4pub13of100,10,192,11,2225,68,2304
test4sub83of100,test4pub14of100,10,192,10,2187,66,2263
test4sub28of100,test4pub15of100,10,192,10,2078,68,2156
test4sub21of100,test4pub15of100,10,192,10,2079,66,2155
test4sub52of100,test4pub15of100,10,192,10,2080,67,2157
test4sub84of100,test4pub15of100,10,192,10,2081,66,2157
test4sub38of100,test4pub15of100,10,192,10,2082,67,2159
test4sub5of100,test4pub16of100,10,192,10,1999,65,2074
test4sub95of100,test4pub14of100,10,192,10,2193,67,2270
test4sub67of100,test4pub15of100,10,192,10,2085,66,2161
test4sub51of100,test4pub5of100,10,191,17,3600,67,3684
test4sub20of100,test4pub15of100,10,192,10,2087,66,2163
test4sub46of100,test4pub15of100,10,192,10,2087,67,2164
test4sub25of100,test4pub15of100,10,192,10,2088,66,2164
test4sub68of100,test4pub11of100,10,192,11,2542,67,2620
test4sub72of100,test4pub15of100,10,192,10,2090,65,2165
test4sub18of100,test4pub15of100,10,192,10,2091,66,2167
test4sub34of100,test4pub15of100,10,192,10,2093,64,2167
test4sub41of100,test4pub8of100,10,191,17,2757,66,2840
test4sub60of100,test4pub15of100,10,192,10,2095,65,2170
test4sub94of100,test4pub12of100,10,191,9,2262,65,2336
test4sub22of100,test4pub15of100,10,192,10,2096,65,2171
test4sub42of100,test4pub15of100,10,192,10,2097,66,2173
test4sub9of100,test4pub16of100,10,192,10,2014,65,2089
test4sub69of100,test4pub15of100,10,192,10,2099,64,2173
test4sub11of100,test4pub16of100,10,192,10,2016,65,2091
test4sub87of100,test4pub15of100,10,192,10,2101,65,2176
test4sub26of100,test4pub9of100,10,191,16,2716,65,2797
test4sub79of100,test4pub8of100,10,191,17,2767,65,2849
test4sub82of100,test4pub10of100,10,192,10,2676,65,2751
test4sub71of100,test4pub9of100,10,191,16,2719,65,2800
test4sub90of100,test4pub15of100,10,192,10,2117,74,2201
test4sub7of100,test4pub7of100,10,191,17,2908,74,2999
test4sub6of100,test4pub12of100,10,191,9,2283,77,2369
test4sub29of100,test4pub15of100,10,192,10,2106,65,2181
test4sub93of100,test4pub14of100,10,192,10,2225,78,2313
test4sub39of100,test4pub15of100,10,192,10,2113,81,2204
test4sub75of100,test4pub15of100,10,192,10,2113,82,2205
test4sub44of100,test4pub16of100,10,192,10,2027,84,2121
test4sub98of100,test4pub10of100,10,192,10,2682,87,2779
test4sub16of100,test4pub15of100,10,192,10,2112,84,2206
test4sub2of100,test4pub15of100,10,192,10,2108,89,2207
test4sub73of100,test4pub15of100,10,192,10,2110,88,2208
test4sub74of100,test4pub15of100,10,192,10,2107,92,2209
test4sub70of100,test4pub15of100,10,192,10,2108,90,2208
test4sub36of100,test4pub1of100,10,1469,25,1689,3118,4832
test4sub59of100,test4pub3of100,10,191,10,4514,112,4636
test4sub1of100,test4pub16of100,10,192,10,2035,114,2159
test4sub14of100,test4pub16of100,10,192,10,2037,113,2160
test4sub85of100,test4pub15of100,10,192,10,2121,114,2245
test4sub27of100,test4pub14of100,10,192,10,2232,113,2355
test4sub4of100,test4pub15of100,10,192,10,2123,115,2248
test4sub48of100,test4pub16of100,10,192,10,2040,113,2163
test4sub3of100,test4pub14of100,10,192,10,2234,114,2358
test4sub92of100,test4pub15of100,10,192,10,2126,113,2249
test4sub13of100,test4pub15of100,10,192,10,2126,113,2249
test4sub96of100,test4pub16of100,10,192,10,2044,113,2167
test4sub17of100,test4pub16of100,10,192,10,2044,113,2167
test4sub62of100,test4pub16of100,10,192,10,2046,114,2170
test4sub78of100,test4pub16of100,10,192,10,2046,113,2169
test4sub23of100,test4pub10of100,10,192,10,2703,113,2826
test4sub43of100,test4pub9of100,10,191,16,2746,114,2876
test4sub50of100,test4pub16of100,10,192,10,2049,113,2172
test4sub37of100,test4pub10of100,10,192,10,2706,114,2830
test4sub8of100,test4pub4of100,10,191,11,2318,1534,3863
test4sub19of100,test4pub16of100,10,192,10,2051,114,2175
test4sub49of100,test4pub10of100,10,192,10,2707,124,2841
test4sub81of100,test4pub16of100,10,192,10,2053,125,2188
test4sub24of100,test4pub16of100,10,192,10,2053,126,2189
test4sub77of100,test4pub3of100,10,191,10,4534,125,4669
test4sub86of100,test4pub16of100,10,192,10,2055,125,2190
test4sub97of100,test4pub15of100,10,192,10,2140,125,2275
test4sub80of100,test4pub16of100,10,192,10,2057,126,2193
test4sub61of100,test4pub15of100,10,192,10,2142,124,2276
test4sub15of100,test4pub16of100,10,192,10,2059,126,2195
test4sub91of100,test4pub15of100,10,192,10,2144,131,2285
test4sub83of100,test4pub15of100,10,192,10,2145,133,2288
test4sub28of100,test4pub16of100,10,192,10,2062,131,2203
test4sub21of100,test4pub16of100,10,192,10,2062,132,2204
test4sub52of100,test4pub16of100,10,192,10,2064,132,2206
test4sub84of100,test4pub16of100,10,192,10,2064,133,2207
test4sub38of100,test4pub16of100,10,192,10,2065,132,2207
test4sub5of100,test4pub17of100,10,192,17,1787,134,1938
test4sub95of100,test4pub15of100,10,192,10,2151,132,2293
test4sub67of100,test4pub16of100,10,192,10,2068,134,2212
test4sub51of100,test4pub6of100,10,191,11,3230,132,3373
test4sub20of100,test4pub16of100,10,192,10,2069,134,2213
test4sub46of100,test4pub16of100,10,192,10,2071,133,2214
test4sub25of100,test4pub16of100,10,192,10,2071,134,2215
test4sub68of100,test4pub14of100,10,192,10,2266,133,2409
test4sub72of100,test4pub16of100,10,192,10,2073,134,2217
test4sub18of100,test4pub16of100,10,192,10,2074,133,2217
test4sub34of100,test4pub16of100,10,192,10,2074,134,2218
test4sub66of100,test4pub13of100,10,192,11,2033,409,2453
test4sub41of100,test4pub9of100,10,191,16,2774,135,2925
test4sub94of100,test4pub15of100,10,192,10,2161,135,2306
test4sub65of100,test4pub9of100,10,191,16,2235,677,2928
test4sub22of100,test4pub16of100,10,192,10,2079,137,2226
test4sub9of100,test4pub17of100,10,192,17,1801,144,1962
test4sub69of100,test4pub16of100,10,192,10,2080,146,2236
test4sub11of100,test4pub17of100,10,192,17,1803,144,1964
test4sub87of100,test4pub16of100,10,192,10,2082,146,2238
test4sub12of100,test4pub1of100,10,1469,25,1738,3188,4951
test4sub26of100,test4pub10of100,10,192,10,2740,185,2935
test4sub82of100,test4pub11of100,10,192,11,2623,184,2818
test4sub71of100,test4pub10of100,10,192,10,2742,185,2937
test4sub6of100,test4pub13of100,10,192,11,2342,164,2517
test4sub90of100,test4pub16of100,10,192,10,2109,164,2283
test4sub93of100,test4pub15of100,10,192,10,2194,166,2370
test4sub29of100,test4pub16of100,10,192,10,2110,166,2286
test4sub39of100,test4pub16of100,10,192,10,2111,167,2288
test4sub44of100,test4pub17of100,10,192,17,1833,165,2015
test4sub75of100,test4pub16of100,10,192,10,2112,167,2289
test4sub7of100,test4pub8of100,10,191,17,2857,167,3041
test4sub98of100,test4pub8of100,10,191,17,2861,169,3047
test4sub16of100,test4pub16of100,10,192,10,2114,168,2292
test4sub2of100,test4pub16of100,10,192,10,2114,168,2292
test4sub74of100,test4pub16of100,10,192,10,2116,168,2294
test4sub73of100,test4pub16of100,10,192,10,2116,168,2294
test4sub70of100,test4pub16of100,10,192,10,2117,168,2295
test4sub36of100,test4pub2of100,10,191,18,4781,138,4937
test4sub59of100,test4pub5of100,10,191,17,3748,138,3903
test4sub1of100,test4pub17of100,10,192,17,1871,138,2026
test4sub14of100,test4pub17of100,10,192,17,1871,138,2026
test4sub85of100,test4pub16of100,10,192,10,2152,139,2301
test4sub27of100,test4pub16of100,10,192,10,2152,139,2301
test4sub4of100,test4pub16of100,10,192,10,2154,138,2302
test4sub48of100,test4pub17of100,10,192,17,1875,138,2030
test4sub3of100,test4pub16of100,10,192,10,2156,139,2305
test4sub13of100,test4pub16of100,10,192,10,2157,138,2305
test4sub17of100,test4pub19of100,10,192,18,1832,138,1988
test4sub96of100,test4pub17of100,10,192,17,1879,139,2035
test4sub62of100,test4pub17of100,10,192,17,1881,137,2035
test4sub78of100,test4pub17of100,10,192,17,1882,139,2038
test4sub43of100,test4pub10of100,10,192,10,2818,137,2965
test4sub23of100,test4pub11of100,10,192,11,2699,139,2849
test4sub37of100,test4pub11of100,10,192,11,2701,138,2850
test4sub50of100,test4pub17of100,10,192,17,1885,139,2041
test4sub8of100,test4pub5of100,10,191,17,3765,137,3919
test4sub19of100,test4pub17of100,10,192,17,1887,139,2043
test4sub49of100,test4pub11of100,10,192,11,2713,128,2852
test4sub81of100,test4pub17of100,10,192,17,1899,128,2044
test4sub24of100,test4pub17of100,10,192,17,1901,126,2044
test4sub77of100,test4pub6of100,10,191,11,3341,127,3479
test4sub86of100,test4pub17of100,10,192,17,1903,127,2047
test4sub97of100,test4pub17of100,10,192,17,1903,127,2047
test4sub61of100,test4pub16of100,10,192,10,2184,127,2321
test4sub80of100,test4pub17of100,10,192,17,1904,127,2048
test4sub15of100,test4pub19of100,10,192,18,1859,126,2003
test4sub91of100,test4pub14of100,10,192,10,2386,120,2516
test4sub28of100,test4pub17of100,10,192,17,1915,119,2051
test4sub83of100,test4pub16of100,10,192,10,2194,120,2324
test4sub21of100,test4pub17of100,10,192,17,1917,119,2053
test4sub52of100,test4pub17of100,10,192,17,1917,119,2053
test4sub84of100,test4pub18of100,10,192,15,1897,121,2033
test4sub38of100,test4pub17of100,10,192,17,1920,119,2056
test4sub95of100,test4pub16of100,10,192,10,2200,119,2329
test4sub5of100,test4pub18of100,10,192,15,1900,119,2034
test4sub51of100,test4pub7of100,10,191,17,3077,119,3213
test4sub67of100,test4pub18of100,10,192,15,1902,119,2036
test4sub20of100,test4pub17of100,10,192,17,1925,118,2060
test4sub46of100,test4pub18of100,10,192,15,1904,119,2038
test4sub68of100,test4pub13of100,10,192,11,2439,119,2569
test4sub25of100,test4pub17of100,10,192,17,1927,119,2063
test4sub18of100,test4pub18of100,10,192,15,1908,119,2042
test4sub72of100,test4pub17of100,10,192,17,1929,119,2065
test4sub34of100,test4pub17of100,10,192,17,1930,118,2065
test4sub66of100,test4pub14of100,10,192,10,2404,118,2532
test4sub41of100,test4pub10of100,10,192,10,2867,118,2995
test4sub94of100,test4pub14of100,10,192,10,2407,116,2533
test4sub65of100,test4pub11of100,10,192,11,2752,117,2880
test4sub22of100,test4pub18of100,10,192,15,1924,108,2047
test4sub9of100,test4pub19of100,10,192,18,1900,107,2025
test4sub69of100,test4pub18of100,10,192,15,1927,105,2047
test4sub11of100,test4pub18of100,10,192,15,1928,107,2050
test4sub87of100,test4pub17of100,10,192,17,1950,105,2072
test4sub58of100,test4pub1of100,10,1469,25,1904,3130,5059
test4sub12of100,test4pub4of100,10,191,11,3956,106,4073
test4sub26of100,test4pub11of100,10,192,11,2807,107,2925
test4sub82of100,test4pub12of100,10,191,9,2522,107,2638
test4sub71of100,test4pub11of100,10,192,11,2809,106,2926
test4sub6of100,test4pub14of100,10,192,10,2468,106,2584
test4sub90of100,test4pub17of100,10,192,17,1996,107,2120
test4sub93of100,test4pub16of100,10,192,10,2276,105,2391
test4sub29of100,test4pub18of100,10,192,15,1977,107,2099
test4sub44of100,test4pub19of100,10,192,18,1953,106,2077
test4sub39of100,test4pub18of100,10,192,15,1978,107,2100
test4sub75of100,test4pub17of100,10,192,17,2001,106,2124
test4sub7of100,test4pub9of100,10,191,16,2979,107,3102
test4sub98of100,test4pub11of100,10,192,11,2819,106,2936
test4sub16of100,test4pub19of100,10,192,18,1956,107,2081
test4sub2of100,test4pub17of100,10,192,17,2005,106,2128
test4sub74of100,test4pub17of100,10,192,17,2005,108,2130
test4sub73of100,test4pub17of100,10,192,17,2006,106,2129
test4sub70of100,test4pub17of100,10,192,17,2007,108,2132
test4sub36of100,test4pub3of100,10,191,10,4766,106,4882
test4sub59of100,test4pub6of100,10,191,11,3449,107,3567
test4sub1of100,test4pub18of100,10,192,15,1989,106,2110
test4sub14of100,test4pub18of100,10,192,15,1990,107,2112
test4sub85of100,test4pub17of100,10,192,17,2012,105,2134
test4sub27of100,test4pub18of100,10,192,15,1992,107,2114
test4sub4of100,test4pub18of100,10,192,15,1993,106,2114
test4sub48of100,test4pub19of100,10,192,18,1968,107,2093
test4sub3of100,test4pub17of100,10,192,17,2016,105,2138
test4sub13of100,test4pub17of100,10,192,17,2017,107,2141
test4sub17of100,test4pub17of100,10,192,17,2018,106,2141
test4sub96of100,test4pub18of100,10,192,15,1998,107,2120
test4sub62of100,test4pub18of100,10,192,15,1999,106,2120
test4sub43of100,test4pub11of100,10,192,11,2837,105,2953
test4sub78of100,test4pub18of100,10,192,15,2000,106,2121
test4sub23of100,test4pub13of100,10,192,11,2535,106,2652
test4sub37of100,test4pub12of100,10,191,9,2553,106,2668
test4sub50of100,test4pub19of100,10,192,18,1977,106,2101
test4sub8of100,test4pub6of100,10,191,11,3465,106,3582
test4sub19of100,test4pub19of100,10,192,18,1979,106,2103
test4sub49of100,test4pub13of100,10,192,11,2539,106,2656
test4sub24of100,test4pub18of100,10,192,15,2008,105,2128
test4sub77of100,test4pub7of100,10,191,17,3183,106,3306
test4sub86of100,test4pub18of100,10,192,15,2009,105,2129
test4sub97of100,test4pub18of100,10,192,15,2010,106,2131
test4sub61of100,test4pub17of100,10,192,17,2032,105,2154
test4sub80of100,test4pub18of100,10,192,15,2011,105,2131
test4sub91of100,test4pub16of100,10,192,10,2313,106,2429
test4sub15of100,test4pub18of100,10,192,15,2013,106,2134
test4sub83of100,test4pub18of100,10,192,15,2015,106,2136
test4sub28of100,test4pub18of100,10,192,15,2015,106,2136
test4sub21of100,test4pub18of100,10,192,15,2016,106,2137
test4sub52of100,test4pub18of100,10,192,15,2017,106,2138
test4sub38of100,test4pub18of100,10,192,15,2018,105,2138
test4sub84of100,test4pub17of100,10,192,17,2039,106,2162
test4sub95of100,test4pub17of100,10,192,17,2041,105,2163
test4sub5of100,test4pub19of100,10,192,18,1994,105,2117
test4sub67of100,test4pub17of100,10,192,17,2043,105,2165
test4sub51of100,test4pub9of100,10,191,16,3020,105,3141
test4sub20of100,test4pub18of100,10,192,15,2024,105,2144
test4sub46of100,test4pub17of100,10,192,17,2045,105,2167
test4sub68of100,test4pub12of100,10,191,9,2576,104,2689
test4sub25of100,test4pub18of100,10,192,15,2025,104,2144
test4sub18of100,test4pub17of100,10,192,17,2048,103,2168
test4sub20of100,test4pub19of100,10,192,18,2505,1,2524
test4sub72of100,test4pub18of100,10,192,15,2027,103,2145
test4sub34of100,test4pub18of100,10,192,15,2029,102,2146
test4sub51of100,test4pub8of100,10,191,17,3579,3,3599
test4sub66of100,test4pub15of100,10,192,10,2413,102,2525
test4sub41of100,test4pub11of100,10,192,11,2867,100,2978
test4sub94of100,test4pub16of100,10,192,10,2330,101,2441
test4sub20of100,test4pub20of100,10,192,10,2154,2,2166
test4sub22of100,test4pub17of100,10,192,17,2053,100,2170
test4sub65of100,test4pub12of100,10,191,9,2583,100,2692
test4sub69of100,test4pub17of100,10,192,17,2055,99,2171
test4sub41of100,test4pub12of100,10,191,9,3088,1,3098
test4sub9of100,test4pub18of100,10,192,15,2034,99,2148
test4sub11of100,test4pub19of100,10,192,18,2009,97,2124
test4sub41of100,test4pub13of100,10,192,11,3072,2,3085
test4sub87of100,test4pub18of100,10,192,15,2036,97,2148
test4sub58of100,test4pub3of100,10,191,10,4855,57,4922
test4sub12of100,test4pub3of100,10,191,10,4856,57,4923
test4sub26of100,test4pub12of100,10,191,9,2629,56,2694
test4sub82of100,test4pub13of100,10,192,11,2611,56,2678
test4sub51of100,test4pub10of100,10,192,10,3491,7,3508
test4sub71of100,test4pub12of100,10,191,9,2631,55,2695
test4sub6of100,test4pub15of100,10,192,10,2464,54,2528
test4sub90of100,test4pub19of100,10,192,18,2056,52,2126
test4sub93of100,test4pub19of100,10,192,18,2057,53,2128
test4sub29of100,test4pub17of100,10,192,17,2105,51,2173
test4sub44of100,test4pub18of100,10,192,15,2085,50,2150
test4sub39of100,test4pub17of100,10,192,17,2108,50,2175
test4sub75of100,test4pub19of100,10,192,18,2061,50,2129
test4sub7of100,test4pub10of100,10,192,10,3044,48,3102
test4sub98of100,test4pub12of100,10,191,9,2640,49,2698
test4sub16of100,test4pub17of100,10,192,17,2111,47,2175
test4sub2of100,test4pub18of100,10,192,15,2090,48,2153
test4sub74of100,test4pub18of100,10,192,15,2092,47,2154
test4sub73of100,test4pub19of100,10,192,18,2067,46,2131
test4sub70of100,test4pub18of100,10,192,15,2094,45,2154
test4sub36of100,test4pub4of100,10,191,11,4081,45,4137
test4sub59of100,test4pub7of100,10,191,17,3271,44,3332
test4sub1of100,test4pub19of100,10,192,18,2070,45,2133
test4sub14of100,test4pub19of100,10,192,18,2071,43,2132
test4sub85of100,test4pub18of100,10,192,15,2098,43,2156
test4sub27of100,test4pub17of100,10,192,17,2121,42,2180
test4sub4of100,test4pub17of100,10,192,17,2121,42,2180
test4sub48of100,test4pub18of100,10,192,15,2101,40,2156
test4sub3of100,test4pub18of100,10,192,15,2102,40,2157
test4sub13of100,test4pub19of100,10,192,18,2077,39,2134
test4sub17of100,test4pub18of100,10,192,15,2103,39,2157
test4sub96of100,test4pub19of100,10,192,18,2079,38,2135
test4sub62of100,test4pub19of100,10,192,18,2079,38,2135
test4sub43of100,test4pub12of100,10,191,9,2658,37,2704
test4sub78of100,test4pub19of100,10,192,18,2081,37,2136
test4sub23of100,test4pub12of100,10,191,9,2659,36,2704
test4sub37of100,test4pub13of100,10,192,11,2642,36,2689
test4sub50of100,test4pub18of100,10,192,15,2110,34,2159
test4sub8of100,test4pub7of100,10,191,17,3286,35,3338
test4sub19of100,test4pub18of100,10,192,15,2112,33,2160
test4sub49of100,test4pub14of100,10,192,10,2606,33,2649
test4sub24of100,test4pub19of100,10,192,18,2088,32,2138
test4sub77of100,test4pub9of100,10,191,16,3112,32,3160
test4sub86of100,test4pub19of100,10,192,18,2090,31,2139
test4sub97of100,test4pub19of100,10,192,18,2090,31,2139
test4sub61of100,test4pub18of100,10,192,15,2117,30,2162
test4sub80of100,test4pub19of100,10,192,18,2092,30,2140
test4sub91of100,test4pub17of100,10,192,17,2140,28,2185
test4sub15of100,test4pub17of100,10,192,17,2141,29,2187
test4sub83of100,test4pub19of100,10,192,18,2095,27,2140
test4sub28of100,test4pub19of100,10,192,18,2096,27,2141
test4sub21of100,test4pub19of100,10,192,18,2097,25,2140
test4sub52of100,test4pub19of100,10,192,18,2097,26,2141
test4sub38of100,test4pub19of100,10,192,18,2099,25,2142
test4sub84of100,test4pub19of100,10,192,18,2099,25,2142
test4sub95of100,test4pub18of100,10,192,15,2126,23,2164
test4sub5of100,test4pub20of100,10,192,10,1747,24,1781
test4sub67of100,test4pub19of100,10,192,18,2102,22,2142
test4sub60of100,test4pub16of100,10,192,10,2077,414,2501
test4sub41of100,test4pub14of100,10,192,10,3035,5,3050
test4sub46of100,test4pub19of100,10,192,18,2506,33,2557
test4sub51of100,test4pub11of100,10,192,11,3381,4,3396
test4sub20of100,test4pub21of100,10,192,13,2103,10,2126
test4sub68of100,test4pub15of100,10,192,10,2917,38,2965
test4sub58of100,test4pub4of100,10,191,11,4529,4,4544
test4sub25of100,test4pub19of100,10,192,18,2507,40,2565
test4sub18of100,test4pub19of100,10,192,18,2508,41,2567
test4sub72of100,test4pub19of100,10,192,18,2509,42,2569
test4sub34of100,test4pub19of100,10,192,18,2509,42,2569
test4sub66of100,test4pub16of100,10,192,10,2836,43,2889
test4sub94of100,test4pub17of100,10,192,17,2558,42,2617
test4sub22of100,test4pub19of100,10,192,18,2511,43,2572
test4sub65of100,test4pub13of100,10,192,11,3071,42,3124
test4sub69of100,test4pub19of100,10,192,18,2513,44,2575
test4sub9of100,test4pub20of100,10,192,10,2160,43,2213
test4sub11of100,test4pub20of100,10,192,10,2160,44,2214
test4sub87of100,test4pub19of100,10,192,18,2515,44,2577
test4sub12of100,test4pub5of100,10,191,17,4441,43,4501
test4sub26of100,test4pub13of100,10,192,11,3076,44,3131
test4sub82of100,test4pub14of100,10,192,10,3038,44,3092
test4sub71of100,test4pub13of100,10,192,11,3077,35,3123
test4sub60of100,test4pub17of100,10,192,17,2573,37,2627
test4sub5of100,test4pub21of100,10,192,13,2118,37,2168
test4sub67of100,test4pub20of100,10,192,10,2172,39,2221
test4sub95of100,test4pub19of100,10,192,18,2525,38,2581
test4sub84of100,test4pub21of100,10,192,13,2117,39,2169
test4sub38of100,test4pub20of100,10,192,10,2171,38,2219
test4sub21of100,test4pub20of100,10,192,10,2171,40,2221
test4sub52of100,test4pub20of100,10,192,10,2171,40,2221
test4sub28of100,test4pub20of100,10,192,10,2171,40,2221
test4sub83of100,test4pub17of100,10,192,17,2572,40,2629
test4sub91of100,test4pub18of100,10,192,15,2550,41,2606
test4sub15of100,test4pub20of100,10,192,10,2171,41,2222
test4sub80of100,test4pub20of100,10,192,10,2170,43,2223
test4sub61of100,test4pub19of100,10,192,18,2524,42,2584
test4sub6of100,test4pub16of100,10,192,10,2845,43,2898
test4sub97of100,test4pub20of100,10,192,10,2170,43,2223
test4sub86of100,test4pub20of100,10,192,10,2170,44,2224
test4sub77of100,test4pub8of100,10,191,17,3598,44,3659
test4sub24of100,test4pub20of100,10,192,10,2170,45,2225
test4sub49of100,test4pub12of100,10,191,9,3100,45,3154
test4sub19of100,test4pub20of100,10,192,10,2169,45,2224
test4sub8of100,test4pub8of100,10,191,17,3597,46,3660
test4sub50of100,test4pub20of100,10,192,10,2169,47,2226
test4sub37of100,test4pub14of100,10,192,10,3043,48,3101
test4sub23of100,test4pub14of100,10,192,10,3043,48,3101
test4sub78of100,test4pub20of100,10,192,10,2169,48,2227
test4sub43of100,test4pub13of100,10,192,11,3082,50,3143
test4sub62of100,test4pub20of100,10,192,10,2168,49,2227
test4sub96of100,test4pub20of100,10,192,10,2168,50,2228
test4sub17of100,test4pub20of100,10,192,10,2168,50,2228
test4sub13of100,test4pub18of100,10,192,15,2548,51,2614
test4sub41of100,test4pub15of100,10,192,10,2948,51,3009
test4sub3of100,test4pub19of100,10,192,18,2522,52,2592
test4sub48of100,test4pub20of100,10,192,10,2168,52,2230
test4sub4of100,test4pub19of100,10,192,18,2522,52,2592
test4sub46of100,test4pub20of100,10,192,10,2185,53,2248
test4sub27of100,test4pub19of100,10,192,18,2521,53,2592
test4sub14of100,test4pub20of100,10,192,10,2167,53,2230
test4sub85of100,test4pub19of100,10,192,18,2521,55,2594
test4sub1of100,test4pub20of100,10,192,10,2167,54,2231
test4sub59of100,test4pub8of100,10,191,17,3595,55,3667
test4sub36of100,test4pub5of100,10,191,17,4446,56,4519
test4sub70of100,test4pub19of100,10,192,18,2520,57,2595
test4sub73of100,test4pub18of100,10,192,15,2546,57,2618
test4sub20of100,test4pub22of100,10,192,10,2043,57,2110
test4sub74of100,test4pub19of100,10,192,18,2520,58,2596
test4sub2of100,test4pub19of100,10,192,18,2520,59,2597
test4sub16of100,test4pub18of100,10,192,15,2546,58,2619
test4sub98of100,test4pub13of100,10,192,11,3079,59,3149
test4sub68of100,test4pub16of100,10,192,10,2871,59,2940
test4sub7of100,test4pub11of100,10,192,11,3382,59,3452
test4sub58of100,test4pub5of100,10,191,17,4471,59,4547
test4sub75of100,test4pub18of100,10,192,15,2545,61,2621
test4sub39of100,test4pub19of100,10,192,18,2519,60,2597
test4sub44of100,test4pub20of100,10,192,10,2165,62,2237
test4sub25of100,test4pub21of100,10,192,13,2140,62,2215
test4sub29of100,test4pub19of100,10,192,18,2519,63,2600
test4sub93of100,test4pub17of100,10,192,17,2566,63,2646
test4sub90of100,test4pub18of100,10,192,15,2545,63,2623
test4sub18of100,test4pub20of100,10,192,10,2196,64,2270
test4sub51of100,test4pub13of100,10,192,11,3100,64,3175
test4sub34of100,test4pub20of100,10,192,10,2198,62,2270
test4sub72of100,test4pub20of100,10,192,10,2198,64,2272
test4sub94of100,test4pub19of100,10,192,18,2554,63,2635
test4sub66of100,test4pub17of100,10,192,17,2601,64,2682
test4sub22of100,test4pub20of100,10,192,10,2201,63,2274
test4sub65of100,test4pub14of100,10,192,10,3076,64,3150
test4sub69of100,test4pub20of100,10,192,10,2203,62,2275
test4sub9of100,test4pub21of100,10,192,13,2150,64,2227
test4sub11of100,test4pub21of100,10,192,13,2151,62,2226
test4sub87of100,test4pub20of100,10,192,10,2206,63,2279
test4sub12of100,test4pub6of100,10,191,11,4048,63,4122
test4sub26of100,test4pub14of100,10,192,10,3081,64,3155
test4sub71of100,test4pub14of100,10,192,10,3083,63,3156
test4sub82of100,test4pub15of100,10,192,10,2972,64,3046
test4sub60of100,test4pub19of100,10,192,18,2564,62,2644
test4sub5of100,test4pub22of100,10,192,10,2064,64,2138
test4sub67of100,test4pub21of100,10,192,13,2158,63,2234
test4sub95of100,test4pub20of100,10,192,10,2212,64,2286
test4sub84of100,test4pub20of100,10,192,10,2213,63,2286
test4sub38of100,test4pub22of100,10,192,10,2068,64,2142
test4sub21of100,test4pub21of100,10,192,13,2161,62,2236
test4sub52of100,test4pub21of100,10,192,13,2161,64,2238
test4sub28of100,test4pub21of100,10,192,13,2163,63,2239
test4sub83of100,test4pub20of100,10,192,10,2217,64,2291
test4sub91of100,test4pub19of100,10,192,18,2572,63,2653
test4sub15of100,test4pub21of100,10,192,13,2165,64,2242
test4sub61of100,test4pub20of100,10,192,10,2220,62,2292
test4sub80of100,test4pub21of100,10,192,13,2166,64,2243
test4sub6of100,test4pub17of100,10,192,17,2623,63,2703
test4sub97of100,test4pub22of100,10,192,10,2076,64,2150
test4sub86of100,test4pub21of100,10,192,13,2169,63,2245
test4sub77of100,test4pub10of100,10,192,10,3560,64,3634
test4sub24of100,test4pub21of100,10,192,13,2171,62,2246
test4sub49of100,test4pub15of100,10,192,10,2989,64,3063
test4sub8of100,test4pub9of100,10,191,16,3605,63,3684
test4sub19of100,test4pub21of100,10,192,13,2173,65,2251
test4sub50of100,test4pub21of100,10,192,13,2174,63,2250
test4sub37of100,test4pub15of100,10,192,10,2993,64,3067
test4sub23of100,test4pub15of100,10,192,10,2994,63,3067
test4sub78of100,test4pub21of100,10,192,13,2177,64,2254
test4sub62of100,test4pub21of100,10,192,13,2178,64,2255
test4sub43of100,test4pub15of100,10,192,10,2996,64,3070
test4sub96of100,test4pub21of100,10,192,13,2180,64,2257
test4sub17of100,test4pub21of100,10,192,13,2180,64,2257
test4sub41of100,test4pub16of100,10,192,10,2916,64,2990
test4sub13of100,test4pub20of100,10,192,10,2235,64,2309
test4sub3of100,test4pub20of100,10,192,10,2237,64,2311
test4sub48of100,test4pub21of100,10,192,13,2183,64,2260
test4sub4of100,test4pub21of100,10,192,13,2185,64,2262
test4sub46of100,test4pub21of100,10,192,13,2185,65,2263
test4sub27of100,test4pub20of100,10,192,10,2240,64,2314
test4sub14of100,test4pub21of100,10,192,13,2187,64,2264
test4sub1of100,test4pub21of100,10,192,13,2188,65,2266
test4sub85of100,test4pub20of100,10,192,10,2242,64,2316
test4sub59of100,test4pub9of100,10,191,16,3622,64,3702
test4sub36of100,test4pub6of100,10,191,11,4085,64,4160
test4sub70of100,test4pub20of100,10,192,10,2246,63,2319
test4sub73of100,test4pub20of100,10,192,10,2246,63,2319
test4sub20of100,test4pub23of100,10,192,17,1918,63,1998
test4sub74of100,test4pub20of100,10,192,10,2248,64,2322
test4sub2of100,test4pub20of100,10,192,10,2249,63,2322
test4sub16of100,test4pub20of100,10,192,10,2250,64,2324
test4sub98of100,test4pub14of100,10,192,10,3125,63,3198
test4sub68of100,test4pub17of100,10,192,17,2652,63,2732
test4sub7of100,test4pub13of100,10,192,11,3165,63,3239
test4sub58of100,test4pub6of100,10,191,11,4094,64,4169
test4sub39of100,test4pub20of100,10,192,10,2254,63,2327
test4sub75of100,test4pub21of100,10,192,13,2200,63,2276
test4sub44of100,test4pub21of100,10,192,13,2202,63,2278
test4sub25of100,test4pub20of100,10,192,10,2257,63,2330
test4sub29of100,test4pub20of100,10,192,10,2258,62,2330
test4sub93of100,test4pub18of100,10,192,15,2638,63,2716
test4sub90of100,test4pub21of100,10,192,13,2206,63,2282
test4sub18of100,test4pub21of100,10,192,13,2206,63,2282
test4sub34of100,test4pub21of100,10,192,13,2208,62,2283
test4sub51of100,test4pub12of100,10,191,9,3192,63,3264
test4sub72of100,test4pub21of100,10,192,13,2209,62,2284
test4sub94of100,test4pub18of100,10,192,15,2643,62,2720
test4sub66of100,test4pub18of100,10,192,15,2645,63,2723
test4sub22of100,test4pub21of100,10,192,13,2211,63,2287
test4sub65of100,test4pub15of100,10,192,10,3030,62,3102
test4sub69of100,test4pub21of100,10,192,13,2213,63,2289
test4sub11of100,test4pub22of100,10,192,10,2122,62,2194
test4sub9of100,test4pub22of100,10,192,10,2122,62,2194
test4sub12of100,test4pub7of100,10,191,17,3825,63,3905
test4sub87of100,test4pub21of100,10,192,13,2216,62,2291
test4sub26of100,test4pub15of100,10,192,10,3036,63,3109
test4sub71of100,test4pub15of100,10,192,10,3036,62,3108
test4sub82of100,test4pub16of100,10,192,10,2953,63,3026
test4sub60of100,test4pub18of100,10,192,15,2654,63,2732
test4sub5of100,test4pub23of100,10,192,17,1945,63,2025
test4sub67of100,test4pub22of100,10,192,10,2129,63,2202
test4sub95of100,test4pub21of100,10,192,13,2223,64,2300
test4sub84of100,test4pub22of100,10,192,10,2131,64,2205
test4sub38of100,test4pub21of100,10,192,13,2224,63,2300
test4sub21of100,test4pub22of100,10,192,10,2133,64,2207
test4sub52of100,test4pub22of100,10,192,10,2134,63,2207
test4sub28of100,test4pub22of100,10,192,10,2134,66,2210
test4sub83of100,test4pub21of100,10,192,13,2228,65,2306
test4sub91of100,test4pub20of100,10,192,10,2282,66,2358
test4sub15of100,test4pub22of100,10,192,10,2137,65,2212
test4sub61of100,test4pub21of100,10,192,13,2230,66,2309
test4sub6of100,test4pub18of100,10,192,15,2665,64,2744
test4sub80of100,test4pub22of100,10,192,10,2139,66,2215
test4sub86of100,test4pub22of100,10,192,10,2141,64,2215
test4sub97of100,test4pub21of100,10,192,13,2233,66,2312
test4sub77of100,test4pub11of100,10,192,11,3506,65,3582
test4sub24of100,test4pub22of100,10,192,10,2143,67,2220
test4sub49of100,test4pub16of100,10,192,10,2970,65,3045
test4sub8of100,test4pub10of100,10,192,10,3626,67,3703
test4sub19of100,test4pub22of100,10,192,10,2146,67,2223
test4sub50of100,test4pub22of100,10,192,10,2146,67,2223
test4sub37of100,test4pub16of100,10,192,10,2974,67,3051
test4sub23of100,test4pub16of100,10,192,10,2974,68,3052
test4sub78of100,test4pub22of100,10,192,10,2149,67,2226
test4sub62of100,test4pub22of100,10,192,10,2151,68,2229
test4sub43of100,test4pub14of100,10,192,10,3171,67,3248
test4sub96of100,test4pub22of100,10,192,10,2153,68,2231
test4sub17of100,test4pub22of100,10,192,10,2153,68,2231
test4sub41of100,test4pub17of100,10,192,17,2701,68,2786
test4sub13of100,test4pub21of100,10,192,13,2247,68,2328
test4sub48of100,test4pub22of100,10,192,10,2156,67,2233
test4sub3of100,test4pub21of100,10,192,13,2248,68,2329
test4sub4of100,test4pub20of100,10,192,10,2304,68,2382
test4sub46of100,test4pub22of100,10,192,10,2158,69,2237
test4sub27of100,test4pub21of100,10,192,13,2251,68,2332
test4sub14of100,test4pub22of100,10,192,10,2160,69,2239
test4sub1of100,test4pub22of100,10,192,10,2161,68,2239
test4sub85of100,test4pub21of100,10,192,13,2253,68,2334
test4sub59of100,test4pub10of100,10,192,10,3645,69,3724
test4sub36of100,test4pub7of100,10,191,17,3864,69,3950
test4sub70of100,test4pub21of100,10,192,13,2256,69,2338
test4sub73of100,test4pub21of100,10,192,13,2256,69,2338
test4sub74of100,test4pub22of100,10,192,10,2166,69,2245
test4sub20of100,test4pub24of100,10,192,15,1899,70,1984
test4sub2of100,test4pub21of100,10,192,13,2260,71,2344
test4sub16of100,test4pub21of100,10,192,13,2260,71,2344
test4sub98of100,test4pub15of100,10,192,10,3079,71,3160
test4sub68of100,test4pub18of100,10,192,15,2695,72,2782
test4sub7of100,test4pub12of100,10,191,9,3248,72,3329
test4sub58of100,test4pub7of100,10,191,17,3872,73,3962
test4sub39of100,test4pub21of100,10,192,13,2264,73,2350
test4sub75of100,test4pub20of100,10,192,10,2319,73,2402
test4sub44of100,test4pub22of100,10,192,10,2174,73,2257
test4sub25of100,test4pub22of100,10,192,10,2174,73,2257
test4sub29of100,test4pub21of100,10,192,13,2268,72,2353
test4sub93of100,test4pub20of100,10,192,10,2322,73,2405
test4sub90of100,test4pub20of100,10,192,10,2323,72,2405
test4sub18of100,test4pub22of100,10,192,10,2178,73,2261
test4sub34of100,test4pub22of100,10,192,10,2179,73,2262
test4sub51of100,test4pub14of100,10,192,10,3199,73,3282
test4sub94of100,test4pub20of100,10,192,10,2327,73,2410
test4sub72of100,test4pub22of100,10,192,10,2180,74,2264
test4sub66of100,test4pub19of100,10,192,18,2682,73,2773
test4sub22of100,test4pub22of100,10,192,10,2182,75,2267
test4sub65of100,test4pub16of100,10,192,10,3010,74,3094
test4sub69of100,test4pub22of100,10,192,10,2184,76,2270
test4sub11of100,test4pub23of100,10,192,17,2001,74,2092
test4sub9of100,test4pub23of100,10,192,17,2002,76,2095
test4sub12of100,test4pub9of100,10,191,16,3711,74,3801
test4sub87of100,test4pub22of100,10,192,10,2188,76,2274
test4sub26of100,test4pub16of100,10,192,10,3015,74,3099
test4sub71of100,test4pub16of100,10,192,10,3015,75,3100
test4sub82of100,test4pub17of100,10,192,17,2738,74,2829
test4sub60of100,test4pub20of100,10,192,10,2338,75,2423
test4sub5of100,test4pub24of100,10,192,15,1926,73,2014
test4sub67of100,test4pub23of100,10,192,17,2010,75,2102
test4sub95of100,test4pub22of100,10,192,10,2195,73,2278
test4sub84of100,test4pub23of100,10,192,17,2011,74,2102
test4sub38of100,test4pub23of100,10,192,17,2013,73,2103
test4sub21of100,test4pub23of100,10,192,17,2013,75,2105
test4sub52of100,test4pub23of100,10,192,17,2015,72,2104
test4sub28of100,test4pub23of100,10,192,17,2017,71,2105
test4sub83of100,test4pub22of100,10,192,10,2201,72,2283
test4sub91of100,test4pub21of100,10,192,13,2295,72,2380
test4sub15of100,test4pub23of100,10,192,17,2019,72,2108
test4sub61of100,test4pub22of100,10,192,10,2204,72,2286
test4sub6of100,test4pub19of100,10,192,18,2705,72,2795
test4sub80of100,test4pub23of100,10,192,17,2022,71,2110
test4sub86of100,test4pub23of100,10,192,17,2022,72,2111
test4sub97of100,test4pub23of100,10,192,17,2024,71,2112
test4sub77of100,test4pub12of100,10,191,9,3285,71,3365
test4sub24of100,test4pub23of100,10,192,17,2026,71,2114
test4sub49of100,test4pub17of100,10,192,17,2758,70,2845
test4sub8of100,test4pub11of100,10,192,11,3575,71,3657
test4sub19of100,test4pub23of100,10,192,17,2029,72,2118
test4sub50of100,test4pub23of100,10,192,17,2031,71,2119
test4sub37of100,test4pub18of100,10,192,15,2741,72,2828
test4sub23of100,test4pub17of100,10,192,17,2764,71,2852
test4sub78of100,test4pub23of100,10,192,17,2034,70,2121
test4sub62of100,test4pub23of100,10,192,17,2036,70,2123
test4sub43of100,test4pub16of100,10,192,10,3046,70,3126
test4sub96of100,test4pub23of100,10,192,17,2037,69,2123
test4sub17of100,test4pub23of100,10,192,17,2037,70,2124
test4sub41of100,test4pub18of100,10,192,15,2749,69,2833
test4sub13of100,test4pub22of100,10,192,10,2223,69,2302
test4sub48of100,test4pub23of100,10,192,17,2041,70,2128
test4sub3of100,test4pub22of100,10,192,10,2225,69,2304
test4sub4of100,test4pub22of100,10,192,10,2227,70,2307
test4sub1of100,test4pub24of100,10,192,15,1964,81,2060
test4sub14of100,test4pub23of100,10,192,17,2045,83,2145
test4sub46of100,test4pub23of100,10,192,17,2043,85,2145
test4sub27of100,test4pub22of100,10,192,10,2229,84,2323
test4sub85of100,test4pub22of100,10,192,10,2231,85,2326
test4sub59of100,test4pub11of100,10,192,11,3595,83,3689
test4sub36of100,test4pub9of100,10,191,16,3757,84,3857
test4sub70of100,test4pub22of100,10,192,10,2234,83,2327
test4sub73of100,test4pub22of100,10,192,10,2235,84,2329
test4sub74of100,test4pub21of100,10,192,13,2328,82,2423
test4sub20of100,test4pub25of100,10,192,10,1887,82,1979
test4sub2of100,test4pub22of100,10,192,10,2239,81,2330
test4sub16of100,test4pub22of100,10,192,10,2239,82,2331
test4sub98of100,test4pub16of100,10,192,10,3068,80,3158
test4sub68of100,test4pub19of100,10,192,18,2742,81,2841
test4sub7of100,test4pub14of100,10,192,10,3264,80,3354
test4sub58of100,test4pub8of100,10,191,17,3818,80,3915
test4sub39of100,test4pub22of100,10,192,10,2246,79,2335
test4sub75of100,test4pub22of100,10,192,10,2246,80,2336
test4sub25of100,test4pub23of100,10,192,17,2064,78,2159
test4sub29of100,test4pub22of100,10,192,10,2248,80,2338
test4sub93of100,test4pub21of100,10,192,13,2342,79,2434
test4sub90of100,test4pub22of100,10,192,10,2250,81,2341
test4sub18of100,test4pub23of100,10,192,17,2067,79,2163
test4sub34of100,test4pub23of100,10,192,17,2068,81,2166
test4sub51of100,test4pub15of100,10,192,10,3164,80,3254
test4sub94of100,test4pub21of100,10,192,13,2346,81,2440
test4sub72of100,test4pub23of100,10,192,17,2071,80,2168
test4sub66of100,test4pub20of100,10,192,10,2402,79,2491
test4sub22of100,test4pub23of100,10,192,17,2074,79,2170
test4sub65of100,test4pub17of100,10,192,17,2806,79,2902
test4sub69of100,test4pub23of100,10,192,17,2076,78,2171
test4sub11of100,test4pub24of100,10,192,15,1994,79,2088
test4sub9of100,test4pub24of100,10,192,15,1995,79,2089
test4sub12of100,test4pub8of100,10,191,17,3836,78,3931
test4sub26of100,test4pub18of100,10,192,15,2790,78,2883
test4sub87of100,test4pub23of100,10,192,17,2080,78,2175
test4sub56of100,test4pub1of100,10,1469,25,529,5338,5892
test4sub89of100,test4pub7of100,10,191,17,1750,2333,4100
test4sub82of100,test4pub18of100,10,192,15,2792,118,2925
test4sub60of100,test4pub21of100,10,192,13,2359,116,2488
test4sub5of100,test4pub25of100,10,192,10,1918,117,2045
test4sub95of100,test4pub23of100,10,192,17,2085,116,2218
test4sub67of100,test4pub24of100,10,192,15,2002,117,2134
test4sub84of100,test4pub24of100,10,192,15,2003,116,2134
test4sub38of100,test4pub24of100,10,192,15,2004,118,2137
test4sub21of100,test4pub24of100,10,192,15,2005,116,2136
test4sub52of100,test4pub24of100,10,192,15,2005,117,2137
test4sub28of100,test4pub24of100,10,192,15,2007,117,2139
test4sub83of100,test4pub23of100,10,192,17,2090,118,2225
test4sub91of100,test4pub22of100,10,192,10,2275,116,2401
test4sub15of100,test4pub24of100,10,192,15,2009,118,2142
test4sub61of100,test4pub23of100,10,192,17,2093,116,2226
test4sub6of100,test4pub20of100,10,192,10,2423,118,2551
test4sub80of100,test4pub24of100,10,192,15,2012,117,2144
test4sub86of100,test4pub24of100,10,192,15,2012,118,2145
test4sub97of100,test4pub24of100,10,192,15,2013,117,2145
test4sub77of100,test4pub13of100,10,192,11,3340,117,3468
test4sub24of100,test4pub24of100,10,192,15,2015,117,2147
test4sub49of100,test4pub18of100,10,192,15,2808,117,2940
test4sub19of100,test4pub24of100,10,192,15,2018,115,2148
test4sub8of100,test4pub13of100,10,192,11,3344,116,3471
test4sub37of100,test4pub17of100,10,192,17,2834,114,2965
test4sub50of100,test4pub24of100,10,192,15,2020,116,2151
test4sub23of100,test4pub18of100,10,192,15,2814,115,2944
test4sub78of100,test4pub24of100,10,192,15,2022,117,2154
test4sub62of100,test4pub24of100,10,192,15,2023,115,2153
test4sub43of100,test4pub17of100,10,192,17,2837,117,2971
test4sub96of100,test4pub24of100,10,192,15,2025,116,2156
test4sub17of100,test4pub24of100,10,192,15,2025,118,2158
test4sub41of100,test4pub19of100,10,192,18,2793,116,2927
test4sub13of100,test4pub23of100,10,192,17,2110,117,2244
test4sub3of100,test4pub23of100,10,192,17,2111,116,2244
test4sub48of100,test4pub24of100,10,192,15,2028,117,2160
test4sub1of100,test4pub23of100,10,192,17,2129,100,2246
test4sub4of100,test4pub23of100,10,192,17,2113,101,2231
test4sub46of100,test4pub24of100,10,192,15,2046,101,2162
test4sub27of100,test4pub24of100,10,192,15,2047,102,2164
test4sub14of100,test4pub24of100,10,192,15,2046,102,2163
test4sub85of100,test4pub23of100,10,192,17,2132,103,2252
test4sub59of100,test4pub12of100,10,191,9,3393,102,3504
test4sub36of100,test4pub8of100,10,191,17,3892,102,4011
test4sub70of100,test4pub23of100,10,192,17,2134,103,2254
test4sub73of100,test4pub23of100,10,192,17,2135,103,2255
test4sub74of100,test4pub23of100,10,192,17,2135,103,2255
test4sub20of100,test4pub26of100,10,192,11,1881,104,1996
test4sub2of100,test4pub23of100,10,192,17,2137,104,2258
test4sub16of100,test4pub23of100,10,192,17,2138,103,2258
test4sub98of100,test4pub17of100,10,192,17,2870,103,2990
test4sub68of100,test4pub20of100,10,192,10,2470,103,2583
test4sub7of100,test4pub16of100,10,192,10,3150,104,3264
test4sub58of100,test4pub9of100,10,191,16,3850,105,3971
test4sub39of100,test4pub23of100,10,192,17,2142,104,2263
test4sub75of100,test4pub23of100,10,192,17,2143,105,2265
test4sub25of100,test4pub24of100,10,192,15,2061,105,2181
test4sub29of100,test4pub23of100,10,192,17,2145,105,2267
test4sub93of100,test4pub22of100,10,192,10,2330,106,2446
test4sub90of100,test4pub23of100,10,192,17,2147,106,2270
test4sub18of100,test4pub24of100,10,192,15,2064,107,2186
test4sub34of100,test4pub24of100,10,192,15,2066,106,2187
test4sub51of100,test4pub16of100,10,192,10,3161,106,3277
test4sub94of100,test4pub22of100,10,192,10,2335,106,2451
test4sub72of100,test4pub24of100,10,192,15,2069,106,2190
test4sub66of100,test4pub21of100,10,192,13,2429,106,2548
test4sub65of100,test4pub18of100,10,192,15,2864,106,2985
test4sub22of100,test4pub24of100,10,192,15,2071,107,2193
test4sub69of100,test4pub24of100,10,192,15,2073,108,2196
test4sub11of100,test4pub25of100,10,192,10,1990,108,2108
test4sub9of100,test4pub25of100,10,192,10,1991,107,2108
test4sub12of100,test4pub10of100,10,192,10,3824,108,3942
test4sub87of100,test4pub24of100,10,192,15,2076,108,2199
test4sub26of100,test4pub17of100,10,192,17,2890,109,3016
test4sub56of100,test4pub2of100,10,191,18,5841,70,5929
test4sub89of100,test4pub9of100,10,191,16,3907,71,3994
test4sub82of100,test4pub19of100,10,192,18,2884,70,2972
test4sub60of100,test4pub22of100,10,192,10,2384,70,2464
test4sub5of100,test4pub26of100,10,192,11,1946,71,2028
test4sub95of100,test4pub24of100,10,192,15,2119,71,2205
test4sub67of100,test4pub25of100,10,192,10,2037,71,2118
test4sub84of100,test4pub25of100,10,192,10,2038,71,2119
test4sub38of100,test4pub25of100,10,192,10,2039,70,2119
test4sub21of100,test4pub25of100,10,192,10,2039,70,2119
test4sub52of100,test4pub25of100,10,192,10,2041,71,2122
test4sub28of100,test4pub25of100,10,192,10,2041,71,2122
test4sub91of100,test4pub23of100,10,192,17,2209,70,2296
test4sub83of100,test4pub24of100,10,192,15,2125,71,2211
test4sub61of100,test4pub24of100,10,192,15,2127,70,2212
test4sub15of100,test4pub25of100,10,192,10,2044,70,2124
test4sub6of100,test4pub21of100,10,192,13,2488,70,2571
test4sub80of100,test4pub25of100,10,192,10,2046,70,2126
test4sub86of100,test4pub25of100,10,192,10,2048,70,2128
test4sub77of100,test4pub14of100,10,192,10,3419,70,3499
test4sub49of100,test4pub19of100,10,192,18,2900,69,2987
test4sub19of100,test4pub25of100,10,192,10,2051,69,2130
test4sub24of100,test4pub25of100,10,192,10,2050,70,2130
test4sub8of100,test4pub12of100,10,191,9,3479,69,3557
test4sub37of100,test4pub19of100,10,192,18,2903,71,2992
test4sub50of100,test4pub25of100,10,192,10,2054,69,2133
test4sub23of100,test4pub19of100,10,192,18,2905,71,2994
test4sub62of100,test4pub25of100,10,192,10,2056,69,2135
test4sub78of100,test4pub25of100,10,192,10,2056,70,2136
test4sub96of100,test4pub25of100,10,192,10,2058,69,2137
test4sub43of100,test4pub18of100,10,192,15,2934,71,3020
test4sub17of100,test4pub25of100,10,192,10,2060,70,2140
test4sub41of100,test4pub20of100,10,192,10,2556,71,2637
test4sub13of100,test4pub24of100,10,192,15,2145,70,2230
test4sub3of100,test4pub24of100,10,192,15,2145,71,2231
test4sub48of100,test4pub25of100,10,192,10,2063,70,2143
test4sub1of100,test4pub25of100,10,192,10,2064,71,2145
test4sub4of100,test4pub24of100,10,192,15,2148,70,2233
test4sub46of100,test4pub25of100,10,192,10,2065,71,2146
test4sub27of100,test4pub23of100,10,192,17,2233,70,2320
test4sub14of100,test4pub25of100,10,192,10,2067,70,2147
test4sub85of100,test4pub24of100,10,192,15,2152,69,2236
test4sub59of100,test4pub13of100,10,192,11,3478,70,3559
test4sub36of100,test4pub10of100,10,192,10,3903,69,3982
test4sub70of100,test4pub24of100,10,192,15,2154,70,2239
test4sub73of100,test4pub24of100,10,192,15,2156,68,2239
test4sub74of100,test4pub24of100,10,192,15,2156,71,2242
test4sub20of100,test4pub27of100,10,192,13,1676,70,1759
test4sub2of100,test4pub24of100,10,192,15,2158,70,2243
test4sub16of100,test4pub24of100,10,192,15,2160,70,2245
test4sub98of100,test4pub18of100,10,192,15,2953,71,3039
test4sub68of100,test4pub21of100,10,192,13,2521,69,2603
test4sub7of100,test4pub15of100,10,192,10,3339,70,3419
test4sub58of100,test4pub10of100,10,192,10,3913,68,3991
test4sub39of100,test4pub24of100,10,192,15,2165,69,2249
test4sub75of100,test4pub24of100,10,192,15,2166,68,2249
test4sub25of100,test4pub25of100,10,192,10,2084,69,2163
test4sub29of100,test4pub24of100,10,192,15,2169,67,2251
test4sub93of100,test4pub23of100,10,192,17,2252,69,2338
test4sub92of100,test4pub16of100,10,192,10,3263,67,3340
test4sub90of100,test4pub24of100,10,192,15,2171,68,2254
test4sub18of100,test4pub25of100,10,192,10,2090,67,2167
test4sub51of100,test4pub18of100,10,192,15,2967,66,3048
test4sub94of100,test4pub23of100,10,192,17,2258,66,2341
test4sub72of100,test4pub25of100,10,192,10,2093,66,2169
test4sub66of100,test4pub22of100,10,192,10,2444,65,2519
test4sub65of100,test4pub19of100,10,192,18,2946,66,3030
test4sub22of100,test4pub25of100,10,192,10,2096,65,2171
test4sub69of100,test4pub25of100,10,192,10,2098,65,2173
test4sub11of100,test4pub26of100,10,192,11,2008,65,2084
test4sub9of100,test4pub26of100,10,192,11,2010,66,2087
test4sub12of100,test4pub11of100,10,192,11,3813,67,3891
test4sub87of100,test4pub25of100,10,192,10,2101,66,2177
test4sub26of100,test4pub19of100,10,192,18,2952,66,3036
test4sub56of100,test4pub3of100,10,191,10,5759,66,5835
test4sub89of100,test4pub8of100,10,191,17,4028,65,4110
test4sub82of100,test4pub20of100,10,192,10,2601,66,2677
test4sub60of100,test4pub23of100,10,192,17,2272,66,2355
test4sub5of100,test4pub27of100,10,192,13,1708,66,1787
test4sub95of100,test4pub25of100,10,192,10,2108,66,2184
test4sub67of100,test4pub26of100,10,192,11,2019,67,2097
test4sub84of100,test4pub26of100,10,192,11,2019,67,2097
test4sub38of100,test4pub26of100,10,192,11,2020,66,2097
test4sub21of100,test4pub26of100,10,192,11,2021,67,2099
test4sub52of100,test4pub26of100,10,192,11,2022,66,2099
test4sub28of100,test4pub26of100,10,192,11,2022,67,2100
test4sub91of100,test4pub24of100,10,192,15,2197,67,2279
test4sub83of100,test4pub25of100,10,192,10,2114,68,2192
test4sub61of100,test4pub25of100,10,192,10,2115,67,2192
test4sub15of100,test4pub26of100,10,192,11,2026,67,2104
test4sub6of100,test4pub22of100,10,192,10,2467,67,2544
test4sub80of100,test4pub26of100,10,192,11,2027,67,2105
test4sub86of100,test4pub26of100,10,192,11,2029,67,2107
test4sub77of100,test4pub15of100,10,192,10,3379,68,3457
test4sub49of100,test4pub20of100,10,192,10,2616,67,2693
test4sub19of100,test4pub26of100,10,192,11,2031,67,2109
test4sub24of100,test4pub26of100,10,192,11,2032,67,2110
test4sub8of100,test4pub14of100,10,192,10,3493,68,3571
test4sub37of100,test4pub20of100,10,192,10,2620,67,2697
test4sub50of100,test4pub26of100,10,192,11,2035,67,2113
test4sub23of100,test4pub20of100,10,192,10,2622,67,2699
test4sub62of100,test4pub26of100,10,192,11,2036,67,2114
test4sub78of100,test4pub26of100,10,192,11,2038,67,2116
test4sub96of100,test4pub26of100,10,192,11,2038,67,2116
test4sub43of100,test4pub19of100,10,192,18,2980,67,3065
test4sub17of100,test4pub26of100,10,192,11,2040,66,2117
test4sub41of100,test4pub21of100,10,192,13,2574,67,2654
test4sub13of100,test4pub25of100,10,192,10,2132,66,2208
test4sub3of100,test4pub25of100,10,192,10,2134,66,2210
test4sub48of100,test4pub26of100,10,192,11,2044,66,2121
test4sub1of100,test4pub26of100,10,192,11,2045,66,2122
test4sub4of100,test4pub25of100,10,192,10,2136,66,2212
test4sub46of100,test4pub26of100,10,192,11,2047,66,2124
test4sub27of100,test4pub25of100,10,192,10,2137,67,2214
test4sub14of100,test4pub26of100,10,192,11,2049,67,2127
test4sub85of100,test4pub25of100,10,192,10,2139,67,2216
test4sub59of100,test4pub14of100,10,192,10,3510,67,3587
test4sub36of100,test4pub11of100,10,192,11,3853,67,3931
test4sub70of100,test4pub25of100,10,192,10,2142,67,2219
test4sub73of100,test4pub25of100,10,192,10,2143,67,2220
test4sub74of100,test4pub25of100,10,192,10,2145,65,2220
test4sub20of100,test4pub28of100,10,192,18,1651,66,1735
test4sub16of100,test4pub25of100,10,192,10,2147,66,2223
test4sub2of100,test4pub25of100,10,192,10,2147,66,2223
test4sub98of100,test4pub19of100,10,192,18,2998,66,3082
test4sub68of100,test4pub22of100,10,192,10,2499,66,2575
test4sub7of100,test4pub17of100,10,192,17,3047,65,3129
test4sub58of100,test4pub11of100,10,192,11,3863,65,3939
test4sub75of100,test4pub25of100,10,192,10,2152,66,2228
test4sub39of100,test4pub25of100,10,192,10,2152,65,2227
test4sub29of100,test4pub25of100,10,192,10,2154,66,2230
test4sub25of100,test4pub26of100,10,192,11,2063,66,2140
test4sub93of100,test4pub24of100,10,192,15,2238,66,2319
test4sub92of100,test4pub17of100,10,192,17,3052,66,3135
test4sub18of100,test4pub26of100,10,192,11,2067,65,2143
test4sub90of100,test4pub25of100,10,192,10,2157,67,2234
test4sub94of100,test4pub24of100,10,192,15,2242,65,2322
test4sub51of100,test4pub17of100,10,192,17,3055,67,3139
test4sub72of100,test4pub26of100,10,192,11,2070,65,2146
test4sub66of100,test4pub23of100,10,192,17,2326,66,2409
test4sub65of100,test4pub21of100,10,192,13,2604,65,2682
test4sub22of100,test4pub26of100,10,192,11,2072,66,2149
test4sub69of100,test4pub26of100,10,192,11,2074,64,2149
test4sub11of100,test4pub27of100,10,192,13,1766,66,1845
test4sub9of100,test4pub27of100,10,192,13,1768,64,1845
test4sub12of100,test4pub13of100,10,192,11,3576,66,3653
test4sub87of100,test4pub26of100,10,192,11,2079,64,2154
test4sub26of100,test4pub20of100,10,192,10,2665,65,2740
test4sub56of100,test4pub4of100,10,191,11,5033,64,5108
test4sub89of100,test4pub10of100,10,192,10,4003,65,4078
test4sub82of100,test4pub22of100,10,192,10,2522,63,2595
test4sub60of100,test4pub24of100,10,192,15,2256,65,2336
test4sub5of100,test4pub28of100,10,192,18,1680,64,1762
test4sub95of100,test4pub26of100,10,192,11,2085,65,2161
test4sub67of100,test4pub27of100,10,192,13,1777,63,1853
test4sub38of100,test4pub27of100,10,192,13,1778,64,1855
test4sub21of100,test4pub27of100,10,192,13,1779,63,1855
test4sub52of100,test4pub27of100,10,192,13,1780,64,1857
test4sub28of100,test4pub27of100,10,192,13,1781,63,1857
test4sub91of100,test4pub25of100,10,192,10,2182,64,2256
test4sub83of100,test4pub26of100,10,192,11,2092,65,2168
test4sub61of100,test4pub26of100,10,192,11,2093,65,2169
test4sub15of100,test4pub27of100,10,192,13,1785,66,1864
test4sub6of100,test4pub23of100,10,192,17,2351,66,2434
test4sub80of100,test4pub27of100,10,192,13,1786,66,1865
test4sub86of100,test4pub27of100,10,192,13,1788,67,1868
test4sub77of100,test4pub16of100,10,192,10,3363,67,3440
test4sub49of100,test4pub21of100,10,192,13,2630,67,2710
test4sub19of100,test4pub27of100,10,192,13,1790,67,1870
test4sub24of100,test4pub27of100,10,192,13,1792,67,1872
test4sub8of100,test4pub15of100,10,192,10,3451,67,3528
test4sub37of100,test4pub21of100,10,192,13,2634,66,2713
test4sub50of100,test4pub27of100,10,192,13,1794,67,1874
test4sub23of100,test4pub21of100,10,192,13,2636,66,2715
test4sub62of100,test4pub27of100,10,192,13,1795,66,1874
test4sub96of100,test4pub27of100,10,192,13,1797,67,1877
test4sub78of100,test4pub27of100,10,192,13,1797,67,1877
test4sub43of100,test4pub20of100,10,192,10,2693,66,2769
test4sub17of100,test4pub27of100,10,192,13,1799,67,1879
test4sub41of100,test4pub22of100,10,192,10,2549,66,2625
test4sub13of100,test4pub26of100,10,192,11,2109,66,2186
test4sub3of100,test4pub26of100,10,192,11,2111,67,2189
test4sub48of100,test4pub27of100,10,192,13,1802,67,1882
test4sub1of100,test4pub27of100,10,192,13,1803,66,1882
test4sub4of100,test4pub26of100,10,192,11,2113,66,2190
test4sub46of100,test4pub27of100,10,192,13,1806,66,1885
test4sub27of100,test4pub26of100,10,192,11,2115,66,2192
test4sub14of100,test4pub27of100,10,192,13,1807,66,1886
test4sub85of100,test4pub26of100,10,192,11,2117,66,2194
test4sub59of100,test4pub15of100,10,192,10,3468,65,3543
test4sub36of100,test4pub13of100,10,192,11,3618,66,3695
test4sub70of100,test4pub26of100,10,192,11,2120,65,2196
test4sub73of100,test4pub26of100,10,192,11,2120,65,2196
test4sub74of100,test4pub26of100,10,192,11,2122,66,2199
test4sub20of100,test4pub29of100,10,192,11,1628,66,1705
test4sub16of100,test4pub26of100,10,192,11,2123,65,2199
test4sub2of100,test4pub26of100,10,192,11,2124,66,2201
test4sub98of100,test4pub20of100,10,192,10,2711,66,2787
test4sub68of100,test4pub23of100,10,192,17,2381,65,2463
test4sub7of100,test4pub18of100,10,192,15,3092,66,3173
test4sub58of100,test4pub12of100,10,191,9,3644,66,3719
test4sub75of100,test4pub26of100,10,192,11,2128,65,2204
test4sub39of100,test4pub26of100,10,192,11,2128,65,2204
test4sub25of100,test4pub27of100,10,192,13,1822,65,1900
test4sub29of100,test4pub26of100,10,192,11,2130,65,2206
test4sub92of100,test4pub18of100,10,192,15,3098,64,3177
test4sub18of100,test4pub27of100,10,192,13,1824,65,1902
test4sub90of100,test4pub26of100,10,192,11,2134,64,2209
test4sub94of100,test4pub25of100,10,192,10,2225,64,2299
test4sub72of100,test4pub27of100,10,192,13,1827,63,1903
test4sub51of100,test4pub19of100,10,192,18,3076,64,3158
test4sub66of100,test4pub24of100,10,192,15,2311,64,2390
test4sub65of100,test4pub20of100,10,192,10,2724,65,2799
test4sub22of100,test4pub27of100,10,192,13,1830,64,1907
test4sub69of100,test4pub27of100,10,192,13,1831,64,1908
test4sub11of100,test4pub28of100,10,192,18,1737,65,1820
test4sub9of100,test4pub28of100,10,192,18,1737,64,1819
test4sub12of100,test4pub12of100,10,191,9,3660,64,3733
test4sub87of100,test4pub27of100,10,192,13,1834,64,1911
test4sub26of100,test4pub21of100,10,192,13,2677,64,2754
test4sub56of100,test4pub5of100,10,191,17,5010,65,5092
test4sub89of100,test4pub11of100,10,192,11,3949,64,4024
test4sub82of100,test4pub21of100,10,192,13,2679,64,2756
test4sub60of100,test4pub25of100,10,192,10,2238,64,2312
test4sub5of100,test4pub29of100,10,192,11,1655,64,1730
test4sub95of100,test4pub27of100,10,192,13,1841,64,1918
test4sub67of100,test4pub28of100,10,192,18,1747,64,1829
test4sub38of100,test4pub28of100,10,192,18,1748,63,1829
test4sub21of100,test4pub28of100,10,192,18,1749,64,1831
test4sub52of100,test4pub28of100,10,192,18,1750,64,1832
test4sub28of100,test4pub28of100,10,192,18,1751,64,1833
test4sub91of100,test4pub26of100,10,192,11,2157,63,2231
test4sub83of100,test4pub27of100,10,192,13,1849,63,1925
test4sub61of100,test4pub27of100,10,192,13,1851,62,1926
test4sub15of100,test4pub28of100,10,192,18,1756,62,1836
test4sub6of100,test4pub24of100,10,192,15,2335,61,2411
test4sub80of100,test4pub28of100,10,192,18,1758,61,1837
test4sub86of100,test4pub28of100,10,192,18,1760,61,1839
test4sub77of100,test4pub17of100,10,192,17,3151,61,3229
test4sub49of100,test4pub22of100,10,192,10,2606,61,2677
test4sub19of100,test4pub28of100,10,192,18,1763,61,1842
test4sub24of100,test4pub28of100,10,192,18,1764,61,1843
test4sub8of100,test4pub16of100,10,192,10,3434,61,3505
test4sub37of100,test4pub22of100,10,192,10,2610,62,2682
test4sub50of100,test4pub28of100,10,192,18,1766,62,1846
test4sub23of100,test4pub22of100,10,192,10,2611,61,2682
test4sub62of100,test4pub28of100,10,192,18,1768,62,1848
test4sub96of100,test4pub28of100,10,192,18,1769,61,1848
test4sub78of100,test4pub28of100,10,192,18,1769,61,1848
test4sub43of100,test4pub21of100,10,192,13,2707,62,2782
test4sub17of100,test4pub28of100,10,192,18,1771,62,1851
test4sub41of100,test4pub23of100,10,192,17,2432,61,2510
test4sub13of100,test4pub27of100,10,192,13,1867,62,1942
test4sub3of100,test4pub27of100,10,192,13,1869,62,1944
test4sub48of100,test4pub28of100,10,192,18,1774,62,1854
test4sub1of100,test4pub29of100,10,192,11,1685,62,1758
test4sub4of100,test4pub27of100,10,192,13,1871,63,1947
test4sub46of100,test4pub28of100,10,192,18,1777,62,1857
test4sub27of100,test4pub27of100,10,192,13,1872,63,1948
test4sub14of100,test4pub28of100,10,192,18,1779,62,1859
test4sub85of100,test4pub27of100,10,192,13,1874,63,1950
test4sub36of100,test4pub12of100,10,191,9,3702,63,3774
test4sub59of100,test4pub16of100,10,192,10,3451,63,3524
test4sub70of100,test4pub27of100,10,192,13,1877,63,1953
test4sub73of100,test4pub27of100,10,192,13,1878,63,1954
test4sub74of100,test4pub27of100,10,192,13,1879,64,1956
test4sub20of100,test4pub30of100,10,191,9,1619,63,1691
test4sub16of100,test4pub27of100,10,192,13,1881,64,1958
test4sub2of100,test4pub27of100,10,192,13,1881,65,1959
test4sub98of100,test4pub21of100,10,192,13,2723,65,2801
test4sub68of100,test4pub24of100,10,192,15,2365,65,2445
test4sub7of100,test4pub19of100,10,192,18,3133,66,3217
test4sub58of100,test4pub13of100,10,192,11,3692,65,3768
test4sub75of100,test4pub27of100,10,192,13,1885,66,1964
test4sub39of100,test4pub27of100,10,192,13,1886,67,1966
test4sub25of100,test4pub28of100,10,192,18,1792,66,1876
test4sub29of100,test4pub27of100,10,192,13,1887,66,1966
test4sub92of100,test4pub19of100,10,192,18,3138,67,3223
test4sub18of100,test4pub28of100,10,192,18,1794,67,1879
test4sub90of100,test4pub27of100,10,192,13,1890,66,1969
test4sub94of100,test4pub26of100,10,192,11,2200,67,2278
test4sub72of100,test4pub28of100,10,192,18,1797,67,1882
test4sub51of100,test4pub20of100,10,192,10,2787,67,2864
test4sub66of100,test4pub25of100,10,192,10,2293,67,2370
test4sub65of100,test4pub22of100,10,192,10,2643,66,2719
test4sub22of100,test4pub28of100,10,192,18,1800,67,1885
test4sub69of100,test4pub28of100,10,192,18,1801,67,1886
test4sub11of100,test4pub29of100,10,192,11,1712,66,1789
test4sub9of100,test4pub29of100,10,192,11,1712,67,1790
test4sub12of100,test4pub14of100,10,192,10,3668,67,3745
test4sub87of100,test4pub28of100,10,192,18,1804,66,1888
test4sub26of100,test4pub22of100,10,192,10,2650,67,2727
test4sub56of100,test4pub6of100,10,191,11,4637,67,4715
test4sub89of100,test4pub13of100,10,192,11,3710,67,3788
test4sub82of100,test4pub23of100,10,192,17,2468,67,2552
test4sub60of100,test4pub26of100,10,192,11,2213,67,2291
test4sub5of100,test4pub30of100,10,191,9,1645,67,1721
test4sub95of100,test4pub28of100,10,192,18,1811,66,1895
test4sub67of100,test4pub29of100,10,192,11,1721,66,1798
test4sub38of100,test4pub29of100,10,192,11,1723,67,1801
test4sub21of100,test4pub29of100,10,192,11,1724,67,1802
test4sub52of100,test4pub29of100,10,192,11,1725,66,1802
test4sub28of100,test4pub29of100,10,192,11,1725,66,1802
test4sub91of100,test4pub27of100,10,192,13,1912,67,1992
test4sub83of100,test4pub28of100,10,192,18,1817,67,1902
test4sub61of100,test4pub28of100,10,192,18,1818,66,1902
test4sub15of100,test4pub29of100,10,192,11,1729,67,1807
test4sub6of100,test4pub25of100,10,192,10,2314,66,2390
test4sub71of100,test4pub18of100,10,192,15,2792,465,3272
test4sub80of100,test4pub29of100,10,192,11,1731,68,1810
test4sub86of100,test4pub29of100,10,192,11,1732,66,1809
test4sub77of100,test4pub18of100,10,192,15,3193,68,3276
test4sub49of100,test4pub23of100,10,192,17,2484,66,2567
test4sub19of100,test4pub29of100,10,192,11,1734,67,1812
test4sub24of100,test4pub29of100,10,192,11,1736,66,1813
test4sub8of100,test4pub18of100,10,192,15,3196,67,3278
test4sub37of100,test4pub23of100,10,192,17,2488,66,2571
test4sub50of100,test4pub29of100,10,192,11,1738,67,1816
test4sub23of100,test4pub23of100,10,192,17,2490,66,2573
test4sub62of100,test4pub29of100,10,192,11,1740,66,1817
test4sub96of100,test4pub29of100,10,192,11,1741,66,1818
test4sub78of100,test4pub29of100,10,192,11,1742,67,1820
test4sub43of100,test4pub22of100,10,192,10,2677,66,2753
test4sub41of100,test4pub24of100,10,192,15,2412,66,2493
test4sub13of100,test4pub28of100,10,192,18,1835,65,1918
test4sub3of100,test4pub28of100,10,192,18,1837,66,1921
test4sub48of100,test4pub29of100,10,192,11,1747,66,1824
test4sub1of100,test4pub28of100,10,192,18,1839,66,1923
test4sub4of100,test4pub28of100,10,192,18,1839,67,1924
test4sub46of100,test4pub29of100,10,192,11,1750,67,1828
test4sub27of100,test4pub28of100,10,192,18,1841,66,1925
test4sub14of100,test4pub29of100,10,192,11,1753,67,1831
test4sub85of100,test4pub28of100,10,192,18,1843,67,1928
test4sub36of100,test4pub15of100,10,192,10,3598,67,3675
test4sub59of100,test4pub17of100,10,192,17,3236,67,3320
test4sub70of100,test4pub28of100,10,192,18,1846,67,1931
test4sub73of100,test4pub28of100,10,192,18,1847,67,1932
test4sub74of100,test4pub28of100,10,192,18,1848,67,1933
test4sub20of100,test4pub31of100,10,192,19,1442,66,1527
test4sub16of100,test4pub28of100,10,192,18,1851,66,1935
test4sub2of100,test4pub28of100,10,192,18,1851,67,1936
test4sub63of100,test4pub9of100,10,191,16,4220,67,4303
test4sub98of100,test4pub22of100,10,192,10,2697,66,2773
test4sub68of100,test4pub25of100,10,192,10,2348,66,2424
test4sub7of100,test4pub20of100,10,192,10,2845,65,2920
test4sub58of100,test4pub14of100,10,192,10,3720,66,3796
test4sub75of100,test4pub28of100,10,192,18,1858,64,1940
test4sub39of100,test4pub28of100,10,192,18,1858,66,1942
test4sub25of100,test4pub29of100,10,192,11,1769,64,1844
test4sub29of100,test4pub28of100,10,192,18,1860,66,1944
test4sub92of100,test4pub20of100,10,192,10,2851,64,2925
test4sub18of100,test4pub29of100,10,192,11,1771,66,1848
test4sub90of100,test4pub28of100,10,192,18,1863,65,1946
test4sub94of100,test4pub27of100,10,192,13,1958,66,2037
test4sub72of100,test4pub29of100,10,192,11,1774,65,1850
test4sub51of100,test4pub21of100,10,192,13,2801,66,2880
test4sub66of100,test4pub26of100,10,192,11,2271,66,2348
test4sub65of100,test4pub23of100,10,192,17,2527,67,2611
test4sub22of100,test4pub29of100,10,192,11,1778,65,1854
test4sub69of100,test4pub29of100,10,192,11,1778,67,1856
test4sub11of100,test4pub31of100,10,192,19,1463,67,1549
test4sub9of100,test4pub30of100,10,191,9,1705,67,1781
test4sub12of100,test4pub15of100,10,192,10,3625,67,3702
test4sub87of100,test4pub29of100,10,192,11,1782,68,1861
test4sub26of100,test4pub23of100,10,192,17,2533,67,2617
test4sub56of100,test4pub7of100,10,191,17,4419,68,4504
test4sub89of100,test4pub12of100,10,191,9,3796,67,3872
test4sub82of100,test4pub24of100,10,192,15,2452,68,2535
test4sub60of100,test4pub27of100,10,192,13,1972,68,2053
test4sub5of100,test4pub31of100,10,192,19,1470,68,1557
test4sub95of100,test4pub29of100,10,192,11,1788,67,1866
test4sub67of100,test4pub30of100,10,191,9,1714,69,1792
test4sub38of100,test4pub30of100,10,191,9,1715,67,1791
test4sub21of100,test4pub30of100,10,191,9,1716,68,1793
test4sub52of100,test4pub30of100,10,191,9,1717,67,1793
test4sub28of100,test4pub31of100,10,192,19,1476,68,1563
test4sub91of100,test4pub28of100,10,192,18,1884,67,1969
test4sub83of100,test4pub29of100,10,192,11,1794,69,1874
test4sub61of100,test4pub29of100,10,192,11,1796,68,1875
test4sub15of100,test4pub31of100,10,192,19,1479,70,1568
test4sub6of100,test4pub26of100,10,192,11,2291,68,2370
test4sub71of100,test4pub17of100,10,192,17,3279,70,3366
test4sub80of100,test4pub30of100,10,191,9,1724,68,1801
test4sub86of100,test4pub30of100,10,191,9,1725,70,1804
test4sub77of100,test4pub19of100,10,192,18,3235,68,3321
test4sub49of100,test4pub24of100,10,192,15,2468,70,2553
test4sub19of100,test4pub30of100,10,191,9,1728,70,1807
test4sub24of100,test4pub31of100,10,192,19,1486,71,1576
test4sub8of100,test4pub17of100,10,192,17,3285,70,3372
test4sub37of100,test4pub24of100,10,192,15,2472,71,2558
test4sub50of100,test4pub30of100,10,191,9,1731,69,1809
test4sub23of100,test4pub24of100,10,192,15,2473,71,2559
test4sub62of100,test4pub31of100,10,192,19,1491,70,1580
test4sub96of100,test4pub30of100,10,191,9,1733,71,1813
test4sub78of100,test4pub30of100,10,191,9,1735,70,1814
test4sub43of100,test4pub23of100,10,192,17,2560,70,2647
test4sub13of100,test4pub29of100,10,192,11,1812,70,1893
test4sub41of100,test4pub25of100,10,192,10,2396,71,2477
test4sub3of100,test4pub29of100,10,192,11,1813,70,1894
test4sub48of100,test4pub31of100,10,192,19,1497,71,1587
test4sub1of100,test4pub31of100,10,192,19,1499,70,1588
test4sub4of100,test4pub29of100,10,192,11,1816,70,1897
test4sub46of100,test4pub30of100,10,191,9,1743,70,1822
test4sub27of100,test4pub29of100,10,192,11,1819,70,1900
test4sub14of100,test4pub30of100,10,191,9,1745,69,1823
test4sub85of100,test4pub29of100,10,192,11,1821,70,1902
test4sub36of100,test4pub14of100,10,192,10,3776,68,3854
test4sub59of100,test4pub18of100,10,192,15,3283,71,3369
test4sub70of100,test4pub29of100,10,192,11,1824,69,1904
test4sub73of100,test4pub29of100,10,192,11,1825,70,1906
test4sub74of100,test4pub29of100,10,192,11,1826,70,1907
test4sub20of100,test4pub32of100,10,192,11,1434,71,1516
test4sub16of100,test4pub29of100,10,192,11,1827,69,1907
test4sub2of100,test4pub29of100,10,192,11,1828,71,1910
test4sub63of100,test4pub10of100,10,192,10,4245,69,4324
test4sub98of100,test4pub23of100,10,192,17,2579,71,2667
test4sub68of100,test4pub26of100,10,192,11,2325,70,2406
test4sub7of100,test4pub21of100,10,192,13,2857,71,2941
test4sub58of100,test4pub15of100,10,192,10,3676,70,3756
test4sub75of100,test4pub29of100,10,192,11,1833,71,1915
test4sub39of100,test4pub29of100,10,192,11,1834,70,1915
test4sub25of100,test4pub30of100,10,191,9,1760,71,1840
test4sub29of100,test4pub29of100,10,192,11,1836,70,1917
test4sub92of100,test4pub21of100,10,192,13,2863,71,2947
test4sub18of100,test4pub30of100,10,191,9,1763,70,1842
test4sub90of100,test4pub29of100,10,192,11,1838,70,1919
test4sub94of100,test4pub28of100,10,192,18,1930,70,2018
test4sub72of100,test4pub30of100,10,191,9,1766,70,1845
test4sub44of100,test4pub23of100,10,192,17,2591,72,2680
test4sub51of100,test4pub22of100,10,192,10,2776,71,2857
test4sub66of100,test4pub27of100,10,192,13,2028,72,2113
test4sub65of100,test4pub24of100,10,192,15,2511,70,2596
test4sub22of100,test4pub30of100,10,191,9,1770,72,1851
test4sub69of100,test4pub30of100,10,191,9,1771,70,1850
test4sub11of100,test4pub30of100,10,191,9,1772,70,1851
test4sub9of100,test4pub31of100,10,192,19,1532,70,1621
test4sub12of100,test4pub16of100,10,192,10,3609,70,3689
test4sub87of100,test4pub30of100,10,191,9,1775,69,1853
test4sub26of100,test4pub24of100,10,192,15,2518,70,2603
test4sub56of100,test4pub9of100,10,191,16,4311,69,4396
test4sub89of100,test4pub14of100,10,192,10,3807,69,3886
test4sub82of100,test4pub25of100,10,192,10,2439,69,2518
test4sub60of100,test4pub28of100,10,192,18,1945,71,2034
test4sub5of100,test4pub32of100,10,192,11,1464,69,1544
test4sub95of100,test4pub31of100,10,192,19,1540,71,1630
test4sub67of100,test4pub31of100,10,192,19,1541,69,1629
test4sub38of100,test4pub31of100,10,192,19,1541,70,1630
test4sub35of100,test4pub7of100,10,191,17,1876,2688,4581
test4sub21of100,test4pub31of100,10,192,19,1543,71,1633
test4sub52of100,test4pub31of100,10,192,19,1543,72,1634
test4sub28of100,test4pub30of100,10,191,9,1786,71,1866
test4sub91of100,test4pub29of100,10,192,11,1862,70,1943
test4sub83of100,test4pub30of100,10,191,9,1789,70,1868
test4sub61of100,test4pub31of100,10,192,19,1548,70,1637
test4sub15of100,test4pub30of100,10,191,9,1791,70,1870
test4sub6of100,test4pub27of100,10,192,13,2051,71,2135
test4sub71of100,test4pub19of100,10,192,18,3302,70,3390
test4sub80of100,test4pub31of100,10,192,19,1552,70,1641
test4sub5of100,test4pub33of100,10,192,16,1246,38,1300
test4sub60of100,test4pub29of100,10,192,11,1926,40,1977
test4sub82of100,test4pub26of100,10,192,11,2418,42,2471
test4sub89of100,test4pub15of100,10,192,10,3768,44,3822
test4sub26of100,test4pub25of100,10,192,10,2506,46,2562
test4sub56of100,test4pub8of100,10,191,17,4430,47,4494
test4sub12of100,test4pub17of100,10,192,17,3401,49,3467
test4sub87of100,test4pub31of100,10,192,19,1604,49,1672
test4sub9of100,test4pub32of100,10,192,11,1527,52,1590
test4sub11of100,test4pub32of100,10,192,11,1527,53,1591
test4sub22of100,test4pub31of100,10,192,19,1600,55,1674
test4sub69of100,test4pub31of100,10,192,19,1600,56,1675
test4sub65of100,test4pub25of100,10,192,10,2500,58,2568
test4sub66of100,test4pub28of100,10,192,18,2005,58,2081
test4sub51of100,test4pub23of100,10,192,17,2664,60,2741
test4sub44of100,test4pub24of100,10,192,15,2581,62,2658
test4sub94of100,test4pub29of100,10,192,11,1911,64,1986
test4sub18of100,test4pub31of100,10,192,19,1592,67,1678
test4sub29of100,test4pub30of100,10,191,9,1832,70,1911
test4sub39of100,test4pub30of100,10,191,9,1830,72,1911
test4sub75of100,test4pub30of100,10,191,9,1830,73,1912
test4sub90of100,test4pub30of100,10,191,9,1835,67,1911
test4sub58of100,test4pub16of100,10,192,10,3663,75,3748
test4sub72of100,test4pub31of100,10,192,19,1595,64,1678
test4sub7of100,test4pub22of100,10,192,10,2837,76,2923
test4sub98of100,test4pub24of100,10,192,15,2568,79,2662
test4sub2of100,test4pub30of100,10,191,9,1824,81,1914
test4sub16of100,test4pub30of100,10,191,9,1823,84,1916
test4sub25of100,test4pub31of100,10,192,19,1590,71,1680
test4sub63of100,test4pub11of100,10,192,11,4197,81,4289
test4sub74of100,test4pub31of100,10,192,19,1579,85,1683
test4sub73of100,test4pub30of100,10,191,9,1821,87,1917
test4sub68of100,test4pub27of100,10,192,13,2086,78,2177
test4sub59of100,test4pub19of100,10,192,18,3328,90,3436
test4sub20of100,test4pub33of100,10,192,16,1217,84,1317
test4sub17of100,test4pub29of100,10,192,11,1893,92,1996
test4sub36of100,test4pub16of100,10,192,10,3652,94,3756
test4sub85of100,test4pub30of100,10,191,9,1816,95,1920
test4sub46of100,test4pub31of100,10,192,19,1571,98,1688
test4sub41of100,test4pub26of100,10,192,11,2378,103,2492
test4sub13of100,test4pub30of100,10,191,9,1807,105,1921
test4sub43of100,test4pub24of100,10,192,15,2549,107,2671
test4sub78of100,test4pub31of100,10,192,19,1563,108,1690
test4sub27of100,test4pub30of100,10,191,9,1815,97,1921
test4sub96of100,test4pub31of100,10,192,19,1563,109,1691
test4sub14of100,test4pub31of100,10,192,19,1573,97,1689
test4sub62of100,test4pub30of100,10,191,9,1804,111,1924
test4sub3of100,test4pub30of100,10,191,9,1809,102,1920
test4sub1of100,test4pub30of100,10,191,9,1811,100,1920
test4sub23of100,test4pub25of100,10,192,10,2462,112,2584
test4sub50of100,test4pub31of100,10,192,19,1560,115,1694
test4sub48of100,test4pub30of100,10,191,9,1811,100,1920
test4sub37of100,test4pub25of100,10,192,10,2460,115,2585
test4sub4of100,test4pub31of100,10,192,19,1570,99,1688
test4sub8of100,test4pub19of100,10,192,18,3309,117,3444
test4sub24of100,test4pub30of100,10,191,9,1800,119,1928
test4sub19of100,test4pub31of100,10,192,19,1556,122,1697
test4sub49of100,test4pub25of100,10,192,10,2457,123,2590
test4sub77of100,test4pub20of100,10,192,10,2951,127,3088
test4sub86of100,test4pub31of100,10,192,19,1553,128,1700
test4sub95of100,test4pub30of100,10,191,9,1853,73,1935
test4sub67of100,test4pub32of100,10,192,11,1536,74,1621
test4sub38of100,test4pub32of100,10,192,11,1538,74,1623
test4sub35of100,test4pub9of100,10,191,16,4388,74,4478
test4sub21of100,test4pub32of100,10,192,11,1539,73,1623
test4sub52of100,test4pub32of100,10,192,11,1540,74,1625
test4sub28of100,test4pub32of100,10,192,11,1541,74,1626
test4sub91of100,test4pub30of100,10,191,9,1859,74,1942
test4sub83of100,test4pub31of100,10,192,19,1618,73,1710
test4sub61of100,test4pub30of100,10,191,9,1861,74,1944
test4sub15of100,test4pub32of100,10,192,11,1545,73,1629
test4sub6of100,test4pub28of100,10,192,18,2028,73,2119
test4sub99of100,test4pub15of100,10,192,10,3782,74,3866
test4sub71of100,test4pub20of100,10,192,10,3020,73,3103
test4sub80of100,test4pub32of100,10,192,11,1548,74,1633
test4sub5of100,test4pub34of100,10,192,11,1222,49,1282
test4sub60of100,test4pub30of100,10,191,9,1891,49,1949
test4sub82of100,test4pub27of100,10,192,13,2153,48,2214
test4sub26of100,test4pub26of100,10,192,11,2463,48,2522
test4sub89of100,test4pub16of100,10,192,10,3729,49,3788
test4sub56of100,test4pub10of100,10,192,10,4386,49,4445
test4sub12of100,test4pub19of100,10,192,18,3404,48,3470
test4sub87of100,test4pub32of100,10,192,11,1579,50,1640
test4sub9of100,test4pub33of100,10,192,16,1291,49,1356
test4sub11of100,test4pub33of100,10,192,16,1292,49,1357
test4sub22of100,test4pub32of100,10,192,11,1581,49,1641
test4sub69of100,test4pub32of100,10,192,11,1582,48,1641
test4sub66of100,test4pub29of100,10,192,11,1975,50,2036
test4sub51of100,test4pub24of100,10,192,15,2642,49,2706
test4sub44of100,test4pub25of100,10,192,10,2560,49,2619
test4sub94of100,test4pub31of100,10,192,19,1659,50,1728
test4sub65of100,test4pub26of100,10,192,11,2468,52,2531
test4sub18of100,test4pub32of100,10,192,11,1585,51,1647
test4sub29of100,test4pub31of100,10,192,19,1661,52,1732
test4sub75of100,test4pub31of100,10,192,19,1661,52,1732
test4sub58of100,test4pub17of100,10,192,17,3460,52,3529
test4sub72of100,test4pub32of100,10,192,11,1587,53,1651
test4sub98of100,test4pub25of100,10,192,10,2564,54,2628
test4sub7of100,test4pub23of100,10,192,17,2730,54,2801
test4sub90of100,test4pub31of100,10,192,19,1662,56,1737
test4sub2of100,test4pub31of100,10,192,19,1664,55,1738
test4sub39of100,test4pub31of100,10,192,19,1661,56,1736
test4sub16of100,test4pub31of100,10,192,19,1665,51,1735
test4sub13of100,test4pub31of100,10,192,19,1671,51,1741
test4sub43of100,test4pub25of100,10,192,10,2573,47,2630
test4sub41of100,test4pub27of100,10,192,13,2173,48,2234
test4sub85of100,test4pub31of100,10,192,19,1670,47,1736
test4sub24of100,test4pub32of100,10,192,11,1602,49,1662
test4sub36of100,test4pub17of100,10,192,17,3467,49,3533
test4sub17of100,test4pub30of100,10,191,9,1910,50,1969
test4sub20of100,test4pub34of100,10,192,11,1242,50,1303
test4sub59of100,test4pub20of100,10,192,10,3064,51,3125
test4sub74of100,test4pub30of100,10,191,9,1908,53,1970
test4sub19of100,test4pub32of100,10,192,11,1604,53,1668
test4sub68of100,test4pub28of100,10,192,18,2074,55,2147
test4sub73of100,test4pub31of100,10,192,19,1666,56,1741
test4sub63of100,test4pub12of100,10,191,9,3994,56,4059
test4sub49of100,test4pub26of100,10,192,11,2491,56,2558
test4sub46of100,test4pub32of100,10,192,11,1595,58,1664
test4sub25of100,test4pub32of100,10,192,11,1590,57,1658
test4sub23of100,test4pub26of100,10,192,11,2485,57,2553
test4sub50of100,test4pub32of100,10,192,11,1600,59,1670
test4sub8of100,test4pub20of100,10,192,10,3073,59,3142
test4sub77of100,test4pub21of100,10,192,13,3024,61,3098
test4sub4of100,test4pub30of100,10,191,9,1918,60,1987
test4sub37of100,test4pub26of100,10,192,11,2486,61,2558
test4sub48of100,test4pub32of100,10,192,11,1600,62,1673
test4sub1of100,test4pub32of100,10,192,11,1599,63,1673
test4sub86of100,test4pub32of100,10,192,11,1607,63,1681
test4sub3of100,test4pub31of100,10,192,19,1674,65,1758
test4sub62of100,test4pub32of100,10,192,11,1599,64,1674
test4sub14of100,test4pub32of100,10,192,11,1598,65,1674
test4sub27of100,test4pub31of100,10,192,19,1673,64,1756
test4sub96of100,test4pub32of100,10,192,11,1598,66,1675
test4sub78of100,test4pub32of100,10,192,11,1597,66,1674
test4sub95of100,test4pub32of100,10,192,11,1610,66,1687
test4sub67of100,test4pub34of100,10,192,11,1260,65,1336
test4sub38of100,test4pub33of100,10,192,16,1325,66,1407
test4sub21of100,test4pub33of100,10,192,16,1326,65,1407
test4sub52of100,test4pub33of100,10,192,16,1326,66,1408
test4sub28of100,test4pub33of100,10,192,16,1328,65,1409
test4sub91of100,test4pub31of100,10,192,19,1691,65,1775
test4sub83of100,test4pub32of100,10,192,11,1618,65,1694
test4sub61of100,test4pub32of100,10,192,11,1618,66,1695
test4sub15of100,test4pub33of100,10,192,16,1331,65,1412
test4sub6of100,test4pub29of100,10,192,11,2012,66,2089
test4sub99of100,test4pub16of100,10,192,10,3773,65,3848
test4sub71of100,test4pub21of100,10,192,13,3039,66,3118
test4sub80of100,test4pub33of100,10,192,16,1335,65,1416
test4sub5of100,test4pub35of100,10,192,15,993,67,1075
test4sub60of100,test4pub31of100,10,192,19,1699,65,1783
test4sub82of100,test4pub28of100,10,192,18,2106,67,2191
test4sub26of100,test4pub27of100,10,192,13,2203,66,2282
test4sub89of100,test4pub17of100,10,192,17,3499,68,3584
test4sub56of100,test4pub11of100,10,192,11,4316,66,4393
test4sub12of100,test4pub18of100,10,192,15,3480,68,3563
test4sub87of100,test4pub33of100,10,192,16,1341,66,1423
test4sub9of100,test4pub34of100,10,192,11,1278,67,1356
test4sub22of100,test4pub33of100,10,192,16,1343,66,1425
test4sub69of100,test4pub34of100,10,192,11,1280,67,1358
test4sub66of100,test4pub30of100,10,191,9,1950,66,2025
test4sub51of100,test4pub25of100,10,192,10,2609,67,2686
test4sub44of100,test4pub26of100,10,192,11,2521,66,2598
test4sub94of100,test4pub30of100,10,191,9,1952,66,2027
test4sub65of100,test4pub27of100,10,192,13,2214,65,2292
test4sub18of100,test4pub33of100,10,192,16,1350,66,1432
test4sub75of100,test4pub32of100,10,192,11,1639,64,1714
test4sub29of100,test4pub32of100,10,192,11,1639,66,1716
test4sub58of100,test4pub18of100,10,192,15,3493,65,3573
test4sub72of100,test4pub33of100,10,192,16,1354,65,1435
test4sub98of100,test4pub26of100,10,192,11,2529,63,2603
test4sub7of100,test4pub24of100,10,192,15,2703,65,2783
test4sub90of100,test4pub32of100,10,192,11,1645,63,1719
test4sub2of100,test4pub32of100,10,192,11,1645,64,1720
test4sub39of100,test4pub32of100,10,192,11,1647,63,1721
test4sub16of100,test4pub32of100,10,192,11,1647,64,1722
test4sub13of100,test4pub32of100,10,192,11,1649,63,1723
test4sub43of100,test4pub26of100,10,192,11,2535,65,2611
test4sub41of100,test4pub28of100,10,192,18,2132,63,2213
test4sub85of100,test4pub32of100,10,192,11,1651,64,1726
test4sub24of100,test4pub33of100,10,192,16,1364,63,1443
test4sub36of100,test4pub18of100,10,192,15,3504,64,3583
test4sub20of100,test4pub35of100,10,192,15,1024,63,1102
test4sub17of100,test4pub31of100,10,192,19,1729,65,1813
test4sub59of100,test4pub22of100,10,192,10,2982,63,3055
test4sub74of100,test4pub32of100,10,192,11,1657,63,1731
test4sub19of100,test4pub33of100,10,192,16,1369,63,1448
test4sub11of100,test4pub34of100,10,192,11,1307,63,1381
test4sub68of100,test4pub29of100,10,192,11,2052,63,2126
test4sub73of100,test4pub32of100,10,192,11,1660,64,1735
test4sub63of100,test4pub13of100,10,192,11,4046,62,4119
test4sub49of100,test4pub27of100,10,192,13,2239,64,2316
test4sub25of100,test4pub33of100,10,192,16,1375,63,1454
test4sub23of100,test4pub27of100,10,192,13,2241,64,2318
test4sub8of100,test4pub21of100,10,192,13,3083,64,3160
test4sub50of100,test4pub33of100,10,192,16,1377,64,1457
test4sub77of100,test4pub22of100,10,192,10,2993,64,3067
test4sub4of100,test4pub32of100,10,192,11,1667,64,1742
test4sub48of100,test4pub33of100,10,192,16,1381,64,1461
test4sub37of100,test4pub27of100,10,192,13,2246,65,2324
test4sub86of100,test4pub33of100,10,192,16,1382,63,1461
test4sub1of100,test4pub33of100,10,192,16,1382,65,1463
test4sub3of100,test4pub32of100,10,192,11,1672,65,1748
test4sub62of100,test4pub33of100,10,192,16,1384,66,1466
test4sub14of100,test4pub33of100,10,192,16,1385,65,1466
test4sub27of100,test4pub32of100,10,192,11,1674,66,1751
test4sub78of100,test4pub33of100,10,192,16,1388,65,1469
test4sub96of100,test4pub33of100,10,192,16,1387,67,1470
test4sub95of100,test4pub33of100,10,192,16,1389,65,1470
test4sub67of100,test4pub33of100,10,192,16,1389,67,1472
test4sub38of100,test4pub34of100,10,192,11,1328,65,1404
test4sub21of100,test4pub34of100,10,192,11,1328,67,1406
test4sub52of100,test4pub34of100,10,192,11,1330,66,1407
test4sub28of100,test4pub34of100,10,192,11,1330,67,1408
test4sub91of100,test4pub32of100,10,192,11,1683,66,1760
test4sub83of100,test4pub33of100,10,192,16,1395,67,1478
test4sub61of100,test4pub33of100,10,192,16,1397,66,1479
test4sub15of100,test4pub34of100,10,192,11,1334,68,1413
test4sub6of100,test4pub30of100,10,191,9,2003,66,2078
test4sub99of100,test4pub17of100,10,192,17,3560,67,3644
test4sub71of100,test4pub22of100,10,192,10,3014,65,3089
test4sub80of100,test4pub34of100,10,192,11,1338,67,1416
test4sub5of100,test4pub36of100,10,192,15,1002,65,1082
test4sub60of100,test4pub32of100,10,192,11,1690,66,1767
test4sub47of100,test4pub6of100,10,191,11,1997,3073,5081
test4sub82of100,test4pub29of100,10,192,11,2084,67,2162
test4sub26of100,test4pub29of100,10,192,11,2085,66,2162
test4sub89of100,test4pub19of100,10,192,18,3520,67,3605
test4sub56of100,test4pub12of100,10,191,9,4097,66,4172
test4sub12of100,test4pub20of100,10,192,10,3168,67,3245
test4sub87of100,test4pub34of100,10,192,11,1345,67,1423
test4sub9of100,test4pub35of100,10,192,15,1068,67,1150
test4sub22of100,test4pub34of100,10,192,11,1347,68,1426
test4sub69of100,test4pub33of100,10,192,16,1411,67,1494
test4sub66of100,test4pub31of100,10,192,19,1775,67,1861
test4sub51of100,test4pub26of100,10,192,11,2587,67,2665
test4sub44of100,test4pub27of100,10,192,13,2278,67,2358
test4sub94of100,test4pub32of100,10,192,11,1703,67,1781
test4sub65of100,test4pub28of100,10,192,18,2185,67,2270
test4sub18of100,test4pub34of100,10,192,11,1353,67,1431
test4sub29of100,test4pub33of100,10,192,16,1418,66,1500
test4sub58of100,test4pub19of100,10,192,18,3532,68,3618
test4sub72of100,test4pub34of100,10,192,11,1356,66,1433
test4sub98of100,test4pub27of100,10,192,13,2285,67,2365
test4sub90of100,test4pub33of100,10,192,16,1421,66,1503
test4sub7of100,test4pub25of100,10,192,10,2685,67,2762
test4sub2of100,test4pub33of100,10,192,16,1422,66,1504
test4sub39of100,test4pub33of100,10,192,16,1423,68,1507
test4sub16of100,test4pub34of100,10,192,11,1361,66,1438
test4sub13of100,test4pub33of100,10,192,16,1425,68,1509
test4sub43of100,test4pub27of100,10,192,13,2291,68,2372
test4sub41of100,test4pub29of100,10,192,11,2106,67,2184
test4sub70of100,test4pub30of100,10,191,9,1819,282,2110
test4sub54of100,test4pub7of100,10,191,17,1734,3077,4828
test4sub85of100,test4pub33of100,10,192,16,1428,70,1514
test4sub24of100,test4pub34of100,10,192,11,1365,70,1446
test4sub36of100,test4pub19of100,10,192,18,3543,70,3631
test4sub20of100,test4pub36of100,10,192,15,1030,70,1115
test4sub17of100,test4pub32of100,10,192,11,1719,70,1800
test4sub59of100,test4pub21of100,10,192,13,3138,70,3221
test4sub74of100,test4pub33of100,10,192,16,1433,69,1518
test4sub19of100,test4pub34of100,10,192,11,1370,69,1450
test4sub32of100,test4pub7of100,10,191,17,1743,3077,4837
test4sub11of100,test4pub36of100,10,192,15,1035,70,1120
test4sub73of100,test4pub34of100,10,192,11,1373,70,1454
test4sub63of100,test4pub14of100,10,192,10,4071,70,4151
test4sub49of100,test4pub28of100,10,192,18,2208,69,2295
test4sub25of100,test4pub34of100,10,192,11,1376,69,1456
test4sub23of100,test4pub28of100,10,192,18,2211,69,2298
test4sub8of100,test4pub22of100,10,192,10,3056,67,3133
test4sub50of100,test4pub34of100,10,192,11,1379,69,1459
test4sub77of100,test4pub23of100,10,192,17,2874,67,2958
test4sub4of100,test4pub33of100,10,192,16,1444,68,1528
test4sub37of100,test4pub28of100,10,192,18,2216,66,2300
test4sub86of100,test4pub34of100,10,192,11,1384,68,1463
test4sub1of100,test4pub34of100,10,192,11,1385,66,1462
test4sub3of100,test4pub33of100,10,192,16,1449,67,1532
test4sub62of100,test4pub34of100,10,192,11,1388,66,1465
test4sub27of100,test4pub33of100,10,192,16,1452,65,1533
test4sub78of100,test4pub34of100,10,192,11,1390,65,1466
test4sub76of100,test4pub10of100,10,192,10,4550,66,4626
test4sub96of100,test4pub34of100,10,192,11,1392,65,1468
test4sub95of100,test4pub34of100,10,192,11,1393,66,1470
test4sub67of100,test4pub35of100,10,192,15,1115,64,1194
test4sub38of100,test4pub35of100,10,192,15,1116,66,1197
test4sub53of100,test4pub7of100,10,191,17,1771,3068,4856
test4sub21of100,test4pub35of100,10,192,15,1117,65,1197
test4sub52of100,test4pub35of100,10,192,15,1118,66,1199
test4sub28of100,test4pub35of100,10,192,15,1119,67,1201
test4sub91of100,test4pub34of100,10,192,11,1398,66,1475
test4sub83of100,test4pub34of100,10,192,11,1400,67,1478
test4sub61of100,test4pub34of100,10,192,11,1400,66,1477
test4sub6of100,test4pub31of100,10,192,19,1828,67,1914
test4sub15of100,test4pub35of100,10,192,15,1123,67,1205
test4sub99of100,test4pub18of100,10,192,15,3606,66,3687
test4sub71of100,test4pub23of100,10,192,17,2897,67,2981
test4sub80of100,test4pub35of100,10,192,15,1126,67,1208
test4sub5of100,test4pub37of100,10,192,10,1031,67,1108
test4sub60of100,test4pub33of100,10,192,16,1470,68,1554
test4sub47of100,test4pub7of100,10,191,17,4785,68,4870
test4sub82of100,test4pub30of100,10,191,9,2076,68,2153
test4sub26of100,test4pub28of100,10,192,18,2242,69,2329
test4sub89of100,test4pub18of100,10,192,15,3613,68,3696
test4sub56of100,test4pub13of100,10,192,11,4147,69,4227
test4sub12of100,test4pub21of100,10,192,13,3181,68,3262
test4sub87of100,test4pub35of100,10,192,15,1134,68,1217
test4sub9of100,test4pub36of100,10,192,15,1077,69,1161
test4sub22of100,test4pub35of100,10,192,15,1136,69,1220
test4sub69of100,test4pub37of100,10,192,10,1042,69,1121
test4sub66of100,test4pub32of100,10,192,11,1768,69,1848
test4sub51of100,test4pub27of100,10,192,13,2346,67,2426
test4sub44of100,test4pub28of100,10,192,18,2251,69,2338
test4sub94of100,test4pub33of100,10,192,16,1483,68,1567
test4sub65of100,test4pub29of100,10,192,11,2163,69,2243
test4sub18of100,test4pub36of100,10,192,15,1084,68,1167
test4sub29of100,test4pub34of100,10,192,11,1422,70,1503
test4sub58of100,test4pub20of100,10,192,10,3246,69,3325
test4sub72of100,test4pub36of100,10,192,15,1086,70,1171
test4sub98of100,test4pub28of100,10,192,18,2258,69,2345
test4sub90of100,test4pub34of100,10,192,11,1425,71,1507
test4sub7of100,test4pub26of100,10,192,11,2663,69,2743
test4sub2of100,test4pub34of100,10,192,11,1427,71,1509
test4sub39of100,test4pub34of100,10,192,11,1428,69,1508
test4sub16of100,test4pub33of100,10,192,16,1491,71,1578
test4sub13of100,test4pub34of100,10,192,11,1430,70,1511
test4sub43of100,test4pub28of100,10,192,18,2264,70,2352
test4sub41of100,test4pub30of100,10,191,9,2100,70,2179
test4sub70of100,test4pub31of100,10,192,19,1860,70,1949
test4sub54of100,test4pub8of100,10,191,17,4685,69,4771
test4sub85of100,test4pub34of100,10,192,11,1436,70,1517
test4sub24of100,test4pub37of100,10,192,10,1062,70,1142
test4sub36of100,test4pub20of100,10,192,10,3260,70,3340
test4sub20of100,test4pub37of100,10,192,10,1063,70,1143
test4sub17of100,test4pub34of100,10,192,11,1439,70,1520
test4sub59of100,test4pub23of100,10,192,17,2932,71,3020
test4sub74of100,test4pub34of100,10,192,11,1440,70,1521
test4sub19of100,test4pub35of100,10,192,15,1162,70,1247
test4sub32of100,test4pub9of100,10,191,16,4643,70,4729
test4sub11of100,test4pub35of100,10,192,15,1163,70,1248
test4sub73of100,test4pub33of100,10,192,16,1507,70,1593
test4sub63of100,test4pub15of100,10,192,10,4031,70,4111
test4sub25of100,test4pub35of100,10,192,15,1167,71,1253
test4sub49of100,test4pub29of100,10,192,11,2189,71,2271
test4sub23of100,test4pub29of100,10,192,11,2190,71,2272
test4sub8of100,test4pub23of100,10,192,17,2941,72,3030
test4sub50of100,test4pub35of100,10,192,15,1170,72,1257
test4sub77of100,test4pub24of100,10,192,15,2859,72,2946
test4sub4of100,test4pub34of100,10,192,11,1450,72,1533
test4sub37of100,test4pub29of100,10,192,11,2194,72,2277
test4sub1of100,test4pub35of100,10,192,15,1174,71,1260
test4sub86of100,test4pub35of100,10,192,15,1173,72,1260
test4sub3of100,test4pub34of100,10,192,11,1454,71,1536
test4sub62of100,test4pub35of100,10,192,15,1175,71,1261
test4sub27of100,test4pub34of100,10,192,11,1456,72,1539
test4sub78of100,test4pub35of100,10,192,15,1177,71,1263
test4sub76of100,test4pub11of100,10,192,11,4498,71,4580
test4sub96of100,test4pub35of100,10,192,15,1179,72,1266
test4sub95of100,test4pub36of100,10,192,15,1122,71,1208
test4sub67of100,test4pub36of100,10,192,15,1122,71,1208
test4sub88of100,test4pub7of100,10,191,17,1831,3079,4927
test4sub38of100,test4pub36of100,10,192,15,1124,71,1210
test4sub21of100,test4pub36of100,10,192,15,1126,71,1212
test4sub52of100,test4pub37of100,10,192,10,1089,70,1169
test4sub28of100,test4pub36of100,10,192,15,1128,70,1213
test4sub91of100,test4pub33of100,10,192,16,1528,70,1614
test4sub83of100,test4pub35of100,10,192,15,1188,69,1272
test4sub61of100,test4pub35of100,10,192,15,1188,70,1273
test4sub6of100,test4pub32of100,10,192,11,1820,69,1900
test4sub15of100,test4pub36of100,10,192,15,1132,69,1216
test4sub99of100,test4pub19of100,10,192,18,3648,70,3736
test4sub71of100,test4pub24of100,10,192,15,2881,69,2965
test4sub80of100,test4pub36of100,10,192,15,1136,68,1219
test4sub5of100,test4pub38of100,10,192,10,880,69,959
test4sub60of100,test4pub34of100,10,192,11,1475,68,1554
test4sub47of100,test4pub9of100,10,191,16,4676,68,4760
test4sub82of100,test4pub31of100,10,192,19,1903,68,1990
test4sub26of100,test4pub30of100,10,191,9,2146,68,2223
test4sub89of100,test4pub20of100,10,192,10,3303,67,3380
test4sub56of100,test4pub15of100,10,192,10,4067,66,4143
test4sub12of100,test4pub22of100,10,192,10,3159,67,3236
test4sub87of100,test4pub36of100,10,192,15,1145,66,1226
test4sub9of100,test4pub37of100,10,192,10,1110,65,1185
test4sub22of100,test4pub36of100,10,192,15,1148,66,1229
test4sub66of100,test4pub33of100,10,192,16,1549,65,1630
test4sub51of100,test4pub28of100,10,192,18,2320,65,2403
test4sub44of100,test4pub29of100,10,192,11,2231,65,2307
test4sub94of100,test4pub34of100,10,192,11,1489,65,1565
test4sub65of100,test4pub30of100,10,191,9,2158,65,2232
test4sub18of100,test4pub35of100,10,192,15,1211,65,1291
test4sub29of100,test4pub35of100,10,192,15,1213,64,1292
test4sub58of100,test4pub22of100,10,192,10,3170,65,3245
test4sub72of100,test4pub35of100,10,192,15,1215,64,1294
test4sub98of100,test4pub29of100,10,192,11,2237,64,2312
test4sub90of100,test4pub36of100,10,192,15,1159,64,1238
test4sub7of100,test4pub27of100,10,192,13,2425,64,2502
test4sub2of100,test4pub35of100,10,192,15,1219,63,1297
test4sub39of100,test4pub35of100,10,192,15,1220,64,1299
test4sub16of100,test4pub35of100,10,192,15,1221,63,1299
test4sub13of100,test4pub36of100,10,192,15,1163,63,1241
test4sub43of100,test4pub29of100,10,192,11,2245,63,2319
test4sub30of100,test4pub7of100,10,191,17,4881,63,4961
test4sub70of100,test4pub32of100,10,192,11,1855,63,1929
test4sub54of100,test4pub9of100,10,191,16,4706,63,4785
test4sub85of100,test4pub35of100,10,192,15,1227,63,1305
test4sub24of100,test4pub35of100,10,192,15,1228,63,1306
test4sub36of100,test4pub21of100,10,192,13,3277,64,3354
test4sub20of100,test4pub38of100,10,192,10,914,64,988
test4sub17of100,test4pub33of100,10,192,16,1573,64,1653
test4sub59of100,test4pub24of100,10,192,15,2920,65,3000
test4sub74of100,test4pub35of100,10,192,15,1232,65,1312
test4sub19of100,test4pub36of100,10,192,15,1175,65,1255
test4sub32of100,test4pub8of100,10,191,17,4764,64,4845
test4sub11of100,test4pub37of100,10,192,10,1140,65,1215
test4sub73of100,test4pub36of100,10,192,15,1178,63,1256
test4sub63of100,test4pub16of100,10,192,10,4018,64,4092
test4sub25of100,test4pub36of100,10,192,15,1180,63,1258
test4sub49of100,test4pub30of100,10,191,9,2186,64,2259
test4sub23of100,test4pub30of100,10,191,9,2188,64,2261
test4sub8of100,test4pub24of100,10,192,15,2930,63,3008
test4sub50of100,test4pub36of100,10,192,15,1185,63,1263
test4sub77of100,test4pub25of100,10,192,10,2849,64,2923
test4sub4of100,test4pub35of100,10,192,15,1244,64,1323
test4sub37of100,test4pub31of100,10,192,19,1949,64,2032
test4sub1of100,test4pub36of100,10,192,15,1188,65,1268
test4sub86of100,test4pub36of100,10,192,15,1188,65,1268
test4sub3of100,test4pub35of100,10,192,15,1247,64,1326
test4sub62of100,test4pub36of100,10,192,15,1190,65,1270
test4sub27of100,test4pub35of100,10,192,15,1249,64,1328
test4sub78of100,test4pub36of100,10,192,15,1191,65,1271
test4sub96of100,test4pub36of100,10,192,15,1193,66,1274
test4sub76of100,test4pub12of100,10,191,9,4284,66,4359
test4sub95of100,test4pub37of100,10,192,10,1157,66,1233
test4sub67of100,test4pub37of100,10,192,10,1157,66,1233
test4sub88of100,test4pub8of100,10,191,17,4784,67,4868
test4sub38of100,test4pub37of100,10,192,10,1159,67,1236
test4sub21of100,test4pub37of100,10,192,10,1160,67,1237
test4sub52of100,test4pub36of100,10,192,15,1198,68,1281
test4sub28of100,test4pub37of100,10,192,10,1162,68,1240
test4sub91of100,test4pub35of100,10,192,15,1257,68,1340
test4sub83of100,test4pub36of100,10,192,15,1201,69,1285
test4sub61of100,test4pub36of100,10,192,15,1201,69,1285
test4sub6of100,test4pub33of100,10,192,16,1602,69,1687
test4sub15of100,test4pub37of100,10,192,10,1166,70,1246
test4sub99of100,test4pub20of100,10,192,10,3364,69,3443
test4sub71of100,test4pub25of100,10,192,10,2868,69,2947
test4sub80of100,test4pub37of100,10,192,10,1169,70,1249
test4sub5of100,test4pub39of100,10,192,19,518,70,607
test4sub60of100,test4pub35of100,10,192,15,1265,69,1349
test4sub47of100,test4pub8of100,10,191,17,4796,69,4882
test4sub26of100,test4pub31of100,10,192,19,1972,69,2060
test4sub82of100,test4pub32of100,10,192,11,1897,69,1977
test4sub89of100,test4pub21of100,10,192,13,3316,69,3398
test4sub56of100,test4pub14of100,10,192,10,4245,70,4325
test4sub12of100,test4pub23of100,10,192,17,3042,69,3128
test4sub87of100,test4pub37of100,10,192,10,1175,69,1254
test4sub9of100,test4pub38of100,10,192,10,957,70,1037
test4sub22of100,test4pub37of100,10,192,10,1177,70,1257
test4sub66of100,test4pub34of100,10,192,11,1552,69,1632
test4sub51of100,test4pub29of100,10,192,11,2296,70,2377
test4sub44of100,test4pub31of100,10,192,19,1980,69,2068
test4sub94of100,test4pub35of100,10,192,15,1276,69,1360
test4sub65of100,test4pub31of100,10,192,19,1982,70,2071
test4sub18of100,test4pub37of100,10,192,10,1182,69,1261
test4sub29of100,test4pub36of100,10,192,15,1221,69,1305
test4sub58of100,test4pub21of100,10,192,13,3327,70,3410
test4sub72of100,test4pub37of100,10,192,10,1185,69,1264
test4sub98of100,test4pub30of100,10,191,9,2228,69,2306
test4sub90of100,test4pub35of100,10,192,15,1282,68,1365
test4sub7of100,test4pub28of100,10,192,18,2394,69,2481
test4sub2of100,test4pub36of100,10,192,15,1226,68,1309
test4sub39of100,test4pub37of100,10,192,10,1189,70,1269
test4sub16of100,test4pub36of100,10,192,15,1227,68,1310
test4sub13of100,test4pub35of100,10,192,15,1286,70,1371
test4sub43of100,test4pub30of100,10,191,9,2234,68,2311
test4sub30of100,test4pub8of100,10,191,17,4818,69,4904
test4sub70of100,test4pub33of100,10,192,16,1631,69,1716
test4sub54of100,test4pub10of100,10,192,10,4728,70,4808
test4sub85of100,test4pub36of100,10,192,15,1233,68,1316
test4sub24of100,test4pub36of100,10,192,15,1234,70,1319
test4sub36of100,test4pub22of100,10,192,10,3249,68,3327
test4sub20of100,test4pub39of100,10,192,19,548,67,634
test4sub17of100,test4pub35of100,10,192,15,1296,68,1379
test4sub59of100,test4pub25of100,10,192,10,2902,67,2979
test4sub74of100,test4pub36of100,10,192,15,1240,66,1321
test4sub19of100,test4pub37of100,10,192,10,1203,67,1280
test4sub32of100,test4pub10of100,10,192,10,4738,67,4815
test4sub73of100,test4pub35of100,10,192,15,1301,66,1382
test4sub63of100,test4pub18of100,10,192,15,3783,67,3865
test4sub25of100,test4pub37of100,10,192,10,1208,66,1284
test4sub49of100,test4pub31of100,10,192,19,2008,67,2094
test4sub23of100,test4pub31of100,10,192,19,2010,65,2094
test4sub50of100,test4pub37of100,10,192,10,1212,65,1287
test4sub77of100,test4pub26of100,10,192,11,2823,64,2898
test4sub100of100,test4pub7of100,10,191,17,1964,3067,5048
test4sub4of100,test4pub36of100,10,192,15,1251,64,1330
test4sub37of100,test4pub30of100,10,191,9,2257,66,2332
test4sub1of100,test4pub37of100,10,192,10,1216,65,1291
test4sub86of100,test4pub37of100,10,192,10,1217,66,1293
test4sub3of100,test4pub37of100,10,192,10,1218,66,1294
test4sub62of100,test4pub37of100,10,192,10,1218,66,1294
test4sub27of100,test4pub37of100,10,192,10,1220,65,1295
test4sub78of100,test4pub37of100,10,192,10,1221,66,1297
test4sub96of100,test4pub37of100,10,192,10,1222,65,1297
test4sub76of100,test4pub14of100,10,192,10,4294,66,4370
test4sub95of100,test4pub35of100,10,192,15,1319,65,1399
test4sub67of100,test4pub38of100,10,192,10,1004,66,1080
test4sub88of100,test4pub10of100,10,192,10,4759,64,4833
test4sub38of100,test4pub38of100,10,192,10,1007,65,1082
test4sub21of100,test4pub38of100,10,192,10,1009,65,1084
test4sub52of100,test4pub38of100,10,192,10,1009,67,1086
test4sub68of100,test4pub30of100,10,191,9,2040,297,2346
test4sub28of100,test4pub38of100,10,192,10,1011,67,1088
test4sub91of100,test4pub36of100,10,192,15,1269,66,1350
test4sub83of100,test4pub37of100,10,192,10,1234,66,1310
test4sub61of100,test4pub37of100,10,192,10,1234,65,1309
test4sub15of100,test4pub38of100,10,192,10,1016,65,1091
test4sub6of100,test4pub34of100,10,192,11,1610,66,1687
test4sub99of100,test4pub21of100,10,192,13,3380,66,3459
test4sub71of100,test4pub26of100,10,192,11,2849,66,2926
test4sub80of100,test4pub38of100,10,192,10,1019,66,1095
test4sub60of100,test4pub36of100,10,192,15,1277,65,1357
test4sub47of100,test4pub10of100,10,192,10,4774,67,4851
test4sub26of100,test4pub32of100,10,192,11,1967,65,2043
test4sub82of100,test4pub33of100,10,192,16,1679,67,1762
test4sub89of100,test4pub22of100,10,192,10,3295,67,3372
test4sub56of100,test4pub16of100,10,192,10,4121,68,4199
test4sub87of100,test4pub38of100,10,192,10,1026,68,1104
test4sub12of100,test4pub24of100,10,192,15,3029,68,3112
test4sub9of100,test4pub39of100,10,192,19,596,69,684
test4sub22of100,test4pub38of100,10,192,10,1027,69,1106
test4sub66of100,test4pub35of100,10,192,15,1344,70,1429
test4sub51of100,test4pub30of100,10,191,9,2291,71,2371
test4sub44of100,test4pub30of100,10,191,9,2292,70,2371
test4sub94of100,test4pub36of100,10,192,15,1288,70,1373
test4sub65of100,test4pub32of100,10,192,11,1977,70,2058
test4sub18of100,test4pub38of100,10,192,10,1032,70,1112
test4sub29of100,test4pub37of100,10,192,10,1254,69,1333
test4sub58of100,test4pub23of100,10,192,17,3121,71,3209
test4sub72of100,test4pub38of100,10,192,10,1035,69,1114
test4sub98of100,test4pub31of100,10,192,19,2055,71,2145
test4sub7of100,test4pub29of100,10,192,11,2374,69,2454
test4sub2of100,test4pub37of100,10,192,10,1258,70,1338
test4sub39of100,test4pub36of100,10,192,15,1296,69,1380
test4sub16of100,test4pub37of100,10,192,10,1260,69,1339
test4sub13of100,test4pub37of100,10,192,10,1261,70,1341
test4sub43of100,test4pub31of100,10,192,19,2061,69,2149
test4sub30of100,test4pub9of100,10,191,16,4837,70,4923
test4sub70of100,test4pub34of100,10,192,11,1637,69,1717
test4sub54of100,test4pub11of100,10,192,11,4679,69,4759
test4sub85of100,test4pub37of100,10,192,10,1265,69,1344
test4sub36of100,test4pub23of100,10,192,17,3134,68,3219
test4sub20of100,test4pub40of100,10,192,11,341,70,422
test4sub17of100,test4pub36of100,10,192,15,1306,70,1391
test4sub59of100,test4pub26of100,10,192,11,2880,72,2963
test4sub74of100,test4pub37of100,10,192,10,1271,73,1354
test4sub19of100,test4pub38of100,10,192,10,1051,74,1135
test4sub32of100,test4pub11of100,10,192,11,4686,74,4771
test4sub73of100,test4pub37of100,10,192,10,1273,76,1359
test4sub63of100,test4pub19of100,10,192,18,3825,75,3918
test4sub25of100,test4pub38of100,10,192,10,1054,77,1141
test4sub49of100,test4pub32of100,10,192,11,2001,77,2089
test4sub23of100,test4pub32of100,10,192,11,2001,77,2089
test4sub50of100,test4pub38of100,10,192,10,1057,78,1145
test4sub77of100,test4pub27of100,10,192,13,2580,80,2673
test4sub100of100,test4pub8of100,10,191,17,4904,79,5000
test4sub4of100,test4pub37of100,10,192,10,1280,80,1370
test4sub37of100,test4pub32of100,10,192,11,2007,81,2099
test4sub1of100,test4pub38of100,10,192,10,1062,81,1153
test4sub86of100,test4pub38of100,10,192,10,1063,82,1155
test4sub3of100,test4pub36of100,10,192,15,1321,84,1420
test4sub62of100,test4pub38of100,10,192,10,1065,82,1157
test4sub27of100,test4pub36of100,10,192,15,1323,83,1421
test4sub78of100,test4pub38of100,10,192,10,1068,84,1162
test4sub96of100,test4pub38of100,10,192,10,1068,86,1164
test4sub76of100,test4pub13of100,10,192,11,4400,85,4496
test4sub67of100,test4pub39of100,10,192,19,640,85,744
test4sub88of100,test4pub9of100,10,191,16,4867,84,4967
test4sub38of100,test4pub39of100,10,192,19,643,85,747
test4sub21of100,test4pub39of100,10,192,19,643,85,747
test4sub52of100,test4pub39of100,10,192,19,645,84,748
test4sub68of100,test4pub31of100,10,192,19,2097,87,2203
test4sub28of100,test4pub39of100,10,192,19,647,87,753
test4sub91of100,test4pub37of100,10,192,10,1299,87,1396
test4sub83of100,test4pub38of100,10,192,10,1080,86,1176
test4sub15of100,test4pub39of100,10,192,19,650,86,755
test4sub90of100,test4pub37of100,10,192,10,1302,86,1398
test4sub6of100,test4pub36of100,10,192,15,1340,87,1442
test4sub99of100,test4pub22of100,10,192,10,3355,86,3451
test4sub71of100,test4pub27of100,10,192,13,2607,87,2707
test4sub80of100,test4pub39of100,10,192,19,655,86,760
test4sub60of100,test4pub37of100,10,192,10,1307,86,1403
test4sub47of100,test4pub11of100,10,192,11,4722,85,4818
test4sub26of100,test4pub33of100,10,192,16,1746,87,1849
test4sub82of100,test4pub34of100,10,192,11,1684,85,1780
test4sub95of100,test4pub38of100,10,192,10,1091,87,1188
test4sub89of100,test4pub23of100,10,192,17,3179,86,3282
test4sub56of100,test4pub18of100,10,192,15,3890,87,3992
test4sub87of100,test4pub39of100,10,192,19,663,85,767
test4sub12of100,test4pub25of100,10,192,10,3016,85,3111
test4sub9of100,test4pub40of100,10,192,11,390,85,486
test4sub22of100,test4pub39of100,10,192,19,666,86,771
test4sub5of100,test4pub40of100,10,192,11,391,87,489
test4sub66of100,test4pub36of100,10,192,15,1357,86,1458
test4sub51of100,test4pub31of100,10,192,19,2120,87,2226
test4sub44of100,test4pub32of100,10,192,11,2046,86,2143
test4sub94of100,test4pub37of100,10,192,10,1322,87,1419
test4sub18of100,test4pub39of100,10,192,19,672,85,776
test4sub29of100,test4pub38of100,10,192,10,1104,86,1200
test4sub58of100,test4pub24of100,10,192,15,3109,86,3210
test4sub72of100,test4pub39of100,10,192,19,674,86,779
test4sub98of100,test4pub32of100,10,192,11,2052,87,2150
test4sub7of100,test4pub30of100,10,191,9,2369,86,2464
test4sub39of100,test4pub38of100,10,192,10,1109,86,1205
test4sub16of100,test4pub38of100,10,192,10,1110,86,1206
test4sub13of100,test4pub38of100,10,192,10,1111,86,1207
test4sub43of100,test4pub32of100,10,192,11,2057,86,2154
test4sub30of100,test4pub10of100,10,192,10,4866,87,4963
test4sub70of100,test4pub35of100,10,192,15,1428,86,1529
test4sub54of100,test4pub12of100,10,191,9,4463,87,4559
test4sub85of100,test4pub38of100,10,192,10,1115,87,1212
test4sub36of100,test4pub24of100,10,192,15,3121,86,3222
test4sub20of100,test4pub41of100,10,191,9,318,85,412
test4sub17of100,test4pub37of100,10,192,10,1341,84,1435
test4sub59of100,test4pub27of100,10,192,13,2644,82,2739
test4sub74of100,test4pub38of100,10,192,10,1124,83,1217
test4sub19of100,test4pub39of100,10,192,19,695,81,795
test4sub32of100,test4pub12of100,10,191,9,4475,81,4565
test4sub73of100,test4pub38of100,10,192,10,1129,80,1219
test4sub63of100,test4pub17of100,10,192,17,3949,80,4046
test4sub49of100,test4pub33of100,10,192,16,1790,78,1884
test4sub23of100,test4pub33of100,10,192,16,1792,78,1886
test4sub50of100,test4pub39of100,10,192,19,705,76,800
test4sub77of100,test4pub28of100,10,192,18,2565,76,2659
test4sub100of100,test4pub10of100,10,192,10,4893,75,4978
test4sub4of100,test4pub38of100,10,192,10,1141,75,1226
test4sub37of100,test4pub33of100,10,192,16,1800,73,1889
test4sub1of100,test4pub39of100,10,192,19,714,74,807
test4sub86of100,test4pub39of100,10,192,19,715,72,806
test4sub62of100,test4pub39of100,10,192,19,718,71,808
test4sub27of100,test4pub38of100,10,192,10,1151,70,1231
test4sub78of100,test4pub40of100,10,192,11,446,69,526
test4sub96of100,test4pub39of100,10,192,19,723,67,809
test4sub76of100,test4pub15of100,10,192,10,4337,68,4415
test4sub88of100,test4pub11of100,10,192,11,4792,66,4869
test4sub21of100,test4pub40of100,10,192,11,453,65,529
test4sub52of100,test4pub40of100,10,192,11,455,65,531
test4sub68of100,test4pub32of100,10,192,11,2109,63,2183
test4sub28of100,test4pub40of100,10,192,11,459,61,531
test4sub83of100,test4pub39of100,10,192,19,736,62,817
test4sub68of100,test4pub33of100,10,192,16,1885,24,1925
test4sub21of100,test4pub41of100,10,191,9,426,26,461
test4sub88of100,test4pub12of100,10,191,9,4573,27,4609
test4sub15of100,test4pub40of100,10,192,11,461,61,533
test4sub76of100,test4pub16of100,10,192,10,4321,29,4360
test4sub96of100,test4pub40of100,10,192,11,516,31,558
test4sub78of100,test4pub39of100,10,192,19,791,32,842
test4sub62of100,test4pub40of100,10,192,11,514,35,560
test4sub86of100,test4pub40of100,10,192,11,512,37,560
test4sub1of100,test4pub40of100,10,192,11,512,38,561
test4sub37of100,test4pub34of100,10,192,11,1811,41,1863
test4sub4of100,test4pub39of100,10,192,19,786,42,847
test4sub100of100,test4pub9of100,10,191,16,5011,45,5072
test4sub77of100,test4pub29of100,10,192,11,2552,46,2609
test4sub50of100,test4pub40of100,10,192,11,507,49,567
test4sub23of100,test4pub34of100,10,192,11,1808,50,1869
test4sub49of100,test4pub34of100,10,192,11,1806,52,1869
test4sub63of100,test4pub20of100,10,192,10,3629,54,3693
test4sub73of100,test4pub39of100,10,192,19,779,57,855
test4sub32of100,test4pub13of100,10,192,11,4540,59,4610
test4sub19of100,test4pub40of100,10,192,11,501,62,574
test4sub58of100,test4pub25of100,10,192,10,3113,80,3203
test4sub29of100,test4pub39of100,10,192,19,759,82,860
test4sub94of100,test4pub38of100,10,192,10,1189,84,1283
test4sub44of100,test4pub34of100,10,192,11,1782,87,1880
test4sub51of100,test4pub32of100,10,192,11,2133,87,2231
test4sub72of100,test4pub40of100,10,192,11,486,79,576
test4sub66of100,test4pub37of100,10,192,10,1406,89,1505
test4sub98of100,test4pub33of100,10,192,16,1851,77,1944
test4sub5of100,test4pub41of100,10,191,9,385,91,485
test4sub22of100,test4pub40of100,10,192,11,477,93,581
test4sub7of100,test4pub31of100,10,192,19,2215,77,2311
test4sub9of100,test4pub41of100,10,191,9,383,94,486
test4sub11of100,test4pub38of100,10,192,10,1183,96,1289
test4sub41of100,test4pub31of100,10,192,19,2202,97,2318
test4sub74of100,test4pub39of100,10,192,19,776,63,858
test4sub12of100,test4pub26of100,10,192,11,3013,99,3123
test4sub87of100,test4pub40of100,10,192,11,473,100,584
test4sub56of100,test4pub17of100,10,192,17,3998,101,4116
test4sub26of100,test4pub34of100,10,192,11,1770,106,1887
test4sub39of100,test4pub39of100,10,192,19,765,75,859
test4sub47of100,test4pub13of100,10,192,11,4504,108,4623
test4sub16of100,test4pub39of100,10,192,19,766,75,860
test4sub13of100,test4pub39of100,10,192,19,767,73,859
test4sub80of100,test4pub40of100,10,192,11,466,110,587
test4sub71of100,test4pub28of100,10,192,18,2599,112,2729
test4sub43of100,test4pub33of100,10,192,16,1855,73,1944
test4sub99of100,test4pub23of100,10,192,17,3259,113,3389
test4sub6of100,test4pub35of100,10,192,15,1485,115,1615
test4sub28of100,test4pub41of100,10,191,9,428,57,494
test4sub30of100,test4pub11of100,10,192,11,4834,71,4916
test4sub70of100,test4pub36of100,10,192,15,1458,70,1543
test4sub54of100,test4pub13of100,10,192,11,4532,69,4612
test4sub85of100,test4pub39of100,10,192,19,771,68,858
test4sub36of100,test4pub25of100,10,192,10,3125,67,3202
test4sub20of100,test4pub42of100,10,192,10,271,67,348
test4sub17of100,test4pub38of100,10,192,10,1205,65,1280
test4sub59of100,test4pub28of100,10,192,18,2633,65,2716
test4sub90of100,test4pub38of100,10,192,10,1170,116,1296
test4sub82of100,test4pub35of100,10,192,15,1492,105,1612
test4sub95of100,test4pub39of100,10,192,19,747,103,869
test4sub89of100,test4pub24of100,10,192,15,3183,103,3301
test4sub83of100,test4pub40of100,10,192,11,523,39,573
test4sub96of100,test4pub41of100,10,191,9,454,43,506
test4sub78of100,test4pub41of100,10,191,9,455,42,506
test4sub62of100,test4pub41of100,10,191,9,455,42,506
test4sub86of100,test4pub41of100,10,191,9,456,42,507
test4sub1of100,test4pub41of100,10,191,9,457,42,508
test4sub37of100,test4pub35of100,10,192,15,1574,42,1631
test4sub4of100,test4pub40of100,10,192,11,554,41,606
test4sub76of100,test4pub17of100,10,192,17,4072,42,4131
test4sub100of100,test4pub11of100,10,192,11,4896,42,4949
test4sub15of100,test4pub41of100,10,191,9,453,44,506
test4sub88of100,test4pub13of100,10,192,11,4584,43,4638
test4sub77of100,test4pub30of100,10,191,9,2525,45,2579
test4sub23of100,test4pub36of100,10,192,15,1521,43,1579
test4sub49of100,test4pub36of100,10,192,15,1522,43,1580
test4sub63of100,test4pub21of100,10,192,13,3630,43,3686
test4sub73of100,test4pub40of100,10,192,11,561,43,615
test4sub32of100,test4pub14of100,10,192,10,4560,41,4611
test4sub19of100,test4pub41of100,10,191,9,469,40,518
test4sub58of100,test4pub26of100,10,192,11,3104,40,3155
test4sub68of100,test4pub34of100,10,192,11,1847,42,1900
test4sub29of100,test4pub40of100,10,192,11,566,42,619
test4sub94of100,test4pub39of100,10,192,19,843,42,904
test4sub51of100,test4pub33of100,10,192,16,1933,42,1991
test4sub44of100,test4pub33of100,10,192,16,1932,43,1991
test4sub72of100,test4pub41of100,10,191,9,476,32,517
test4sub56of100,test4pub19of100,10,192,18,4053,32,4103
test4sub85of100,test4pub40of100,10,192,11,581,34,626
test4sub54of100,test4pub14of100,10,192,10,4578,34,4622
test4sub70of100,test4pub37of100,10,192,10,1507,35,1552
test4sub30of100,test4pub14of100,10,192,10,4578,37,4625
test4sub36of100,test4pub26of100,10,192,11,3120,37,3168
test4sub28of100,test4pub42of100,10,192,10,353,39,402
test4sub6of100,test4pub37of100,10,192,10,1506,40,1556
test4sub99of100,test4pub24of100,10,192,15,3289,39,3343
test4sub17of100,test4pub39of100,10,192,19,859,40,918
test4sub98of100,test4pub34of100,10,192,11,1871,41,1923
test4sub59of100,test4pub29of100,10,192,11,2628,40,2679
test4sub16of100,test4pub40of100,10,192,11,576,40,627
test4sub90of100,test4pub39of100,10,192,19,861,40,920
test4sub66of100,test4pub38of100,10,192,10,1277,41,1328
test4sub43of100,test4pub34of100,10,192,11,1879,43,1933
test4sub95of100,test4pub40of100,10,192,11,585,42,638
test4sub89of100,test4pub25of100,10,192,10,3214,43,3267
test4sub7of100,test4pub32of100,10,192,11,2223,43,2277
test4sub71of100,test4pub29of100,10,192,11,2621,44,2676
test4sub80of100,test4pub41of100,10,191,9,483,44,536
test4sub83of100,test4pub41of100,10,191,9,494,45,548
test4sub13of100,test4pub40of100,10,192,11,577,45,633
test4sub47of100,test4pub12of100,10,191,9,4631,46,4686
test4sub26of100,test4pub35of100,10,192,15,1598,48,1661
test4sub87of100,test4pub41of100,10,191,9,481,48,538
test4sub50of100,test4pub41of100,10,191,9,480,50,539
test4sub12of100,test4pub27of100,10,192,13,2803,50,2866
test4sub74of100,test4pub40of100,10,192,11,573,50,634
test4sub41of100,test4pub32of100,10,192,11,2225,52,2288
test4sub11of100,test4pub39of100,10,192,19,848,51,918
test4sub5of100,test4pub42of100,10,192,10,346,52,408
test4sub9of100,test4pub42of100,10,192,10,345,53,408
test4sub96of100,test4pub42of100,10,192,10,365,52,427
test4sub78of100,test4pub42of100,10,192,10,365,52,427
test4sub62of100,test4pub42of100,10,192,10,367,53,430
test4sub86of100,test4pub42of100,10,192,10,367,53,430
test4sub37of100,test4pub36of100,10,192,15,1559,52,1626
test4sub4of100,test4pub41of100,10,191,9,501,52,562
test4sub76of100,test4pub18of100,10,192,15,4101,53,4169
test4sub100of100,test4pub12of100,10,191,9,4653,52,4714
test4sub15of100,test4pub42of100,10,192,10,373,52,435
test4sub88of100,test4pub14of100,10,192,10,4598,52,4660
test4sub77of100,test4pub31of100,10,192,19,2328,53,2400
test4sub23of100,test4pub35of100,10,192,15,1623,52,1690
test4sub49of100,test4pub35of100,10,192,15,1625,53,1693
test4sub63of100,test4pub22of100,10,192,10,3581,52,3643
test4sub73of100,test4pub41of100,10,191,9,510,53,572
test4sub32of100,test4pub15of100,10,192,10,4493,53,4556
test4sub19of100,test4pub42of100,10,192,10,380,53,443
test4sub58of100,test4pub27of100,10,192,13,2836,53,2902
test4sub1of100,test4pub42of100,10,192,10,382,54,446
test4sub68of100,test4pub35of100,10,192,15,1630,54,1699
test4sub29of100,test4pub41of100,10,191,9,516,55,580
test4sub94of100,test4pub40of100,10,192,11,610,56,677
test4sub51of100,test4pub34of100,10,192,11,1912,56,1979
test4sub44of100,test4pub36of100,10,192,15,1576,56,1647
test4sub72of100,test4pub42of100,10,192,10,387,56,453
test4sub56of100,test4pub20of100,10,192,10,3738,58,3806
test4sub85of100,test4pub41of100,10,191,9,521,56,586
test4sub54of100,test4pub15of100,10,192,10,4504,57,4571
test4sub70of100,test4pub38of100,10,192,10,1324,56,1390
test4sub27of100,test4pub39of100,10,192,19,894,58,971
test4sub30of100,test4pub12of100,10,191,9,4674,56,4739
test4sub36of100,test4pub27of100,10,192,13,2849,56,2918
test4sub28of100,test4pub44of100,10,192,10,216,56,282
test4sub99of100,test4pub25of100,10,192,10,3251,55,3316
test4sub98of100,test4pub35of100,10,192,15,1646,55,1716
test4sub59of100,test4pub30of100,10,191,9,2593,55,2657
test4sub16of100,test4pub41of100,10,191,9,531,55,595
test4sub66of100,test4pub39of100,10,192,19,902,56,977
test4sub43of100,test4pub36of100,10,192,15,1592,55,1662
test4sub95of100,test4pub41of100,10,191,9,535,56,600
test4sub89of100,test4pub26of100,10,192,11,3168,54,3233
test4sub7of100,test4pub33of100,10,192,16,1994,56,2066
test4sub71of100,test4pub30of100,10,191,9,2601,55,2665
test4sub83of100,test4pub42of100,10,192,10,407,55,472
test4sub67of100,test4pub40of100,10,192,11,634,55,700
test4sub13of100,test4pub41of100,10,191,9,541,56,606
test4sub47of100,test4pub14of100,10,192,10,4634,55,4699
test4sub26of100,test4pub36of100,10,192,15,1601,55,1671
test4sub87of100,test4pub42of100,10,192,10,412,55,477
test4sub12of100,test4pub28of100,10,192,18,2773,54,2845
test4sub74of100,test4pub41of100,10,191,9,546,54,609
test4sub41of100,test4pub33of100,10,192,16,2005,54,2075
test4sub11of100,test4pub40of100,10,192,11,641,54,706
test4sub5of100,test4pub43of100,10,192,10,313,55,378
test4sub9of100,test4pub43of100,10,192,10,313,56,379
test4sub96of100,test4pub43of100,10,192,10,314,54,378
test4sub78of100,test4pub43of100,10,192,10,315,55,380
test4sub62of100,test4pub43of100,10,192,10,316,54,380
test4sub86of100,test4pub43of100,10,192,10,316,54,380
test4sub37of100,test4pub37of100,10,192,10,1575,54,1639
test4sub4of100,test4pub42of100,10,192,10,422,54,486
test4sub80of100,test4pub42of100,10,192,10,423,53,486
test4sub76of100,test4pub19of100,10,192,18,4128,53,4199
test4sub100of100,test4pub13of100,10,192,11,4688,54,4753
test4sub15of100,test4pub43of100,10,192,10,322,52,384
test4sub88of100,test4pub15of100,10,192,10,4541,54,4605
test4sub77of100,test4pub32of100,10,192,11,2306,52,2369
test4sub23of100,test4pub37of100,10,192,10,1581,54,1645
test4sub20of100,test4pub43of100,10,192,10,325,53,388
test4sub49of100,test4pub37of100,10,192,10,1583,54,1647
test4sub63of100,test4pub23of100,10,192,17,3451,54,3522
test4sub73of100,test4pub42of100,10,192,10,432,54,496
test4sub32of100,test4pub16of100,10,192,10,4463,55,4528
test4sub19of100,test4pub43of100,10,192,10,330,54,394
test4sub58of100,test4pub28of100,10,192,18,2795,54,2867
test4sub1of100,test4pub44of100,10,192,10,256,53,319
test4sub24of100,test4pub38of100,10,192,10,1370,53,1433
test4sub68of100,test4pub37of100,10,192,10,1590,53,1653
test4sub2of100,test4pub38of100,10,192,10,1371,53,1434
test4sub3of100,test4pub38of100,10,192,10,1371,54,1435
test4sub29of100,test4pub42of100,10,192,10,440,54,504
test4sub91of100,test4pub38of100,10,192,10,1373,55,1438
test4sub94of100,test4pub41of100,10,191,9,573,55,637
test4sub51of100,test4pub35of100,10,192,15,1690,55,1760
test4sub44of100,test4pub35of100,10,192,15,1691,55,1761
test4sub72of100,test4pub43of100,10,192,10,340,55,405
test4sub56of100,test4pub21of100,10,192,13,3742,55,3810
test4sub85of100,test4pub42of100,10,192,10,447,54,511
test4sub54of100,test4pub16of100,10,192,10,4478,54,4542
test4sub70of100,test4pub39of100,10,192,19,951,56,1026
test4sub27of100,test4pub40of100,10,192,11,676,55,742
test4sub30of100,test4pub13of100,10,192,11,4713,56,4780
test4sub36of100,test4pub28of100,10,192,18,2812,55,2885
test4sub99of100,test4pub26of100,10,192,11,3217,55,3283
test4sub98of100,test4pub36of100,10,192,15,1643,54,1712
test4sub59of100,test4pub31of100,10,192,19,2408,56,2483
test4sub16of100,test4pub43of100,10,192,10,351,55,416
test4sub66of100,test4pub40of100,10,192,11,683,56,750
test4sub43of100,test4pub35of100,10,192,15,1706,56,1777
test4sub95of100,test4pub42of100,10,192,10,459,55,524
test4sub89of100,test4pub27of100,10,192,13,2915,56,2984
test4sub7of100,test4pub34of100,10,192,11,1988,56,2055
test4sub71of100,test4pub31of100,10,192,19,2415,57,2491
test4sub83of100,test4pub43of100,10,192,10,359,57,426
test4sub67of100,test4pub41of100,10,191,9,596,57,662
test4sub13of100,test4pub42of100,10,192,10,465,56,531
test4sub47of100,test4pub15of100,10,192,10,4580,58,4648
test4sub26of100,test4pub37of100,10,192,10,1620,57,1687
test4sub87of100,test4pub43of100,10,192,10,363,57,430
test4sub12of100,test4pub29of100,10,192,11,2739,57,2807
test4sub10of100,test4pub3of100,10,191,10,3964,3066,7040
test4sub74of100,test4pub42of100,10,192,10,469,58,537
test4sub41of100,test4pub34of100,10,192,11,1997,58,2066
test4sub11of100,test4pub41of100,10,191,9,603,58,670
test4sub9of100,test4pub44of100,10,192,10,293,57,360
test4sub37of100,test4pub38of100,10,192,10,1409,56,1475
test4sub4of100,test4pub43of100,10,192,10,372,55,437
test4sub80of100,test4pub43of100,10,192,10,374,56,440
test4sub76of100,test4pub21of100,10,192,13,3774,56,3843
test4sub100of100,test4pub14of100,10,192,10,4703,55,4768
test4sub15of100,test4pub44of100,10,192,10,300,56,366
test4sub88of100,test4pub16of100,10,192,10,4511,54,4575
test4sub77of100,test4pub33of100,10,192,16,2072,55,2143
test4sub23of100,test4pub38of100,10,192,10,1416,54,1480
test4sub20of100,test4pub44of100,10,192,10,304,55,369
test4sub49of100,test4pub38of100,10,192,10,1418,53,1481
test4sub63of100,test4pub24of100,10,192,15,3423,54,3492
test4sub86of100,test4pub44of100,10,192,10,306,54,370
test4sub73of100,test4pub43of100,10,192,10,383,53,446
test4sub32of100,test4pub17of100,10,192,17,4239,54,4310
test4sub58of100,test4pub29of100,10,192,11,2760,53,2824
test4sub24of100,test4pub39of100,10,192,19,993,52,1064
test4sub68of100,test4pub36of100,10,192,15,1681,53,1749
test4sub2of100,test4pub39of100,10,192,19,995,52,1066
test4sub3of100,test4pub39of100,10,192,19,995,53,1067
test4sub18of100,test4pub40of100,10,192,11,720,51,782
test4sub29of100,test4pub43of100,10,192,10,391,52,453
test4sub78of100,test4pub44of100,10,192,10,315,52,377
test4sub91of100,test4pub39of100,10,192,19,998,51,1068
test4sub94of100,test4pub42of100,10,192,10,497,51,558
test4sub51of100,test4pub36of100,10,192,15,1689,51,1755
test4sub44of100,test4pub37of100,10,192,10,1652,52,1714
test4sub56of100,test4pub22of100,10,192,10,3705,49,3764
test4sub5of100,test4pub44of100,10,192,10,322,51,383
test4sub85of100,test4pub44of100,10,192,10,322,51,383
test4sub62of100,test4pub44of100,10,192,10,323,53,386
test4sub54of100,test4pub17of100,10,192,17,4254,52,4323
test4sub70of100,test4pub40of100,10,192,11,731,50,792
test4sub27of100,test4pub41of100,10,191,9,638,53,700
test4sub30of100,test4pub15of100,10,192,10,4621,53,4684
test4sub36of100,test4pub29of100,10,192,11,2777,52,2840
test4sub99of100,test4pub27of100,10,192,13,2963,53,3029
test4sub98of100,test4pub37of100,10,192,10,1662,53,1725
test4sub46of100,test4pub33of100,10,192,16,2100,54,2170
test4sub59of100,test4pub32of100,10,192,11,2389,53,2453
test4sub16of100,test4pub42of100,10,192,10,511,53,574
test4sub6of100,test4pub38of100,10,192,10,1445,53,1508
test4sub66of100,test4pub41of100,10,191,9,646,52,707
test4sub43of100,test4pub37of100,10,192,10,1667,53,1730
test4sub95of100,test4pub43of100,10,192,10,412,55,477
test4sub89of100,test4pub28of100,10,192,18,2877,54,2949
test4sub7of100,test4pub35of100,10,192,15,1766,54,1835
test4sub71of100,test4pub32of100,10,192,11,2397,54,2462
test4sub67of100,test4pub42of100,10,192,10,522,53,585
test4sub13of100,test4pub43of100,10,192,10,418,53,481
test4sub47of100,test4pub16of100,10,192,10,4554,53,4617
test4sub26of100,test4pub38of100,10,192,10,1457,54,1521
test4sub87of100,test4pub44of100,10,192,10,346,54,410
test4sub12of100,test4pub30of100,10,191,9,2721,55,2785
test4sub10of100,test4pub5of100,10,191,17,6156,53,6226
test4sub74of100,test4pub43of100,10,192,10,424,55,489
test4sub65of100,test4pub33of100,10,192,16,2119,55,2190
test4sub41of100,test4pub35of100,10,192,15,1777,56,1848
test4sub11of100,test4pub42of100,10,192,10,531,55,596
test4sub37of100,test4pub39of100,10,192,19,1034,54,1107
test4sub4of100,test4pub44of100,10,192,10,352,55,417
test4sub76of100,test4pub20of100,10,192,10,3884,54,3948
test4sub100of100,test4pub15of100,10,192,10,4649,53,4712
test4sub88of100,test4pub17of100,10,192,17,4287,54,4358
test4sub77of100,test4pub34of100,10,192,11,2064,53,2128
test4sub23of100,test4pub39of100,10,192,19,1041,54,1114
test4sub49of100,test4pub39of100,10,192,19,1042,53,1114
test4sub63of100,test4pub25of100,10,192,10,3394,54,3458
test4sub40of100,test4pub4of100,10,191,11,3255,3057,6323
test4sub73of100,test4pub44of100,10,192,10,362,54,426
test4sub32of100,test4pub18of100,10,192,15,4272,54,4341
test4sub58of100,test4pub30of100,10,191,9,2739,54,2802
test4sub24of100,test4pub40of100,10,192,11,770,54,835
test4sub68of100,test4pub38of100,10,192,10,1478,54,1542
test4sub18of100,test4pub41of100,10,191,9,678,53,740
test4sub29of100,test4pub44of100,10,192,10,367,55,432
test4sub9of100,test4pub45of100,10,191,9,227,53,289
test4sub94of100,test4pub43of100,10,192,10,446,53,509
test4sub51of100,test4pub37of100,10,192,10,1703,53,1766
test4sub44of100,test4pub38of100,10,192,10,1484,53,1547
test4sub56of100,test4pub23of100,10,192,17,3572,54,3643
test4sub5of100,test4pub45of100,10,191,9,232,53,294
test4sub85of100,test4pub43of100,10,192,10,450,53,513
test4sub54of100,test4pub18of100,10,192,15,4286,51,4352
test4sub86of100,test4pub45of100,10,191,9,236,52,297
test4sub70of100,test4pub41of100,10,191,9,690,51,750
test4sub62of100,test4pub45of100,10,191,9,238,51,298
test4sub30of100,test4pub16of100,10,192,10,4590,51,4651
test4sub36of100,test4pub31of100,10,192,19,2514,51,2584
test4sub99of100,test4pub28of100,10,192,18,2922,51,2991
test4sub98of100,test4pub38of100,10,192,10,1496,51,1557
test4sub46of100,test4pub34of100,10,192,11,2091,51,2153
test4sub59of100,test4pub33of100,10,192,16,2154,51,2221
test4sub16of100,test4pub44of100,10,192,10,386,51,447
test4sub6of100,test4pub39of100,10,192,19,1068,50,1137
test4sub66of100,test4pub42of100,10,192,10,568,50,628
test4sub43of100,test4pub38of100,10,192,10,1501,50,1561
test4sub52of100,test4pub41of100,10,191,9,702,50,761
test4sub95of100,test4pub44of100,10,192,10,391,49,450
test4sub89of100,test4pub29of100,10,192,11,2842,50,2903
test4sub7of100,test4pub36of100,10,192,15,1763,50,1828
test4sub71of100,test4pub33of100,10,192,16,2164,49,2229
test4sub67of100,test4pub43of100,10,192,10,472,50,532
test4sub13of100,test4pub44of100,10,192,10,396,49,455
test4sub3of100,test4pub40of100,10,192,11,803,52,866
test4sub91of100,test4pub40of100,10,192,11,804,52,867
test4sub47of100,test4pub18of100,10,192,15,4308,52,4375
test4sub26of100,test4pub39of100,10,192,19,1082,51,1152
test4sub12of100,test4pub31of100,10,192,19,2534,51,2604
test4sub10of100,test4pub6of100,10,191,11,5773,51,5835
test4sub74of100,test4pub44of100,10,192,10,403,50,463
test4sub65of100,test4pub34of100,10,192,11,2111,50,2172
test4sub41of100,test4pub37of100,10,192,10,1739,50,1799
test4sub11of100,test4pub43of100,10,192,10,482,50,542
test4sub37of100,test4pub40of100,10,192,11,814,50,875
test4sub76of100,test4pub22of100,10,192,10,3793,48,3851
test4sub100of100,test4pub16of100,10,192,10,4620,50,4680
test4sub88of100,test4pub18of100,10,192,15,4321,50,4386
test4sub77of100,test4pub36of100,10,192,15,1782,50,1847
test4sub23of100,test4pub40of100,10,192,11,819,50,880
test4sub49of100,test4pub40of100,10,192,11,819,50,880
test4sub63of100,test4pub26of100,10,192,11,3359,51,3421
test4sub40of100,test4pub5of100,10,191,17,6224,50,6291
test4sub73of100,test4pub45of100,10,191,9,276,51,336
test4sub32of100,test4pub19of100,10,192,18,4301,51,4370
test4sub58of100,test4pub31of100,10,192,19,2551,50,2620
test4sub24of100,test4pub41of100,10,191,9,731,51,791
test4sub68of100,test4pub39of100,10,192,19,1102,50,1171
test4sub18of100,test4pub42of100,10,192,10,600,51,661
test4sub29of100,test4pub45of100,10,191,9,281,49,339
test4sub94of100,test4pub44of100,10,192,10,423,49,482
test4sub51of100,test4pub38of100,10,192,10,1537,49,1596
test4sub57of100,test4pub10of100,10,192,10,2290,3049,5349
test4sub44of100,test4pub39of100,10,192,19,1108,50,1177
test4sub56of100,test4pub24of100,10,192,15,3543,51,3609
test4sub85of100,test4pub45of100,10,191,9,287,49,345
test4sub54of100,test4pub19of100,10,192,18,4312,50,4380
test4sub70of100,test4pub42of100,10,192,10,610,50,670
test4sub62of100,test4pub46of100,10,192,10,103,49,162
test4sub30of100,test4pub17of100,10,192,17,4363,49,4429
test4sub36of100,test4pub30of100,10,191,9,2807,50,2866
test4sub98of100,test4pub39of100,10,192,19,1116,49,1184
test4sub46of100,test4pub35of100,10,192,15,1863,49,1927
test4sub59of100,test4pub34of100,10,192,11,2144,49,2204
test4sub6of100,test4pub40of100,10,192,11,844,48,903
test4sub66of100,test4pub43of100,10,192,10,514,48,572
test4sub43of100,test4pub39of100,10,192,19,1122,48,1189
test4sub52of100,test4pub42of100,10,192,10,620,49,679
test4sub95of100,test4pub45of100,10,191,9,300,48,357
test4sub89of100,test4pub30of100,10,191,9,2817,48,2874
test4sub9of100,test4pub46of100,10,192,10,116,49,175
test4sub7of100,test4pub37of100,10,192,10,1777,47,1834
test4sub71of100,test4pub34of100,10,192,11,2152,47,2210
test4sub67of100,test4pub44of100,10,192,10,446,47,503
test4sub13of100,test4pub45of100,10,191,9,306,47,362
test4sub22of100,test4pub41of100,10,191,9,760,47,816
test4sub3of100,test4pub41of100,10,191,9,762,46,817
test4sub91of100,test4pub41of100,10,191,9,762,47,818
test4sub47of100,test4pub19of100,10,192,18,4335,45,4398
test4sub26of100,test4pub40of100,10,192,11,858,47,916
test4sub12of100,test4pub32of100,10,192,11,2511,45,2567
test4sub10of100,test4pub7of100,10,191,17,5538,47,5602
test4sub74of100,test4pub45of100,10,191,9,314,46,369
test4sub65of100,test4pub35of100,10,192,15,1883,47,1945
test4sub41of100,test4pub36of100,10,192,15,1827,48,1890
test4sub11of100,test4pub44of100,10,192,10,457,47,514
test4sub37of100,test4pub41of100,10,191,9,770,47,826
test4sub76of100,test4pub23of100,10,192,17,3659,49,3725
test4sub14of100,test4pub34of100,10,192,11,2167,47,2225
test4sub100of100,test4pub18of100,10,192,15,4370,49,4434
test4sub88of100,test4pub19of100,10,192,18,4346,47,4411
test4sub5of100,test4pub47of100,10,192,10,60,50,120
test4sub77of100,test4pub35of100,10,192,15,1891,50,1956
test4sub23of100,test4pub41of100,10,191,9,777,49,835
test4sub49of100,test4pub41of100,10,191,9,777,50,836
test4sub63of100,test4pub27of100,10,192,13,3101,48,3162
test4sub40of100,test4pub6of100,10,191,11,5838,50,5899
test4sub32of100,test4pub20of100,10,192,10,3998,48,4056
test4sub58of100,test4pub32of100,10,192,11,2527,49,2587
test4sub24of100,test4pub42of100,10,192,10,650,47,707
test4sub68of100,test4pub40of100,10,192,11,877,49,937
test4sub29of100,test4pub46of100,10,192,10,146,47,203
test4sub51of100,test4pub39of100,10,192,19,1156,47,1222
test4sub57of100,test4pub11of100,10,192,11,5221,47,5279
test4sub73of100,test4pub46of100,10,192,10,148,47,205
test4sub44of100,test4pub40of100,10,192,11,882,46,939
test4sub56of100,test4pub25of100,10,192,10,3511,46,3567
test4sub54of100,test4pub20of100,10,192,10,4009,46,4065
test4sub28of100,test4pub43of100,10,192,10,555,47,612
test4sub70of100,test4pub43of100,10,192,10,556,46,612
test4sub4of100,test4pub45of100,10,191,9,340,45,394
test4sub30of100,test4pub18of100,10,192,15,4392,47,4454
test4sub86of100,test4pub46of100,10,192,10,156,46,212
test4sub36of100,test4pub32of100,10,192,11,2541,46,2598
test4sub98of100,test4pub40of100,10,192,11,891,46,948
test4sub46of100,test4pub37of100,10,192,10,1818,47,1875
test4sub59of100,test4pub35of100,10,192,15,1914,45,1974
test4sub66of100,test4pub44of100,10,192,10,487,45,542
test4sub6of100,test4pub41of100,10,191,9,799,47,855
test4sub43of100,test4pub40of100,10,192,11,895,46,952
test4sub52of100,test4pub44of100,10,192,10,489,46,545
test4sub95of100,test4pub46of100,10,192,10,164,46,220
test4sub89of100,test4pub31of100,10,192,19,2624,47,2690
test4sub7of100,test4pub38of100,10,192,10,1605,45,1660
test4sub71of100,test4pub35of100,10,192,15,1921,46,1982
test4sub67of100,test4pub45of100,10,191,9,353,45,407
test4sub13of100,test4pub46of100,10,192,10,167,46,223
test4sub22of100,test4pub42of100,10,192,10,676,45,731
test4sub3of100,test4pub42of100,10,192,10,676,47,733
test4sub91of100,test4pub42of100,10,192,10,677,45,732
test4sub47of100,test4pub17of100,10,192,17,4429,46,4492
test4sub26of100,test4pub41of100,10,191,9,811,44,864
test4sub12of100,test4pub33of100,10,192,16,2269,46,2331
test4sub74of100,test4pub46of100,10,192,10,174,44,228
test4sub10of100,test4pub8of100,10,191,17,5459,45,5521
test4sub65of100,test4pub36of100,10,192,15,1873,44,1932
test4sub85of100,test4pub46of100,10,192,10,177,44,231
test4sub41of100,test4pub38of100,10,192,10,1618,43,1671
test4sub37of100,test4pub42of100,10,192,10,686,44,740
test4sub50of100,test4pub42of100,10,192,10,687,44,741
test4sub14of100,test4pub36of100,10,192,15,1879,42,1936
test4sub76of100,test4pub24of100,10,192,15,3625,44,3684
test4sub88of100,test4pub20of100,10,192,10,4041,42,4093
test4sub100of100,test4pub17of100,10,192,17,4441,44,4502
test4sub78of100,test4pub45of100,10,191,9,371,44,424
test4sub23of100,test4pub42of100,10,192,10,694,43,747
test4sub77of100,test4pub37of100,10,192,10,1847,44,1901
test4sub49of100,test4pub42of100,10,192,10,695,42,747
test4sub63of100,test4pub28of100,10,192,18,3056,43,3117
test4sub40of100,test4pub7of100,10,191,17,5602,43,5662
test4sub32of100,test4pub21of100,10,192,13,3993,44,4050
test4sub58of100,test4pub33of100,10,192,16,2289,43,2348
test4sub24of100,test4pub43of100,10,192,10,595,45,650
test4sub68of100,test4pub41of100,10,191,9,832,44,885
test4sub51of100,test4pub40of100,10,192,11,927,44,982
test4sub57of100,test4pub13of100,10,192,11,4965,44,5020
test4sub44of100,test4pub41of100,10,191,9,836,45,890
test4sub56of100,test4pub26of100,10,192,11,3468,44,3523
test4sub54of100,test4pub21of100,10,192,13,4002,45,4060
test4sub28of100,test4pub45of100,10,191,9,385,48,442
test4sub70of100,test4pub44of100,10,192,10,527,46,583
test4sub4of100,test4pub46of100,10,192,10,201,47,258
test4sub30of100,test4pub19of100,10,192,18,4413,46,4477
test4sub36of100,test4pub33of100,10,192,16,2300,46,2362
test4sub46of100,test4pub36of100,10,192,15,1902,46,1963
test4sub98of100,test4pub41of100,10,191,9,844,46,899
test4sub59of100,test4pub36of100,10,192,15,1903,46,1964
test4sub66of100,test4pub45of100,10,191,9,393,47,449
test4sub6of100,test4pub42of100,10,192,10,715,46,771
test4sub43of100,test4pub41of100,10,191,9,847,47,903
test4sub33of100,test4pub8of100,10,191,17,2491,3049,5557
test4sub52of100,test4pub43of100,10,192,10,613,47,670
test4sub89of100,test4pub32of100,10,192,11,2596,46,2653
test4sub7of100,test4pub39of100,10,192,19,1220,47,1286
test4sub71of100,test4pub37of100,10,192,10,1873,47,1930
test4sub67of100,test4pub46of100,10,192,10,213,48,271
test4sub13of100,test4pub47of100,10,192,10,138,46,194
test4sub22of100,test4pub44of100,10,192,10,542,47,599
test4sub3of100,test4pub44of100,10,192,10,543,47,600
test4sub91of100,test4pub43of100,10,192,10,619,47,676
test4sub47of100,test4pub20of100,10,192,10,4074,47,4131
test4sub26of100,test4pub42of100,10,192,10,725,48,783
test4sub12of100,test4pub34of100,10,192,11,2253,47,2311
test4sub10of100,test4pub10of100,10,192,10,5413,47,5470
test4sub65of100,test4pub37of100,10,192,10,1881,47,1938
test4sub41of100,test4pub39of100,10,192,19,1231,46,1296
test4sub37of100,test4pub43of100,10,192,10,626,46,682
test4sub50of100,test4pub43of100,10,192,10,627,46,683
test4sub14of100,test4pub35of100,10,192,15,1980,46,2041
test4sub76of100,test4pub25of100,10,192,10,3587,45,3642
test4sub88of100,test4pub21of100,10,192,13,4030,45,4088
test4sub100of100,test4pub19of100,10,192,18,4440,44,4502
test4sub78of100,test4pub46of100,10,192,10,229,45,284
test4sub77of100,test4pub38of100,10,192,10,1671,43,1724
test4sub49of100,test4pub43of100,10,192,10,634,43,687
test4sub63of100,test4pub29of100,10,192,11,3010,44,3065
test4sub40of100,test4pub9of100,10,191,16,5468,43,5527
test4sub32of100,test4pub22of100,10,192,10,3946,43,3999
test4sub58of100,test4pub34of100,10,192,11,2269,43,2323
test4sub5of100,test4pub46of100,10,192,10,236,43,289
test4sub24of100,test4pub44of100,10,192,10,564,43,617
test4sub68of100,test4pub42of100,10,192,10,746,42,798
test4sub51of100,test4pub41of100,10,191,9,878,44,931
test4sub57of100,test4pub12of100,10,191,9,5028,42,5079
test4sub87of100,test4pub45of100,10,191,9,426,43,478
test4sub44of100,test4pub42of100,10,192,10,749,42,801
test4sub56of100,test4pub27of100,10,192,13,3205,43,3261
test4sub54of100,test4pub22of100,10,192,10,3955,41,4006
test4sub15of100,test4pub45of100,10,191,9,430,42,481
test4sub48of100,test4pub34of100,10,192,11,2279,42,2332
test4sub70of100,test4pub45of100,10,191,9,433,41,483
test4sub72of100,test4pub44of100,10,192,10,574,41,625
test4sub30of100,test4pub20of100,10,192,10,4106,41,4157
test4sub36of100,test4pub34of100,10,192,11,2284,42,2337
test4sub46of100,test4pub38of100,10,192,10,1691,42,1743
test4sub98of100,test4pub42of100,10,192,10,758,42,810
test4sub59of100,test4pub37of100,10,192,10,1913,44,1967
test4sub6of100,test4pub43of100,10,192,10,658,44,712
test4sub66of100,test4pub46of100,10,192,10,255,44,309
test4sub43of100,test4pub42of100,10,192,10,763,44,817
test4sub33of100,test4pub9of100,10,191,16,5491,44,5551
test4sub52of100,test4pub45of100,10,191,9,444,44,497
test4sub89of100,test4pub33of100,10,192,16,2355,44,2415
test4sub7of100,test4pub40of100,10,192,11,993,45,1049
test4sub71of100,test4pub36of100,10,192,15,1957,45,2017
test4sub67of100,test4pub47of100,10,192,10,185,45,240
test4sub22of100,test4pub43of100,10,192,10,665,44,719
test4sub3of100,test4pub43of100,10,192,10,667,44,721
test4sub91of100,test4pub44of100,10,192,10,591,45,646
test4sub47of100,test4pub21of100,10,192,13,4069,44,4126
test4sub26of100,test4pub43of100,10,192,10,669,44,723
test4sub12of100,test4pub36of100,10,192,15,1965,44,2024
test4sub10of100,test4pub9of100,10,191,16,5503,44,5563
test4sub65of100,test4pub38of100,10,192,10,1709,44,1763
test4sub37of100,test4pub44of100,10,192,10,597,45,652
test4sub14of100,test4pub37of100,10,192,10,1931,44,1985
test4sub76of100,test4pub26of100,10,192,11,3543,45,3599
test4sub88of100,test4pub22of100,10,192,10,3984,44,4038
test4sub100of100,test4pub20of100,10,192,10,4131,45,4186
test4sub77of100,test4pub39of100,10,192,19,1284,44,1347
test4sub49of100,test4pub44of100,10,192,10,603,46,659
test4sub63of100,test4pub30of100,10,191,9,2979,45,3033
test4sub40of100,test4pub8of100,10,191,17,5563,46,5626
test4sub32of100,test4pub23of100,10,192,17,3806,45,3868
test4sub58of100,test4pub35of100,10,192,15,2034,47,2096
test4sub24of100,test4pub45of100,10,191,9,467,46,522
test4sub68of100,test4pub43of100,10,192,10,684,47,741
test4sub51of100,test4pub42of100,10,192,10,790,47,847
test4sub57of100,test4pub14of100,10,192,10,5014,47,5071
test4sub87of100,test4pub46of100,10,192,10,284,47,341
test4sub44of100,test4pub43of100,10,192,10,688,47,745
test4sub54of100,test4pub23of100,10,192,17,3813,46,3876
test4sub56of100,test4pub28of100,10,192,18,3153,47,3218
test4sub15of100,test4pub46of100,10,192,10,288,47,345
test4sub48of100,test4pub35of100,10,192,15,2043,47,2105
test4sub70of100,test4pub46of100,10,192,10,289,46,345
test4sub11of100,test4pub45of100,10,191,9,476,46,531
test4sub72of100,test4pub45of100,10,191,9,477,46,532
test4sub30of100,test4pub21of100,10,192,13,4095,47,4155
test4sub36of100,test4pub35of100,10,192,15,2048,46,2109
test4sub46of100,test4pub39of100,10,192,19,1303,46,1368
test4sub98of100,test4pub43of100,10,192,10,698,47,755
test4sub96of100,test4pub44of100,10,192,10,622,49,681
test4sub86of100,test4pub48of100,10,192,10,164,48,222
test4sub59of100,test4pub38of100,10,192,10,1737,48,1795
test4sub6of100,test4pub44of100,10,192,10,626,47,683
test4sub66of100,test4pub48of100,10,192,10,167,48,225
test4sub43of100,test4pub43of100,10,192,10,704,47,761
test4sub33of100,test4pub10of100,10,192,10,5494,48,5552
test4sub52of100,test4pub47of100,10,192,10,227,49,286
test4sub89of100,test4pub34of100,10,192,11,2337,48,2396
test4sub62of100,test4pub47of100,10,192,10,228,50,288
test4sub7of100,test4pub41of100,10,191,9,944,48,1001
test4sub55of100,test4pub12of100,10,191,9,2087,3055,5151
test4sub71of100,test4pub38of100,10,192,10,1746,50,1806
test4sub22of100,test4pub45of100,10,191,9,494,49,552
test4sub3of100,test4pub45of100,10,191,9,494,49,552
test4sub91of100,test4pub45of100,10,191,9,496,50,555
test4sub47of100,test4pub22of100,10,192,10,4021,50,4081
test4sub26of100,test4pub44of100,10,192,10,638,50,698
test4sub74of100,test4pub47of100,10,192,10,236,49,295
test4sub10of100,test4pub11of100,10,192,11,5387,50,5448
test4sub65of100,test4pub39of100,10,192,19,1324,48,1391
test4sub34of100,test4pub25of100,10,192,10,3676,50,3736
test4sub14of100,test4pub38of100,10,192,10,1757,48,1815
test4sub76of100,test4pub27of100,10,192,13,3279,49,3341
test4sub88of100,test4pub23of100,10,192,17,3846,47,3910
test4sub100of100,test4pub21of100,10,192,13,4122,49,4184
test4sub60of100,test4pub38of100,10,192,10,1760,47,1817
test4sub77of100,test4pub40of100,10,192,11,1054,49,1114
test4sub28of100,test4pub46of100,10,192,10,321,49,380
test4sub85of100,test4pub47of100,10,192,10,246,49,305
test4sub49of100,test4pub45of100,10,191,9,509,49,567
test4sub63of100,test4pub31of100,10,192,19,2783,48,2850
test4sub40of100,test4pub10of100,10,192,10,5518,49,5577
test4sub32of100,test4pub24of100,10,192,15,3769,48,3832
test4sub58of100,test4pub36of100,10,192,15,2024,47,2086
test4sub24of100,test4pub46of100,10,192,10,327,48,385
test4sub67of100,test4pub48of100,10,192,10,195,48,253
test4sub68of100,test4pub44of100,10,192,10,656,48,714
test4sub51of100,test4pub43of100,10,192,10,734,47,791
test4sub57of100,test4pub15of100,10,192,10,4952,48,5010
test4sub44of100,test4pub44of100,10,192,10,660,47,717
test4sub54of100,test4pub24of100,10,192,15,3777,46,3838
test4sub56of100,test4pub29of100,10,192,11,3112,46,3169
test4sub48of100,test4pub36of100,10,192,15,2033,47,2095
test4sub11of100,test4pub46of100,10,192,10,337,46,393
test4sub72of100,test4pub46of100,10,192,10,337,46,393
test4sub70of100,test4pub47of100,10,192,10,262,45,317
test4sub30of100,test4pub22of100,10,192,10,4050,46,4106
test4sub36of100,test4pub36of100,10,192,15,2037,45,2097
test4sub46of100,test4pub40of100,10,192,11,1075,46,1132
test4sub98of100,test4pub44of100,10,192,10,669,46,725
test4sub13of100,test4pub48of100,10,192,10,210,46,266
test4sub78of100,test4pub47of100,10,192,10,268,46,324
test4sub4of100,test4pub47of100,10,192,10,267,46,323
test4sub96of100,test4pub45of100,10,191,9,531,44,584
test4sub59of100,test4pub39of100,10,192,19,1356,45,1420
test4sub6of100,test4pub45of100,10,191,9,533,44,586
test4sub43of100,test4pub44of100,10,192,10,676,43,729
test4sub33of100,test4pub11of100,10,192,11,5424,43,5478
test4sub52of100,test4pub46of100,10,192,10,352,43,405
test4sub89of100,test4pub35of100,10,192,15,2107,43,2165
test4sub7of100,test4pub42of100,10,192,10,861,42,913
test4sub55of100,test4pub14of100,10,192,10,5086,43,5139
test4sub71of100,test4pub39of100,10,192,19,1365,42,1426
test4sub22of100,test4pub47of100,10,192,10,281,43,334
test4sub5of100,test4pub48of100,10,192,10,225,43,278
test4sub3of100,test4pub47of100,10,192,10,283,42,335
test4sub91of100,test4pub46of100,10,192,10,360,41,411
test4sub47of100,test4pub23of100,10,192,17,3888,42,3947
test4sub26of100,test4pub45of100,10,191,9,548,42,599
test4sub10of100,test4pub13of100,10,192,11,5133,41,5185
test4sub65of100,test4pub40of100,10,192,11,1097,43,1151
test4sub34of100,test4pub26of100,10,192,11,3636,41,3688
test4sub76of100,test4pub28of100,10,192,18,3233,42,3293
test4sub88of100,test4pub24of100,10,192,15,3811,42,3868
test4sub34of100,test4pub27of100,10,192,13,3370,22,3405
test4sub65of100,test4pub41of100,10,191,9,1046,23,1078
test4sub76of100,test4pub29of100,10,192,11,3186,2,3199
test4sub10of100,test4pub12of100,10,191,9,5194,26,5229
test4sub26of100,test4pub46of100,10,192,10,405,27,442
test4sub76of100,test4pub30of100,10,191,9,3134,1,3144
test4sub44of100,test4pub45of100,10,191,9,590,29,628
test4sub76of100,test4pub31of100,10,192,19,2893,1,2913
test4sub47of100,test4pub24of100,10,192,15,3848,31,3894
test4sub91of100,test4pub47of100,10,192,10,327,33,370
test4sub76of100,test4pub32of100,10,192,11,2820,1,2832
test4sub3of100,test4pub46of100,10,192,10,401,35,446
test4sub22of100,test4pub46of100,10,192,10,400,38,448
test4sub76of100,test4pub33of100,10,192,16,2534,1,2551
test4sub71of100,test4pub40of100,10,192,11,1133,39,1183
test4sub30of100,test4pub23of100,10,192,17,3913,54,3984
test4sub36of100,test4pub37of100,10,192,10,2047,53,2110
test4sub48of100,test4pub37of100,10,192,10,2043,59,2112
test4sub46of100,test4pub41of100,10,191,9,1027,52,1088
test4sub56of100,test4pub31of100,10,192,19,2841,62,2922
test4sub98of100,test4pub45of100,10,191,9,574,51,634
test4sub54of100,test4pub25of100,10,192,10,3742,64,3816
test4sub4of100,test4pub48of100,10,192,10,257,49,316
test4sub57of100,test4pub16of100,10,192,10,4917,65,4992
test4sub96of100,test4pub46of100,10,192,10,391,49,450
test4sub59of100,test4pub40of100,10,192,11,1125,48,1184
test4sub51of100,test4pub44of100,10,192,10,705,68,783
test4sub6of100,test4pub46of100,10,192,10,392,47,449
test4sub43of100,test4pub45of100,10,191,9,579,46,634
test4sub33of100,test4pub12of100,10,191,9,5182,46,5237
test4sub52of100,test4pub48of100,10,192,10,263,44,317
test4sub32of100,test4pub25of100,10,192,10,3735,74,3819
test4sub89of100,test4pub36of100,10,192,15,2093,43,2151
test4sub7of100,test4pub43of100,10,192,10,801,42,853
test4sub63of100,test4pub32of100,10,192,11,2757,77,2845
test4sub55of100,test4pub15of100,10,192,10,5019,41,5070
test4sub28of100,test4pub47of100,10,192,10,294,80,384
test4sub60of100,test4pub39of100,10,192,19,1378,82,1479
test4sub100of100,test4pub22of100,10,192,10,4079,83,4172
test4sub76of100,test4pub34of100,10,192,11,2472,1,2484
test4sub87of100,test4pub48of100,10,192,10,265,41,316
test4sub34of100,test4pub28of100,10,192,18,3297,25,3340
test4sub77of100,test4pub41of100,10,191,9,1009,80,1098
test4sub49of100,test4pub46of100,10,192,10,372,78,460
test4sub40of100,test4pub11of100,10,192,11,5448,75,5534
test4sub10of100,test4pub14of100,10,192,10,5163,26,5199
test4sub58of100,test4pub37of100,10,192,10,2036,73,2119
test4sub24of100,test4pub47of100,10,192,10,300,72,382
test4sub68of100,test4pub45of100,10,191,9,564,70,643
test4sub26of100,test4pub47of100,10,192,10,357,27,394
test4sub72of100,test4pub47of100,10,192,10,308,58,376
test4sub44of100,test4pub46of100,10,192,10,434,27,471
test4sub70of100,test4pub48of100,10,192,10,252,57,319
test4sub47of100,test4pub25of100,10,192,10,3796,26,3832
test4sub91of100,test4pub48of100,10,192,10,303,28,341
test4sub3of100,test4pub48of100,10,192,10,304,27,341
test4sub22of100,test4pub48of100,10,192,10,305,27,342
test4sub71of100,test4pub41of100,10,191,9,1078,27,1114
test4sub80of100,test4pub44of100,10,192,10,768,26,804
test4sub36of100,test4pub38of100,10,192,10,1882,26,1918
test4sub19of100,test4pub44of100,10,192,10,770,26,806
test4sub88of100,test4pub25of100,10,192,10,3790,42,3842
test4sub65of100,test4pub42of100,10,192,10,938,40,988
test4sub30of100,test4pub24of100,10,192,15,3885,31,3931
test4sub2of100,test4pub40of100,10,192,11,1175,31,1217
test4sub48of100,test4pub38of100,10,192,10,1884,31,1925
test4sub46of100,test4pub42of100,10,192,10,951,31,992
test4sub15of100,test4pub47of100,10,192,10,364,32,406
test4sub56of100,test4pub30of100,10,191,9,3147,35,3191
test4sub98of100,test4pub47of100,10,192,10,369,37,416
test4sub57of100,test4pub17of100,10,192,17,4704,37,4758
test4sub59of100,test4pub41of100,10,191,9,1085,38,1132
test4sub51of100,test4pub45of100,10,191,9,633,38,680
test4sub43of100,test4pub46of100,10,192,10,447,39,496
test4sub61of100,test4pub38of100,10,192,10,1888,40,1938
test4sub33of100,test4pub13of100,10,192,11,5218,41,5270
test4sub89of100,test4pub37of100,10,192,10,2109,40,2159
test4sub32of100,test4pub26of100,10,192,11,3720,42,3773
test4sub7of100,test4pub44of100,10,192,10,777,42,829
test4sub63of100,test4pub33of100,10,192,16,2547,43,2606
test4sub55of100,test4pub16of100,10,192,10,4988,43,5041
test4sub60of100,test4pub40of100,10,192,11,1184,44,1239
test4sub100of100,test4pub23of100,10,192,17,3979,44,4040
test4sub27of100,test4pub42of100,10,192,10,960,44,1014
test4sub11of100,test4pub47of100,10,192,10,378,46,434
test4sub87of100,test4pub47of100,10,192,10,379,45,434
test4sub34of100,test4pub29of100,10,192,11,3233,45,3289
test4sub49of100,test4pub47of100,10,192,10,381,45,436
test4sub76of100,test4pub35of100,10,192,15,2208,47,2270
test4sub40of100,test4pub13of100,10,192,11,5228,45,5284
test4sub10of100,test4pub15of100,10,192,10,5080,45,5135
test4sub58of100,test4pub38of100,10,192,10,1899,46,1955
test4sub68of100,test4pub46of100,10,192,10,460,45,515
test4sub26of100,test4pub48of100,10,192,10,328,45,383
test4sub54of100,test4pub26of100,10,192,11,3716,46,3773
test4sub72of100,test4pub48of100,10,192,10,329,44,383
test4sub77of100,test4pub42of100,10,192,10,963,45,1018
test4sub20of100,test4pub45of100,10,191,9,641,46,696
test4sub47of100,test4pub26of100,10,192,11,3734,46,3791
test4sub44of100,test4pub47of100,10,192,10,386,46,442
test4sub71of100,test4pub42of100,10,192,10,973,45,1028
test4sub80of100,test4pub45of100,10,191,9,653,44,706
test4sub36of100,test4pub39of100,10,192,19,1478,43,1540
test4sub19of100,test4pub45of100,10,191,9,655,44,708
test4sub65of100,test4pub43of100,10,192,10,874,43,927
test4sub88of100,test4pub26of100,10,192,11,3742,44,3797
test4sub37of100,test4pub45of100,10,191,9,658,44,711
test4sub96of100,test4pub47of100,10,192,10,396,44,450
test4sub30of100,test4pub25of100,10,192,10,3835,45,3890
test4sub2of100,test4pub41of100,10,191,9,1113,45,1167
test4sub48of100,test4pub39of100,10,192,19,1485,44,1548
test4sub46of100,test4pub43of100,10,192,10,879,44,933
test4sub86of100,test4pub47of100,10,192,10,400,45,455
test4sub15of100,test4pub48of100,10,192,10,345,44,399
test4sub83of100,test4pub44of100,10,192,10,805,43,858
test4sub66of100,test4pub47of100,10,192,10,403,44,457
test4sub24of100,test4pub48of100,10,192,10,347,44,401
test4sub62of100,test4pub48of100,10,192,10,347,44,401
test4sub56of100,test4pub32of100,10,192,11,2866,43,2920
test4sub74of100,test4pub48of100,10,192,10,348,43,401
test4sub98of100,test4pub46of100,10,192,10,483,42,535
test4sub57of100,test4pub19of100,10,192,18,4694,44,4756
test4sub59of100,test4pub42of100,10,192,10,992,43,1045
test4sub51of100,test4pub46of100,10,192,10,486,43,539
test4sub43of100,test4pub47of100,10,192,10,411,42,463
test4sub33of100,test4pub14of100,10,192,10,5220,41,5271
test4sub89of100,test4pub38of100,10,192,10,1929,42,1981
test4sub28of100,test4pub48of100,10,192,10,357,43,410
test4sub85of100,test4pub48of100,10,192,10,358,43,411
test4sub32of100,test4pub27of100,10,192,13,3454,42,3509
test4sub7of100,test4pub45of100,10,191,9,679,43,731
test4sub63of100,test4pub34of100,10,192,11,2528,42,2581
test4sub55of100,test4pub18of100,10,192,15,4732,42,4789
test4sub60of100,test4pub41of100,10,191,9,1135,42,1186
test4sub100of100,test4pub24of100,10,192,15,3941,42,3998
test4sub50of100,test4pub44of100,10,192,10,825,41,876
test4sub27of100,test4pub43of100,10,192,10,902,44,956
test4sub11of100,test4pub48of100,10,192,10,367,43,420
test4sub34of100,test4pub30of100,10,191,9,3204,43,3256
test4sub76of100,test4pub36of100,10,192,15,2200,42,2257
test4sub40of100,test4pub12of100,10,191,9,5291,44,5344
test4sub10of100,test4pub16of100,10,192,10,5042,44,5096
test4sub58of100,test4pub39of100,10,192,19,1514,45,1578
test4sub68of100,test4pub47of100,10,192,10,430,44,484
test4sub54of100,test4pub27of100,10,192,13,3469,43,3525
test4sub77of100,test4pub44of100,10,192,10,836,44,890
test4sub20of100,test4pub46of100,10,192,10,509,44,563
test4sub47of100,test4pub27of100,10,192,13,3472,44,3529
test4sub44of100,test4pub48of100,10,192,10,378,45,433
test4sub71of100,test4pub43of100,10,192,10,915,43,968
test4sub80of100,test4pub46of100,10,192,10,512,44,566
test4sub36of100,test4pub40of100,10,192,11,1247,45,1303
test4sub19of100,test4pub46of100,10,192,10,514,44,568
test4sub65of100,test4pub44of100,10,192,10,843,44,897
test4sub88of100,test4pub27of100,10,192,13,3478,45,3536
test4sub37of100,test4pub46of100,10,192,10,517,44,571
test4sub96of100,test4pub48of100,10,192,10,384,45,439
test4sub30of100,test4pub26of100,10,192,11,3790,45,3846
test4sub48of100,test4pub40of100,10,192,11,1253,44,1308
test4sub46of100,test4pub44of100,10,192,10,847,45,902
test4sub83of100,test4pub45of100,10,191,9,708,43,760
test4sub56of100,test4pub33of100,10,192,16,2622,43,2681
test4sub98of100,test4pub48of100,10,192,10,393,42,445
test4sub14of100,test4pub39of100,10,192,19,1535,42,1596
test4sub49of100,test4pub48of100,10,192,10,394,42,446
test4sub57of100,test4pub18of100,10,192,15,4765,43,4823
test4sub59of100,test4pub43of100,10,192,10,931,42,983
test4sub51of100,test4pub47of100,10,192,10,454,43,507
test4sub43of100,test4pub48of100,10,192,10,397,42,449
test4sub33of100,test4pub15of100,10,192,10,5153,42,5205
test4sub89of100,test4pub39of100,10,192,19,1541,42,1602
test4sub90of100,test4pub40of100,10,192,11,1266,43,1320
test4sub16of100,test4pub45of100,10,191,9,720,41,770
test4sub32of100,test4pub28of100,10,192,18,3402,41,3461
test4sub7of100,test4pub46of100,10,192,10,536,42,588
test4sub63of100,test4pub36of100,10,192,15,2234,41,2290
test4sub55of100,test4pub17of100,10,192,17,4796,41,4854
test4sub100of100,test4pub25of100,10,192,10,3900,40,3950
test4sub6of100,test4pub47of100,10,192,10,464,40,514
test4sub95of100,test4pub47of100,10,192,10,464,40,514
test4sub23of100,test4pub43of100,10,192,10,944,40,994
test4sub50of100,test4pub45of100,10,191,9,728,40,777
test4sub61of100,test4pub39of100,10,192,19,1551,40,1610
test4sub27of100,test4pub44of100,10,192,10,871,40,921
test4sub34of100,test4pub31of100,10,192,19,3005,39,3063
test4sub42of100,test4pub16of100,10,192,10,2079,3043,5132
test4sub76of100,test4pub37of100,10,192,10,2206,40,2256
test4sub84of100,test4pub27of100,10,192,13,3509,39,3561
test4sub40of100,test4pub14of100,10,192,10,5279,41,5330
test4sub10of100,test4pub17of100,10,192,17,4808,40,4865
test4sub58of100,test4pub40of100,10,192,11,1283,42,1336
test4sub68of100,test4pub48of100,10,192,10,418,40,468
test4sub54of100,test4pub28of100,10,192,18,3419,41,3478
test4sub20of100,test4pub47of100,10,192,10,478,39,527
test4sub77of100,test4pub43of100,10,192,10,956,40,1006
test4sub79of100,test4pub10of100,10,192,10,2740,3046,5796
test4sub47of100,test4pub28of100,10,192,18,3423,40,3481
test4sub71of100,test4pub44of100,10,192,10,884,39,933
test4sub80of100,test4pub47of100,10,192,10,482,39,531
test4sub36of100,test4pub41of100,10,191,9,1198,38,1245
test4sub65of100,test4pub45of100,10,191,9,747,39,795
test4sub88of100,test4pub28of100,10,192,18,3428,40,3486
test4sub37of100,test4pub47of100,10,192,10,487,39,536
test4sub30of100,test4pub27of100,10,192,13,3526,38,3577
test4sub48of100,test4pub41of100,10,191,9,1204,39,1252
test4sub46of100,test4pub45of100,10,191,9,752,40,801
test4sub83of100,test4pub46of100,10,192,10,567,40,617
test4sub56of100,test4pub34of100,10,192,11,2602,41,2654
test4sub14of100,test4pub40of100,10,192,11,1302,41,1354
test4sub60of100,test4pub42of100,10,192,10,1077,42,1129
test4sub57of100,test4pub20of100,10,192,10,4428,40,4478
test4sub59of100,test4pub44of100,10,192,10,898,42,950
test4sub51of100,test4pub48of100,10,192,10,440,41,491
test4sub33of100,test4pub16of100,10,192,10,5111,40,5161
test4sub89of100,test4pub40of100,10,192,11,1308,40,1359
test4sub90of100,test4pub41of100,10,191,9,1215,40,1264
test4sub16of100,test4pub46of100,10,192,10,576,40,626
test4sub32of100,test4pub29of100,10,192,11,3355,41,3407
test4sub7of100,test4pub47of100,10,192,10,502,41,553
test4sub63of100,test4pub35of100,10,192,15,2334,41,2390
test4sub55of100,test4pub19of100,10,192,18,4790,43,4851
test4sub100of100,test4pub26of100,10,192,11,3852,42,3905
test4sub23of100,test4pub44of100,10,192,10,909,43,962
test4sub50of100,test4pub46of100,10,192,10,583,44,637
test4sub61of100,test4pub40of100,10,192,11,1317,44,1372
test4sub27of100,test4pub45of100,10,191,9,770,44,823
test4sub34of100,test4pub32of100,10,192,11,2970,44,3025
test4sub42of100,test4pub17of100,10,192,17,4844,45,4906
test4sub76of100,test4pub38of100,10,192,10,2027,45,2082
test4sub84of100,test4pub28of100,10,192,18,3454,45,3517
test4sub1of100,test4pub43of100,10,192,10,991,46,1047
test4sub9of100,test4pub47of100,10,192,10,513,47,570
test4sub40of100,test4pub15of100,10,192,10,5211,46,5267
test4sub10of100,test4pub18of100,10,192,15,4828,46,4889
test4sub54of100,test4pub29of100,10,192,11,3370,45,3426
test4sub77of100,test4pub45of100,10,191,9,780,44,833
test4sub79of100,test4pub11of100,10,192,11,5669,46,5726
test4sub47of100,test4pub29of100,10,192,11,3373,44,3428
test4sub71of100,test4pub45of100,10,191,9,782,46,837
test4sub36of100,test4pub42of100,10,192,10,1105,44,1159
test4sub41of100,test4pub40of100,10,192,11,1332,45,1388
test4sub29of100,test4pub47of100,10,192,10,523,45,578
test4sub65of100,test4pub46of100,10,192,10,600,44,654
test4sub88of100,test4pub29of100,10,192,11,3379,43,3433
test4sub30of100,test4pub28of100,10,192,18,3470,43,3531
test4sub48of100,test4pub42of100,10,192,10,1111,43,1164
test4sub73of100,test4pub47of100,10,192,10,527,44,581
test4sub6of100,test4pub48of100,10,192,10,472,44,526
test4sub95of100,test4pub48of100,10,192,10,473,44,527
test4sub46of100,test4pub46of100,10,192,10,607,42,659
test4sub83of100,test4pub47of100,10,192,10,532,43,585
test4sub56of100,test4pub35of100,10,192,15,2365,42,2422
test4sub14of100,test4pub41of100,10,191,9,1249,43,1301
test4sub60of100,test4pub43of100,10,192,10,1015,43,1068
test4sub57of100,test4pub21of100,10,192,13,4415,43,4471
test4sub59of100,test4pub45of100,10,191,9,800,44,853
test4sub33of100,test4pub18of100,10,192,15,4852,43,4910
test4sub89of100,test4pub41of100,10,191,9,1255,44,1308
test4sub90of100,test4pub42of100,10,192,10,1124,45,1179
test4sub16of100,test4pub47of100,10,192,10,542,45,597
test4sub32of100,test4pub31of100,10,192,19,3079,45,3143
test4sub7of100,test4pub48of100,10,192,10,486,47,543
test4sub43of100,test4pub49of100,10,192,11,79,46,136
test4sub63of100,test4pub37of100,10,192,10,2281,46,2337
test4sub55of100,test4pub20of100,10,192,10,4480,45,4535
test4sub100of100,test4pub27of100,10,192,13,3585,45,3643
test4sub66of100,test4pub49of100,10,192,11,83,45,139
test4sub74of100,test4pub49of100,10,192,11,84,45,140
test4sub70of100,test4pub49of100,10,192,11,85,45,141
test4sub23of100,test4pub45of100,10,191,9,812,44,865
test4sub50of100,test4pub47of100,10,192,10,552,43,605
test4sub61of100,test4pub41of100,10,191,9,1267,45,1321
test4sub27of100,test4pub47of100,10,192,10,553,43,606
test4sub85of100,test4pub49of100,10,192,11,89,44,144
test4sub34of100,test4pub33of100,10,192,16,2728,43,2787
test4sub42of100,test4pub18of100,10,192,15,4868,42,4925
test4sub84of100,test4pub29of100,10,192,11,3410,42,3463
test4sub76of100,test4pub39of100,10,192,19,1642,44,1705
test4sub26of100,test4pub49of100,10,192,11,93,45,149
test4sub28of100,test4pub49of100,10,192,11,94,45,150
test4sub1of100,test4pub45of100,10,191,9,822,44,875
test4sub40of100,test4pub16of100,10,192,10,5174,44,5228
test4sub10of100,test4pub19of100,10,192,18,4848,44,4910
test4sub54of100,test4pub31of100,10,192,19,3099,43,3161
test4sub77of100,test4pub46of100,10,192,10,640,44,694
test4sub79of100,test4pub12of100,10,191,9,5429,42,5480
test4sub47of100,test4pub30of100,10,191,9,3343,45,3397
test4sub71of100,test4pub46of100,10,192,10,643,43,696
test4sub36of100,test4pub43of100,10,192,10,1046,44,1100
test4sub41of100,test4pub41of100,10,191,9,1284,44,1337
test4sub65of100,test4pub47of100,10,192,10,570,45,625
test4sub88of100,test4pub30of100,10,191,9,3348,44,3401
test4sub30of100,test4pub29of100,10,192,11,3425,44,3480
test4sub48of100,test4pub43of100,10,192,10,1051,45,1106
test4sub73of100,test4pub48of100,10,192,10,516,45,571
test4sub46of100,test4pub47of100,10,192,10,575,45,630
test4sub83of100,test4pub48of100,10,192,10,518,45,573
test4sub62of100,test4pub49of100,10,192,11,111,47,169
test4sub52of100,test4pub49of100,10,192,11,112,46,169
test4sub56of100,test4pub37of100,10,192,10,2313,47,2370
test4sub3of100,test4pub49of100,10,192,11,113,49,173
test4sub14of100,test4pub42of100,10,192,10,1162,48,1220
test4sub60of100,test4pub44of100,10,192,10,983,48,1041
test4sub57of100,test4pub22of100,10,192,10,4368,50,4428
test4sub9of100,test4pub48of100,10,192,10,525,51,586
test4sub59of100,test4pub46of100,10,192,10,658,50,718
test4sub33of100,test4pub17of100,10,192,17,4918,50,4985
test4sub89of100,test4pub42of100,10,192,10,1167,50,1227
test4sub87of100,test4pub49of100,10,192,11,120,50,181
test4sub13of100,test4pub49of100,10,192,11,120,50,181
test4sub16of100,test4pub48of100,10,192,10,530,49,589
test4sub90of100,test4pub43of100,10,192,10,1066,49,1125
test4sub32of100,test4pub30of100,10,191,9,3367,47,3423
test4sub63of100,test4pub38of100,10,192,10,2108,47,2165
test4sub55of100,test4pub21of100,10,192,13,4471,46,4530
test4sub100of100,test4pub28of100,10,192,18,3537,47,3602
test4sub23of100,test4pub46of100,10,192,10,671,45,726
test4sub50of100,test4pub48of100,10,192,10,539,47,596
test4sub61of100,test4pub42of100,10,192,10,1180,46,1236
test4sub34of100,test4pub34of100,10,192,11,2708,46,2765
test4sub42of100,test4pub19of100,10,192,18,4886,47,4951
test4sub29of100,test4pub48of100,10,192,10,543,46,599
test4sub84of100,test4pub30of100,10,191,9,3379,46,3434
test4sub91of100,test4pub49of100,10,192,11,137,47,195
test4sub4of100,test4pub49of100,10,192,11,136,47,194
test4sub76of100,test4pub40of100,10,192,11,1412,47,1470
test4sub1of100,test4pub46of100,10,192,10,680,45,735
test4sub40of100,test4pub17of100,10,192,17,4939,46,5002
test4sub10of100,test4pub20of100,10,192,10,4539,45,4594
test4sub54of100,test4pub30of100,10,191,9,3385,46,3440
test4sub77of100,test4pub47of100,10,192,10,608,46,664
test4sub79of100,test4pub13of100,10,192,11,5455,46,5512
test4sub96of100,test4pub49of100,10,192,11,145,46,202
test4sub47of100,test4pub31of100,10,192,19,3147,45,3211
test4sub36of100,test4pub44of100,10,192,10,1016,44,1070
test4sub41of100,test4pub42of100,10,192,10,1196,45,1251
test4sub65of100,test4pub48of100,10,192,10,558,44,612
test4sub88of100,test4pub31of100,10,192,19,3151,45,3215
test4sub21of100,test4pub42of100,10,192,10,1200,43,1253
test4sub30of100,test4pub30of100,10,191,9,3395,45,3449
test4sub48of100,test4pub44of100,10,192,10,1021,44,1075
test4sub67of100,test4pub49of100,10,192,11,154,45,210
test4sub46of100,test4pub48of100,10,192,10,563,44,617
test4sub49of100,test4pub49of100,10,192,11,155,44,210
test4sub98of100,test4pub49of100,10,192,11,156,45,212
test4sub83of100,test4pub49of100,10,192,11,157,44,212
test4sub95of100,test4pub49of100,10,192,11,159,42,212
test4sub56of100,test4pub36of100,10,192,15,2398,41,2454
test4sub86of100,test4pub49of100,10,192,11,160,42,213
test4sub68of100,test4pub49of100,10,192,11,161,43,215
test4sub14of100,test4pub43of100,10,192,10,1107,41,1158
test4sub66of100,test4pub50of100,10,192,12,85,40,137
test4sub74of100,test4pub50of100,10,192,12,86,41,139
test4sub60of100,test4pub45of100,10,191,9,891,41,941
test4sub24of100,test4pub49of100,10,192,11,166,40,217
test4sub57of100,test4pub23of100,10,192,17,4235,41,4293
test4sub59of100,test4pub47of100,10,192,10,634,40,684
test4sub33of100,test4pub19of100,10,192,18,4921,41,4980
test4sub89of100,test4pub44of100,10,192,10,1039,40,1089
test4sub90of100,test4pub44of100,10,192,10,1040,40,1090
test4sub32of100,test4pub32of100,10,192,11,3099,40,3150
test4sub63of100,test4pub39of100,10,192,19,1724,40,1783
test4sub55of100,test4pub22of100,10,192,10,4427,40,4477
test4sub85of100,test4pub50of100,10,192,12,97,43,152
test4sub100of100,test4pub29of100,10,192,11,3494,42,3547
test4sub23of100,test4pub48of100,10,192,10,584,42,636
test4sub70of100,test4pub50of100,10,192,12,100,43,155
test4sub3of100,test4pub50of100,10,192,12,100,42,154
test4sub50of100,test4pub49of100,10,192,11,179,43,233
test4sub61of100,test4pub43of100,10,192,10,1123,43,1176
test4sub34of100,test4pub36of100,10,192,15,2419,43,2477
test4sub42of100,test4pub20of100,10,192,10,4579,43,4632
test4sub29of100,test4pub49of100,10,192,11,183,44,238
test4sub84of100,test4pub31of100,10,192,19,3184,44,3247
test4sub76of100,test4pub41of100,10,191,9,1365,42,1416
test4sub1of100,test4pub47of100,10,192,10,650,43,703
test4sub40of100,test4pub18of100,10,192,15,4965,44,5024
test4sub10of100,test4pub21of100,10,192,13,4531,43,4587
test4sub52of100,test4pub50of100,10,192,12,110,45,167
test4sub54of100,test4pub32of100,10,192,11,3115,45,3171
test4sub77of100,test4pub48of100,10,192,10,598,43,651
test4sub79of100,test4pub14of100,10,192,10,5462,45,5517
test4sub47of100,test4pub32of100,10,192,11,3118,44,3173
test4sub36of100,test4pub45of100,10,191,9,919,44,972
test4sub65of100,test4pub49of100,10,192,11,194,43,248
test4sub9of100,test4pub49of100,10,192,11,194,45,250
test4sub88of100,test4pub32of100,10,192,11,3122,43,3176
test4sub30of100,test4pub31of100,10,192,19,3198,44,3261
test4sub48of100,test4pub45of100,10,191,9,925,44,978
test4sub11of100,test4pub49of100,10,192,11,199,45,255
test4sub46of100,test4pub49of100,10,192,11,200,44,255
test4sub83of100,test4pub50of100,10,192,12,124,45,181
test4sub56of100,test4pub38of100,10,192,10,2184,45,2239
test4sub14of100,test4pub44of100,10,192,10,1072,43,1125
test4sub60of100,test4pub46of100,10,192,10,747,43,800
test4sub87of100,test4pub50of100,10,192,12,129,43,184
test4sub57of100,test4pub24of100,10,192,15,4193,42,4250
test4sub62of100,test4pub50of100,10,192,12,131,44,187
test4sub59of100,test4pub48of100,10,192,10,617,46,673
test4sub33of100,test4pub20of100,10,192,10,4609,48,4667
test4sub89of100,test4pub43of100,10,192,10,1155,47,1212
test4sub67of100,test4pub50of100,10,192,12,134,48,194
test4sub90of100,test4pub45of100,10,191,9,940,47,996
test4sub32of100,test4pub33of100,10,192,16,2852,48,2916
test4sub63of100,test4pub40of100,10,192,11,1489,48,1548
test4sub55of100,test4pub24of100,10,192,15,4201,47,4263
test4sub96of100,test4pub50of100,10,192,12,139,49,200
test4sub98of100,test4pub50of100,10,192,12,139,48,199
test4sub100of100,test4pub30of100,10,191,9,3462,47,3518
test4sub23of100,test4pub47of100,10,192,10,685,47,742
test4sub24of100,test4pub50of100,10,192,12,143,46,201
test4sub50of100,test4pub50of100,10,192,12,145,45,202
test4sub61of100,test4pub44of100,10,192,10,1091,46,1147
test4sub95of100,test4pub50of100,10,192,12,146,44,202
test4sub34of100,test4pub35of100,10,192,15,2520,45,2580
test4sub42of100,test4pub21of100,10,192,13,4570,44,4627
test4sub74of100,test4pub51of100,10,191,9,59,45,113
test4sub84of100,test4pub32of100,10,192,11,3154,44,3209
test4sub44of100,test4pub49of100,10,192,11,228,43,282
test4sub76of100,test4pub42of100,10,192,10,1277,44,1331
test4sub1of100,test4pub48of100,10,192,10,638,45,693
test4sub40of100,test4pub19of100,10,192,18,4983,44,5045
test4sub10of100,test4pub22of100,10,192,10,4484,44,4538
test4sub26of100,test4pub50of100,10,192,12,154,45,211
test4sub68of100,test4pub51of100,10,191,9,66,46,121
test4sub54of100,test4pub33of100,10,192,16,2872,44,2932
test4sub77of100,test4pub49of100,10,192,11,235,45,291
test4sub79of100,test4pub15of100,10,192,10,5398,44,5452
test4sub47of100,test4pub33of100,10,192,16,2874,44,2934
test4sub36of100,test4pub46of100,10,192,10,778,44,832
test4sub43of100,test4pub50of100,10,192,12,160,44,216
test4sub65of100,test4pub50of100,10,192,12,161,44,217
test4sub9of100,test4pub50of100,10,192,12,162,44,218
test4sub88of100,test4pub33of100,10,192,16,2878,44,2938
test4sub30of100,test4pub32of100,10,192,11,3168,42,3221
test4sub48of100,test4pub46of100,10,192,10,784,44,838
test4sub28of100,test4pub50of100,10,192,12,165,43,220
test4sub11of100,test4pub50of100,10,192,12,167,43,222
test4sub46of100,test4pub50of100,10,192,12,167,42,221
test4sub52of100,test4pub51of100,10,191,9,79,42,130
test4sub56of100,test4pub39of100,10,192,19,1798,40,1857
test4sub14of100,test4pub45of100,10,191,9,976,40,1025
test4sub60of100,test4pub47of100,10,192,10,715,40,765
test4sub57of100,test4pub25of100,10,192,10,4153,39,4202
test4sub3of100,test4pub51of100,10,191,9,86,39,134
test4sub75of100,test4pub33of100,10,192,16,2893,37,2946
test4sub59of100,test4pub49of100,10,192,11,257,36,304
test4sub12of100,test4pub35of100,10,192,15,2554,37,2606
test4sub33of100,test4pub21of100,10,192,13,4603,35,4651
test4sub89of100,test4pub45of100,10,191,9,987,37,1033
test4sub90of100,test4pub46of100,10,192,10,803,35,848
test4sub32of100,test4pub34of100,10,192,11,2837,36,2884
test4sub63of100,test4pub41of100,10,191,9,1444,35,1488
test4sub55of100,test4pub23of100,10,192,17,4332,36,4385
test4sub62of100,test4pub51of100,10,191,9,98,36,143
test4sub100of100,test4pub31of100,10,192,19,3268,36,3323
test4sub23of100,test4pub49of100,10,192,11,267,35,313
test4sub61of100,test4pub45of100,10,191,9,996,35,1040
test4sub34of100,test4pub37of100,10,192,10,2471,34,2515
test4sub42of100,test4pub22of100,10,192,10,4523,38,4571
test4sub84of100,test4pub33of100,10,192,16,2910,37,2963
test4sub44of100,test4pub50of100,10,192,12,195,38,245
test4sub21of100,test4pub43of100,10,192,10,1218,38,1266
test4sub76of100,test4pub43of100,10,192,10,1219,37,1266
test4sub1of100,test4pub49of100,10,192,11,275,39,325
test4sub40of100,test4pub20of100,10,192,10,4674,37,4721
test4sub10of100,test4pub23of100,10,192,17,4345,39,4401
test4sub83of100,test4pub51of100,10,191,9,111,37,157
test4sub54of100,test4pub34of100,10,192,11,2855,37,2903
test4sub79of100,test4pub16of100,10,192,10,5359,36,5405
test4sub47of100,test4pub34of100,10,192,11,2856,37,2904
test4sub36of100,test4pub47of100,10,192,10,748,37,795
test4sub96of100,test4pub51of100,10,191,9,117,37,163
test4sub30of100,test4pub34of100,10,192,11,2861,35,2907
test4sub88of100,test4pub34of100,10,192,11,2860,36,2907
test4sub48of100,test4pub48of100,10,192,10,695,39,744
test4sub11of100,test4pub51of100,10,191,9,121,39,169
test4sub56of100,test4pub40of100,10,192,11,1563,38,1612
test4sub14of100,test4pub46of100,10,192,10,831,38,879
test4sub60of100,test4pub48of100,10,192,10,699,39,748
test4sub57of100,test4pub26of100,10,192,11,4103,41,4155
test4sub75of100,test4pub34of100,10,192,11,2868,40,2919
test4sub59of100,test4pub50of100,10,192,12,216,41,269
test4sub12of100,test4pub37of100,10,192,10,2496,39,2545
test4sub33of100,test4pub22of100,10,192,10,4548,41,4599
test4sub89of100,test4pub46of100,10,192,10,838,39,887
test4sub90of100,test4pub47of100,10,192,10,763,40,813
test4sub32of100,test4pub35of100,10,192,15,2595,38,2648
test4sub63of100,test4pub42of100,10,192,10,1348,40,1398
test4sub55of100,test4pub25of100,10,192,10,4203,38,4251
test4sub24of100,test4pub51of100,10,191,9,135,40,184
test4sub100of100,test4pub32of100,10,192,11,3229,39,3279
test4sub23of100,test4pub50of100,10,192,12,226,39,277
test4sub61of100,test4pub46of100,10,192,10,846,38,894
test4sub70of100,test4pub51of100,10,191,9,139,38,186
test4sub95of100,test4pub51of100,10,191,9,140,38,187
test4sub85of100,test4pub51of100,10,191,9,140,38,187
test4sub34of100,test4pub38of100,10,192,10,2289,38,2337
test4sub67of100,test4pub51of100,10,191,9,141,39,189
test4sub42of100,test4pub23of100,10,192,17,4378,37,4432
test4sub84of100,test4pub34of100,10,192,11,2885,38,2934
test4sub21of100,test4pub44of100,10,192,10,1180,37,1227
test4sub76of100,test4pub44of100,10,192,10,1180,37,1227
test4sub1of100,test4pub50of100,10,192,12,236,37,285
test4sub40of100,test4pub21of100,10,192,13,4659,36,4708
test4sub10of100,test4pub24of100,10,192,15,4301,35,4351
test4sub54of100,test4pub35of100,10,192,15,2613,35,2663
test4sub79of100,test4pub17of100,10,192,17,5117,36,5170
test4sub47of100,test4pub35of100,10,192,15,2615,34,2664
test4sub36of100,test4pub48of100,10,192,10,728,36,774
test4sub30of100,test4pub33of100,10,192,16,2960,34,3010
test4sub88of100,test4pub35of100,10,192,15,2618,34,2667
test4sub44of100,test4pub51of100,10,191,9,156,35,200
test4sub4of100,test4pub50of100,10,192,12,245,35,292
test4sub46of100,test4pub51of100,10,191,9,157,34,200
test4sub77of100,test4pub50of100,10,192,12,247,35,294
test4sub98of100,test4pub51of100,10,191,9,158,35,202
test4sub68of100,test4pub50of100,10,192,12,248,35,295
test4sub48of100,test4pub47of100,10,192,10,791,34,835
test4sub56of100,test4pub41of100,10,191,9,1508,33,1550
test4sub14of100,test4pub47of100,10,192,10,793,34,837
test4sub25of100,test4pub39of100,10,192,19,1879,34,1932
test4sub49of100,test4pub50of100,10,192,12,253,34,299
test4sub60of100,test4pub50of100,10,192,12,253,33,298
test4sub86of100,test4pub50of100,10,192,12,254,35,301
test4sub57of100,test4pub27of100,10,192,13,3836,33,3882
test4sub75of100,test4pub35of100,10,192,15,2630,34,2679
test4sub59of100,test4pub51of100,10,191,9,168,33,210
test4sub12of100,test4pub38of100,10,192,10,2317,33,2360
test4sub89of100,test4pub47of100,10,192,10,802,33,845
test4sub33of100,test4pub23of100,10,192,17,4405,34,4456
test4sub90of100,test4pub48of100,10,192,10,746,34,790
test4sub32of100,test4pub36of100,10,192,15,2577,34,2626
test4sub63of100,test4pub43of100,10,192,10,1284,34,1328
test4sub55of100,test4pub26of100,10,192,11,4152,34,4197
test4sub65of100,test4pub51of100,10,191,9,174,35,218
test4sub100of100,test4pub33of100,10,192,16,2981,34,3031
test4sub23of100,test4pub51of100,10,191,9,176,34,219
test4sub61of100,test4pub47of100,10,192,10,809,33,852
test4sub34of100,test4pub39of100,10,192,19,1896,32,1947
test4sub42of100,test4pub24of100,10,192,15,4333,32,4380
test4sub84of100,test4pub35of100,10,192,15,2644,31,2690
test4sub21of100,test4pub45of100,10,191,9,1077,32,1118
test4sub76of100,test4pub45of100,10,191,9,1077,32,1118
test4sub40of100,test4pub22of100,10,192,10,4603,32,4645
test4sub10of100,test4pub25of100,10,192,10,4254,33,4297
test4sub79of100,test4pub18of100,10,192,15,5132,33,5180
test4sub47of100,test4pub37of100,10,192,10,2556,33,2599
test4sub36of100,test4pub49of100,10,192,11,356,33,400
test4sub30of100,test4pub35of100,10,192,15,2652,33,2700
test4sub88of100,test4pub36of100,10,192,15,2596,34,2645
test4sub4of100,test4pub51of100,10,191,9,192,33,234
test4sub77of100,test4pub51of100,10,191,9,193,33,235
test4sub48of100,test4pub49of100,10,192,11,362,31,404
test4sub56of100,test4pub42of100,10,192,10,1410,30,1450
test4sub14of100,test4pub48of100,10,192,10,772,31,813
test4sub25of100,test4pub40of100,10,192,11,1638,32,1681
test4sub49of100,test4pub51of100,10,191,9,198,31,238
test4sub60of100,test4pub49of100,10,192,11,366,32,409
test4sub86of100,test4pub51of100,10,191,9,200,30,239
test4sub57of100,test4pub28of100,10,192,18,3775,31,3824
test4sub75of100,test4pub36of100,10,192,15,2607,31,2653
test4sub12of100,test4pub39of100,10,192,19,1920,32,1971
test4sub91of100,test4pub50of100,10,192,12,292,32,336
test4sub89of100,test4pub48of100,10,192,10,779,32,821
test4sub33of100,test4pub24of100,10,192,15,4357,32,4404
test4sub90of100,test4pub49of100,10,192,11,373,32,416
test4sub32of100,test4pub37of100,10,192,10,2575,32,2617
test4sub63of100,test4pub44of100,10,192,10,1243,33,1286
test4sub55of100,test4pub27of100,10,192,13,3879,32,3924
test4sub100of100,test4pub34of100,10,192,11,2952,31,2994
test4sub61of100,test4pub48of100,10,192,10,787,32,829
test4sub34of100,test4pub40of100,10,192,11,1653,34,1698
test4sub42of100,test4pub25of100,10,192,10,4282,38,4330
test4sub84of100,test4pub36of100,10,192,15,2619,43,2677
test4sub21of100,test4pub46of100,10,192,10,923,43,976
test4sub76of100,test4pub46of100,10,192,10,924,45,979
test4sub40of100,test4pub23of100,10,192,17,4452,47,4516
test4sub69of100,test4pub35of100,10,192,15,2681,46,2742
test4sub10of100,test4pub26of100,10,192,11,4198,47,4256
test4sub79of100,test4pub19of100,10,192,18,5140,45,5203
test4sub47of100,test4pub36of100,10,192,15,2627,47,2689
test4sub36of100,test4pub51of100,10,191,9,223,47,279
test4sub30of100,test4pub36of100,10,192,15,2629,47,2691
test4sub88of100,test4pub37of100,10,192,10,2593,47,2650
test4sub48of100,test4pub50of100,10,192,12,315,46,373
test4sub56of100,test4pub44of100,10,192,10,1262,46,1318
test4sub14of100,test4pub49of100,10,192,11,395,46,452
test4sub29of100,test4pub50of100,10,192,12,318,45,375
test4sub25of100,test4pub41of100,10,191,9,1576,46,1631
test4sub60of100,test4pub51of100,10,191,9,231,45,285
test4sub57of100,test4pub29of100,10,192,11,3717,44,3772
test4sub13of100,test4pub50of100,10,192,12,322,45,379
test4sub75of100,test4pub37of100,10,192,10,2601,45,2656
test4sub12of100,test4pub40of100,10,192,11,1676,45,1732
test4sub91of100,test4pub51of100,10,191,9,235,44,288
test4sub74of100,test4pub52of100,10,191,9,169,44,222
test4sub89of100,test4pub49of100,10,192,11,404,44,459
test4sub33of100,test4pub25of100,10,192,10,4307,44,4361
test4sub90of100,test4pub50of100,10,192,12,328,42,382
test4sub32of100,test4pub38of100,10,192,10,2387,43,2440
test4sub55of100,test4pub28of100,10,192,18,3816,42,3876
test4sub100of100,test4pub36of100,10,192,15,2648,42,2705
test4sub61of100,test4pub50of100,10,192,12,334,40,386
test4sub34of100,test4pub41of100,10,191,9,1594,39,1642
test4sub18of100,test4pub44of100,10,192,10,1283,39,1332
test4sub70of100,test4pub52of100,10,191,9,181,39,229
test4sub63of100,test4pub45of100,10,191,9,1135,48,1192
test4sub95of100,test4pub52of100,10,191,9,182,39,230
test4sub85of100,test4pub52of100,10,191,9,183,40,232
test4sub23of100,test4pub52of100,10,191,9,184,38,231
test4sub67of100,test4pub52of100,10,191,9,185,37,231
test4sub41of100,test4pub43of100,10,192,10,1365,37,1412
test4sub59of100,test4pub52of100,10,191,9,187,36,232
test4sub42of100,test4pub26of100,10,192,11,4235,36,4282
test4sub84of100,test4pub37of100,10,192,10,2626,34,2670
test4sub21of100,test4pub47of100,10,192,10,891,33,934
test4sub76of100,test4pub47of100,10,192,10,893,32,935
test4sub44of100,test4pub52of100,10,191,9,196,32,237
test4sub46of100,test4pub52of100,10,191,9,197,31,237
test4sub40of100,test4pub24of100,10,192,15,4417,30,4462
test4sub69of100,test4pub36of100,10,192,15,2671,30,2716
test4sub10of100,test4pub27of100,10,192,13,3937,29,3979
test4sub79of100,test4pub20of100,10,192,10,4832,29,4871
test4sub24of100,test4pub52of100,10,191,9,201,30,240
test4sub3of100,test4pub52of100,10,191,9,202,29,240
test4sub47of100,test4pub38of100,10,192,10,2417,30,2457
test4sub36of100,test4pub50of100,10,192,12,360,28,400
test4sub30of100,test4pub37of100,10,192,10,2639,29,2678
test4sub88of100,test4pub38of100,10,192,10,2421,28,2459
test4sub56of100,test4pub43of100,10,192,10,1385,29,1424
test4sub29of100,test4pub51of100,10,191,9,275,27,311
test4sub25of100,test4pub42of100,10,192,10,1491,28,1529
test4sub60of100,test4pub52of100,10,191,9,210,26,245
test4sub57of100,test4pub30of100,10,191,9,3687,27,3723
test4sub13of100,test4pub51of100,10,191,9,279,27,315
test4sub75of100,test4pub38of100,10,192,10,2427,28,2465
test4sub12of100,test4pub41of100,10,191,9,1627,26,1662
test4sub33of100,test4pub26of100,10,192,11,4261,24,4296
test4sub32of100,test4pub39of100,10,192,19,2000,24,2043
test4sub55of100,test4pub29of100,10,192,11,3769,25,3805
test4sub100of100,test4pub35of100,10,192,15,2748,24,2787
test4sub61of100,test4pub49of100,10,192,11,452,24,487
test4sub34of100,test4pub42of100,10,192,10,1502,25,1537
test4sub18of100,test4pub43of100,10,192,10,1398,24,1432
test4sub63of100,test4pub46of100,10,192,10,997,24,1031
test4sub41of100,test4pub44of100,10,192,10,1326,22,1358
test4sub42of100,test4pub27of100,10,192,13,3962,22,3997
test4sub84of100,test4pub38of100,10,192,10,2440,22,2472
test4sub21of100,test4pub48of100,10,192,10,869,22,901
test4sub76of100,test4pub48of100,10,192,10,869,23,902
test4sub40of100,test4pub25of100,10,192,10,4365,21,4396
test4sub10of100,test4pub28of100,10,192,18,3872,20,3910
test4sub79of100,test4pub21of100,10,192,13,4809,22,4844
test4sub47of100,test4pub39of100,10,192,19,2017,20,2056
test4sub36of100,test4pub52of100,10,191,9,233,20,262
test4sub30of100,test4pub38of100,10,192,10,2449,20,2479
test4sub88of100,test4pub39of100,10,192,19,2019,20,2058
test4sub56of100,test4pub45of100,10,191,9,1197,19,1225
test4sub25of100,test4pub43of100,10,192,10,1416,19,1445
test4sub57of100,test4pub31of100,10,192,19,3474,19,3512
test4sub12of100,test4pub42of100,10,192,10,1522,18,1550
test4sub33of100,test4pub27of100,10,192,13,3977,19,4009
test4sub32of100,test4pub40of100,10,192,11,1750,19,1780
test4sub55of100,test4pub30of100,10,191,9,3719,20,3748
test4sub100of100,test4pub37of100,10,192,10,2678,18,2706
test4sub61of100,test4pub51of100,10,191,9,311,20,340
test4sub34of100,test4pub43of100,10,192,10,1423,19,1452
test4sub18of100,test4pub45of100,10,191,9,1206,19,1234
test4sub41of100,test4pub45of100,10,191,9,1208,20,1237
test4sub63of100,test4pub47of100,10,192,10,946,20,976
test4sub42of100,test4pub28of100,10,192,18,3890,19,3927
test4sub84of100,test4pub39of100,10,192,19,2032,21,2072
test4sub21of100,test4pub49of100,10,192,11,484,20,515
test4sub76of100,test4pub49of100,10,192,11,484,22,517
test4sub40of100,test4pub26of100,10,192,11,4297,20,4328
test4sub10of100,test4pub29of100,10,192,11,3804,21,3836
test4sub79of100,test4pub22of100,10,192,10,4739,20,4769
test4sub47of100,test4pub40of100,10,192,11,1761,21,1793
test4sub30of100,test4pub39of100,10,192,19,2039,20,2078
test4sub88of100,test4pub40of100,10,192,11,1764,21,1796
test4sub56of100,test4pub46of100,10,192,10,1032,20,1062
test4sub25of100,test4pub44of100,10,192,10,1359,21,1390
test4sub73of100,test4pub49of100,10,192,11,493,20,524
test4sub57of100,test4pub32of100,10,192,11,3418,21,3450
test4sub12of100,test4pub43of100,10,192,10,1437,21,1468
test4sub33of100,test4pub28of100,10,192,18,3903,22,3943
test4sub32of100,test4pub41of100,10,191,9,1675,21,1705
test4sub55of100,test4pub31of100,10,192,19,3497,23,3539
test4sub100of100,test4pub38of100,10,192,10,2478,23,2511
test4sub72of100,test4pub49of100,10,192,11,498,23,532
test4sub34of100,test4pub44of100,10,192,10,1367,22,1399
test4sub18of100,test4pub46of100,10,192,10,1041,23,1074
test4sub41of100,test4pub46of100,10,192,10,1042,22,1074
test4sub63of100,test4pub48of100,10,192,10,909,23,942
test4sub42of100,test4pub29of100,10,192,11,3821,22,3854
test4sub21of100,test4pub50of100,10,192,12,426,22,460
test4sub84of100,test4pub40of100,10,192,11,1778,22,1811
test4sub76of100,test4pub50of100,10,192,12,428,21,461
test4sub40of100,test4pub27of100,10,192,13,4009,22,4044
test4sub10of100,test4pub30of100,10,191,9,3751,22,3782
test4sub79of100,test4pub23of100,10,192,17,4576,21,4614
test4sub47of100,test4pub41of100,10,191,9,1690,22,1721
test4sub30of100,test4pub40of100,10,192,11,1784,22,1817
test4sub56of100,test4pub47of100,10,192,10,977,21,1008
test4sub88of100,test4pub41of100,10,191,9,1691,22,1722
test4sub25of100,test4pub45of100,10,191,9,1240,21,1270
test4sub73of100,test4pub50of100,10,192,12,436,22,470
test4sub12of100,test4pub44of100,10,192,10,1383,20,1413
test4sub57of100,test4pub33of100,10,192,16,3153,22,3191
test4sub33of100,test4pub29of100,10,192,11,3835,20,3866
test4sub51of100,test4pub49of100,10,192,11,518,22,551
test4sub32of100,test4pub42of100,10,192,10,1567,21,1598
test4sub55of100,test4pub32of100,10,192,11,3446,20,3477
test4sub100of100,test4pub39of100,10,192,19,2070,21,2110
test4sub34of100,test4pub45of100,10,191,9,1249,20,1278
test4sub72of100,test4pub50of100,10,192,12,444,20,476
test4sub18of100,test4pub47of100,10,192,10,989,22,1021
test4sub41of100,test4pub47of100,10,192,10,989,23,1022
test4sub63of100,test4pub49of100,10,192,11,525,21,557
test4sub42of100,test4pub30of100,10,191,9,3769,23,3801
test4sub21of100,test4pub51of100,10,191,9,360,21,390
test4sub84of100,test4pub41of100,10,191,9,1707,23,1739
test4sub76of100,test4pub51of100,10,191,9,362,22,393
test4sub40of100,test4pub28of100,10,192,18,3937,24,3979
test4sub10of100,test4pub31of100,10,192,19,3531,23,3573
test4sub79of100,test4pub24of100,10,192,15,4516,25,4556
test4sub47of100,test4pub42of100,10,192,10,1580,25,1615
test4sub30of100,test4pub41of100,10,191,9,1712,25,1746
test4sub56of100,test4pub48of100,10,192,10,942,25,977
test4sub88of100,test4pub42of100,10,192,10,1582,24,1616
test4sub73of100,test4pub51of100,10,191,9,369,24,402
test4sub12of100,test4pub45of100,10,191,9,1264,25,1298
test4sub57of100,test4pub34of100,10,192,11,3113,23,3147
test4sub33of100,test4pub31of100,10,192,19,3540,25,3584
test4sub51of100,test4pub50of100,10,192,12,462,24,498
test4sub32of100,test4pub43of100,10,192,10,1484,25,1519
test4sub55of100,test4pub33of100,10,192,16,3180,24,3220
test4sub100of100,test4pub40of100,10,192,11,1816,25,1852
test4sub34of100,test4pub46of100,10,192,10,1084,24,1118
test4sub72of100,test4pub51of100,10,191,9,377,25,411
test4sub82of100,test4pub37of100,10,192,10,2746,25,2781
test4sub18of100,test4pub48of100,10,192,10,954,24,988
test4sub4of100,test4pub52of100,10,191,9,312,26,347
test4sub41of100,test4pub48of100,10,192,10,955,24,989
test4sub63of100,test4pub50of100,10,192,12,470,24,506
test4sub42of100,test4pub31of100,10,192,19,3550,24,3593
test4sub21of100,test4pub52of100,10,191,9,316,24,349
test4sub84of100,test4pub42of100,10,192,10,1599,23,1632
test4sub76of100,test4pub52of100,10,191,9,317,23,349
test4sub49of100,test4pub52of100,10,191,9,318,23,350
test4sub40of100,test4pub29of100,10,192,11,3871,22,3904
test4sub10of100,test4pub32of100,10,192,11,3480,22,3513
test4sub80of100,test4pub48of100,10,192,10,963,22,995
test4sub79of100,test4pub25of100,10,192,10,4458,21,4489
test4sub33of100,test4pub30of100,10,191,9,3807,25,3841
test4sub57of100,test4pub36of100,10,192,15,2800,27,2842
test4sub12of100,test4pub46of100,10,192,10,1103,28,1141
test4sub88of100,test4pub43of100,10,192,10,1504,32,1546
test4sub56of100,test4pub49of100,10,192,11,559,33,603
test4sub30of100,test4pub42of100,10,192,10,1606,35,1651
test4sub47of100,test4pub43of100,10,192,10,1502,36,1548
test4sub51of100,test4pub52of100,10,191,9,330,30,369
test4sub32of100,test4pub44of100,10,192,10,1434,30,1474
test4sub55of100,test4pub34of100,10,192,11,3141,31,3183
test4sub100of100,test4pub41of100,10,191,9,1748,30,1787
test4sub34of100,test4pub48of100,10,192,10,976,31,1017
test4sub82of100,test4pub36of100,10,192,15,2808,31,2854
test4sub18of100,test4pub49of100,10,192,11,571,31,613
test4sub41of100,test4pub49of100,10,192,11,572,30,613
test4sub63of100,test4pub51of100,10,191,9,406,30,445
test4sub84of100,test4pub43of100,10,192,10,1519,29,1558
test4sub40of100,test4pub30of100,10,191,9,3820,28,3857
test4sub10of100,test4pub33of100,10,192,16,3215,29,3260
test4sub79of100,test4pub26of100,10,192,11,4402,17,4430
test4sub33of100,test4pub32of100,10,192,11,3516,18,3545
test4sub57of100,test4pub35of100,10,192,15,2887,18,2920
test4sub12of100,test4pub47of100,10,192,10,1057,18,1085
test4sub88of100,test4pub44of100,10,192,10,1461,17,1488
test4sub30of100,test4pub43of100,10,192,10,1538,18,1566
test4sub56of100,test4pub50of100,10,192,12,516,18,546
test4sub47of100,test4pub44of100,10,192,10,1463,18,1491
test4sub80of100,test4pub49of100,10,192,11,596,17,624
test4sub7of100,test4pub49of100,10,192,11,597,17,625
test4sub32of100,test4pub45of100,10,191,9,1325,17,1351
test4sub55of100,test4pub35of100,10,192,15,2894,16,2925
test4sub50of100,test4pub51of100,10,191,9,432,18,459
test4sub100of100,test4pub42of100,10,192,10,1648,17,1675
test4sub34of100,test4pub47of100,10,192,10,1065,17,1092
test4sub82of100,test4pub38of100,10,192,10,2583,16,2609
test4sub18of100,test4pub50of100,10,192,12,524,16,552
test4sub41of100,test4pub50of100,10,192,12,526,16,554
test4sub63of100,test4pub52of100,10,191,9,370,16,395
test4sub84of100,test4pub44of100,10,192,10,1473,15,1498
test4sub40of100,test4pub31of100,10,192,19,3607,15,3641
test4sub10of100,test4pub34of100,10,192,11,3182,15,3208
test4sub79of100,test4pub27of100,10,192,13,4110,15,4138
test4sub33of100,test4pub33of100,10,192,16,3247,15,3278
test4sub57of100,test4pub37of100,10,192,10,2810,16,2836
test4sub12of100,test4pub48of100,10,192,10,1018,15,1043
test4sub88of100,test4pub45of100,10,191,9,1338,16,1363
test4sub30of100,test4pub44of100,10,192,10,1480,16,1506
test4sub47of100,test4pub45of100,10,191,9,1340,15,1364
test4sub80of100,test4pub50of100,10,192,12,536,16,564
test4sub32of100,test4pub46of100,10,192,10,1156,14,1180
test4sub55of100,test4pub37of100,10,192,10,2817,16,2843
test4sub100of100,test4pub43of100,10,192,10,1561,15,1586
test4sub82of100,test4pub40of100,10,192,11,1892,15,1918
test4sub18of100,test4pub51of100,10,191,9,452,15,476
test4sub41of100,test4pub51of100,10,191,9,453,15,477
test4sub84of100,test4pub45of100,10,191,9,1348,16,1373
test4sub40of100,test4pub32of100,10,192,11,3548,16,3575
test4sub79of100,test4pub28of100,10,192,18,4031,16,4065
test4sub10of100,test4pub35of100,10,192,15,2919,16,2950
test4sub33of100,test4pub34of100,10,192,11,3200,17,3228
test4sub57of100,test4pub38of100,10,192,10,2606,16,2632
test4sub12of100,test4pub49of100,10,192,11,627,17,655
test4sub88of100,test4pub46of100,10,192,10,1168,17,1195
test4sub39of100,test4pub40of100,10,192,11,1902,18,1931
test4sub30of100,test4pub45of100,10,191,9,1356,18,1383
test4sub47of100,test4pub46of100,10,192,10,1170,17,1197
test4sub80of100,test4pub51of100,10,191,9,463,18,490
test4sub32of100,test4pub47of100,10,192,10,1096,19,1125
test4sub16of100,test4pub49of100,10,192,11,631,20,662
test4sub55of100,test4pub36of100,10,192,15,2871,20,2906
test4sub100of100,test4pub44of100,10,192,10,1501,20,1531
test4sub82of100,test4pub39of100,10,192,19,2184,19,2222
test4sub18of100,test4pub52of100,10,191,9,401,20,430
test4sub72of100,test4pub52of100,10,191,9,402,19,430
test4sub41of100,test4pub52of100,10,191,9,402,19,430
test4sub40of100,test4pub33of100,10,192,16,3276,17,3309
test4sub84of100,test4pub46of100,10,192,10,1179,17,1206
test4sub79of100,test4pub29of100,10,192,11,3958,18,3987
test4sub10of100,test4pub37of100,10,192,10,2842,18,2870
test4sub5of100,test4pub49of100,10,192,11,641,20,672
test4sub33of100,test4pub35of100,10,192,15,2938,18,2971
test4sub57of100,test4pub39of100,10,192,19,2192,19,2230
test4sub12of100,test4pub50of100,10,192,12,566,19,597
test4sub88of100,test4pub47of100,10,192,10,1109,20,1139
test4sub56of100,test4pub51of100,10,191,9,479,19,507
test4sub39of100,test4pub41of100,10,191,9,1826,19,1854
test4sub30of100,test4pub46of100,10,192,10,1189,18,1217
test4sub51of100,test4pub51of100,10,191,9,481,19,509
test4sub47of100,test4pub47of100,10,192,10,1114,19,1143
test4sub29of100,test4pub52of100,10,191,9,416,18,443
test4sub80of100,test4pub52of100,10,191,9,416,19,444
test4sub32of100,test4pub48of100,10,192,10,1059,18,1087
test4sub16of100,test4pub50of100,10,192,12,574,18,604
test4sub55of100,test4pub38of100,10,192,10,2634,19,2663
test4sub100of100,test4pub45of100,10,191,9,1381,18,1408
test4sub40of100,test4pub34of100,10,192,11,3231,17,3259
test4sub38of100,test4pub40of100,10,192,11,1931,16,1958
test4sub84of100,test4pub48of100,10,192,10,1065,18,1093
test4sub69of100,test4pub38of100,10,192,10,2639,19,2668
test4sub79of100,test4pub31of100,10,192,19,3660,18,3697
test4sub10of100,test4pub36of100,10,192,15,2898,19,2932
test4sub5of100,test4pub51of100,10,191,9,494,18,521
test4sub33of100,test4pub37of100,10,192,10,2862,18,2890
test4sub57of100,test4pub40of100,10,192,11,1937,19,1967
test4sub12of100,test4pub51of100,10,191,9,496,18,523
test4sub88of100,test4pub48of100,10,192,10,1073,19,1102
test4sub39of100,test4pub42of100,10,192,10,1714,17,1741
test4sub30of100,test4pub47of100,10,192,10,1131,18,1159
test4sub47of100,test4pub48of100,10,192,10,1076,17,1103
test4sub20of100,test4pub48of100,10,192,10,1077,18,1105
test4sub32of100,test4pub49of100,10,192,11,670,18,699
test4sub16of100,test4pub51of100,10,191,9,504,19,532
test4sub55of100,test4pub40of100,10,192,11,1947,19,1977
test4sub100of100,test4pub46of100,10,192,10,1214,20,1244
test4sub40of100,test4pub35of100,10,192,15,2970,19,3004
test4sub38of100,test4pub41of100,10,191,9,1854,21,1884
test4sub82of100,test4pub41of100,10,191,9,1855,22,1886
test4sub84of100,test4pub47of100,10,192,10,1142,23,1175
test4sub69of100,test4pub39of100,10,192,19,2227,23,2269
test4sub79of100,test4pub30of100,10,191,9,3922,24,3955
test4sub10of100,test4pub38of100,10,192,10,2660,24,2694
test4sub5of100,test4pub50of100,10,192,12,602,26,640
test4sub33of100,test4pub36of100,10,192,15,2919,27,2961
test4sub57of100,test4pub41of100,10,191,9,1862,27,1898
test4sub12of100,test4pub52of100,10,191,9,448,28,485
test4sub89of100,test4pub50of100,10,192,12,605,28,645
test4sub88of100,test4pub49of100,10,192,11,684,28,723
test4sub47of100,test4pub49of100,10,192,11,685,29,725
test4sub26of100,test4pub51of100,10,191,9,520,28,557
test4sub20of100,test4pub49of100,10,192,11,688,28,727
test4sub30of100,test4pub48of100,10,192,10,1093,29,1132
test4sub32of100,test4pub50of100,10,192,12,612,30,654
test4sub55of100,test4pub39of100,10,192,19,2242,32,2293
test4sub100of100,test4pub47of100,10,192,10,1158,33,1201
test4sub40of100,test4pub36of100,10,192,15,2933,33,2981
test4sub38of100,test4pub42of100,10,192,10,1745,33,1788
test4sub82of100,test4pub42of100,10,192,10,1746,32,1788
test4sub84of100,test4pub49of100,10,192,11,700,31,742
test4sub69of100,test4pub40of100,10,192,11,1976,32,2019
test4sub79of100,test4pub32of100,10,192,11,3629,32,3672
test4sub10of100,test4pub39of100,10,192,19,2255,31,2305
test4sub87of100,test4pub51of100,10,191,9,539,32,580
test4sub33of100,test4pub38of100,10,192,10,2690,29,2729
test4sub57of100,test4pub42of100,10,192,10,1758,27,1795
test4sub88of100,test4pub50of100,10,192,12,635,26,673
test4sub47of100,test4pub50of100,10,192,12,637,24,673
test4sub20of100,test4pub50of100,10,192,12,639,24,675
test4sub30of100,test4pub49of100,10,192,11,719,22,752
test4sub32of100,test4pub51of100,10,191,9,554,22,585
test4sub95of100,test4pub53of100,10,192,10,147,22,179
test4sub3of100,test4pub53of100,10,192,10,147,21,178
test4sub18of100,test4pub53of100,10,192,10,148,21,179
test4sub55of100,test4pub41of100,10,191,9,1904,20,1933
test4sub37of100,test4pub48of100,10,192,10,1133,19,1162
test4sub100of100,test4pub48of100,10,192,10,1135,19,1164
test4sub40of100,test4pub37of100,10,192,10,2930,18,2958
test4sub82of100,test4pub43of100,10,192,10,1675,18,1703
test4sub84of100,test4pub50of100,10,192,12,655,16,683
test4sub69of100,test4pub41of100,10,191,9,1914,15,1938
test4sub79of100,test4pub33of100,10,192,16,3374,14,3404
test4sub10of100,test4pub40of100,10,192,11,2010,15,2036
test4sub33of100,test4pub39of100,10,192,19,2288,13,2320
test4sub57of100,test4pub43of100,10,192,10,1683,15,1708
test4sub88of100,test4pub51of100,10,191,9,573,14,596
test4sub47of100,test4pub51of100,10,191,9,574,15,598
test4sub30of100,test4pub50of100,10,192,12,664,14,690
test4sub20of100,test4pub51of100,10,191,9,575,16,600
test4sub55of100,test4pub42of100,10,192,10,1793,13,1816
test4sub22of100,test4pub49of100,10,192,11,746,13,770
test4sub37of100,test4pub49of100,10,192,11,746,14,771
test4sub100of100,test4pub49of100,10,192,11,747,13,771
test4sub40of100,test4pub38of100,10,192,10,2729,14,2753
test4sub82of100,test4pub44of100,10,192,10,1617,12,1639
test4sub84of100,test4pub51of100,10,191,9,582,14,605
test4sub69of100,test4pub42of100,10,192,10,1799,13,1822
test4sub79of100,test4pub34of100,10,192,11,3326,14,3351
test4sub10of100,test4pub41of100,10,191,9,1932,13,1954
test4sub33of100,test4pub40of100,10,192,11,2027,14,2052
test4sub4of100,test4pub53of100,10,192,10,179,15,204
test4sub57of100,test4pub44of100,10,192,10,1623,14,1647
test4sub88of100,test4pub52of100,10,191,9,521,13,543
test4sub43of100,test4pub51of100,10,191,9,590,13,612
test4sub30of100,test4pub51of100,10,191,9,590,12,611
test4sub20of100,test4pub52of100,10,191,9,524,13,546
test4sub55of100,test4pub43of100,10,192,10,1703,11,1724
test4sub37of100,test4pub50of100,10,192,12,682,11,705
test4sub100of100,test4pub50of100,10,192,12,683,13,708
test4sub40of100,test4pub39of100,10,192,19,2312,12,2343
test4sub82of100,test4pub45of100,10,191,9,1490,13,1512
test4sub84of100,test4pub52of100,10,191,9,530,11,550
test4sub69of100,test4pub43of100,10,192,10,1708,12,1730
test4sub79of100,test4pub35of100,10,192,15,3062,11,3088
test4sub10of100,test4pub42of100,10,192,10,1814,13,1837
test4sub12of100,test4pub53of100,10,192,10,192,11,213
test4sub33of100,test4pub41of100,10,191,9,1948,12,1969
test4sub57of100,test4pub45of100,10,191,9,1496,11,1516
test4sub30of100,test4pub52of100,10,191,9,537,11,557
test4sub55of100,test4pub44of100,10,192,10,1640,11,1661
test4sub37of100,test4pub51of100,10,191,9,605,11,625
test4sub29of100,test4pub53of100,10,192,10,608,2,620
test4sub37of100,test4pub52of100,10,191,9,550,3,562
test4sub91of100,test4pub52of100,10,191,9,935,6,950
test4sub81of100,test4pub18of100,10,192,15,2766,3001,5782
test4sub86of100,test4pub52of100,10,191,9,934,7,950
test4sub15of100,test4pub49of100,10,192,11,1162,7,1180
test4sub53of100,test4pub9of100,10,191,16,4662,2043,6721
test4sub60of100,test4pub53of100,10,192,10,565,10,585
test4sub87of100,test4pub52of100,10,191,9,890,11,910
test4sub21of100,test4pub53of100,10,192,10,543,12,565
test4sub14of100,test4pub50of100,10,192,12,1029,12,1053
test4sub37of100,test4pub54of100,10,192,10,551,13,574
test4sub93of100,test4pub25of100,10,192,10,5001,14,5025
test4sub47of100,test4pub52of100,10,191,9,871,15,895
test4sub8of100,test4pub25of100,10,192,10,4959,18,4987
test4sub6of100,test4pub49of100,10,192,11,1045,19,1075
test4sub94of100,test4pub45of100,10,191,9,1744,21,1774
test4sub16of100,test4pub52of100,10,191,9,548,4,561
test4sub57of100,test4pub46of100,10,192,10,1322,6,1338
test4sub91of100,test4pub53of100,10,192,10,679,22,711
test4sub33of100,test4pub42of100,10,192,10,1828,6,1844
test4sub10of100,test4pub43of100,10,192,10,1723,6,1739
test4sub81of100,test4pub19of100,10,192,18,6007,22,6047
test4sub79of100,test4pub36of100,10,192,15,3016,8,3039
test4sub69of100,test4pub44of100,10,192,10,1645,8,1663
test4sub82of100,test4pub46of100,10,192,10,1317,9,1336
test4sub44of100,test4pub53of100,10,192,10,413,23,446
test4sub40of100,test4pub40of100,10,192,11,2049,10,2070
test4sub25of100,test4pub46of100,10,192,10,1512,24,1546
test4sub55of100,test4pub45of100,10,191,9,1511,3,1523
test4sub100of100,test4pub51of100,10,191,9,608,10,627
test4sub39of100,test4pub43of100,10,192,10,1717,10,1737
test4sub22of100,test4pub50of100,10,192,12,934,22,968
test4sub84of100,test4pub53of100,10,192,10,512,20,542
test4sub72of100,test4pub53of100,10,192,10,509,17,536
test4sub61of100,test4pub52of100,10,191,9,933,7,949
test4sub15of100,test4pub50of100,10,192,12,1179,29,1220
test4sub74of100,test4pub53of100,10,192,10,373,29,412
test4sub53of100,test4pub8of100,10,191,17,7084,30,7131
test4sub12of100,test4pub54of100,10,192,10,226,30,266
test4sub43of100,test4pub52of100,10,191,9,687,30,726
test4sub63of100,test4pub53of100,10,192,10,340,30,380
test4sub13of100,test4pub52of100,10,191,9,675,31,715
test4sub60of100,test4pub54of100,10,192,10,560,31,601
test4sub18of100,test4pub54of100,10,192,10,209,32,251
test4sub24of100,test4pub53of100,10,192,10,332,32,374
test4sub7of100,test4pub51of100,10,191,9,739,32,780
test4sub87of100,test4pub53of100,10,192,10,686,32,728
test4sub68of100,test4pub52of100,10,191,9,669,32,710
test4sub26of100,test4pub52of100,10,191,9,659,32,700
test4sub89of100,test4pub51of100,10,191,9,723,33,765
test4sub49of100,test4pub53of100,10,192,10,313,33,356
test4sub14of100,test4pub51of100,10,191,9,1096,34,1139
test4sub59of100,test4pub53of100,10,192,10,309,34,353
test4sub67of100,test4pub53of100,10,192,10,306,35,351
test4sub88of100,test4pub53of100,10,192,10,292,35,337
test4sub37of100,test4pub53of100,10,192,10,690,36,736
test4sub36of100,test4pub53of100,10,192,10,285,35,330
test4sub32of100,test4pub52of100,10,191,9,622,36,667
test4sub38of100,test4pub43of100,10,192,10,1793,35,1838
test4sub85of100,test4pub53of100,10,192,10,272,36,318
test4sub83of100,test4pub52of100,10,191,9,612,36,657
test4sub51of100,test4pub53of100,10,192,10,269,36,315
test4sub23of100,test4pub53of100,10,192,10,268,38,316
test4sub56of100,test4pub52of100,10,191,9,607,37,653
test4sub28of100,test4pub51of100,10,191,9,673,38,720
test4sub98of100,test4pub52of100,10,191,9,605,38,652
test4sub66of100,test4pub51of100,10,191,9,663,38,710
test4sub71of100,test4pub47of100,10,192,10,1292,39,1341
test4sub5of100,test4pub52of100,10,191,9,589,39,637
test4sub17of100,test4pub40of100,10,192,11,2097,40,2148
test4sub52of100,test4pub52of100,10,191,9,586,39,634
test4sub8of100,test4pub26of100,10,192,11,5084,41,5136
test4sub75of100,test4pub39of100,10,192,19,2369,41,2429
test4sub30of100,test4pub53of100,10,192,10,243,41,294
test4sub65of100,test4pub52of100,10,191,9,580,41,630
test4sub6of100,test4pub51of100,10,191,9,1107,42,1158
test4sub70of100,test4pub53of100,10,192,10,213,42,265
test4sub57of100,test4pub47of100,10,192,10,1740,42,1792
test4sub91of100,test4pub54of100,10,192,10,576,42,628
test4sub33of100,test4pub43of100,10,192,10,2220,42,2272
test4sub10of100,test4pub44of100,10,192,10,2145,41,2196
test4sub81of100,test4pub20of100,10,192,10,5676,41,5727
test4sub69of100,test4pub45of100,10,191,9,2006,42,2057
test4sub82of100,test4pub47of100,10,192,10,1744,42,1796
test4sub44of100,test4pub54of100,10,192,10,580,42,632
test4sub40of100,test4pub41of100,10,191,9,2460,42,2511
test4sub48of100,test4pub51of100,10,191,9,618,43,670
test4sub25of100,test4pub47of100,10,192,10,1746,43,1799
test4sub100of100,test4pub52of100,10,191,9,1048,42,1099
test4sub55of100,test4pub46of100,10,192,10,1823,43,1876
test4sub79of100,test4pub37of100,10,192,10,3479,44,3533
test4sub39of100,test4pub44of100,10,192,10,2151,45,2206
test4sub22of100,test4pub51of100,10,191,9,1117,45,1171
test4sub94of100,test4pub46of100,10,192,10,1816,45,1871
test4sub93of100,test4pub26of100,10,192,11,5078,45,5134
test4sub61of100,test4pub53of100,10,192,10,710,46,766
test4sub15of100,test4pub51of100,10,191,9,1119,45,1173
test4sub53of100,test4pub10of100,10,192,10,7022,44,7076
test4sub74of100,test4pub54of100,10,192,10,588,46,644
test4sub43of100,test4pub53of100,10,192,10,714,44,768
test4sub63of100,test4pub54of100,10,192,10,590,45,645
test4sub13of100,test4pub53of100,10,192,10,716,43,769
test4sub60of100,test4pub55of100,10,192,18,258,44,320
test4sub24of100,test4pub54of100,10,192,10,593,44,647
test4sub7of100,test4pub50of100,10,192,12,1215,43,1270
test4sub68of100,test4pub53of100,10,192,10,720,42,772
test4sub26of100,test4pub53of100,10,192,10,720,42,772
test4sub89of100,test4pub52of100,10,191,9,1062,42,1113
test4sub49of100,test4pub54of100,10,192,10,597,43,650
test4sub14of100,test4pub52of100,10,191,9,1064,42,1115
test4sub59of100,test4pub54of100,10,192,10,599,43,652
test4sub67of100,test4pub54of100,10,192,10,600,43,653
test4sub88of100,test4pub54of100,10,192,10,600,42,652
test4sub32of100,test4pub53of100,10,192,10,727,40,777
test4sub38of100,test4pub44of100,10,192,10,2170,41,2221
test4sub83of100,test4pub53of100,10,192,10,729,40,779
test4sub51of100,test4pub54of100,10,192,10,604,41,655
test4sub23of100,test4pub54of100,10,192,10,606,40,656
test4sub56of100,test4pub53of100,10,192,10,731,41,782
test4sub28of100,test4pub52of100,10,191,9,1073,39,1121
test4sub66of100,test4pub52of100,10,191,9,1074,39,1122
test4sub71of100,test4pub48of100,10,192,10,1718,39,1767
test4sub5of100,test4pub53of100,10,192,10,735,39,784
test4sub17of100,test4pub41of100,10,191,9,2491,38,2538
test4sub52of100,test4pub53of100,10,192,10,737,40,787
test4sub8of100,test4pub27of100,10,192,13,4816,38,4867
test4sub75of100,test4pub40of100,10,192,11,2587,39,2637
test4sub30of100,test4pub54of100,10,192,10,615,38,663
test4sub65of100,test4pub53of100,10,192,10,740,39,789
test4sub6of100,test4pub50of100,10,192,12,1238,38,1288
test4sub70of100,test4pub54of100,10,192,10,617,39,666
test4sub57of100,test4pub48of100,10,192,10,1726,39,1775
test4sub33of100,test4pub44of100,10,192,10,2187,40,2237
test4sub10of100,test4pub45of100,10,191,9,2046,39,2094
test4sub31of100,test4pub1of100,10,1469,25,684,9058,9767
test4sub96of100,test4pub52of100,10,191,9,1870,3,1882
test4sub64of100,test4pub1of100,10,1469,25,501,9049,9575
test4sub31of100,test4pub2of100,10,191,18,9829,4,9851
test4sub2of100,test4pub42of100,10,192,10,3009,5,3024
test4sub78of100,test4pub48of100,10,192,10,2302,8,2320
test4sub54of100,test4pub36of100,10,192,15,4094,9,4118
test4sub50of100,test4pub52of100,10,191,9,1617,11,1637
test4sub96of100,test4pub53of100,10,192,10,1546,11,1567
test4sub60of100,test4pub56of100,10,192,10,692,12,714
test4sub31of100,test4pub4of100,10,191,11,8888,11,8910
test4sub43of100,test4pub54of100,10,192,10,1140,15,1165
test4sub92of100,test4pub22of100,10,192,10,6079,15,6104
test4sub64of100,test4pub2of100,10,191,18,9834,15,9867
test4sub36of100,test4pub54of100,10,192,10,658,12,680
test4sub9of100,test4pub51of100,10,191,9,1632,16,1657
test4sub16of100,test4pub53of100,10,192,10,1120,16,1146
test4sub57of100,test4pub49of100,10,192,11,1357,12,1380
test4sub70of100,test4pub55of100,10,192,18,324,13,355
test4sub6of100,test4pub52of100,10,191,9,1121,14,1144
test4sub2of100,test4pub43of100,10,192,10,3069,18,3097
test4sub65of100,test4pub54of100,10,192,10,655,14,679
test4sub29of100,test4pub54of100,10,192,10,971,17,998
test4sub75of100,test4pub41of100,10,191,9,2533,15,2557
test4sub8of100,test4pub28of100,10,192,18,4760,16,4794
test4sub90of100,test4pub51of100,10,191,9,1516,19,1544
test4sub52of100,test4pub54of100,10,192,10,652,17,679
test4sub17of100,test4pub42of100,10,192,10,2399,17,2426
test4sub91of100,test4pub55of100,10,192,18,636,21,675
test4sub5of100,test4pub54of100,10,192,10,650,17,677
test4sub86of100,test4pub54of100,10,192,10,839,20,869
test4sub71of100,test4pub50of100,10,192,12,1271,18,1301
test4sub61of100,test4pub54of100,10,192,10,829,21,860
test4sub66of100,test4pub53of100,10,192,10,774,19,803
test4sub28of100,test4pub53of100,10,192,10,772,19,801
test4sub56of100,test4pub54of100,10,192,10,647,19,676
test4sub83of100,test4pub54of100,10,192,10,646,21,677
test4sub38of100,test4pub45of100,10,191,9,2071,21,2101
test4sub32of100,test4pub54of100,10,192,10,644,22,676
test4sub67of100,test4pub55of100,10,192,18,310,23,351
test4sub14of100,test4pub53of100,10,192,10,766,25,801
test4sub3of100,test4pub54of100,10,192,10,641,24,675
test4sub97of100,test4pub25of100,10,192,10,5420,25,5455
test4sub89of100,test4pub53of100,10,192,10,764,25,799
test4sub4of100,test4pub54of100,10,192,10,814,25,849
test4sub26of100,test4pub54of100,10,192,10,639,26,675
test4sub68of100,test4pub54of100,10,192,10,638,27,675
test4sub87of100,test4pub54of100,10,192,10,813,26,849
test4sub7of100,test4pub52of100,10,191,9,1103,26,1138
test4sub13of100,test4pub54of100,10,192,10,635,28,673
test4sub88of100,test4pub55of100,10,192,18,477,27,522
test4sub63of100,test4pub55of100,10,192,18,302,28,348
test4sub53of100,test4pub11of100,10,192,11,6948,30,6989
test4sub54of100,test4pub37of100,10,192,10,4330,27,4367
test4sub15of100,test4pub52of100,10,191,9,1098,30,1137
test4sub35of100,test4pub8of100,10,191,17,7333,27,7377
test4sub93of100,test4pub27of100,10,192,13,4834,32,4879
test4sub94of100,test4pub47of100,10,192,10,1795,32,1837
test4sub22of100,test4pub52of100,10,191,9,1095,33,1137
test4sub73of100,test4pub52of100,10,191,9,1253,28,1290
test4sub39of100,test4pub45of100,10,191,9,2056,33,2098
test4sub79of100,test4pub38of100,10,192,10,3308,34,3352
test4sub100of100,test4pub53of100,10,192,10,750,35,795
test4sub84of100,test4pub54of100,10,192,10,786,30,826
test4sub25of100,test4pub48of100,10,192,10,1733,35,1778
test4sub48of100,test4pub52of100,10,191,9,1090,37,1136
test4sub50of100,test4pub53of100,10,192,10,1556,33,1599
test4sub40of100,test4pub42of100,10,192,10,2371,36,2417
test4sub82of100,test4pub48of100,10,192,10,1730,37,1777
test4sub69of100,test4pub46of100,10,192,10,1862,39,1911
test4sub44of100,test4pub55of100,10,192,18,452,36,506
test4sub81of100,test4pub21of100,10,192,13,5665,39,5717
test4sub30of100,test4pub55of100,10,192,18,447,38,503
test4sub12of100,test4pub55of100,10,192,18,446,37,501
test4sub55of100,test4pub48of100,10,192,10,1735,35,1780
test4sub47of100,test4pub53of100,10,192,10,923,29,962
test4sub96of100,test4pub54of100,10,192,10,1433,39,1482
test4sub21of100,test4pub54of100,10,192,10,805,28,843
test4sub18of100,test4pub55of100,10,192,18,396,42,456
test4sub78of100,test4pub49of100,10,192,11,2128,26,2165
test4sub46of100,test4pub53of100,10,192,10,851,44,905
test4sub98of100,test4pub53of100,10,192,10,1227,16,1253
test4sub11of100,test4pub52of100,10,191,9,1810,4,1823
test4sub80of100,test4pub53of100,10,192,10,1505,4,1519
test4sub10of100,test4pub46of100,10,192,10,2658,3,2671
test4sub23of100,test4pub55of100,10,192,18,388,46,452
test4sub31of100,test4pub3of100,10,191,10,9692,46,9748
test4sub72of100,test4pub54of100,10,192,10,720,47,777
test4sub51of100,test4pub55of100,10,192,18,387,46,451
test4sub74of100,test4pub55of100,10,192,18,385,48,451
test4sub85of100,test4pub54of100,10,192,10,710,47,767
test4sub92of100,test4pub23of100,10,192,17,6205,48,6270
test4sub58of100,test4pub41of100,10,191,9,2587,48,2644
test4sub24of100,test4pub55of100,10,192,18,373,49,440
test4sub64of100,test4pub4of100,10,191,11,8904,49,8964
test4sub49of100,test4pub55of100,10,192,18,364,49,431
test4sub59of100,test4pub55of100,10,192,18,345,50,413
test4sub36of100,test4pub55of100,10,192,18,1108,49,1175
test4sub16of100,test4pub54of100,10,192,10,1441,50,1501
test4sub70of100,test4pub56of100,10,192,10,1009,50,1069
test4sub65of100,test4pub55of100,10,192,18,1110,49,1177
test4sub75of100,test4pub42of100,10,192,10,3192,49,3251
test4sub29of100,test4pub55of100,10,192,18,1111,50,1179
test4sub8of100,test4pub29of100,10,192,11,5463,50,5524
test4sub90of100,test4pub52of100,10,191,9,1911,49,1969
test4sub52of100,test4pub55of100,10,192,18,1113,51,1182
test4sub17of100,test4pub43of100,10,192,10,3090,50,3150
test4sub5of100,test4pub55of100,10,192,18,1114,50,1182
test4sub71of100,test4pub49of100,10,192,11,2148,49,2208
test4sub61of100,test4pub55of100,10,192,18,1116,51,1185
test4sub66of100,test4pub54of100,10,192,10,1450,50,1510
test4sub56of100,test4pub55of100,10,192,18,1117,49,1184
test4sub32of100,test4pub55of100,10,192,18,1118,42,1178
test4sub73of100,test4pub53of100,10,192,10,1585,42,1637
test4sub22of100,test4pub53of100,10,192,10,1584,43,1637
test4sub94of100,test4pub48of100,10,192,10,2566,44,2620
test4sub93of100,test4pub28of100,10,192,18,5566,43,5627
test4sub35of100,test4pub10of100,10,192,10,7891,45,7946
test4sub15of100,test4pub53of100,10,192,10,1582,45,1637
test4sub53of100,test4pub13of100,10,192,11,7468,46,7525
test4sub63of100,test4pub56of100,10,192,10,1023,47,1080
test4sub13of100,test4pub55of100,10,192,18,1122,46,1186
test4sub7of100,test4pub53of100,10,192,10,1580,47,1637
test4sub87of100,test4pub55of100,10,192,18,1122,48,1188
test4sub68of100,test4pub55of100,10,192,18,1121,49,1188
test4sub26of100,test4pub55of100,10,192,18,1121,49,1188
test4sub89of100,test4pub54of100,10,192,10,1453,49,1512
test4sub79of100,test4pub39of100,10,192,19,3713,51,3783
test4sub3of100,test4pub55of100,10,192,18,1120,50,1188
test4sub84of100,test4pub55of100,10,192,18,1131,51,1200
test4sub25of100,test4pub49of100,10,192,11,2164,51,2226
test4sub67of100,test4pub56of100,10,192,10,1018,51,1079
test4sub25of100,test4pub50of100,10,192,12,2138,20,2170
test4sub84of100,test4pub56of100,10,192,10,1083,20,1113
test4sub3of100,test4pub56of100,10,192,10,1081,21,1112
test4sub79of100,test4pub40of100,10,192,11,3488,21,3520
test4sub89of100,test4pub55of100,10,192,18,1180,22,1220
test4sub26of100,test4pub56of100,10,192,10,1079,22,1111
test4sub68of100,test4pub56of100,10,192,10,1078,24,1112
test4sub87of100,test4pub56of100,10,192,10,1078,24,1112
test4sub7of100,test4pub54of100,10,192,10,1509,24,1543
test4sub13of100,test4pub56of100,10,192,10,1076,25,1111
test4sub53of100,test4pub14of100,10,192,10,7480,26,7516
test4sub15of100,test4pub54of100,10,192,10,1506,27,1543
test4sub35of100,test4pub11of100,10,192,11,7821,26,7858
test4sub93of100,test4pub29of100,10,192,11,5523,28,5562
test4sub94of100,test4pub49of100,10,192,11,2204,27,2242
test4sub22of100,test4pub54of100,10,192,10,1503,29,1542
test4sub73of100,test4pub54of100,10,192,10,1502,29,1541
test4sub56of100,test4pub56of100,10,192,10,1068,30,1108
test4sub66of100,test4pub55of100,10,192,18,1167,30,1215
test4sub71of100,test4pub51of100,10,191,9,2032,32,2073
test4sub5of100,test4pub56of100,10,192,10,1065,32,1107
test4sub17of100,test4pub44of100,10,192,10,3065,32,3107
test4sub52of100,test4pub56of100,10,192,10,1064,33,1107
test4sub90of100,test4pub53of100,10,192,10,1620,34,1664
test4sub8of100,test4pub30of100,10,191,9,5438,33,5480
test4sub29of100,test4pub56of100,10,192,10,1061,35,1106
test4sub75of100,test4pub43of100,10,192,10,3138,35,3183
test4sub16of100,test4pub55of100,10,192,18,1159,36,1213
test4sub36of100,test4pub56of100,10,192,10,1058,37,1105
test4sub59of100,test4pub56of100,10,192,10,1057,37,1104
test4sub49of100,test4pub56of100,10,192,10,1056,39,1105
test4sub64of100,test4pub3of100,10,191,10,9746,39,9795
test4sub58of100,test4pub42of100,10,192,10,3235,40,3285
test4sub92of100,test4pub24of100,10,192,15,6171,40,6226
test4sub74of100,test4pub56of100,10,192,10,1052,41,1103
test4sub51of100,test4pub56of100,10,192,10,1051,43,1104
test4sub72of100,test4pub55of100,10,192,18,1150,42,1210
test4sub23of100,test4pub56of100,10,192,10,1049,44,1103
test4sub10of100,test4pub47of100,10,192,10,2645,45,2700
test4sub46of100,test4pub54of100,10,192,10,1478,46,1534
test4sub6of100,test4pub53of100,10,192,10,1568,47,1625
test4sub2of100,test4pub44of100,10,192,10,3011,47,3068
test4sub91of100,test4pub56of100,10,192,10,1014,48,1072
test4sub86of100,test4pub53of100,10,192,10,1573,47,1630
test4sub28of100,test4pub54of100,10,192,10,1450,48,1508
test4sub38of100,test4pub46of100,10,192,10,2692,48,2750
test4sub97of100,test4pub26of100,10,192,11,5965,47,6023
test4sub78of100,test4pub50of100,10,192,12,2097,48,2157
test4sub18of100,test4pub56of100,10,192,10,1042,48,1100
test4sub54of100,test4pub38of100,10,192,10,4138,48,4196
test4sub21of100,test4pub55of100,10,192,18,1141,48,1207
test4sub47of100,test4pub54of100,10,192,10,1473,48,1531
test4sub96of100,test4pub55of100,10,192,18,1140,49,1207
test4sub39of100,test4pub46of100,10,192,10,2701,49,2760
test4sub100of100,test4pub54of100,10,192,10,1464,49,1523
test4sub48of100,test4pub53of100,10,192,10,1590,50,1650
test4sub12of100,test4pub56of100,10,192,10,1038,49,1097
test4sub37of100,test4pub55of100,10,192,18,1133,49,1200
test4sub81of100,test4pub22of100,10,192,10,6420,50,6480
test4sub33of100,test4pub45of100,10,191,9,2086,50,2145
test4sub95of100,test4pub54of100,10,192,10,659,50,719
test4sub44of100,test4pub56of100,10,192,10,1035,50,1095
test4sub69of100,test4pub47of100,10,192,10,2632,50,2692
test4sub40of100,test4pub43of100,10,192,10,3111,51,3172
test4sub82of100,test4pub49of100,10,192,11,2167,51,2229
test4sub14of100,test4pub54of100,10,192,10,1452,51,1513
test4sub50of100,test4pub54of100,10,192,10,1465,51,1526
test4sub99of100,test4pub29of100,10,192,11,5919,240,6170
test4sub67of100,test4pub57of100,10,192,10,1152,240,1402
test4sub88of100,test4pub56of100,10,192,10,1399,241,1650
test4sub61of100,test4pub56of100,10,192,10,1369,241,1620
test4sub27of100,test4pub46of100,10,192,10,3031,242,3283
test4sub24of100,test4pub56of100,10,192,10,1337,241,1588
test4sub85of100,test4pub55of100,10,192,18,1435,242,1695
test4sub4of100,test4pub55of100,10,192,18,1427,243,1688
test4sub32of100,test4pub56of100,10,192,10,1325,244,1579
test4sub65of100,test4pub56of100,10,192,10,1321,243,1574
test4sub41of100,test4pub53of100,10,192,10,1866,245,2121
test4sub62of100,test4pub52of100,10,191,9,2148,245,2402
test4sub30of100,test4pub56of100,10,192,10,1160,246,1416
test4sub77of100,test4pub52of100,10,191,9,2057,245,2311
test4sub43of100,test4pub55of100,10,192,18,1237,247,1502
test4sub70of100,test4pub57of100,10,192,10,680,247,937
test4sub83of100,test4pub55of100,10,192,18,1232,247,1497
test4sub60of100,test4pub57of100,10,192,10,658,248,916
test4sub25of100,test4pub51of100,10,191,9,2578,248,2835
test4sub84of100,test4pub57of100,10,192,10,1159,248,1417
test4sub79of100,test4pub41of100,10,191,9,3926,249,4184
test4sub89of100,test4pub56of100,10,192,10,1614,249,1873
test4sub26of100,test4pub57of100,10,192,10,1160,249,1419
test4sub87of100,test4pub57of100,10,192,10,1161,248,1419
test4sub7of100,test4pub55of100,10,192,18,1715,250,1983
test4sub13of100,test4pub57of100,10,192,10,1162,249,1421
test4sub53of100,test4pub12of100,10,191,9,8078,250,8337
test4sub15of100,test4pub55of100,10,192,18,1717,251,1986
test4sub93of100,test4pub31of100,10,192,19,5751,251,6021
test4sub94of100,test4pub50of100,10,192,12,2673,252,2937
test4sub22of100,test4pub55of100,10,192,18,1718,252,1988
test4sub9of100,test4pub52of100,10,191,9,1998,253,2260
test4sub73of100,test4pub55of100,10,192,18,1719,253,1990
test4sub56of100,test4pub57of100,10,192,10,1166,253,1429
test4sub66of100,test4pub56of100,10,192,10,1620,254,1884
test4sub52of100,test4pub57of100,10,192,10,1168,253,1431
test4sub8of100,test4pub31of100,10,192,19,5756,254,6029
test4sub17of100,test4pub45of100,10,191,9,3481,255,3745
test4sub5of100,test4pub57of100,10,192,10,1167,254,1431
test4sub16of100,test4pub56of100,10,192,10,1623,254,1887
test4sub49of100,test4pub57of100,10,192,10,1170,254,1434
test4sub92of100,test4pub25of100,10,192,10,6660,255,6925
test4sub58of100,test4pub43of100,10,192,10,3702,254,3966
test4sub23of100,test4pub57of100,10,192,10,1172,255,1437
test4sub72of100,test4pub56of100,10,192,10,1626,255,1891
test4sub10of100,test4pub48of100,10,192,10,3168,255,3433
test4sub6of100,test4pub54of100,10,192,10,2061,255,2326
test4sub2of100,test4pub45of100,10,191,9,3488,256,3753
test4sub86of100,test4pub55of100,10,192,18,1729,256,2003
test4sub28of100,test4pub55of100,10,192,18,1730,256,2004
test4sub97of100,test4pub27of100,10,192,13,6266,257,6536
test4sub63of100,test4pub57of100,10,192,10,635,256,901
test4sub54of100,test4pub39of100,10,192,19,4314,256,4589
test4sub47of100,test4pub55of100,10,192,18,1732,257,2007
test4sub39of100,test4pub47of100,10,192,10,3230,257,3497
test4sub48of100,test4pub54of100,10,192,10,2066,257,2333
test4sub100of100,test4pub55of100,10,192,18,1733,258,2009
test4sub37of100,test4pub56of100,10,192,10,1634,257,1901
test4sub33of100,test4pub46of100,10,192,10,3309,258,3577
test4sub20of100,test4pub53of100,10,192,10,1645,258,1913
test4sub95of100,test4pub55of100,10,192,18,1736,259,2013
test4sub44of100,test4pub57of100,10,192,10,1182,259,1451
test4sub40of100,test4pub44of100,10,192,10,3638,260,3908
test4sub14of100,test4pub55of100,10,192,18,1738,260,2016
test4sub82of100,test4pub50of100,10,192,12,2693,262,2967
test4sub69of100,test4pub48of100,10,192,10,3177,261,3448
test4sub50of100,test4pub55of100,10,192,18,1738,263,2019
test4sub81of100,test4pub23of100,10,192,17,6835,263,7115
test4sub96of100,test4pub56of100,10,192,10,1632,264,1906
test4sub99of100,test4pub30of100,10,191,9,6223,57,6289
test4sub88of100,test4pub57of100,10,192,10,1394,57,1461
test4sub61of100,test4pub57of100,10,192,10,1395,57,1462
test4sub27of100,test4pub48of100,10,192,10,3391,56,3457
test4sub24of100,test4pub57of100,10,192,10,1396,56,1462
test4sub85of100,test4pub56of100,10,192,10,1852,57,1919
test4sub4of100,test4pub56of100,10,192,10,1852,57,1919
test4sub32of100,test4pub57of100,10,192,10,1399,57,1466
test4sub65of100,test4pub57of100,10,192,10,1400,57,1467
test4sub62of100,test4pub53of100,10,192,10,2413,57,2480
test4sub65of100,test4pub58of100,10,192,11,455,18,484
test4sub32of100,test4pub58of100,10,192,11,455,19,485
test4sub4of100,test4pub57of100,10,192,10,1456,19,1485
test4sub85of100,test4pub57of100,10,192,10,1455,19,1484
test4sub62of100,test4pub54of100,10,192,10,2459,2,2471
test4sub24of100,test4pub58of100,10,192,11,452,21,484
test4sub27of100,test4pub49of100,10,192,11,3041,21,3073
test4sub34of100,test4pub49of100,10,192,11,3075,2,3088
test4sub61of100,test4pub58of100,10,192,11,450,21,482
test4sub88of100,test4pub58of100,10,192,11,450,22,483
test4sub99of100,test4pub31of100,10,192,19,6038,23,6080
test4sub32of100,test4pub59of100,10,192,15,494,3,512
test4sub96of100,test4pub57of100,10,192,10,1450,22,1482
test4sub34of100,test4pub50of100,10,192,12,3085,2,3099
test4sub81of100,test4pub24of100,10,192,15,7020,24,7059
test4sub50of100,test4pub56of100,10,192,10,1902,24,1936
test4sub69of100,test4pub49of100,10,192,11,3033,26,3070
test4sub99of100,test4pub32of100,10,192,11,6089,3,6103
test4sub82of100,test4pub51of100,10,191,9,2866,25,2900
test4sub14of100,test4pub56of100,10,192,10,1899,27,1936
test4sub40of100,test4pub45of100,10,191,9,3758,28,3795
test4sub44of100,test4pub58of100,10,192,11,440,29,480
test4sub95of100,test4pub56of100,10,192,10,1896,29,1935
test4sub27of100,test4pub50of100,10,192,12,3084,5,3101
test4sub20of100,test4pub54of100,10,192,10,2327,30,2367
test4sub33of100,test4pub47of100,10,192,10,3492,31,3533
test4sub37of100,test4pub57of100,10,192,10,1438,31,1479
test4sub34of100,test4pub51of100,10,191,9,2998,5,3012
test4sub100of100,test4pub56of100,10,192,10,1892,31,1933
test4sub39of100,test4pub48of100,10,192,10,3431,33,3474
test4sub69of100,test4pub50of100,10,192,12,3088,5,3105
test4sub96of100,test4pub58of100,10,192,11,575,8,594
test4sub47of100,test4pub56of100,10,192,10,1890,33,1933
test4sub14of100,test4pub57of100,10,192,10,1580,5,1595
test4sub54of100,test4pub40of100,10,192,11,4296,34,4341
test4sub44of100,test4pub59of100,10,192,15,502,6,523
test4sub63of100,test4pub58of100,10,192,11,432,34,477
test4sub97of100,test4pub28of100,10,192,18,6428,36,6482
test4sub27of100,test4pub51of100,10,191,9,3002,6,3017
test4sub28of100,test4pub56of100,10,192,10,1887,35,1932
test4sub34of100,test4pub52of100,10,191,9,2937,5,2951
test4sub2of100,test4pub46of100,10,192,10,3559,36,3605
test4sub86of100,test4pub56of100,10,192,10,1885,36,1931
test4sub100of100,test4pub57of100,10,192,10,1585,6,1601
test4sub6of100,test4pub55of100,10,192,18,1984,37,2039
test4sub33of100,test4pub48of100,10,192,10,3578,9,3597
test4sub10of100,test4pub49of100,10,192,11,3016,37,3064
test4sub99of100,test4pub33of100,10,192,16,5805,10,5831
test4sub23of100,test4pub58of100,10,192,11,426,38,475
test4sub58of100,test4pub44of100,10,192,10,3882,40,3932
test4sub92of100,test4pub26of100,10,192,11,6825,39,6875
test4sub39of100,test4pub49of100,10,192,11,3172,9,3192
test4sub49of100,test4pub58of100,10,192,11,423,41,475
test4sub16of100,test4pub57of100,10,192,10,1425,41,1476
test4sub54of100,test4pub41of100,10,191,9,4354,9,4372
test4sub5of100,test4pub58of100,10,192,11,421,42,474
test4sub17of100,test4pub46of100,10,192,10,3551,41,3602
test4sub97of100,test4pub29of100,10,192,11,6493,9,6513
test4sub8of100,test4pub32of100,10,192,11,5935,43,5989
test4sub52of100,test4pub58of100,10,192,11,419,43,473
test4sub56of100,test4pub58of100,10,192,11,418,44,473
test4sub9of100,test4pub53of100,10,192,10,2431,45,2486
test4sub22of100,test4pub56of100,10,192,10,1871,47,1928
test4sub94of100,test4pub51of100,10,191,9,2837,46,2892
test4sub93of100,test4pub30of100,10,191,9,6245,47,6301
test4sub67of100,test4pub58of100,10,192,11,413,47,471
test4sub53of100,test4pub15of100,10,192,10,8163,49,8222
test4sub15of100,test4pub56of100,10,192,10,1868,48,1926
test4sub13of100,test4pub58of100,10,192,11,410,49,470
test4sub28of100,test4pub57of100,10,192,10,1589,11,1610
test4sub87of100,test4pub58of100,10,192,11,409,51,471
test4sub26of100,test4pub58of100,10,192,11,408,51,470
test4sub89of100,test4pub57of100,10,192,10,1409,52,1471
test4sub79of100,test4pub42of100,10,192,10,4044,52,4106
test4sub2of100,test4pub47of100,10,192,10,3642,14,3666
test4sub84of100,test4pub58of100,10,192,11,406,53,470
test4sub25of100,test4pub52of100,10,191,9,2760,52,2821
test4sub60of100,test4pub58of100,10,192,11,404,54,469
test4sub83of100,test4pub56of100,10,192,10,1860,54,1924
test4sub86of100,test4pub57of100,10,192,10,1591,15,1616
test4sub70of100,test4pub58of100,10,192,11,402,55,468
test4sub43of100,test4pub56of100,10,192,10,1858,54,1922
test4sub77of100,test4pub53of100,10,192,10,2415,56,2481
test4sub6of100,test4pub56of100,10,192,10,2046,16,2072
test4sub30of100,test4pub57of100,10,192,10,1402,56,1468
test4sub41of100,test4pub54of100,10,192,10,2288,58,2356
test4sub33of100,test4pub49of100,10,192,11,3180,17,3208
test4sub34of100,test4pub53of100,10,192,10,2602,15,2627
test4sub20of100,test4pub55of100,10,192,18,2136,5,2159
test4sub23of100,test4pub59of100,10,192,15,515,22,552
test4sub34of100,test4pub54of100,10,192,10,2499,24,2533
test4sub4of100,test4pub58of100,10,192,11,572,3,586
test4sub6of100,test4pub57of100,10,192,10,1609,24,1643
test4sub41of100,test4pub55of100,10,192,18,2165,26,2209
test4sub33of100,test4pub50of100,10,192,12,3120,25,3157
test4sub30of100,test4pub58of100,10,192,11,608,27,646
test4sub54of100,test4pub42of100,10,192,10,4232,24,4266
test4sub10of100,test4pub50of100,10,192,12,3103,21,3136
test4sub86of100,test4pub58of100,10,192,11,605,31,647
test4sub25of100,test4pub53of100,10,192,10,2618,33,2661
test4sub100of100,test4pub58of100,10,192,11,589,21,621
test4sub27of100,test4pub52of100,10,191,9,2942,20,2971
test4sub2of100,test4pub48of100,10,192,10,3600,34,3644
test4sub14of100,test4pub58of100,10,192,11,585,20,616
test4sub89of100,test4pub58of100,10,192,11,602,37,650
test4sub20of100,test4pub56of100,10,192,10,2068,19,2097
test4sub53of100,test4pub16of100,10,192,10,8267,38,8315
test4sub69of100,test4pub51of100,10,191,9,3006,18,3033
test4sub37of100,test4pub58of100,10,192,11,582,29,622
test4sub99of100,test4pub34of100,10,192,11,5756,47,5814
test4sub58of100,test4pub45of100,10,191,9,3908,47,3964
test4sub92of100,test4pub27of100,10,192,13,6685,46,6744
test4sub39of100,test4pub50of100,10,192,12,3105,46,3163
test4sub40of100,test4pub46of100,10,192,10,3709,11,3730
test4sub16of100,test4pub58of100,10,192,11,594,45,650
test4sub17of100,test4pub48of100,10,192,10,3592,44,3646
test4sub82of100,test4pub52of100,10,191,9,2933,13,2955
test4sub97of100,test4pub30of100,10,191,9,6428,44,6481
test4sub8of100,test4pub33of100,10,192,16,5824,43,5883
test4sub34of100,test4pub55of100,10,192,18,2190,13,2221
test4sub9of100,test4pub54of100,10,192,10,2486,42,2538
test4sub81of100,test4pub25of100,10,192,10,7067,14,7091
test4sub22of100,test4pub57of100,10,192,10,1600,41,1651
test4sub94of100,test4pub52of100,10,191,9,2954,41,3004
test4sub93of100,test4pub32of100,10,192,11,6114,41,6166
test4sub15of100,test4pub57of100,10,192,10,1602,39,1651
test4sub62of100,test4pub55of100,10,192,18,2129,16,2163
test4sub28of100,test4pub58of100,10,192,11,601,37,649
test4sub79of100,test4pub43of100,10,192,10,4136,36,4182
test4sub85of100,test4pub58of100,10,192,11,573,17,601
test4sub83of100,test4pub57of100,10,192,10,1607,32,1649
test4sub41of100,test4pub56of100,10,192,10,2091,18,2119
test4sub43of100,test4pub57of100,10,192,10,1608,30,1648
test4sub77of100,test4pub54of100,10,192,10,2496,29,2535
test4sub6of100,test4pub58of100,10,192,11,635,18,664
test4sub30of100,test4pub59of100,10,192,15,559,20,594
test4sub33of100,test4pub51of100,10,191,9,3058,22,3089
test4sub54of100,test4pub44of100,10,192,10,4094,21,4125
test4sub10of100,test4pub52of100,10,191,9,2992,21,3022
test4sub25of100,test4pub54of100,10,192,10,2527,22,2559
test4sub27of100,test4pub53of100,10,192,10,2652,22,2684
test4sub2of100,test4pub50of100,10,192,12,3150,22,3184
test4sub20of100,test4pub57of100,10,192,10,1642,21,1673
test4sub69of100,test4pub52of100,10,191,9,2996,21,3026
test4sub58of100,test4pub46of100,10,192,10,3773,21,3804
test4sub92of100,test4pub28of100,10,192,18,6640,20,6678
test4sub39of100,test4pub51of100,10,191,9,3066,21,3096
test4sub40of100,test4pub47of100,10,192,10,3698,21,3729
test4sub17of100,test4pub47of100,10,192,10,3699,22,3731
test4sub82of100,test4pub53of100,10,192,10,2660,22,2692
test4sub97of100,test4pub31of100,10,192,19,6236,23,6278
test4sub8of100,test4pub34of100,10,192,11,5811,24,5846
test4sub9of100,test4pub55of100,10,192,18,2204,23,2245
test4sub81of100,test4pub26of100,10,192,11,7049,23,7083
test4sub22of100,test4pub58of100,10,192,11,650,23,684
test4sub93of100,test4pub33of100,10,192,16,5877,23,5916
test4sub15of100,test4pub58of100,10,192,11,651,24,686
test4sub53of100,test4pub17of100,10,192,17,8028,23,8068
test4sub62of100,test4pub56of100,10,192,10,2107,24,2141
test4sub79of100,test4pub44of100,10,192,10,4109,24,4143
test4sub83of100,test4pub58of100,10,192,11,653,25,689
test4sub41of100,test4pub57of100,10,192,10,1656,25,1691
test4sub43of100,test4pub58of100,10,192,11,654,25,690
test4sub6of100,test4pub59of100,10,192,15,578,26,619
test4sub77of100,test4pub55of100,10,192,18,2211,26,2255
test4sub94of100,test4pub53of100,10,192,10,2664,26,2700
test4sub48of100,test4pub55of100,10,192,18,2623,1,2642
test4sub94of100,test4pub54of100,10,192,10,3221,3,3234
test4sub57of100,test4pub50of100,10,192,12,2063,1275,3350
test4sub98of100,test4pub54of100,10,192,10,1479,1275,2764
test4sub61of100,test4pub59of100,10,192,15,930,7,952
test4sub6of100,test4pub60of100,10,192,18,476,7,501
test4sub32of100,test4pub60of100,10,192,18,464,8,490
test4sub94of100,test4pub55of100,10,192,18,2892,9,2919
test4sub89of100,test4pub59of100,10,192,15,798,10,823
test4sub77of100,test4pub56of100,10,192,10,2138,9,2157
test4sub85of100,test4pub59of100,10,192,15,604,9,628
test4sub41of100,test4pub58of100,10,192,11,680,10,701
test4sub100of100,test4pub59of100,10,192,15,804,13,832
test4sub79of100,test4pub45of100,10,191,9,3994,12,4015
test4sub14of100,test4pub59of100,10,192,15,803,12,830
test4sub62of100,test4pub57of100,10,192,10,1678,12,1700
test4sub56of100,test4pub59of100,10,192,15,796,13,824
test4sub13of100,test4pub59of100,10,192,15,600,11,626
test4sub24of100,test4pub59of100,10,192,15,599,12,626
test4sub47of100,test4pub57of100,10,192,10,1870,13,1893
test4sub53of100,test4pub18of100,10,192,15,8043,13,8071
test4sub93of100,test4pub34of100,10,192,11,5838,15,5864
test4sub81of100,test4pub27of100,10,192,13,6765,15,6793
test4sub9of100,test4pub56of100,10,192,10,2127,16,2153
test4sub8of100,test4pub35of100,10,192,15,5556,16,5587
test4sub97of100,test4pub32of100,10,192,11,6185,17,6213
test4sub57of100,test4pub51of100,10,191,9,3761,15,3785
test4sub84of100,test4pub59of100,10,192,15,593,17,625
test4sub82of100,test4pub54of100,10,192,10,2557,18,2585
test4sub65of100,test4pub59of100,10,192,15,783,19,817
test4sub17of100,test4pub49of100,10,192,11,3257,17,3285
test4sub40of100,test4pub48of100,10,192,10,3664,19,3693
test4sub26of100,test4pub59of100,10,192,15,589,19,623
test4sub39of100,test4pub52of100,10,191,9,3020,21,3050
test4sub92of100,test4pub29of100,10,192,11,6572,20,6603
test4sub98of100,test4pub55of100,10,192,18,2895,21,2934
test4sub69of100,test4pub53of100,10,192,10,2677,22,2709
test4sub20of100,test4pub58of100,10,192,11,663,22,696
test4sub28of100,test4pub59of100,10,192,15,780,23,818
test4sub2of100,test4pub49of100,10,192,11,3250,22,3283
test4sub27of100,test4pub54of100,10,192,10,2550,22,2582
test4sub25of100,test4pub55of100,10,192,18,2216,24,2258
test4sub10of100,test4pub51of100,10,191,9,3081,24,3114
test4sub54of100,test4pub43of100,10,192,10,4191,24,4225
test4sub33of100,test4pub52of100,10,191,9,3013,24,3046
test4sub99of100,test4pub35of100,10,192,15,5527,26,5568
test4sub34of100,test4pub56of100,10,192,10,2103,26,2139
test4sub48of100,test4pub56of100,10,192,10,2791,13,2814
test4sub18of100,test4pub57of100,10,192,10,1913,9,1932
test4sub23of100,test4pub60of100,10,192,18,470,9,497
test4sub1of100,test4pub51of100,10,191,9,3407,8,3424
test4sub12of100,test4pub57of100,10,192,10,2074,7,2091
test4sub86of100,test4pub59of100,10,192,15,778,30,823
test4sub59of100,test4pub57of100,10,192,10,1853,31,1894
test4sub61of100,test4pub60of100,10,192,18,884,31,933
test4sub68of100,test4pub57of100,10,192,10,1852,31,1893
test4sub49of100,test4pub59of100,10,192,15,768,32,815
test4sub43of100,test4pub59of100,10,192,15,723,32,770
test4sub6of100,test4pub61of100,10,192,12,382,33,427
test4sub60of100,test4pub59of100,10,192,15,690,33,738
test4sub22of100,test4pub59of100,10,192,15,689,33,737
test4sub96of100,test4pub59of100,10,192,15,679,34,728
test4sub32of100,test4pub61of100,10,192,12,383,33,428
test4sub5of100,test4pub59of100,10,192,15,678,35,728
test4sub73of100,test4pub56of100,10,192,10,2209,35,2254
test4sub4of100,test4pub59of100,10,192,15,672,35,722
test4sub16of100,test4pub59of100,10,192,15,669,35,719
test4sub45of100,test4pub12of100,10,191,9,8660,35,8704
test4sub95of100,test4pub57of100,10,192,10,1741,31,1782
test4sub24of100,test4pub60of100,10,192,18,895,31,944
test4sub88of100,test4pub59of100,10,192,15,657,32,704
test4sub47of100,test4pub58of100,10,192,11,1352,32,1395
test4sub53of100,test4pub19of100,10,192,18,8694,32,8744
test4sub79of100,test4pub46of100,10,192,10,4480,33,4523
test4sub41of100,test4pub59of100,10,192,15,1273,33,1321
test4sub77of100,test4pub57of100,10,192,10,2351,34,2395
test4sub93of100,test4pub35of100,10,192,15,6239,34,6288
test4sub63of100,test4pub59of100,10,192,15,617,35,667
test4sub87of100,test4pub59of100,10,192,15,621,35,671
test4sub81of100,test4pub28of100,10,192,18,7352,35,7405
test4sub3of100,test4pub57of100,10,192,10,1724,36,1770
test4sub8of100,test4pub37of100,10,192,10,6146,36,6192
test4sub7of100,test4pub56of100,10,192,10,2188,36,2234
test4sub94of100,test4pub56of100,10,192,10,2802,36,2848
test4sub97of100,test4pub33of100,10,192,16,6584,37,6637
test4sub57of100,test4pub52of100,10,191,9,3712,37,3758
test4sub84of100,test4pub60of100,10,192,18,900,37,955
test4sub82of100,test4pub55of100,10,192,18,2914,38,2970
test4sub36of100,test4pub57of100,10,192,10,1735,38,1783
test4sub65of100,test4pub60of100,10,192,18,902,39,959
test4sub40of100,test4pub49of100,10,192,11,3949,39,3999
test4sub39of100,test4pub53of100,10,192,10,3374,39,3423
test4sub92of100,test4pub30of100,10,191,9,7193,40,7242
test4sub98of100,test4pub56of100,10,192,10,2817,39,2866
test4sub69of100,test4pub54of100,10,192,10,3251,40,3301
test4sub20of100,test4pub59of100,10,192,15,1285,40,1340
test4sub28of100,test4pub60of100,10,192,18,906,41,965
test4sub2of100,test4pub51of100,10,191,9,3786,40,3835
test4sub25of100,test4pub56of100,10,192,10,2820,40,2870
test4sub54of100,test4pub45of100,10,191,9,4681,40,4730
test4sub10of100,test4pub53of100,10,192,10,3379,40,3429
test4sub99of100,test4pub36of100,10,192,15,6193,42,6250
test4sub33of100,test4pub53of100,10,192,10,3380,42,3432
test4sub27of100,test4pub55of100,10,192,18,2920,42,2980
test4sub34of100,test4pub57of100,10,192,10,2369,43,2422
test4sub26of100,test4pub60of100,10,192,18,903,43,964
test4sub17of100,test4pub50of100,10,192,12,3870,43,3925
test4sub9of100,test4pub57of100,10,192,10,2358,44,2412
test4sub56of100,test4pub60of100,10,192,18,894,44,956
test4sub62of100,test4pub58of100,10,192,11,1351,44,1406
test4sub1of100,test4pub52of100,10,191,9,3725,45,3779
test4sub23of100,test4pub61of100,10,192,12,409,45,466
test4sub86of100,test4pub60of100,10,192,18,914,44,976
test4sub48of100,test4pub57of100,10,192,10,2372,44,2426
test4sub12of100,test4pub58of100,10,192,11,1371,46,1428
test4sub61of100,test4pub61of100,10,192,12,412,44,468
test4sub49of100,test4pub60of100,10,192,18,917,44,979
test4sub43of100,test4pub60of100,10,192,18,918,44,980
test4sub60of100,test4pub60of100,10,192,18,919,44,981
test4sub22of100,test4pub60of100,10,192,18,920,44,982
test4sub96of100,test4pub60of100,10,192,18,921,43,982
test4sub32of100,test4pub62of100,10,192,10,303,43,356
test4sub5of100,test4pub60of100,10,192,18,923,42,983
test4sub73of100,test4pub57of100,10,192,10,2382,43,2435
test4sub45of100,test4pub14of100,10,192,10,9243,42,9295
test4sub24of100,test4pub61of100,10,192,12,422,41,475
test4sub47of100,test4pub59of100,10,192,15,1308,40,1363
test4sub53of100,test4pub20of100,10,192,10,8373,40,8423
test4sub79of100,test4pub48of100,10,192,10,4384,40,4434
test4sub77of100,test4pub58of100,10,192,11,1388,39,1438
test4sub93of100,test4pub36of100,10,192,15,6215,40,6270
test4sub87of100,test4pub60of100,10,192,18,933,40,991
test4sub81of100,test4pub29of100,10,192,11,7297,40,7348
test4sub8of100,test4pub36of100,10,192,15,6219,38,6272
test4sub7of100,test4pub57of100,10,192,10,2394,40,2444
test4sub94of100,test4pub57of100,10,192,10,2396,39,2445
test4sub97of100,test4pub34of100,10,192,11,6558,40,6609
test4sub57of100,test4pub53of100,10,192,10,3409,39,3458
test4sub84of100,test4pub61of100,10,192,12,435,40,487
test4sub82of100,test4pub56of100,10,192,10,2853,38,2901
test4sub65of100,test4pub61of100,10,192,12,437,38,487
test4sub40of100,test4pub50of100,10,192,12,3910,37,3959
test4sub39of100,test4pub54of100,10,192,10,3289,38,3337
test4sub92of100,test4pub31of100,10,192,19,6991,37,7047
test4sub98of100,test4pub57of100,10,192,10,2403,38,2451
test4sub39of100,test4pub55of100,10,192,18,2994,12,3024
test4sub92of100,test4pub32of100,10,192,11,6955,11,6977
test4sub40of100,test4pub51of100,10,191,9,3859,13,3881
test4sub82of100,test4pub57of100,10,192,10,2438,13,2461
test4sub57of100,test4pub54of100,10,192,10,3324,15,3349
test4sub97of100,test4pub35of100,10,192,15,6320,15,6350
test4sub94of100,test4pub58of100,10,192,11,1433,16,1460
test4sub40of100,test4pub52of100,10,191,9,3968,1,3978
test4sub7of100,test4pub58of100,10,192,11,1433,15,1459
test4sub8of100,test4pub38of100,10,192,10,6002,17,6029
test4sub81of100,test4pub31of100,10,192,19,7021,17,7057
test4sub57of100,test4pub55of100,10,192,18,3170,3,3191
test4sub87of100,test4pub61of100,10,192,12,469,19,500
test4sub93of100,test4pub37of100,10,192,10,6220,19,6249
test4sub97of100,test4pub36of100,10,192,15,6442,3,6460
test4sub77of100,test4pub59of100,10,192,15,1352,19,1386
test4sub53of100,test4pub21of100,10,192,13,8360,21,8394
test4sub79of100,test4pub47of100,10,192,10,4482,19,4511
test4sub8of100,test4pub39of100,10,192,19,5755,3,5777
test4sub57of100,test4pub56of100,10,192,10,3074,3,3087
test4sub47of100,test4pub60of100,10,192,18,969,20,1007
test4sub7of100,test4pub59of100,10,192,15,1539,6,1560
test4sub73of100,test4pub58of100,10,192,11,1424,23,1458
test4sub93of100,test4pub38of100,10,192,10,6189,4,6203
test4sub5of100,test4pub61of100,10,192,12,462,23,497
test4sub45of100,test4pub13of100,10,192,11,9325,21,9357
test4sub81of100,test4pub30of100,10,191,9,7449,6,7464
test4sub22of100,test4pub61of100,10,192,12,460,24,496
test4sub60of100,test4pub61of100,10,192,12,460,25,497
test4sub43of100,test4pub61of100,10,192,12,458,25,495
test4sub49of100,test4pub61of100,10,192,12,458,25,495
test4sub12of100,test4pub59of100,10,192,15,1341,26,1382
test4sub48of100,test4pub58of100,10,192,11,1417,28,1456
test4sub86of100,test4pub61of100,10,192,12,455,27,494
test4sub1of100,test4pub53of100,10,192,10,3429,28,3467
test4sub96of100,test4pub61of100,10,192,12,461,23,496
test4sub62of100,test4pub59of100,10,192,15,1337,30,1382
test4sub56of100,test4pub61of100,10,192,12,452,30,494
test4sub45of100,test4pub15of100,10,192,10,9375,3,9388
test4sub9of100,test4pub58of100,10,192,11,1412,30,1453
test4sub17of100,test4pub51of100,10,191,9,3834,31,3874
test4sub34of100,test4pub58of100,10,192,11,1410,33,1454
test4sub48of100,test4pub59of100,10,192,15,1549,3,1567
test4sub27of100,test4pub56of100,10,192,10,2866,33,2909
test4sub99of100,test4pub37of100,10,192,10,6198,33,6241
test4sub33of100,test4pub54of100,10,192,10,3297,33,3340
test4sub10of100,test4pub54of100,10,192,10,3296,35,3341
test4sub54of100,test4pub46of100,10,192,10,4536,35,4581
test4sub25of100,test4pub57of100,10,192,10,2407,35,2452
test4sub12of100,test4pub60of100,10,192,18,1169,5,1192
test4sub1of100,test4pub54of100,10,192,10,3516,6,3532
test4sub2of100,test4pub52of100,10,191,9,3760,36,3805
test4sub20of100,test4pub60of100,10,192,18,946,38,1002
test4sub69of100,test4pub55of100,10,192,18,2959,37,3014
test4sub34of100,test4pub59of100,10,192,15,1552,5,1572
test4sub93of100,test4pub39of100,10,192,19,5762,3,5784
test4sub73of100,test4pub59of100,10,192,15,1546,2,1563
test4sub40of100,test4pub53of100,10,192,10,3630,3,3643
test4sub27of100,test4pub57of100,10,192,10,2632,10,2652
test4sub39of100,test4pub56of100,10,192,10,3068,1,3079
test4sub98of100,test4pub58of100,10,192,11,1440,1,1452
test4sub17of100,test4pub52of100,10,191,9,3983,11,4003
test4sub48of100,test4pub60of100,10,192,18,1173,9,1200
test4sub45of100,test4pub16of100,10,192,10,9295,6,9311
test4sub33of100,test4pub55of100,10,192,18,3187,13,3218
test4sub10of100,test4pub55of100,10,192,18,3187,13,3218
test4sub79of100,test4pub49of100,10,192,11,4210,25,4246
test4sub47of100,test4pub61of100,10,192,12,661,25,698
test4sub54of100,test4pub48of100,10,192,10,4629,15,4654
test4sub25of100,test4pub58of100,10,192,11,1633,16,1660
test4sub1of100,test4pub55of100,10,192,18,3190,15,3223
test4sub2of100,test4pub53of100,10,192,10,3648,16,3674
test4sub69of100,test4pub56of100,10,192,10,3091,16,3117
test4sub99of100,test4pub38of100,10,192,10,6201,16,6227
test4sub34of100,test4pub60of100,10,192,18,1179,16,1213
test4sub9of100,test4pub59of100,10,192,15,1551,17,1583
test4sub93of100,test4pub40of100,10,192,11,5500,17,5528
test4sub8of100,test4pub40of100,10,192,11,5484,16,5511
test4sub81of100,test4pub32of100,10,192,11,7140,18,7169
test4sub57of100,test4pub57of100,10,192,10,2624,17,2651
test4sub53of100,test4pub22of100,10,192,10,8461,18,8489
test4sub73of100,test4pub60of100,10,192,18,1180,19,1217
test4sub40of100,test4pub54of100,10,192,10,3529,18,3557
test4sub97of100,test4pub37of100,10,192,10,6409,18,6437
test4sub27of100,test4pub58of100,10,192,11,1641,19,1671
test4sub82of100,test4pub58of100,10,192,11,1614,19,1644
test4sub39of100,test4pub57of100,10,192,10,2644,20,2674
test4sub92of100,test4pub33of100,10,192,16,6840,20,6876
test4sub98of100,test4pub59of100,10,192,15,1565,21,1601
test4sub17of100,test4pub53of100,10,192,10,3657,21,3688
test4sub48of100,test4pub61of100,10,192,12,683,21,716
test4sub45of100,test4pub17of100,10,192,17,9032,20,9069
test4sub33of100,test4pub56of100,10,192,10,3101,20,3131
test4sub10of100,test4pub56of100,10,192,10,3101,20,3131
test4sub79of100,test4pub50of100,10,192,12,4158,20,4190
test4sub54of100,test4pub47of100,10,192,10,4702,20,4732
test4sub25of100,test4pub59of100,10,192,15,1572,19,1606
test4sub1of100,test4pub56of100,10,192,10,3105,19,3134
test4sub2of100,test4pub54of100,10,192,10,3540,19,3569
test4sub69of100,test4pub57of100,10,192,10,2653,19,2682
test4sub99of100,test4pub39of100,10,192,19,5791,18,5828
test4sub34of100,test4pub61of100,10,192,12,692,19,723
test4sub93of100,test4pub41of100,10,191,9,5423,18,5450
test4sub8of100,test4pub41of100,10,191,9,5424,18,5451
test4sub81of100,test4pub33of100,10,192,16,6883,18,6917
test4sub57of100,test4pub58of100,10,192,11,1656,18,1685
test4sub53of100,test4pub23of100,10,192,17,8315,17,8349
test4sub73of100,test4pub61of100,10,192,12,697,18,727
test4sub97of100,test4pub38of100,10,192,10,6229,17,6256
test4sub40of100,test4pub55of100,10,192,18,3215,17,3250
test4sub27of100,test4pub59of100,10,192,15,1584,17,1616
test4sub82of100,test4pub59of100,10,192,15,1584,18,1617
test4sub39of100,test4pub58of100,10,192,11,1662,17,1690
test4sub92of100,test4pub34of100,10,192,11,6827,18,6856
test4sub17of100,test4pub54of100,10,192,10,3553,16,3579
test4sub33of100,test4pub57of100,10,192,10,2668,17,2695
test4sub10of100,test4pub57of100,10,192,10,2668,16,2694
test4sub54of100,test4pub49of100,10,192,11,4257,16,4284
test4sub79of100,test4pub51of100,10,191,9,4090,17,4116
test4sub2of100,test4pub55of100,10,192,18,3226,15,3259
test4sub69of100,test4pub58of100,10,192,11,1670,15,1696
test4sub99of100,test4pub40of100,10,192,11,5535,15,5561
test4sub34of100,test4pub62of100,10,192,10,596,16,622
test4sub93of100,test4pub42of100,10,192,10,5310,14,5334
test4sub8of100,test4pub42of100,10,192,10,5311,16,5337
test4sub81of100,test4pub34of100,10,192,11,6839,15,6865
test4sub53of100,test4pub24of100,10,192,15,8250,15,8280
test4sub97of100,test4pub39of100,10,192,19,5816,14,5849
test4sub40of100,test4pub56of100,10,192,10,3133,15,3158
test4sub82of100,test4pub60of100,10,192,18,1222,13,1253
test4sub27of100,test4pub60of100,10,192,18,1222,14,1254
test4sub39of100,test4pub59of100,10,192,15,1603,15,1633
test4sub92of100,test4pub35of100,10,192,15,6566,14,6595
test4sub17of100,test4pub55of100,10,192,18,3238,14,3270
test4sub33of100,test4pub58of100,10,192,11,1683,13,1707
test4sub10of100,test4pub58of100,10,192,11,1683,14,1708
test4sub54of100,test4pub51of100,10,191,9,4107,14,4130
test4sub79of100,test4pub52of100,10,191,9,4040,14,4063
test4sub2of100,test4pub56of100,10,192,10,3142,14,3166
test4sub69of100,test4pub59of100,10,192,15,1609,14,1638
test4sub99of100,test4pub41of100,10,191,9,5457,14,5480
test4sub93of100,test4pub43of100,10,192,10,5222,14,5246
test4sub8of100,test4pub43of100,10,192,10,5223,14,5247
test4sub81of100,test4pub35of100,10,192,15,6575,13,6603
test4sub97of100,test4pub40of100,10,192,11,5555,13,5579
test4sub53of100,test4pub25of100,10,192,10,8183,14,8207
test4sub40of100,test4pub57of100,10,192,10,2696,13,2719
test4sub27of100,test4pub61of100,10,192,12,734,12,758
test4sub39of100,test4pub60of100,10,192,18,1238,13,1269
test4sub92of100,test4pub36of100,10,192,15,6523,12,6550
test4sub17of100,test4pub56of100,10,192,10,3153,13,3176
test4sub10of100,test4pub59of100,10,192,15,1621,13,1649
test4sub33of100,test4pub59of100,10,192,15,1621,13,1649
test4sub54of100,test4pub50of100,10,192,12,4210,12,4234
test4sub79of100,test4pub53of100,10,192,10,3714,13,3737
test4sub69of100,test4pub60of100,10,192,18,1244,12,1274
test4sub2of100,test4pub57of100,10,192,10,2703,12,2725
test4sub99of100,test4pub42of100,10,192,10,5340,13,5363
test4sub93of100,test4pub44of100,10,192,10,5160,13,5183
test4sub8of100,test4pub44of100,10,192,10,5161,12,5183
test4sub81of100,test4pub36of100,10,192,15,6531,12,6558
test4sub97of100,test4pub41of100,10,191,9,5475,13,5497
test4sub1of100,test4pub57of100,10,192,10,2882,1,2893
test4sub81of100,test4pub37of100,10,192,10,6508,4,6522
test4sub96of100,test4pub62of100,10,192,10,799,3,812
test4sub5of100,test4pub62of100,10,192,10,798,2,810
test4sub8of100,test4pub45of100,10,191,9,5033,4,5046
test4sub78of100,test4pub51of100,10,191,9,4277,2,4288
test4sub93of100,test4pub45of100,10,191,9,5032,5,5046
test4sub99of100,test4pub43of100,10,192,10,5249,6,5265
test4sub2of100,test4pub58of100,10,192,11,1715,6,1732
test4sub69of100,test4pub61of100,10,192,12,753,6,771
test4sub79of100,test4pub54of100,10,192,10,3602,8,3620
test4sub73of100,test4pub62of100,10,192,10,793,5,808
test4sub54of100,test4pub52of100,10,191,9,4068,8,4085
test4sub33of100,test4pub60of100,10,192,18,1255,9,1282
test4sub10of100,test4pub60of100,10,192,18,1254,8,1280
test4sub17of100,test4pub57of100,10,192,10,2712,10,2732
test4sub78of100,test4pub52of100,10,191,9,4367,6,4382
test4sub92of100,test4pub37of100,10,192,10,6500,10,6520
test4sub39of100,test4pub61of100,10,192,12,747,10,769
test4sub93of100,test4pub46of100,10,192,10,5143,7,5160
test4sub40of100,test4pub58of100,10,192,11,1707,11,1729
test4sub53of100,test4pub26of100,10,192,11,8107,13,8131
test4sub8of100,test4pub46of100,10,192,10,5142,6,5158
test4sub81of100,test4pub38of100,10,192,10,6580,5,6595
test4sub45of100,test4pub18of100,10,192,15,9198,6,9219
test4sub23of100,test4pub62of100,10,192,10,796,6,812
test4sub2of100,test4pub59of100,10,192,15,1936,12,1963
test4sub99of100,test4pub44of100,10,192,10,5470,14,5494
test4sub69of100,test4pub62of100,10,192,10,938,13,961
test4sub79of100,test4pub55of100,10,192,18,3571,13,3602
test4sub54of100,test4pub53of100,10,192,10,4030,12,4052
test4sub22of100,test4pub62of100,10,192,10,941,13,964
test4sub33of100,test4pub61of100,10,192,12,1056,13,1081
test4sub17of100,test4pub58of100,10,192,11,2019,13,2043
test4sub78of100,test4pub53of100,10,192,10,4033,12,4055
test4sub92of100,test4pub38of100,10,192,10,6590,14,6614
test4sub39of100,test4pub62of100,10,192,10,945,13,968
test4sub93of100,test4pub47of100,10,192,10,5075,14,5099
test4sub40of100,test4pub59of100,10,192,15,1944,13,1972
test4sub61of100,test4pub62of100,10,192,10,946,14,970
test4sub53of100,test4pub27of100,10,192,13,8115,13,8141
test4sub81of100,test4pub39of100,10,192,19,6162,12,6193
test4sub45of100,test4pub19of100,10,192,18,9365,13,9396
test4sub1of100,test4pub58of100,10,192,11,2009,13,2033
test4sub97of100,test4pub42of100,10,192,10,5644,15,5669
test4sub8of100,test4pub47of100,10,192,10,5077,15,5102
test4sub65of100,test4pub62of100,10,192,10,949,16,975
test4sub2of100,test4pub60of100,10,192,18,1570,15,1603
test4sub60of100,test4pub62of100,10,192,10,950,15,975
test4sub99of100,test4pub45of100,10,191,9,5344,15,5368
test4sub79of100,test4pub56of100,10,192,10,3485,15,3510
test4sub54of100,test4pub54of100,10,192,10,3919,14,3943
test4sub17of100,test4pub59of100,10,192,15,1955,13,1983
test4sub78of100,test4pub54of100,10,192,10,3921,14,3945
test4sub92of100,test4pub39of100,10,192,19,6173,14,6206
test4sub93of100,test4pub48of100,10,192,10,5032,13,5055
test4sub53of100,test4pub28of100,10,192,18,8033,13,8064
test4sub81of100,test4pub40of100,10,192,11,5900,13,5924
test4sub45of100,test4pub20of100,10,192,10,9025,12,9047
test4sub1of100,test4pub59of100,10,192,15,1962,13,1990
test4sub97of100,test4pub43of100,10,192,10,5573,11,5594
test4sub8of100,test4pub48of100,10,192,10,5037,12,5059
test4sub2of100,test4pub61of100,10,192,12,1081,11,1104
test4sub99of100,test4pub46of100,10,192,10,5173,10,5193
test4sub54of100,test4pub55of100,10,192,18,3601,10,3629
test4sub30of100,test4pub60of100,10,192,18,1588,10,1616
test4sub17of100,test4pub60of100,10,192,18,1590,10,1618
test4sub78of100,test4pub55of100,10,192,18,3603,10,3631
test4sub92of100,test4pub40of100,10,192,11,5911,10,5932
test4sub93of100,test4pub49of100,10,192,11,4638,10,4659
test4sub53of100,test4pub29of100,10,192,11,7957,9,7977
test4sub81of100,test4pub41of100,10,191,9,5819,10,5838
test4sub1of100,test4pub60of100,10,192,18,1595,10,1623
test4sub97of100,test4pub44of100,10,192,10,5509,9,5528
test4sub8of100,test4pub49of100,10,192,11,4643,10,4664
test4sub99of100,test4pub47of100,10,192,10,5109,9,5128
test4sub54of100,test4pub56of100,10,192,10,3512,8,3530
test4sub30of100,test4pub61of100,10,192,12,1095,9,1116
test4sub17of100,test4pub61of100,10,192,12,1097,9,1118
test4sub78of100,test4pub56of100,10,192,10,3514,9,3533
test4sub92of100,test4pub41of100,10,191,9,5828,8,5845
test4sub93of100,test4pub50of100,10,192,12,4570,9,4591
test4sub81of100,test4pub42of100,10,192,10,5698,9,5717
test4sub53of100,test4pub31of100,10,192,19,7651,10,7680
test4sub1of100,test4pub61of100,10,192,12,1101,9,1122
test4sub97of100,test4pub45of100,10,191,9,5379,10,5398
test4sub8of100,test4pub50of100,10,192,12,4575,8,4595
test4sub99of100,test4pub48of100,10,192,10,5061,10,5081
test4sub54of100,test4pub57of100,10,192,10,3068,9,3087
test4sub30of100,test4pub62of100,10,192,10,990,10,1010
test4sub17of100,test4pub62of100,10,192,10,991,9,1010
test4sub92of100,test4pub42of100,10,192,10,5706,8,5724
test4sub93of100,test4pub51of100,10,191,9,4491,8,4508
test4sub81of100,test4pub43of100,10,192,10,5603,8,5621
test4sub94of100,test4pub59of100,10,192,15,1994,9,2018
test4sub1of100,test4pub62of100,10,192,10,996,7,1013
test4sub53of100,test4pub30of100,10,191,9,7904,8,7921
test4sub97of100,test4pub46of100,10,192,10,5204,7,5221
test4sub8of100,test4pub51of100,10,191,9,4496,9,4514
test4sub99of100,test4pub49of100,10,192,11,4664,7,4682
test4sub54of100,test4pub58of100,10,192,11,2076,8,2095
test4sub92of100,test4pub43of100,10,192,10,5611,7,5628
test4sub93of100,test4pub52of100,10,191,9,4433,7,4449
test4sub81of100,test4pub44of100,10,192,10,5537,6,5553
test4sub97of100,test4pub47of100,10,192,10,5135,6,5151
test4sub53of100,test4pub32of100,10,192,11,7596,6,7613
test4sub8of100,test4pub52of100,10,191,9,4438,6,4453
test4sub99of100,test4pub50of100,10,192,12,4594,6,4612
test4sub54of100,test4pub59of100,10,192,15,2008,6,2029
test4sub92of100,test4pub44of100,10,192,10,5542,6,5558
test4sub93of100,test4pub53of100,10,192,10,4100,6,4116
test4sub81of100,test4pub45of100,10,191,9,5403,6,5418
test4sub97of100,test4pub48of100,10,192,10,5085,6,5101
test4sub53of100,test4pub33of100,10,192,16,7315,6,7337
test4sub8of100,test4pub53of100,10,192,10,4103,6,4119
test4sub99of100,test4pub51of100,10,191,9,4512,7,4528
test4sub54of100,test4pub60of100,10,192,18,1634,5,1657
test4sub92of100,test4pub45of100,10,191,9,5408,7,5424
test4sub93of100,test4pub54of100,10,192,10,3982,5,3997
test4sub81of100,test4pub46of100,10,192,10,5224,7,5241
test4sub53of100,test4pub34of100,10,192,11,7259,5,7275
test4sub99of100,test4pub52of100,10,191,9,4452,5,4466
test4sub8of100,test4pub54of100,10,192,10,3986,4,4000
test4sub54of100,test4pub61of100,10,192,12,1137,6,1155
test4sub92of100,test4pub46of100,10,192,10,5229,4,5243
test4sub93of100,test4pub55of100,10,192,18,3655,6,3679
test4sub81of100,test4pub47of100,10,192,10,5155,5,5170
test4sub53of100,test4pub35of100,10,192,15,6986,5,7006
test4sub99of100,test4pub53of100,10,192,10,4116,5,4131
test4sub8of100,test4pub55of100,10,192,18,3659,6,3683
test4sub92of100,test4pub47of100,10,192,10,5159,4,5173
test4sub54of100,test4pub62of100,10,192,10,1028,6,1044
test4sub93of100,test4pub56of100,10,192,10,3562,5,3577
test4sub81of100,test4pub48of100,10,192,10,5103,4,5117
test4sub99of100,test4pub54of100,10,192,10,3997,5,4012
test4sub53of100,test4pub36of100,10,192,15,6935,5,6955
test4sub92of100,test4pub48of100,10,192,10,5107,4,5121
test4sub93of100,test4pub57of100,10,192,10,3113,3,3126
test4sub8of100,test4pub56of100,10,192,10,3565,4,3579
test4sub81of100,test4pub49of100,10,192,11,4701,5,4717
test4sub99of100,test4pub55of100,10,192,18,3669,3,3690
test4sub53of100,test4pub37of100,10,192,10,6904,3,6917
test4sub92of100,test4pub49of100,10,192,11,4704,4,4719
test4sub8of100,test4pub57of100,10,192,10,3118,4,3132
test4sub93of100,test4pub58of100,10,192,11,2115,4,2130
test4sub99of100,test4pub56of100,10,192,10,3573,4,3587
test4sub81of100,test4pub50of100,10,192,12,4628,4,4644
test4sub53of100,test4pub38of100,10,192,10,6689,4,6703
test4sub92of100,test4pub50of100,10,192,12,4630,5,4647
test4sub8of100,test4pub58of100,10,192,11,2120,4,2135
test4sub93of100,test4pub59of100,10,192,15,2044,4,2063
test4sub81of100,test4pub51of100,10,191,9,4544,3,4556
test4sub99of100,test4pub57of100,10,192,10,3124,4,3138
test4sub53of100,test4pub39of100,10,192,19,6263,4,6286
test4sub92of100,test4pub51of100,10,191,9,4546,4,4559
test4sub99of100,test4pub58of100,10,192,11,2127,3,2141
test4sub81of100,test4pub52of100,10,191,9,4482,2,4493
test4sub12of100,test4pub61of100,10,192,12,1219,2,1233
test4sub93of100,test4pub60of100,10,192,18,1668,3,1689
test4sub49of100,test4pub62of100,10,192,10,1102,3,1115
test4sub8of100,test4pub59of100,10,192,15,2048,3,2066
test4sub92of100,test4pub52of100,10,191,9,4734,2,4745
test4sub47of100,test4pub62of100,10,192,10,1101,5,1116
test4sub15of100,test4pub59of100,10,192,15,2098,5,2118
test4sub81of100,test4pub53of100,10,192,10,4396,5,4411
test4sub93of100,test4pub61of100,10,192,12,1422,5,1439
test4sub49of100,test4pub63of100,10,192,10,1171,5,1186
test4sub8of100,test4pub60of100,10,192,18,1927,5,1950
test4sub12of100,test4pub62of100,10,192,10,1307,4,1321
test4sub92of100,test4pub53of100,10,192,10,4399,5,4414
test4sub53of100,test4pub40of100,10,192,11,5991,5,6007
test4sub15of100,test4pub60of100,10,192,18,1930,5,1953
test4sub81of100,test4pub54of100,10,192,10,4276,4,4290
test4sub8of100,test4pub61of100,10,192,12,1428,4,1444
test4sub92of100,test4pub54of100,10,192,10,4279,3,4292
test4sub15of100,test4pub61of100,10,192,12,1431,1,1444
test4sub81of100,test4pub55of100,10,192,18,3949,2,3969
test4sub53of100,test4pub41of100,10,191,9,6161,3,6173
test4sub92of100,test4pub55of100,10,192,18,3950,2,3970
test4sub81of100,test4pub56of100,10,192,10,3851,1,3862
test4sub53of100,test4pub42of100,10,192,10,6033,2,6045
test4sub92of100,test4pub56of100,10,192,10,3853,1,3864
test4sub81of100,test4pub57of100,10,192,10,3400,1,3411
test4sub92of100,test4pub57of100,10,192,10,3401,1,3412
test4sub81of100,test4pub58of100,10,192,11,2400,1,2412
test4sub53of100,test4pub43of100,10,192,10,5932,3,5945
test4sub81of100,test4pub59of100,10,192,15,2325,1,2341
test4sub92of100,test4pub58of100,10,192,11,2401,2,2414
test4sub53of100,test4pub44of100,10,192,10,5860,1,5871
test4sub81of100,test4pub60of100,10,192,18,1946,1,1965
test4sub53of100,test4pub45of100,10,191,9,5721,0,5730
test4sub92of100,test4pub59of100,10,192,15,2328,1,2344
test4sub81of100,test4pub61of100,10,192,12,1444,1,1457
test4sub53of100,test4pub46of100,10,192,10,5537,1,5548
test4sub92of100,test4pub60of100,10,192,18,1950,1,1969
test4sub81of100,test4pub62of100,10,192,10,1332,1,1343
test4sub92of100,test4pub61of100,10,192,12,1449,1,1462
test4sub53of100,test4pub47of100,10,192,10,5463,1,5474
test4sub53of100,test4pub48of100,10,192,10,5408,1,5419
test4sub92of100,test4pub62of100,10,192,10,1335,1,1346
test4sub53of100,test4pub49of100,10,192,11,5002,1,5014
test4sub53of100,test4pub50of100,10,192,12,4925,0,4937
test4sub53of100,test4pub51of100,10,191,9,4838,1,4848
test4sub53of100,test4pub52of100,10,191,9,4772,0,4781
test4sub53of100,test4pub53of100,10,192,10,4432,0,4442
test4sub53of100,test4pub54of100,10,192,10,4309,1,4320
test4sub53of100,test4pub55of100,10,192,18,3977,0,3995
test4sub53of100,test4pub56of100,10,192,10,3878,0,3888
test4sub53of100,test4pub57of100,10,192,10,3426,1,3437
test4sub53of100,test4pub58of100,10,192,11,2425,1,2437
test4sub25of100,test4pub60of100,10,192,18,2037,1,2056
test4sub56of100,test4pub62of100,10,192,10,1421,0,1431
test4sub56of100,test4pub63of100,10,192,10,1286,1,1297
test4sub70of100,test4pub59of100,10,192,15,2426,1,2442
test4sub70of100,test4pub60of100,10,192,18,2047,0,2065
test4sub70of100,test4pub61of100,10,192,12,1545,1,1558
test4sub34of100,test4pub63of100,10,192,10,1301,0,1311
test4sub48of100,test4pub62of100,10,192,10,1440,1,1451
test4sub93of100,test4pub62of100,10,192,10,1441,1,1452
test4sub48of100,test4pub63of100,10,192,10,1305,3,1318
test4sub43of100,test4pub62of100,10,192,10,1443,2,1455
test4sub93of100,test4pub63of100,10,192,10,1306,2,1318
test4sub82of100,test4pub61of100,10,192,12,1559,1,1572
test4sub82of100,test4pub62of100,10,192,10,1446,0,1456
test4sub10of100,test4pub61of100,10,192,12,1586,0,1598
test4sub32of100,test4pub63of100,10,192,10,1335,1,1346
test4sub10of100,test4pub62of100,10,192,10,1473,2,1485
test4sub86of100,test4pub62of100,10,192,10,1473,1,1484
test4sub10of100,test4pub63of100,10,192,10,1338,1,1349
test4sub86of100,test4pub63of100,10,192,10,1338,1,1349
test4sub11of100,test4pub53of100,10,192,10,1605,3002,4617
test4sub80of100,test4pub54of100,10,192,10,1480,3001,4491
test4sub11of100,test4pub54of100,10,192,10,4482,0,4492
test4sub80of100,test4pub55of100,10,192,18,4149,1,4168
test4sub11of100,test4pub55of100,10,192,18,4151,1,4170
test4sub80of100,test4pub56of100,10,192,10,4051,1,4062
test4sub80of100,test4pub57of100,10,192,10,3599,1,3610
test4sub11of100,test4pub56of100,10,192,10,4052,1,4063
test4sub11of100,test4pub57of100,10,192,10,3600,0,3610
test4sub80of100,test4pub58of100,10,192,11,2598,1,2610
test4sub55of100,test4pub47of100,10,192,10,2638,3010,5658
test4sub31of100,test4pub5of100,10,191,17,8859,3008,11884
test4sub11of100,test4pub58of100,10,192,11,2600,2,2613
test4sub80of100,test4pub59of100,10,192,15,2523,2,2540
test4sub55of100,test4pub49of100,10,192,11,5191,2,5204
test4sub31of100,test4pub6of100,10,191,11,11430,3,11444
test4sub80of100,test4pub60of100,10,192,18,2146,1,2165
test4sub55of100,test4pub50of100,10,192,12,5115,2,5129
test4sub31of100,test4pub7of100,10,191,17,11147,1,11165
test4sub80of100,test4pub61of100,10,192,12,1645,2,1659
test4sub55of100,test4pub51of100,10,191,9,5029,1,5039
test4sub31of100,test4pub8of100,10,191,17,11022,1,11040
test4sub55of100,test4pub52of100,10,191,9,4964,1,4974
test4sub31of100,test4pub9of100,10,191,16,10974,1,10991
test4sub31of100,test4pub10of100,10,192,10,10934,1,10945
test4sub55of100,test4pub53of100,10,192,10,4625,1,4636
test4sub55of100,test4pub54of100,10,192,10,4501,1,4512
test4sub31of100,test4pub11of100,10,192,11,10816,1,10828
test4sub31of100,test4pub13of100,10,192,11,10514,0,10525
test4sub55of100,test4pub55of100,10,192,18,4170,1,4189
test4sub31of100,test4pub12of100,10,191,9,10534,1,10544
test4sub55of100,test4pub56of100,10,192,10,4072,1,4083
test4sub55of100,test4pub57of100,10,192,10,3620,1,3631
test4sub31of100,test4pub14of100,10,192,10,10478,1,10489
test4sub55of100,test4pub58of100,10,192,11,2619,0,2630
test4sub31of100,test4pub15of100,10,192,10,10370,1,10381
test4sub55of100,test4pub59of100,10,192,15,2544,1,2560
test4sub31of100,test4pub16of100,10,192,10,10288,1,10299
test4sub55of100,test4pub60of100,10,192,18,2165,1,2184
test4sub31of100,test4pub17of100,10,192,17,10011,1,10029
test4sub31of100,test4pub18of100,10,192,15,9991,0,10006
test4sub55of100,test4pub61of100,10,192,12,1663,1,1676
test4sub31of100,test4pub19of100,10,192,18,9967,1,9986
test4sub55of100,test4pub62of100,10,192,10,1550,1,1561
test4sub31of100,test4pub20of100,10,192,10,9615,1,9626
test4sub31of100,test4pub21of100,10,192,13,9562,1,9576
test4sub31of100,test4pub22of100,10,192,10,9471,0,9481
test4sub31of100,test4pub23of100,10,192,17,9288,1,9306
test4sub31of100,test4pub24of100,10,192,15,9207,1,9223
test4sub31of100,test4pub25of100,10,192,10,9125,0,9135
test4sub31of100,test4pub26of100,10,192,11,9037,1,9049
test4sub31of100,test4pub27of100,10,192,13,8729,1,8743
test4sub31of100,test4pub28of100,10,192,18,8635,0,8653
test4sub31of100,test4pub29of100,10,192,11,8546,1,8558
test4sub31of100,test4pub30of100,10,191,9,8473,1,8483
test4sub31of100,test4pub31of100,10,192,19,8232,0,8251
test4sub31of100,test4pub32of100,10,192,11,8158,0,8169
test4sub31of100,test4pub33of100,10,192,16,7872,1,7889
test4sub31of100,test4pub34of100,10,192,11,7810,1,7822
test4sub31of100,test4pub37of100,10,192,10,7437,0,7447
test4sub31of100,test4pub35of100,10,192,15,7533,1,7549
test4sub31of100,test4pub36of100,10,192,15,7477,1,7493
test4sub31of100,test4pub38of100,10,192,10,7221,0,7231
test4sub31of100,test4pub39of100,10,192,19,6791,0,6810
test4sub31of100,test4pub40of100,10,192,11,6517,1,6529
test4sub31of100,test4pub41of100,10,191,9,6424,1,6434
test4sub31of100,test4pub42of100,10,192,10,6293,0,6303
test4sub31of100,test4pub43of100,10,192,10,6190,0,6200
test4sub31of100,test4pub44of100,10,192,10,6116,1,6127
test4sub31of100,test4pub45of100,10,191,9,5976,1,5986
test4sub31of100,test4pub46of100,10,192,10,5791,0,5801
test4sub31of100,test4pub47of100,10,192,10,5716,0,5726
test4sub31of100,test4pub48of100,10,192,10,5661,1,5672
test4sub31of100,test4pub49of100,10,192,11,5254,1,5266
test4sub31of100,test4pub50of100,10,192,12,5177,0,5189
test4sub31of100,test4pub51of100,10,191,9,5089,1,5099
test4sub31of100,test4pub52of100,10,191,9,5024,1,5034
test4sub37of100,test4pub59of100,10,192,15,2679,1,2695
test4sub46of100,test4pub55of100,10,192,18,1842,3002,4862
test4sub37of100,test4pub60of100,10,192,18,2301,4,2323
test4sub54of100,test4pub63of100,10,192,10,2107,4,2121
test4sub35of100,test4pub13of100,10,192,11,8061,3009,11081
test4sub71of100,test4pub52of100,10,191,9,2520,3009,5538
test4sub65of100,test4pub63of100,10,192,10,2200,6,2216
test4sub29of100,test4pub57of100,10,192,10,1169,3009,4188
test4sub90of100,test4pub54of100,10,192,10,2055,3008,5073
test4sub75of100,test4pub44of100,10,192,10,3624,3009,6643
test4sub64of100,test4pub5of100,10,191,17,9435,3009,12461
test4sub92of100,test4pub63of100,10,192,10,2096,6,2112
test4sub38of100,test4pub47of100,10,192,10,3228,3010,6248
test4sub91of100,test4pub57of100,10,192,10,1174,3008,4192
test4sub21of100,test4pub56of100,10,192,10,1631,3001,4642
test4sub60of100,test4pub63of100,10,192,10,2229,12,2251
test4sub46of100,test4pub56of100,10,192,10,5274,13,5297
test4sub89of100,test4pub60of100,10,192,18,2811,13,2842
test4sub73of100,test4pub63of100,10,192,10,2059,16,2085
test4sub18of100,test4pub58of100,10,192,11,3263,17,3291
test4sub61of100,test4pub63of100,10,192,10,2046,18,2074
test4sub100of100,test4pub60of100,10,192,18,2798,19,2835
test4sub14of100,test4pub60of100,10,192,18,2796,21,2835
test4sub62of100,test4pub60of100,10,192,18,2782,21,2821
test4sub59of100,test4pub58of100,10,192,11,3235,22,3268
test4sub94of100,test4pub60of100,10,192,18,2754,24,2796
test4sub54of100,test4pub64of100,10,192,11,1781,25,1817
test4sub35of100,test4pub12of100,10,191,9,11740,28,11777
test4sub71of100,test4pub53of100,10,192,10,5837,29,5876
test4sub65of100,test4pub64of100,10,192,11,1782,32,1825
test4sub29of100,test4pub58of100,10,192,11,3824,33,3868
test4sub75of100,test4pub45of100,10,191,9,7141,32,7182
test4sub64of100,test4pub6of100,10,191,11,12653,32,12696
test4sub38of100,test4pub48of100,10,192,10,6823,32,6865
test4sub21of100,test4pub57of100,10,192,10,4829,33,4872
test4sub45of100,test4pub21of100,10,192,13,10104,32,10149
test4sub6of100,test4pub62of100,10,192,10,2075,34,2119
test4sub24of100,test4pub62of100,10,192,10,2042,34,2086
test4sub5of100,test4pub63of100,10,192,10,1902,35,1947
test4sub50of100,test4pub57of100,10,192,10,4105,35,4150
test4sub86of100,test4pub64of100,10,192,11,1051,36,1098
test4sub10of100,test4pub64of100,10,192,11,1049,35,1095
test4sub60of100,test4pub64of100,10,192,11,1789,36,1836
test4sub82of100,test4pub63of100,10,192,10,1874,36,1920
test4sub43of100,test4pub63of100,10,192,10,1873,37,1920
test4sub93of100,test4pub64of100,10,192,11,1044,37,1092
test4sub48of100,test4pub64of100,10,192,11,1043,37,1091
test4sub34of100,test4pub64of100,10,192,11,1042,37,1090
test4sub55of100,test4pub63of100,10,192,10,1869,37,1916
test4sub70of100,test4pub62of100,10,192,10,2005,37,2052
test4sub56of100,test4pub64of100,10,192,11,1036,39,1086
test4sub25of100,test4pub61of100,10,192,12,2114,38,2164
test4sub74of100,test4pub57of100,10,192,10,4072,39,4121
test4sub89of100,test4pub61of100,10,192,12,2873,40,2925
test4sub66of100,test4pub57of100,10,192,10,4070,41,4121
test4sub51of100,test4pub57of100,10,192,10,4068,41,4119
test4sub12of100,test4pub63of100,10,192,10,1848,41,1899
test4sub49of100,test4pub64of100,10,192,11,1020,41,1072
test4sub47of100,test4pub63of100,10,192,10,1846,41,1897
test4sub18of100,test4pub59of100,10,192,15,3760,42,3817
test4sub15of100,test4pub62of100,10,192,10,1979,43,2032
test4sub72of100,test4pub57of100,10,192,10,4056,44,4110
test4sub26of100,test4pub61of100,10,192,12,2090,44,2146
test4sub61of100,test4pub64of100,10,192,11,1797,45,1853
test4sub20of100,test4pub61of100,10,192,12,2089,46,2147
test4sub27of100,test4pub62of100,10,192,10,1951,45,2006
test4sub28of100,test4pub61of100,10,192,12,2048,47,2107
test4sub100of100,test4pub61of100,10,192,12,2879,47,2938
test4sub97of100,test4pub49of100,10,192,11,5587,47,5645
test4sub30of100,test4pub63of100,10,192,10,1783,48,1841
test4sub81of100,test4pub63of100,10,192,10,1773,48,1831
test4sub14of100,test4pub61of100,10,192,12,2880,49,2941
test4sub8of100,test4pub62of100,10,192,10,1909,49,1968
test4sub9of100,test4pub60of100,10,192,18,2527,49,2594
test4sub78of100,test4pub57of100,10,192,10,3977,50,4037
test4sub69of100,test4pub63of100,10,192,10,1759,50,1819
test4sub36of100,test4pub58of100,10,192,11,2969,51,3031
test4sub79of100,test4pub57of100,10,192,10,3969,51,4030
test4sub59of100,test4pub59of100,10,192,15,3768,51,3834
test4sub19of100,test4pub47of100,10,192,10,6017,52,6079
test4sub63of100,test4pub60of100,10,192,18,2509,52,2579
test4sub39of100,test4pub63of100,10,192,10,1744,53,1807
test4sub2of100,test4pub62of100,10,192,10,1879,54,1943
test4sub16of100,test4pub60of100,10,192,18,2487,54,2559
test4sub88of100,test4pub60of100,10,192,18,2486,54,2558
test4sub4of100,test4pub60of100,10,192,18,2485,55,2558
test4sub98of100,test4pub60of100,10,192,18,2483,56,2557
test4sub77of100,test4pub60of100,10,192,18,2482,55,2555
test4sub13of100,test4pub60of100,10,192,18,2477,57,2552
test4sub83of100,test4pub59of100,10,192,15,2856,58,2929
test4sub40of100,test4pub60of100,10,192,18,2475,61,2554
test4sub41of100,test4pub60of100,10,192,18,2474,60,2552
test4sub52of100,test4pub59of100,10,192,15,2846,62,2923
test4sub11of100,test4pub59of100,10,192,15,2764,62,2841
test4sub35of100,test4pub14of100,10,192,10,11712,63,11785
test4sub85of100,test4pub60of100,10,192,18,2383,65,2466
test4sub44of100,test4pub60of100,10,192,18,2372,64,2454
test4sub53of100,test4pub59of100,10,192,15,2748,66,2829
test4sub71of100,test4pub54of100,10,192,10,5741,65,5816
test4sub67of100,test4pub59of100,10,192,15,2701,67,2783
test4sub57of100,test4pub59of100,10,192,15,2686,66,2767
test4sub94of100,test4pub61of100,10,192,12,2886,67,2965
test4sub62of100,test4pub61of100,10,192,12,2882,69,2963
test4sub73of100,test4pub64of100,10,192,11,1794,69,1874
test4sub92of100,test4pub64of100,10,192,11,1785,69,1865
test4sub75of100,test4pub46of100,10,192,10,6987,66,7063
test4sub29of100,test4pub59of100,10,192,15,3780,67,3862
test4sub64of100,test4pub7of100,10,191,17,12401,67,12485
test4sub38of100,test4pub49of100,10,192,11,6448,67,6526
test4sub21of100,test4pub58of100,10,192,11,3860,67,3938
test4sub45of100,test4pub22of100,10,192,10,10702,67,10779
test4sub6of100,test4pub63of100,10,192,10,2649,67,2726
test4sub24of100,test4pub63of100,10,192,10,2650,67,2727
test4sub50of100,test4pub58of100,10,192,11,3864,67,3942
test4sub60of100,test4pub65of100,10,192,10,191,66,267
test4sub82of100,test4pub64of100,10,192,11,1826,67,1904
test4sub43of100,test4pub64of100,10,192,11,1827,65,1903
test4sub55of100,test4pub64of100,10,192,11,1829,63,1903
test4sub70of100,test4pub63of100,10,192,10,2658,64,2732
test4sub25of100,test4pub62of100,10,192,10,2796,62,2868
test4sub91of100,test4pub58of100,10,192,11,3826,210,4047
test4sub46of100,test4pub57of100,10,192,10,4833,210,5053
test4sub50of100,test4pub59of100,10,192,15,3856,19,3890
test4sub24of100,test4pub64of100,10,192,11,1890,20,1921
test4sub87of100,test4pub62of100,10,192,10,3255,4,3269
test4sub6of100,test4pub64of100,10,192,11,1889,21,1921
test4sub45of100,test4pub23of100,10,192,17,10586,23,10626
test4sub21of100,test4pub59of100,10,192,15,3851,22,3888
test4sub87of100,test4pub63of100,10,192,10,3263,17,3290
test4sub60of100,test4pub66of100,10,192,17,168,19,204
test4sub46of100,test4pub58of100,10,192,11,4474,21,4506
test4sub38of100,test4pub50of100,10,192,12,6438,24,6474
test4sub64of100,test4pub9of100,10,191,16,12292,24,12332
test4sub29of100,test4pub60of100,10,192,18,3468,25,3511
test4sub75of100,test4pub47of100,10,192,10,6979,25,7014
test4sub84of100,test4pub62of100,10,192,10,3166,26,3202
test4sub62of100,test4pub62of100,10,192,10,2847,26,2883
test4sub95of100,test4pub58of100,10,192,11,4249,28,4288
test4sub33of100,test4pub62of100,10,192,10,2845,28,2883
test4sub94of100,test4pub62of100,10,192,10,2845,28,2883
test4sub57of100,test4pub60of100,10,192,18,3463,28,3509
test4sub71of100,test4pub55of100,10,192,18,5475,30,5523
test4sub53of100,test4pub60of100,10,192,18,3461,30,3509
test4sub44of100,test4pub61of100,10,192,12,2956,31,2999
test4sub85of100,test4pub61of100,10,192,12,2955,31,2998
test4sub35of100,test4pub15of100,10,192,10,11666,33,11709
test4sub48of100,test4pub65of100,10,192,10,239,32,281
test4sub11of100,test4pub60of100,10,192,18,3456,33,3507
test4sub52of100,test4pub60of100,10,192,18,3456,34,3508
test4sub41of100,test4pub61of100,10,192,12,2950,36,2998
test4sub40of100,test4pub61of100,10,192,12,2950,35,2997
test4sub83of100,test4pub60of100,10,192,18,3452,37,3507
test4sub93of100,test4pub65of100,10,192,10,233,37,280
test4sub21of100,test4pub60of100,10,192,18,4035,15,4068
test4sub49of100,test4pub65of100,10,192,10,232,37,279
test4sub45of100,test4pub24of100,10,192,15,11051,16,11082
test4sub13of100,test4pub61of100,10,192,12,2946,38,2996
test4sub77of100,test4pub61of100,10,192,12,2944,39,2995
test4sub87of100,test4pub64of100,10,192,11,2452,16,2479
test4sub98of100,test4pub61of100,10,192,12,2943,40,2995
test4sub4of100,test4pub61of100,10,192,12,2942,41,2995
test4sub60of100,test4pub67of100,10,192,11,514,17,542
test4sub46of100,test4pub59of100,10,192,15,4418,15,4448
test4sub88of100,test4pub61of100,10,192,12,2941,41,2994
test4sub16of100,test4pub61of100,10,192,12,2940,43,2995
test4sub38of100,test4pub51of100,10,191,9,6917,17,6943
test4sub2of100,test4pub63of100,10,192,10,2688,42,2740
test4sub39of100,test4pub64of100,10,192,11,1858,44,1913
test4sub63of100,test4pub61of100,10,192,12,2938,44,2994
test4sub64of100,test4pub8of100,10,191,17,12911,18,12946
test4sub91of100,test4pub59of100,10,192,15,4396,43,4454
test4sub19of100,test4pub48of100,10,192,10,6894,45,6949
test4sub59of100,test4pub60of100,10,192,18,3440,45,3503
test4sub36of100,test4pub59of100,10,192,15,3819,46,3880
test4sub69of100,test4pub64of100,10,192,11,1853,47,1911
test4sub24of100,test4pub65of100,10,192,10,800,42,852
test4sub78of100,test4pub58of100,10,192,11,3894,47,3952
test4sub9of100,test4pub61of100,10,192,12,2931,48,2991
test4sub29of100,test4pub61of100,10,192,12,3536,23,3571
test4sub8of100,test4pub63of100,10,192,10,2679,49,2738
test4sub75of100,test4pub48of100,10,192,10,7495,22,7527
test4sub81of100,test4pub64of100,10,192,11,1850,50,1911
test4sub14of100,test4pub62of100,10,192,10,3422,22,3454
test4sub34of100,test4pub65of100,10,192,10,214,51,275
test4sub62of100,test4pub63of100,10,192,10,3286,23,3319
test4sub30of100,test4pub64of100,10,192,11,1848,50,1909
test4sub97of100,test4pub50of100,10,192,12,6399,51,6462
test4sub28of100,test4pub62of100,10,192,10,2811,52,2873
test4sub27of100,test4pub63of100,10,192,10,2673,53,2736
test4sub20of100,test4pub62of100,10,192,10,2810,53,2873
test4sub61of100,test4pub65of100,10,192,10,209,55,274
test4sub95of100,test4pub59of100,10,192,15,4422,26,4463
test4sub26of100,test4pub62of100,10,192,10,2808,54,2872
test4sub56of100,test4pub65of100,10,192,10,206,56,272
test4sub72of100,test4pub58of100,10,192,11,3882,55,3948
test4sub15of100,test4pub63of100,10,192,10,2667,57,2734
test4sub18of100,test4pub60of100,10,192,18,3423,57,3498
test4sub54of100,test4pub65of100,10,192,10,203,58,271
test4sub47of100,test4pub64of100,10,192,11,1837,58,1906
test4sub12of100,test4pub64of100,10,192,11,1836,60,1907
test4sub89of100,test4pub62of100,10,192,10,2799,61,2870
test4sub65of100,test4pub65of100,10,192,10,200,61,271
test4sub74of100,test4pub58of100,10,192,11,3873,62,3946
test4sub33of100,test4pub63of100,10,192,10,3287,29,3326
test4sub94of100,test4pub63of100,10,192,10,3287,34,3331
test4sub70of100,test4pub64of100,10,192,11,1894,33,1938
test4sub100of100,test4pub62of100,10,192,10,3378,32,3420
test4sub57of100,test4pub61of100,10,192,12,3540,38,3590
test4sub67of100,test4pub60of100,10,192,18,3868,29,3915
test4sub80of100,test4pub62of100,10,192,10,3094,26,3130
test4sub71of100,test4pub56of100,10,192,10,5958,38,6006
test4sub7of100,test4pub60of100,10,192,18,3647,23,3688
test4sub44of100,test4pub62of100,10,192,10,3426,39,3475
test4sub85of100,test4pub62of100,10,192,10,3427,39,3476
test4sub48of100,test4pub66of100,10,192,17,702,40,759
test4sub11of100,test4pub61of100,10,192,12,3543,39,3594
test4sub41of100,test4pub62of100,10,192,10,3429,40,3479
test4sub83of100,test4pub61of100,10,192,12,3544,39,3595
test4sub40of100,test4pub62of100,10,192,10,3429,40,3479
test4sub93of100,test4pub66of100,10,192,17,705,39,761
test4sub49of100,test4pub66of100,10,192,17,706,39,762
test4sub13of100,test4pub62of100,10,192,10,3432,38,3480
test4sub45of100,test4pub25of100,10,192,10,10999,39,11048
test4sub77of100,test4pub62of100,10,192,10,3433,39,3482
test4sub87of100,test4pub65of100,10,192,10,835,40,885
test4sub98of100,test4pub62of100,10,192,10,3434,39,3483
test4sub4of100,test4pub62of100,10,192,10,3435,40,3485
test4sub88of100,test4pub62of100,10,192,10,3436,39,3485
test4sub46of100,test4pub60of100,10,192,18,4054,39,4111
test4sub16of100,test4pub62of100,10,192,10,3437,39,3486
test4sub38of100,test4pub52of100,10,191,9,6868,39,6916
test4sub39of100,test4pub65of100,10,192,10,839,39,888
test4sub64of100,test4pub10of100,10,192,10,12838,39,12887
test4sub19of100,test4pub49of100,10,192,11,7105,38,7154
test4sub91of100,test4pub60of100,10,192,18,4059,39,4116
test4sub69of100,test4pub65of100,10,192,10,842,38,890
test4sub24of100,test4pub66of100,10,192,17,717,39,773
test4sub78of100,test4pub59of100,10,192,15,4441,39,4495
test4sub9of100,test4pub62of100,10,192,10,3443,40,3493
test4sub8of100,test4pub64of100,10,192,11,2479,39,2529
test4sub81of100,test4pub65of100,10,192,10,846,39,895
test4sub34of100,test4pub66of100,10,192,17,721,40,778
test4sub62of100,test4pub64of100,10,192,11,2482,40,2533
test4sub30of100,test4pub65of100,10,192,10,849,39,898
test4sub28of100,test4pub63of100,10,192,10,3311,41,3362
test4sub20of100,test4pub63of100,10,192,10,3312,40,3362
test4sub27of100,test4pub64of100,10,192,11,2484,42,2537
test4sub61of100,test4pub66of100,10,192,17,725,41,783
test4sub95of100,test4pub60of100,10,192,18,4070,41,4129
test4sub56of100,test4pub66of100,10,192,17,727,40,784
test4sub15of100,test4pub64of100,10,192,11,2487,40,2538
test4sub18of100,test4pub61of100,10,192,12,3568,40,3620
test4sub54of100,test4pub66of100,10,192,17,728,41,786
test4sub47of100,test4pub65of100,10,192,10,855,41,906
test4sub89of100,test4pub63of100,10,192,10,3317,40,3367
test4sub65of100,test4pub66of100,10,192,17,730,40,787
test4sub74of100,test4pub59of100,10,192,15,4454,41,4510
test4sub25of100,test4pub63of100,10,192,10,2723,41,2774
test4sub33of100,test4pub64of100,10,192,11,2491,41,2543
test4sub26of100,test4pub63of100,10,192,10,3314,43,3367
test4sub72of100,test4pub59of100,10,192,15,4451,43,4509
test4sub97of100,test4pub51of100,10,191,9,6946,43,6998
test4sub14of100,test4pub63of100,10,192,10,3309,44,3363
test4sub75of100,test4pub49of100,10,192,11,7110,44,7165
test4sub29of100,test4pub62of100,10,192,10,3444,44,3498
test4sub94of100,test4pub64of100,10,192,11,2494,45,2550
test4sub36of100,test4pub60of100,10,192,18,4060,45,4123
test4sub59of100,test4pub61of100,10,192,12,3556,46,3614
test4sub63of100,test4pub62of100,10,192,10,3439,46,3495
test4sub21of100,test4pub61of100,10,192,12,3546,48,3606
test4sub52of100,test4pub61of100,10,192,12,3543,47,3602
test4sub35of100,test4pub16of100,10,192,10,12170,48,12228
test4sub70of100,test4pub65of100,10,192,10,862,47,919
test4sub53of100,test4pub61of100,10,192,12,3541,48,3601
test4sub100of100,test4pub63of100,10,192,10,3325,49,3384
test4sub53of100,test4pub62of100,10,192,10,3511,14,3535
test4sub70of100,test4pub66of100,10,192,17,784,15,816
test4sub35of100,test4pub17of100,10,192,17,11973,15,12005
test4sub21of100,test4pub62of100,10,192,10,3508,16,3534
test4sub63of100,test4pub63of100,10,192,10,3369,17,3396
test4sub100of100,test4pub64of100,10,192,11,2546,1,2558
test4sub59of100,test4pub62of100,10,192,10,3506,16,3532
test4sub36of100,test4pub61of100,10,192,12,3620,18,3650
test4sub94of100,test4pub65of100,10,192,10,905,18,933
test4sub75of100,test4pub50of100,10,192,12,7090,19,7121
test4sub51of100,test4pub58of100,10,192,11,4692,4,4707
test4sub35of100,test4pub18of100,10,192,15,12159,2,12176
test4sub14of100,test4pub64of100,10,192,11,2537,20,2568
test4sub97of100,test4pub52of100,10,191,9,6933,20,6962
test4sub72of100,test4pub60of100,10,192,18,4119,21,4158
test4sub26of100,test4pub64of100,10,192,11,2535,21,2567
test4sub33of100,test4pub65of100,10,192,10,900,22,932
test4sub100of100,test4pub65of100,10,192,10,1118,4,1132
test4sub25of100,test4pub64of100,10,192,11,2533,22,2566
test4sub74of100,test4pub60of100,10,192,18,4116,24,4158
test4sub21of100,test4pub63of100,10,192,10,3579,6,3595
test4sub65of100,test4pub67of100,10,192,11,593,23,627
test4sub36of100,test4pub62of100,10,192,10,3717,7,3734
test4sub89of100,test4pub64of100,10,192,11,2530,24,2565
test4sub47of100,test4pub66of100,10,192,17,770,24,811
test4sub94of100,test4pub66of100,10,192,17,993,8,1018
test4sub18of100,test4pub62of100,10,192,10,3494,26,3530
test4sub15of100,test4pub65of100,10,192,10,894,25,929
test4sub95of100,test4pub61of100,10,192,12,3607,27,3646
test4sub27of100,test4pub65of100,10,192,10,892,28,930
test4sub75of100,test4pub51of100,10,191,9,7217,9,7235
test4sub20of100,test4pub64of100,10,192,11,2524,29,2564
test4sub28of100,test4pub64of100,10,192,11,2524,28,2563
test4sub35of100,test4pub19of100,10,192,18,12137,11,12166
test4sub62of100,test4pub65of100,10,192,10,888,30,928
test4sub30of100,test4pub66of100,10,192,17,763,30,810
test4sub97of100,test4pub53of100,10,192,10,6811,11,6832
test4sub34of100,test4pub67of100,10,192,11,582,32,625
test4sub81of100,test4pub66of100,10,192,17,760,31,808
test4sub8of100,test4pub65of100,10,192,10,885,33,928
test4sub9of100,test4pub63of100,10,192,10,3347,33,3390
test4sub72of100,test4pub61of100,10,192,12,3836,13,3861
test4sub78of100,test4pub60of100,10,192,18,4101,33,4152
test4sub33of100,test4pub66of100,10,192,17,997,13,1027
test4sub24of100,test4pub67of100,10,192,11,578,33,622
test4sub100of100,test4pub66of100,10,192,17,997,13,1027
test4sub69of100,test4pub66of100,10,192,17,756,35,808
test4sub74of100,test4pub61of100,10,192,12,3838,13,3863
test4sub91of100,test4pub61of100,10,192,12,3595,35,3642
test4sub65of100,test4pub69of100,10,192,14,351,13,378
test4sub64of100,test4pub11of100,10,192,11,12759,35,12805
test4sub36of100,test4pub63of100,10,192,10,3588,14,3612
test4sub39of100,test4pub66of100,10,192,17,753,37,807
test4sub38of100,test4pub53of100,10,192,10,6567,38,6615
test4sub46of100,test4pub61of100,10,192,12,3591,39,3642
test4sub87of100,test4pub66of100,10,192,17,749,40,806
test4sub89of100,test4pub65of100,10,192,10,1126,14,1150
test4sub45of100,test4pub26of100,10,192,11,10949,41,11001
test4sub47of100,test4pub67of100,10,192,11,822,17,850
test4sub49of100,test4pub67of100,10,192,11,567,42,620
test4sub48of100,test4pub67of100,10,192,11,564,45,620
test4sub94of100,test4pub67of100,10,192,11,822,18,851
test4sub60of100,test4pub69of100,10,192,14,94,45,153
test4sub80of100,test4pub63of100,10,192,10,3327,47,3384
test4sub18of100,test4pub63of100,10,192,10,3590,19,3619
test4sub71of100,test4pub57of100,10,192,10,5542,47,5599
test4sub7of100,test4pub61of100,10,192,12,3579,46,3637
test4sub67of100,test4pub61of100,10,192,12,3578,46,3636
test4sub84of100,test4pub63of100,10,192,10,3285,47,3342
test4sub57of100,test4pub62of100,10,192,10,3463,47,3520
test4sub95of100,test4pub62of100,10,192,10,3728,22,3760
test4sub75of100,test4pub52of100,10,191,9,7160,22,7191
test4sub63of100,test4pub64of100,10,192,11,2751,10,2772
test4sub35of100,test4pub20of100,10,192,10,11794,23,11827
test4sub27of100,test4pub66of100,10,192,17,1003,27,1047
test4sub20of100,test4pub65of100,10,192,10,1131,27,1168
test4sub28of100,test4pub65of100,10,192,10,1131,26,1167
test4sub62of100,test4pub66of100,10,192,17,1006,26,1049
test4sub97of100,test4pub54of100,10,192,10,6697,26,6733
test4sub34of100,test4pub68of100,10,192,10,611,26,647
test4sub8of100,test4pub66of100,10,192,17,1008,26,1051
test4sub72of100,test4pub62of100,10,192,10,3734,26,3770
test4sub9of100,test4pub64of100,10,192,11,2769,27,2807
test4sub78of100,test4pub61of100,10,192,12,3850,27,3889
test4sub24of100,test4pub68of100,10,192,10,614,26,650
test4sub69of100,test4pub67of100,10,192,11,833,26,870
test4sub91of100,test4pub62of100,10,192,10,3738,25,3773
test4sub64of100,test4pub12of100,10,191,9,12733,27,12769
test4sub36of100,test4pub64of100,10,192,11,2774,26,2811
test4sub39of100,test4pub67of100,10,192,11,836,28,875
test4sub38of100,test4pub54of100,10,192,10,6706,27,6743
test4sub46of100,test4pub62of100,10,192,10,3742,26,3778
test4sub89of100,test4pub66of100,10,192,17,1017,27,1061
test4sub45of100,test4pub27of100,10,192,13,10911,27,10951
test4sub49of100,test4pub68of100,10,192,10,622,27,659
test4sub47of100,test4pub69of100,10,192,14,371,29,414
test4sub48of100,test4pub68of100,10,192,10,623,28,661
test4sub60of100,test4pub68of100,10,192,10,623,27,660
test4sub94of100,test4pub68of100,10,192,10,623,28,661
test4sub80of100,test4pub64of100,10,192,11,2781,27,2819
test4sub18of100,test4pub64of100,10,192,11,2782,29,2822
test4sub71of100,test4pub58of100,10,192,11,4823,29,4863
test4sub7of100,test4pub62of100,10,192,10,3748,29,3787
test4sub57of100,test4pub63of100,10,192,10,3612,27,3649
test4sub84of100,test4pub64of100,10,192,11,2784,28,2823
test4sub67of100,test4pub62of100,10,192,10,3749,29,3788
test4sub87of100,test4pub67of100,10,192,11,838,28,877
test4sub74of100,test4pub62of100,10,192,10,3738,30,3778
test4sub100of100,test4pub67of100,10,192,11,833,29,873
test4sub75of100,test4pub53of100,10,192,10,6842,30,6882
test4sub33of100,test4pub67of100,10,192,11,832,31,874
test4sub15of100,test4pub66of100,10,192,17,1002,31,1050
test4sub63of100,test4pub65of100,10,192,10,1154,32,1196
test4sub14of100,test4pub65of100,10,192,10,1121,33,1164
test4sub51of100,test4pub59of100,10,192,15,4718,32,4765
test4sub59of100,test4pub63of100,10,192,10,3580,32,3622
test4sub35of100,test4pub21of100,10,192,13,11763,32,11808
test4sub53of100,test4pub63of100,10,192,10,3578,34,3622
test4sub95of100,test4pub63of100,10,192,10,3614,33,3657
test4sub27of100,test4pub67of100,10,192,11,852,34,897
test4sub20of100,test4pub66of100,10,192,17,1032,33,1082
test4sub28of100,test4pub66of100,10,192,17,1032,34,1083
test4sub97of100,test4pub55of100,10,192,18,6391,32,6441
test4sub34of100,test4pub69of100,10,192,14,386,34,434
test4sub8of100,test4pub67of100,10,192,11,857,33,901
test4sub72of100,test4pub63of100,10,192,10,3624,33,3667
test4sub78of100,test4pub62of100,10,192,10,3763,33,3806
test4sub69of100,test4pub68of100,10,192,10,642,31,683
test4sub91of100,test4pub63of100,10,192,10,3628,32,3670
test4sub64of100,test4pub13of100,10,192,11,12742,31,12784
test4sub36of100,test4pub65of100,10,192,10,1168,32,1210
test4sub39of100,test4pub68of100,10,192,10,646,30,686
test4sub38of100,test4pub55of100,10,192,18,6400,32,6450
test4sub46of100,test4pub63of100,10,192,10,3633,31,3674
test4sub45of100,test4pub28of100,10,192,18,10844,31,10893
test4sub49of100,test4pub69of100,10,192,14,398,30,442
test4sub94of100,test4pub69of100,10,192,14,401,29,444
test4sub80of100,test4pub65of100,10,192,10,1175,29,1214
test4sub18of100,test4pub65of100,10,192,10,1177,28,1215
test4sub71of100,test4pub59of100,10,192,15,4775,29,4819
test4sub57of100,test4pub64of100,10,192,11,2813,28,2852
test4sub84of100,test4pub65of100,10,192,10,1179,27,1216
test4sub67of100,test4pub63of100,10,192,10,3642,27,3679
test4sub87of100,test4pub69of100,10,192,14,407,28,449
test4sub74of100,test4pub63of100,10,192,10,3644,27,3681
test4sub100of100,test4pub68of100,10,192,10,659,28,697
test4sub33of100,test4pub68of100,10,192,10,661,27,698
test4sub75of100,test4pub54of100,10,192,10,6748,28,6786
test4sub15of100,test4pub67of100,10,192,11,880,27,918
test4sub63of100,test4pub66of100,10,192,17,1060,27,1104
test4sub14of100,test4pub66of100,10,192,17,1061,26,1104
test4sub59of100,test4pub64of100,10,192,11,2822,25,2858
test4sub35of100,test4pub22of100,10,192,10,11705,27,11742
test4sub53of100,test4pub64of100,10,192,11,2824,25,2860
test4sub95of100,test4pub64of100,10,192,11,2824,27,2862
test4sub27of100,test4pub68of100,10,192,10,669,26,705
test4sub20of100,test4pub67of100,10,192,11,887,27,925
test4sub28of100,test4pub67of100,10,192,11,888,26,925
test4sub97of100,test4pub56of100,10,192,10,6325,27,6362
test4sub8of100,test4pub68of100,10,192,10,672,25,707
test4sub72of100,test4pub64of100,10,192,11,2830,27,2868
test4sub78of100,test4pub63of100,10,192,10,3659,25,3694
test4sub8of100,test4pub69of100,10,192,14,448,8,470
test4sub97of100,test4pub57of100,10,192,10,5898,8,5916
test4sub28of100,test4pub68of100,10,192,10,697,10,717
test4sub20of100,test4pub68of100,10,192,10,697,10,717
test4sub65of100,test4pub68of100,10,192,10,745,3,758
test4sub27of100,test4pub69of100,10,192,14,444,10,468
test4sub95of100,test4pub65of100,10,192,10,1218,11,1239
test4sub48of100,test4pub69of100,10,192,14,499,4,517
test4sub53of100,test4pub65of100,10,192,10,1217,12,1239
test4sub35of100,test4pub23of100,10,192,17,11548,12,11577
test4sub59of100,test4pub65of100,10,192,10,1215,13,1238
test4sub97of100,test4pub58of100,10,192,11,5039,4,5054
test4sub14of100,test4pub67of100,10,192,11,909,13,933
test4sub75of100,test4pub55of100,10,192,18,6443,16,6477
test4sub78of100,test4pub64of100,10,192,11,2857,6,2874
test4sub15of100,test4pub68of100,10,192,10,690,14,714
test4sub33of100,test4pub69of100,10,192,14,438,15,467
test4sub74of100,test4pub64of100,10,192,11,2844,17,2872
test4sub87of100,test4pub68of100,10,192,10,687,17,714
test4sub67of100,test4pub64of100,10,192,11,2842,18,2871
test4sub20of100,test4pub69of100,10,192,14,591,7,612
test4sub95of100,test4pub66of100,10,192,17,1240,6,1263
test4sub84of100,test4pub66of100,10,192,17,1082,18,1117
test4sub71of100,test4pub60of100,10,192,18,4425,19,4462
test4sub18of100,test4pub66of100,10,192,17,1080,20,1117
test4sub80of100,test4pub66of100,10,192,17,1079,20,1116
test4sub46of100,test4pub64of100,10,192,11,2836,22,2869
test4sub38of100,test4pub56of100,10,192,10,6333,23,6366
test4sub39of100,test4pub69of100,10,192,14,427,24,465
test4sub36of100,test4pub66of100,10,192,17,1074,23,1114
test4sub64of100,test4pub14of100,10,192,10,12735,25,12770
test4sub45of100,test4pub29of100,10,192,11,10785,21,10817
test4sub91of100,test4pub64of100,10,192,11,2833,25,2869
test4sub69of100,test4pub69of100,10,192,14,424,25,463
test4sub47of100,test4pub68of100,10,192,10,727,5,742
test4sub48of100,test4pub70of100,10,192,10,494,11,515
test4sub24of100,test4pub69of100,10,192,14,488,3,505
test4sub35of100,test4pub24of100,10,192,15,11616,13,11644
test4sub59of100,test4pub66of100,10,192,17,1242,12,1271
test4sub97of100,test4pub59of100,10,192,15,4967,13,4995
test4sub14of100,test4pub69of100,10,192,14,596,13,623
test4sub75of100,test4pub56of100,10,192,10,6502,14,6526
test4sub15of100,test4pub69of100,10,192,14,598,13,625
test4sub78of100,test4pub65of100,10,192,10,1371,14,1395
test4sub67of100,test4pub65of100,10,192,10,1373,12,1395
test4sub95of100,test4pub67of100,10,192,11,1069,14,1094
test4sub84of100,test4pub67of100,10,192,11,1070,13,1094
test4sub18of100,test4pub67of100,10,192,11,1070,14,1095
test4sub46of100,test4pub65of100,10,192,10,1376,13,1399
test4sub45of100,test4pub31of100,10,192,19,10642,12,10673
test4sub64of100,test4pub15of100,10,192,10,12803,13,12826
test4sub71of100,test4pub61of100,10,192,12,4089,13,4114
test4sub47of100,test4pub70of100,10,192,10,506,14,530
test4sub53of100,test4pub66of100,10,192,17,1241,13,1271
test4sub91of100,test4pub65of100,10,192,10,1378,14,1402
test4sub28of100,test4pub69of100,10,192,14,590,15,619
test4sub38of100,test4pub57of100,10,192,10,6053,15,6078
test4sub35of100,test4pub25of100,10,192,10,11547,14,11571
test4sub59of100,test4pub67of100,10,192,11,1077,16,1104
test4sub97of100,test4pub60of100,10,192,18,4601,14,4633
test4sub14of100,test4pub68of100,10,192,10,861,15,886
test4sub75of100,test4pub57of100,10,192,10,6062,14,6086
test4sub78of100,test4pub66of100,10,192,17,1260,13,1290
test4sub67of100,test4pub66of100,10,192,17,1261,15,1293
test4sub84of100,test4pub68of100,10,192,10,865,13,888
test4sub95of100,test4pub68of100,10,192,10,865,14,889
test4sub46of100,test4pub66of100,10,192,17,1264,13,1294
test4sub45of100,test4pub30of100,10,191,9,10897,13,10919
test4sub64of100,test4pub16of100,10,192,10,12734,13,12757
test4sub71of100,test4pub62of100,10,192,10,3991,13,4014
test4sub53of100,test4pub67of100,10,192,11,1089,13,1113
test4sub91of100,test4pub66of100,10,192,17,1268,12,1297
test4sub38of100,test4pub58of100,10,192,11,5071,12,5094
test4sub35of100,test4pub26of100,10,192,11,11472,11,11494
test4sub59of100,test4pub68of100,10,192,10,875,12,897
test4sub97of100,test4pub61of100,10,192,12,4112,11,4135
test4sub75of100,test4pub58of100,10,192,11,5075,11,5097
test4sub78of100,test4pub67of100,10,192,11,1096,10,1117
test4sub67of100,test4pub67of100,10,192,11,1097,11,1119
test4sub84of100,test4pub69of100,10,192,14,628,10,652
test4sub95of100,test4pub69of100,10,192,14,629,10,653
test4sub64of100,test4pub17of100,10,192,17,12468,9,12494
test4sub71of100,test4pub63of100,10,192,10,3868,9,3887
test4sub53of100,test4pub68of100,10,192,10,884,9,903
test4sub38of100,test4pub59of100,10,192,15,5006,8,5029
test4sub35of100,test4pub27of100,10,192,13,11175,8,11196
test4sub59of100,test4pub69of100,10,192,14,636,8,658
test4sub97of100,test4pub62of100,10,192,10,4009,7,4026
test4sub78of100,test4pub68of100,10,192,10,889,7,906
test4sub75of100,test4pub59of100,10,192,15,5009,8,5032
test4sub67of100,test4pub68of100,10,192,10,890,6,906
test4sub64of100,test4pub18of100,10,192,15,12457,6,12478
test4sub38of100,test4pub60of100,10,192,18,4635,5,4658
test4sub35of100,test4pub28of100,10,192,18,11089,7,11114
test4sub97of100,test4pub63of100,10,192,10,3880,5,3895
test4sub78of100,test4pub69of100,10,192,14,645,6,665
test4sub75of100,test4pub60of100,10,192,18,4638,5,4661
test4sub67of100,test4pub69of100,10,192,14,647,6,667
test4sub38of100,test4pub61of100,10,192,12,4136,4,4152
test4sub64of100,test4pub19of100,10,192,18,12438,5,12461
test4sub35of100,test4pub29of100,10,192,11,11006,5,11022
test4sub97of100,test4pub64of100,10,192,11,3058,6,3075
test4sub75of100,test4pub61of100,10,192,12,4140,4,4156
test4sub38of100,test4pub62of100,10,192,10,4027,3,4040
test4sub64of100,test4pub20of100,10,192,10,12090,3,12103
test4sub35of100,test4pub31of100,10,192,19,10695,3,10717
test4sub97of100,test4pub65of100,10,192,10,1430,4,1444
test4sub75of100,test4pub62of100,10,192,10,4030,3,4043
test4sub38of100,test4pub63of100,10,192,10,3894,4,3908
test4sub35of100,test4pub30of100,10,191,9,10940,2,10951
test4sub64of100,test4pub21of100,10,192,13,12041,4,12058
test4sub97of100,test4pub66of100,10,192,17,1308,3,1328
test4sub75of100,test4pub63of100,10,192,10,3897,3,3910
test4sub38of100,test4pub64of100,10,192,11,3070,3,3084
test4sub35of100,test4pub32of100,10,192,11,10627,3,10641
test4sub75of100,test4pub64of100,10,192,11,3073,2,3086
test4sub64of100,test4pub22of100,10,192,10,11953,2,11965
test4sub38of100,test4pub65of100,10,192,10,1439,2,1451
test4sub35of100,test4pub33of100,10,192,16,10342,2,10360
test4sub64of100,test4pub23of100,10,192,17,11774,1,11792
test4sub75of100,test4pub65of100,10,192,10,1441,3,1454
test4sub38of100,test4pub66of100,10,192,17,1316,3,1336
test4sub35of100,test4pub34of100,10,192,11,10283,3,10297
test4sub64of100,test4pub24of100,10,192,15,11693,2,11710
test4sub75of100,test4pub66of100,10,192,17,1320,3,1340
test4sub38of100,test4pub67of100,10,192,11,1141,3,1155
test4sub64of100,test4pub25of100,10,192,10,11614,2,11626
test4sub35of100,test4pub35of100,10,192,15,10008,3,10026
test4sub64of100,test4pub26of100,10,192,11,11526,2,11539
test4sub38of100,test4pub68of100,10,192,10,926,1,937
test4sub35of100,test4pub36of100,10,192,15,9953,1,9969
test4sub64of100,test4pub27of100,10,192,13,11219,1,11233
test4sub38of100,test4pub69of100,10,192,14,678,1,693
test4sub38of100,test4pub70of100,10,192,10,581,0,591
test4sub35of100,test4pub37of100,10,192,10,9919,1,9930
test4sub64of100,test4pub28of100,10,192,18,11126,1,11145
test4sub64of100,test4pub29of100,10,192,11,11038,1,11050
test4sub35of100,test4pub38of100,10,192,10,9701,1,9712
test4sub35of100,test4pub39of100,10,192,19,9272,0,9291
test4sub64of100,test4pub30of100,10,191,9,10965,0,10974
test4sub35of100,test4pub40of100,10,192,11,8998,1,9010
test4sub64of100,test4pub31of100,10,192,19,10725,1,10745
test4sub64of100,test4pub32of100,10,192,11,10651,0,10662
test4sub35of100,test4pub41of100,10,191,9,8905,1,8915
test4sub35of100,test4pub42of100,10,192,10,8775,3,8788
test4sub64of100,test4pub33of100,10,192,16,10365,4,10385
test4sub64of100,test4pub34of100,10,192,11,10306,0,10317
test4sub35of100,test4pub43of100,10,192,10,8675,1,8686
test4sub35of100,test4pub44of100,10,192,10,8601,1,8612
test4sub64of100,test4pub35of100,10,192,15,10029,1,10045
test4sub64of100,test4pub36of100,10,192,15,9972,0,9987
test4sub35of100,test4pub45of100,10,191,9,8461,1,8471
test4sub35of100,test4pub46of100,10,192,10,8277,10,8297
test4sub64of100,test4pub37of100,10,192,10,9937,11,9958
test4sub64of100,test4pub38of100,10,192,10,9728,1,9739
test4sub35of100,test4pub47of100,10,192,10,8212,1,8223
test4sub53of100,test4pub69of100,10,192,14,1046,1,1061
test4sub27of100,test4pub70of100,10,192,10,953,0,963
test4sub64of100,test4pub39of100,10,192,19,9733,1,9753
test4sub35of100,test4pub48of100,10,192,10,8591,1,8602
test4sub64of100,test4pub40of100,10,192,11,9458,1,9470
test4sub35of100,test4pub49of100,10,192,11,8185,2,8198
test4sub64of100,test4pub41of100,10,191,9,9366,1,9376
test4sub35of100,test4pub50of100,10,192,12,8110,1,8123
test4sub64of100,test4pub42of100,10,192,10,9236,0,9246
test4sub35of100,test4pub51of100,10,191,9,8022,1,8032
test4sub64of100,test4pub43of100,10,192,10,9134,1,9145
test4sub64of100,test4pub44of100,10,192,10,9059,0,9069
test4sub35of100,test4pub52of100,10,191,9,7957,1,7967
test4sub35of100,test4pub53of100,10,192,10,7618,8,7636
test4sub64of100,test4pub45of100,10,191,9,8920,8,8937
test4sub64of100,test4pub46of100,10,192,10,8743,0,8753
test4sub35of100,test4pub54of100,10,192,10,7502,1,7513
test4sub35of100,test4pub55of100,10,192,18,7171,1,7190
test4sub64of100,test4pub47of100,10,192,10,8669,1,8680
test4sub35of100,test4pub56of100,10,192,10,7072,1,7083
test4sub64of100,test4pub48of100,10,192,10,8614,1,8625
test4sub35of100,test4pub57of100,10,192,10,6620,0,6630
test4sub64of100,test4pub50of100,10,192,12,8129,1,8142
test4sub35of100,test4pub58of100,10,192,11,5620,1,5632
test4sub64of100,test4pub49of100,10,192,11,8209,1,8221
test4sub35of100,test4pub59of100,10,192,15,5544,1,5560
test4sub64of100,test4pub51of100,10,191,9,8044,1,8054
test4sub64of100,test4pub52of100,10,191,9,7978,9,7996
test4sub35of100,test4pub60of100,10,192,18,5166,9,5193
test4sub64of100,test4pub53of100,10,192,10,7647,1,7658
test4sub35of100,test4pub61of100,10,192,12,4672,1,4685
test4sub35of100,test4pub62of100,10,192,10,4559,1,4570
test4sub64of100,test4pub54of100,10,192,10,7523,1,7534
test4sub64of100,test4pub55of100,10,192,18,7192,0,7210
test4sub35of100,test4pub63of100,10,192,10,4423,1,4434
test4sub64of100,test4pub56of100,10,192,10,7094,1,7105
test4sub35of100,test4pub64of100,10,192,11,3597,1,3609
test4sub64of100,test4pub57of100,10,192,10,6641,1,6652
test4sub35of100,test4pub65of100,10,192,10,1965,1,1976
test4sub35of100,test4pub66of100,10,192,17,1840,0,1857
test4sub64of100,test4pub58of100,10,192,11,5641,1,5653
test4sub64of100,test4pub59of100,10,192,15,5566,10,5591
test4sub35of100,test4pub67of100,10,192,11,1663,10,1684
test4sub35of100,test4pub68of100,10,192,10,1455,0,1465
test4sub35of100,test4pub69of100,10,192,14,1206,1,1221
test4sub66of100,test4pub58of100,10,192,11,6148,1,6160
test4sub66of100,test4pub59of100,10,192,15,6073,1,6089
test4sub37of100,test4pub61of100,10,192,12,2860,3001,5873
test4sub90of100,test4pub55of100,10,192,18,5380,3002,8400
test4sub37of100,test4pub62of100,10,192,10,5781,0,5791
test4sub90of100,test4pub56of100,10,192,10,8314,1,8325
test4sub37of100,test4pub63of100,10,192,10,5646,1,5657
test4sub90of100,test4pub57of100,10,192,10,7862,1,7873
test4sub37of100,test4pub64of100,10,192,11,4820,1,4832
test4sub90of100,test4pub58of100,10,192,11,6861,1,6873
test4sub90of100,test4pub59of100,10,192,15,6786,1,6802
test4sub90of100,test4pub60of100,10,192,18,6407,1,6426
test4sub90of100,test4pub61of100,10,192,12,5905,1,5918
test4sub90of100,test4pub62of100,10,192,10,5791,0,5801
test4sub90of100,test4pub63of100,10,192,10,5656,1,5667
test4sub90of100,test4pub64of100,10,192,11,4829,6,4846
test4sub90of100,test4pub65of100,10,192,10,3202,1,3213
test4sub90of100,test4pub66of100,10,192,17,3077,0,3094
test4sub90of100,test4pub67of100,10,192,11,2899,0,2910
test4sub90of100,test4pub68of100,10,192,10,2683,1,2694
test4sub90of100,test4pub69of100,10,192,14,2433,1,2448
test4sub30of100,test4pub67of100,10,192,11,3240,1,3252
test4sub30of100,test4pub68of100,10,192,10,3024,1,3035
test4sub30of100,test4pub69of100,10,192,14,2774,0,2788
test4sub14of100,test4pub70of100,10,192,10,2832,1,2843
test4sub35of100,test4pub70of100,10,192,10,2927,0,2937
test4sub39of100,test4pub70of100,10,192,10,3166,1,3177
test4sub94of100,test4pub70of100,10,192,10,3599,1,3610
test4sub95of100,test4pub70of100,10,192,10,3650,0,3660
test4sub20of100,test4pub70of100,10,192,10,4642,0,4652
test4sub34of100,test4pub70of100,10,192,10,4822,1,4833
test4sub100of100,test4pub69of100,10,192,14,4978,1,4993
test4sub60of100,test4pub70of100,10,192,10,4883,1,4894
test4sub87of100,test4pub70of100,10,192,10,4928,1,4939
test4sub18of100,test4pub68of100,10,192,10,5398,1,5409
test4sub18of100,test4pub69of100,10,192,14,5148,0,5162
test4sub90of100,test4pub70of100,10,192,10,5060,0,5070
test4sub76of100,test4pub53of100,10,192,10,11628,0,11638
test4sub78of100,test4pub70of100,10,192,10,5067,1,5078
test4sub76of100,test4pub54of100,10,192,10,11505,1,11516
test4sub76of100,test4pub55of100,10,192,18,11173,0,11191
test4sub84of100,test4pub70of100,10,192,10,5135,1,5146
test4sub69of100,test4pub70of100,10,192,10,5154,1,5165
test4sub59of100,test4pub70of100,10,192,10,5157,1,5168
test4sub15of100,test4pub70of100,10,192,10,5160,0,5170
test4sub8of100,test4pub70of100,10,192,10,5160,1,5171
test4sub28of100,test4pub71of100,10,192,11,5026,0,5037
test4sub32of100,test4pub64of100,10,192,11,7716,0,7727
test4sub33of100,test4pub70of100,10,192,10,5213,1,5224
test4sub33of100,test4pub71of100,10,192,11,5077,1,5089
test4sub49of100,test4pub70of100,10,192,10,5218,1,5229
test4sub49of100,test4pub71of100,10,192,11,5081,0,5092
test4sub67of100,test4pub70of100,10,192,10,5226,1,5237
test4sub47of100,test4pub71of100,10,192,11,5090,1,5102
test4sub67of100,test4pub71of100,10,192,11,5090,0,5101
test4sub24of100,test4pub70of100,10,192,10,5236,1,5247
test4sub24of100,test4pub71of100,10,192,11,5100,1,5112
test4sub65of100,test4pub70of100,10,192,10,5240,1,5251
test4sub48of100,test4pub71of100,10,192,11,5102,0,5113
test4sub65of100,test4pub71of100,10,192,11,5104,1,5116
test4sub42of100,test4pub32of100,10,192,11,15309,0,15320
test4sub42of100,test4pub33of100,10,192,16,15023,1,15040
test4sub29of100,test4pub63of100,10,192,10,8597,2,8609
test4sub16of100,test4pub63of100,10,192,10,8597,2,8609
test4sub77of100,test4pub63of100,10,192,10,8598,5,8613
test4sub4of100,test4pub63of100,10,192,10,8599,6,8615
test4sub29of100,test4pub64of100,10,192,11,7771,5,7787
test4sub16of100,test4pub64of100,10,192,11,7773,6,7790
test4sub88of100,test4pub63of100,10,192,10,8601,5,8616
test4sub92of100,test4pub65of100,10,192,10,6140,7,6157
test4sub77of100,test4pub64of100,10,192,11,7775,7,7793
test4sub40of100,test4pub63of100,10,192,10,8603,8,8621
test4sub61of100,test4pub67of100,10,192,11,5837,7,5855
test4sub4of100,test4pub64of100,10,192,11,7777,8,7796
test4sub73of100,test4pub65of100,10,192,10,6144,7,6161
test4sub29of100,test4pub65of100,10,192,10,6144,8,6162
test4sub16of100,test4pub65of100,10,192,10,6146,6,6162
test4sub88of100,test4pub64of100,10,192,11,7780,8,7799
test4sub85of100,test4pub63of100,10,192,10,8609,7,8626
test4sub92of100,test4pub66of100,10,192,17,6022,8,6047
test4sub40of100,test4pub64of100,10,192,11,7783,6,7800
test4sub61of100,test4pub68of100,10,192,10,5627,7,5644
test4sub4of100,test4pub65of100,10,192,10,6151,8,6169
test4sub73of100,test4pub66of100,10,192,17,6025,7,6049
test4sub29of100,test4pub66of100,10,192,17,6026,7,6050
test4sub16of100,test4pub66of100,10,192,17,6027,8,6052
test4sub88of100,test4pub65of100,10,192,10,6154,6,6170
test4sub85of100,test4pub64of100,10,192,11,7789,8,7808
test4sub92of100,test4pub67of100,10,192,11,5851,7,5869
test4sub40of100,test4pub65of100,10,192,10,6156,7,6173
test4sub61of100,test4pub69of100,10,192,14,5383,7,5404
test4sub41of100,test4pub63of100,10,192,10,8620,8,8638
test4sub4of100,test4pub66of100,10,192,17,6033,7,6057
test4sub73of100,test4pub67of100,10,192,11,5854,8,5873
test4sub16of100,test4pub67of100,10,192,11,5856,7,5874
test4sub88of100,test4pub66of100,10,192,17,6036,7,6060
test4sub85of100,test4pub65of100,10,192,10,6163,7,6180
test4sub92of100,test4pub68of100,10,192,10,5640,7,5657
test4sub40of100,test4pub66of100,10,192,17,6039,7,6063
test4sub11of100,test4pub62of100,10,192,10,8764,7,8781
test4sub41of100,test4pub64of100,10,192,11,7800,7,7818
test4sub4of100,test4pub67of100,10,192,11,5863,7,5881
test4sub73of100,test4pub68of100,10,192,10,5645,8,5663
test4sub16of100,test4pub68of100,10,192,10,5646,6,5662
test4sub88of100,test4pub67of100,10,192,11,5865,8,5884
test4sub85of100,test4pub66of100,10,192,17,6045,6,6068
test4sub92of100,test4pub69of100,10,192,14,5397,7,5418
test4sub40of100,test4pub67of100,10,192,11,5868,7,5886
test4sub11of100,test4pub63of100,10,192,10,8635,7,8652
test4sub41of100,test4pub65of100,10,192,10,6175,6,6191
test4sub4of100,test4pub68of100,10,192,10,5652,8,5670
test4sub73of100,test4pub69of100,10,192,14,5402,6,5422
test4sub16of100,test4pub69of100,10,192,14,5403,7,5424
test4sub88of100,test4pub68of100,10,192,10,5655,6,5671
test4sub85of100,test4pub67of100,10,192,11,5873,6,5890
test4sub92of100,test4pub70of100,10,192,10,5307,6,5323
test4sub40of100,test4pub68of100,10,192,10,5657,7,5674
test4sub11of100,test4pub64of100,10,192,11,7815,5,7831
test4sub41of100,test4pub66of100,10,192,17,6056,6,6079
test4sub4of100,test4pub69of100,10,192,14,5409,5,5428
test4sub73of100,test4pub70of100,10,192,10,5310,4,5324
test4sub88of100,test4pub69of100,10,192,14,5411,4,5429
test4sub85of100,test4pub68of100,10,192,10,5662,3,5675
test4sub40of100,test4pub69of100,10,192,14,5413,2,5429
test4sub85of100,test4pub69of100,10,192,14,5416,1,5431
test4sub89of100,test4pub67of100,10,192,11,5892,0,5903
test4sub89of100,test4pub68of100,10,192,10,5675,0,5685
test4sub89of100,test4pub69of100,10,192,14,5426,1,5441
test4sub13of100,test4pub63of100,10,192,10,8669,1,8680
test4sub13of100,test4pub64of100,10,192,11,7842,1,7854
test4sub7of100,test4pub63of100,10,192,10,8671,2,8683
test4sub44of100,test4pub63of100,10,192,10,8671,2,8683
test4sub13of100,test4pub65of100,10,192,10,6211,1,6222
test4sub7of100,test4pub64of100,10,192,11,7845,3,7859
test4sub44of100,test4pub64of100,10,192,11,7846,1,7858
test4sub13of100,test4pub66of100,10,192,17,6087,2,6106
test4sub7of100,test4pub65of100,10,192,10,6214,2,6226
test4sub44of100,test4pub65of100,10,192,10,6214,2,6226
test4sub98of100,test4pub63of100,10,192,10,8677,2,8689
test4sub13of100,test4pub67of100,10,192,11,5911,3,5925
test4sub44of100,test4pub66of100,10,192,17,6091,1,6109
test4sub98of100,test4pub64of100,10,192,11,7852,2,7865
test4sub13of100,test4pub69of100,10,192,14,5445,1,5460
test4sub44of100,test4pub67of100,10,192,11,5914,3,5928
test4sub98of100,test4pub65of100,10,192,10,6221,3,6234
test4sub13of100,test4pub68of100,10,192,10,5698,2,5710
test4sub72of100,test4pub65of100,10,192,10,6222,2,6234
test4sub44of100,test4pub68of100,10,192,10,5700,3,5713
test4sub98of100,test4pub66of100,10,192,17,6098,2,6117
test4sub72of100,test4pub66of100,10,192,17,6099,2,6118
test4sub44of100,test4pub69of100,10,192,14,5453,1,5468
test4sub98of100,test4pub67of100,10,192,11,5922,2,5935
test4sub72of100,test4pub67of100,10,192,11,5923,2,5936
test4sub98of100,test4pub68of100,10,192,10,5706,1,5717
test4sub91of100,test4pub67of100,10,192,11,5925,2,5938
test4sub72of100,test4pub68of100,10,192,10,5708,1,5719
test4sub98of100,test4pub69of100,10,192,14,5457,2,5473
test4sub91of100,test4pub68of100,10,192,10,5710,1,5721
test4sub72of100,test4pub69of100,10,192,14,5459,2,5475
test4sub91of100,test4pub69of100,10,192,14,5461,1,5476
test4sub72of100,test4pub70of100,10,192,10,5362,1,5373
test4sub22of100,test4pub63of100,10,192,10,8700,1,8711
test4sub53of100,test4pub70of100,10,192,10,5369,1,5380
test4sub27of100,test4pub71of100,10,192,11,5231,0,5242
test4sub53of100,test4pub71of100,10,192,11,5232,1,5244
test4sub55of100,test4pub65of100,10,192,10,6244,2,6256
test4sub81of100,test4pub67of100,10,192,11,5941,1,5953
test4sub55of100,test4pub66of100,10,192,17,6121,1,6139
test4sub81of100,test4pub68of100,10,192,10,5724,1,5735
test4sub55of100,test4pub67of100,10,192,11,5944,1,5956
test4sub81of100,test4pub69of100,10,192,14,5475,1,5490
test4sub55of100,test4pub68of100,10,192,10,5727,1,5738
test4sub55of100,test4pub69of100,10,192,14,5478,1,5493
test4sub55of100,test4pub70of100,10,192,10,5380,0,5390
test4sub30of100,test4pub70of100,10,192,10,5420,1,5431
test4sub30of100,test4pub71of100,10,192,11,5283,0,5294
test4sub39of100,test4pub71of100,10,192,11,5285,1,5297
test4sub94of100,test4pub71of100,10,192,11,5375,0,5386
test4sub95of100,test4pub71of100,10,192,11,5382,0,5393
test4sub26of100,test4pub65of100,10,192,10,6397,1,6408
test4sub26of100,test4pub66of100,10,192,17,6272,1,6290
test4sub26of100,test4pub67of100,10,192,11,6094,0,6105
test4sub26of100,test4pub68of100,10,192,10,5878,1,5889
test4sub66of100,test4pub60of100,10,192,18,9620,1,9639
test4sub26of100,test4pub69of100,10,192,14,5629,1,5644
test4sub26of100,test4pub70of100,10,192,10,5531,0,5541
test4sub66of100,test4pub61of100,10,192,12,9118,1,9131
test4sub66of100,test4pub62of100,10,192,10,9005,0,9015
test4sub36of100,test4pub67of100,10,192,11,6107,0,6118
test4sub36of100,test4pub68of100,10,192,10,5891,1,5902
test4sub36of100,test4pub69of100,10,192,14,5641,2,5657
test4sub51of100,test4pub60of100,10,192,18,9633,1,9652
test4sub51of100,test4pub61of100,10,192,12,9131,0,9143
test4sub51of100,test4pub62of100,10,192,10,9018,1,9029
test4sub6of100,test4pub65of100,10,192,10,6419,1,6430
test4sub51of100,test4pub63of100,10,192,10,8882,1,8893
test4sub6of100,test4pub66of100,10,192,17,6295,1,6313
test4sub6of100,test4pub67of100,10,192,11,6117,1,6129
test4sub51of100,test4pub64of100,10,192,11,8056,1,8068
test4sub6of100,test4pub68of100,10,192,10,5901,1,5912
test4sub51of100,test4pub65of100,10,192,10,6424,1,6435
test4sub6of100,test4pub69of100,10,192,14,5652,0,5666
test4sub56of100,test4pub67of100,10,192,11,6122,1,6134
test4sub6of100,test4pub70of100,10,192,10,5555,1,5566
test4sub51of100,test4pub66of100,10,192,17,6300,2,6319
test4sub56of100,test4pub69of100,10,192,14,5655,1,5670
test4sub51of100,test4pub67of100,10,192,11,6125,0,6136
test4sub56of100,test4pub68of100,10,192,10,5908,0,5918
test4sub51of100,test4pub68of100,10,192,10,5909,0,5919
test4sub63of100,test4pub67of100,10,192,11,6137,1,6149
test4sub63of100,test4pub68of100,10,192,10,5920,0,5930
test4sub63of100,test4pub69of100,10,192,14,5671,1,5686
test4sub93of100,test4pub67of100,10,192,11,6163,1,6175
test4sub93of100,test4pub68of100,10,192,10,5947,1,5958
test4sub93of100,test4pub69of100,10,192,14,5697,0,5711
test4sub12of100,test4pub65of100,10,192,10,6490,1,6501
test4sub12of100,test4pub66of100,10,192,17,6365,0,6382
test4sub12of100,test4pub67of100,10,192,11,6188,1,6200
test4sub12of100,test4pub68of100,10,192,10,5971,0,5981
test4sub12of100,test4pub69of100,10,192,14,5721,0,5735
test4sub12of100,test4pub70of100,10,192,10,5624,1,5635
test4sub97of100,test4pub67of100,10,192,11,6225,0,6236
test4sub97of100,test4pub68of100,10,192,10,6009,1,6020
test4sub97of100,test4pub69of100,10,192,14,5759,0,5773
test4sub20of100,test4pub71of100,10,192,11,5580,1,5592
test4sub60of100,test4pub71of100,10,192,11,5581,0,5592
test4sub25of100,test4pub65of100,10,192,10,6595,1,6606
test4sub25of100,test4pub66of100,10,192,17,6470,0,6487
test4sub87of100,test4pub71of100,10,192,11,5585,0,5596
test4sub25of100,test4pub67of100,10,192,11,6293,1,6305
test4sub19of100,test4pub50of100,10,192,12,12784,1,12797
test4sub19of100,test4pub51of100,10,191,9,12697,0,12706
test4sub25of100,test4pub68of100,10,192,10,6077,1,6088
test4sub19of100,test4pub52of100,10,191,9,12632,1,12642
test4sub25of100,test4pub69of100,10,192,14,5828,0,5842
test4sub25of100,test4pub70of100,10,192,10,5731,1,5742
test4sub19of100,test4pub53of100,10,192,10,12293,1,12304
test4sub19of100,test4pub54of100,10,192,10,12169,1,12180
test4sub19of100,test4pub55of100,10,192,18,11838,1,11857
test4sub19of100,test4pub56of100,10,192,10,11739,1,11750
test4sub18of100,test4pub70of100,10,192,10,5735,1,5746
test4sub19of100,test4pub57of100,10,192,10,11287,1,11298
test4sub18of100,test4pub71of100,10,192,11,5599,1,5611
test4sub96of100,test4pub63of100,10,192,10,9081,1,9092
test4sub28of100,test4pub70of100,10,192,10,5750,1,5761
test4sub28of100,test4pub72of100,10,192,18,771,1,790
test4sub24of100,test4pub72of100,10,192,18,783,0,801
test4sub38of100,test4pub71of100,10,192,11,5628,1,5640
test4sub29of100,test4pub67of100,10,192,11,6337,1,6349
test4sub29of100,test4pub68of100,10,192,10,6120,0,6130
test4sub29of100,test4pub69of100,10,192,14,5870,1,5885
test4sub4of100,test4pub70of100,10,192,10,5772,1,5783
test4sub29of100,test4pub70of100,10,192,10,5773,2,5785
test4sub40of100,test4pub70of100,10,192,10,5774,3,5787
test4sub4of100,test4pub71of100,10,192,11,5637,3,5651
test4sub61of100,test4pub71of100,10,192,11,5638,2,5651
test4sub29of100,test4pub71of100,10,192,11,5638,3,5652
test4sub40of100,test4pub71of100,10,192,11,5640,3,5654
test4sub4of100,test4pub72of100,10,192,18,797,3,818
test4sub85of100,test4pub70of100,10,192,10,5779,3,5792
test4sub61of100,test4pub70of100,10,192,10,5780,4,5794
test4sub29of100,test4pub72of100,10,192,18,799,3,820
test4sub40of100,test4pub72of100,10,192,18,801,3,822
test4sub85of100,test4pub71of100,10,192,11,5645,3,5659
test4sub61of100,test4pub72of100,10,192,18,803,1,822
test4sub85of100,test4pub72of100,10,192,18,805,1,824
test4sub44of100,test4pub70of100,10,192,10,5788,0,5798
test4sub22of100,test4pub64of100,10,192,11,8297,1,8309
test4sub44of100,test4pub71of100,10,192,11,5652,1,5664
test4sub22of100,test4pub65of100,10,192,10,6664,1,6675
test4sub44of100,test4pub72of100,10,192,18,811,1,830
test4sub22of100,test4pub66of100,10,192,17,6540,0,6557
test4sub22of100,test4pub67of100,10,192,11,6363,1,6375
test4sub22of100,test4pub68of100,10,192,10,6146,1,6157
test4sub81of100,test4pub70of100,10,192,10,5797,1,5808
test4sub81of100,test4pub71of100,10,192,11,5660,1,5672
test4sub81of100,test4pub72of100,10,192,18,818,0,836
test4sub94of100,test4pub72of100,10,192,18,822,1,841
test4sub95of100,test4pub72of100,10,192,18,826,1,845
test4sub26of100,test4pub71of100,10,192,11,5671,1,5683
test4sub26of100,test4pub72of100,10,192,18,829,0,847
test4sub66of100,test4pub63of100,10,192,10,9151,1,9162
test4sub66of100,test4pub64of100,10,192,11,8324,0,8335
test4sub66of100,test4pub65of100,10,192,10,6692,1,6703
test4sub66of100,test4pub66of100,10,192,17,6567,0,6584
test4sub66of100,test4pub67of100,10,192,11,6389,0,6400
test4sub66of100,test4pub68of100,10,192,10,6173,1,6184
test4sub82of100,test4pub65of100,10,192,10,6755,1,6766
test4sub32of100,test4pub65of100,10,192,10,6757,1,6768
test4sub82of100,test4pub66of100,10,192,17,6631,1,6649
test4sub82of100,test4pub67of100,10,192,11,6454,1,6466
test4sub32of100,test4pub66of100,10,192,17,6633,1,6651
test4sub32of100,test4pub67of100,10,192,11,6456,0,6467
test4sub82of100,test4pub68of100,10,192,10,6237,2,6249
test4sub82of100,test4pub69of100,10,192,14,5989,1,6004
test4sub32of100,test4pub68of100,10,192,10,6240,1,6251
test4sub82of100,test4pub71of100,10,192,11,5754,1,5766
test4sub32of100,test4pub69of100,10,192,14,5991,1,6006
test4sub86of100,test4pub65of100,10,192,10,6768,0,6778
test4sub86of100,test4pub66of100,10,192,17,6643,1,6661
test4sub86of100,test4pub67of100,10,192,11,6466,1,6478
test4sub86of100,test4pub68of100,10,192,10,6250,1,6261
test4sub86of100,test4pub69of100,10,192,14,6000,1,6015
test4sub86of100,test4pub70of100,10,192,10,5902,0,5912
test4sub86of100,test4pub71of100,10,192,11,5766,1,5778
test4sub86of100,test4pub72of100,10,192,18,924,1,943
test4sub36of100,test4pub70of100,10,192,10,5911,1,5922
test4sub36of100,test4pub71of100,10,192,11,5774,1,5786
test4sub36of100,test4pub72of100,10,192,18,932,0,950
test4sub51of100,test4pub69of100,10,192,14,6056,1,6071
test4sub51of100,test4pub70of100,10,192,10,5959,1,5970
test4sub51of100,test4pub71of100,10,192,11,5890,1,5902
test4sub51of100,test4pub72of100,10,192,18,1049,0,1067
test4sub6of100,test4pub71of100,10,192,11,5898,1,5910
test4sub6of100,test4pub72of100,10,192,18,1057,1,1076
test4sub57of100,test4pub65of100,10,192,10,6911,1,6922
test4sub57of100,test4pub66of100,10,192,17,6787,1,6805
test4sub57of100,test4pub67of100,10,192,11,6609,0,6620
test4sub57of100,test4pub68of100,10,192,10,6393,1,6404
test4sub57of100,test4pub69of100,10,192,14,6143,0,6157
test4sub57of100,test4pub70of100,10,192,10,6045,0,6055
test4sub57of100,test4pub71of100,10,192,11,5909,1,5921
test4sub57of100,test4pub72of100,10,192,18,1067,0,1085
test4sub56of100,test4pub70of100,10,192,10,6101,1,6112
test4sub56of100,test4pub71of100,10,192,11,5965,1,5977
test4sub25of100,test4pub71of100,10,192,11,5966,1,5978
test4sub56of100,test4pub72of100,10,192,18,1124,1,1143
test4sub25of100,test4pub72of100,10,192,18,1125,0,1143
test4sub19of100,test4pub58of100,10,192,11,10662,1,10674
test4sub19of100,test4pub59of100,10,192,15,10586,1,10602
test4sub19of100,test4pub60of100,10,192,18,10208,1,10227
test4sub18of100,test4pub72of100,10,192,18,1136,0,1154
test4sub19of100,test4pub61of100,10,192,12,9705,1,9718
test4sub19of100,test4pub62of100,10,192,10,9592,1,9603
test4sub19of100,test4pub63of100,10,192,10,9456,0,9466
test4sub17of100,test4pub63of100,10,192,10,9525,1,9536
test4sub96of100,test4pub64of100,10,192,11,8925,1,8937
test4sub96of100,test4pub65of100,10,192,10,7293,1,7304
test4sub96of100,test4pub66of100,10,192,17,7168,1,7186
test4sub96of100,test4pub67of100,10,192,11,6991,1,7003
test4sub96of100,test4pub68of100,10,192,10,6774,0,6784
test4sub38of100,test4pub72of100,10,192,18,1469,0,1487
test4sub7of100,test4pub66of100,10,192,17,7247,0,7264
test4sub7of100,test4pub67of100,10,192,11,7070,1,7082
test4sub7of100,test4pub69of100,10,192,14,6602,0,6616
test4sub7of100,test4pub68of100,10,192,10,6854,1,6865
test4sub22of100,test4pub69of100,10,192,14,6604,1,6619
test4sub22of100,test4pub70of100,10,192,10,6507,1,6518
test4sub22of100,test4pub71of100,10,192,11,6370,0,6381
test4sub22of100,test4pub72of100,10,192,18,1529,1,1548
test4sub79of100,test4pub58of100,10,192,11,11073,1,11085
test4sub79of100,test4pub59of100,10,192,15,10998,1,11014
test4sub79of100,test4pub60of100,10,192,18,10619,0,10637
test4sub79of100,test4pub61of100,10,192,12,10117,1,10130
test4sub79of100,test4pub62of100,10,192,10,10003,0,10013
test4sub79of100,test4pub63of100,10,192,10,9868,1,9879
test4sub79of100,test4pub64of100,10,192,11,9041,1,9053
test4sub79of100,test4pub65of100,10,192,10,7408,0,7418
test4sub79of100,test4pub66of100,10,192,17,7284,1,7302
test4sub79of100,test4pub67of100,10,192,11,7106,0,7117
test4sub79of100,test4pub68of100,10,192,10,6889,1,6900
test4sub79of100,test4pub69of100,10,192,14,6641,1,6656
test4sub79of100,test4pub70of100,10,192,10,6543,1,6554
test4sub79of100,test4pub71of100,10,192,11,6422,1,6434
test4sub79of100,test4pub72of100,10,192,18,1580,0,1598
test4sub26of100,test4pub73of100,10,192,11,720,1,732
test4sub64of100,test4pub60of100,10,192,18,10672,1,10691
test4sub64of100,test4pub61of100,10,192,12,10169,1,10182
test4sub64of100,test4pub62of100,10,192,10,10056,1,10067
test4sub64of100,test4pub63of100,10,192,10,9920,0,9930
test4sub64of100,test4pub64of100,10,192,11,9094,1,9106
test4sub64of100,test4pub65of100,10,192,10,7461,0,7471
test4sub64of100,test4pub66of100,10,192,17,7385,0,7402
test4sub64of100,test4pub67of100,10,192,11,7208,1,7220
test4sub64of100,test4pub68of100,10,192,10,6991,0,7001
test4sub64of100,test4pub69of100,10,192,14,6746,1,6761
test4sub64of100,test4pub70of100,10,192,10,6648,0,6658
test4sub40of100,test4pub73of100,10,192,11,789,1,801
test4sub64of100,test4pub71of100,10,192,11,6512,1,6524
test4sub29of100,test4pub73of100,10,192,11,817,0,828
test4sub66of100,test4pub69of100,10,192,14,6803,1,6818
test4sub66of100,test4pub70of100,10,192,10,6706,1,6717
test4sub66of100,test4pub71of100,10,192,11,6575,1,6587
test4sub66of100,test4pub72of100,10,192,18,1733,0,1751
test4sub45of100,test4pub32of100,10,192,11,16799,1,16811
test4sub45of100,test4pub33of100,10,192,16,16513,1,16530
test4sub45of100,test4pub34of100,10,192,11,16469,0,16480
test4sub45of100,test4pub35of100,10,192,15,16192,1,16208
test4sub45of100,test4pub36of100,10,192,15,16135,0,16150
test4sub82of100,test4pub70of100,10,192,10,6771,1,6782
test4sub82of100,test4pub72of100,10,192,18,1792,1,1811
test4sub61of100,test4pub73of100,10,192,11,922,1,934
test4sub9of100,test4pub65of100,10,192,10,7666,1,7677
test4sub9of100,test4pub66of100,10,192,17,7544,1,7562
test4sub9of100,test4pub67of100,10,192,11,7366,0,7377
test4sub9of100,test4pub68of100,10,192,10,7150,1,7161
test4sub9of100,test4pub69of100,10,192,14,6900,0,6914
test4sub9of100,test4pub70of100,10,192,10,6803,1,6814
test4sub9of100,test4pub71of100,10,192,11,6666,1,6678
test4sub9of100,test4pub72of100,10,192,18,1824,0,1842
test4sub77of100,test4pub65of100,10,192,10,7709,1,7720
test4sub77of100,test4pub66of100,10,192,17,7584,0,7601
test4sub77of100,test4pub67of100,10,192,11,7406,0,7417
test4sub77of100,test4pub68of100,10,192,10,7190,1,7201
test4sub77of100,test4pub69of100,10,192,14,6940,0,6954
test4sub77of100,test4pub70of100,10,192,10,6869,0,6879
test4sub51of100,test4pub73of100,10,192,11,1011,1,1023
test4sub77of100,test4pub71of100,10,192,11,6733,1,6745
test4sub77of100,test4pub72of100,10,192,18,1892,1,1911
test4sub86of100,test4pub73of100,10,192,11,1033,1,1045
test4sub85of100,test4pub73of100,10,192,11,1033,0,1044
test4sub7of100,test4pub70of100,10,192,10,6917,1,6928
test4sub7of100,test4pub71of100,10,192,11,6781,1,6793
test4sub7of100,test4pub72of100,10,192,18,1939,0,1957
test4sub57of100,test4pub73of100,10,192,11,1063,0,1074
test4sub36of100,test4pub73of100,10,192,11,1084,0,1095
test4sub6of100,test4pub73of100,10,192,11,1088,0,1099
test4sub4of100,test4pub73of100,10,192,11,1089,0,1100
test4sub95of100,test4pub73of100,10,192,11,1123,1,1135
test4sub94of100,test4pub73of100,10,192,11,1147,1,1159
test4sub56of100,test4pub73of100,10,192,11,1153,1,1165
test4sub19of100,test4pub64of100,10,192,11,9540,0,9551
test4sub19of100,test4pub65of100,10,192,10,7908,1,7919
test4sub19of100,test4pub66of100,10,192,17,7783,1,7801
test4sub19of100,test4pub67of100,10,192,11,7606,1,7618
test4sub19of100,test4pub68of100,10,192,10,7389,0,7399
test4sub44of100,test4pub73of100,10,192,11,1210,1,1222
test4sub24of100,test4pub73of100,10,192,11,1211,1,1223
test4sub19of100,test4pub69of100,10,192,14,7200,1,7215
test4sub25of100,test4pub73of100,10,192,11,1242,2,1255
test4sub19of100,test4pub70of100,10,192,10,7103,1,7114
test4sub81of100,test4pub73of100,10,192,11,1245,1,1257
test4sub19of100,test4pub71of100,10,192,11,6967,2,6980
test4sub18of100,test4pub73of100,10,192,11,1263,1,1275
test4sub17of100,test4pub64of100,10,192,11,9645,1,9657
test4sub17of100,test4pub65of100,10,192,10,8012,0,8022
test4sub17of100,test4pub66of100,10,192,17,7888,1,7906
test4sub23of100,test4pub63of100,10,192,10,10476,1,10487
test4sub17of100,test4pub67of100,10,192,11,7711,1,7723
test4sub17of100,test4pub68of100,10,192,10,7494,0,7504
test4sub31of100,test4pub53of100,10,192,10,13711,1,13722
test4sub31of100,test4pub54of100,10,192,10,13587,1,13598
test4sub31of100,test4pub55of100,10,192,18,13255,0,13273
test4sub31of100,test4pub56of100,10,192,10,13157,2,13169
test4sub96of100,test4pub69of100,10,192,14,7253,1,7268
test4sub96of100,test4pub70of100,10,192,10,7156,1,7167
test4sub38of100,test4pub73of100,10,192,11,1296,1,1308
test4sub31of100,test4pub57of100,10,192,10,12705,1,12716
test4sub96of100,test4pub71of100,10,192,11,7019,2,7032
test4sub31of100,test4pub58of100,10,192,11,11707,1,11719
test4sub96of100,test4pub72of100,10,192,18,2179,0,2197
test4sub96of100,test4pub73of100,10,192,11,1301,1,1313
test4sub48of100,test4pub72of100,10,192,18,2181,0,2199
test4sub48of100,test4pub73of100,10,192,11,1304,1,1316
test4sub35of100,test4pub71of100,10,192,11,7034,1,7046
test4sub7of100,test4pub73of100,10,192,11,1313,1,1325
test4sub65of100,test4pub72of100,10,192,18,2193,0,2211
test4sub65of100,test4pub73of100,10,192,11,1316,1,1328
test4sub22of100,test4pub73of100,10,192,11,1319,0,1330
test4sub1of100,test4pub63of100,10,192,10,10516,0,10526
test4sub79of100,test4pub73of100,10,192,11,1327,1,1339
test4sub79of100,test4pub74of100,10,192,10,702,1,713
test4sub14of100,test4pub71of100,10,192,11,7053,1,7065
test4sub26of100,test4pub74of100,10,192,10,708,1,719
test4sub64of100,test4pub72of100,10,192,18,2229,1,2248
test4sub64of100,test4pub73of100,10,192,11,1351,0,1362
test4sub40of100,test4pub74of100,10,192,10,724,1,735
test4sub64of100,test4pub74of100,10,192,10,726,1,737
test4sub29of100,test4pub74of100,10,192,10,727,1,738
test4sub66of100,test4pub73of100,10,192,11,1359,1,1371
test4sub66of100,test4pub74of100,10,192,10,733,0,743
test4sub45of100,test4pub37of100,10,192,10,16560,0,16570
test4sub45of100,test4pub38of100,10,192,10,16342,1,16353
test4sub45of100,test4pub39of100,10,192,19,15912,1,15932
test4sub45of100,test4pub40of100,10,192,11,15639,1,15651
test4sub45of100,test4pub41of100,10,191,9,15547,1,15557
test4sub45of100,test4pub42of100,10,192,10,15416,0,15426
test4sub45of100,test4pub43of100,10,192,10,15314,1,15325
test4sub82of100,test4pub73of100,10,192,11,1374,1,1386
test4sub45of100,test4pub44of100,10,192,10,15239,2,15251
test4sub82of100,test4pub74of100,10,192,10,748,1,759
test4sub61of100,test4pub74of100,10,192,10,749,1,760
test4sub9of100,test4pub73of100,10,192,11,1378,1,1390
test4sub9of100,test4pub74of100,10,192,10,752,1,763
test4sub77of100,test4pub73of100,10,192,11,1380,1,1392
test4sub77of100,test4pub74of100,10,192,10,755,1,766
test4sub51of100,test4pub74of100,10,192,10,758,0,768
test4sub57of100,test4pub74of100,10,192,10,766,1,777
test4sub36of100,test4pub74of100,10,192,10,766,0,776
test4sub56of100,test4pub74of100,10,192,10,768,1,779
test4sub19of100,test4pub72of100,10,192,18,2276,0,2294
test4sub19of100,test4pub73of100,10,192,11,1399,1,1411
test4sub19of100,test4pub74of100,10,192,10,773,1,784
test4sub44of100,test4pub74of100,10,192,10,786,1,797
test4sub17of100,test4pub69of100,10,192,14,7382,0,7396
test4sub17of100,test4pub70of100,10,192,10,7285,1,7296
test4sub17of100,test4pub71of100,10,192,11,7148,0,7159
test4sub17of100,test4pub72of100,10,192,18,2331,0,2349
test4sub17of100,test4pub73of100,10,192,11,1454,1,1466
test4sub17of100,test4pub74of100,10,192,10,828,0,838
test4sub23of100,test4pub64of100,10,192,11,9825,1,9837
test4sub23of100,test4pub65of100,10,192,10,8193,1,8204
test4sub23of100,test4pub66of100,10,192,17,8070,1,8088
test4sub23of100,test4pub67of100,10,192,11,7892,0,7903
test4sub23of100,test4pub68of100,10,192,10,7676,1,7687
test4sub31of100,test4pub59of100,10,192,15,11814,0,11829
test4sub31of100,test4pub60of100,10,192,18,11436,1,11455
test4sub31of100,test4pub61of100,10,192,12,10942,0,10954
test4sub31of100,test4pub62of100,10,192,10,10828,1,10839
test4sub31of100,test4pub63of100,10,192,10,10693,1,10704
test4sub96of100,test4pub74of100,10,192,10,873,1,884
test4sub38of100,test4pub74of100,10,192,10,873,1,884
test4sub35of100,test4pub72of100,10,192,18,2387,0,2405
test4sub1of100,test4pub64of100,10,192,11,9877,1,9889
test4sub35of100,test4pub73of100,10,192,11,1510,1,1522
test4sub1of100,test4pub65of100,10,192,10,8244,2,8256
test4sub35of100,test4pub74of100,10,192,10,884,4,898
test4sub1of100,test4pub66of100,10,192,17,8122,2,8141
test4sub1of100,test4pub67of100,10,192,11,7945,1,7957
test4sub1of100,test4pub68of100,10,192,10,7728,0,7738
test4sub14of100,test4pub72of100,10,192,18,2404,1,2423
test4sub14of100,test4pub73of100,10,192,11,1526,0,1537
test4sub14of100,test4pub74of100,10,192,10,907,2,919
test4sub40of100,test4pub75of100,10,192,10,224,1,235
test4sub45of100,test4pub45of100,10,191,9,15265,1,15275
test4sub45of100,test4pub47of100,10,192,10,15004,1,15015
test4sub29of100,test4pub75of100,10,192,10,232,0,242
test4sub45of100,test4pub46of100,10,192,10,15082,0,15092
test4sub45of100,test4pub48of100,10,192,10,14975,1,14986
test4sub45of100,test4pub49of100,10,192,11,14568,0,14579
test4sub45of100,test4pub50of100,10,192,12,14492,1,14505
test4sub45of100,test4pub51of100,10,191,9,14418,0,14427
test4sub45of100,test4pub52of100,10,191,9,14353,1,14363
test4sub45of100,test4pub53of100,10,192,10,14013,0,14023
test4sub28of100,test4pub73of100,10,192,11,1598,1,1610
test4sub28of100,test4pub74of100,10,192,10,972,0,982
test4sub51of100,test4pub75of100,10,192,10,298,2,310
test4sub56of100,test4pub75of100,10,192,10,299,1,310
test4sub64of100,test4pub75of100,10,192,10,300,2,312
test4sub57of100,test4pub75of100,10,192,10,310,2,322
test4sub17of100,test4pub75of100,10,192,10,311,2,323
test4sub23of100,test4pub69of100,10,192,14,7583,2,7599
test4sub23of100,test4pub71of100,10,192,11,7348,1,7360
test4sub31of100,test4pub64of100,10,192,11,9994,2,10007
test4sub23of100,test4pub70of100,10,192,10,7488,2,7500
test4sub31of100,test4pub65of100,10,192,10,8363,2,8375
test4sub23of100,test4pub72of100,10,192,18,2511,2,2531
test4sub31of100,test4pub66of100,10,192,17,8241,3,8261
test4sub23of100,test4pub73of100,10,192,11,1635,2,1648
test4sub31of100,test4pub67of100,10,192,11,8065,2,8078
test4sub23of100,test4pub74of100,10,192,10,1012,2,1024
test4sub31of100,test4pub68of100,10,192,10,7851,2,7863
test4sub31of100,test4pub69of100,10,192,14,7602,0,7616
test4sub31of100,test4pub70of100,10,192,10,7512,0,7522
test4sub31of100,test4pub71of100,10,192,11,7376,1,7388
test4sub96of100,test4pub75of100,10,192,10,347,1,358
test4sub38of100,test4pub75of100,10,192,10,349,0,359
test4sub35of100,test4pub75of100,10,192,10,349,1,360
test4sub22of100,test4pub74of100,10,192,10,1046,0,1056
test4sub22of100,test4pub75of100,10,192,10,364,1,375
test4sub7of100,test4pub74of100,10,192,10,1204,0,1214
test4sub7of100,test4pub75of100,10,192,10,522,1,533
test4sub1of100,test4pub69of100,10,192,14,7792,1,7807
test4sub1of100,test4pub70of100,10,192,10,7695,1,7706
test4sub1of100,test4pub71of100,10,192,11,7558,0,7569
test4sub1of100,test4pub72of100,10,192,18,2717,1,2736
test4sub1of100,test4pub73of100,10,192,11,1839,0,1850
test4sub1of100,test4pub74of100,10,192,10,1213,0,1223
test4sub1of100,test4pub75of100,10,192,10,531,1,542
test4sub1of100,test4pub76of100,10,192,10,365,0,375
test4sub45of100,test4pub54of100,10,192,10,14144,0,14154
test4sub45of100,test4pub55of100,10,192,18,13813,1,13832
test4sub45of100,test4pub56of100,10,192,10,13715,0,13725
test4sub45of100,test4pub57of100,10,192,10,13263,1,13274
test4sub45of100,test4pub58of100,10,192,11,12262,1,12274
test4sub45of100,test4pub59of100,10,192,15,12186,0,12201
test4sub45of100,test4pub60of100,10,192,18,11808,1,11827
test4sub45of100,test4pub61of100,10,192,12,11305,0,11317
test4sub28of100,test4pub75of100,10,192,10,547,0,557
test4sub58of100,test4pub47of100,10,192,10,15323,2,15335
test4sub45of100,test4pub62of100,10,192,10,11192,2,11204
test4sub28of100,test4pub76of100,10,192,10,382,2,394
test4sub58of100,test4pub48of100,10,192,10,15268,2,15280
test4sub45of100,test4pub63of100,10,192,10,11058,2,11070
test4sub58of100,test4pub49of100,10,192,11,14862,0,14873
test4sub51of100,test4pub76of100,10,192,10,388,3,401
test4sub56of100,test4pub76of100,10,192,10,389,1,400
test4sub58of100,test4pub50of100,10,192,12,14787,1,14800
test4sub64of100,test4pub76of100,10,192,10,390,2,402
test4sub45of100,test4pub64of100,10,192,11,10233,5,10249
test4sub58of100,test4pub51of100,10,191,9,14699,1,14709
test4sub58of100,test4pub52of100,10,191,9,14635,1,14645
test4sub57of100,test4pub76of100,10,192,10,395,1,406
test4sub58of100,test4pub53of100,10,192,10,14295,1,14306
test4sub17of100,test4pub76of100,10,192,10,397,2,409
test4sub58of100,test4pub54of100,10,192,10,14172,2,14184
test4sub31of100,test4pub72of100,10,192,18,2755,1,2774
test4sub31of100,test4pub73of100,10,192,11,1878,0,1889
test4sub58of100,test4pub55of100,10,192,18,13842,1,13861
test4sub58of100,test4pub56of100,10,192,10,13744,1,13755
test4sub31of100,test4pub74of100,10,192,10,1253,1,1264
test4sub58of100,test4pub57of100,10,192,10,13292,1,13303
test4sub58of100,test4pub58of100,10,192,11,12291,0,12302
test4sub58of100,test4pub59of100,10,192,15,12215,1,12231
test4sub58of100,test4pub60of100,10,192,18,11837,0,11855
test4sub31of100,test4pub75of100,10,192,10,583,0,593
test4sub31of100,test4pub76of100,10,192,10,418,1,429
test4sub96of100,test4pub76of100,10,192,10,427,1,438
test4sub38of100,test4pub76of100,10,192,10,428,2,440
test4sub35of100,test4pub76of100,10,192,10,428,1,439
test4sub22of100,test4pub76of100,10,192,10,430,0,440
test4sub75of100,test4pub67of100,10,192,11,8351,1,8363
test4sub75of100,test4pub68of100,10,192,10,8135,1,8146
test4sub7of100,test4pub76of100,10,192,10,447,2,459
test4sub54of100,test4pub67of100,10,192,11,8355,1,8367
test4sub75of100,test4pub69of100,10,192,14,7886,2,7902
test4sub54of100,test4pub68of100,10,192,10,8138,1,8149
test4sub54of100,test4pub69of100,10,192,14,7889,1,7904
test4sub93of100,test4pub70of100,10,192,10,7790,1,7801
test4sub93of100,test4pub71of100,10,192,11,7654,1,7666
test4sub93of100,test4pub72of100,10,192,18,2812,0,2830
test4sub93of100,test4pub73of100,10,192,11,1935,1,1947
test4sub45of100,test4pub65of100,10,192,10,8669,2,8681
test4sub93of100,test4pub74of100,10,192,10,1309,1,1320
test4sub45of100,test4pub66of100,10,192,17,8545,0,8562
test4sub45of100,test4pub67of100,10,192,11,8367,1,8379
test4sub45of100,test4pub68of100,10,192,10,8151,1,8162
test4sub45of100,test4pub69of100,10,192,14,7901,1,7916
test4sub58of100,test4pub61of100,10,192,12,11391,1,11404
test4sub45of100,test4pub70of100,10,192,10,7804,1,7815
test4sub58of100,test4pub62of100,10,192,10,11277,1,11288
test4sub45of100,test4pub71of100,10,192,11,7667,1,7679
test4sub58of100,test4pub63of100,10,192,10,11142,1,11153
test4sub45of100,test4pub72of100,10,192,18,2826,1,2845
test4sub58of100,test4pub64of100,10,192,11,10316,0,10327
test4sub45of100,test4pub73of100,10,192,11,1949,1,1961
test4sub45of100,test4pub74of100,10,192,10,1324,1,1335
test4sub58of100,test4pub65of100,10,192,10,8684,1,8695
test4sub45of100,test4pub75of100,10,192,10,641,1,652
test4sub58of100,test4pub66of100,10,192,17,8566,1,8584
test4sub58of100,test4pub67of100,10,192,11,8389,0,8400
test4sub3of100,test4pub58of100,10,192,11,12369,1,12381
test4sub58of100,test4pub68of100,10,192,10,8173,1,8184
test4sub3of100,test4pub59of100,10,192,15,12294,1,12310
test4sub3of100,test4pub60of100,10,192,18,11916,2,11936
test4sub75of100,test4pub70of100,10,192,10,7826,1,7837
test4sub3of100,test4pub61of100,10,192,12,11414,1,11427
test4sub75of100,test4pub71of100,10,192,11,7689,1,7701
test4sub3of100,test4pub62of100,10,192,10,11301,0,11311
test4sub75of100,test4pub72of100,10,192,18,2848,1,2867
test4sub75of100,test4pub73of100,10,192,11,1971,1,1983
test4sub75of100,test4pub74of100,10,192,10,1345,0,1355
test4sub75of100,test4pub75of100,10,192,10,663,1,674
test4sub54of100,test4pub70of100,10,192,10,7845,1,7856
test4sub54of100,test4pub71of100,10,192,11,7709,1,7721
test4sub54of100,test4pub72of100,10,192,18,2867,1,2886
test4sub93of100,test4pub75of100,10,192,10,678,1,689
test4sub45of100,test4pub76of100,10,192,10,512,1,523
test4sub54of100,test4pub73of100,10,192,11,1990,1,2002
test4sub93of100,test4pub76of100,10,192,10,514,1,525
test4sub54of100,test4pub74of100,10,192,10,1366,1,1377
test4sub54of100,test4pub75of100,10,192,10,683,1,694
test4sub58of100,test4pub69of100,10,192,14,7954,1,7969
test4sub58of100,test4pub70of100,10,192,10,7857,1,7868
test4sub58of100,test4pub71of100,10,192,11,7720,0,7731
test4sub58of100,test4pub72of100,10,192,18,2882,0,2900
test4sub58of100,test4pub73of100,10,192,11,2005,1,2017
test4sub58of100,test4pub74of100,10,192,10,1379,0,1389
test4sub7of100,test4pub77of100,10,192,10,75,1,86
test4sub64of100,test4pub77of100,10,192,10,85,0,95
test4sub17of100,test4pub77of100,10,192,10,90,1,101
test4sub22of100,test4pub77of100,10,192,10,94,1,105
test4sub35of100,test4pub77of100,10,192,10,96,0,106
test4sub1of100,test4pub77of100,10,192,10,109,0,119
test4sub44of100,test4pub75of100,10,192,10,739,1,750
test4sub44of100,test4pub76of100,10,192,10,573,0,583
test4sub96of100,test4pub77of100,10,192,10,122,1,133
test4sub66of100,test4pub75of100,10,192,10,919,1,930
test4sub56of100,test4pub77of100,10,192,10,291,1,302
test4sub66of100,test4pub76of100,10,192,10,753,1,764
test4sub29of100,test4pub76of100,10,192,10,758,1,769
test4sub29of100,test4pub77of100,10,192,10,298,2,310
test4sub28of100,test4pub77of100,10,192,10,299,1,310
test4sub79of100,test4pub75of100,10,192,10,937,1,948
test4sub79of100,test4pub76of100,10,192,10,772,1,783
test4sub58of100,test4pub75of100,10,192,10,961,1,972
test4sub58of100,test4pub76of100,10,192,10,795,0,805
test4sub3of100,test4pub63of100,10,192,10,11476,1,11487
test4sub3of100,test4pub64of100,10,192,11,10649,0,10660
test4sub3of100,test4pub65of100,10,192,10,9017,1,9028
test4sub3of100,test4pub66of100,10,192,17,8892,1,8910
test4sub3of100,test4pub67of100,10,192,11,8714,0,8725
test4sub75of100,test4pub76of100,10,192,10,810,0,820
test4sub3of100,test4pub68of100,10,192,10,8498,1,8509
test4sub75of100,test4pub77of100,10,192,10,351,1,362
test4sub3of100,test4pub69of100,10,192,14,8249,0,8263
test4sub3of100,test4pub70of100,10,192,10,8152,1,8163
test4sub57of100,test4pub77of100,10,192,10,404,1,415
test4sub54of100,test4pub76of100,10,192,10,868,1,879
test4sub54of100,test4pub77of100,10,192,10,409,1,420
test4sub93of100,test4pub77of100,10,192,10,411,0,421
test4sub38of100,test4pub77of100,10,192,10,415,1,426
test4sub51of100,test4pub77of100,10,192,10,449,0,459
test4sub31of100,test4pub77of100,10,192,10,453,1,464
test4sub45of100,test4pub78of100,10,192,12,389,1,402
test4sub45of100,test4pub77of100,10,192,10,457,1,468
test4sub92of100,test4pub71of100,10,192,11,8121,1,8133
test4sub92of100,test4pub72of100,10,192,18,3279,1,3298
test4sub92of100,test4pub73of100,10,192,11,2402,1,2414
test4sub92of100,test4pub74of100,10,192,10,1776,0,1786
test4sub92of100,test4pub75of100,10,192,10,1094,1,1105
test4sub92of100,test4pub76of100,10,192,10,928,1,939
test4sub40of100,test4pub76of100,10,192,10,933,0,943
test4sub40of100,test4pub77of100,10,192,10,473,0,483
test4sub17of100,test4pub78of100,10,192,12,430,0,442
test4sub10of100,test4pub65of100,10,192,10,9201,0,9211
test4sub10of100,test4pub66of100,10,192,17,9077,1,9095
test4sub10of100,test4pub67of100,10,192,11,8899,2,8912
test4sub44of100,test4pub77of100,10,192,10,532,1,543
test4sub22of100,test4pub79of100,10,191,9,387,3,399
test4sub10of100,test4pub68of100,10,192,10,8683,2,8695
test4sub44of100,test4pub78of100,10,192,12,468,3,483
test4sub64of100,test4pub78of100,10,192,12,469,2,483
test4sub96of100,test4pub79of100,10,191,9,391,1,401
test4sub10of100,test4pub69of100,10,192,14,8435,1,8450
test4sub10of100,test4pub70of100,10,192,10,8338,0,8348
test4sub10of100,test4pub71of100,10,192,11,8202,1,8214
test4sub10of100,test4pub72of100,10,192,18,3360,0,3378
test4sub10of100,test4pub73of100,10,192,11,2482,0,2493
test4sub10of100,test4pub74of100,10,192,10,1857,1,1868
test4sub10of100,test4pub75of100,10,192,10,1174,0,1184
test4sub10of100,test4pub76of100,10,192,10,1008,0,1018
test4sub35of100,test4pub78of100,10,192,12,492,1,505
test4sub7of100,test4pub78of100,10,192,12,503,1,516
test4sub1of100,test4pub78of100,10,192,12,506,2,520
test4sub12of100,test4pub71of100,10,192,11,8235,1,8247
test4sub58of100,test4pub77of100,10,192,10,576,1,587
test4sub12of100,test4pub72of100,10,192,18,3393,3,3414
test4sub66of100,test4pub77of100,10,192,10,576,4,590
test4sub58of100,test4pub78of100,10,192,12,510,3,525
test4sub56of100,test4pub78of100,10,192,12,511,4,527
test4sub29of100,test4pub78of100,10,192,12,512,5,529
test4sub12of100,test4pub73of100,10,192,11,2519,5,2535
test4sub28of100,test4pub78of100,10,192,12,515,4,531
test4sub66of100,test4pub78of100,10,192,12,514,5,531
test4sub56of100,test4pub79of100,10,191,9,436,6,451
test4sub79of100,test4pub77of100,10,192,10,583,5,598
test4sub12of100,test4pub74of100,10,192,10,1897,4,1911
test4sub29of100,test4pub79of100,10,191,9,439,7,455
test4sub58of100,test4pub79of100,10,191,9,440,6,455
test4sub28of100,test4pub79of100,10,191,9,441,4,454
test4sub66of100,test4pub79of100,10,191,9,441,5,455
test4sub79of100,test4pub78of100,10,192,12,522,3,537
test4sub3of100,test4pub71of100,10,192,11,8251,3,8265
test4sub12of100,test4pub75of100,10,192,10,1218,4,1232
test4sub79of100,test4pub79of100,10,191,9,447,1,457
test4sub3of100,test4pub72of100,10,192,18,3412,2,3432
test4sub12of100,test4pub76of100,10,192,10,1056,1,1067
test4sub3of100,test4pub73of100,10,192,11,2535,0,2546
test4sub12of100,test4pub77of100,10,192,10,598,2,610
test4sub3of100,test4pub74of100,10,192,10,1911,0,1921
test4sub75of100,test4pub78of100,10,192,12,534,1,547
test4sub57of100,test4pub78of100,10,192,12,535,2,549
test4sub3of100,test4pub75of100,10,192,10,1229,1,1240
test4sub75of100,test4pub79of100,10,191,9,456,3,468
test4sub54of100,test4pub78of100,10,192,12,536,3,551
test4sub57of100,test4pub79of100,10,191,9,458,3,470
test4sub3of100,test4pub76of100,10,192,10,1066,4,1080
test4sub93of100,test4pub78of100,10,192,12,539,6,557
test4sub38of100,test4pub79of100,10,191,9,461,5,475
test4sub54of100,test4pub79of100,10,191,9,462,5,476
test4sub51of100,test4pub78of100,10,192,12,542,5,559
test4sub31of100,test4pub79of100,10,191,9,463,6,478
test4sub45of100,test4pub79of100,10,191,9,464,6,479
test4sub3of100,test4pub77of100,10,192,10,611,5,626
test4sub42of100,test4pub34of100,10,192,11,18121,7,18139
test4sub93of100,test4pub79of100,10,191,9,466,5,480
test4sub38of100,test4pub78of100,10,192,12,545,6,563
test4sub17of100,test4pub79of100,10,191,9,468,4,481
test4sub51of100,test4pub79of100,10,191,9,468,5,482
test4sub31of100,test4pub78of100,10,192,12,549,4,565
test4sub3of100,test4pub78of100,10,192,12,550,3,565
test4sub42of100,test4pub35of100,10,192,15,17850,2,17867
test4sub3of100,test4pub79of100,10,191,9,475,1,485
test4sub42of100,test4pub36of100,10,192,15,17795,1,17811
test4sub42of100,test4pub37of100,10,192,10,17760,0,17770
test4sub10of100,test4pub77of100,10,192,10,623,0,633
test4sub10of100,test4pub78of100,10,192,12,558,1,571
test4sub42of100,test4pub38of100,10,192,10,17542,1,17553
test4sub10of100,test4pub79of100,10,191,9,480,1,490
test4sub44of100,test4pub79of100,10,191,9,484,1,494
test4sub22of100,test4pub78of100,10,192,12,568,1,581
test4sub64of100,test4pub79of100,10,191,9,528,1,538
test4sub7of100,test4pub79of100,10,191,9,529,1,539
test4sub1of100,test4pub79of100,10,191,9,530,1,540
test4sub12of100,test4pub78of100,10,192,12,610,1,623
test4sub12of100,test4pub79of100,10,191,9,532,0,541
test4sub28of100,test4pub80of100,10,192,10,136,0,146
test4sub75of100,test4pub80of100,10,192,10,143,1,154
test4sub57of100,test4pub80of100,10,192,10,155,1,166
test4sub38of100,test4pub80of100,10,192,10,157,1,168
test4sub51of100,test4pub80of100,10,192,10,162,0,172
test4sub42of100,test4pub39of100,10,192,19,17194,1,17214
test4sub42of100,test4pub40of100,10,192,11,16920,1,16932
test4sub56of100,test4pub80of100,10,192,10,166,1,177
test4sub42of100,test4pub41of100,10,191,9,16827,0,16836
test4sub42of100,test4pub42of100,10,192,10,16697,1,16708
test4sub31of100,test4pub80of100,10,192,10,170,1,181
test4sub42of100,test4pub43of100,10,192,10,16594,1,16605
test4sub42of100,test4pub44of100,10,192,10,16521,1,16532
test4sub3of100,test4pub80of100,10,192,10,172,0,182
test4sub17of100,test4pub80of100,10,192,10,174,1,185
test4sub66of100,test4pub80of100,10,192,10,182,0,192
test4sub29of100,test4pub80of100,10,192,10,186,0,196
test4sub54of100,test4pub80of100,10,192,10,187,1,198
test4sub44of100,test4pub80of100,10,192,10,192,0,202
test4sub22of100,test4pub80of100,10,192,10,194,0,204
test4sub45of100,test4pub80of100,10,192,10,199,1,210
test4sub79of100,test4pub80of100,10,192,10,201,1,212
test4sub93of100,test4pub80of100,10,192,10,206,1,217
test4sub58of100,test4pub80of100,10,192,10,220,0,230
test4sub10of100,test4pub80of100,10,192,10,233,1,244
test4sub64of100,test4pub80of100,10,192,10,264,1,275
test4sub7of100,test4pub80of100,10,192,10,265,0,275
test4sub64of100,test4pub81of100,10,192,17,150,0,167
test4sub1of100,test4pub80of100,10,192,10,267,0,277
test4sub1of100,test4pub81of100,10,192,17,152,1,170
test4sub12of100,test4pub80of100,10,192,10,271,1,282
test4sub75of100,test4pub81of100,10,192,17,175,1,193
test4sub28of100,test4pub81of100,10,192,17,176,1,194
test4sub42of100,test4pub45of100,10,191,9,16515,1,16525
test4sub42of100,test4pub46of100,10,192,10,16330,1,16341
test4sub31of100,test4pub81of100,10,192,17,205,0,222
test4sub35of100,test4pub79of100,10,191,9,726,1,736
test4sub38of100,test4pub81of100,10,192,17,211,1,229
test4sub35of100,test4pub80of100,10,192,10,328,1,339
test4sub3of100,test4pub81of100,10,192,17,216,1,234
test4sub17of100,test4pub81of100,10,192,17,217,1,235
test4sub51of100,test4pub81of100,10,192,17,224,1,242
test4sub74of100,test4pub65of100,10,192,10,9559,1,9570
test4sub74of100,test4pub66of100,10,192,17,9434,0,9451
test4sub74of100,test4pub67of100,10,192,11,9257,1,9269
test4sub74of100,test4pub68of100,10,192,10,9040,1,9051
test4sub74of100,test4pub69of100,10,192,14,8790,0,8804
test4sub74of100,test4pub71of100,10,192,11,8554,1,8566
test4sub54of100,test4pub81of100,10,192,17,236,1,254
test4sub45of100,test4pub81of100,10,192,17,238,1,256
test4sub79of100,test4pub81of100,10,192,17,240,1,258
test4sub93of100,test4pub81of100,10,192,17,243,3,263
test4sub10of100,test4pub81of100,10,192,17,250,0,267
test4sub13of100,test4pub70of100,10,192,10,8717,1,8728
test4sub13of100,test4pub71of100,10,192,11,8580,0,8591
test4sub13of100,test4pub72of100,10,192,18,3738,1,3757
test4sub13of100,test4pub73of100,10,192,11,2861,1,2873
test4sub7of100,test4pub81of100,10,192,17,262,1,280
test4sub13of100,test4pub74of100,10,192,10,2236,2,2248
test4sub12of100,test4pub81of100,10,192,17,263,1,281
test4sub13of100,test4pub75of100,10,192,10,1554,0,1564
test4sub13of100,test4pub76of100,10,192,10,1388,0,1398
test4sub13of100,test4pub78of100,10,192,12,862,1,875
test4sub13of100,test4pub77of100,10,192,10,930,0,940
test4sub13of100,test4pub79of100,10,191,9,785,0,794
test4sub13of100,test4pub80of100,10,192,10,388,1,399
test4sub67of100,test4pub72of100,10,192,18,3774,1,3793
test4sub75of100,test4pub82of100,10,192,10,142,1,153
test4sub67of100,test4pub73of100,10,192,11,2897,1,2909
test4sub1of100,test4pub82of100,10,192,10,143,1,154
test4sub67of100,test4pub74of100,10,192,10,2272,1,2283
test4sub67of100,test4pub75of100,10,192,10,1589,1,1600
test4sub55of100,test4pub71of100,10,192,11,8623,1,8635
test4sub55of100,test4pub72of100,10,192,18,3782,1,3801
test4sub67of100,test4pub76of100,10,192,10,1424,0,1434
test4sub55of100,test4pub73of100,10,192,11,2904,1,2916
test4sub67of100,test4pub77of100,10,192,10,966,1,977
test4sub55of100,test4pub74of100,10,192,10,2279,0,2289
test4sub67of100,test4pub78of100,10,192,12,901,1,914
test4sub55of100,test4pub75of100,10,192,10,1597,1,1608
test4sub67of100,test4pub79of100,10,191,9,823,1,833
test4sub55of100,test4pub76of100,10,192,10,1432,1,1443
test4sub67of100,test4pub80of100,10,192,10,426,1,437
test4sub68of100,test4pub58of100,10,192,11,13320,1,13332
test4sub55of100,test4pub77of100,10,192,10,974,1,985
test4sub68of100,test4pub59of100,10,192,15,13244,1,13260
test4sub55of100,test4pub78of100,10,192,12,909,1,922
test4sub55of100,test4pub79of100,10,191,9,831,0,840
test4sub55of100,test4pub80of100,10,192,10,434,1,445
test4sub68of100,test4pub60of100,10,192,18,12873,1,12892
test4sub53of100,test4pub72of100,10,192,18,3802,1,3821
test4sub68of100,test4pub61of100,10,192,12,12371,1,12384
test4sub68of100,test4pub62of100,10,192,10,12257,0,12267
test4sub53of100,test4pub73of100,10,192,11,2925,1,2937
test4sub53of100,test4pub74of100,10,192,10,2300,1,2311
test4sub31of100,test4pub82of100,10,192,10,174,1,185
test4sub35of100,test4pub81of100,10,192,17,330,3,350
test4sub38of100,test4pub82of100,10,192,10,176,2,188
test4sub53of100,test4pub75of100,10,192,10,1617,2,1629
test4sub30of100,test4pub72of100,10,192,18,3811,2,3831
test4sub53of100,test4pub76of100,10,192,10,1456,1,1467
test4sub30of100,test4pub73of100,10,192,11,2934,1,2946
test4sub30of100,test4pub74of100,10,192,10,2309,1,2320
test4sub53of100,test4pub77of100,10,192,10,997,1,1008
test4sub53of100,test4pub79of100,10,191,9,853,1,863
test4sub30of100,test4pub75of100,10,192,10,1626,1,1637
test4sub53of100,test4pub78of100,10,192,12,933,1,946
test4sub30of100,test4pub76of100,10,192,10,1461,1,1472
test4sub53of100,test4pub80of100,10,192,10,457,0,467
test4sub30of100,test4pub77of100,10,192,10,1002,1,1013
test4sub30of100,test4pub78of100,10,192,12,937,0,949
test4sub30of100,test4pub79of100,10,191,9,860,1,870
test4sub30of100,test4pub80of100,10,192,10,462,0,472
test4sub64of100,test4pub82of100,10,192,10,194,0,204
test4sub28of100,test4pub82of100,10,192,10,197,1,208
test4sub3of100,test4pub82of100,10,192,10,199,0,209
test4sub17of100,test4pub82of100,10,192,10,205,1,216
test4sub88of100,test4pub70of100,10,192,10,8822,0,8832
test4sub88of100,test4pub71of100,10,192,11,8685,1,8697
test4sub88of100,test4pub72of100,10,192,18,3844,2,3864
test4sub51of100,test4pub82of100,10,192,10,211,1,222
test4sub74of100,test4pub70of100,10,192,10,8828,1,8839
test4sub88of100,test4pub73of100,10,192,11,2967,1,2979
test4sub74of100,test4pub72of100,10,192,18,3848,0,3866
test4sub88of100,test4pub74of100,10,192,10,2342,1,2353
test4sub74of100,test4pub73of100,10,192,11,2971,1,2983
test4sub88of100,test4pub75of100,10,192,10,1660,1,1671
test4sub88of100,test4pub76of100,10,192,10,1495,1,1506
test4sub88of100,test4pub77of100,10,192,10,1035,0,1045
test4sub88of100,test4pub78of100,10,192,12,969,1,982
test4sub74of100,test4pub74of100,10,192,10,2350,1,2361
test4sub79of100,test4pub82of100,10,192,10,223,1,234
test4sub88of100,test4pub79of100,10,191,9,893,2,904
test4sub74of100,test4pub75of100,10,192,10,1668,1,1679
test4sub88of100,test4pub80of100,10,192,10,497,0,507
test4sub74of100,test4pub76of100,10,192,10,1503,1,1514
test4sub93of100,test4pub82of100,10,192,10,229,1,240
test4sub14of100,test4pub75of100,10,192,10,1736,0,1746
test4sub14of100,test4pub76of100,10,192,10,1570,0,1580
test4sub14of100,test4pub77of100,10,192,10,1173,1,1184
test4sub14of100,test4pub78of100,10,192,12,1108,1,1121
test4sub14of100,test4pub79of100,10,191,9,1031,1,1041
test4sub14of100,test4pub80of100,10,192,10,633,1,644
test4sub14of100,test4pub81of100,10,192,17,519,1,537
test4sub14of100,test4pub82of100,10,192,10,365,0,375
test4sub97of100,test4pub70of100,10,192,10,9011,0,9021
test4sub97of100,test4pub71of100,10,192,11,8874,1,8886
test4sub97of100,test4pub72of100,10,192,18,4033,1,4052
test4sub97of100,test4pub73of100,10,192,11,3156,1,3168
test4sub97of100,test4pub74of100,10,192,10,2530,0,2540
test4sub97of100,test4pub75of100,10,192,10,1848,1,1859
test4sub99of100,test4pub59of100,10,192,15,13643,1,13659
test4sub99of100,test4pub60of100,10,192,18,13265,1,13284
test4sub99of100,test4pub61of100,10,192,12,12762,0,12774
test4sub99of100,test4pub62of100,10,192,10,12650,1,12661
test4sub99of100,test4pub63of100,10,192,10,12514,0,12524
test4sub99of100,test4pub64of100,10,192,11,11687,1,11699
test4sub50of100,test4pub60of100,10,192,18,13298,0,13316
test4sub50of100,test4pub61of100,10,192,12,12796,1,12809
test4sub50of100,test4pub62of100,10,192,10,12682,1,12693
test4sub50of100,test4pub63of100,10,192,10,12547,1,12558
test4sub50of100,test4pub64of100,10,192,11,11720,1,11732
test4sub50of100,test4pub65of100,10,192,10,10087,0,10097
test4sub65of100,test4pub74of100,10,192,10,2814,0,2824
test4sub65of100,test4pub75of100,10,192,10,2132,1,2143
test4sub65of100,test4pub76of100,10,192,10,1966,1,1977
test4sub65of100,test4pub77of100,10,192,10,1520,1,1531
test4sub65of100,test4pub78of100,10,192,12,1454,0,1466
test4sub65of100,test4pub79of100,10,191,9,1377,1,1387
test4sub48of100,test4pub74of100,10,192,10,2929,0,2939
test4sub48of100,test4pub75of100,10,192,10,2247,1,2258
test4sub48of100,test4pub76of100,10,192,10,2081,1,2092
test4sub48of100,test4pub77of100,10,192,10,1650,1,1661
test4sub48of100,test4pub78of100,10,192,12,1585,1,1598
test4sub48of100,test4pub79of100,10,191,9,1507,0,1516
test4sub58of100,test4pub81of100,10,192,17,1025,1,1043
test4sub58of100,test4pub82of100,10,192,10,871,0,881
test4sub10of100,test4pub82of100,10,192,10,892,0,902
test4sub13of100,test4pub81of100,10,192,17,1081,1,1099
test4sub13of100,test4pub82of100,10,192,10,928,1,939
test4sub13of100,test4pub83of100,10,192,10,779,0,789
test4sub7of100,test4pub82of100,10,192,10,951,0,961
test4sub12of100,test4pub82of100,10,192,10,967,1,978
test4sub12of100,test4pub83of100,10,192,10,818,0,828
test4sub67of100,test4pub81of100,10,192,17,1174,1,1192
test4sub67of100,test4pub82of100,10,192,10,1020,0,1030
test4sub55of100,test4pub81of100,10,192,17,1211,1,1229
test4sub55of100,test4pub82of100,10,192,10,1057,0,1067
test4sub55of100,test4pub83of100,10,192,10,909,1,920
test4sub68of100,test4pub63of100,10,192,10,13036,1,13047
test4sub68of100,test4pub64of100,10,192,11,12210,1,12222
test4sub68of100,test4pub65of100,10,192,10,10577,1,10588
test4sub68of100,test4pub66of100,10,192,17,10479,0,10496
test4sub68of100,test4pub67of100,10,192,11,10302,1,10314
test4sub68of100,test4pub68of100,10,192,10,10085,0,10095
test4sub68of100,test4pub69of100,10,192,14,9871,0,9885
test4sub68of100,test4pub70of100,10,192,10,9773,1,9784
test4sub53of100,test4pub81of100,10,192,17,1333,0,1350
test4sub53of100,test4pub82of100,10,192,10,1180,1,1191
test4sub31of100,test4pub83of100,10,192,10,1048,1,1059
test4sub30of100,test4pub81of100,10,192,17,1374,0,1391
test4sub30of100,test4pub82of100,10,192,10,1221,1,1232
test4sub30of100,test4pub83of100,10,192,10,1072,0,1082
test4sub1of100,test4pub83of100,10,192,10,1102,1,1113
test4sub64of100,test4pub83of100,10,192,10,1109,0,1119
test4sub28of100,test4pub83of100,10,192,10,1137,1,1148
test4sub88of100,test4pub81of100,10,192,17,1475,1,1493
test4sub88of100,test4pub82of100,10,192,10,1322,1,1333
test4sub88of100,test4pub83of100,10,192,10,1173,0,1183
test4sub35of100,test4pub82of100,10,192,10,1341,0,1351
test4sub35of100,test4pub83of100,10,192,10,1193,1,1204
test4sub38of100,test4pub83of100,10,192,10,1213,0,1223
test4sub74of100,test4pub77of100,10,192,10,2199,1,2210
test4sub74of100,test4pub79of100,10,191,9,2054,0,2063
test4sub74of100,test4pub78of100,10,192,12,2154,1,2167
test4sub74of100,test4pub80of100,10,192,10,1678,1,1689
test4sub74of100,test4pub81of100,10,192,17,1563,0,1580
test4sub74of100,test4pub82of100,10,192,10,1410,1,1421
test4sub8of100,test4pub71of100,10,192,11,9887,1,9899
test4sub8of100,test4pub72of100,10,192,18,5046,1,5065
test4sub8of100,test4pub73of100,10,192,11,4168,0,4179
test4sub8of100,test4pub74of100,10,192,10,3543,1,3554
test4sub8of100,test4pub75of100,10,192,10,2860,0,2870
test4sub8of100,test4pub76of100,10,192,10,2694,0,2704
test4sub8of100,test4pub77of100,10,192,10,2235,1,2246
test4sub8of100,test4pub78of100,10,192,12,2169,1,2182
test4sub8of100,test4pub79of100,10,191,9,2091,0,2100
test4sub8of100,test4pub80of100,10,192,10,1694,1,1705
test4sub75of100,test4pub83of100,10,192,10,1290,1,1301
test4sub3of100,test4pub83of100,10,192,10,1329,1,1340
test4sub17of100,test4pub83of100,10,192,10,1358,0,1368
test4sub51of100,test4pub83of100,10,192,10,1390,1,1401
test4sub79of100,test4pub83of100,10,192,10,1414,0,1424
test4sub93of100,test4pub83of100,10,192,10,1441,0,1451
test4sub71of100,test4pub64of100,10,192,11,12742,0,12753
test4sub71of100,test4pub65of100,10,192,10,11109,1,11120
test4sub14of100,test4pub83of100,10,192,10,1512,1,1523
test4sub47of100,test4pub72of100,10,192,18,5330,0,5348
test4sub47of100,test4pub73of100,10,192,11,4453,1,4465
test4sub47of100,test4pub74of100,10,192,10,3827,0,3837
test4sub47of100,test4pub75of100,10,192,10,3144,0,3154
test4sub47of100,test4pub76of100,10,192,10,2979,1,2990
test4sub47of100,test4pub77of100,10,192,10,2519,0,2529
test4sub47of100,test4pub78of100,10,192,12,2454,1,2467
test4sub47of100,test4pub79of100,10,191,9,2376,0,2385
test4sub47of100,test4pub80of100,10,192,10,1979,1,1990
test4sub97of100,test4pub76of100,10,192,10,3007,1,3018
test4sub97of100,test4pub77of100,10,192,10,2547,1,2558
test4sub97of100,test4pub78of100,10,192,12,2482,1,2495
test4sub97of100,test4pub79of100,10,191,9,2424,0,2433
test4sub97of100,test4pub80of100,10,192,10,2027,1,2038
test4sub97of100,test4pub81of100,10,192,17,1932,0,1949
test4sub97of100,test4pub82of100,10,192,10,1779,1,1790
test4sub97of100,test4pub83of100,10,192,10,1630,0,1640
test4sub6of100,test4pub74of100,10,192,10,3931,1,3942
test4sub6of100,test4pub75of100,10,192,10,3248,1,3259
test4sub6of100,test4pub76of100,10,192,10,3083,1,3094
test4sub6of100,test4pub77of100,10,192,10,2623,0,2633
test4sub6of100,test4pub78of100,10,192,12,2558,1,2571
test4sub6of100,test4pub79of100,10,191,9,2480,1,2490
test4sub6of100,test4pub80of100,10,192,10,2082,0,2092
test4sub6of100,test4pub81of100,10,192,17,1968,1,1986
test4sub6of100,test4pub82of100,10,192,10,1814,0,1824
test4sub82of100,test4pub75of100,10,192,10,3278,0,3288
test4sub82of100,test4pub76of100,10,192,10,3113,1,3124
test4sub82of100,test4pub77of100,10,192,10,2653,0,2663
test4sub33of100,test4pub72of100,10,192,18,5491,1,5510
test4sub33of100,test4pub73of100,10,192,11,4613,0,4624
test4sub33of100,test4pub74of100,10,192,10,3987,0,3997
test4sub33of100,test4pub75of100,10,192,10,3305,1,3316
test4sub33of100,test4pub76of100,10,192,10,3139,0,3149
test4sub33of100,test4pub77of100,10,192,10,2680,1,2691
test4sub33of100,test4pub79of100,10,191,9,2535,1,2545
test4sub33of100,test4pub78of100,10,192,12,2615,0,2627
test4sub33of100,test4pub80of100,10,192,10,2139,1,2150
test4sub23of100,test4pub75of100,10,192,10,3362,1,3373
test4sub23of100,test4pub76of100,10,192,10,3197,1,3208
test4sub23of100,test4pub77of100,10,192,10,2737,0,2747
test4sub23of100,test4pub78of100,10,192,12,2672,1,2685
test4sub23of100,test4pub79of100,10,191,9,2594,0,2603
test4sub23of100,test4pub80of100,10,192,10,2197,1,2208
test4sub99of100,test4pub65of100,10,192,10,11434,1,11445
test4sub99of100,test4pub66of100,10,192,17,11309,0,11326
test4sub99of100,test4pub67of100,10,192,11,11149,1,11161
test4sub99of100,test4pub68of100,10,192,10,10933,1,10944
test4sub99of100,test4pub69of100,10,192,14,10683,1,10698
test4sub99of100,test4pub70of100,10,192,10,10626,0,10636
test4sub99of100,test4pub71of100,10,192,11,10490,1,10502
test4sub99of100,test4pub72of100,10,192,18,5648,0,5666
test4sub25of100,test4pub74of100,10,192,10,4164,0,4174
test4sub25of100,test4pub75of100,10,192,10,3482,1,3493
test4sub25of100,test4pub76of100,10,192,10,3316,1,3327
test4sub25of100,test4pub77of100,10,192,10,2856,0,2866
test4sub25of100,test4pub78of100,10,192,12,2791,1,2804
test4sub25of100,test4pub79of100,10,191,9,2713,1,2723
test4sub25of100,test4pub80of100,10,192,10,2315,0,2325
test4sub25of100,test4pub81of100,10,192,17,2201,1,2219
test4sub25of100,test4pub82of100,10,192,10,2047,1,2058
test4sub50of100,test4pub66of100,10,192,17,11450,1,11468
test4sub50of100,test4pub67of100,10,192,11,11273,1,11285
test4sub50of100,test4pub68of100,10,192,10,11056,1,11067
test4sub50of100,test4pub69of100,10,192,14,10807,1,10822
test4sub50of100,test4pub70of100,10,192,10,10709,0,10719
test4sub50of100,test4pub71of100,10,192,11,10588,1,10600
test4sub50of100,test4pub72of100,10,192,18,5746,0,5764
test4sub50of100,test4pub73of100,10,192,11,4869,1,4881
test4sub36of100,test4pub75of100,10,192,10,3567,0,3577
test4sub36of100,test4pub76of100,10,192,10,3402,1,3413
test4sub36of100,test4pub77of100,10,192,10,2942,0,2952
test4sub36of100,test4pub78of100,10,192,12,2876,0,2888
test4sub36of100,test4pub79of100,10,191,9,2799,1,2809
test4sub36of100,test4pub80of100,10,192,10,2401,0,2411
test4sub24of100,test4pub74of100,10,192,10,4275,1,4286
test4sub24of100,test4pub75of100,10,192,10,3592,0,3602
test4sub24of100,test4pub76of100,10,192,10,3427,1,3438
test4sub24of100,test4pub77of100,10,192,10,2967,0,2977
test4sub24of100,test4pub78of100,10,192,12,2901,0,2913
test4sub24of100,test4pub79of100,10,191,9,2824,1,2834
test4sub24of100,test4pub80of100,10,192,10,2426,1,2437
test4sub24of100,test4pub81of100,10,192,17,2311,0,2328
test4sub11of100,test4pub65of100,10,192,10,11646,1,11657
test4sub24of100,test4pub82of100,10,192,10,2158,1,2169
test4sub11of100,test4pub66of100,10,192,17,11521,0,11538
test4sub11of100,test4pub67of100,10,192,11,11344,1,11356
test4sub11of100,test4pub69of100,10,192,14,10876,0,10890
test4sub11of100,test4pub68of100,10,192,10,11128,1,11139
test4sub11of100,test4pub70of100,10,192,10,10780,0,10790
test4sub11of100,test4pub71of100,10,192,11,10643,1,10655
test4sub11of100,test4pub72of100,10,192,18,5802,1,5821
test4sub11of100,test4pub73of100,10,192,11,4924,0,4935
test4sub11of100,test4pub74of100,10,192,10,4298,0,4308
test4sub11of100,test4pub75of100,10,192,10,3616,1,3627
test4sub11of100,test4pub76of100,10,192,10,3478,1,3489
test4sub11of100,test4pub77of100,10,192,10,3019,0,3029
test4sub65of100,test4pub80of100,10,192,10,2523,1,2534
test4sub65of100,test4pub81of100,10,192,17,2409,1,2427
test4sub65of100,test4pub82of100,10,192,10,2255,0,2265
test4sub65of100,test4pub83of100,10,192,10,2107,1,2118
test4sub4of100,test4pub74of100,10,192,10,4394,0,4404
test4sub4of100,test4pub75of100,10,192,10,3712,1,3723
test4sub4of100,test4pub76of100,10,192,10,3546,1,3557
test4sub4of100,test4pub77of100,10,192,10,3086,0,3096
test4sub4of100,test4pub78of100,10,192,12,3021,1,3034
test4sub4of100,test4pub79of100,10,191,9,2943,0,2952
test4sub95of100,test4pub74of100,10,192,10,4402,1,4413
test4sub4of100,test4pub80of100,10,192,10,2546,1,2557
test4sub95of100,test4pub75of100,10,192,10,3720,0,3730
test4sub4of100,test4pub81of100,10,192,17,2431,2,2450
test4sub95of100,test4pub76of100,10,192,10,3555,1,3566
test4sub4of100,test4pub82of100,10,192,10,2279,1,2290
test4sub95of100,test4pub77of100,10,192,10,3095,1,3106
test4sub95of100,test4pub78of100,10,192,12,3030,0,3042
test4sub18of100,test4pub74of100,10,192,10,4411,1,4422
test4sub95of100,test4pub79of100,10,191,9,2953,1,2963
test4sub18of100,test4pub75of100,10,192,10,3729,1,3740
test4sub95of100,test4pub80of100,10,192,10,2556,0,2566
test4sub95of100,test4pub81of100,10,192,17,2442,1,2460
test4sub18of100,test4pub76of100,10,192,10,3563,1,3574
test4sub95of100,test4pub82of100,10,192,10,2288,0,2298
test4sub18of100,test4pub77of100,10,192,10,3105,1,3116
test4sub85of100,test4pub74of100,10,192,10,4418,1,4429
test4sub18of100,test4pub78of100,10,192,12,3039,0,3051
test4sub85of100,test4pub75of100,10,192,10,3736,2,3748
test4sub18of100,test4pub79of100,10,191,9,2962,1,2972
test4sub85of100,test4pub76of100,10,192,10,3571,0,3581
test4sub18of100,test4pub80of100,10,192,10,2566,2,2578
test4sub85of100,test4pub78of100,10,192,12,3045,2,3059
test4sub48of100,test4pub80of100,10,192,10,2568,2,2580
test4sub18of100,test4pub81of100,10,192,17,2452,1,2470
test4sub48of100,test4pub81of100,10,192,17,2454,1,2472
test4sub18of100,test4pub82of100,10,192,10,2299,2,2311
test4sub85of100,test4pub77of100,10,192,10,3114,2,3126
test4sub48of100,test4pub82of100,10,192,10,2301,3,2314
test4sub85of100,test4pub79of100,10,191,9,2973,1,2983
test4sub48of100,test4pub83of100,10,192,10,2154,0,2164
test4sub85of100,test4pub80of100,10,192,10,2575,1,2586
test4sub48of100,test4pub84of100,10,192,11,1676,1,1688
test4sub85of100,test4pub81of100,10,192,17,2461,1,2479
test4sub85of100,test4pub82of100,10,192,10,2308,1,2319
test4sub58of100,test4pub83of100,10,192,10,2161,1,2172
test4sub58of100,test4pub84of100,10,192,11,1682,0,1693
test4sub54of100,test4pub82of100,10,192,10,2322,1,2333
test4sub27of100,test4pub72of100,10,192,18,5957,0,5975
test4sub27of100,test4pub73of100,10,192,11,5080,1,5092
test4sub27of100,test4pub74of100,10,192,10,4454,1,4465
test4sub10of100,test4pub83of100,10,192,10,2176,0,2186
test4sub27of100,test4pub75of100,10,192,10,3772,1,3783
test4sub10of100,test4pub84of100,10,192,11,1698,1,1710
test4sub27of100,test4pub76of100,10,192,10,3606,1,3617
test4sub27of100,test4pub77of100,10,192,10,3147,1,3158
test4sub27of100,test4pub78of100,10,192,12,3081,0,3093
test4sub27of100,test4pub79of100,10,191,9,3003,1,3013
test4sub94of100,test4pub74of100,10,192,10,4463,0,4473
test4sub27of100,test4pub80of100,10,192,10,2606,1,2617
test4sub94of100,test4pub75of100,10,192,10,3781,1,3792
test4sub94of100,test4pub76of100,10,192,10,3615,0,3625
test4sub94of100,test4pub78of100,10,192,12,3088,0,3100
test4sub94of100,test4pub77of100,10,192,10,3157,1,3168
test4sub94of100,test4pub79of100,10,191,9,3012,1,3022
test4sub94of100,test4pub80of100,10,192,10,2614,0,2624
test4sub94of100,test4pub81of100,10,192,17,2500,1,2518
test4sub94of100,test4pub82of100,10,192,10,2346,0,2356
test4sub13of100,test4pub84of100,10,192,11,1718,1,1730
test4sub7of100,test4pub83of100,10,192,10,2199,1,2210
test4sub7of100,test4pub84of100,10,192,11,1721,1,1733
test4sub12of100,test4pub84of100,10,192,11,1725,0,1736
test4sub81of100,test4pub74of100,10,192,10,4486,1,4497
test4sub67of100,test4pub83of100,10,192,10,2208,1,2219
test4sub81of100,test4pub75of100,10,192,10,3803,1,3814
test4sub67of100,test4pub84of100,10,192,11,1731,1,1743
test4sub81of100,test4pub76of100,10,192,10,3638,1,3649
test4sub81of100,test4pub77of100,10,192,10,3178,1,3189
test4sub81of100,test4pub78of100,10,192,12,3113,1,3126
test4sub81of100,test4pub79of100,10,191,9,3035,0,3044
test4sub81of100,test4pub80of100,10,192,10,2637,0,2647
test4sub81of100,test4pub81of100,10,192,17,2523,1,2541
test4sub19of100,test4pub75of100,10,192,10,3812,0,3822
test4sub19of100,test4pub76of100,10,192,10,3647,1,3658
test4sub42of100,test4pub47of100,10,192,10,18587,4,18601
test4sub81of100,test4pub82of100,10,192,10,2371,4,2385
test4sub19of100,test4pub77of100,10,192,10,3188,3,3201
test4sub9of100,test4pub75of100,10,192,10,3817,1,3828
test4sub42of100,test4pub48of100,10,192,10,18534,2,18546
test4sub19of100,test4pub78of100,10,192,12,3124,1,3137
test4sub9of100,test4pub76of100,10,192,10,3653,2,3665
test4sub19of100,test4pub79of100,10,191,9,3047,0,3056
test4sub42of100,test4pub49of100,10,192,11,18129,3,18143
test4sub9of100,test4pub77of100,10,192,10,3194,2,3206
test4sub19of100,test4pub80of100,10,192,10,2650,4,2664
test4sub55of100,test4pub84of100,10,192,11,1750,3,1764
test4sub9of100,test4pub78of100,10,192,12,3131,2,3145
test4sub42of100,test4pub50of100,10,192,12,18055,4,18071
test4sub19of100,test4pub81of100,10,192,17,2538,2,2557
test4sub9of100,test4pub79of100,10,191,9,3054,1,3064
test4sub42of100,test4pub51of100,10,191,9,17971,1,17981
test4sub19of100,test4pub82of100,10,192,10,2386,1,2397
test4sub9of100,test4pub80of100,10,192,10,2659,2,2671
test4sub42of100,test4pub52of100,10,191,9,17906,2,17917
test4sub19of100,test4pub83of100,10,192,10,2239,2,2251
test4sub9of100,test4pub81of100,10,192,17,2545,1,2563
test4sub42of100,test4pub53of100,10,192,10,17569,1,17580
test4sub9of100,test4pub82of100,10,192,10,2393,2,2405
test4sub42of100,test4pub54of100,10,192,10,17446,1,17457
test4sub63of100,test4pub70of100,10,192,10,11009,1,11020
test4sub9of100,test4pub83of100,10,192,10,2246,0,2256
test4sub63of100,test4pub71of100,10,192,11,10874,0,10885
test4sub42of100,test4pub55of100,10,192,18,17115,1,17134
test4sub63of100,test4pub72of100,10,192,18,6033,1,6052
test4sub63of100,test4pub73of100,10,192,11,5157,0,5168
test4sub63of100,test4pub74of100,10,192,10,4532,1,4543
test4sub63of100,test4pub75of100,10,192,10,3849,0,3859
test4sub68of100,test4pub71of100,10,192,11,10885,0,10896
test4sub68of100,test4pub72of100,10,192,18,6044,1,6063
test4sub26of100,test4pub75of100,10,192,10,3855,0,3865
test4sub68of100,test4pub73of100,10,192,11,5166,1,5178
test4sub26of100,test4pub76of100,10,192,10,3690,0,3700
test4sub68of100,test4pub74of100,10,192,10,4541,0,4551
test4sub26of100,test4pub77of100,10,192,10,3231,1,3242
test4sub68of100,test4pub75of100,10,192,10,3859,1,3870
test4sub26of100,test4pub78of100,10,192,12,3165,1,3178
test4sub68of100,test4pub76of100,10,192,10,3693,1,3704
test4sub26of100,test4pub79of100,10,191,9,3088,0,3097
test4sub26of100,test4pub80of100,10,192,10,2691,1,2702
test4sub26of100,test4pub81of100,10,192,17,2576,1,2594
test4sub26of100,test4pub82of100,10,192,10,2422,0,2432
test4sub26of100,test4pub83of100,10,192,10,2274,1,2285
test4sub68of100,test4pub77of100,10,192,10,3242,1,3253
test4sub68of100,test4pub78of100,10,192,12,3176,0,3188
test4sub68of100,test4pub79of100,10,191,9,3099,1,3109
test4sub77of100,test4pub75of100,10,192,10,3874,1,3885
test4sub77of100,test4pub76of100,10,192,10,3708,0,3718
test4sub53of100,test4pub83of100,10,192,10,2283,1,2294
test4sub31of100,test4pub84of100,10,192,11,1804,2,1817
test4sub77of100,test4pub77of100,10,192,10,3249,1,3260
test4sub53of100,test4pub84of100,10,192,11,1805,2,1818
test4sub14of100,test4pub84of100,10,192,11,1813,0,1824
test4sub47of100,test4pub81of100,10,192,17,2601,1,2619
test4sub47of100,test4pub82of100,10,192,10,2448,1,2459
test4sub47of100,test4pub83of100,10,192,10,2299,1,2310
test4sub33of100,test4pub81of100,10,192,17,2606,1,2624
test4sub33of100,test4pub82of100,10,192,10,2453,0,2463
test4sub33of100,test4pub83of100,10,192,10,2305,1,2316
test4sub25of100,test4pub83of100,10,192,10,2305,1,2316
test4sub39of100,test4pub72of100,10,192,18,6091,1,6110
test4sub25of100,test4pub84of100,10,192,11,1828,3,1842
test4sub39of100,test4pub73of100,10,192,11,5214,1,5226
test4sub36of100,test4pub81of100,10,192,17,2615,1,2633
test4sub39of100,test4pub74of100,10,192,10,4590,1,4601
test4sub36of100,test4pub82of100,10,192,10,2462,1,2473
test4sub36of100,test4pub83of100,10,192,10,2314,1,2325
test4sub39of100,test4pub75of100,10,192,10,3908,1,3919
test4sub39of100,test4pub76of100,10,192,10,3743,1,3754
test4sub39of100,test4pub77of100,10,192,10,3283,1,3294
test4sub24of100,test4pub83of100,10,192,10,2372,1,2383
test4sub24of100,test4pub84of100,10,192,11,1893,0,1904
test4sub76of100,test4pub56of100,10,192,10,17145,0,17155
test4sub11of100,test4pub78of100,10,192,12,3277,1,3290
test4sub76of100,test4pub57of100,10,192,10,16693,2,16705
test4sub11of100,test4pub79of100,10,191,9,3200,1,3210
test4sub76of100,test4pub58of100,10,192,11,15693,1,15705
test4sub11of100,test4pub80of100,10,192,10,2803,1,2814
test4sub11of100,test4pub81of100,10,192,17,2715,0,2732
test4sub11of100,test4pub82of100,10,192,10,2561,1,2572
test4sub11of100,test4pub83of100,10,192,10,2413,0,2423
test4sub11of100,test4pub84of100,10,192,11,1942,0,1953
test4sub34of100,test4pub71of100,10,192,11,11065,1,11077
test4sub34of100,test4pub72of100,10,192,18,6224,1,6243
test4sub34of100,test4pub73of100,10,192,11,5346,14,5371
test4sub65of100,test4pub84of100,10,192,11,1970,6,1987
test4sub87of100,test4pub72of100,10,192,18,6234,6,6258
test4sub90of100,test4pub71of100,10,192,11,11079,6,11096
test4sub84of100,test4pub71of100,10,192,11,11081,5,11097
test4sub61of100,test4pub75of100,10,192,10,4049,6,4065
test4sub4of100,test4pub83of100,10,192,10,2456,7,2473
test4sub65of100,test4pub85of100,10,192,23,445,7,475
test4sub95of100,test4pub83of100,10,192,10,2457,6,2473
test4sub87of100,test4pub73of100,10,192,11,5363,8,5382
test4sub58of100,test4pub85of100,10,192,23,446,9,478
test4sub84of100,test4pub72of100,10,192,18,6244,9,6271
test4sub90of100,test4pub72of100,10,192,18,6244,9,6271
test4sub67of100,test4pub85of100,10,192,23,449,7,479
test4sub61of100,test4pub76of100,10,192,10,3888,8,3906
test4sub9of100,test4pub84of100,10,192,11,1982,8,2001
test4sub4of100,test4pub84of100,10,192,11,1984,7,2002
test4sub95of100,test4pub84of100,10,192,11,1985,7,2003
test4sub55of100,test4pub85of100,10,192,23,453,8,484
test4sub63of100,test4pub76of100,10,192,10,3893,7,3910
test4sub87of100,test4pub74of100,10,192,10,4745,7,4762
test4sub9of100,test4pub85of100,10,192,23,459,5,487
test4sub61of100,test4pub77of100,10,192,10,3436,5,3451
test4sub4of100,test4pub85of100,10,192,23,460,4,487
test4sub95of100,test4pub85of100,10,192,23,460,4,487
test4sub63of100,test4pub77of100,10,192,10,3440,3,3453
test4sub87of100,test4pub75of100,10,192,10,4069,3,4082
test4sub61of100,test4pub78of100,10,192,12,3375,2,3389
test4sub87of100,test4pub76of100,10,192,10,3905,1,3916
test4sub63of100,test4pub78of100,10,192,12,3377,1,3390
test4sub87of100,test4pub77of100,10,192,10,3446,1,3457
test4sub63of100,test4pub79of100,10,191,9,3301,1,3311
test4sub61of100,test4pub79of100,10,191,9,3300,2,3311
test4sub63of100,test4pub80of100,10,192,10,2903,1,2914
test4sub61of100,test4pub80of100,10,192,10,2904,1,2915
test4sub61of100,test4pub81of100,10,192,17,2789,1,2807
test4sub61of100,test4pub82of100,10,192,10,2636,1,2647
test4sub61of100,test4pub83of100,10,192,10,2487,0,2497
test4sub63of100,test4pub81of100,10,192,17,2821,0,2838
test4sub68of100,test4pub80of100,10,192,10,2938,1,2949
test4sub63of100,test4pub82of100,10,192,10,2669,1,2680
test4sub68of100,test4pub81of100,10,192,17,2824,1,2842
test4sub68of100,test4pub82of100,10,192,10,2671,0,2681
test4sub63of100,test4pub83of100,10,192,10,2521,1,2532
test4sub68of100,test4pub83of100,10,192,10,2523,1,2534
test4sub68of100,test4pub84of100,10,192,11,2044,0,2055
test4sub26of100,test4pub84of100,10,192,11,2050,0,2061
test4sub26of100,test4pub85of100,10,192,23,520,1,544
test4sub68of100,test4pub85of100,10,192,23,523,1,547
test4sub53of100,test4pub85of100,10,192,23,532,1,556
test4sub31of100,test4pub85of100,10,192,23,534,1,558
test4sub71of100,test4pub66of100,10,192,17,12068,1,12086
test4sub71of100,test4pub67of100,10,192,11,11890,1,11902
test4sub71of100,test4pub68of100,10,192,10,11674,1,11685
test4sub71of100,test4pub69of100,10,192,14,11424,1,11439
test4sub71of100,test4pub70of100,10,192,10,11327,1,11338
test4sub71of100,test4pub71of100,10,192,11,11190,0,11201
test4sub71of100,test4pub72of100,10,192,18,6349,1,6368
test4sub71of100,test4pub73of100,10,192,11,5471,0,5482
test4sub71of100,test4pub74of100,10,192,10,4845,1,4856
test4sub71of100,test4pub75of100,10,192,10,4169,1,4180
test4sub71of100,test4pub76of100,10,192,10,4003,0,4013
test4sub14of100,test4pub85of100,10,192,23,575,0,598
test4sub47of100,test4pub84of100,10,192,11,2114,1,2126
test4sub47of100,test4pub85of100,10,192,23,584,1,608
test4sub82of100,test4pub78of100,10,192,12,3495,0,3507
test4sub82of100,test4pub79of100,10,191,9,3418,1,3428
test4sub82of100,test4pub80of100,10,192,10,3020,0,3030
test4sub82of100,test4pub81of100,10,192,17,2905,1,2923
test4sub82of100,test4pub82of100,10,192,10,2752,1,2763
test4sub82of100,test4pub83of100,10,192,10,2603,0,2613
test4sub33of100,test4pub84of100,10,192,11,2125,1,2137
test4sub25of100,test4pub85of100,10,192,23,593,2,618
test4sub82of100,test4pub84of100,10,192,11,2125,2,2138
test4sub33of100,test4pub85of100,10,192,23,594,1,618
test4sub91of100,test4pub70of100,10,192,10,11376,1,11387
test4sub22of100,test4pub81of100,10,192,17,2917,1,2935
test4sub91of100,test4pub71of100,10,192,11,11240,1,11252
test4sub22of100,test4pub82of100,10,192,10,2763,1,2774
test4sub22of100,test4pub83of100,10,192,10,2615,2,2627
test4sub21of100,test4pub64of100,10,192,11,13887,1,13899
test4sub91of100,test4pub72of100,10,192,18,6399,3,6420
test4sub5of100,test4pub64of100,10,192,11,13888,3,13902
test4sub21of100,test4pub65of100,10,192,10,12255,2,12267
test4sub59of100,test4pub71of100,10,192,11,11245,2,11258
test4sub24of100,test4pub85of100,10,192,23,606,2,631
test4sub5of100,test4pub65of100,10,192,10,12258,2,12270
test4sub59of100,test4pub72of100,10,192,18,6405,0,6423
test4sub92of100,test4pub77of100,10,192,10,3591,1,3602
test4sub11of100,test4pub85of100,10,192,23,614,1,638
test4sub92of100,test4pub78of100,10,192,12,3525,1,3538
test4sub54of100,test4pub83of100,10,192,10,2650,1,2661
test4sub54of100,test4pub84of100,10,192,11,2171,0,2182
test4sub54of100,test4pub85of100,10,192,23,644,1,668
test4sub61of100,test4pub84of100,10,192,11,2212,0,2223
test4sub61of100,test4pub85of100,10,192,23,681,0,704
test4sub1of100,test4pub84of100,10,192,11,2222,0,2233
test4sub63of100,test4pub84of100,10,192,11,2232,1,2244
test4sub63of100,test4pub85of100,10,192,23,701,0,724
test4sub63of100,test4pub86of100,10,192,21,275,0,296
test4sub65of100,test4pub86of100,10,192,21,278,1,300
test4sub67of100,test4pub86of100,10,192,21,283,1,305
test4sub55of100,test4pub86of100,10,192,21,284,1,306
test4sub4of100,test4pub86of100,10,192,21,320,1,342
test4sub9of100,test4pub86of100,10,192,21,320,1,342
test4sub26of100,test4pub86of100,10,192,21,322,0,343
test4sub95of100,test4pub86of100,10,192,21,323,1,345
test4sub68of100,test4pub86of100,10,192,21,326,1,348
test4sub58of100,test4pub86of100,10,192,21,327,0,348
test4sub77of100,test4pub78of100,10,192,12,3673,1,3686
test4sub53of100,test4pub86of100,10,192,21,335,2,358
test4sub77of100,test4pub79of100,10,191,9,3595,1,3605
test4sub31of100,test4pub86of100,10,192,21,336,3,360
test4sub71of100,test4pub77of100,10,192,10,3743,1,3754
test4sub77of100,test4pub80of100,10,192,10,3199,1,3210
test4sub71of100,test4pub78of100,10,192,12,3678,1,3691
test4sub20of100,test4pub72of100,10,192,18,6564,3,6585
test4sub77of100,test4pub81of100,10,192,17,3086,3,3106
test4sub71of100,test4pub79of100,10,191,9,3602,2,3613
test4sub45of100,test4pub82of100,10,192,10,2932,4,2946
test4sub14of100,test4pub86of100,10,192,21,345,3,369
test4sub77of100,test4pub82of100,10,192,10,2934,3,2947
test4sub47of100,test4pub86of100,10,192,21,347,5,373
test4sub71of100,test4pub80of100,10,192,10,3207,5,3222
test4sub82of100,test4pub85of100,10,192,23,777,3,803
test4sub45of100,test4pub83of100,10,192,10,2788,4,2802
test4sub33of100,test4pub86of100,10,192,21,350,5,376
test4sub77of100,test4pub83of100,10,192,10,2790,4,2804
test4sub25of100,test4pub86of100,10,192,21,351,5,377
test4sub71of100,test4pub81of100,10,192,17,3097,4,3118
test4sub45of100,test4pub84of100,10,192,11,2313,4,2328
test4sub39of100,test4pub78of100,10,192,12,3692,4,3708
test4sub82of100,test4pub86of100,10,192,21,355,5,381
test4sub77of100,test4pub84of100,10,192,11,2316,3,2330
test4sub71of100,test4pub82of100,10,192,10,2947,3,2960
test4sub39of100,test4pub79of100,10,191,9,3618,3,3630
test4sub77of100,test4pub85of100,10,192,23,788,2,813
test4sub71of100,test4pub83of100,10,192,10,2802,2,2814
test4sub39of100,test4pub80of100,10,192,10,3223,2,3235
test4sub39of100,test4pub81of100,10,192,17,3109,0,3126
test4sub71of100,test4pub84of100,10,192,11,2324,1,2336
test4sub39of100,test4pub82of100,10,192,10,2956,1,2967
test4sub71of100,test4pub85of100,10,192,23,794,1,818
test4sub39of100,test4pub83of100,10,192,10,2807,0,2817
test4sub39of100,test4pub84of100,10,192,11,2329,1,2341
test4sub39of100,test4pub85of100,10,192,23,798,1,822
test4sub92of100,test4pub79of100,10,191,9,3631,1,3641
test4sub11of100,test4pub86of100,10,192,21,373,1,395
test4sub92of100,test4pub80of100,10,192,10,3234,1,3245
test4sub34of100,test4pub74of100,10,192,10,5092,1,5103
test4sub92of100,test4pub81of100,10,192,17,3120,1,3138
test4sub34of100,test4pub75of100,10,192,10,4410,1,4421
test4sub34of100,test4pub76of100,10,192,10,4244,0,4254
test4sub92of100,test4pub82of100,10,192,10,2967,1,2978
test4sub92of100,test4pub83of100,10,192,10,2819,0,2829
test4sub34of100,test4pub77of100,10,192,10,3785,1,3796
test4sub92of100,test4pub84of100,10,192,11,2341,1,2353
test4sub34of100,test4pub78of100,10,192,12,3720,1,3733
test4sub34of100,test4pub79of100,10,191,9,3643,1,3653
test4sub34of100,test4pub80of100,10,192,10,3245,0,3255
test4sub34of100,test4pub81of100,10,192,17,3130,1,3148
test4sub34of100,test4pub82of100,10,192,10,2977,1,2988
test4sub34of100,test4pub83of100,10,192,10,2828,0,2838
test4sub34of100,test4pub84of100,10,192,11,2349,0,2360
test4sub34of100,test4pub85of100,10,192,23,854,1,878
test4sub34of100,test4pub86of100,10,192,21,428,0,449
test4sub54of100,test4pub86of100,10,192,21,440,0,461
test4sub87of100,test4pub78of100,10,192,12,3782,1,3795
test4sub87of100,test4pub79of100,10,191,9,3704,1,3714
test4sub87of100,test4pub80of100,10,192,10,3306,1,3317
test4sub48of100,test4pub85of100,10,192,23,874,1,898
test4sub48of100,test4pub86of100,10,192,21,448,1,470
test4sub87of100,test4pub81of100,10,192,17,3192,1,3210
test4sub87of100,test4pub82of100,10,192,10,3039,0,3049
test4sub87of100,test4pub83of100,10,192,10,2891,1,2902
test4sub87of100,test4pub84of100,10,192,11,2412,0,2423
test4sub87of100,test4pub85of100,10,192,23,882,1,906
test4sub13of100,test4pub85of100,10,192,23,885,0,908
test4sub13of100,test4pub86of100,10,192,21,460,1,482
test4sub90of100,test4pub73of100,10,192,11,5804,1,5816
test4sub90of100,test4pub74of100,10,192,10,5178,1,5189
test4sub90of100,test4pub75of100,10,192,10,4496,1,4507
test4sub90of100,test4pub76of100,10,192,10,4330,0,4340
test4sub90of100,test4pub77of100,10,192,10,3871,1,3882
test4sub90of100,test4pub79of100,10,191,9,3726,0,3735
test4sub90of100,test4pub78of100,10,192,12,3806,0,3818
test4sub90of100,test4pub80of100,10,192,10,3330,1,3341
test4sub84of100,test4pub73of100,10,192,11,5815,1,5827
test4sub84of100,test4pub74of100,10,192,10,5189,1,5200
test4sub90of100,test4pub81of100,10,192,17,3216,1,3234
test4sub84of100,test4pub75of100,10,192,10,4506,1,4517
test4sub90of100,test4pub82of100,10,192,10,3063,1,3074
test4sub84of100,test4pub76of100,10,192,10,4341,0,4351
test4sub90of100,test4pub83of100,10,192,10,2914,1,2925
test4sub90of100,test4pub84of100,10,192,11,2436,1,2448
test4sub84of100,test4pub77of100,10,192,10,3882,1,3893
test4sub84of100,test4pub78of100,10,192,12,3817,1,3830
test4sub90of100,test4pub85of100,10,192,23,905,1,929
test4sub84of100,test4pub79of100,10,191,9,3739,0,3748
test4sub84of100,test4pub80of100,10,192,10,3342,1,3353
test4sub84of100,test4pub81of100,10,192,17,3238,1,3256
test4sub84of100,test4pub82of100,10,192,10,3085,0,3095
test4sub64of100,test4pub84of100,10,192,11,2456,1,2468
test4sub84of100,test4pub83of100,10,192,10,2937,0,2947
test4sub84of100,test4pub84of100,10,192,11,2459,1,2471
test4sub84of100,test4pub85of100,10,192,23,928,0,951
test4sub15of100,test4pub71of100,10,192,11,11576,1,11588
test4sub15of100,test4pub72of100,10,192,18,6735,1,6754
test4sub3of100,test4pub84of100,10,192,11,2471,3,2485
test4sub67of100,test4pub87of100,10,192,10,282,2,294
test4sub55of100,test4pub87of100,10,192,10,283,3,296
test4sub15of100,test4pub73of100,10,192,11,5859,2,5872
test4sub15of100,test4pub74of100,10,192,10,5234,1,5245
test4sub15of100,test4pub75of100,10,192,10,4552,1,4563
test4sub15of100,test4pub76of100,10,192,10,4386,0,4396
test4sub15of100,test4pub77of100,10,192,10,3926,1,3937
test4sub10of100,test4pub85of100,10,192,23,1139,0,1162
test4sub10of100,test4pub86of100,10,192,21,714,1,736
test4sub63of100,test4pub87of100,10,192,10,496,0,506
test4sub65of100,test4pub87of100,10,192,10,547,1,558
test4sub7of100,test4pub85of100,10,192,23,1206,1,1230
test4sub7of100,test4pub86of100,10,192,21,781,1,803
test4sub4of100,test4pub87of100,10,192,10,555,1,566
test4sub9of100,test4pub87of100,10,192,10,556,1,567
test4sub26of100,test4pub87of100,10,192,10,557,1,568
test4sub95of100,test4pub87of100,10,192,10,567,1,578
test4sub68of100,test4pub87of100,10,192,10,569,0,579
test4sub12of100,test4pub85of100,10,192,23,1306,1,1330
test4sub38of100,test4pub84of100,10,192,11,2841,1,2853
test4sub12of100,test4pub86of100,10,192,21,881,2,904
test4sub12of100,test4pub87of100,10,192,10,653,0,663
test4sub77of100,test4pub86of100,10,192,21,884,2,907
test4sub38of100,test4pub85of100,10,192,23,1310,2,1335
test4sub53of100,test4pub87of100,10,192,10,654,3,667
test4sub77of100,test4pub87of100,10,192,10,655,2,667
test4sub38of100,test4pub86of100,10,192,21,887,2,910
test4sub31of100,test4pub87of100,10,192,10,657,2,669
test4sub71of100,test4pub86of100,10,192,21,905,1,927
test4sub71of100,test4pub87of100,10,192,10,675,1,686
test4sub45of100,test4pub85of100,10,192,23,1345,1,1369
test4sub14of100,test4pub87of100,10,192,10,688,2,700
test4sub47of100,test4pub87of100,10,192,10,688,3,701
test4sub45of100,test4pub86of100,10,192,21,920,3,944
test4sub82of100,test4pub87of100,10,192,10,691,3,704
test4sub45of100,test4pub87of100,10,192,10,693,1,704
test4sub33of100,test4pub87of100,10,192,10,709,2,721
test4sub25of100,test4pub87of100,10,192,10,710,1,721
test4sub39of100,test4pub86of100,10,192,21,960,1,982
test4sub39of100,test4pub87of100,10,192,10,730,1,741
test4sub91of100,test4pub73of100,10,192,11,6308,1,6320
test4sub91of100,test4pub74of100,10,192,10,5682,0,5692
test4sub91of100,test4pub75of100,10,192,10,5000,1,5011
test4sub91of100,test4pub76of100,10,192,10,4834,0,4844
test4sub91of100,test4pub77of100,10,192,10,4375,1,4386
test4sub91of100,test4pub78of100,10,192,12,4309,1,4322
test4sub91of100,test4pub79of100,10,191,9,4231,0,4240
test4sub91of100,test4pub80of100,10,192,10,3834,1,3845
test4sub91of100,test4pub81of100,10,192,17,3719,1,3737
test4sub91of100,test4pub82of100,10,192,10,3565,0,3575
test4sub91of100,test4pub83of100,10,192,10,3417,1,3428
test4sub21of100,test4pub66of100,10,192,17,12938,1,12956
test4sub21of100,test4pub67of100,10,192,11,12760,1,12772
test4sub21of100,test4pub68of100,10,192,10,12544,0,12554
test4sub21of100,test4pub69of100,10,192,14,12294,0,12308
test4sub21of100,test4pub70of100,10,192,10,12197,1,12208
test4sub21of100,test4pub71of100,10,192,11,12060,0,12071
test4sub21of100,test4pub72of100,10,192,18,7218,0,7236
test4sub21of100,test4pub73of100,10,192,11,6341,1,6353
test4sub21of100,test4pub74of100,10,192,10,5715,0,5725
test4sub21of100,test4pub75of100,10,192,10,5072,1,5083
test4sub21of100,test4pub76of100,10,192,10,4906,0,4916
test4sub5of100,test4pub66of100,10,192,17,13007,1,13025
test4sub5of100,test4pub67of100,10,192,11,12829,1,12841
test4sub5of100,test4pub68of100,10,192,10,12612,0,12622
test4sub5of100,test4pub69of100,10,192,14,12363,1,12378
test4sub5of100,test4pub70of100,10,192,10,12265,0,12275
test4sub58of100,test4pub87of100,10,192,10,831,1,842
test4sub5of100,test4pub71of100,10,192,11,12130,1,12142
test4sub11of100,test4pub87of100,10,192,10,834,1,845
test4sub5of100,test4pub72of100,10,192,18,7289,1,7308
test4sub5of100,test4pub73of100,10,192,11,6411,0,6422
test4sub5of100,test4pub74of100,10,192,10,5786,1,5797
test4sub34of100,test4pub87of100,10,192,10,838,1,849
test4sub5of100,test4pub75of100,10,192,10,5103,2,5115
test4sub54of100,test4pub87of100,10,192,10,840,1,851
test4sub5of100,test4pub76of100,10,192,10,4939,0,4949
test4sub87of100,test4pub86of100,10,192,21,1077,0,1098
test4sub87of100,test4pub87of100,10,192,10,848,1,859
test4sub48of100,test4pub87of100,10,192,10,848,1,859
test4sub13of100,test4pub87of100,10,192,10,851,1,862
test4sub90of100,test4pub86of100,10,192,21,1085,1,1107
test4sub90of100,test4pub87of100,10,192,10,855,0,865
test4sub78of100,test4pub71of100,10,192,11,12156,1,12168
test4sub69of100,test4pub71of100,10,192,11,12157,1,12169
test4sub78of100,test4pub72of100,10,192,18,7315,1,7334
test4sub69of100,test4pub72of100,10,192,18,7316,1,7335
test4sub69of100,test4pub73of100,10,192,11,6438,1,6450
test4sub84of100,test4pub86of100,10,192,21,1095,0,1116
test4sub69of100,test4pub74of100,10,192,10,5813,1,5824
test4sub84of100,test4pub87of100,10,192,10,866,1,877
test4sub69of100,test4pub75of100,10,192,10,5131,0,5141
test4sub69of100,test4pub76of100,10,192,10,4965,1,4976
test4sub69of100,test4pub77of100,10,192,10,4506,1,4517
test4sub3of100,test4pub85of100,10,192,23,1530,1,1554
test4sub73of100,test4pub71of100,10,192,11,12171,1,12183
test4sub3of100,test4pub86of100,10,192,21,1105,1,1127
test4sub73of100,test4pub72of100,10,192,18,7330,1,7349
test4sub3of100,test4pub87of100,10,192,10,876,1,887
test4sub73of100,test4pub73of100,10,192,11,6452,0,6463
test4sub73of100,test4pub74of100,10,192,10,5827,1,5838
test4sub73of100,test4pub75of100,10,192,10,5144,1,5155
test4sub73of100,test4pub76of100,10,192,10,4978,0,4988
test4sub73of100,test4pub77of100,10,192,10,4519,1,4530
test4sub67of100,test4pub88of100,10,192,11,658,1,670
test4sub64of100,test4pub85of100,10,192,23,1544,1,1568
test4sub64of100,test4pub86of100,10,192,21,1118,0,1139
test4sub64of100,test4pub87of100,10,192,10,889,1,900
test4sub55of100,test4pub88of100,10,192,11,668,0,679
test4sub70of100,test4pub67of100,10,192,11,12901,1,12913
test4sub17of100,test4pub84of100,10,192,11,3089,1,3101
test4sub70of100,test4pub68of100,10,192,10,12685,1,12696
test4sub17of100,test4pub85of100,10,192,23,1558,1,1582
test4sub70of100,test4pub69of100,10,192,14,12436,1,12451
test4sub17of100,test4pub86of100,10,192,21,1133,1,1155
test4sub10of100,test4pub87of100,10,192,10,907,1,918
test4sub10of100,test4pub88of100,10,192,11,682,1,694
test4sub63of100,test4pub88of100,10,192,11,682,1,694
test4sub51of100,test4pub84of100,10,192,11,3099,1,3111
test4sub51of100,test4pub85of100,10,192,23,1569,0,1592
test4sub65of100,test4pub88of100,10,192,11,686,1,698
test4sub51of100,test4pub86of100,10,192,21,1144,1,1166
test4sub7of100,test4pub87of100,10,192,10,918,1,929
test4sub4of100,test4pub88of100,10,192,11,692,2,705
test4sub9of100,test4pub88of100,10,192,11,693,1,705
test4sub7of100,test4pub88of100,10,192,11,694,1,706
test4sub26of100,test4pub88of100,10,192,11,697,0,708
test4sub95of100,test4pub88of100,10,192,11,699,0,710
test4sub68of100,test4pub88of100,10,192,11,705,1,717
test4sub35of100,test4pub84of100,10,192,11,3121,0,3132
test4sub35of100,test4pub85of100,10,192,23,1591,1,1615
test4sub35of100,test4pub86of100,10,192,21,1165,0,1186
test4sub57of100,test4pub81of100,10,192,17,3913,1,3931
test4sub12of100,test4pub88of100,10,192,11,713,0,724
test4sub57of100,test4pub82of100,10,192,10,3759,1,3770
test4sub57of100,test4pub83of100,10,192,10,3611,1,3622
test4sub57of100,test4pub84of100,10,192,11,3132,1,3144
test4sub38of100,test4pub87of100,10,192,10,944,2,956
test4sub57of100,test4pub85of100,10,192,23,1602,3,1628
test4sub98of100,test4pub70of100,10,192,10,12380,2,12392
test4sub77of100,test4pub88of100,10,192,11,720,3,734
test4sub38of100,test4pub88of100,10,192,11,720,3,734
test4sub53of100,test4pub88of100,10,192,11,721,4,736
test4sub31of100,test4pub88of100,10,192,11,723,3,737
test4sub98of100,test4pub71of100,10,192,11,12246,3,12260
test4sub71of100,test4pub88of100,10,192,11,725,2,738
test4sub57of100,test4pub86of100,10,192,21,1179,2,1202
test4sub98of100,test4pub72of100,10,192,18,7407,0,7425
test4sub98of100,test4pub73of100,10,192,11,6530,1,6542
test4sub14of100,test4pub88of100,10,192,11,730,1,742
test4sub98of100,test4pub74of100,10,192,10,5904,1,5915
test4sub98of100,test4pub75of100,10,192,10,5222,1,5233
test4sub98of100,test4pub76of100,10,192,10,5056,0,5066
test4sub98of100,test4pub78of100,10,192,12,4530,1,4543
test4sub74of100,test4pub83of100,10,192,10,3650,0,3660
test4sub74of100,test4pub84of100,10,192,11,3172,1,3184
test4sub74of100,test4pub85of100,10,192,23,1641,1,1665
test4sub74of100,test4pub86of100,10,192,21,1215,0,1236
test4sub87of100,test4pub88of100,10,192,11,768,1,780
test4sub13of100,test4pub88of100,10,192,11,770,1,782
test4sub90of100,test4pub88of100,10,192,11,771,1,783
test4sub15of100,test4pub78of100,10,192,12,4567,0,4579
test4sub15of100,test4pub79of100,10,191,9,4490,1,4500
test4sub15of100,test4pub80of100,10,192,10,4092,0,4102
test4sub40of100,test4pub78of100,10,192,12,4572,1,4585
test4sub15of100,test4pub81of100,10,192,17,3978,2,3997
test4sub70of100,test4pub70of100,10,192,10,12439,1,12450
test4sub40of100,test4pub79of100,10,191,9,4494,3,4506
test4sub15of100,test4pub82of100,10,192,10,3826,4,3840
test4sub70of100,test4pub71of100,10,192,11,12303,5,12319
test4sub17of100,test4pub87of100,10,192,10,1007,4,1021
test4sub40of100,test4pub80of100,10,192,10,4099,5,4114
test4sub51of100,test4pub87of100,10,192,10,1009,4,1023
test4sub58of100,test4pub88of100,10,192,11,784,6,801
test4sub15of100,test4pub83of100,10,192,10,3681,5,3696
test4sub70of100,test4pub72of100,10,192,18,7466,4,7488
test4sub17of100,test4pub88of100,10,192,11,787,5,803
test4sub40of100,test4pub81of100,10,192,17,3989,4,4010
test4sub51of100,test4pub88of100,10,192,11,789,4,804
test4sub15of100,test4pub84of100,10,192,11,3206,3,3220
test4sub70of100,test4pub73of100,10,192,11,6592,3,6606
test4sub40of100,test4pub82of100,10,192,10,3839,2,3851
test4sub15of100,test4pub85of100,10,192,23,1678,3,1704
test4sub54of100,test4pub88of100,10,192,11,795,3,809
test4sub70of100,test4pub74of100,10,192,10,5969,2,5981
test4sub15of100,test4pub86of100,10,192,21,1254,1,1276
test4sub40of100,test4pub83of100,10,192,10,3693,2,3705
test4sub70of100,test4pub75of100,10,192,10,5289,2,5301
test4sub15of100,test4pub87of100,10,192,10,1025,2,1037
test4sub40of100,test4pub84of100,10,192,11,3217,2,3230
test4sub74of100,test4pub87of100,10,192,10,1028,3,1041
test4sub15of100,test4pub88of100,10,192,11,803,2,816
test4sub40of100,test4pub85of100,10,192,23,1688,2,1713
test4sub74of100,test4pub88of100,10,192,11,805,0,816
test4sub40of100,test4pub86of100,10,192,21,1263,1,1285
test4sub40of100,test4pub87of100,10,192,10,1033,0,1043
test4sub29of100,test4pub81of100,10,192,17,4013,0,4030
test4sub29of100,test4pub82of100,10,192,10,3860,1,3871
test4sub29of100,test4pub83of100,10,192,10,3711,0,3721
test4sub29of100,test4pub84of100,10,192,11,3233,1,3245
test4sub40of100,test4pub88of100,10,192,11,817,2,830
test4sub29of100,test4pub85of100,10,192,23,1702,2,1727
test4sub70of100,test4pub76of100,10,192,10,5142,1,5153
test4sub70of100,test4pub77of100,10,192,10,4684,1,4695
test4sub29of100,test4pub86of100,10,192,21,1278,1,1300
test4sub70of100,test4pub78of100,10,192,12,4618,0,4630
test4sub70of100,test4pub79of100,10,191,9,4540,0,4549
test4sub70of100,test4pub80of100,10,192,10,4143,1,4154
test4sub70of100,test4pub81of100,10,192,17,4033,0,4050
test4sub70of100,test4pub82of100,10,192,10,3880,1,3891
test4sub70of100,test4pub83of100,10,192,10,3731,0,3741
test4sub98of100,test4pub77of100,10,192,10,4708,1,4719
test4sub98of100,test4pub79of100,10,191,9,4563,0,4572
test4sub98of100,test4pub80of100,10,192,10,4166,1,4177
test4sub98of100,test4pub81of100,10,192,17,4051,0,4068
test4sub98of100,test4pub82of100,10,192,10,3898,1,3909
test4sub98of100,test4pub83of100,10,192,10,3749,1,3760
test4sub98of100,test4pub84of100,10,192,11,3270,0,3281
test4sub98of100,test4pub85of100,10,192,23,1739,0,1762
test4sub98of100,test4pub86of100,10,192,21,1314,2,1337
test4sub5of100,test4pub77of100,10,192,10,4720,1,4731
test4sub98of100,test4pub87of100,10,192,10,1085,0,1095
test4sub5of100,test4pub78of100,10,192,12,4654,1,4667
test4sub98of100,test4pub88of100,10,192,11,861,0,872
test4sub5of100,test4pub79of100,10,191,9,4577,1,4587
test4sub5of100,test4pub80of100,10,192,10,4180,2,4192
test4sub29of100,test4pub87of100,10,192,10,1089,1,1100
test4sub5of100,test4pub81of100,10,192,17,4066,0,4083
test4sub29of100,test4pub88of100,10,192,11,865,1,877
test4sub5of100,test4pub82of100,10,192,10,3913,1,3924
test4sub70of100,test4pub84of100,10,192,11,3284,1,3296
test4sub5of100,test4pub83of100,10,192,10,3764,1,3775
test4sub70of100,test4pub85of100,10,192,23,1754,1,1778
test4sub5of100,test4pub84of100,10,192,11,3286,1,3298
test4sub5of100,test4pub85of100,10,192,23,1756,1,1780
test4sub70of100,test4pub86of100,10,192,21,1329,1,1351
test4sub5of100,test4pub86of100,10,192,21,1330,1,1352
test4sub5of100,test4pub87of100,10,192,10,1101,1,1112
test4sub5of100,test4pub88of100,10,192,11,876,0,887
test4sub70of100,test4pub87of100,10,192,10,1101,0,1111
test4sub37of100,test4pub65of100,10,192,10,13411,0,13421
test4sub70of100,test4pub88of100,10,192,11,878,1,890
test4sub37of100,test4pub66of100,10,192,17,13287,1,13305
test4sub32of100,test4pub70of100,10,192,10,12732,1,12743
test4sub32of100,test4pub71of100,10,192,11,12596,1,12608
test4sub32of100,test4pub72of100,10,192,18,7754,1,7773
test4sub32of100,test4pub73of100,10,192,11,6876,1,6888
test4sub32of100,test4pub74of100,10,192,10,6251,1,6262
test4sub32of100,test4pub75of100,10,192,10,5568,0,5578
test4sub32of100,test4pub76of100,10,192,10,5403,1,5414
test4sub16of100,test4pub70of100,10,192,10,12743,1,12754
test4sub32of100,test4pub77of100,10,192,10,4943,2,4955
test4sub16of100,test4pub71of100,10,192,11,12606,0,12617
test4sub32of100,test4pub78of100,10,192,12,4878,1,4891
test4sub32of100,test4pub79of100,10,191,9,4801,1,4811
test4sub16of100,test4pub72of100,10,192,18,7765,1,7784
test4sub32of100,test4pub80of100,10,192,10,4403,1,4414
test4sub32of100,test4pub81of100,10,192,17,4289,0,4306
test4sub32of100,test4pub82of100,10,192,10,4135,0,4145
test4sub32of100,test4pub83of100,10,192,10,3987,1,3998
test4sub32of100,test4pub84of100,10,192,11,3508,1,3520
test4sub32of100,test4pub85of100,10,192,23,1977,0,2000
test4sub12of100,test4pub89of100,10,192,39,142,1,182
test4sub13of100,test4pub89of100,10,192,39,147,1,187
test4sub37of100,test4pub67of100,10,192,11,13370,1,13382
test4sub37of100,test4pub68of100,10,192,10,13154,1,13165
test4sub37of100,test4pub69of100,10,192,14,12904,1,12919
test4sub32of100,test4pub86of100,10,192,21,1602,1,1624
test4sub37of100,test4pub70of100,10,192,10,12807,1,12818
test4sub26of100,test4pub89of100,10,192,39,159,2,200
test4sub37of100,test4pub71of100,10,192,11,12670,2,12683
test4sub56of100,test4pub81of100,10,192,17,4350,1,4368
test4sub37of100,test4pub72of100,10,192,18,7830,0,7848
test4sub32of100,test4pub87of100,10,192,10,1374,2,1386
test4sub56of100,test4pub82of100,10,192,10,4197,2,4209
test4sub37of100,test4pub73of100,10,192,11,6953,0,6964
test4sub56of100,test4pub83of100,10,192,10,4049,1,4060
test4sub32of100,test4pub88of100,10,192,11,1152,2,1165
test4sub37of100,test4pub74of100,10,192,10,6328,2,6340
test4sub23of100,test4pub81of100,10,192,17,4357,1,4375
test4sub37of100,test4pub75of100,10,192,10,5646,0,5656
test4sub37of100,test4pub76of100,10,192,10,5480,0,5490
test4sub23of100,test4pub82of100,10,192,10,4203,1,4214
test4sub37of100,test4pub77of100,10,192,10,5021,1,5032
test4sub23of100,test4pub83of100,10,192,10,4055,0,4065
test4sub37of100,test4pub78of100,10,192,12,4956,1,4969
test4sub37of100,test4pub79of100,10,191,9,4878,1,4888
test4sub37of100,test4pub80of100,10,192,10,4480,0,4490
test4sub37of100,test4pub81of100,10,192,17,4366,1,4384
test4sub37of100,test4pub82of100,10,192,10,4212,1,4223
test4sub37of100,test4pub83of100,10,192,10,4063,1,4074
test4sub37of100,test4pub84of100,10,192,11,3585,1,3597
test4sub37of100,test4pub85of100,10,192,23,2054,0,2077
test4sub31of100,test4pub89of100,10,192,39,183,0,222
test4sub9of100,test4pub89of100,10,192,39,188,1,228
test4sub98of100,test4pub89of100,10,192,39,192,0,231
test4sub29of100,test4pub89of100,10,192,39,221,1,261
test4sub77of100,test4pub89of100,10,192,39,227,0,266
test4sub71of100,test4pub89of100,10,192,39,234,0,273
test4sub15of100,test4pub89of100,10,192,39,234,1,274
test4sub14of100,test4pub89of100,10,192,39,238,1,278
test4sub37of100,test4pub86of100,10,192,21,1684,0,1705
test4sub58of100,test4pub89of100,10,192,39,240,0,279
test4sub37of100,test4pub87of100,10,192,10,1455,1,1466
test4sub55of100,test4pub89of100,10,192,39,243,1,283
test4sub37of100,test4pub88of100,10,192,11,1230,1,1242
test4sub17of100,test4pub89of100,10,192,39,245,1,285
test4sub40of100,test4pub89of100,10,192,39,247,1,287
test4sub54of100,test4pub89of100,10,192,39,247,0,286
test4sub90of100,test4pub89of100,10,192,39,254,1,294
test4sub51of100,test4pub89of100,10,192,39,254,1,294
test4sub38of100,test4pub89of100,10,192,39,256,1,296
test4sub53of100,test4pub89of100,10,192,39,256,1,296
test4sub87of100,test4pub89of100,10,192,39,257,1,297
test4sub5of100,test4pub89of100,10,192,39,258,1,298
test4sub44of100,test4pub81of100,10,192,17,4449,1,4467
test4sub70of100,test4pub89of100,10,192,39,261,2,302
test4sub44of100,test4pub82of100,10,192,10,4295,1,4306
test4sub74of100,test4pub89of100,10,192,39,262,1,302
test4sub44of100,test4pub83of100,10,192,10,4147,1,4158
test4sub1of100,test4pub85of100,10,192,23,2136,1,2160
test4sub44of100,test4pub84of100,10,192,11,3670,1,3682
test4sub1of100,test4pub86of100,10,192,21,1711,1,1733
test4sub44of100,test4pub85of100,10,192,23,2139,1,2163
test4sub1of100,test4pub87of100,10,192,10,1482,1,1493
test4sub44of100,test4pub86of100,10,192,21,1714,1,1736
test4sub1of100,test4pub88of100,10,192,11,1257,1,1269
test4sub11of100,test4pub88of100,10,192,11,1294,1,1306
test4sub37of100,test4pub89of100,10,192,39,307,1,347
test4sub32of100,test4pub89of100,10,192,39,309,1,349
test4sub11of100,test4pub89of100,10,192,39,308,1,348
test4sub84of100,test4pub88of100,10,192,11,1299,0,1310
test4sub84of100,test4pub89of100,10,192,39,312,0,351
test4sub56of100,test4pub84of100,10,192,11,3720,0,3731
test4sub56of100,test4pub85of100,10,192,23,2190,1,2214
test4sub56of100,test4pub86of100,10,192,21,1764,1,1786
test4sub56of100,test4pub87of100,10,192,10,1534,1,1545
test4sub56of100,test4pub88of100,10,192,11,1310,1,1322
test4sub56of100,test4pub89of100,10,192,39,323,0,362
test4sub41of100,test4pub67of100,10,192,11,13541,0,13552
test4sub41of100,test4pub68of100,10,192,10,13325,1,13336
test4sub41of100,test4pub69of100,10,192,14,13075,1,13090
test4sub16of100,test4pub73of100,10,192,11,7125,1,7137
test4sub16of100,test4pub74of100,10,192,10,6500,1,6511
test4sub16of100,test4pub75of100,10,192,10,5817,0,5827
test4sub16of100,test4pub76of100,10,192,10,5652,1,5663
test4sub16of100,test4pub77of100,10,192,10,5192,1,5203
test4sub16of100,test4pub79of100,10,191,9,5047,0,5056
test4sub16of100,test4pub78of100,10,192,12,5128,1,5141
test4sub16of100,test4pub80of100,10,192,10,4651,0,4661
test4sub16of100,test4pub81of100,10,192,17,4536,1,4554
test4sub16of100,test4pub82of100,10,192,10,4383,1,4394
test4sub16of100,test4pub83of100,10,192,10,4234,0,4244
test4sub16of100,test4pub84of100,10,192,11,3755,0,3766
test4sub16of100,test4pub85of100,10,192,23,2225,1,2249
test4sub31of100,test4pub90of100,10,192,23,200,1,224
test4sub98of100,test4pub90of100,10,192,23,203,0,226
test4sub34of100,test4pub88of100,10,192,11,1352,1,1364
test4sub77of100,test4pub90of100,10,192,23,206,0,229
test4sub34of100,test4pub89of100,10,192,39,366,2,407
test4sub15of100,test4pub90of100,10,192,23,209,0,232
test4sub14of100,test4pub90of100,10,192,23,216,1,240
test4sub55of100,test4pub90of100,10,192,23,218,1,242
test4sub17of100,test4pub90of100,10,192,23,219,0,242
test4sub40of100,test4pub90of100,10,192,23,220,1,244
test4sub90of100,test4pub90of100,10,192,23,227,1,251
test4sub13of100,test4pub90of100,10,192,23,228,1,252
test4sub38of100,test4pub90of100,10,192,23,230,1,254
test4sub53of100,test4pub90of100,10,192,23,231,1,255
test4sub87of100,test4pub90of100,10,192,23,238,0,261
test4sub5of100,test4pub90of100,10,192,23,239,1,263
test4sub12of100,test4pub90of100,10,192,23,240,1,264
test4sub71of100,test4pub90of100,10,192,23,241,0,264
test4sub29of100,test4pub90of100,10,192,23,244,1,268
test4sub48of100,test4pub88of100,10,192,11,1397,0,1408
test4sub48of100,test4pub89of100,10,192,39,411,1,451
test4sub51of100,test4pub90of100,10,192,23,255,1,279
test4sub26of100,test4pub90of100,10,192,23,258,1,282
test4sub54of100,test4pub90of100,10,192,23,261,1,285
test4sub44of100,test4pub87of100,10,192,10,1637,1,1648
test4sub44of100,test4pub88of100,10,192,11,1412,1,1424
test4sub44of100,test4pub89of100,10,192,39,425,0,464
test4sub44of100,test4pub90of100,10,192,23,308,0,331
test4sub70of100,test4pub90of100,10,192,23,311,1,335
test4sub74of100,test4pub90of100,10,192,23,312,3,338
test4sub1of100,test4pub89of100,10,192,39,473,2,514
test4sub6of100,test4pub83of100,10,192,10,4358,1,4369
test4sub1of100,test4pub90of100,10,192,23,316,1,340
test4sub6of100,test4pub84of100,10,192,11,3880,1,3892
test4sub6of100,test4pub85of100,10,192,23,2350,0,2373
test4sub11of100,test4pub90of100,10,192,23,319,1,343
test4sub37of100,test4pub90of100,10,192,23,320,1,344
test4sub6of100,test4pub86of100,10,192,21,1925,2,1948
test4sub43of100,test4pub65of100,10,192,10,14004,0,14014
test4sub6of100,test4pub87of100,10,192,10,1696,1,1707
test4sub43of100,test4pub66of100,10,192,17,13880,1,13898
test4sub6of100,test4pub88of100,10,192,11,1472,1,1484
test4sub6of100,test4pub89of100,10,192,39,486,0,525
test4sub43of100,test4pub67of100,10,192,11,13702,1,13714
test4sub32of100,test4pub90of100,10,192,23,326,1,350
test4sub43of100,test4pub68of100,10,192,10,13487,0,13497
test4sub43of100,test4pub69of100,10,192,14,13238,1,13253
test4sub43of100,test4pub70of100,10,192,10,13140,1,13151
test4sub95of100,test4pub89of100,10,192,39,686,0,725
test4sub95of100,test4pub90of100,10,192,23,528,1,552
test4sub84of100,test4pub90of100,10,192,23,530,0,553
test4sub56of100,test4pub90of100,10,192,23,542,1,566
test4sub23of100,test4pub84of100,10,192,11,4117,1,4129
test4sub23of100,test4pub85of100,10,192,23,2586,1,2610
test4sub23of100,test4pub86of100,10,192,21,2160,1,2182
test4sub16of100,test4pub86of100,10,192,21,2161,1,2183
test4sub23of100,test4pub87of100,10,192,10,1931,0,1941
test4sub23of100,test4pub88of100,10,192,11,1707,1,1719
test4sub16of100,test4pub87of100,10,192,10,1932,3,1945
test4sub7of100,test4pub89of100,10,192,39,719,3,761
test4sub31of100,test4pub91of100,10,192,26,396,3,425
test4sub23of100,test4pub89of100,10,192,39,720,2,761
test4sub7of100,test4pub90of100,10,192,23,562,3,588
test4sub16of100,test4pub88of100,10,192,11,1710,3,1724
test4sub34of100,test4pub90of100,10,192,23,564,1,588
test4sub16of100,test4pub89of100,10,192,39,726,1,766
test4sub34of100,test4pub91of100,10,192,26,402,2,430
test4sub68of100,test4pub89of100,10,192,39,727,1,767
test4sub16of100,test4pub90of100,10,192,23,568,1,592
test4sub16of100,test4pub91of100,10,192,26,405,0,431
test4sub68of100,test4pub90of100,10,192,23,569,2,594
test4sub65of100,test4pub89of100,10,192,39,730,3,772
test4sub98of100,test4pub91of100,10,192,26,407,3,436
test4sub4of100,test4pub89of100,10,192,39,732,4,775
test4sub14of100,test4pub91of100,10,192,26,409,3,438
test4sub17of100,test4pub91of100,10,192,26,409,3,438
test4sub65of100,test4pub90of100,10,192,23,574,3,600
test4sub40of100,test4pub91of100,10,192,26,411,4,441
test4sub4of100,test4pub90of100,10,192,23,576,2,601
test4sub77of100,test4pub91of100,10,192,26,413,1,440
test4sub13of100,test4pub91of100,10,192,26,419,0,445
test4sub15of100,test4pub91of100,10,192,26,421,1,448
test4sub63of100,test4pub89of100,10,192,39,763,1,803
test4sub63of100,test4pub90of100,10,192,23,604,1,628
test4sub38of100,test4pub91of100,10,192,26,450,1,477
test4sub10of100,test4pub89of100,10,192,39,790,0,829
test4sub53of100,test4pub91of100,10,192,26,467,2,495
test4sub10of100,test4pub90of100,10,192,23,632,2,657
test4sub58of100,test4pub90of100,10,192,23,632,1,656
test4sub87of100,test4pub91of100,10,192,26,469,2,497
test4sub58of100,test4pub91of100,10,192,26,471,3,500
test4sub5of100,test4pub91of100,10,192,26,471,3,500
test4sub12of100,test4pub91of100,10,192,26,472,2,500
test4sub26of100,test4pub91of100,10,192,26,473,1,500
test4sub90of100,test4pub91of100,10,192,26,476,0,502
test4sub56of100,test4pub91of100,10,192,26,590,1,617
test4sub56of100,test4pub92of100,10,192,12,419,0,431
test4sub41of100,test4pub70of100,10,192,10,13577,1,13588
test4sub41of100,test4pub71of100,10,192,11,13440,0,13451
test4sub41of100,test4pub72of100,10,192,18,8599,1,8618
test4sub41of100,test4pub73of100,10,192,11,7721,1,7733
test4sub41of100,test4pub74of100,10,192,10,7095,0,7105
test4sub41of100,test4pub75of100,10,192,10,6413,1,6424
test4sub41of100,test4pub76of100,10,192,10,6247,0,6257
test4sub41of100,test4pub77of100,10,192,10,5787,0,5797
test4sub41of100,test4pub78of100,10,192,12,5775,0,5787
test4sub41of100,test4pub79of100,10,191,9,5698,1,5708
test4sub41of100,test4pub80of100,10,192,10,5300,0,5310
test4sub41of100,test4pub81of100,10,192,17,5186,1,5204
test4sub23of100,test4pub90of100,10,192,23,836,1,860
test4sub16of100,test4pub92of100,10,192,12,500,2,514
test4sub41of100,test4pub82of100,10,192,10,5032,2,5044
test4sub23of100,test4pub91of100,10,192,26,675,3,704
test4sub31of100,test4pub92of100,10,192,12,503,4,519
test4sub34of100,test4pub92of100,10,192,12,504,4,520
test4sub68of100,test4pub91of100,10,192,26,678,3,707
test4sub65of100,test4pub91of100,10,192,26,679,3,708
test4sub98of100,test4pub92of100,10,192,12,507,4,523
test4sub23of100,test4pub92of100,10,192,12,506,4,522
test4sub41of100,test4pub83of100,10,192,10,4886,4,4900
test4sub68of100,test4pub92of100,10,192,12,510,3,525
test4sub65of100,test4pub92of100,10,192,12,510,3,525
test4sub4of100,test4pub91of100,10,192,26,684,2,712
test4sub4of100,test4pub92of100,10,192,12,513,1,526
test4sub14of100,test4pub92of100,10,192,12,515,1,528
test4sub17of100,test4pub92of100,10,192,12,679,1,692
test4sub40of100,test4pub92of100,10,192,12,680,1,693
test4sub3of100,test4pub88of100,10,192,11,2173,1,2185
test4sub3of100,test4pub89of100,10,192,39,1187,1,1227
test4sub3of100,test4pub90of100,10,192,23,1029,1,1053
test4sub77of100,test4pub92of100,10,192,12,691,1,704
test4sub3of100,test4pub91of100,10,192,26,866,0,892
test4sub3of100,test4pub92of100,10,192,12,695,1,708
test4sub13of100,test4pub92of100,10,192,12,883,1,896
test4sub15of100,test4pub92of100,10,192,12,900,0,912
test4sub7of100,test4pub91of100,10,192,26,1078,1,1105
test4sub7of100,test4pub92of100,10,192,12,907,1,920
test4sub63of100,test4pub91of100,10,192,26,1082,0,1108
test4sub63of100,test4pub92of100,10,192,12,911,1,924
test4sub38of100,test4pub92of100,10,192,12,1010,1,1023
test4sub10of100,test4pub91of100,10,192,26,1184,0,1210
test4sub10of100,test4pub92of100,10,192,12,1013,1,1026
test4sub53of100,test4pub92of100,10,192,12,1014,1,1027
test4sub53of100,test4pub93of100,10,192,13,686,1,700
test4sub87of100,test4pub92of100,10,192,12,1019,0,1031
test4sub5of100,test4pub92of100,10,192,12,1019,1,1032
test4sub12of100,test4pub92of100,10,192,12,1044,1,1057
test4sub26of100,test4pub92of100,10,192,12,1046,1,1059
test4sub26of100,test4pub93of100,10,192,13,718,0,731
test4sub83of100,test4pub62of100,10,192,10,17677,1,17688
test4sub83of100,test4pub63of100,10,192,10,17542,1,17553
test4sub83of100,test4pub64of100,10,192,11,16715,0,16726
test4sub90of100,test4pub92of100,10,192,12,1074,1,1087
test4sub84of100,test4pub91of100,10,192,26,1256,0,1282
test4sub84of100,test4pub92of100,10,192,12,1085,1,1098
test4sub36of100,test4pub84of100,10,192,11,4996,1,5008
test4sub54of100,test4pub91of100,10,192,26,1269,1,1296
test4sub36of100,test4pub85of100,10,192,23,3466,1,3490
test4sub56of100,test4pub93of100,10,192,13,769,1,783
test4sub36of100,test4pub86of100,10,192,21,3041,1,3063
test4sub36of100,test4pub87of100,10,192,10,2811,0,2821
test4sub41of100,test4pub84of100,10,192,11,5001,1,5013
test4sub36of100,test4pub88of100,10,192,11,2587,0,2598
test4sub41of100,test4pub85of100,10,192,23,3471,1,3495
test4sub36of100,test4pub89of100,10,192,39,1601,1,1641
test4sub36of100,test4pub90of100,10,192,23,1442,0,1465
test4sub36of100,test4pub91of100,10,192,26,1279,1,1306
test4sub58of100,test4pub92of100,10,192,12,1108,0,1120
test4sub36of100,test4pub92of100,10,192,12,1108,1,1121
test4sub58of100,test4pub93of100,10,192,13,781,2,796
test4sub41of100,test4pub86of100,10,192,21,3053,1,3075
test4sub23of100,test4pub93of100,10,192,13,783,1,797
test4sub41of100,test4pub87of100,10,192,10,2823,2,2835
test4sub16of100,test4pub93of100,10,192,13,784,2,799
test4sub31of100,test4pub93of100,10,192,13,786,1,800
test4sub41of100,test4pub88of100,10,192,11,2600,1,2612
test4sub41of100,test4pub89of100,10,192,39,1614,0,1653
test4sub41of100,test4pub90of100,10,192,23,1456,1,1480
test4sub41of100,test4pub91of100,10,192,26,1293,1,1320
test4sub34of100,test4pub93of100,10,192,13,789,3,805
test4sub68of100,test4pub93of100,10,192,13,790,3,806
test4sub65of100,test4pub93of100,10,192,13,791,2,806
test4sub98of100,test4pub93of100,10,192,13,792,3,808
test4sub4of100,test4pub93of100,10,192,13,796,1,810
test4sub14of100,test4pub93of100,10,192,13,797,1,811
test4sub22of100,test4pub84of100,10,192,11,5029,0,5040
test4sub22of100,test4pub85of100,10,192,23,3498,1,3522
test4sub22of100,test4pub86of100,10,192,21,3073,1,3095
test4sub22of100,test4pub87of100,10,192,10,2843,0,2853
test4sub17of100,test4pub93of100,10,192,13,805,1,819
test4sub22of100,test4pub88of100,10,192,11,2618,1,2630
test4sub40of100,test4pub93of100,10,192,13,806,1,820
test4sub3of100,test4pub93of100,10,192,13,807,1,821
test4sub77of100,test4pub93of100,10,192,13,808,0,821
test4sub96of100,test4pub78of100,10,192,12,6511,1,6524
test4sub96of100,test4pub80of100,10,192,10,6035,0,6045
test4sub82of100,test4pub88of100,10,192,11,2718,1,2730
test4sub96of100,test4pub81of100,10,192,17,5921,2,5940
test4sub82of100,test4pub89of100,10,192,39,1733,1,1773
test4sub15of100,test4pub93of100,10,192,13,907,4,924
test4sub13of100,test4pub93of100,10,192,13,906,4,923
test4sub96of100,test4pub82of100,10,192,10,5768,2,5780
test4sub82of100,test4pub90of100,10,192,23,1575,3,1601
test4sub7of100,test4pub93of100,10,192,13,910,2,925
test4sub63of100,test4pub93of100,10,192,13,927,1,941
test4sub45of100,test4pub88of100,10,192,11,2746,1,2758
test4sub45of100,test4pub89of100,10,192,39,1759,1,1799
test4sub45of100,test4pub90of100,10,192,23,1600,1,1624
test4sub2of100,test4pub64of100,10,192,11,16928,1,16940
test4sub52of100,test4pub62of100,10,192,10,17908,1,17919
test4sub52of100,test4pub63of100,10,192,10,17772,0,17782
test4sub52of100,test4pub64of100,10,192,11,16946,1,16958
test4sub52of100,test4pub65of100,10,192,10,15313,0,15323
test4sub38of100,test4pub93of100,10,192,13,966,1,980
test4sub52of100,test4pub66of100,10,192,17,15189,1,15207
test4sub10of100,test4pub93of100,10,192,13,968,0,981
test4sub38of100,test4pub94of100,10,192,10,376,2,388
test4sub53of100,test4pub94of100,10,192,10,388,0,398
test4sub95of100,test4pub91of100,10,192,26,1485,0,1511
test4sub95of100,test4pub92of100,10,192,12,1314,1,1327
test4sub95of100,test4pub93of100,10,192,13,986,0,999
test4sub87of100,test4pub93of100,10,192,13,988,1,1002
test4sub5of100,test4pub93of100,10,192,13,990,1,1004
test4sub87of100,test4pub94of100,10,192,10,399,1,410
test4sub5of100,test4pub94of100,10,192,10,400,1,411
test4sub60of100,test4pub72of100,10,192,18,9504,1,9523
test4sub97of100,test4pub84of100,10,192,11,5241,1,5253
test4sub97of100,test4pub85of100,10,192,23,3710,1,3734
test4sub88of100,test4pub84of100,10,192,11,5243,0,5254
test4sub97of100,test4pub86of100,10,192,21,3285,0,3306
test4sub88of100,test4pub85of100,10,192,23,3712,1,3736
test4sub88of100,test4pub86of100,10,192,21,3287,1,3309
test4sub97of100,test4pub87of100,10,192,10,3056,1,3067
test4sub12of100,test4pub93of100,10,192,13,1018,1,1032
test4sub88of100,test4pub87of100,10,192,10,3058,1,3069
test4sub97of100,test4pub88of100,10,192,11,2833,3,2847
test4sub12of100,test4pub94of100,10,192,10,429,1,440
test4sub88of100,test4pub88of100,10,192,11,2835,2,2848
test4sub97of100,test4pub89of100,10,192,39,1848,1,1888
test4sub88of100,test4pub89of100,10,192,39,1849,0,1888
test4sub97of100,test4pub90of100,10,192,23,1691,1,1715
test4sub26of100,test4pub94of100,10,192,10,434,1,445
test4sub88of100,test4pub90of100,10,192,23,1691,2,1716
test4sub97of100,test4pub91of100,10,192,26,1528,1,1555
test4sub88of100,test4pub91of100,10,192,26,1530,1,1557
test4sub97of100,test4pub92of100,10,192,12,1357,1,1370
test4sub88of100,test4pub92of100,10,192,12,1359,0,1371
test4sub70of100,test4pub91of100,10,192,26,1537,1,1564
test4sub70of100,test4pub92of100,10,192,12,1365,2,1379
test4sub90of100,test4pub93of100,10,192,13,1037,2,1052
test4sub84of100,test4pub93of100,10,192,13,1038,3,1054
test4sub30of100,test4pub84of100,10,192,11,5269,2,5282
test4sub70of100,test4pub93of100,10,192,13,1040,2,1055
test4sub90of100,test4pub94of100,10,192,10,450,3,463
test4sub84of100,test4pub94of100,10,192,10,451,1,462
test4sub30of100,test4pub85of100,10,192,23,3740,1,3764
test4sub30of100,test4pub86of100,10,192,21,3316,1,3338
test4sub36of100,test4pub93of100,10,192,13,1046,1,1060
test4sub30of100,test4pub87of100,10,192,10,3086,2,3098
test4sub54of100,test4pub92of100,10,192,12,1377,2,1391
test4sub36of100,test4pub94of100,10,192,10,457,2,469
test4sub56of100,test4pub94of100,10,192,10,459,2,471
test4sub54of100,test4pub93of100,10,192,13,1050,2,1065
test4sub30of100,test4pub88of100,10,192,11,2865,3,2879
test4sub41of100,test4pub92of100,10,192,12,1381,2,1395
test4sub23of100,test4pub94of100,10,192,10,462,4,476
test4sub54of100,test4pub94of100,10,192,10,462,4,476
test4sub41of100,test4pub93of100,10,192,13,1055,2,1070
test4sub16of100,test4pub94of100,10,192,10,464,4,478
test4sub30of100,test4pub89of100,10,192,39,1881,4,1924
test4sub31of100,test4pub94of100,10,192,10,466,4,480
test4sub34of100,test4pub94of100,10,192,10,467,3,480
test4sub68of100,test4pub94of100,10,192,10,468,4,482
test4sub41of100,test4pub94of100,10,192,10,468,3,481
test4sub65of100,test4pub94of100,10,192,10,469,3,482
test4sub30of100,test4pub90of100,10,192,23,1727,2,1752
test4sub30of100,test4pub91of100,10,192,26,1566,0,1592
test4sub98of100,test4pub94of100,10,192,10,475,1,486
test4sub30of100,test4pub92of100,10,192,12,1395,0,1407
test4sub4of100,test4pub94of100,10,192,10,482,1,493
test4sub14of100,test4pub94of100,10,192,10,483,1,494
test4sub17of100,test4pub94of100,10,192,10,492,1,503
test4sub100of100,test4pub70of100,10,192,10,14566,1,14577
test4sub100of100,test4pub71of100,10,192,11,14429,0,14440
test4sub100of100,test4pub72of100,10,192,18,9588,1,9607
test4sub100of100,test4pub73of100,10,192,11,8710,0,8721
test4sub100of100,test4pub74of100,10,192,10,8084,1,8095
test4sub100of100,test4pub75of100,10,192,10,7402,1,7413
test4sub100of100,test4pub76of100,10,192,10,7236,0,7246
test4sub100of100,test4pub77of100,10,192,10,6776,1,6787
test4sub100of100,test4pub78of100,10,192,12,6711,1,6724
test4sub100of100,test4pub79of100,10,191,9,6633,0,6642
test4sub13of100,test4pub94of100,10,192,10,519,0,529
test4sub15of100,test4pub94of100,10,192,10,532,1,543
test4sub45of100,test4pub91of100,10,192,26,1649,1,1676
test4sub45of100,test4pub92of100,10,192,12,1477,0,1489
test4sub45of100,test4pub93of100,10,192,13,1150,1,1164
test4sub52of100,test4pub67of100,10,192,11,15195,0,15206
test4sub52of100,test4pub68of100,10,192,10,14979,1,14990
test4sub52of100,test4pub69of100,10,192,14,14729,0,14743
test4sub52of100,test4pub70of100,10,192,10,14632,1,14643
test4sub52of100,test4pub71of100,10,192,11,14496,1,14508
test4sub91of100,test4pub84of100,10,192,11,5391,2,5404
test4sub52of100,test4pub72of100,10,192,18,9654,4,9676
test4sub10of100,test4pub94of100,10,192,10,570,3,583
test4sub53of100,test4pub95of100,10,192,17,214,3,234
test4sub91of100,test4pub85of100,10,192,23,3861,2,3886
test4sub95of100,test4pub94of100,10,192,10,573,1,584
test4sub95of100,test4pub95of100,10,192,17,217,1,235
test4sub71of100,test4pub91of100,10,192,26,1678,1,1705
test4sub5of100,test4pub95of100,10,192,17,229,1,247
test4sub71of100,test4pub92of100,10,192,12,1507,0,1519
test4sub71of100,test4pub93of100,10,192,13,1179,1,1193
test4sub51of100,test4pub91of100,10,192,26,1694,0,1720
test4sub51of100,test4pub92of100,10,192,12,1523,1,1536
test4sub51of100,test4pub93of100,10,192,13,1195,1,1209
test4sub97of100,test4pub93of100,10,192,13,1202,0,1215
test4sub97of100,test4pub94of100,10,192,10,613,1,624
test4sub97of100,test4pub95of100,10,192,17,256,1,274
test4sub88of100,test4pub93of100,10,192,13,1205,1,1219
test4sub12of100,test4pub95of100,10,192,17,257,2,276
test4sub26of100,test4pub95of100,10,192,17,258,2,277
test4sub88of100,test4pub94of100,10,192,10,617,3,630
test4sub90of100,test4pub95of100,10,192,17,259,3,279
test4sub54of100,test4pub95of100,10,192,17,261,2,280
test4sub56of100,test4pub95of100,10,192,17,262,2,281
test4sub88of100,test4pub95of100,10,192,17,262,3,282
test4sub41of100,test4pub95of100,10,192,17,264,3,284
test4sub23of100,test4pub95of100,10,192,17,265,2,284
test4sub16of100,test4pub95of100,10,192,17,265,2,284
test4sub34of100,test4pub95of100,10,192,17,266,2,285
test4sub68of100,test4pub95of100,10,192,17,272,1,290
test4sub65of100,test4pub95of100,10,192,17,274,0,291
test4sub98of100,test4pub95of100,10,192,17,275,2,294
test4sub4of100,test4pub95of100,10,192,17,276,0,293
test4sub14of100,test4pub95of100,10,192,17,279,0,296
test4sub22of100,test4pub89of100,10,192,39,2056,1,2096
test4sub17of100,test4pub95of100,10,192,17,281,0,298
test4sub22of100,test4pub90of100,10,192,23,1897,1,1921
test4sub22of100,test4pub91of100,10,192,26,1735,0,1761
test4sub22of100,test4pub92of100,10,192,12,1563,1,1576
test4sub100of100,test4pub80of100,10,192,10,6367,1,6378
test4sub22of100,test4pub93of100,10,192,13,1236,1,1250
test4sub22of100,test4pub94of100,10,192,10,647,0,657
test4sub100of100,test4pub81of100,10,192,17,6253,1,6271
test4sub13of100,test4pub95of100,10,192,17,291,1,309
test4sub66of100,test4pub81of100,10,192,17,6257,1,6275
test4sub100of100,test4pub82of100,10,192,10,6100,1,6111
test4sub15of100,test4pub95of100,10,192,17,293,3,313
test4sub66of100,test4pub82of100,10,192,10,6104,1,6115
test4sub7of100,test4pub94of100,10,192,10,654,2,666
test4sub100of100,test4pub83of100,10,192,10,5954,2,5966
test4sub7of100,test4pub95of100,10,192,17,298,1,316
test4sub66of100,test4pub83of100,10,192,10,5957,1,5968
test4sub100of100,test4pub84of100,10,192,11,5478,2,5491
test4sub52of100,test4pub73of100,10,192,11,8881,1,8893
test4sub52of100,test4pub74of100,10,192,10,8255,0,8265
test4sub52of100,test4pub75of100,10,192,10,7572,1,7583
test4sub52of100,test4pub76of100,10,192,10,7407,1,7418
test4sub52of100,test4pub77of100,10,192,10,6947,0,6957
test4sub52of100,test4pub78of100,10,192,12,6883,0,6895
test4sub52of100,test4pub79of100,10,191,9,6806,1,6816
test4sub91of100,test4pub86of100,10,192,21,3549,1,3571
test4sub10of100,test4pub95of100,10,192,17,329,1,347
test4sub52of100,test4pub80of100,10,192,10,6408,4,6422
test4sub91of100,test4pub87of100,10,192,10,3319,1,3330
test4sub58of100,test4pub94of100,10,192,10,689,1,700
test4sub91of100,test4pub88of100,10,192,11,3096,1,3108
test4sub58of100,test4pub95of100,10,192,17,333,0,350
test4sub53of100,test4pub96of100,10,192,10,185,2,197
test4sub71of100,test4pub94of100,10,192,10,708,3,721
test4sub91of100,test4pub89of100,10,192,39,2110,3,2152
test4sub63of100,test4pub94of100,10,192,10,706,6,722
test4sub95of100,test4pub96of100,10,192,10,185,6,201
test4sub51of100,test4pub94of100,10,192,10,706,6,722
test4sub71of100,test4pub95of100,10,192,17,354,4,375
test4sub91of100,test4pub90of100,10,192,23,1970,3,1996
test4sub63of100,test4pub95of100,10,192,17,355,4,376
test4sub51of100,test4pub95of100,10,192,17,357,2,376
test4sub60of100,test4pub73of100,10,192,11,8921,3,8935
test4sub71of100,test4pub96of100,10,192,10,195,3,208
test4sub91of100,test4pub91of100,10,192,26,1810,3,1839
test4sub51of100,test4pub96of100,10,192,10,197,2,209
test4sub60of100,test4pub74of100,10,192,10,8298,2,8310
test4sub91of100,test4pub92of100,10,192,12,1641,1,1654
test4sub60of100,test4pub75of100,10,192,10,7617,0,7627
test4sub60of100,test4pub76of100,10,192,10,7452,1,7463
test4sub91of100,test4pub93of100,10,192,13,1315,1,1329
test4sub60of100,test4pub77of100,10,192,10,6992,0,7002
test4sub60of100,test4pub78of100,10,192,12,6927,1,6940
test4sub60of100,test4pub79of100,10,191,9,6849,0,6858
test4sub60of100,test4pub80of100,10,192,10,6452,0,6462
test4sub97of100,test4pub96of100,10,192,10,208,1,219
test4sub60of100,test4pub81of100,10,192,17,6338,1,6356
test4sub60of100,test4pub82of100,10,192,10,6184,0,6194
test4sub60of100,test4pub83of100,10,192,10,6036,1,6047
test4sub60of100,test4pub84of100,10,192,11,5557,1,5569
test4sub60of100,test4pub85of100,10,192,23,4026,0,4049
test4sub60of100,test4pub86of100,10,192,21,3601,1,3623
test4sub88of100,test4pub96of100,10,192,10,218,0,228
test4sub60of100,test4pub87of100,10,192,10,3371,0,3381
test4sub60of100,test4pub88of100,10,192,11,3147,1,3159
test4sub12of100,test4pub96of100,10,192,10,220,1,231
test4sub60of100,test4pub89of100,10,192,39,2160,1,2200
test4sub60of100,test4pub90of100,10,192,23,2002,1,2026
test4sub26of100,test4pub96of100,10,192,10,223,1,234
test4sub90of100,test4pub96of100,10,192,10,225,1,236
test4sub60of100,test4pub91of100,10,192,26,1839,1,1866
test4sub54of100,test4pub96of100,10,192,10,227,0,237
test4sub56of100,test4pub96of100,10,192,10,229,1,240
test4sub41of100,test4pub96of100,10,192,10,240,0,250
test4sub23of100,test4pub96of100,10,192,10,264,0,274
test4sub16of100,test4pub96of100,10,192,10,267,1,278
test4sub34of100,test4pub96of100,10,192,10,267,1,278
test4sub68of100,test4pub96of100,10,192,10,273,0,283
test4sub65of100,test4pub96of100,10,192,10,275,1,286
test4sub22of100,test4pub95of100,10,192,17,452,1,470
test4sub22of100,test4pub96of100,10,192,10,289,0,299
test4sub36of100,test4pub95of100,10,192,17,456,1,474
test4sub36of100,test4pub96of100,10,192,10,293,0,303
test4sub98of100,test4pub96of100,10,192,10,312,1,323
test4sub98of100,test4pub97of100,10,192,10,175,1,186
test4sub4of100,test4pub96of100,10,192,10,328,1,339
test4sub4of100,test4pub97of100,10,192,10,190,0,200
test4sub14of100,test4pub96of100,10,192,10,331,1,342
test4sub22of100,test4pub97of100,10,192,10,198,1,209
test4sub17of100,test4pub96of100,10,192,10,339,1,350
test4sub100of100,test4pub85of100,10,192,23,4153,1,4177
test4sub100of100,test4pub86of100,10,192,21,3727,0,3748
test4sub100of100,test4pub87of100,10,192,10,3498,1,3509
test4sub100of100,test4pub88of100,10,192,11,3279,1,3291
test4sub100of100,test4pub89of100,10,192,39,2292,0,2331
test4sub100of100,test4pub90of100,10,192,23,2133,0,2156
test4sub100of100,test4pub91of100,10,192,26,1977,1,2004
test4sub100of100,test4pub92of100,10,192,12,1806,1,1819
test4sub100of100,test4pub93of100,10,192,13,1478,0,1491
test4sub84of100,test4pub95of100,10,192,17,537,0,554
test4sub84of100,test4pub96of100,10,192,10,375,1,386
test4sub31of100,test4pub95of100,10,192,17,557,0,574
test4sub31of100,test4pub96of100,10,192,10,395,1,406
test4sub66of100,test4pub84of100,10,192,11,5743,1,5755
test4sub66of100,test4pub85of100,10,192,23,4213,1,4237
test4sub66of100,test4pub86of100,10,192,21,3787,1,3809
test4sub66of100,test4pub87of100,10,192,10,3557,0,3567
test4sub66of100,test4pub88of100,10,192,11,3333,1,3345
test4sub66of100,test4pub89of100,10,192,39,2346,0,2385
test4sub52of100,test4pub81of100,10,192,17,6548,1,6566
test4sub52of100,test4pub82of100,10,192,10,6395,1,6406
test4sub52of100,test4pub83of100,10,192,10,6246,1,6257
test4sub52of100,test4pub84of100,10,192,11,5767,1,5779
test4sub91of100,test4pub94of100,10,192,10,947,1,958
test4sub52of100,test4pub85of100,10,192,23,4237,1,4261
test4sub52of100,test4pub86of100,10,192,21,3811,1,3833
test4sub91of100,test4pub95of100,10,192,17,591,1,609
test4sub52of100,test4pub87of100,10,192,10,3582,0,3592
test4sub91of100,test4pub96of100,10,192,10,429,1,440
test4sub52of100,test4pub88of100,10,192,11,3358,1,3370
test4sub91of100,test4pub97of100,10,192,10,293,1,304
test4sub10of100,test4pub96of100,10,192,10,434,1,445
test4sub10of100,test4pub97of100,10,192,10,296,1,307
test4sub53of100,test4pub97of100,10,192,10,297,1,308
test4sub71of100,test4pub97of100,10,192,10,298,0,308
test4sub95of100,test4pub97of100,10,192,10,307,0,317
test4sub51of100,test4pub97of100,10,192,10,313,1,324
test4sub63of100,test4pub96of100,10,192,10,458,0,468
test4sub63of100,test4pub97of100,10,192,10,320,1,331
test4sub60of100,test4pub92of100,10,192,12,1902,1,1915
test4sub60of100,test4pub93of100,10,192,13,1575,0,1588
test4sub60of100,test4pub94of100,10,192,10,985,0,995
test4sub23of100,test4pub97of100,10,192,10,331,0,341
test4sub16of100,test4pub97of100,10,192,10,333,1,344
test4sub34of100,test4pub97of100,10,192,10,334,1,345
test4sub68of100,test4pub97of100,10,192,10,335,1,346
test4sub65of100,test4pub97of100,10,192,10,338,0,348
test4sub33of100,test4pub88of100,10,192,11,3410,1,3422
test4sub33of100,test4pub89of100,10,192,39,2424,1,2464
test4sub58of100,test4pub96of100,10,192,10,486,1,497
test4sub33of100,test4pub90of100,10,192,23,2266,1,2290
test4sub58of100,test4pub97of100,10,192,10,348,0,358
test4sub33of100,test4pub91of100,10,192,26,2103,1,2130
test4sub33of100,test4pub92of100,10,192,12,1932,1,1945
test4sub33of100,test4pub93of100,10,192,13,1604,1,1618
test4sub14of100,test4pub97of100,10,192,10,353,1,364
test4sub33of100,test4pub94of100,10,192,10,1016,1,1027
test4sub22of100,test4pub98of100,10,192,11,208,2,221
test4sub33of100,test4pub95of100,10,192,17,659,1,677
test4sub17of100,test4pub97of100,10,192,10,357,2,369
test4sub100of100,test4pub94of100,10,192,10,1019,1,1030
test4sub33of100,test4pub96of100,10,192,10,498,1,509
test4sub100of100,test4pub95of100,10,192,17,663,0,680
test4sub89of100,test4pub70of100,10,192,10,15090,0,15100
test4sub89of100,test4pub71of100,10,192,11,14953,1,14965
test4sub89of100,test4pub72of100,10,192,18,10112,1,10131
test4sub4of100,test4pub98of100,10,192,11,219,1,231
test4sub43of100,test4pub71of100,10,192,11,14962,1,14974
test4sub98of100,test4pub98of100,10,192,11,226,0,237
test4sub43of100,test4pub72of100,10,192,18,10121,0,10139
test4sub47of100,test4pub88of100,10,192,11,3442,1,3454
test4sub43of100,test4pub73of100,10,192,11,9244,1,9256
test4sub47of100,test4pub89of100,10,192,39,2456,0,2495
test4sub5of100,test4pub96of100,10,192,10,518,1,529
test4sub47of100,test4pub90of100,10,192,23,2298,1,2322
test4sub5of100,test4pub97of100,10,192,10,381,0,391
test4sub47of100,test4pub91of100,10,192,26,2135,1,2162
test4sub100of100,test4pub96of100,10,192,10,522,1,533
test4sub84of100,test4pub97of100,10,192,10,385,1,396
test4sub47of100,test4pub92of100,10,192,12,1964,1,1977
test4sub100of100,test4pub97of100,10,192,10,385,2,397
test4sub47of100,test4pub93of100,10,192,13,1639,1,1653
test4sub100of100,test4pub98of100,10,192,11,239,1,251
test4sub31of100,test4pub97of100,10,192,10,389,1,400
test4sub47of100,test4pub94of100,10,192,10,1049,1,1060
test4sub31of100,test4pub98of100,10,192,11,242,1,254
test4sub47of100,test4pub95of100,10,192,17,694,1,712
test4sub47of100,test4pub96of100,10,192,10,531,0,541
test4sub66of100,test4pub90of100,10,192,23,2314,1,2338
test4sub66of100,test4pub91of100,10,192,26,2152,0,2178
test4sub66of100,test4pub92of100,10,192,12,1980,0,1992
test4sub66of100,test4pub93of100,10,192,13,1653,1,1667
test4sub66of100,test4pub94of100,10,192,10,1063,0,1073
test4sub66of100,test4pub95of100,10,192,17,707,1,725
test4sub66of100,test4pub96of100,10,192,10,544,1,555
test4sub52of100,test4pub89of100,10,192,39,2484,1,2524
test4sub66of100,test4pub97of100,10,192,10,406,1,417
test4sub52of100,test4pub90of100,10,192,23,2326,1,2350
test4sub52of100,test4pub91of100,10,192,26,2163,0,2189
test4sub52of100,test4pub92of100,10,192,12,1992,1,2005
test4sub52of100,test4pub93of100,10,192,13,1664,0,1677
test4sub52of100,test4pub94of100,10,192,10,1074,1,1085
test4sub91of100,test4pub98of100,10,192,11,267,2,280
test4sub10of100,test4pub98of100,10,192,11,268,1,280
test4sub52of100,test4pub95of100,10,192,17,719,2,738
test4sub53of100,test4pub98of100,10,192,11,269,1,281
test4sub71of100,test4pub98of100,10,192,11,271,0,282
test4sub52of100,test4pub96of100,10,192,10,557,1,568
test4sub95of100,test4pub98of100,10,192,11,272,1,284
test4sub52of100,test4pub97of100,10,192,10,421,0,431
test4sub63of100,test4pub98of100,10,192,11,279,1,291
test4sub60of100,test4pub95of100,10,192,17,732,1,750
test4sub60of100,test4pub96of100,10,192,10,569,0,579
test4sub60of100,test4pub97of100,10,192,10,432,1,443
test4sub23of100,test4pub98of100,10,192,11,285,1,297
test4sub16of100,test4pub98of100,10,192,11,286,1,298
test4sub60of100,test4pub98of100,10,192,11,285,1,297
test4sub34of100,test4pub98of100,10,192,11,287,1,299
test4sub68of100,test4pub98of100,10,192,11,289,1,301
test4sub65of100,test4pub98of100,10,192,11,290,0,301
test4sub33of100,test4pub97of100,10,192,10,440,1,451
test4sub58of100,test4pub98of100,10,192,11,293,1,305
test4sub33of100,test4pub98of100,10,192,11,294,1,306
test4sub14of100,test4pub98of100,10,192,11,295,0,306
test4sub17of100,test4pub98of100,10,192,11,297,0,308
test4sub56of100,test4pub97of100,10,192,10,468,1,479
test4sub4of100,test4pub99of100,10,192,10,112,2,124
test4sub56of100,test4pub98of100,10,192,11,322,1,334
test4sub54of100,test4pub97of100,10,192,10,472,0,482
test4sub54of100,test4pub98of100,10,192,11,326,1,338
test4sub47of100,test4pub97of100,10,192,10,478,0,488
test4sub47of100,test4pub98of100,10,192,11,331,0,342
test4sub5of100,test4pub98of100,10,192,11,332,0,343
test4sub7of100,test4pub96of100,10,192,10,621,1,632
test4sub7of100,test4pub97of100,10,192,10,484,1,495
test4sub84of100,test4pub98of100,10,192,11,337,3,351
test4sub100of100,test4pub99of100,10,192,10,128,2,140
test4sub66of100,test4pub98of100,10,192,11,338,2,351
test4sub7of100,test4pub98of100,10,192,11,338,4,353
test4sub66of100,test4pub99of100,10,192,10,132,2,144
test4sub98of100,test4pub99of100,10,192,10,134,1,145
test4sub41of100,test4pub97of100,10,192,10,493,1,504
test4sub41of100,test4pub98of100,10,192,11,346,0,357
test4sub90of100,test4pub97of100,10,192,10,494,1,505
test4sub90of100,test4pub98of100,10,192,11,348,1,360
test4sub97of100,test4pub97of100,10,192,10,504,1,515
test4sub26of100,test4pub97of100,10,192,10,505,2,517
test4sub97of100,test4pub98of100,10,192,11,359,2,372
test4sub26of100,test4pub98of100,10,192,11,360,1,372
test4sub52of100,test4pub98of100,10,192,11,387,1,399
test4sub52of100,test4pub99of100,10,192,10,180,0,190
test4sub22of100,test4pub99of100,10,192,10,181,1,192
test4sub10of100,test4pub99of100,10,192,10,205,1,216
test4sub88of100,test4pub97of100,10,192,10,564,1,575
test4sub88of100,test4pub98of100,10,192,11,417,0,428
test4sub60of100,test4pub99of100,10,192,10,211,1,222
test4sub31of100,test4pub99of100,10,192,10,212,1,223
test4sub12of100,test4pub97of100,10,192,10,572,1,583
test4sub12of100,test4pub98of100,10,192,11,425,0,436
test4sub91of100,test4pub99of100,10,192,10,218,1,229
test4sub16of100,test4pub99of100,10,192,10,221,0,231
test4sub53of100,test4pub99of100,10,192,10,227,0,237
test4sub65of100,test4pub99of100,10,192,10,235,1,246
test4sub71of100,test4pub99of100,10,192,10,236,2,248
test4sub23of100,test4pub99of100,10,192,10,237,1,248
test4sub63of100,test4pub99of100,10,192,10,245,1,256
test4sub34of100,test4pub99of100,10,192,10,246,1,257
test4sub95of100,test4pub99of100,10,192,10,247,1,258
test4sub33of100,test4pub99of100,10,192,10,253,0,263
test4sub58of100,test4pub99of100,10,192,10,260,1,271
test4sub14of100,test4pub99of100,10,192,10,261,0,271
test4sub17of100,test4pub99of100,10,192,10,263,1,274
test4sub89of100,test4pub73of100,10,192,11,9489,0,9500
test4sub89of100,test4pub74of100,10,192,10,8864,1,8875
test4sub89of100,test4pub75of100,10,192,10,8181,1,8192
test4sub89of100,test4pub76of100,10,192,10,8015,1,8026
test4sub89of100,test4pub77of100,10,192,10,7556,1,7567
test4sub89of100,test4pub78of100,10,192,12,7490,0,7502
test4sub56of100,test4pub99of100,10,192,10,273,0,283
test4sub89of100,test4pub79of100,10,191,9,7413,0,7422
test4sub54of100,test4pub99of100,10,192,10,275,0,285
test4sub89of100,test4pub80of100,10,192,10,7016,1,7027
test4sub43of100,test4pub74of100,10,192,10,8874,1,8885
test4sub89of100,test4pub81of100,10,192,17,6902,1,6920
test4sub43of100,test4pub75of100,10,192,10,8192,0,8202
test4sub89of100,test4pub82of100,10,192,10,6748,1,6759
test4sub43of100,test4pub76of100,10,192,10,8027,1,8038
test4sub89of100,test4pub83of100,10,192,10,6600,1,6611
test4sub89of100,test4pub84of100,10,192,11,6122,1,6134
test4sub43of100,test4pub77of100,10,192,10,7567,1,7578
test4sub68of100,test4pub99of100,10,192,10,284,1,295
test4sub89of100,test4pub85of100,10,192,23,4592,1,4616
test4sub43of100,test4pub78of100,10,192,12,7503,1,7516
test4sub43of100,test4pub79of100,10,191,9,7426,1,7436
test4sub43of100,test4pub80of100,10,192,10,7028,1,7039
test4sub43of100,test4pub81of100,10,192,17,6914,1,6932
test4sub43of100,test4pub82of100,10,192,10,6760,0,6770
test4sub47of100,test4pub99of100,10,192,10,291,1,302
test4sub43of100,test4pub83of100,10,192,10,6612,1,6623
test4sub5of100,test4pub99of100,10,192,10,295,1,306
test4sub84of100,test4pub99of100,10,192,10,295,0,305
test4sub43of100,test4pub84of100,10,192,11,6133,1,6145
test4sub43of100,test4pub85of100,10,192,23,4604,0,4627
test4sub43of100,test4pub86of100,10,192,21,4179,1,4201
test4sub43of100,test4pub87of100,10,192,10,3949,1,3960
test4sub66of100,test4pub100of100,10,193,15,187,1,203
test4sub100of100,test4pub100of100,10,193,15,231,1,247
test4sub41of100,test4pub99of100,10,192,10,355,1,366
test4sub90of100,test4pub99of100,10,192,10,358,0,368
test4sub90of100,test4pub100of100,10,193,15,238,1,254
test4sub97of100,test4pub99of100,10,192,10,371,1,382
test4sub97of100,test4pub100of100,10,193,15,250,0,265
test4sub26of100,test4pub99of100,10,192,10,375,1,386
test4sub26of100,test4pub100of100,10,193,15,254,0,269
test4sub98of100,test4pub100of100,10,193,15,269,0,284
test4sub10of100,test4pub100of100,10,193,15,272,0,287
test4sub88of100,test4pub99of100,10,192,10,399,0,409
test4sub60of100,test4pub100of100,10,193,15,278,1,294
test4sub88of100,test4pub100of100,10,193,15,279,1,295
test4sub31of100,test4pub100of100,10,193,15,279,1,295
test4sub12of100,test4pub99of100,10,192,10,414,0,424
test4sub4of100,test4pub100of100,10,193,15,299,1,315
test4sub16of100,test4pub100of100,10,193,15,302,0,317
test4sub53of100,test4pub100of100,10,193,15,349,0,364
test4sub65of100,test4pub100of100,10,193,15,350,2,367
test4sub71of100,test4pub100of100,10,193,15,351,1,367
test4sub23of100,test4pub100of100,10,193,15,356,0,371
test4sub63of100,test4pub100of100,10,193,15,357,1,373
test4sub34of100,test4pub100of100,10,193,15,359,0,374
test4sub91of100,test4pub100of100,10,193,15,358,1,374
test4sub95of100,test4pub100of100,10,193,15,360,0,375
test4sub33of100,test4pub100of100,10,193,15,362,1,378
test4sub14of100,test4pub100of100,10,193,15,362,1,378
test4sub17of100,test4pub100of100,10,193,15,363,0,378
test4sub89of100,test4pub86of100,10,192,21,4369,1,4391
test4sub89of100,test4pub87of100,10,192,10,4139,0,4149
test4sub89of100,test4pub88of100,10,192,11,3915,2,3928
test4sub7of100,test4pub99of100,10,192,10,492,1,503
test4sub7of100,test4pub100of100,10,193,15,372,0,387
test4sub89of100,test4pub89of100,10,192,39,2929,1,2969
test4sub89of100,test4pub90of100,10,192,23,2771,1,2795
test4sub89of100,test4pub91of100,10,192,26,2611,1,2638
test4sub89of100,test4pub92of100,10,192,12,2439,0,2451
test4sub89of100,test4pub93of100,10,192,13,2112,1,2126
test4sub56of100,test4pub100of100,10,193,15,467,1,483
test4sub54of100,test4pub100of100,10,193,15,473,0,488
test4sub43of100,test4pub88of100,10,192,11,4020,0,4031
test4sub43of100,test4pub89of100,10,192,39,3033,1,3073
test4sub43of100,test4pub90of100,10,192,23,2875,1,2899
test4sub43of100,test4pub91of100,10,192,26,2712,0,2738
test4sub43of100,test4pub92of100,10,192,12,2541,1,2554
test4sub43of100,test4pub93of100,10,192,13,2214,0,2227
test4sub43of100,test4pub94of100,10,192,10,1625,1,1636
test4sub43of100,test4pub95of100,10,192,17,1268,1,1286
test4sub47of100,test4pub100of100,10,193,15,496,1,512
test4sub44of100,test4pub91of100,10,192,26,2730,1,2757
test4sub5of100,test4pub100of100,10,193,15,498,1,514
test4sub44of100,test4pub92of100,10,192,12,2559,1,2572
test4sub44of100,test4pub93of100,10,192,13,2231,0,2244
test4sub84of100,test4pub100of100,10,193,15,506,1,522
test4sub85of100,test4pub83of100,10,192,10,6949,0,6959
test4sub85of100,test4pub84of100,10,192,11,6471,1,6483
test4sub85of100,test4pub85of100,10,192,23,4940,1,4964
test4sub85of100,test4pub86of100,10,192,21,4516,0,4537
test4sub41of100,test4pub100of100,10,193,15,516,1,532
test4sub85of100,test4pub87of100,10,192,10,4286,0,4296
test4sub68of100,test4pub100of100,10,193,15,519,1,535
test4sub29of100,test4pub91of100,10,192,26,2755,1,2782
test4sub29of100,test4pub92of100,10,192,12,2583,0,2595
test4sub29of100,test4pub93of100,10,192,13,2255,0,2268
test4sub29of100,test4pub94of100,10,192,10,1666,1,1677
test4sub29of100,test4pub95of100,10,192,17,1309,1,1327
test4sub29of100,test4pub96of100,10,192,10,1146,0,1156
test4sub29of100,test4pub97of100,10,192,10,1008,2,1020
test4sub48of100,test4pub90of100,10,192,23,2927,1,2951
test4sub48of100,test4pub91of100,10,192,26,2765,1,2792
test4sub11of100,test4pub91of100,10,192,26,2766,1,2793
test4sub48of100,test4pub92of100,10,192,12,2594,1,2607
test4sub29of100,test4pub98of100,10,192,11,863,2,876
test4sub11of100,test4pub92of100,10,192,12,2596,2,2610
test4sub48of100,test4pub93of100,10,192,13,2267,1,2281
test4sub29of100,test4pub99of100,10,192,10,659,2,671
test4sub11of100,test4pub93of100,10,192,13,2269,1,2283
test4sub48of100,test4pub94of100,10,192,10,1678,1,1689
test4sub11of100,test4pub94of100,10,192,10,1680,0,1690
test4sub48of100,test4pub95of100,10,192,17,1322,2,1341
test4sub58of100,test4pub100of100,10,193,15,541,2,558
test4sub12of100,test4pub100of100,10,193,15,542,3,560
test4sub11of100,test4pub95of100,10,192,17,1324,5,1346
test4sub48of100,test4pub96of100,10,192,10,1162,5,1177
test4sub32of100,test4pub91of100,10,192,26,2778,7,2811
test4sub37of100,test4pub91of100,10,192,26,2779,5,2810
test4sub6of100,test4pub90of100,10,192,23,2944,6,2973
test4sub11of100,test4pub96of100,10,192,10,1167,5,1182
test4sub55of100,test4pub91of100,10,192,26,2783,6,2815
test4sub89of100,test4pub94of100,10,192,10,1691,4,1705
test4sub48of100,test4pub97of100,10,192,10,1029,6,1045
test4sub32of100,test4pub92of100,10,192,12,2612,5,2629
test4sub37of100,test4pub92of100,10,192,12,2613,7,2632
test4sub6of100,test4pub91of100,10,192,26,2787,5,2818
test4sub11of100,test4pub97of100,10,192,10,1034,7,1051
test4sub55of100,test4pub92of100,10,192,12,2616,6,2634
test4sub89of100,test4pub95of100,10,192,17,1338,7,1362
test4sub48of100,test4pub98of100,10,192,11,889,6,906
test4sub32of100,test4pub93of100,10,192,13,2290,7,2310
test4sub37of100,test4pub93of100,10,192,13,2291,6,2310
test4sub6of100,test4pub92of100,10,192,12,2620,7,2639
test4sub24of100,test4pub86of100,10,192,21,4563,6,4590
test4sub55of100,test4pub93of100,10,192,13,2294,6,2313
test4sub46of100,test4pub67of100,10,192,11,16337,5,16353
test4sub11of100,test4pub98of100,10,192,11,893,8,912
test4sub89of100,test4pub96of100,10,192,10,1182,6,1198
test4sub48of100,test4pub99of100,10,192,10,687,7,704
test4sub32of100,test4pub94of100,10,192,10,1706,7,1723
test4sub37of100,test4pub94of100,10,192,10,1707,6,1723
test4sub6of100,test4pub93of100,10,192,13,2299,6,2318
test4sub24of100,test4pub87of100,10,192,10,4339,6,4355
test4sub55of100,test4pub94of100,10,192,10,1709,6,1725
test4sub46of100,test4pub68of100,10,192,10,16126,6,16142
test4sub11of100,test4pub99of100,10,192,10,693,6,709
test4sub89of100,test4pub97of100,10,192,10,1050,6,1066
test4sub32of100,test4pub95of100,10,192,17,1355,4,1376
test4sub37of100,test4pub95of100,10,192,17,1355,6,1378
test4sub6of100,test4pub94of100,10,192,10,1715,5,1730
test4sub24of100,test4pub88of100,10,192,11,4120,6,4137
test4sub55of100,test4pub95of100,10,192,17,1358,4,1379
test4sub46of100,test4pub69of100,10,192,14,15882,5,15901
test4sub89of100,test4pub98of100,10,192,11,909,4,924
test4sub32of100,test4pub96of100,10,192,10,1197,4,1211
test4sub37of100,test4pub96of100,10,192,10,1198,3,1211
test4sub6of100,test4pub95of100,10,192,17,1362,4,1383
test4sub55of100,test4pub96of100,10,192,10,1200,4,1214
test4sub89of100,test4pub99of100,10,192,10,705,3,718
test4sub32of100,test4pub97of100,10,192,10,1062,4,1076
test4sub37of100,test4pub97of100,10,192,10,1064,3,1077
test4sub6of100,test4pub96of100,10,192,10,1203,4,1217
test4sub89of100,test4pub100of100,10,193,15,587,3,605
test4sub55of100,test4pub97of100,10,192,10,1065,3,1078
test4sub37of100,test4pub98of100,10,192,11,919,3,933
test4sub32of100,test4pub98of100,10,192,11,919,3,933
test4sub6of100,test4pub97of100,10,192,10,1068,3,1081
test4sub55of100,test4pub98of100,10,192,11,922,3,936
test4sub37of100,test4pub99of100,10,192,10,714,3,727
test4sub32of100,test4pub99of100,10,192,10,714,2,726
test4sub55of100,test4pub99of100,10,192,10,716,1,727
test4sub6of100,test4pub98of100,10,192,11,925,2,938
test4sub6of100,test4pub99of100,10,192,10,718,1,729
test4sub43of100,test4pub96of100,10,192,10,1290,1,1301
test4sub43of100,test4pub97of100,10,192,10,1153,1,1164
test4sub43of100,test4pub98of100,10,192,11,1006,1,1018
test4sub85of100,test4pub88of100,10,192,11,4221,2,4234
test4sub43of100,test4pub99of100,10,192,10,799,1,810
test4sub85of100,test4pub89of100,10,192,39,3235,0,3274
test4sub43of100,test4pub100of100,10,193,15,679,1,695
test4sub85of100,test4pub90of100,10,192,23,3077,1,3101
test4sub85of100,test4pub91of100,10,192,26,2914,1,2941
test4sub29of100,test4pub100of100,10,193,15,681,1,697
test4sub85of100,test4pub92of100,10,192,12,2743,1,2756
test4sub27of100,test4pub81of100,10,192,17,7430,1,7448
test4sub85of100,test4pub93of100,10,192,13,2416,1,2430
test4sub27of100,test4pub82of100,10,192,10,7277,2,7289
test4sub48of100,test4pub100of100,10,193,15,687,1,703
test4sub11of100,test4pub100of100,10,193,15,687,2,704
test4sub85of100,test4pub94of100,10,192,10,1827,3,1840
test4sub27of100,test4pub83of100,10,192,10,7130,1,7141
test4sub85of100,test4pub95of100,10,192,17,1473,1,1491
test4sub27of100,test4pub84of100,10,192,11,6652,0,6663
test4sub27of100,test4pub85of100,10,192,23,5122,1,5146
test4sub85of100,test4pub96of100,10,192,10,1310,1,1321
test4sub32of100,test4pub100of100,10,193,15,870,1,886
test4sub37of100,test4pub100of100,10,193,15,902,1,918
test4sub62of100,test4pub67of100,10,192,11,16677,1,16689
test4sub62of100,test4pub68of100,10,192,10,16461,0,16471
test4sub62of100,test4pub69of100,10,192,14,16211,0,16225
test4sub38of100,test4pub95of100,10,192,17,1719,1,1737
test4sub38of100,test4pub96of100,10,192,10,1556,0,1566
test4sub38of100,test4pub97of100,10,192,10,1419,1,1430
test4sub6of100,test4pub100of100,10,193,15,965,1,981
test4sub55of100,test4pub100of100,10,193,15,996,1,1012
test4sub46of100,test4pub70of100,10,192,10,16262,0,16272
test4sub46of100,test4pub71of100,10,192,11,16126,1,16138
test4sub46of100,test4pub72of100,10,192,18,11284,0,11302
test4sub46of100,test4pub73of100,10,192,11,10427,1,10439
test4sub46of100,test4pub74of100,10,192,10,9801,0,9811
test4sub46of100,test4pub75of100,10,192,10,9118,1,9129
test4sub77of100,test4pub94of100,10,192,10,2255,1,2266
test4sub44of100,test4pub94of100,10,192,10,2259,1,2270
test4sub44of100,test4pub95of100,10,192,17,1902,0,1919
test4sub44of100,test4pub96of100,10,192,10,1740,1,1751
test4sub85of100,test4pub97of100,10,192,10,1602,2,1614
test4sub44of100,test4pub97of100,10,192,10,1602,1,1613
test4sub44of100,test4pub98of100,10,192,11,1456,0,1467
test4sub27of100,test4pub86of100,10,192,21,5128,1,5150
test4sub44of100,test4pub99of100,10,192,10,1249,1,1260
test4sub85of100,test4pub98of100,10,192,11,1456,3,1470
test4sub27of100,test4pub87of100,10,192,10,4899,1,4910
test4sub44of100,test4pub100of100,10,193,15,1129,1,1145
test4sub85of100,test4pub99of100,10,192,10,1252,1,1263
test4sub27of100,test4pub88of100,10,192,11,4676,1,4688
test4sub85of100,test4pub100of100,10,193,15,1132,0,1147
test4sub27of100,test4pub89of100,10,192,39,3728,0,3767
test4sub27of100,test4pub90of100,10,192,23,3570,1,3594
test4sub27of100,test4pub91of100,10,192,26,3407,0,3433
test4sub27of100,test4pub92of100,10,192,12,3236,1,3249
test4sub27of100,test4pub93of100,10,192,13,2908,1,2922
test4sub27of100,test4pub94of100,10,192,10,2318,0,2328
test4sub96of100,test4pub83of100,10,192,10,7625,1,7636
test4sub93of100,test4pub84of100,10,192,11,7145,1,7157
test4sub96of100,test4pub84of100,10,192,11,7146,1,7158
test4sub93of100,test4pub85of100,10,192,23,5615,1,5639
test4sub93of100,test4pub86of100,10,192,21,5189,0,5210
test4sub86of100,test4pub74of100,10,192,10,9907,1,9918
test4sub62of100,test4pub70of100,10,192,10,16395,1,16406
test4sub86of100,test4pub75of100,10,192,10,9225,1,9236
test4sub62of100,test4pub71of100,10,192,11,16260,1,16272
test4sub86of100,test4pub76of100,10,192,10,9060,2,9072
test4sub62of100,test4pub72of100,10,192,18,11418,1,11437
test4sub38of100,test4pub98of100,10,192,11,1524,2,1537
test4sub86of100,test4pub77of100,10,192,10,8601,1,8612
test4sub62of100,test4pub73of100,10,192,11,10541,2,10554
test4sub38of100,test4pub99of100,10,192,10,1318,1,1329
test4sub86of100,test4pub78of100,10,192,12,8537,2,8551
test4sub62of100,test4pub74of100,10,192,10,9917,1,9928
test4sub38of100,test4pub100of100,10,193,15,1198,2,1215
test4sub86of100,test4pub79of100,10,191,9,8460,1,8470
test4sub62of100,test4pub75of100,10,192,10,9236,1,9247
test4sub86of100,test4pub80of100,10,192,10,8064,1,8075
test4sub79of100,test4pub84of100,10,192,11,7164,1,7176
test4sub86of100,test4pub81of100,10,192,17,7950,1,7968
test4sub79of100,test4pub85of100,10,192,23,5634,1,5658
test4sub86of100,test4pub82of100,10,192,10,7796,1,7807
test4sub79of100,test4pub86of100,10,192,21,5208,2,5231
test4sub45of100,test4pub94of100,10,192,10,2348,1,2359
test4sub45of100,test4pub95of100,10,192,17,1991,0,2008
test4sub82of100,test4pub91of100,10,192,26,3448,1,3475
test4sub8of100,test4pub81of100,10,192,17,7963,1,7981
test4sub82of100,test4pub92of100,10,192,12,3277,1,3290
test4sub8of100,test4pub82of100,10,192,10,7810,1,7821
test4sub82of100,test4pub93of100,10,192,13,2950,3,2966
test4sub8of100,test4pub83of100,10,192,10,7661,1,7672
test4sub24of100,test4pub89of100,10,192,39,3777,1,3817
test4sub24of100,test4pub90of100,10,192,23,3620,1,3644
test4sub24of100,test4pub91of100,10,192,26,3457,1,3484
test4sub24of100,test4pub92of100,10,192,12,3285,0,3297
test4sub24of100,test4pub93of100,10,192,13,2958,1,2972
test4sub24of100,test4pub94of100,10,192,10,2368,1,2379
test4sub24of100,test4pub95of100,10,192,17,2011,0,2028
test4sub24of100,test4pub96of100,10,192,10,1849,1,1860
test4sub24of100,test4pub97of100,10,192,10,1711,1,1722
test4sub46of100,test4pub76of100,10,192,10,9101,2,9113
test4sub24of100,test4pub98of100,10,192,11,1566,2,1579
test4sub46of100,test4pub77of100,10,192,10,8642,2,8654
test4sub83of100,test4pub65of100,10,192,10,17315,2,17327
test4sub46of100,test4pub78of100,10,192,12,8577,2,8591
test4sub24of100,test4pub99of100,10,192,10,1359,1,1370
test4sub83of100,test4pub66of100,10,192,17,17191,2,17210
test4sub46of100,test4pub79of100,10,191,9,8501,0,8510
test4sub83of100,test4pub67of100,10,192,11,17015,2,17028
test4sub24of100,test4pub100of100,10,193,15,1240,1,1256
test4sub46of100,test4pub80of100,10,192,10,8104,2,8116
test4sub83of100,test4pub68of100,10,192,10,16799,1,16810
test4sub46of100,test4pub81of100,10,192,17,7990,0,8007
test4sub83of100,test4pub69of100,10,192,14,16550,0,16564
test4sub46of100,test4pub82of100,10,192,10,7837,1,7848
test4sub83of100,test4pub70of100,10,192,10,16453,1,16464
test4sub46of100,test4pub83of100,10,192,10,7688,1,7699
test4sub83of100,test4pub71of100,10,192,11,16316,1,16328
test4sub83of100,test4pub72of100,10,192,18,11475,1,11494
test4sub27of100,test4pub95of100,10,192,17,2036,1,2054
test4sub27of100,test4pub96of100,10,192,10,1873,0,1883
test4sub27of100,test4pub97of100,10,192,10,1740,1,1751
test4sub27of100,test4pub98of100,10,192,11,1593,1,1605
test4sub27of100,test4pub99of100,10,192,10,1386,0,1396
test4sub27of100,test4pub100of100,10,193,15,1269,1,1285
test4sub93of100,test4pub87of100,10,192,10,5071,1,5082
test4sub93of100,test4pub88of100,10,192,11,4846,1,4858
test4sub93of100,test4pub89of100,10,192,39,3859,0,3898
test4sub93of100,test4pub90of100,10,192,23,3708,0,3731
test4sub93of100,test4pub91of100,10,192,26,3546,1,3573
test4sub86of100,test4pub83of100,10,192,10,7755,1,7766
test4sub93of100,test4pub92of100,10,192,12,3374,1,3387
test4sub86of100,test4pub84of100,10,192,11,7277,1,7289
test4sub86of100,test4pub85of100,10,192,23,5746,0,5769
test4sub86of100,test4pub86of100,10,192,21,5323,0,5344
test4sub86of100,test4pub87of100,10,192,10,5094,1,5105
test4sub62of100,test4pub76of100,10,192,10,9199,1,9210
test4sub62of100,test4pub77of100,10,192,10,8740,1,8751
test4sub62of100,test4pub78of100,10,192,12,8674,0,8686
test4sub62of100,test4pub79of100,10,191,9,8597,1,8607
test4sub62of100,test4pub80of100,10,192,10,8199,1,8210
test4sub62of100,test4pub81of100,10,192,17,8084,0,8101
test4sub62of100,test4pub82of100,10,192,10,7931,1,7942
test4sub62of100,test4pub83of100,10,192,10,7782,1,7793
test4sub35of100,test4pub87of100,10,192,10,5116,1,5127
test4sub35of100,test4pub88of100,10,192,11,4892,1,4904
test4sub35of100,test4pub89of100,10,192,39,3905,0,3944
test4sub35of100,test4pub90of100,10,192,23,3751,1,3775
test4sub79of100,test4pub87of100,10,192,10,5126,0,5136
test4sub35of100,test4pub91of100,10,192,26,3588,1,3615
test4sub35of100,test4pub92of100,10,192,12,3417,1,3430
test4sub79of100,test4pub88of100,10,192,11,4902,1,4914
test4sub79of100,test4pub89of100,10,192,39,3916,1,3956
test4sub79of100,test4pub90of100,10,192,23,3757,0,3780
test4sub79of100,test4pub91of100,10,192,26,3594,0,3620
test4sub79of100,test4pub92of100,10,192,12,3423,1,3436
test4sub39of100,test4pub88of100,10,192,11,4932,0,4943
test4sub8of100,test4pub84of100,10,192,11,7359,1,7371
test4sub8of100,test4pub85of100,10,192,23,5829,1,5853
test4sub8of100,test4pub86of100,10,192,21,5403,0,5424
test4sub8of100,test4pub87of100,10,192,10,5173,1,5184
test4sub46of100,test4pub84of100,10,192,11,7364,1,7376
test4sub8of100,test4pub88of100,10,192,11,4949,1,4961
test4sub46of100,test4pub85of100,10,192,23,5834,1,5858
test4sub83of100,test4pub73of100,10,192,11,10752,1,10764
test4sub46of100,test4pub86of100,10,192,21,5409,1,5431
test4sub46of100,test4pub87of100,10,192,10,5180,0,5190
test4sub83of100,test4pub74of100,10,192,10,10128,1,10139
test4sub46of100,test4pub88of100,10,192,11,4956,1,4968
test4sub83of100,test4pub75of100,10,192,10,9446,1,9457
test4sub83of100,test4pub76of100,10,192,10,9281,2,9293
test4sub46of100,test4pub89of100,10,192,39,3970,3,4012
test4sub77of100,test4pub95of100,10,192,17,2196,1,2214
test4sub83of100,test4pub77of100,10,192,10,8822,3,8835
test4sub46of100,test4pub90of100,10,192,23,3813,1,3837
test4sub77of100,test4pub96of100,10,192,10,2035,2,2047
test4sub46of100,test4pub91of100,10,192,26,3651,1,3678
test4sub77of100,test4pub97of100,10,192,10,1898,1,1909
test4sub77of100,test4pub98of100,10,192,11,1751,0,1762
test4sub77of100,test4pub99of100,10,192,10,1544,1,1555
test4sub77of100,test4pub100of100,10,193,15,1423,0,1438
test4sub70of100,test4pub94of100,10,192,10,2564,1,2575
test4sub70of100,test4pub95of100,10,192,17,2208,1,2226
test4sub70of100,test4pub96of100,10,192,10,2045,0,2055
test4sub70of100,test4pub97of100,10,192,10,1908,1,1919
test4sub70of100,test4pub98of100,10,192,11,1761,0,1772
test4sub70of100,test4pub99of100,10,192,10,1553,0,1563
test4sub67of100,test4pub89of100,10,192,39,3995,0,4034
test4sub67of100,test4pub90of100,10,192,23,3836,0,3859
test4sub67of100,test4pub91of100,10,192,26,3674,1,3701
test4sub67of100,test4pub92of100,10,192,12,3502,0,3514
test4sub67of100,test4pub93of100,10,192,13,3174,0,3187
test4sub67of100,test4pub94of100,10,192,10,2585,1,2596
test4sub67of100,test4pub95of100,10,192,17,2228,0,2245
test4sub67of100,test4pub96of100,10,192,10,2065,0,2075
test4sub67of100,test4pub97of100,10,192,10,1928,1,1939
test4sub67of100,test4pub98of100,10,192,11,1781,1,1793
test4sub67of100,test4pub99of100,10,192,10,1573,0,1583
test4sub67of100,test4pub100of100,10,193,15,1452,0,1467
test4sub96of100,test4pub85of100,10,192,23,5887,1,5911
test4sub96of100,test4pub86of100,10,192,21,5461,0,5482
test4sub96of100,test4pub87of100,10,192,10,5232,1,5243
test4sub96of100,test4pub88of100,10,192,11,5007,0,5018
test4sub93of100,test4pub93of100,10,192,13,3195,1,3209
test4sub96of100,test4pub89of100,10,192,39,4022,2,4063
test4sub93of100,test4pub94of100,10,192,10,2605,1,2616
test4sub93of100,test4pub95of100,10,192,17,2249,0,2266
test4sub96of100,test4pub90of100,10,192,23,3864,1,3888
test4sub93of100,test4pub96of100,10,192,10,2087,0,2097
test4sub96of100,test4pub91of100,10,192,26,3702,1,3729
test4sub93of100,test4pub97of100,10,192,10,1950,1,1961
test4sub96of100,test4pub92of100,10,192,12,3531,1,3544
test4sub96of100,test4pub93of100,10,192,13,3204,1,3218
test4sub93of100,test4pub98of100,10,192,11,1803,1,1815
test4sub93of100,test4pub99of100,10,192,10,1596,1,1607
test4sub86of100,test4pub88of100,10,192,11,5020,1,5032
test4sub96of100,test4pub94of100,10,192,10,2614,3,2627
test4sub86of100,test4pub89of100,10,192,39,4034,2,4075
test4sub93of100,test4pub100of100,10,193,15,1476,3,1494
test4sub96of100,test4pub95of100,10,192,17,2260,1,2278
test4sub86of100,test4pub90of100,10,192,23,3876,1,3900
test4sub96of100,test4pub96of100,10,192,10,2098,1,2109
test4sub86of100,test4pub91of100,10,192,26,3714,1,3741
test4sub86of100,test4pub92of100,10,192,12,3543,1,3556
test4sub96of100,test4pub97of100,10,192,10,1961,1,1972
test4sub96of100,test4pub98of100,10,192,11,1815,1,1827
test4sub86of100,test4pub93of100,10,192,13,3215,1,3229
test4sub86of100,test4pub94of100,10,192,10,2648,1,2659
test4sub62of100,test4pub84of100,10,192,11,7470,0,7481
test4sub86of100,test4pub95of100,10,192,17,2292,1,2310
test4sub62of100,test4pub85of100,10,192,23,5940,1,5964
test4sub86of100,test4pub96of100,10,192,10,2130,1,2141
test4sub62of100,test4pub86of100,10,192,21,5515,0,5536
test4sub62of100,test4pub87of100,10,192,10,5285,1,5296
test4sub62of100,test4pub88of100,10,192,11,5061,1,5073
test4sub62of100,test4pub89of100,10,192,39,4074,0,4113
test4sub62of100,test4pub90of100,10,192,23,3916,0,3939
test4sub62of100,test4pub91of100,10,192,26,3754,1,3781
test4sub35of100,test4pub93of100,10,192,13,3258,0,3271
test4sub35of100,test4pub94of100,10,192,10,2669,1,2680
test4sub35of100,test4pub95of100,10,192,17,2312,1,2330
test4sub35of100,test4pub96of100,10,192,10,2149,1,2160
test4sub35of100,test4pub97of100,10,192,10,2012,1,2023
test4sub35of100,test4pub98of100,10,192,11,1865,0,1876
test4sub35of100,test4pub99of100,10,192,10,1658,1,1669
test4sub35of100,test4pub100of100,10,193,15,1537,1,1553
test4sub79of100,test4pub93of100,10,192,13,3275,1,3289
test4sub79of100,test4pub94of100,10,192,10,2685,0,2695
test4sub79of100,test4pub95of100,10,192,17,2328,1,2346
test4sub79of100,test4pub96of100,10,192,10,2169,1,2180
test4sub79of100,test4pub97of100,10,192,10,2032,1,2043
test4sub82of100,test4pub94of100,10,192,10,2696,0,2706
test4sub82of100,test4pub95of100,10,192,17,2340,1,2358
test4sub82of100,test4pub96of100,10,192,10,2178,1,2189
test4sub82of100,test4pub97of100,10,192,10,2040,0,2050
test4sub82of100,test4pub98of100,10,192,11,1894,1,1906
test4sub82of100,test4pub99of100,10,192,10,1686,0,1696
test4sub64of100,test4pub88of100,10,192,11,5113,1,5125
test4sub64of100,test4pub89of100,10,192,39,4127,0,4166
test4sub64of100,test4pub90of100,10,192,23,3969,1,3993
test4sub64of100,test4pub91of100,10,192,26,3806,1,3833
test4sub64of100,test4pub92of100,10,192,12,3635,0,3647
test4sub8of100,test4pub89of100,10,192,39,4158,1,4198
test4sub8of100,test4pub90of100,10,192,23,4000,0,4023
test4sub8of100,test4pub91of100,10,192,26,3838,1,3865
test4sub83of100,test4pub78of100,10,192,12,8950,1,8963
test4sub83of100,test4pub79of100,10,191,9,8873,1,8883
test4sub83of100,test4pub80of100,10,192,10,8475,0,8485
test4sub83of100,test4pub81of100,10,192,17,8361,1,8379
test4sub83of100,test4pub82of100,10,192,10,8207,0,8217
test4sub83of100,test4pub83of100,10,192,10,8059,1,8070
test4sub83of100,test4pub84of100,10,192,11,7580,0,7591
test4sub3of100,test4pub94of100,10,192,10,2761,2,2773
test4sub83of100,test4pub85of100,10,192,23,6051,1,6075
test4sub3of100,test4pub95of100,10,192,17,2405,0,2422
test4sub83of100,test4pub86of100,10,192,21,5625,0,5646
test4sub3of100,test4pub96of100,10,192,10,2242,1,2253
test4sub3of100,test4pub97of100,10,192,10,2105,1,2116
test4sub3of100,test4pub98of100,10,192,11,1958,0,1969
test4sub3of100,test4pub99of100,10,192,10,1751,1,1762
test4sub70of100,test4pub100of100,10,193,15,1633,1,1649
test4sub1of100,test4pub91of100,10,192,26,3922,1,3949
test4sub96of100,test4pub99of100,10,192,10,1813,1,1824
test4sub1of100,test4pub92of100,10,192,12,3751,1,3764
test4sub96of100,test4pub100of100,10,193,15,1693,1,1709
test4sub1of100,test4pub93of100,10,192,13,3424,2,3439
test4sub52of100,test4pub100of100,10,193,15,1694,0,1709
test4sub86of100,test4pub97of100,10,192,10,2175,1,2186
test4sub86of100,test4pub98of100,10,192,11,2028,0,2039
test4sub86of100,test4pub99of100,10,192,10,1833,1,1844
test4sub86of100,test4pub100of100,10,193,15,1712,1,1728
test4sub40of100,test4pub94of100,10,192,10,2860,1,2871
test4sub62of100,test4pub92of100,10,192,12,3781,0,3793
test4sub62of100,test4pub93of100,10,192,13,3453,1,3467
test4sub62of100,test4pub94of100,10,192,10,2864,1,2875
test4sub62of100,test4pub95of100,10,192,17,2507,0,2524
test4sub62of100,test4pub96of100,10,192,10,2345,1,2356
test4sub62of100,test4pub97of100,10,192,10,2207,1,2218
test4sub62of100,test4pub98of100,10,192,11,2060,0,2071
test4sub62of100,test4pub99of100,10,192,10,1853,1,1864
test4sub62of100,test4pub100of100,10,193,15,1732,1,1748
test4sub76of100,test4pub59of100,10,192,15,21429,1,21445
test4sub76of100,test4pub60of100,10,192,18,21050,1,21069
test4sub76of100,test4pub61of100,10,192,12,20548,1,20561
test4sub82of100,test4pub100of100,10,193,15,1756,0,1771
test4sub76of100,test4pub62of100,10,192,10,20435,1,20446
test4sub76of100,test4pub63of100,10,192,10,20299,0,20309
test4sub76of100,test4pub64of100,10,192,11,19473,1,19485
test4sub64of100,test4pub93of100,10,192,13,3492,1,3506
test4sub76of100,test4pub65of100,10,192,10,17840,1,17851
test4sub64of100,test4pub94of100,10,192,10,2903,0,2913
test4sub76of100,test4pub66of100,10,192,17,17716,1,17734
test4sub64of100,test4pub95of100,10,192,17,2547,1,2565
test4sub76of100,test4pub67of100,10,192,11,17539,1,17551
test4sub64of100,test4pub96of100,10,192,10,2384,1,2395
test4sub42of100,test4pub56of100,10,192,10,22977,1,22988
test4sub76of100,test4pub68of100,10,192,10,17323,2,17335
test4sub42of100,test4pub57of100,10,192,10,22525,1,22536
test4sub64of100,test4pub97of100,10,192,10,2248,2,2260
test4sub42of100,test4pub58of100,10,192,11,21525,1,21537
test4sub76of100,test4pub69of100,10,192,14,17074,2,17090
test4sub64of100,test4pub98of100,10,192,11,2104,3,2118
test4sub39of100,test4pub89of100,10,192,39,4331,2,4372
test4sub42of100,test4pub59of100,10,192,15,21451,3,21469
test4sub76of100,test4pub70of100,10,192,10,16981,3,16994
test4sub64of100,test4pub99of100,10,192,10,1898,2,1910
test4sub42of100,test4pub60of100,10,192,18,21075,2,21095
test4sub39of100,test4pub90of100,10,192,23,4175,2,4200
test4sub76of100,test4pub71of100,10,192,11,16847,1,16859
test4sub39of100,test4pub91of100,10,192,26,4014,1,4041
test4sub83of100,test4pub87of100,10,192,10,5553,3,5566
test4sub42of100,test4pub61of100,10,192,12,20574,3,20589
test4sub64of100,test4pub100of100,10,193,15,1780,4,1799
test4sub76of100,test4pub72of100,10,192,18,12006,3,12027
test4sub39of100,test4pub92of100,10,192,12,3844,4,3860
test4sub83of100,test4pub88of100,10,192,11,5330,3,5344
test4sub3of100,test4pub100of100,10,193,15,1786,4,1805
test4sub42of100,test4pub62of100,10,192,10,20464,4,20478
test4sub76of100,test4pub73of100,10,192,11,11134,3,11148
test4sub39of100,test4pub93of100,10,192,13,3520,3,3536
test4sub83of100,test4pub89of100,10,192,39,4346,3,4388
test4sub42of100,test4pub63of100,10,192,10,20332,2,20344
test4sub39of100,test4pub94of100,10,192,10,2932,3,2945
test4sub76of100,test4pub74of100,10,192,10,10510,2,10522
test4sub83of100,test4pub90of100,10,192,23,4191,2,4216
test4sub42of100,test4pub64of100,10,192,11,19508,4,19523
test4sub39of100,test4pub95of100,10,192,17,2578,2,2597
test4sub1of100,test4pub94of100,10,192,10,2937,4,2951
test4sub83of100,test4pub91of100,10,192,26,4031,3,4060
test4sub76of100,test4pub75of100,10,192,10,9833,4,9847
test4sub42of100,test4pub65of100,10,192,10,17878,3,17891
test4sub39of100,test4pub96of100,10,192,10,2418,4,2432
test4sub1of100,test4pub95of100,10,192,17,2583,2,2602
test4sub83of100,test4pub92of100,10,192,12,3861,3,3876
test4sub39of100,test4pub97of100,10,192,10,2283,1,2294
test4sub42of100,test4pub66of100,10,192,17,17756,3,17776
test4sub1of100,test4pub96of100,10,192,10,2422,3,2435
test4sub83of100,test4pub93of100,10,192,13,3537,2,3552
test4sub39of100,test4pub98of100,10,192,11,2137,2,2150
test4sub42of100,test4pub67of100,10,192,11,17581,2,17594
test4sub83of100,test4pub94of100,10,192,10,2949,1,2960
test4sub39of100,test4pub99of100,10,192,10,1931,2,1943
test4sub42of100,test4pub68of100,10,192,10,17366,1,17377
test4sub39of100,test4pub100of100,10,193,15,1811,0,1826
test4sub42of100,test4pub69of100,10,192,14,17117,0,17131
test4sub42of100,test4pub70of100,10,192,10,17019,0,17029
test4sub42of100,test4pub71of100,10,192,11,16883,1,16895
test4sub1of100,test4pub97of100,10,192,10,2298,0,2308
test4sub1of100,test4pub98of100,10,192,11,2152,1,2164
test4sub1of100,test4pub99of100,10,192,10,1944,1,1955
test4sub22of100,test4pub100of100,10,193,15,1838,0,1853
test4sub76of100,test4pub76of100,10,192,10,9709,1,9720
test4sub76of100,test4pub77of100,10,192,10,9250,1,9261
test4sub76of100,test4pub78of100,10,192,12,9191,1,9204
test4sub87of100,test4pub95of100,10,192,17,2634,1,2652
test4sub76of100,test4pub79of100,10,191,9,9114,0,9123
test4sub87of100,test4pub96of100,10,192,10,2472,1,2483
test4sub76of100,test4pub80of100,10,192,10,8717,1,8728
test4sub87of100,test4pub97of100,10,192,10,2335,0,2345
test4sub42of100,test4pub72of100,10,192,18,12085,1,12104
test4sub42of100,test4pub73of100,10,192,11,11207,0,11218
test4sub42of100,test4pub74of100,10,192,10,10582,1,10593
test4sub42of100,test4pub75of100,10,192,10,9902,0,9912
test4sub42of100,test4pub76of100,10,192,10,9736,1,9747
test4sub42of100,test4pub77of100,10,192,10,9277,0,9287
test4sub42of100,test4pub78of100,10,192,12,9211,0,9223
test4sub83of100,test4pub95of100,10,192,17,2656,1,2674
test4sub42of100,test4pub79of100,10,191,9,9134,2,9145
test4sub83of100,test4pub96of100,10,192,10,2493,0,2503
test4sub83of100,test4pub97of100,10,192,10,2355,0,2365
test4sub83of100,test4pub98of100,10,192,11,2216,0,2227
test4sub83of100,test4pub99of100,10,192,10,2009,1,2020
test4sub83of100,test4pub100of100,10,193,15,1894,0,1909
test4sub13of100,test4pub96of100,10,192,10,2531,1,2542
test4sub13of100,test4pub97of100,10,192,10,2394,1,2405
test4sub1of100,test4pub100of100,10,193,15,1916,0,1931
test4sub13of100,test4pub98of100,10,192,11,2248,0,2259
test4sub13of100,test4pub99of100,10,192,10,2040,1,2051
test4sub40of100,test4pub95of100,10,192,17,2701,0,2718
test4sub40of100,test4pub96of100,10,192,10,2539,1,2550
test4sub40of100,test4pub97of100,10,192,10,2401,1,2412
test4sub76of100,test4pub81of100,10,192,17,8668,1,8686
test4sub76of100,test4pub82of100,10,192,10,8515,1,8526
test4sub40of100,test4pub98of100,10,192,11,2255,1,2267
test4sub76of100,test4pub83of100,10,192,10,8366,1,8377
test4sub40of100,test4pub99of100,10,192,10,2048,1,2059
test4sub40of100,test4pub100of100,10,193,15,1927,0,1942
test4sub76of100,test4pub84of100,10,192,11,8005,1,8017
test4sub76of100,test4pub85of100,10,192,23,6475,1,6499
test4sub76of100,test4pub86of100,10,192,21,6049,0,6070
test4sub76of100,test4pub87of100,10,192,10,5824,1,5835
test4sub87of100,test4pub98of100,10,192,11,2386,1,2398
test4sub76of100,test4pub88of100,10,192,11,5600,1,5612
test4sub87of100,test4pub99of100,10,192,10,2178,1,2189
test4sub42of100,test4pub80of100,10,192,10,8918,1,8929
test4sub87of100,test4pub100of100,10,193,15,2058,1,2074
test4sub42of100,test4pub81of100,10,192,17,8805,1,8823
test4sub42of100,test4pub82of100,10,192,10,8651,1,8662
test4sub42of100,test4pub83of100,10,192,10,8503,1,8514
test4sub8of100,test4pub92of100,10,192,12,4123,0,4135
test4sub42of100,test4pub84of100,10,192,11,8025,1,8037
test4sub8of100,test4pub93of100,10,192,13,3796,1,3810
test4sub42of100,test4pub85of100,10,192,23,6494,1,6518
test4sub8of100,test4pub94of100,10,192,10,3207,1,3218
test4sub42of100,test4pub86of100,10,192,21,6069,1,6091
test4sub42of100,test4pub87of100,10,192,10,5840,1,5851
test4sub42of100,test4pub88of100,10,192,11,5615,0,5626
test4sub59of100,test4pub73of100,10,192,11,11426,0,11437
test4sub59of100,test4pub74of100,10,192,10,10801,1,10812
test4sub13of100,test4pub100of100,10,193,15,2192,1,2208
test4sub76of100,test4pub89of100,10,192,39,4750,1,4790
test4sub76of100,test4pub90of100,10,192,23,4592,1,4616
test4sub76of100,test4pub91of100,10,192,26,4429,0,4455
test4sub76of100,test4pub92of100,10,192,12,4260,0,4272
test4sub76of100,test4pub93of100,10,192,13,3933,1,3947
test4sub76of100,test4pub94of100,10,192,10,3343,1,3354
test4sub76of100,test4pub95of100,10,192,17,2986,0,3003
test4sub76of100,test4pub96of100,10,192,10,2824,1,2835
test4sub76of100,test4pub97of100,10,192,10,2686,1,2697
test4sub42of100,test4pub89of100,10,192,39,4790,1,4830
test4sub42of100,test4pub90of100,10,192,23,4631,0,4654
test4sub42of100,test4pub91of100,10,192,26,4468,0,4494
test4sub42of100,test4pub92of100,10,192,12,4297,1,4310
test4sub42of100,test4pub93of100,10,192,13,3970,1,3984
test4sub42of100,test4pub94of100,10,192,10,3390,0,3400
test4sub42of100,test4pub95of100,10,192,17,3034,1,3052
test4sub42of100,test4pub96of100,10,192,10,2871,0,2881
test4sub42of100,test4pub97of100,10,192,10,2734,1,2745
test4sub42of100,test4pub98of100,10,192,11,2587,0,2598
test4sub8of100,test4pub95of100,10,192,17,3038,1,3056
test4sub42of100,test4pub99of100,10,192,10,2380,1,2391
test4sub8of100,test4pub96of100,10,192,10,2876,1,2887
test4sub8of100,test4pub97of100,10,192,10,2739,1,2750
test4sub8of100,test4pub98of100,10,192,11,2592,1,2604
test4sub20of100,test4pub73of100,10,192,11,11609,1,11621
test4sub8of100,test4pub99of100,10,192,10,2384,2,2396
test4sub21of100,test4pub77of100,10,192,10,9671,2,9683
test4sub20of100,test4pub74of100,10,192,10,10983,3,10996
test4sub59of100,test4pub75of100,10,192,10,10301,3,10314
test4sub8of100,test4pub100of100,10,193,15,2266,2,2283
test4sub21of100,test4pub78of100,10,192,12,9608,2,9622
test4sub20of100,test4pub75of100,10,192,10,10303,4,10317
test4sub59of100,test4pub76of100,10,192,10,10137,2,10149
test4sub21of100,test4pub79of100,10,191,9,9531,2,9542
test4sub20of100,test4pub76of100,10,192,10,10140,1,10151
test4sub59of100,test4pub77of100,10,192,10,9679,1,9690
test4sub20of100,test4pub77of100,10,192,10,9681,0,9691
test4sub59of100,test4pub78of100,10,192,12,9614,1,9627
test4sub59of100,test4pub79of100,10,191,9,9537,1,9547
test4sub20of100,test4pub78of100,10,192,12,9616,1,9629
test4sub20of100,test4pub79of100,10,191,9,9539,1,9549
test4sub59of100,test4pub80of100,10,192,10,9140,1,9151
test4sub20of100,test4pub80of100,10,192,10,9141,0,9151
test4sub20of100,test4pub81of100,10,192,17,9027,1,9045
test4sub20of100,test4pub82of100,10,192,10,8873,1,8884
test4sub20of100,test4pub83of100,10,192,10,8724,0,8734
test4sub20of100,test4pub84of100,10,192,11,8246,1,8258
test4sub20of100,test4pub85of100,10,192,23,6715,1,6739
test4sub20of100,test4pub86of100,10,192,21,6289,0,6310
test4sub20of100,test4pub87of100,10,192,10,6060,1,6071
test4sub20of100,test4pub88of100,10,192,11,5835,1,5847
test4sub76of100,test4pub98of100,10,192,11,2654,0,2665
test4sub76of100,test4pub99of100,10,192,10,2446,1,2457
test4sub76of100,test4pub100of100,10,193,15,2326,1,2342
test4sub42of100,test4pub100of100,10,193,15,2329,1,2345
test4sub15of100,test4pub96of100,10,192,10,2951,1,2962
test4sub15of100,test4pub97of100,10,192,10,2813,0,2823
test4sub15of100,test4pub98of100,10,192,11,2667,0,2678
test4sub15of100,test4pub99of100,10,192,10,2459,1,2470
test4sub20of100,test4pub89of100,10,192,39,4909,0,4948
test4sub20of100,test4pub90of100,10,192,23,4751,1,4775
test4sub20of100,test4pub91of100,10,192,26,4588,1,4615
test4sub20of100,test4pub92of100,10,192,12,4417,1,4430
test4sub20of100,test4pub93of100,10,192,13,4089,0,4102
test4sub20of100,test4pub94of100,10,192,10,3500,1,3511
test4sub20of100,test4pub95of100,10,192,17,3143,9,3169
test4sub59of100,test4pub81of100,10,192,17,9108,9,9134
test4sub20of100,test4pub96of100,10,192,10,2989,0,2999
test4sub59of100,test4pub82of100,10,192,10,8962,1,8973
test4sub20of100,test4pub97of100,10,192,10,2852,1,2863
test4sub59of100,test4pub83of100,10,192,10,8814,1,8825
test4sub59of100,test4pub84of100,10,192,11,8336,1,8348
test4sub20of100,test4pub98of100,10,192,11,2705,1,2717
test4sub20of100,test4pub99of100,10,192,10,2498,0,2508
test4sub59of100,test4pub85of100,10,192,23,6805,1,6829
test4sub20of100,test4pub100of100,10,193,15,2378,1,2394
test4sub59of100,test4pub86of100,10,192,21,6380,1,6402
test4sub59of100,test4pub87of100,10,192,10,6151,1,6162
test4sub59of100,test4pub88of100,10,192,11,5927,1,5939
test4sub15of100,test4pub100of100,10,193,15,2393,0,2408
test4sub21of100,test4pub80of100,10,192,10,9280,0,9290
test4sub21of100,test4pub81of100,10,192,17,9166,1,9184
test4sub21of100,test4pub82of100,10,192,10,9012,0,9022
test4sub21of100,test4pub83of100,10,192,10,8864,1,8875
test4sub21of100,test4pub84of100,10,192,11,8385,1,8397
test4sub21of100,test4pub85of100,10,192,23,6854,1,6878
test4sub59of100,test4pub89of100,10,192,39,4984,1,5024
test4sub21of100,test4pub86of100,10,192,21,6429,0,6450
test4sub21of100,test4pub87of100,10,192,10,6200,1,6211
test4sub59of100,test4pub90of100,10,192,23,4826,1,4850
test4sub59of100,test4pub91of100,10,192,26,4664,1,4691
test4sub21of100,test4pub88of100,10,192,11,5975,1,5987
test4sub21of100,test4pub89of100,10,192,39,4989,0,5028
test4sub21of100,test4pub90of100,10,192,23,4831,1,4855
test4sub21of100,test4pub91of100,10,192,26,4668,0,4694
test4sub59of100,test4pub92of100,10,192,12,4495,1,4508
test4sub21of100,test4pub92of100,10,192,12,4497,1,4510
test4sub59of100,test4pub93of100,10,192,13,4168,1,4182
test4sub21of100,test4pub93of100,10,192,13,4169,1,4183
test4sub59of100,test4pub94of100,10,192,10,3579,1,3590
test4sub21of100,test4pub94of100,10,192,10,3580,10,3600
test4sub59of100,test4pub95of100,10,192,17,3223,9,3249
test4sub21of100,test4pub95of100,10,192,17,3233,0,3250
test4sub59of100,test4pub96of100,10,192,10,3069,0,3079
test4sub21of100,test4pub96of100,10,192,10,3071,1,3082
test4sub46of100,test4pub92of100,10,192,12,4550,1,4563
test4sub46of100,test4pub93of100,10,192,13,4223,0,4236
test4sub46of100,test4pub94of100,10,192,10,3634,1,3645
test4sub46of100,test4pub95of100,10,192,17,3277,1,3295
test4sub46of100,test4pub96of100,10,192,10,3115,0,3125
test4sub21of100,test4pub97of100,10,192,10,2977,1,2988
test4sub46of100,test4pub97of100,10,192,10,2978,2,2990
test4sub21of100,test4pub98of100,10,192,11,2830,1,2842
test4sub46of100,test4pub98of100,10,192,11,2832,0,2843
test4sub46of100,test4pub99of100,10,192,10,2625,1,2636
test4sub46of100,test4pub100of100,10,193,15,2504,0,2519
test4sub21of100,test4pub99of100,10,192,10,2643,2,2655
test4sub59of100,test4pub97of100,10,192,10,3001,0,3011
test4sub21of100,test4pub100of100,10,193,15,2523,1,2539
test4sub59of100,test4pub98of100,10,192,11,2855,1,2867
test4sub59of100,test4pub99of100,10,192,10,2648,1,2659
test4sub59of100,test4pub100of100,10,193,15,2527,1,2543
test4sub51of100,test4pub98of100,10,192,11,3000,0,3011
test4sub51of100,test4pub99of100,10,192,10,2793,1,2804
test4sub51of100,test4pub100of100,10,193,15,2672,0,2687
test4sub45of100,test4pub96of100,10,192,10,3721,1,3732
test4sub45of100,test4pub97of100,10,192,10,3583,1,3594
test4sub45of100,test4pub98of100,10,192,11,3438,1,3450
test4sub45of100,test4pub99of100,10,192,10,3230,0,3240
test4sub45of100,test4pub100of100,10,193,15,3111,1,3127
test4sub79of100,test4pub98of100,10,192,11,3836,0,3847
test4sub79of100,test4pub99of100,10,192,10,3629,1,3640
test4sub79of100,test4pub100of100,10,193,15,3508,1,3524
test4sub25of100,test4pub88of100,10,192,11,7150,0,7161
test4sub25of100,test4pub89of100,10,192,39,6164,1,6204
test4sub25of100,test4pub90of100,10,192,23,6005,1,6029
test4sub9of100,test4pub90of100,10,192,23,6006,1,6030
test4sub25of100,test4pub91of100,10,192,26,5843,1,5870
test4sub9of100,test4pub91of100,10,192,26,5844,0,5870
test4sub9of100,test4pub92of100,10,192,12,5673,1,5686
test4sub25of100,test4pub92of100,10,192,12,5672,1,5685
test4sub9of100,test4pub93of100,10,192,13,5345,1,5359
test4sub25of100,test4pub93of100,10,192,13,5346,0,5359
test4sub9of100,test4pub94of100,10,192,10,4756,0,4766
test4sub9of100,test4pub95of100,10,192,17,4399,1,4417
test4sub74of100,test4pub91of100,10,192,26,5867,1,5894
test4sub74of100,test4pub92of100,10,192,12,5695,0,5707
test4sub74of100,test4pub93of100,10,192,13,5368,1,5382
test4sub25of100,test4pub94of100,10,192,10,4825,1,4836
test4sub25of100,test4pub95of100,10,192,17,4469,0,4486
test4sub25of100,test4pub96of100,10,192,10,4307,1,4318
test4sub25of100,test4pub97of100,10,192,10,4169,0,4179
test4sub25of100,test4pub98of100,10,192,11,4023,1,4035
test4sub25of100,test4pub99of100,10,192,10,3815,0,3825
test4sub9of100,test4pub96of100,10,192,10,4341,1,4352
test4sub9of100,test4pub97of100,10,192,10,4203,1,4214
test4sub9of100,test4pub98of100,10,192,11,4057,0,4068
test4sub9of100,test4pub99of100,10,192,10,3850,1,3861
test4sub9of100,test4pub100of100,10,193,15,3729,0,3744
test4sub25of100,test4pub100of100,10,193,15,3809,0,3824
test4sub74of100,test4pub94of100,10,192,10,4988,1,4999
test4sub74of100,test4pub95of100,10,192,17,4632,0,4649
test4sub74of100,test4pub96of100,10,192,10,4470,1,4481
test4sub74of100,test4pub97of100,10,192,10,4332,0,4342
test4sub74of100,test4pub98of100,10,192,11,4186,1,4198
test4sub74of100,test4pub99of100,10,192,10,3978,0,3988
test4sub74of100,test4pub100of100,10,193,15,3857,1,3873
test4sub57of100,test4pub87of100,10,192,10,7684,1,7695
test4sub57of100,test4pub88of100,10,192,11,7460,1,7472
test4sub57of100,test4pub89of100,10,192,39,6473,1,6513
test4sub57of100,test4pub90of100,10,192,23,6315,1,6339
test4sub57of100,test4pub91of100,10,192,26,6153,1,6180
test4sub57of100,test4pub92of100,10,192,12,5981,0,5993
test4sub57of100,test4pub93of100,10,192,13,5661,1,5675
test4sub57of100,test4pub94of100,10,192,10,5071,1,5082
test4sub57of100,test4pub95of100,10,192,17,4715,0,4732
test4sub57of100,test4pub96of100,10,192,10,4553,1,4564
test4sub57of100,test4pub97of100,10,192,10,4415,0,4425
test4sub57of100,test4pub98of100,10,192,11,4290,0,4301
test4sub57of100,test4pub99of100,10,192,10,4083,1,4094
test4sub57of100,test4pub100of100,10,193,15,3962,0,3977
test4sub30of100,test4pub93of100,10,192,13,5850,1,5864
test4sub30of100,test4pub94of100,10,192,10,5261,0,5271
test4sub30of100,test4pub95of100,10,192,17,4905,1,4923
test4sub30of100,test4pub96of100,10,192,10,4742,0,4752
test4sub30of100,test4pub97of100,10,192,10,4605,1,4616
test4sub30of100,test4pub98of100,10,192,11,4461,1,4473
test4sub30of100,test4pub99of100,10,192,10,4253,12,4275
test4sub30of100,test4pub100of100,10,193,15,4144,1,4160
test4sub92of100,test4pub85of100,10,192,23,8724,1,8748
test4sub92of100,test4pub86of100,10,192,21,8298,0,8319
test4sub92of100,test4pub87of100,10,192,10,8069,1,8080
test4sub92of100,test4pub88of100,10,192,11,7844,0,7855
test4sub92of100,test4pub89of100,10,192,39,6857,1,6897
test4sub92of100,test4pub90of100,10,192,23,6699,1,6723
test4sub92of100,test4pub91of100,10,192,26,6551,0,6577
test4sub92of100,test4pub92of100,10,192,12,6380,1,6393
test4sub92of100,test4pub93of100,10,192,13,6072,1,6086
test4sub92of100,test4pub94of100,10,192,10,5483,1,5494
test4sub92of100,test4pub95of100,10,192,17,5126,0,5143
test4sub92of100,test4pub96of100,10,192,10,4963,1,4974
test4sub92of100,test4pub97of100,10,192,10,4826,1,4837
test4sub92of100,test4pub98of100,10,192,11,4679,0,4690
test4sub92of100,test4pub99of100,10,192,10,4475,1,4486
test4sub92of100,test4pub100of100,10,193,15,4354,0,4369
test4sub28of100,test4pub84of100,10,192,11,10653,0,10664
test4sub28of100,test4pub85of100,10,192,23,9123,1,9147
test4sub28of100,test4pub86of100,10,192,21,8698,1,8720
test4sub28of100,test4pub87of100,10,192,10,8468,1,8479
test4sub28of100,test4pub88of100,10,192,11,8244,0,8255
test4sub28of100,test4pub89of100,10,192,39,7257,1,7297
test4sub28of100,test4pub90of100,10,192,23,7099,0,7122
test4sub28of100,test4pub91of100,10,192,26,6937,1,6964
test4sub28of100,test4pub92of100,10,192,12,6765,0,6777
test4sub28of100,test4pub93of100,10,192,13,6437,0,6450
test4sub28of100,test4pub94of100,10,192,10,5848,1,5859
test4sub28of100,test4pub95of100,10,192,17,5491,1,5509
test4sub28of100,test4pub96of100,10,192,10,5346,0,5356
test4sub28of100,test4pub97of100,10,192,10,5209,1,5220
test4sub28of100,test4pub98of100,10,192,11,5063,1,5075
test4sub28of100,test4pub99of100,10,192,10,4855,1,4866
test4sub28of100,test4pub100of100,10,193,15,4734,0,4749
test4sub75of100,test4pub84of100,10,192,11,11005,1,11017
test4sub75of100,test4pub85of100,10,192,23,9478,1,9502
test4sub75of100,test4pub86of100,10,192,21,9053,1,9075
test4sub75of100,test4pub87of100,10,192,10,8823,1,8834
test4sub75of100,test4pub88of100,10,192,11,8598,1,8610
test4sub75of100,test4pub89of100,10,192,39,7612,1,7652
test4sub75of100,test4pub90of100,10,192,23,7466,1,7490
test4sub75of100,test4pub91of100,10,192,26,7304,1,7331
test4sub75of100,test4pub92of100,10,192,12,7132,0,7144
test4sub75of100,test4pub93of100,10,192,13,6806,0,6819
test4sub75of100,test4pub94of100,10,192,10,6217,1,6228
test4sub75of100,test4pub95of100,10,192,17,5860,0,5877
test4sub75of100,test4pub96of100,10,192,10,5702,1,5713
test4sub75of100,test4pub97of100,10,192,10,5565,1,5576
test4sub75of100,test4pub98of100,10,192,11,5433,1,5445
test4sub75of100,test4pub99of100,10,192,10,5225,1,5236
test4sub75of100,test4pub100of100,10,193,15,5105,1,5121
test4sub51of100,test4pub2of100,100,192,10,68,1,79
test4sub30of100,test4pub2of100,100,192,10,69,0,79
test4sub62of100,test4pub2of100,100,192,10,74,0,84
test4sub89of100,test4pub2of100,100,192,10,91,1,102
test4sub35of100,test4pub2of100,100,192,10,100,1,111
test4sub54of100,test4pub2of100,100,192,10,165,1,176
test4sub33of100,test4pub2of100,100,192,10,166,0,176
test4sub86of100,test4pub2of100,100,192,10,176,1,187
test4sub97of100,test4pub2of100,100,192,10,183,1,194
test4sub27of100,test4pub2of100,100,192,10,185,0,195
test4sub31of100,test4pub2of100,100,192,10,187,1,198
test4sub12of100,test4pub2of100,100,192,10,195,0,205
test4sub8of100,test4pub2of100,100,192,10,214,0,224
test4sub57of100,test4pub2of100,100,192,10,219,1,230
test4sub28of100,test4pub2of100,100,192,10,220,1,231
test4sub42of100,test4pub2of100,100,192,10,223,1,234
test4sub13of100,test4pub2of100,100,192,10,226,0,236
test4sub71of100,test4pub2of100,100,192,10,227,1,238
test4sub4of100,test4pub2of100,100,192,10,323,1,334
test4sub85of100,test4pub2of100,100,192,10,324,1,335
test4sub7of100,test4pub2of100,100,192,10,327,1,338
test4sub10of100,test4pub2of100,100,192,10,329,1,340
test4sub75of100,test4pub2of100,100,192,10,345,1,356
test4sub52of100,test4pub2of100,100,192,10,360,1,371
test4sub84of100,test4pub2of100,100,192,10,387,1,398
test4sub63of100,test4pub2of100,100,192,10,401,0,411
test4sub39of100,test4pub2of100,100,192,10,404,1,415
test4sub43of100,test4pub2of100,100,192,10,418,1,429
test4sub46of100,test4pub2of100,100,192,10,419,0,429
test4sub95of100,test4pub2of100,100,192,10,446,0,456
test4sub21of100,test4pub2of100,100,192,10,449,1,460
test4sub82of100,test4pub2of100,100,192,10,453,1,464
test4sub48of100,test4pub1of100,100,12977,24,487,241,752
test4sub22of100,test4pub2of100,100,192,10,476,218,704
test4sub20of100,test4pub2of100,100,192,10,490,206,706
test4sub90of100,test4pub2of100,100,192,10,503,193,706
test4sub24of100,test4pub2of100,100,192,10,540,156,706
test4sub47of100,test4pub2of100,100,192,10,811,1,822
test4sub60of100,test4pub2of100,100,192,10,828,1,839
test4sub30of100,test4pub3of100,100,192,28,738,1,767
test4sub90of100,test4pub3of100,100,192,28,805,1,834
test4sub52of100,test4pub3of100,100,192,28,822,1,851
test4sub46of100,test4pub3of100,100,192,28,836,0,864
test4sub95of100,test4pub3of100,100,192,28,840,0,868
test4sub13of100,test4pub3of100,100,192,28,863,1,892
test4sub20of100,test4pub3of100,100,192,28,877,0,905
test4sub75of100,test4pub3of100,100,192,28,958,0,986
test4sub60of100,test4pub3of100,100,192,28,966,1,995
test4sub85of100,test4pub3of100,100,192,28,985,1,1014
test4sub48of100,test4pub2of100,100,192,10,1204,0,1214
test4sub48of100,test4pub3of100,100,192,28,1107,1,1136
test4sub71of100,test4pub3of100,100,192,28,1292,0,1320
test4sub40of100,test4pub1of100,100,12977,24,1443,42,1509
test4sub40of100,test4pub2of100,100,192,10,1453,1,1464
test4sub68of100,test4pub2of100,100,192,10,1453,0,1463
test4sub40of100,test4pub3of100,100,192,28,1357,1,1386
test4sub26of100,test4pub2of100,100,192,10,1497,1,1508
test4sub87of100,test4pub2of100,100,192,10,1527,0,1537
test4sub53of100,test4pub2of100,100,192,10,1535,0,1545
test4sub36of100,test4pub97of100,10,192,10,7248,1,7259
test4sub36of100,test4pub98of100,10,192,11,7101,0,7112
test4sub36of100,test4pub99of100,10,192,10,6894,1,6905
test4sub36of100,test4pub100of100,10,193,15,6773,0,6788
test4sub36of100,test4pub2of100,100,192,10,1542,1,1553
test4sub36of100,test4pub3of100,100,192,28,1446,1,1475
test4sub83of100,test4pub2of100,100,192,10,1547,1,1558
test4sub50of100,test4pub74of100,10,192,10,15518,1,15529
test4sub50of100,test4pub75of100,10,192,10,14836,0,14846
test4sub50of100,test4pub76of100,10,192,10,14670,0,14680
test4sub98of100,test4pub2of100,100,192,10,1605,1,1616
test4sub98of100,test4pub3of100,100,192,28,1508,1,1537
test4sub3of100,test4pub2of100,100,192,10,1616,1,1627
test4sub3of100,test4pub3of100,100,192,28,1520,1,1549
test4sub15of100,test4pub1of100,100,12977,24,1729,44,1797
test4sub4of100,test4pub1of100,100,12977,24,1744,68,1836
test4sub12of100,test4pub3of100,100,192,28,1637,45,1710
test4sub15of100,test4pub2of100,100,192,10,1740,40,1790
test4sub46of100,test4pub1of100,100,12977,24,1779,78,1881
test4sub4of100,test4pub3of100,100,192,28,1682,43,1753
test4sub15of100,test4pub3of100,100,192,28,1683,43,1754
test4sub85of100,test4pub1of100,100,12977,24,1872,41,1937
test4sub79of100,test4pub2of100,100,192,10,1888,1,1899
test4sub53of100,test4pub3of100,100,192,28,1812,1,1841
test4sub50of100,test4pub77of100,10,192,10,14609,1,14620
test4sub50of100,test4pub78of100,10,192,12,14543,0,14555
test4sub50of100,test4pub79of100,10,191,9,14466,1,14476
test4sub50of100,test4pub80of100,10,192,10,14068,1,14079
test4sub50of100,test4pub81of100,10,192,17,13953,0,13970
test4sub50of100,test4pub82of100,10,192,10,13800,1,13811
test4sub50of100,test4pub83of100,10,192,10,13651,0,13661
test4sub50of100,test4pub84of100,10,192,11,13172,1,13184
test4sub50of100,test4pub85of100,10,192,23,11642,1,11666
test4sub50of100,test4pub86of100,10,192,21,11216,1,11238
test4sub50of100,test4pub87of100,10,192,10,10987,1,10998
test4sub71of100,test4pub1of100,100,12977,24,2019,42,2085
test4sub50of100,test4pub88of100,10,192,11,10763,42,10816
test4sub25of100,test4pub2of100,100,192,10,2013,16,2039
test4sub50of100,test4pub89of100,10,192,39,9818,0,9857
test4sub25of100,test4pub3of100,100,192,28,1932,0,1960
test4sub52of100,test4pub1of100,100,12977,24,2163,42,2229
test4sub31of100,test4pub1of100,100,12977,24,2167,82,2273
test4sub50of100,test4pub90of100,10,192,23,9764,81,9868
test4sub50of100,test4pub91of100,10,192,26,9681,1,9708
test4sub31of100,test4pub3of100,100,192,28,2118,0,2146
test4sub50of100,test4pub92of100,10,192,12,9510,1,9523
test4sub50of100,test4pub93of100,10,192,13,9183,1,9197
test4sub50of100,test4pub94of100,10,192,10,8593,0,8603
test4sub50of100,test4pub95of100,10,192,17,8237,1,8255
test4sub50of100,test4pub96of100,10,192,10,8074,0,8084
test4sub50of100,test4pub97of100,10,192,10,7936,0,7946
test4sub68of100,test4pub1of100,100,12977,24,2362,46,2432
test4sub26of100,test4pub1of100,100,12977,24,2384,69,2477
test4sub43of100,test4pub1of100,100,12977,24,2391,105,2520
test4sub12of100,test4pub1of100,100,12977,24,2405,134,2563
test4sub68of100,test4pub3of100,100,192,28,2278,132,2438
test4sub83of100,test4pub1of100,100,12977,24,2410,171,2605
test4sub50of100,test4pub98of100,10,192,11,7941,171,8123
test4sub26of100,test4pub3of100,100,192,28,2323,131,2482
test4sub34of100,test4pub1of100,100,12977,24,2461,168,2653
test4sub46of100,test4pub4of100,100,192,11,989,166,1166
test4sub31of100,test4pub4of100,100,192,11,988,166,1165
test4sub71of100,test4pub4of100,100,192,11,989,166,1166
test4sub52of100,test4pub4of100,100,192,11,992,165,1168
test4sub43of100,test4pub3of100,100,192,28,2366,135,2529
test4sub4of100,test4pub4of100,100,192,11,1051,105,1167
test4sub85of100,test4pub4of100,100,192,11,1053,104,1168
test4sub15of100,test4pub4of100,100,192,11,1054,103,1168
test4sub65of100,test4pub1of100,100,12977,24,2537,140,2701
test4sub93of100,test4pub1of100,100,12977,24,2559,162,2745
test4sub68of100,test4pub4of100,100,192,11,1098,146,1255
test4sub83of100,test4pub3of100,100,192,28,2451,139,2618
test4sub50of100,test4pub99of100,10,192,10,7905,139,8054
test4sub1of100,test4pub1of100,100,12977,24,2585,184,2793
test4sub29of100,test4pub2of100,100,192,10,2552,183,2745
test4sub26of100,test4pub4of100,100,192,11,1110,184,1305
test4sub21of100,test4pub1of100,100,12977,24,2592,221,2837
test4sub12of100,test4pub4of100,100,192,11,1128,210,1349
test4sub34of100,test4pub2of100,100,192,10,2597,184,2791
test4sub13of100,test4pub1of100,100,12977,24,2631,226,2881
test4sub71of100,test4pub5of100,100,192,14,177,206,397
test4sub31of100,test4pub5of100,100,192,14,196,187,397
test4sub52of100,test4pub5of100,100,192,14,200,184,398
test4sub46of100,test4pub5of100,100,192,14,201,184,399
test4sub65of100,test4pub2of100,100,192,10,2644,181,2835
test4sub4of100,test4pub5of100,100,192,14,205,181,400
test4sub85of100,test4pub5of100,100,192,14,205,180,399
test4sub15of100,test4pub5of100,100,192,14,208,178,400
test4sub3of100,test4pub1of100,100,12977,24,2690,211,2925
test4sub74of100,test4pub1of100,100,12977,24,2692,248,2964
test4sub48of100,test4pub4of100,100,192,11,1232,232,1475
test4sub93of100,test4pub2of100,100,192,10,2688,220,2918
test4sub83of100,test4pub4of100,100,192,11,1246,220,1477
test4sub50of100,test4pub100of100,10,193,15,7923,219,8157
test4sub10of100,test4pub1of100,100,12977,24,2726,355,3105
test4sub68of100,test4pub5of100,100,192,14,254,352,620
test4sub29of100,test4pub3of100,100,192,28,2639,312,2979
test4sub1of100,test4pub2of100,100,192,10,2736,313,3059
test4sub26of100,test4pub5of100,100,192,14,338,271,623
test4sub21of100,test4pub3of100,100,192,28,2683,270,2981
test4sub34of100,test4pub3of100,100,192,28,2684,271,2983
test4sub12of100,test4pub5of100,100,192,14,363,248,625
test4sub13of100,test4pub4of100,100,192,11,1381,229,1621
test4sub65of100,test4pub3of100,100,192,28,2729,229,2986
test4sub55of100,test4pub2of100,100,192,10,2840,215,3065
test4sub3of100,test4pub4of100,100,192,11,1425,188,1624
test4sub74of100,test4pub2of100,100,192,10,2908,148,3066
test4sub48of100,test4pub5of100,100,192,14,467,150,631
test4sub93of100,test4pub3of100,100,192,28,2812,149,2989
test4sub83of100,test4pub5of100,100,192,14,469,149,632
test4sub50of100,test4pub2of100,100,192,10,2911,148,3069
test4sub28of100,test4pub3of100,100,192,28,2827,136,2991
test4sub77of100,test4pub1of100,100,12977,24,2963,174,3161
test4sub5of100,test4pub1of100,100,12977,24,2982,199,3205
test4sub56of100,test4pub2of100,100,192,10,3000,147,3157
test4sub41of100,test4pub2of100,100,192,10,3005,144,3159
test4sub7of100,test4pub1of100,100,12977,24,3070,155,3249
test4sub10of100,test4pub3of100,100,192,28,2950,143,3121
test4sub1of100,test4pub3of100,100,192,28,2952,143,3123
test4sub21of100,test4pub4of100,100,192,11,1608,142,1761
test4sub17of100,test4pub1of100,100,12977,24,3087,181,3292
test4sub13of100,test4pub5of100,100,192,14,614,181,809
test4sub65of100,test4pub4of100,100,192,11,1613,180,1804
test4sub3of100,test4pub5of100,100,192,14,616,181,811
test4sub74of100,test4pub3of100,100,192,28,2960,181,3169
test4sub93of100,test4pub4of100,100,192,11,1617,179,1807
test4sub50of100,test4pub3of100,100,192,28,2963,180,3171
test4sub77of100,test4pub2of100,100,192,10,3105,136,3251
test4sub87of100,test4pub1of100,100,12977,24,3150,167,3341
test4sub5of100,test4pub2of100,100,192,10,3148,135,3293
test4sub56of100,test4pub3of100,100,192,28,3051,137,3216
test4sub19of100,test4pub84of100,10,192,11,14356,122,14489
test4sub7of100,test4pub3of100,100,192,28,3094,94,3216
test4sub10of100,test4pub4of100,100,192,11,1750,95,1856
test4sub1of100,test4pub4of100,100,192,11,1751,96,1858
test4sub21of100,test4pub5of100,100,192,14,753,97,864
test4sub99of100,test4pub73of100,10,192,11,17810,60,17881
test4sub17of100,test4pub2of100,100,192,10,3236,56,3302
test4sub65of100,test4pub5of100,100,192,14,796,57,867
test4sub74of100,test4pub4of100,100,192,11,1796,55,1862
test4sub93of100,test4pub5of100,100,192,14,799,55,868
test4sub77of100,test4pub3of100,100,192,28,3143,54,3225
test4sub50of100,test4pub1of100,100,12977,24,3276,97,3397
test4sub29of100,test4pub1of100,100,12977,24,3295,117,3436
test4sub87of100,test4pub3of100,100,192,28,3186,95,3309
test4sub5of100,test4pub3of100,100,192,28,3187,97,3312
test4sub19of100,test4pub85of100,10,192,23,12947,95,13065
test4sub7of100,test4pub4of100,100,192,11,1844,97,1952
test4sub10of100,test4pub5of100,100,192,14,847,95,956
test4sub44of100,test4pub1of100,100,12977,24,3324,137,3485
test4sub1of100,test4pub5of100,100,192,14,850,136,1000
test4sub99of100,test4pub74of100,10,192,10,17244,136,17390
test4sub17of100,test4pub3of100,100,192,28,3196,136,3360
test4sub74of100,test4pub5of100,100,192,14,854,135,1003
test4sub77of100,test4pub4of100,100,192,11,1853,135,1999
test4sub70of100,test4pub1of100,100,12977,24,3347,162,3533
test4sub66of100,test4pub1of100,100,12977,24,3360,193,3577
test4sub50of100,test4pub4of100,100,192,11,1897,179,2087
test4sub28of100,test4pub1of100,100,12977,24,3408,189,3621
test4sub29of100,test4pub4of100,100,192,11,1938,183,2132
test4sub87of100,test4pub4of100,100,192,11,1938,185,2134
test4sub5of100,test4pub4of100,100,192,11,1939,183,2133
test4sub19of100,test4pub86of100,10,192,21,12617,184,12822
test4sub7of100,test4pub5of100,100,192,14,943,184,1141
test4sub21of100,test4pub6of100,100,192,26,624,179,829
test4sub68of100,test4pub6of100,100,192,26,631,173,830
test4sub85of100,test4pub6of100,100,192,26,642,161,829
test4sub71of100,test4pub6of100,100,192,26,647,157,830
test4sub4of100,test4pub6of100,100,192,26,648,156,830
test4sub48of100,test4pub6of100,100,192,26,656,149,831
test4sub1of100,test4pub6of100,100,192,26,664,142,832
test4sub44of100,test4pub2of100,100,192,10,3428,142,3580
test4sub99of100,test4pub75of100,10,192,10,16697,140,16847
test4sub17of100,test4pub4of100,100,192,11,1987,141,2139
test4sub74of100,test4pub6of100,100,192,26,667,141,834
test4sub77of100,test4pub5of100,100,192,14,991,142,1147
test4sub3of100,test4pub6of100,100,192,26,694,114,834
test4sub12of100,test4pub6of100,100,192,26,710,99,835
test4sub70of100,test4pub2of100,100,192,10,3477,98,3585
test4sub52of100,test4pub6of100,100,192,26,712,98,836
test4sub46of100,test4pub6of100,100,192,26,715,95,836
test4sub83of100,test4pub6of100,100,192,26,721,91,838
test4sub55of100,test4pub1of100,100,12977,24,3532,121,3677
test4sub38of100,test4pub2of100,100,192,10,3501,118,3629
test4sub66of100,test4pub2of100,100,192,10,3520,144,3674
test4sub22of100,test4pub1of100,100,12977,24,3549,149,3722
test4sub50of100,test4pub5of100,100,192,14,1080,146,1240
test4sub43of100,test4pub4of100,100,192,11,2085,139,2235
test4sub28of100,test4pub4of100,100,192,11,2121,104,2236
test4sub29of100,test4pub5of100,100,192,14,1123,104,1241
test4sub87of100,test4pub5of100,100,192,14,1125,105,1244
test4sub5of100,test4pub5of100,100,192,14,1125,104,1243
test4sub19of100,test4pub87of100,10,192,10,12571,104,12685
test4sub44of100,test4pub3of100,100,192,28,3473,101,3602
test4sub17of100,test4pub5of100,100,192,14,1131,101,1246
test4sub77of100,test4pub6of100,100,192,26,809,101,936
test4sub70of100,test4pub3of100,100,192,28,3477,99,3604
test4sub91of100,test4pub1of100,100,12977,24,3637,112,3773
test4sub55of100,test4pub3of100,100,192,28,3522,96,3646
test4sub40of100,test4pub4of100,100,192,11,2200,74,2285
test4sub14of100,test4pub1of100,100,12977,24,3678,115,3817
test4sub32of100,test4pub1of100,100,12977,24,3696,141,3861
test4sub100of100,test4pub3of100,100,192,28,3566,139,3733
test4sub66of100,test4pub3of100,100,192,28,3567,139,3734
test4sub22of100,test4pub3of100,100,192,28,3568,141,3737
test4sub50of100,test4pub6of100,100,192,26,902,139,1067
test4sub48of100,test4pub7of100,100,192,14,269,141,424
test4sub29of100,test4pub6of100,100,192,26,905,139,1070
test4sub28of100,test4pub5of100,100,192,14,1228,139,1381
test4sub5of100,test4pub6of100,100,192,26,906,138,1070
test4sub87of100,test4pub6of100,100,192,26,906,139,1071
test4sub19of100,test4pub88of100,10,192,11,12450,139,12600
test4sub44of100,test4pub4of100,100,192,11,2230,139,2380
test4sub85of100,test4pub7of100,100,192,14,275,138,427
test4sub70of100,test4pub4of100,100,192,11,2233,138,2382
test4sub1of100,test4pub7of100,100,192,14,281,133,428
test4sub71of100,test4pub7of100,100,192,14,282,134,430
test4sub74of100,test4pub7of100,100,192,14,294,122,430
test4sub23of100,test4pub2of100,100,192,10,3696,119,3825
test4sub4of100,test4pub7of100,100,192,14,301,115,430
test4sub63of100,test4pub1of100,100,12977,24,3740,153,3917
test4sub3of100,test4pub7of100,100,192,14,311,149,474
test4sub68of100,test4pub7of100,100,192,14,312,151,477
test4sub21of100,test4pub7of100,100,192,14,316,148,478
test4sub91of100,test4pub2of100,100,192,10,3717,146,3873
test4sub55of100,test4pub4of100,100,192,11,2274,146,2431
test4sub40of100,test4pub5of100,100,192,14,1278,146,1438
test4sub49of100,test4pub72of100,10,192,18,19177,145,19340
test4sub12of100,test4pub7of100,100,192,14,326,141,481
test4sub52of100,test4pub7of100,100,192,14,327,140,481
test4sub67of100,test4pub2of100,100,192,10,3729,139,3878
test4sub46of100,test4pub7of100,100,192,14,331,138,483
test4sub14of100,test4pub2of100,100,192,10,3760,108,3878
test4sub32of100,test4pub2of100,100,192,10,3804,64,3878
test4sub66of100,test4pub4of100,100,192,11,2363,64,2438
test4sub22of100,test4pub4of100,100,192,11,2364,63,2438
test4sub50of100,test4pub7of100,100,192,14,408,64,486
test4sub28of100,test4pub6of100,100,192,26,1045,63,1134
test4sub5of100,test4pub7of100,100,192,14,411,63,488
test4sub34of100,test4pub4of100,100,192,11,2368,61,2440
test4sub44of100,test4pub5of100,100,192,14,1372,61,1447
test4sub70of100,test4pub5of100,100,192,14,1373,60,1447
test4sub23of100,test4pub3of100,100,192,28,3718,59,3805
test4sub26of100,test4pub6of100,100,192,26,1059,51,1136
test4sub48of100,test4pub8of100,100,192,12,183,31,226
test4sub71of100,test4pub8of100,100,192,12,183,30,225
test4sub3of100,test4pub8of100,100,192,12,198,17,227
test4sub63of100,test4pub3of100,100,192,28,3762,17,3807
test4sub74of100,test4pub8of100,100,192,12,199,17,228
test4sub91of100,test4pub3of100,100,192,28,3765,16,3809
test4sub55of100,test4pub5of100,100,192,14,1423,16,1453
test4sub40of100,test4pub6of100,100,192,26,1100,15,1141
test4sub1of100,test4pub8of100,100,192,12,203,16,231
test4sub14of100,test4pub3of100,100,192,28,3771,14,3813
test4sub32of100,test4pub3of100,100,192,28,3771,14,3813
test4sub66of100,test4pub5of100,100,192,14,1429,14,1457
test4sub22of100,test4pub5of100,100,192,14,1430,14,1458
test4sub52of100,test4pub8of100,100,192,12,208,15,235
test4sub34of100,test4pub5of100,100,192,14,1433,13,1460
test4sub44of100,test4pub6of100,100,192,26,1109,14,1149
test4sub70of100,test4pub6of100,100,192,26,1110,13,1149
test4sub26of100,test4pub7of100,100,192,14,478,12,504
test4sub63of100,test4pub4of100,100,192,11,2436,11,2458
test4sub91of100,test4pub4of100,100,192,11,2437,10,2458
test4sub55of100,test4pub6of100,100,192,26,1115,11,1152
test4sub46of100,test4pub8of100,100,192,12,218,11,241
test4sub40of100,test4pub7of100,100,192,14,483,10,507
test4sub14of100,test4pub4of100,100,192,11,2441,8,2460
test4sub32of100,test4pub4of100,100,192,11,2441,8,2460
test4sub66of100,test4pub6of100,100,192,26,1121,8,1155
test4sub22of100,test4pub6of100,100,192,26,1121,10,1157
test4sub50of100,test4pub8of100,100,192,12,224,9,245
test4sub34of100,test4pub6of100,100,192,26,1123,9,1158
test4sub63of100,test4pub5of100,100,192,14,1449,8,1471
test4sub91of100,test4pub5of100,100,192,14,1449,7,1470
test4sub14of100,test4pub5of100,100,192,14,1452,7,1473
test4sub32of100,test4pub5of100,100,192,14,1452,7,1473
test4sub68of100,test4pub8of100,100,192,12,231,6,249
test4sub4of100,test4pub8of100,100,192,12,232,5,249
test4sub12of100,test4pub8of100,100,192,12,233,5,250
test4sub91of100,test4pub6of100,100,192,26,1133,3,1162
test4sub63of100,test4pub6of100,100,192,26,1133,3,1162
test4sub32of100,test4pub6of100,100,192,26,1135,3,1164
test4sub14of100,test4pub6of100,100,192,26,1135,4,1165
test4sub91of100,test4pub7of100,100,192,14,503,3,520
test4sub63of100,test4pub7of100,100,192,14,504,4,522
test4sub5of100,test4pub8of100,100,192,12,240,3,255
test4sub32of100,test4pub7of100,100,192,14,505,3,522
test4sub14of100,test4pub7of100,100,192,14,506,3,523
test4sub21of100,test4pub8of100,100,192,12,243,1,256
test4sub47of100,test4pub3of100,100,192,28,3811,2,3841
test4sub85of100,test4pub8of100,100,192,12,247,1,260
test4sub91of100,test4pub8of100,100,192,12,260,1,273
test4sub14of100,test4pub8of100,100,192,12,267,1,280
test4sub34of100,test4pub7of100,100,192,14,532,1,547
test4sub34of100,test4pub8of100,100,192,12,270,1,283
test4sub40of100,test4pub8of100,100,192,12,271,1,284
test4sub32of100,test4pub8of100,100,192,12,275,1,288
test4sub26of100,test4pub8of100,100,192,12,284,1,297
test4sub49of100,test4pub73of100,10,192,11,18545,1,18557
test4sub49of100,test4pub74of100,10,192,10,17919,0,17929
test4sub49of100,test4pub75of100,10,192,10,17236,1,17247
test4sub49of100,test4pub76of100,10,192,10,17071,1,17082
test4sub49of100,test4pub77of100,10,192,10,16611,1,16622
test4sub49of100,test4pub78of100,10,192,12,16546,1,16559
test4sub49of100,test4pub79of100,10,191,9,16468,0,16477
test4sub49of100,test4pub80of100,10,192,10,16071,1,16082
test4sub49of100,test4pub81of100,10,192,17,15956,0,15973
test4sub49of100,test4pub82of100,10,192,10,15802,0,15812
test4sub49of100,test4pub83of100,10,192,10,15654,4,15668
test4sub75of100,test4pub1of100,100,12977,24,4017,44,4085
test4sub49of100,test4pub84of100,10,192,11,15178,42,15231
test4sub75of100,test4pub4of100,100,192,11,2585,1,2597
test4sub49of100,test4pub85of100,10,192,23,13689,1,13713
test4sub75of100,test4pub5of100,100,192,14,1589,1,1604
test4sub75of100,test4pub6of100,100,192,26,1266,0,1292
test4sub75of100,test4pub7of100,100,192,14,634,1,649
test4sub75of100,test4pub8of100,100,192,12,371,0,383
test4sub49of100,test4pub86of100,10,192,21,13364,1,13386
test4sub49of100,test4pub87of100,10,192,10,13134,0,13144
test4sub49of100,test4pub88of100,10,192,11,12910,1,12922
test4sub49of100,test4pub89of100,10,192,39,11924,1,11964
test4sub49of100,test4pub90of100,10,192,23,11765,0,11788
test4sub49of100,test4pub91of100,10,192,26,11603,1,11630
test4sub49of100,test4pub92of100,10,192,12,11431,0,11443
test4sub49of100,test4pub93of100,10,192,13,11104,1,11118
test4sub49of100,test4pub94of100,10,192,10,10514,1,10525
test4sub46of100,test4pub9of100,100,192,20,379,1,400
test4sub31of100,test4pub6of100,100,192,26,1472,1,1499
test4sub59of100,test4pub1of100,100,12977,24,4271,43,4338
test4sub73of100,test4pub78of100,10,192,12,16815,37,16864
test4sub91of100,test4pub9of100,100,192,20,402,33,455
test4sub68of100,test4pub9of100,100,192,20,409,25,454
test4sub52of100,test4pub9of100,100,192,20,411,24,455
test4sub100of100,test4pub1of100,100,12977,24,4301,60,4385
test4sub5of100,test4pub9of100,100,192,20,423,57,500
test4sub75of100,test4pub9of100,100,192,20,423,57,500
test4sub23of100,test4pub1of100,100,12977,24,4308,97,4429
test4sub40of100,test4pub9of100,100,192,20,428,95,543
test4sub48of100,test4pub9of100,100,192,20,431,94,545
test4sub59of100,test4pub2of100,100,192,10,4281,92,4383
test4sub73of100,test4pub79of100,10,191,9,16775,92,16876
test4sub45of100,test4pub2of100,100,192,10,4285,90,4385
test4sub26of100,test4pub9of100,100,192,20,453,75,548
test4sub100of100,test4pub2of100,100,192,10,4328,48,4386
test4sub1of100,test4pub9of100,100,192,20,503,26,549
test4sub12of100,test4pub9of100,100,192,20,505,24,549
test4sub14of100,test4pub9of100,100,192,20,509,21,550
test4sub3of100,test4pub9of100,100,192,20,509,21,550
test4sub8of100,test4pub3of100,100,192,28,4261,19,4308
test4sub4of100,test4pub9of100,100,192,20,514,17,551
test4sub23of100,test4pub4of100,100,192,11,2929,7,2947
test4sub73of100,test4pub80of100,10,192,10,16469,7,16486
test4sub85of100,test4pub9of100,100,192,20,527,6,553
test4sub59of100,test4pub3of100,100,192,28,4276,7,4311
test4sub100of100,test4pub4of100,100,192,11,2934,6,2951
test4sub74of100,test4pub9of100,100,192,20,532,3,555
test4sub23of100,test4pub5of100,100,192,14,1939,4,1957
test4sub73of100,test4pub81of100,10,192,17,16360,2,16379
test4sub59of100,test4pub4of100,100,192,11,2940,2,2953
test4sub73of100,test4pub82of100,10,192,10,16208,1,16219
test4sub23of100,test4pub6of100,100,192,26,1620,2,1648
test4sub59of100,test4pub5of100,100,192,14,1945,1,1960
test4sub73of100,test4pub83of100,10,192,10,16061,2,16073
test4sub59of100,test4pub6of100,100,192,26,1624,1,1651
test4sub23of100,test4pub7of100,100,192,14,989,2,1005
test4sub73of100,test4pub84of100,10,192,11,15583,1,15595
test4sub59of100,test4pub7of100,100,192,14,991,1,1006
test4sub73of100,test4pub85of100,10,192,23,14053,0,14076
test4sub73of100,test4pub86of100,10,192,21,13627,0,13648
test4sub73of100,test4pub87of100,10,192,10,13398,1,13409
test4sub73of100,test4pub88of100,10,192,11,13173,0,13184
test4sub73of100,test4pub89of100,10,192,39,12186,0,12225
test4sub73of100,test4pub90of100,10,192,23,12028,1,12052
test4sub73of100,test4pub91of100,10,192,26,11865,1,11892
test4sub93of100,test4pub6of100,100,192,26,1670,0,1696
test4sub47of100,test4pub1of100,100,12977,24,4479,42,4545
test4sub59of100,test4pub8of100,100,192,12,786,39,837
test4sub73of100,test4pub92of100,10,192,12,11764,18,11794
test4sub59of100,test4pub9of100,100,192,20,641,1,662
test4sub47of100,test4pub4of100,100,192,11,3045,2,3058
test4sub73of100,test4pub93of100,10,192,13,11453,1,11467
test4sub47of100,test4pub5of100,100,192,14,2050,1,2065
test4sub73of100,test4pub94of100,10,192,10,10864,1,10875
test4sub47of100,test4pub6of100,100,192,26,1728,1,1755
test4sub73of100,test4pub95of100,10,192,17,10508,0,10525
test4sub47of100,test4pub7of100,100,192,14,1095,1,1110
test4sub73of100,test4pub96of100,10,192,10,10346,1,10357
test4sub73of100,test4pub97of100,10,192,10,10214,0,10224
test4sub73of100,test4pub98of100,10,192,11,10067,0,10078
test4sub73of100,test4pub99of100,10,192,10,9860,1,9871
test4sub24of100,test4pub1of100,100,12977,24,4546,43,4613
test4sub91of100,test4pub10of100,100,193,11,313,30,354
test4sub24of100,test4pub3of100,100,192,28,4459,0,4487
test4sub24of100,test4pub4of100,100,192,11,3115,1,3127
test4sub52of100,test4pub10of100,100,193,11,368,1,380
test4sub48of100,test4pub10of100,100,193,11,369,1,381
test4sub40of100,test4pub10of100,100,193,11,371,0,382
test4sub46of100,test4pub10of100,100,193,11,373,1,385
test4sub1of100,test4pub10of100,100,193,11,388,0,399
test4sub75of100,test4pub10of100,100,193,11,399,0,410
test4sub68of100,test4pub10of100,100,193,11,403,1,415
test4sub37of100,test4pub3of100,100,192,28,4533,1,4562
test4sub43of100,test4pub5of100,100,192,14,2202,1,2217
test4sub43of100,test4pub6of100,100,192,26,1879,0,1905
test4sub73of100,test4pub100of100,10,193,15,9921,1,9937
test4sub73of100,test4pub2of100,100,192,10,4691,1,4702
test4sub73of100,test4pub3of100,100,192,28,4594,0,4622
test4sub24of100,test4pub5of100,100,192,14,2257,0,2271
test4sub24of100,test4pub6of100,100,192,26,1935,1,1962
test4sub24of100,test4pub7of100,100,192,14,1302,1,1317
test4sub24of100,test4pub8of100,100,192,12,1039,1,1052
test4sub24of100,test4pub9of100,100,192,20,856,0,876
test4sub24of100,test4pub10of100,100,193,11,492,0,503
test4sub15of100,test4pub6of100,100,192,26,1945,1,1972
test4sub71of100,test4pub9of100,100,192,20,863,0,883
test4sub71of100,test4pub10of100,100,193,11,500,1,512
test4sub71of100,test4pub11of100,100,193,10,264,0,274
test4sub96of100,test4pub1of100,100,12977,24,4753,45,4822
test4sub34of100,test4pub9of100,100,192,20,890,27,937
test4sub52of100,test4pub11of100,100,193,10,296,20,326
test4sub48of100,test4pub11of100,100,193,10,302,14,326
test4sub13of100,test4pub6of100,100,192,26,1993,8,2027
test4sub40of100,test4pub11of100,100,193,10,313,5,328
test4sub46of100,test4pub11of100,100,193,10,314,4,328
test4sub96of100,test4pub2of100,100,192,10,4765,3,4778
test4sub34of100,test4pub10of100,100,193,11,553,3,567
test4sub13of100,test4pub7of100,100,192,14,1369,2,1385
test4sub96of100,test4pub3of100,100,192,28,4671,1,4700
test4sub13of100,test4pub8of100,100,192,12,1107,1,1120
test4sub96of100,test4pub4of100,100,192,11,3329,1,3341
test4sub96of100,test4pub5of100,100,192,14,2332,0,2346
test4sub96of100,test4pub6of100,100,192,26,2010,1,2037
test4sub1of100,test4pub11of100,100,193,10,327,1,338
test4sub75of100,test4pub11of100,100,193,10,328,1,339
test4sub68of100,test4pub11of100,100,193,10,332,1,343
test4sub77of100,test4pub7of100,100,192,14,1385,1,1400
test4sub77of100,test4pub8of100,100,192,12,1123,1,1136
test4sub77of100,test4pub9of100,100,192,20,939,0,959
test4sub56of100,test4pub1of100,100,12977,24,4846,43,4913
test4sub86of100,test4pub1of100,100,12977,24,4866,162,5052
test4sub87of100,test4pub7of100,100,192,14,1437,160,1611
test4sub56of100,test4pub4of100,100,192,11,3414,140,3565
test4sub24of100,test4pub11of100,100,193,10,413,135,558
test4sub96of100,test4pub7of100,100,192,14,1473,125,1612
test4sub29of100,test4pub7of100,100,192,14,1504,96,1614
test4sub76of100,test4pub1of100,100,12977,24,4956,117,5097
test4sub13of100,test4pub9of100,100,192,20,1091,101,1212
test4sub69of100,test4pub78of100,10,192,12,17524,89,17625
test4sub77of100,test4pub10of100,100,193,11,751,78,840
test4sub12of100,test4pub10of100,100,193,11,753,78,842
test4sub66of100,test4pub7of100,100,192,14,1567,77,1658
test4sub43of100,test4pub7of100,100,192,14,1579,66,1659
test4sub51of100,test4pub1of100,100,12977,24,5017,104,5145
test4sub87of100,test4pub8of100,100,192,12,1333,92,1437
test4sub86of100,test4pub3of100,100,192,28,4898,93,5019
test4sub96of100,test4pub8of100,100,192,12,1336,93,1441
test4sub29of100,test4pub8of100,100,192,12,1336,95,1443
test4sub22of100,test4pub7of100,100,192,14,1630,66,1710
test4sub13of100,test4pub10of100,100,193,11,828,55,894
test4sub76of100,test4pub2of100,100,192,10,5041,55,5106
test4sub77of100,test4pub11of100,100,193,10,593,55,658
test4sub69of100,test4pub79of100,10,191,9,17535,55,17599
test4sub66of100,test4pub8of100,100,192,12,1381,53,1446
test4sub43of100,test4pub8of100,100,192,12,1382,55,1449
test4sub73of100,test4pub1of100,100,12977,24,5105,68,5197
test4sub15of100,test4pub7of100,100,192,14,1677,64,1755
test4sub51of100,test4pub3of100,100,192,28,4991,53,5072
test4sub87of100,test4pub9of100,100,192,20,1241,52,1313
test4sub86of100,test4pub4of100,100,192,11,3648,52,3711
test4sub45of100,test4pub1of100,100,12977,24,5126,91,5241
test4sub96of100,test4pub9of100,100,192,20,1245,92,1357
test4sub29of100,test4pub9of100,100,192,20,1247,91,1358
test4sub22of100,test4pub8of100,100,192,12,1432,91,1535
test4sub13of100,test4pub11of100,100,193,10,647,91,748
test4sub76of100,test4pub3of100,100,192,28,4999,92,5119
test4sub69of100,test4pub80of100,10,192,10,17192,90,17292
test4sub66of100,test4pub9of100,100,192,20,1251,92,1363
test4sub43of100,test4pub9of100,100,192,20,1252,90,1362
test4sub26of100,test4pub10of100,100,193,11,893,86,990
test4sub75of100,test4pub12of100,100,193,11,216,81,308
test4sub24of100,test4pub12of100,100,193,11,217,81,309
test4sub73of100,test4pub4of100,100,192,11,3697,52,3760
test4sub15of100,test4pub8of100,100,192,12,1478,52,1542
test4sub51of100,test4pub4of100,100,192,11,3699,52,3762
test4sub87of100,test4pub10of100,100,193,11,930,52,993
test4sub86of100,test4pub5of100,100,192,14,2703,52,2769
test4sub77of100,test4pub12of100,100,193,11,255,47,313
test4sub12of100,test4pub11of100,100,193,10,701,46,757
test4sub48of100,test4pub12of100,100,193,11,261,42,314
test4sub8of100,test4pub1of100,100,12977,24,5204,69,5297
test4sub45of100,test4pub3of100,100,192,28,5087,55,5170
test4sub96of100,test4pub10of100,100,193,11,972,57,1040
test4sub29of100,test4pub10of100,100,193,11,974,55,1040
test4sub22of100,test4pub9of100,100,192,20,1339,56,1415
test4sub76of100,test4pub4of100,100,192,11,3746,54,3811
test4sub69of100,test4pub81of100,10,192,17,17167,55,17239
test4sub66of100,test4pub10of100,100,193,11,978,54,1043
test4sub43of100,test4pub10of100,100,193,11,978,55,1044
test4sub73of100,test4pub5of100,100,192,14,2752,54,2820
test4sub15of100,test4pub9of100,100,192,20,1346,55,1421
test4sub51of100,test4pub5of100,100,192,14,2754,54,2822
test4sub87of100,test4pub11of100,100,193,10,745,55,810
test4sub86of100,test4pub6of100,100,192,26,2432,54,2512
test4sub28of100,test4pub7of100,100,192,14,1802,52,1868
test4sub1of100,test4pub12of100,100,193,11,310,49,370
test4sub44of100,test4pub7of100,100,192,14,1806,47,1867
test4sub62of100,test4pub1of100,100,12977,24,5242,87,5353
test4sub46of100,test4pub12of100,100,193,11,320,82,413
test4sub71of100,test4pub12of100,100,193,11,323,79,413
test4sub8of100,test4pub4of100,100,192,11,3797,57,3865
test4sub45of100,test4pub4of100,100,192,11,3798,57,3866
test4sub96of100,test4pub11of100,100,193,10,792,56,858
test4sub29of100,test4pub11of100,100,193,10,792,57,859
test4sub22of100,test4pub10of100,100,193,11,1031,57,1099
test4sub76of100,test4pub5of100,100,192,14,2803,56,2873
test4sub69of100,test4pub82of100,10,192,10,17069,57,17136
test4sub66of100,test4pub11of100,100,193,10,796,57,863
test4sub14of100,test4pub10of100,100,193,11,1033,58,1102
test4sub43of100,test4pub11of100,100,193,10,798,59,867
test4sub73of100,test4pub6of100,100,192,26,2483,60,2569
test4sub15of100,test4pub10of100,100,193,11,1037,59,1107
test4sub51of100,test4pub6of100,100,192,26,2485,60,2571
test4sub87of100,test4pub12of100,100,193,11,357,59,427
test4sub86of100,test4pub7of100,100,192,14,1853,59,1926
test4sub28of100,test4pub8of100,100,192,12,1590,59,1661
test4sub44of100,test4pub8of100,100,192,12,1591,58,1661
test4sub26of100,test4pub11of100,100,193,10,811,53,874
test4sub24of100,test4pub13of100,100,193,10,168,49,227
test4sub55of100,test4pub7of100,100,192,14,1892,23,1929
test4sub62of100,test4pub3of100,100,192,28,5198,19,5245
test4sub8of100,test4pub5of100,100,192,14,2857,18,2889
test4sub45of100,test4pub5of100,100,192,14,2857,18,2889
test4sub96of100,test4pub12of100,100,193,11,406,19,436
test4sub29of100,test4pub12of100,100,193,11,406,19,436
test4sub76of100,test4pub6of100,100,192,26,2537,17,2580
test4sub22of100,test4pub11of100,100,193,10,851,18,879
test4sub69of100,test4pub83of100,10,192,10,16976,17,17003
test4sub66of100,test4pub12of100,100,193,11,409,18,438
test4sub42of100,test4pub1of100,100,12977,24,5340,58,5422
test4sub43of100,test4pub12of100,100,193,11,413,59,483
test4sub73of100,test4pub7of100,100,192,14,1910,57,1981
test4sub15of100,test4pub11of100,100,193,10,859,58,927
test4sub51of100,test4pub7of100,100,192,14,1912,59,1985
test4sub86of100,test4pub8of100,100,192,12,1649,58,1719
test4sub28of100,test4pub9of100,100,192,20,1464,57,1541
test4sub44of100,test4pub9of100,100,192,20,1466,56,1542
test4sub26of100,test4pub12of100,100,193,11,420,57,488
test4sub55of100,test4pub8of100,100,192,12,1652,55,1719
test4sub62of100,test4pub4of100,100,192,11,3873,55,3939
test4sub8of100,test4pub6of100,100,192,26,2552,54,2632
test4sub45of100,test4pub6of100,100,192,26,2552,54,2632
test4sub76of100,test4pub7of100,100,192,14,1921,52,1987
test4sub22of100,test4pub12of100,100,193,11,426,51,488
test4sub69of100,test4pub84of100,10,192,11,16515,50,16576
test4sub75of100,test4pub13of100,100,193,10,227,48,285
test4sub1of100,test4pub13of100,100,193,10,250,25,285
test4sub91of100,test4pub11of100,100,193,10,899,24,933
test4sub71of100,test4pub13of100,100,193,10,252,23,285
test4sub42of100,test4pub3of100,100,192,28,5267,8,5303
test4sub38of100,test4pub1of100,100,12977,24,5400,49,5473
test4sub87of100,test4pub13of100,100,193,10,270,48,328
test4sub29of100,test4pub13of100,100,193,10,284,35,329
test4sub51of100,test4pub8of100,100,192,12,1730,26,1768
test4sub43of100,test4pub13of100,100,193,10,295,26,331
test4sub86of100,test4pub9of100,100,192,20,1545,26,1591
test4sub73of100,test4pub8of100,100,192,12,1730,26,1768
test4sub28of100,test4pub10of100,100,193,11,1181,27,1219
test4sub93of100,test4pub7of100,100,192,14,1995,27,2036
test4sub44of100,test4pub10of100,100,193,11,1182,28,1221
test4sub26of100,test4pub13of100,100,193,10,297,28,335
test4sub55of100,test4pub9of100,100,192,20,1548,29,1597
test4sub62of100,test4pub5of100,100,192,14,2955,28,2997
test4sub3of100,test4pub10of100,100,193,11,1196,25,1232
test4sub42of100,test4pub4of100,100,192,11,3957,36,4004
test4sub69of100,test4pub85of100,10,192,23,15059,38,15120
test4sub76of100,test4pub8of100,100,192,12,1735,38,1785
test4sub91of100,test4pub12of100,100,193,11,505,37,553
test4sub22of100,test4pub13of100,100,193,10,300,37,347
test4sub8of100,test4pub7of100,100,192,14,1998,40,2052
test4sub45of100,test4pub7of100,100,192,14,1998,39,2051
test4sub24of100,test4pub14of100,100,193,10,150,24,184
test4sub38of100,test4pub3of100,100,192,28,5319,24,5371
test4sub46of100,test4pub13of100,100,193,10,320,23,353
test4sub51of100,test4pub9of100,100,192,20,1571,22,1613
test4sub86of100,test4pub10of100,100,193,11,1207,22,1240
test4sub73of100,test4pub9of100,100,192,20,1573,23,1616
test4sub28of100,test4pub11of100,100,193,10,972,22,1004
test4sub93of100,test4pub8of100,100,192,12,1759,23,1794
test4sub44of100,test4pub11of100,100,193,10,974,22,1006
test4sub55of100,test4pub10of100,100,193,11,1212,22,1245
test4sub3of100,test4pub11of100,100,193,10,984,13,1007
test4sub62of100,test4pub6of100,100,192,26,2670,13,2709
test4sub69of100,test4pub86of100,10,192,21,14672,12,14705
test4sub76of100,test4pub9of100,100,192,20,1590,12,1622
test4sub45of100,test4pub8of100,100,192,12,1776,13,1801
test4sub42of100,test4pub5of100,100,192,14,2997,12,3023
test4sub38of100,test4pub4of100,100,192,11,3998,12,4021
test4sub51of100,test4pub10of100,100,193,11,1230,11,1252
test4sub86of100,test4pub11of100,100,193,10,993,12,1015
test4sub73of100,test4pub10of100,100,193,11,1231,11,1253
test4sub28of100,test4pub12of100,100,193,11,551,12,574
test4sub93of100,test4pub9of100,100,192,20,1598,10,1628
test4sub44of100,test4pub12of100,100,193,11,552,12,575
test4sub55of100,test4pub11of100,100,193,10,998,12,1020
test4sub3of100,test4pub12of100,100,193,11,554,12,577
test4sub80of100,test4pub67of100,10,192,11,26455,11,26477
test4sub62of100,test4pub7of100,100,192,14,2050,13,2077
test4sub69of100,test4pub87of100,10,192,10,14454,12,14476
test4sub76of100,test4pub10of100,100,193,11,1238,12,1261
test4sub45of100,test4pub9of100,100,192,20,1605,11,1636
test4sub42of100,test4pub6of100,100,192,26,2688,12,2726
test4sub51of100,test4pub11of100,100,193,10,1004,11,1025
test4sub38of100,test4pub5of100,100,192,14,3013,12,3039
test4sub86of100,test4pub12of100,100,193,11,562,11,584
test4sub73of100,test4pub11of100,100,193,10,1006,13,1029
test4sub93of100,test4pub10of100,100,193,11,1245,11,1267
test4sub28of100,test4pub13of100,100,193,10,359,11,380
test4sub75of100,test4pub14of100,100,193,10,192,12,214
test4sub80of100,test4pub68of100,10,192,10,26249,10,26269
test4sub55of100,test4pub12of100,100,193,11,566,10,587
test4sub44of100,test4pub13of100,100,193,10,363,10,383
test4sub62of100,test4pub8of100,100,192,12,1800,10,1822
test4sub69of100,test4pub88of100,10,192,11,14240,9,14260
test4sub76of100,test4pub11of100,100,193,10,1014,10,1034
test4sub42of100,test4pub7of100,100,192,14,2067,9,2090
test4sub51of100,test4pub12of100,100,193,11,572,9,592
test4sub38of100,test4pub6of100,100,192,26,2702,9,2737
test4sub86of100,test4pub13of100,100,193,10,370,11,391
test4sub93of100,test4pub11of100,100,193,10,1019,9,1038
test4sub28of100,test4pub14of100,100,193,10,204,11,225
test4sub44of100,test4pub14of100,100,193,10,206,9,225
test4sub55of100,test4pub13of100,100,193,10,374,10,394
test4sub69of100,test4pub89of100,10,192,39,13263,9,13311
test4sub62of100,test4pub9of100,100,192,20,1625,11,1656
test4sub42of100,test4pub8of100,100,192,12,1812,10,1834
test4sub76of100,test4pub12of100,100,193,11,581,11,603
test4sub51of100,test4pub13of100,100,193,10,379,11,400
test4sub38of100,test4pub7of100,100,192,14,2078,12,2104
test4sub12of100,test4pub12of100,100,193,11,584,12,607
test4sub93of100,test4pub12of100,100,193,11,586,10,607
test4sub91of100,test4pub13of100,100,193,10,381,12,403
test4sub52of100,test4pub12of100,100,193,11,588,10,609
test4sub55of100,test4pub14of100,100,193,10,216,10,236
test4sub71of100,test4pub14of100,100,193,10,217,9,236
test4sub69of100,test4pub90of100,10,192,23,13112,9,13144
test4sub86of100,test4pub14of100,100,193,10,218,9,237
test4sub62of100,test4pub10of100,100,193,11,1273,8,1292
test4sub42of100,test4pub9of100,100,192,20,1638,8,1666
test4sub76of100,test4pub13of100,100,193,10,390,8,408
test4sub87of100,test4pub14of100,100,193,10,223,6,239
test4sub38of100,test4pub8of100,100,192,12,1826,7,1845
test4sub12of100,test4pub13of100,100,193,10,392,6,408
test4sub52of100,test4pub13of100,100,193,10,394,5,409
test4sub69of100,test4pub91of100,10,192,26,12959,5,12990
test4sub62of100,test4pub11of100,100,193,10,1045,4,1059
test4sub42of100,test4pub10of100,100,193,11,1282,4,1297
test4sub38of100,test4pub9of100,100,192,20,1649,3,1672
test4sub69of100,test4pub92of100,10,192,12,12791,3,12806
test4sub62of100,test4pub12of100,100,193,11,605,3,619
test4sub42of100,test4pub11of100,100,193,10,1050,3,1063
test4sub38of100,test4pub10of100,100,193,11,1288,3,1302
test4sub69of100,test4pub93of100,10,192,13,12465,3,12481
test4sub62of100,test4pub13of100,100,193,10,405,3,418
test4sub42of100,test4pub12of100,100,193,11,610,3,624
test4sub1of100,test4pub14of100,100,193,10,239,3,252
test4sub38of100,test4pub11of100,100,193,10,1055,4,1069
test4sub42of100,test4pub13of100,100,193,10,409,1,420
test4sub69of100,test4pub94of100,10,192,10,11878,2,11890
test4sub42of100,test4pub14of100,100,193,10,243,2,255
test4sub38of100,test4pub12of100,100,193,11,615,4,630
test4sub22of100,test4pub14of100,100,193,10,245,2,257
test4sub29of100,test4pub14of100,100,193,10,246,2,258
test4sub69of100,test4pub95of100,10,192,17,11524,3,11544
test4sub38of100,test4pub13of100,100,193,10,415,1,426
test4sub69of100,test4pub96of100,10,192,10,11364,1,11375
test4sub69of100,test4pub97of100,10,192,10,11227,1,11238
test4sub38of100,test4pub14of100,100,193,10,250,1,261
test4sub69of100,test4pub98of100,10,192,11,11080,1,11092
test4sub43of100,test4pub14of100,100,193,10,252,1,263
test4sub69of100,test4pub99of100,10,192,10,10874,1,10885
test4sub51of100,test4pub14of100,100,193,10,258,0,268
test4sub26of100,test4pub14of100,100,193,10,262,0,272
test4sub76of100,test4pub14of100,100,193,10,266,1,277
test4sub93of100,test4pub13of100,100,193,10,438,1,449
test4sub93of100,test4pub14of100,100,193,10,271,1,282
test4sub83of100,test4pub7of100,100,192,14,2144,1,2159
test4sub66of100,test4pub13of100,100,193,10,457,0,467
test4sub66of100,test4pub14of100,100,193,10,291,1,302
test4sub96of100,test4pub13of100,100,193,10,459,1,470
test4sub96of100,test4pub14of100,100,193,10,292,1,303
test4sub3of100,test4pub13of100,100,193,10,466,0,476
test4sub3of100,test4pub14of100,100,193,10,300,1,311
test4sub3of100,test4pub15of100,100,193,11,162,1,174
test4sub55of100,test4pub15of100,100,193,11,174,1,186
test4sub20of100,test4pub1of100,100,12977,24,5619,45,5688
test4sub58of100,test4pub2of100,100,192,10,5591,43,5644
test4sub75of100,test4pub15of100,100,193,11,206,23,240
test4sub28of100,test4pub15of100,100,193,11,207,24,242
test4sub44of100,test4pub15of100,100,193,11,209,24,244
test4sub62of100,test4pub14of100,100,193,10,350,22,382
test4sub9of100,test4pub1of100,100,12977,24,5653,61,5738
test4sub12of100,test4pub14of100,100,193,10,360,55,425
test4sub68of100,test4pub12of100,100,193,11,734,54,799
test4sub20of100,test4pub4of100,100,192,11,4188,52,4251
test4sub91of100,test4pub14of100,100,193,10,366,52,428
test4sub58of100,test4pub3of100,100,192,28,5536,52,5616
test4sub4of100,test4pub10of100,100,193,11,1423,51,1485
test4sub52of100,test4pub14of100,100,193,10,371,50,431
test4sub86of100,test4pub15of100,100,193,11,233,51,295
test4sub62of100,test4pub15of100,100,193,11,234,50,295
test4sub1of100,test4pub15of100,100,193,11,242,43,296
test4sub22of100,test4pub15of100,100,193,11,242,42,295
test4sub56of100,test4pub5of100,100,192,14,3208,42,3264
test4sub29of100,test4pub15of100,100,193,11,245,40,296
test4sub51of100,test4pub15of100,100,193,11,247,39,297
test4sub63of100,test4pub8of100,100,192,12,1991,37,2040
test4sub93of100,test4pub15of100,100,193,11,263,23,297
test4sub83of100,test4pub8of100,100,192,12,2007,22,2041
test4sub100of100,test4pub5of100,100,192,14,3239,15,3268
test4sub66of100,test4pub15of100,100,193,11,275,14,300
test4sub96of100,test4pub15of100,100,193,11,276,14,301
test4sub9of100,test4pub3of100,100,192,28,5584,14,5626
test4sub12of100,test4pub15of100,100,193,11,278,13,302
test4sub68of100,test4pub13of100,100,193,10,585,14,609
test4sub46of100,test4pub14of100,100,193,10,418,14,442
test4sub20of100,test4pub5of100,100,192,14,3244,14,3272
test4sub64of100,test4pub2of100,100,192,10,5685,15,5710
test4sub91of100,test4pub15of100,100,193,11,281,14,306
test4sub4of100,test4pub11of100,100,193,10,1237,13,1260
test4sub52of100,test4pub15of100,100,193,11,283,13,307
test4sub56of100,test4pub6of100,100,192,26,2926,11,2963
test4sub63of100,test4pub9of100,100,192,20,1844,10,1874
test4sub83of100,test4pub9of100,100,192,20,1846,10,1876
test4sub100of100,test4pub6of100,100,192,26,2930,10,2966
test4sub9of100,test4pub2of100,100,192,10,5696,8,5714
test4sub68of100,test4pub14of100,100,193,10,431,9,450
test4sub46of100,test4pub15of100,100,193,11,293,10,314
test4sub20of100,test4pub6of100,100,192,26,2934,8,2968
test4sub4of100,test4pub12of100,100,193,11,807,7,825
test4sub56of100,test4pub7of100,100,192,14,2303,6,2323
test4sub63of100,test4pub10of100,100,193,11,1491,7,1509
test4sub83of100,test4pub10of100,100,193,11,1491,8,1510
test4sub9of100,test4pub4of100,100,192,11,4263,7,4281
test4sub100of100,test4pub7of100,100,192,14,2306,7,2327
test4sub80of100,test4pub69of100,10,192,14,26244,7,26265
test4sub20of100,test4pub7of100,100,192,14,2310,6,2330
test4sub56of100,test4pub8of100,100,192,12,2047,7,2066
test4sub63of100,test4pub11of100,100,193,10,1261,6,1277
test4sub83of100,test4pub11of100,100,193,10,1262,8,1280
test4sub9of100,test4pub5of100,100,192,14,3272,6,3292
test4sub100of100,test4pub8of100,100,192,12,2051,7,2070
test4sub80of100,test4pub70of100,10,192,10,26153,6,26169
test4sub75of100,test4pub16of100,100,193,10,153,6,169
test4sub56of100,test4pub9of100,100,192,20,1869,6,1895
test4sub28of100,test4pub16of100,100,193,10,154,6,170
test4sub20of100,test4pub8of100,100,192,12,2053,7,2072
test4sub63of100,test4pub12of100,100,193,11,825,6,842
test4sub9of100,test4pub6of100,100,192,26,2955,5,2986
test4sub83of100,test4pub12of100,100,193,11,826,6,843
test4sub80of100,test4pub71of100,10,192,11,26022,5,26038
test4sub100of100,test4pub9of100,100,192,20,1874,5,1899
test4sub56of100,test4pub10of100,100,193,11,1511,5,1527
test4sub20of100,test4pub9of100,100,192,20,1877,3,1900
test4sub63of100,test4pub13of100,100,193,10,627,4,641
test4sub80of100,test4pub72of100,10,192,18,21184,4,21206
test4sub100of100,test4pub10of100,100,193,11,1515,4,1530
test4sub56of100,test4pub11of100,100,193,10,1279,4,1293
test4sub20of100,test4pub10of100,100,193,11,1516,4,1531
test4sub12of100,test4pub16of100,100,193,10,168,4,182
test4sub100of100,test4pub11of100,100,193,10,1282,2,1294
test4sub80of100,test4pub73of100,10,192,11,20310,3,20324
test4sub20of100,test4pub11of100,100,193,10,1284,3,1297
test4sub56of100,test4pub12of100,100,193,11,840,4,855
test4sub100of100,test4pub12of100,100,193,11,842,4,857
test4sub80of100,test4pub74of100,10,192,10,19687,4,19701
test4sub68of100,test4pub15of100,100,193,11,332,4,347
test4sub20of100,test4pub12of100,100,193,11,844,4,859
test4sub80of100,test4pub75of100,10,192,10,19007,2,19019
test4sub20of100,test4pub13of100,100,193,10,644,1,655
test4sub100of100,test4pub13of100,100,193,10,642,2,654
test4sub80of100,test4pub76of100,10,192,10,18843,1,18854
test4sub20of100,test4pub14of100,100,193,10,478,2,490
test4sub80of100,test4pub77of100,10,192,10,18384,1,18395
test4sub100of100,test4pub14of100,100,193,10,478,2,490
test4sub20of100,test4pub15of100,100,193,11,342,2,355
test4sub80of100,test4pub78of100,10,192,12,18319,1,18332
test4sub80of100,test4pub79of100,10,191,9,18242,0,18251
test4sub80of100,test4pub80of100,10,192,10,17845,1,17856
test4sub80of100,test4pub81of100,10,192,17,17730,1,17748
test4sub80of100,test4pub82of100,10,192,10,17576,1,17587
test4sub55of100,test4pub16of100,100,193,10,191,1,202
test4sub4of100,test4pub13of100,100,193,10,660,0,670
test4sub4of100,test4pub14of100,100,193,10,494,1,505
test4sub86of100,test4pub16of100,100,193,10,197,2,209
test4sub44of100,test4pub16of100,100,193,10,198,2,210
test4sub4of100,test4pub15of100,100,193,11,356,1,368
test4sub4of100,test4pub16of100,100,193,10,200,0,210
test4sub1of100,test4pub16of100,100,193,10,212,1,223
test4sub22of100,test4pub16of100,100,193,10,222,0,232
test4sub56of100,test4pub13of100,100,193,10,689,1,700
test4sub56of100,test4pub14of100,100,193,10,522,0,532
test4sub56of100,test4pub15of100,100,193,11,384,1,396
test4sub56of100,test4pub16of100,100,193,10,228,1,239
test4sub89of100,test4pub3of100,100,192,28,5694,1,5723
test4sub52of100,test4pub16of100,100,193,10,237,1,248
test4sub51of100,test4pub16of100,100,193,10,238,0,248
test4sub63of100,test4pub14of100,100,193,10,537,1,548
test4sub63of100,test4pub15of100,100,193,11,399,0,410
test4sub29of100,test4pub16of100,100,193,10,241,1,252
test4sub83of100,test4pub13of100,100,193,10,709,1,720
test4sub83of100,test4pub14of100,100,193,10,542,1,553
test4sub100of100,test4pub15of100,100,193,11,404,1,416
test4sub83of100,test4pub15of100,100,193,11,405,1,417
test4sub100of100,test4pub16of100,100,193,10,248,1,259
test4sub66of100,test4pub16of100,100,193,10,250,1,261
test4sub62of100,test4pub16of100,100,193,10,252,1,263
test4sub96of100,test4pub16of100,100,193,10,255,1,266
test4sub80of100,test4pub83of100,10,192,10,17525,16,17551
test4sub54of100,test4pub1of100,100,12977,24,5857,44,5925
test4sub38of100,test4pub15of100,100,193,11,454,10,475
test4sub43of100,test4pub15of100,100,193,11,456,10,477
test4sub76of100,test4pub15of100,100,193,11,459,9,479
test4sub80of100,test4pub84of100,10,192,11,17062,5,17078
test4sub28of100,test4pub17of100,100,193,11,171,7,189
test4sub54of100,test4pub3of100,100,192,28,5772,6,5806
test4sub38of100,test4pub16of100,100,193,10,307,6,323
test4sub87of100,test4pub15of100,100,193,11,466,5,482
test4sub43of100,test4pub16of100,100,193,10,309,7,326
test4sub12of100,test4pub17of100,100,193,11,175,6,192
test4sub76of100,test4pub16of100,100,193,10,311,6,327
test4sub80of100,test4pub85of100,10,192,23,15535,5,15563
test4sub68of100,test4pub16of100,100,193,10,313,3,326
test4sub75of100,test4pub17of100,100,193,11,179,3,193
test4sub87of100,test4pub16of100,100,193,10,315,3,328
test4sub54of100,test4pub4of100,100,192,11,4433,4,4448
test4sub80of100,test4pub86of100,10,192,21,15114,2,15137
test4sub54of100,test4pub5of100,100,192,14,3441,1,3456
test4sub80of100,test4pub87of100,10,192,10,14886,1,14897
test4sub54of100,test4pub6of100,100,192,26,3119,1,3146
test4sub54of100,test4pub7of100,100,192,14,2486,0,2500
test4sub80of100,test4pub88of100,10,192,11,14662,1,14674
test4sub80of100,test4pub89of100,10,192,39,13676,1,13716
test4sub54of100,test4pub8of100,100,192,12,2224,1,2237
test4sub80of100,test4pub90of100,10,192,23,13517,1,13541
test4sub54of100,test4pub9of100,100,192,20,2041,1,2062
test4sub54of100,test4pub10of100,100,193,11,1677,0,1688
test4sub54of100,test4pub11of100,100,193,10,1442,1,1453
test4sub54of100,test4pub12of100,100,193,11,999,1,1011
test4sub26of100,test4pub15of100,100,193,11,535,1,547
test4sub4of100,test4pub17of100,100,193,11,243,2,256
test4sub26of100,test4pub16of100,100,193,10,379,1,390
test4sub55of100,test4pub17of100,100,193,11,244,2,257
test4sub22of100,test4pub17of100,100,193,11,245,1,257
test4sub56of100,test4pub17of100,100,193,11,247,1,259
test4sub52of100,test4pub17of100,100,193,11,252,1,264
test4sub51of100,test4pub17of100,100,193,11,254,0,265
test4sub29of100,test4pub17of100,100,193,11,255,1,267
test4sub100of100,test4pub17of100,100,193,11,279,0,290
test4sub8of100,test4pub8of100,100,192,12,2318,1,2331
test4sub8of100,test4pub9of100,100,192,20,2134,0,2154
test4sub66of100,test4pub17of100,100,193,11,286,1,298
test4sub62of100,test4pub17of100,100,193,11,298,0,309
test4sub54of100,test4pub13of100,100,193,10,904,0,914
test4sub54of100,test4pub14of100,100,193,10,738,1,749
test4sub46of100,test4pub16of100,100,193,10,442,1,453
test4sub54of100,test4pub15of100,100,193,11,601,1,613
test4sub46of100,test4pub17of100,100,193,11,308,1,320
test4sub54of100,test4pub16of100,100,193,10,465,1,476
test4sub54of100,test4pub17of100,100,193,11,332,1,344
test4sub58of100,test4pub1of100,100,12977,24,6070,43,6137
test4sub80of100,test4pub91of100,10,192,26,13506,39,13571
test4sub38of100,test4pub17of100,100,193,11,351,33,395
test4sub43of100,test4pub17of100,100,193,11,351,32,394
test4sub9of100,test4pub7of100,100,192,14,2655,29,2698
test4sub76of100,test4pub17of100,100,193,11,357,28,396
test4sub31of100,test4pub7of100,100,192,14,2658,26,2698
test4sub87of100,test4pub17of100,100,193,11,368,18,397
test4sub74of100,test4pub10of100,100,193,11,1860,12,1883
test4sub68of100,test4pub17of100,100,193,11,378,9,398
test4sub58of100,test4pub4of100,100,192,11,4637,7,4655
test4sub80of100,test4pub92of100,10,192,12,13373,7,13392
test4sub9of100,test4pub8of100,100,192,12,2420,4,2436
test4sub31of100,test4pub8of100,100,192,12,2421,6,2439
test4sub74of100,test4pub11of100,100,193,10,1636,4,1650
test4sub21of100,test4pub9of100,100,192,20,2238,4,2262
test4sub80of100,test4pub93of100,10,192,13,13051,3,13067
test4sub9of100,test4pub9of100,100,192,20,2241,3,2264
test4sub31of100,test4pub9of100,100,192,20,2242,2,2264
test4sub74of100,test4pub12of100,100,193,11,1196,3,1210
test4sub80of100,test4pub94of100,10,192,10,12464,2,12476
test4sub9of100,test4pub10of100,100,193,11,1879,2,1892
test4sub31of100,test4pub10of100,100,193,11,1881,2,1894
test4sub74of100,test4pub13of100,100,193,10,996,4,1010
test4sub9of100,test4pub11of100,100,193,10,1646,2,1658
test4sub80of100,test4pub95of100,10,192,17,12109,2,12128
test4sub31of100,test4pub11of100,100,193,10,1647,3,1660
test4sub74of100,test4pub14of100,100,193,10,832,3,845
test4sub9of100,test4pub12of100,100,193,11,1204,2,1217
test4sub80of100,test4pub96of100,10,192,10,11950,3,11963
test4sub74of100,test4pub15of100,100,193,11,696,2,709
test4sub9of100,test4pub13of100,100,193,10,1003,2,1015
test4sub63of100,test4pub16of100,100,193,10,540,1,551
test4sub80of100,test4pub97of100,10,192,10,11814,3,11827
test4sub9of100,test4pub14of100,100,193,10,838,1,849
test4sub63of100,test4pub17of100,100,193,11,407,2,420
test4sub9of100,test4pub15of100,100,193,11,701,1,713
test4sub80of100,test4pub98of100,10,192,11,11669,0,11680
test4sub9of100,test4pub16of100,100,193,10,545,0,555
test4sub80of100,test4pub99of100,10,192,10,11463,1,11474
test4sub28of100,test4pub18of100,100,193,18,241,1,260
test4sub3of100,test4pub16of100,100,193,10,570,1,581
test4sub3of100,test4pub17of100,100,193,11,436,0,447
test4sub32of100,test4pub9of100,100,192,20,2324,0,2344
test4sub25of100,test4pub1of100,100,12977,24,6210,43,6277
test4sub26of100,test4pub17of100,100,193,11,483,39,533
test4sub4of100,test4pub18of100,100,193,18,298,39,355
test4sub55of100,test4pub18of100,100,193,18,301,38,357
test4sub22of100,test4pub18of100,100,193,18,302,36,356
test4sub56of100,test4pub18of100,100,193,18,305,34,357
test4sub51of100,test4pub18of100,100,193,18,317,23,358
test4sub29of100,test4pub18of100,100,193,18,318,22,358
test4sub75of100,test4pub18of100,100,193,18,321,19,358
test4sub12of100,test4pub18of100,100,193,18,322,19,359
test4sub25of100,test4pub4of100,100,192,11,4778,4,4793
test4sub26of100,test4pub18of100,100,193,18,337,3,358
test4sub25of100,test4pub5of100,100,192,14,3784,1,3799
test4sub45of100,test4pub10of100,100,193,11,2013,0,2024
test4sub25of100,test4pub6of100,100,192,26,3462,1,3489
test4sub45of100,test4pub11of100,100,193,10,1778,1,1789
test4sub25of100,test4pub7of100,100,192,14,2830,0,2844
test4sub45of100,test4pub12of100,100,193,11,1335,1,1347
test4sub71of100,test4pub15of100,100,193,11,827,2,840
test4sub100of100,test4pub18of100,100,193,18,348,2,368
test4sub62of100,test4pub18of100,100,193,18,350,2,370
test4sub71of100,test4pub16of100,100,193,10,671,1,682
test4sub71of100,test4pub17of100,100,193,11,538,0,549
test4sub41of100,test4pub1of100,100,12977,24,6273,44,6341
test4sub80of100,test4pub100of100,10,193,15,11483,33,11531
test4sub15of100,test4pub12of100,100,193,11,1380,12,1403
test4sub34of100,test4pub11of100,100,193,10,1828,7,1845
test4sub80of100,test4pub2of100,100,192,10,6285,2,6297
test4sub41of100,test4pub3of100,100,192,28,6187,2,6217
test4sub34of100,test4pub12of100,100,193,11,1393,1,1405
test4sub41of100,test4pub4of100,100,192,11,4845,2,4858
test4sub34of100,test4pub13of100,100,193,10,1190,2,1202
test4sub43of100,test4pub18of100,100,193,18,405,3,426
test4sub41of100,test4pub5of100,100,192,14,3849,1,3864
test4sub9of100,test4pub17of100,100,193,11,592,2,605
test4sub34of100,test4pub14of100,100,193,10,1025,2,1037
test4sub9of100,test4pub18of100,100,193,18,409,1,428
test4sub41of100,test4pub6of100,100,192,26,3528,2,3556
test4sub34of100,test4pub15of100,100,193,11,890,1,902
test4sub41of100,test4pub7of100,100,192,14,2896,1,2911
test4sub34of100,test4pub16of100,100,193,10,734,1,745
test4sub44of100,test4pub17of100,100,193,11,600,2,613
test4sub34of100,test4pub17of100,100,193,11,600,1,612
test4sub44of100,test4pub18of100,100,193,18,416,1,435
test4sub68of100,test4pub18of100,100,193,18,425,0,443
test4sub63of100,test4pub18of100,100,193,18,442,1,461
test4sub28of100,test4pub19of100,100,193,11,233,1,245
test4sub63of100,test4pub19of100,100,193,11,234,1,246
test4sub3of100,test4pub18of100,100,193,18,447,0,465
test4sub46of100,test4pub18of100,100,193,18,448,1,467
test4sub46of100,test4pub19of100,100,193,11,239,0,250
test4sub25of100,test4pub8of100,100,192,12,2680,0,2692
test4sub25of100,test4pub9of100,100,192,20,2496,1,2517
test4sub25of100,test4pub10of100,100,193,11,2138,1,2150
test4sub25of100,test4pub11of100,100,193,10,1903,1,1914
test4sub25of100,test4pub12of100,100,193,11,1460,0,1471
test4sub25of100,test4pub13of100,100,193,10,1262,1,1273
test4sub25of100,test4pub14of100,100,193,10,1095,0,1105
test4sub25of100,test4pub15of100,100,193,11,958,1,970
test4sub25of100,test4pub16of100,100,193,10,801,1,812
test4sub22of100,test4pub19of100,100,193,11,272,1,284
test4sub25of100,test4pub17of100,100,193,11,667,1,679
test4sub25of100,test4pub18of100,100,193,18,483,1,502
test4sub86of100,test4pub17of100,100,193,11,673,1,685
test4sub86of100,test4pub18of100,100,193,18,488,1,507
test4sub56of100,test4pub19of100,100,193,11,280,0,291
test4sub93of100,test4pub16of100,100,193,10,818,0,828
test4sub93of100,test4pub17of100,100,193,11,685,1,697
test4sub93of100,test4pub18of100,100,193,18,500,1,519
test4sub89of100,test4pub1of100,100,12977,24,6427,42,6493
test4sub29of100,test4pub19of100,100,193,11,309,33,353
test4sub75of100,test4pub19of100,100,193,11,309,33,353
test4sub12of100,test4pub19of100,100,193,11,312,32,355
test4sub96of100,test4pub17of100,100,193,11,711,29,751
test4sub50of100,test4pub9of100,100,192,20,2575,16,2611
test4sub55of100,test4pub19of100,100,193,11,335,10,356
test4sub89of100,test4pub4of100,100,192,11,4994,3,5008
test4sub96of100,test4pub18of100,100,193,18,554,2,574
test4sub50of100,test4pub10of100,100,193,11,2226,2,2239
test4sub89of100,test4pub5of100,100,192,14,3999,1,4014
test4sub50of100,test4pub11of100,100,193,10,1992,1,2003
test4sub89of100,test4pub6of100,100,192,26,3677,1,3704
test4sub50of100,test4pub12of100,100,193,11,1549,1,1561
test4sub89of100,test4pub7of100,100,192,14,3045,1,3060
test4sub50of100,test4pub13of100,100,193,10,1347,1,1358
test4sub50of100,test4pub14of100,100,193,10,1181,1,1192
test4sub89of100,test4pub8of100,100,192,12,2783,1,2796
test4sub50of100,test4pub15of100,100,193,11,1043,0,1054
test4sub50of100,test4pub16of100,100,193,10,887,1,898
test4sub50of100,test4pub17of100,100,193,11,753,0,764
test4sub34of100,test4pub18of100,100,193,18,571,1,590
test4sub34of100,test4pub19of100,100,193,11,362,0,373
test4sub83of100,test4pub16of100,100,193,10,895,0,905
test4sub83of100,test4pub17of100,100,193,11,761,1,773
test4sub83of100,test4pub18of100,100,193,18,577,1,596
test4sub43of100,test4pub19of100,100,193,11,371,1,383
test4sub9of100,test4pub19of100,100,193,11,375,0,386
test4sub68of100,test4pub19of100,100,193,11,383,1,395
test4sub85of100,test4pub10of100,100,193,11,2278,0,2289
test4sub3of100,test4pub19of100,100,193,11,398,1,410
test4sub85of100,test4pub11of100,100,193,10,2043,1,2054
test4sub85of100,test4pub12of100,100,193,11,1600,1,1612
test4sub25of100,test4pub19of100,100,193,11,401,1,413
test4sub86of100,test4pub19of100,100,193,11,403,0,414
test4sub85of100,test4pub13of100,100,193,10,1398,1,1409
test4sub85of100,test4pub14of100,100,193,10,1233,1,1244
test4sub85of100,test4pub15of100,100,193,11,1095,0,1106
test4sub85of100,test4pub16of100,100,193,10,939,4,953
test4sub93of100,test4pub19of100,100,193,11,409,3,423
test4sub82of100,test4pub1of100,100,12977,24,6538,47,6609
test4sub89of100,test4pub9of100,100,192,20,2658,46,2724
test4sub85of100,test4pub17of100,100,193,11,809,45,865
test4sub96of100,test4pub19of100,100,193,11,420,39,470
test4sub59of100,test4pub10of100,100,193,11,2303,39,2353
test4sub50of100,test4pub18of100,100,193,18,633,38,689
test4sub77of100,test4pub13of100,100,193,10,1421,37,1468
test4sub45of100,test4pub13of100,100,193,10,1423,37,1470
test4sub80of100,test4pub1of100,100,12977,24,6568,65,6657
test4sub15of100,test4pub13of100,100,193,10,1439,64,1513
test4sub83of100,test4pub19of100,100,193,11,450,57,518
test4sub70of100,test4pub7of100,100,192,14,3146,57,3217
test4sub91of100,test4pub16of100,100,193,10,984,55,1049
test4sub82of100,test4pub3of100,100,192,28,6454,52,6534
test4sub89of100,test4pub10of100,100,193,11,2340,52,2403
test4sub85of100,test4pub18of100,100,193,18,670,51,739
test4sub59of100,test4pub11of100,100,193,10,2105,51,2166
test4sub26of100,test4pub19of100,100,193,11,462,51,524
test4sub50of100,test4pub19of100,100,193,11,462,51,524
test4sub77of100,test4pub14of100,100,193,10,1292,51,1353
test4sub45of100,test4pub14of100,100,193,10,1292,51,1353
test4sub23of100,test4pub8of100,100,192,12,2905,41,2958
test4sub15of100,test4pub14of100,100,193,10,1335,9,1354
test4sub80of100,test4pub3of100,100,192,28,6503,10,6541
test4sub17of100,test4pub6of100,100,192,26,3837,9,3872
test4sub70of100,test4pub8of100,100,192,12,2940,10,2962
test4sub91of100,test4pub17of100,100,193,11,906,10,927
test4sub82of100,test4pub4of100,100,192,11,5162,10,5183
test4sub89of100,test4pub11of100,100,193,10,2155,10,2175
test4sub85of100,test4pub19of100,100,193,11,513,11,535
test4sub59of100,test4pub12of100,100,193,11,1713,11,1735
test4sub77of100,test4pub15of100,100,193,11,1204,10,1225
test4sub45of100,test4pub15of100,100,193,11,1204,10,1225
test4sub15of100,test4pub15of100,100,193,11,1206,9,1226
test4sub80of100,test4pub4of100,100,192,11,5168,10,5189
test4sub29of100,test4pub20of100,100,193,10,76,10,96
test4sub17of100,test4pub7of100,100,192,14,3214,10,3238
test4sub70of100,test4pub9of100,100,192,20,2766,9,2795
test4sub91of100,test4pub18of100,100,193,18,731,9,758
test4sub9of100,test4pub20of100,100,193,10,79,10,99
test4sub82of100,test4pub5of100,100,192,14,4175,9,4198
test4sub89of100,test4pub12of100,100,193,11,1723,9,1743
test4sub59of100,test4pub13of100,100,193,10,1520,9,1539
test4sub77of100,test4pub16of100,100,193,10,1056,11,1077
test4sub45of100,test4pub16of100,100,193,10,1057,9,1076
test4sub15of100,test4pub16of100,100,193,10,1058,11,1079
test4sub80of100,test4pub5of100,100,192,14,4181,12,4207
test4sub17of100,test4pub8of100,100,192,12,2960,12,2984
test4sub10of100,test4pub6of100,100,192,26,3858,12,3896
test4sub70of100,test4pub10of100,100,193,11,2411,12,2434
test4sub91of100,test4pub19of100,100,193,11,531,12,554
test4sub63of100,test4pub20of100,100,193,10,91,11,112
test4sub89of100,test4pub13of100,100,193,10,1529,10,1549
test4sub93of100,test4pub20of100,100,193,10,91,11,112
test4sub82of100,test4pub6of100,100,192,26,3862,10,3898
test4sub59of100,test4pub14of100,100,193,10,1363,12,1385
test4sub45of100,test4pub17of100,100,193,11,933,11,955
test4sub77of100,test4pub17of100,100,193,11,932,11,954
test4sub96of100,test4pub20of100,100,193,10,95,12,117
test4sub24of100,test4pub15of100,100,193,11,1227,11,1249
test4sub15of100,test4pub17of100,100,193,11,935,13,959
test4sub46of100,test4pub20of100,100,193,10,97,12,119
test4sub80of100,test4pub6of100,100,192,26,3870,12,3908
test4sub10of100,test4pub7of100,100,192,14,3237,11,3262
test4sub70of100,test4pub11of100,100,193,10,2187,11,2208
test4sub89of100,test4pub14of100,100,193,10,1373,10,1393
test4sub82of100,test4pub7of100,100,192,14,3241,12,3267
test4sub83of100,test4pub20of100,100,193,10,105,11,126
test4sub59of100,test4pub15of100,100,193,11,1236,12,1259
test4sub45of100,test4pub18of100,100,193,18,758,10,786
test4sub77of100,test4pub18of100,100,193,18,759,12,789
test4sub26of100,test4pub20of100,100,193,10,107,11,128
test4sub28of100,test4pub20of100,100,193,10,108,11,129
test4sub24of100,test4pub16of100,100,193,10,1082,11,1103
test4sub15of100,test4pub18of100,100,193,18,762,11,791
test4sub80of100,test4pub7of100,100,192,14,3248,10,3272
test4sub10of100,test4pub8of100,100,192,12,2984,10,3006
test4sub43of100,test4pub20of100,100,193,10,112,11,133
test4sub89of100,test4pub15of100,100,193,11,1245,10,1266
test4sub70of100,test4pub12of100,100,193,11,1755,10,1776
test4sub87of100,test4pub18of100,100,193,18,767,10,795
test4sub82of100,test4pub8of100,100,192,12,2989,8,3009
test4sub59of100,test4pub16of100,100,193,10,1090,9,1109
test4sub45of100,test4pub19of100,100,193,11,560,10,581
test4sub77of100,test4pub19of100,100,193,11,561,8,580
test4sub15of100,test4pub19of100,100,193,11,563,9,583
test4sub24of100,test4pub17of100,100,193,11,959,9,979
test4sub80of100,test4pub8of100,100,192,12,2995,8,3015
test4sub89of100,test4pub16of100,100,193,10,1097,6,1113
test4sub70of100,test4pub13of100,100,193,10,1562,8,1580
test4sub87of100,test4pub19of100,100,193,11,567,7,585
test4sub82of100,test4pub9of100,100,192,20,2814,8,2842
test4sub68of100,test4pub20of100,100,193,10,126,8,144
test4sub59of100,test4pub17of100,100,193,11,965,8,984
test4sub45of100,test4pub20of100,100,193,10,128,7,145
test4sub77of100,test4pub20of100,100,193,10,129,7,146
test4sub80of100,test4pub9of100,100,192,20,2819,5,2844
test4sub89of100,test4pub17of100,100,193,11,970,5,986
test4sub70of100,test4pub14of100,100,193,10,1403,5,1418
test4sub82of100,test4pub10of100,100,193,11,2457,4,2472
test4sub59of100,test4pub18of100,100,193,18,788,4,810
test4sub80of100,test4pub10of100,100,193,11,2461,3,2475
test4sub89of100,test4pub18of100,100,193,18,790,4,812
test4sub82of100,test4pub11of100,100,193,10,2225,4,2239
test4sub70of100,test4pub15of100,100,193,11,1270,5,1286
test4sub59of100,test4pub19of100,100,193,11,583,4,598
test4sub50of100,test4pub20of100,100,193,10,142,3,155
test4sub80of100,test4pub11of100,100,193,10,2229,4,2243
test4sub89of100,test4pub19of100,100,193,11,585,3,599
test4sub82of100,test4pub12of100,100,193,11,1786,3,1800
test4sub34of100,test4pub20of100,100,193,10,145,3,158
test4sub80of100,test4pub12of100,100,193,11,1789,1,1801
test4sub82of100,test4pub13of100,100,193,10,1586,1,1597
test4sub80of100,test4pub13of100,100,193,10,1587,0,1597
test4sub82of100,test4pub14of100,100,193,10,1420,1,1431
test4sub80of100,test4pub14of100,100,193,10,1421,1,1432
test4sub82of100,test4pub15of100,100,193,11,1283,1,1295
test4sub44of100,test4pub19of100,100,193,11,595,1,607
test4sub80of100,test4pub15of100,100,193,11,1283,2,1296
test4sub44of100,test4pub20of100,100,193,10,155,1,166
test4sub85of100,test4pub20of100,100,193,10,156,1,167
test4sub15of100,test4pub20of100,100,193,10,155,2,167
test4sub80of100,test4pub16of100,100,193,10,1128,1,1139
test4sub82of100,test4pub16of100,100,193,10,1127,2,1139
test4sub80of100,test4pub17of100,100,193,11,997,1,1009
test4sub82of100,test4pub17of100,100,193,11,997,1,1009
test4sub80of100,test4pub18of100,100,193,18,812,1,831
test4sub82of100,test4pub18of100,100,193,18,812,1,831
test4sub80of100,test4pub19of100,100,193,11,604,7,622
test4sub82of100,test4pub19of100,100,193,11,604,7,622
test4sub48of100,test4pub13of100,100,193,10,1601,8,1619
test4sub56of100,test4pub20of100,100,193,10,170,1,181
test4sub48of100,test4pub14of100,100,193,10,1441,1,1452
test4sub48of100,test4pub15of100,100,193,11,1303,1,1315
test4sub48of100,test4pub16of100,100,193,10,1147,1,1158
test4sub48of100,test4pub17of100,100,193,11,1013,0,1024
test4sub48of100,test4pub18of100,100,193,18,828,0,846
test4sub48of100,test4pub19of100,100,193,11,620,1,632
test4sub17of100,test4pub9of100,100,192,20,2869,1,2890
test4sub17of100,test4pub10of100,100,193,11,2506,1,2518
test4sub75of100,test4pub20of100,100,193,10,184,2,196
test4sub3of100,test4pub20of100,100,193,10,185,1,196
test4sub17of100,test4pub11of100,100,193,10,2271,1,2282
test4sub89of100,test4pub20of100,100,193,10,186,0,196
test4sub76of100,test4pub18of100,100,193,18,840,1,859
test4sub86of100,test4pub20of100,100,193,10,189,1,200
test4sub76of100,test4pub19of100,100,193,11,631,1,643
test4sub17of100,test4pub12of100,100,193,11,1829,1,1841
test4sub17of100,test4pub13of100,100,193,10,1630,1,1641
test4sub17of100,test4pub14of100,100,193,10,1463,1,1474
test4sub12of100,test4pub20of100,100,193,10,194,1,205
test4sub55of100,test4pub20of100,100,193,10,196,1,207
test4sub25of100,test4pub20of100,100,193,10,200,1,211
test4sub80of100,test4pub20of100,100,193,10,202,0,212
test4sub22of100,test4pub20of100,100,193,10,203,0,213
test4sub59of100,test4pub20of100,100,193,10,205,1,216
test4sub91of100,test4pub20of100,100,193,10,211,1,222
test4sub24of100,test4pub18of100,100,193,18,866,0,884
test4sub77of100,test4pub21of100,100,193,10,128,2,140
test4sub24of100,test4pub19of100,100,193,11,658,1,670
test4sub24of100,test4pub20of100,100,193,10,217,0,227
test4sub29of100,test4pub21of100,100,193,10,135,1,146
test4sub26of100,test4pub21of100,100,193,10,144,1,155
test4sub63of100,test4pub21of100,100,193,10,175,1,186
test4sub96of100,test4pub21of100,100,193,10,180,1,191
test4sub100of100,test4pub19of100,100,193,11,761,1,773
test4sub28of100,test4pub21of100,100,193,10,232,1,243
test4sub83of100,test4pub21of100,100,193,10,234,1,245
test4sub100of100,test4pub20of100,100,193,10,320,2,332
test4sub62of100,test4pub19of100,100,193,11,764,1,776
test4sub93of100,test4pub21of100,100,193,10,236,1,247
test4sub62of100,test4pub20of100,100,193,10,324,1,335
test4sub46of100,test4pub21of100,100,193,10,238,1,249
test4sub43of100,test4pub21of100,100,193,10,246,1,257
test4sub9of100,test4pub21of100,100,193,10,246,1,257
test4sub68of100,test4pub21of100,100,193,10,250,1,261
test4sub82of100,test4pub20of100,100,193,10,340,1,351
test4sub45of100,test4pub21of100,100,193,10,252,1,263
test4sub50of100,test4pub21of100,100,193,10,253,2,265
test4sub82of100,test4pub21of100,100,193,10,254,3,267
test4sub47of100,test4pub8of100,100,192,12,3215,3,3230
test4sub34of100,test4pub21of100,100,193,10,256,2,268
test4sub44of100,test4pub21of100,100,193,10,257,2,269
test4sub15of100,test4pub21of100,100,193,10,258,2,270
test4sub47of100,test4pub9of100,100,192,20,3034,2,3056
test4sub85of100,test4pub21of100,100,193,10,260,2,272
test4sub48of100,test4pub20of100,100,193,10,348,2,360
test4sub48of100,test4pub21of100,100,193,10,263,1,274
test4sub17of100,test4pub15of100,100,193,11,1482,1,1494
test4sub51of100,test4pub19of100,100,193,11,794,1,806
test4sub17of100,test4pub16of100,100,193,10,1326,0,1336
test4sub17of100,test4pub17of100,100,193,11,1193,1,1205
test4sub75of100,test4pub21of100,100,193,10,268,1,279
test4sub5of100,test4pub10of100,100,193,11,2679,3,2693
test4sub3of100,test4pub21of100,100,193,10,270,2,282
test4sub89of100,test4pub21of100,100,193,10,271,2,283
test4sub76of100,test4pub20of100,100,193,10,358,2,370
test4sub76of100,test4pub21of100,100,193,10,274,1,285
test4sub86of100,test4pub21of100,100,193,10,275,1,286
test4sub12of100,test4pub21of100,100,193,10,276,1,287
test4sub55of100,test4pub21of100,100,193,10,277,0,287
test4sub80of100,test4pub21of100,100,193,10,283,1,294
test4sub22of100,test4pub21of100,100,193,10,284,0,294
test4sub59of100,test4pub21of100,100,193,10,286,0,296
test4sub24of100,test4pub21of100,100,193,10,289,1,300
test4sub73of100,test4pub12of100,100,193,11,2022,1,2034
test4sub100of100,test4pub21of100,100,193,10,322,1,333
test4sub96of100,test4pub22of100,100,193,10,192,1,203
test4sub38of100,test4pub18of100,100,193,18,1065,1,1084
test4sub63of100,test4pub22of100,100,193,10,203,0,213
test4sub83of100,test4pub22of100,100,193,10,208,0,218
test4sub29of100,test4pub22of100,100,193,10,209,1,220
test4sub62of100,test4pub21of100,100,193,10,342,1,353
test4sub62of100,test4pub22of100,100,193,10,212,0,222
test4sub77of100,test4pub22of100,100,193,10,214,1,225
test4sub68of100,test4pub22of100,100,193,10,216,0,226
test4sub45of100,test4pub22of100,100,193,10,221,1,232
test4sub90of100,test4pub1of100,100,12977,24,7011,42,7077
test4sub82of100,test4pub22of100,100,193,10,223,43,276
test4sub50of100,test4pub22of100,100,193,10,224,43,277
test4sub43of100,test4pub22of100,100,193,10,227,40,277
test4sub44of100,test4pub22of100,100,193,10,229,38,277
test4sub28of100,test4pub22of100,100,193,10,232,35,277
test4sub85of100,test4pub22of100,100,193,10,233,36,279
test4sub51of100,test4pub20of100,100,193,10,454,35,499
test4sub5of100,test4pub11of100,100,193,10,2543,31,2584
test4sub3of100,test4pub22of100,100,193,10,245,26,281
test4sub26of100,test4pub22of100,100,193,10,247,25,282
test4sub89of100,test4pub22of100,100,193,10,247,25,282
test4sub76of100,test4pub22of100,100,193,10,248,24,282
test4sub86of100,test4pub22of100,100,193,10,249,23,282
test4sub55of100,test4pub22of100,100,193,10,251,22,283
test4sub22of100,test4pub22of100,100,193,10,253,20,283
test4sub15of100,test4pub22of100,100,193,10,258,15,283
test4sub12of100,test4pub22of100,100,193,10,260,14,284
test4sub9of100,test4pub22of100,100,193,10,262,13,285
test4sub59of100,test4pub22of100,100,193,10,265,10,285
test4sub90of100,test4pub4of100,100,192,11,5578,8,5597
test4sub24of100,test4pub22of100,100,193,10,269,6,285
test4sub51of100,test4pub21of100,100,193,10,402,5,417
test4sub5of100,test4pub12of100,100,193,11,2132,7,2150
test4sub51of100,test4pub22of100,100,193,10,276,1,287
test4sub71of100,test4pub18of100,100,193,18,1148,2,1168
test4sub5of100,test4pub13of100,100,193,10,1935,0,1945
test4sub71of100,test4pub19of100,100,193,11,940,1,952
test4sub5of100,test4pub14of100,100,193,10,1769,1,1780
test4sub71of100,test4pub20of100,100,193,10,500,0,510
test4sub5of100,test4pub15of100,100,193,11,1631,1,1643
test4sub71of100,test4pub21of100,100,193,10,415,1,426
test4sub71of100,test4pub22of100,100,193,10,284,0,294
test4sub100of100,test4pub22of100,100,193,10,289,0,299
test4sub80of100,test4pub22of100,100,193,10,290,1,301
test4sub66of100,test4pub18of100,100,193,18,1164,0,1182
test4sub66of100,test4pub19of100,100,193,11,956,1,968
test4sub66of100,test4pub20of100,100,193,10,515,0,525
test4sub62of100,test4pub23of100,100,193,11,130,0,141
test4sub68of100,test4pub23of100,100,193,11,133,1,145
test4sub29of100,test4pub23of100,100,193,11,134,0,145
test4sub90of100,test4pub5of100,100,192,14,4623,0,4637
test4sub90of100,test4pub6of100,100,192,26,4301,2,4329
test4sub45of100,test4pub23of100,100,193,11,138,2,151
test4sub47of100,test4pub10of100,100,193,11,2854,2,2867
test4sub90of100,test4pub7of100,100,192,14,3669,1,3684
test4sub47of100,test4pub11of100,100,193,10,2619,1,2630
test4sub90of100,test4pub8of100,100,192,12,3407,3,3422
test4sub47of100,test4pub12of100,100,193,11,2177,2,2190
test4sub43of100,test4pub23of100,100,193,11,143,3,157
test4sub85of100,test4pub23of100,100,193,11,144,2,157
test4sub90of100,test4pub9of100,100,192,20,3225,3,3248
test4sub47of100,test4pub13of100,100,193,10,1977,1,1988
test4sub47of100,test4pub14of100,100,193,10,1810,1,1821
test4sub90of100,test4pub10of100,100,193,11,2863,2,2876
test4sub63of100,test4pub23of100,100,193,11,150,1,162
test4sub47of100,test4pub15of100,100,193,11,1673,2,1686
test4sub5of100,test4pub16of100,100,193,10,1517,2,1529
test4sub90of100,test4pub11of100,100,193,10,2629,2,2641
test4sub47of100,test4pub16of100,100,193,10,1518,2,1530
test4sub5of100,test4pub17of100,100,193,11,1384,1,1396
test4sub90of100,test4pub12of100,100,193,11,2188,1,2200
test4sub5of100,test4pub18of100,100,193,18,1200,1,1219
test4sub90of100,test4pub13of100,100,193,10,1987,1,1998
test4sub47of100,test4pub17of100,100,193,11,1385,1,1397
test4sub90of100,test4pub14of100,100,193,10,1821,1,1832
test4sub5of100,test4pub19of100,100,193,11,992,1,1004
test4sub47of100,test4pub18of100,100,193,18,1204,0,1222
test4sub5of100,test4pub20of100,100,193,10,552,1,563
test4sub90of100,test4pub15of100,100,193,11,1683,1,1695
test4sub47of100,test4pub19of100,100,193,11,996,1,1008
test4sub5of100,test4pub21of100,100,193,10,467,0,477
test4sub90of100,test4pub16of100,100,193,10,1528,2,1540
test4sub47of100,test4pub20of100,100,193,10,556,1,567
test4sub90of100,test4pub17of100,100,193,11,1395,1,1407
test4sub47of100,test4pub21of100,100,193,10,471,8,489
test4sub90of100,test4pub18of100,100,193,18,1210,8,1236
test4sub90of100,test4pub19of100,100,193,11,1009,0,1020
test4sub90of100,test4pub20of100,100,193,10,569,0,579
test4sub90of100,test4pub21of100,100,193,10,483,1,494
test4sub5of100,test4pub22of100,100,193,10,534,1,545
test4sub26of100,test4pub23of100,100,193,11,362,0,373
test4sub5of100,test4pub23of100,100,193,11,363,1,375
test4sub89of100,test4pub23of100,100,193,11,364,1,376
test4sub28of100,test4pub23of100,100,193,11,367,0,378
test4sub86of100,test4pub23of100,100,193,11,368,0,379
test4sub3of100,test4pub23of100,100,193,11,369,0,380
test4sub46of100,test4pub22of100,100,193,10,544,1,555
test4sub22of100,test4pub23of100,100,193,11,372,1,384
test4sub46of100,test4pub23of100,100,193,11,372,1,384
test4sub83of100,test4pub23of100,100,193,11,374,1,386
test4sub15of100,test4pub23of100,100,193,11,375,1,387
test4sub9of100,test4pub23of100,100,193,11,376,1,388
test4sub10of100,test4pub9of100,100,192,20,3458,0,3478
test4sub10of100,test4pub10of100,100,193,11,3095,1,3107
test4sub10of100,test4pub11of100,100,193,10,2859,0,2869
test4sub10of100,test4pub12of100,100,193,11,2416,0,2427
test4sub10of100,test4pub13of100,100,193,10,2214,1,2225
test4sub10of100,test4pub14of100,100,193,10,2047,1,2058
test4sub76of100,test4pub23of100,100,193,11,386,0,397
test4sub10of100,test4pub15of100,100,193,11,1909,1,1921
test4sub73of100,test4pub13of100,100,193,10,2218,0,2228
test4sub10of100,test4pub16of100,100,193,10,1753,1,1764
test4sub73of100,test4pub14of100,100,193,10,2052,1,2063
test4sub10of100,test4pub17of100,100,193,11,1620,1,1632
test4sub73of100,test4pub15of100,100,193,11,1914,1,1926
test4sub10of100,test4pub18of100,100,193,18,1435,1,1454
test4sub10of100,test4pub19of100,100,193,11,1227,0,1238
test4sub73of100,test4pub16of100,100,193,10,1758,1,1769
test4sub73of100,test4pub17of100,100,193,11,1625,1,1637
test4sub73of100,test4pub18of100,100,193,18,1440,0,1458
test4sub73of100,test4pub19of100,100,193,11,1232,1,1244
test4sub73of100,test4pub20of100,100,193,10,791,1,802
test4sub91of100,test4pub21of100,100,193,10,704,0,714
test4sub91of100,test4pub22of100,100,193,10,574,1,585
test4sub73of100,test4pub21of100,100,193,10,705,1,716
test4sub73of100,test4pub22of100,100,193,10,575,0,585
test4sub59of100,test4pub23of100,100,193,11,406,1,418
test4sub82of100,test4pub23of100,100,193,11,411,1,423
test4sub44of100,test4pub23of100,100,193,11,417,1,429
test4sub96of100,test4pub23of100,100,193,11,424,0,435
test4sub71of100,test4pub23of100,100,193,11,425,0,436
test4sub100of100,test4pub23of100,100,193,11,426,0,437
test4sub66of100,test4pub21of100,100,193,10,734,1,745
test4sub50of100,test4pub23of100,100,193,11,430,1,442
test4sub12of100,test4pub23of100,100,193,11,431,1,443
test4sub66of100,test4pub22of100,100,193,10,604,1,615
test4sub66of100,test4pub23of100,100,193,11,433,1,445
test4sub24of100,test4pub23of100,100,193,11,437,1,449
test4sub90of100,test4pub22of100,100,193,10,612,1,623
test4sub68of100,test4pub24of100,100,193,19,310,2,331
test4sub90of100,test4pub23of100,100,193,11,441,1,453
test4sub55of100,test4pub24of100,100,193,19,311,1,331
test4sub51of100,test4pub23of100,100,193,11,444,1,456
test4sub47of100,test4pub22of100,100,193,10,618,1,629
test4sub47of100,test4pub23of100,100,193,11,446,0,457
test4sub25of100,test4pub21of100,100,193,10,915,0,925
test4sub25of100,test4pub22of100,100,193,10,784,1,795
test4sub63of100,test4pub24of100,100,193,19,496,0,515
test4sub43of100,test4pub24of100,100,193,19,503,0,522
test4sub77of100,test4pub24of100,100,193,19,505,1,525
test4sub80of100,test4pub23of100,100,193,11,671,1,683
test4sub80of100,test4pub24of100,100,193,19,542,0,561
test4sub62of100,test4pub24of100,100,193,19,544,1,564
test4sub85of100,test4pub24of100,100,193,19,545,0,564
test4sub29of100,test4pub24of100,100,193,19,547,1,567
test4sub45of100,test4pub24of100,100,193,19,553,1,573
test4sub93of100,test4pub22of100,100,193,10,865,0,875
test4sub93of100,test4pub23of100,100,193,11,693,0,704
test4sub7of100,test4pub6of100,100,192,26,4861,1,4888
test4sub7of100,test4pub7of100,100,192,14,4228,0,4242
test4sub7of100,test4pub8of100,100,192,12,3966,1,3979
test4sub91of100,test4pub23of100,100,193,11,703,1,715
test4sub91of100,test4pub24of100,100,193,19,575,1,595
test4sub44of100,test4pub24of100,100,193,19,582,1,602
test4sub87of100,test4pub20of100,100,193,10,1105,0,1115
test4sub87of100,test4pub21of100,100,193,10,1020,1,1031
test4sub71of100,test4pub24of100,100,193,19,585,1,605
test4sub100of100,test4pub24of100,100,193,19,587,1,607
test4sub66of100,test4pub24of100,100,193,19,588,1,608
test4sub87of100,test4pub22of100,100,193,10,890,0,900
test4sub87of100,test4pub23of100,100,193,11,720,1,732
test4sub50of100,test4pub24of100,100,193,19,591,1,611
test4sub12of100,test4pub24of100,100,193,19,592,1,612
test4sub24of100,test4pub24of100,100,193,19,598,0,617
test4sub90of100,test4pub24of100,100,193,19,599,1,619
test4sub55of100,test4pub23of100,100,193,11,730,0,741
test4sub51of100,test4pub24of100,100,193,19,603,1,623
test4sub47of100,test4pub24of100,100,193,19,603,1,623
test4sub46of100,test4pub24of100,100,193,19,604,1,624
test4sub96of100,test4pub24of100,100,193,19,662,1,682
test4sub25of100,test4pub23of100,100,193,11,796,0,807
test4sub25of100,test4pub24of100,100,193,19,667,0,686
test4sub43of100,test4pub25of100,100,193,16,259,1,276
test4sub60of100,test4pub1of100,100,12977,24,7779,46,7849
test4sub77of100,test4pub23of100,100,193,11,820,43,874
test4sub42of100,test4pub15of100,100,193,11,2383,5,2399
test4sub29of100,test4pub25of100,100,193,16,308,6,330
test4sub77of100,test4pub25of100,100,193,16,312,3,331
test4sub60of100,test4pub4of100,100,192,11,6350,3,6364
test4sub45of100,test4pub25of100,100,193,16,312,2,330
test4sub42of100,test4pub16of100,100,193,10,2231,2,2243
test4sub60of100,test4pub5of100,100,192,14,5355,0,5369
test4sub42of100,test4pub17of100,100,193,11,2099,1,2111
test4sub60of100,test4pub6of100,100,192,26,5033,1,5060
test4sub93of100,test4pub24of100,100,193,19,741,1,761
test4sub60of100,test4pub7of100,100,192,14,4400,1,4415
test4sub93of100,test4pub25of100,100,193,16,320,1,337
test4sub60of100,test4pub8of100,100,192,12,4138,1,4151
test4sub60of100,test4pub9of100,100,192,20,3955,1,3976
test4sub7of100,test4pub9of100,100,192,20,3957,1,3978
test4sub60of100,test4pub10of100,100,193,11,3591,1,3603
test4sub7of100,test4pub10of100,100,193,11,3593,2,3606
test4sub60of100,test4pub11of100,100,193,10,3356,1,3367
test4sub7of100,test4pub11of100,100,193,10,3358,1,3369
test4sub60of100,test4pub12of100,100,193,11,2914,1,2926
test4sub7of100,test4pub12of100,100,193,11,2915,2,2928
test4sub91of100,test4pub25of100,100,193,16,329,1,346
test4sub7of100,test4pub13of100,100,193,10,2714,0,2724
test4sub7of100,test4pub14of100,100,193,10,2547,1,2558
test4sub44of100,test4pub25of100,100,193,16,334,1,351
test4sub87of100,test4pub24of100,100,193,19,765,1,785
test4sub62of100,test4pub25of100,100,193,16,342,0,358
test4sub87of100,test4pub25of100,100,193,16,343,1,360
test4sub71of100,test4pub25of100,100,193,16,344,2,362
test4sub100of100,test4pub25of100,100,193,16,344,1,361
test4sub66of100,test4pub25of100,100,193,16,345,2,363
test4sub50of100,test4pub25of100,100,193,16,347,2,365
test4sub12of100,test4pub25of100,100,193,16,348,1,365
test4sub17of100,test4pub18of100,100,193,18,1947,1,1966
test4sub17of100,test4pub19of100,100,193,11,1739,1,1751
test4sub17of100,test4pub20of100,100,193,10,1298,1,1309
test4sub67of100,test4pub1of100,100,12977,24,7868,45,7937
test4sub17of100,test4pub21of100,100,193,10,1213,43,1266
test4sub24of100,test4pub25of100,100,193,16,359,41,416
test4sub90of100,test4pub25of100,100,193,16,360,41,417
test4sub55of100,test4pub25of100,100,193,16,366,36,418
test4sub83of100,test4pub24of100,100,193,19,790,35,844
test4sub46of100,test4pub25of100,100,193,16,369,32,417
test4sub39of100,test4pub1of100,100,12977,24,7905,52,7981
test4sub25of100,test4pub25of100,100,193,16,392,51,459
test4sub28of100,test4pub24of100,100,193,19,819,48,886
test4sub80of100,test4pub25of100,100,193,16,398,47,461
test4sub17of100,test4pub22of100,100,193,10,1126,45,1181
test4sub67of100,test4pub3of100,100,192,28,7782,46,7856
test4sub60of100,test4pub13of100,100,193,10,2815,14,2839
test4sub20of100,test4pub16of100,100,193,10,2352,13,2375
test4sub7of100,test4pub15of100,100,193,11,2515,9,2535
test4sub39of100,test4pub3of100,100,192,28,7827,5,7860
test4sub17of100,test4pub23of100,100,193,11,999,5,1015
test4sub67of100,test4pub4of100,100,192,11,6484,4,6499
test4sub60of100,test4pub14of100,100,193,10,2663,4,2677
test4sub20of100,test4pub17of100,100,193,11,2231,5,2247
test4sub7of100,test4pub16of100,100,193,10,2367,3,2380
test4sub39of100,test4pub4of100,100,192,11,6488,5,6504
test4sub67of100,test4pub5of100,100,192,14,5491,3,5508
test4sub60of100,test4pub15of100,100,193,11,2528,5,2544
test4sub20of100,test4pub18of100,100,193,18,2050,3,2071
test4sub7of100,test4pub17of100,100,193,11,2237,5,2253
test4sub39of100,test4pub5of100,100,192,14,5495,3,5512
test4sub67of100,test4pub6of100,100,192,26,5172,4,5202
test4sub20of100,test4pub19of100,100,193,11,1844,2,1857
test4sub60of100,test4pub16of100,100,193,10,2375,4,2389
test4sub7of100,test4pub18of100,100,193,18,2056,3,2077
test4sub39of100,test4pub6of100,100,192,26,5175,3,5204
test4sub67of100,test4pub7of100,100,192,14,4542,3,4559
test4sub20of100,test4pub20of100,100,193,10,1406,4,1420
test4sub60of100,test4pub17of100,100,193,11,2245,4,2260
test4sub17of100,test4pub24of100,100,193,19,887,3,909
test4sub7of100,test4pub19of100,100,193,11,1850,4,1865
test4sub39of100,test4pub7of100,100,192,14,4546,4,4564
test4sub67of100,test4pub8of100,100,192,12,4282,5,4299
test4sub20of100,test4pub21of100,100,193,10,1324,4,1338
test4sub60of100,test4pub18of100,100,193,18,2064,5,2087
test4sub17of100,test4pub25of100,100,193,16,469,3,488
test4sub7of100,test4pub20of100,100,193,10,1414,4,1428
test4sub67of100,test4pub9of100,100,192,20,4104,5,4129
test4sub20of100,test4pub22of100,100,193,10,1198,4,1212
test4sub83of100,test4pub25of100,100,193,16,474,3,493
test4sub7of100,test4pub21of100,100,193,10,1332,3,1345
test4sub60of100,test4pub19of100,100,193,11,1860,5,1876
test4sub20of100,test4pub23of100,100,193,11,1029,3,1043
test4sub5of100,test4pub24of100,100,193,19,900,3,922
test4sub67of100,test4pub10of100,100,193,11,3744,3,3758
test4sub7of100,test4pub22of100,100,193,10,1204,3,1217
test4sub60of100,test4pub20of100,100,193,10,1424,4,1438
test4sub20of100,test4pub24of100,100,193,19,903,3,925
test4sub67of100,test4pub11of100,100,193,10,3512,3,3525
test4sub60of100,test4pub21of100,100,193,10,1341,2,1353
test4sub39of100,test4pub8of100,100,192,12,4301,1,4314
test4sub60of100,test4pub22of100,100,193,10,1212,1,1223
test4sub67of100,test4pub12of100,100,193,11,3072,2,3085
test4sub39of100,test4pub9of100,100,192,20,4119,3,4142
test4sub96of100,test4pub25of100,100,193,16,488,2,506
test4sub67of100,test4pub13of100,100,193,10,2872,3,2885
test4sub3of100,test4pub24of100,100,193,19,912,3,934
test4sub60of100,test4pub23of100,100,193,11,1040,5,1056
test4sub39of100,test4pub10of100,100,193,11,3758,2,3771
test4sub67of100,test4pub14of100,100,193,10,2707,2,2719
test4sub60of100,test4pub24of100,100,193,19,916,1,936
test4sub39of100,test4pub11of100,100,193,10,3525,1,3536
test4sub28of100,test4pub25of100,100,193,16,496,0,512
test4sub67of100,test4pub15of100,100,193,11,2571,1,2583
test4sub39of100,test4pub12of100,100,193,11,3083,2,3096
test4sub60of100,test4pub25of100,100,193,16,496,1,513
test4sub67of100,test4pub16of100,100,193,10,2416,1,2427
test4sub39of100,test4pub13of100,100,193,10,2882,0,2892
test4sub67of100,test4pub17of100,100,193,11,2283,1,2295
test4sub39of100,test4pub14of100,100,193,10,2716,1,2727
test4sub22of100,test4pub24of100,100,193,19,925,0,944
test4sub67of100,test4pub18of100,100,193,18,2099,1,2118
test4sub39of100,test4pub15of100,100,193,11,2579,1,2591
test4sub67of100,test4pub19of100,100,193,11,1891,0,1902
test4sub67of100,test4pub20of100,100,193,10,1450,1,1461
test4sub67of100,test4pub21of100,100,193,10,1365,1,1376
test4sub67of100,test4pub22of100,100,193,10,1234,0,1244
test4sub67of100,test4pub23of100,100,193,11,1062,1,1074
test4sub20of100,test4pub25of100,100,193,16,514,1,531
test4sub42of100,test4pub18of100,100,193,18,2117,0,2135
test4sub42of100,test4pub19of100,100,193,11,1909,1,1921
test4sub42of100,test4pub20of100,100,193,10,1468,0,1478
test4sub7of100,test4pub23of100,100,193,11,1078,1,1090
test4sub42of100,test4pub21of100,100,193,10,1384,2,1396
test4sub7of100,test4pub24of100,100,193,19,950,1,970
test4sub42of100,test4pub22of100,100,193,10,1254,1,1265
test4sub7of100,test4pub25of100,100,193,16,528,1,545
test4sub42of100,test4pub23of100,100,193,11,1083,1,1095
test4sub42of100,test4pub24of100,100,193,19,955,1,975
test4sub42of100,test4pub25of100,100,193,16,534,1,551
test4sub24of100,test4pub26of100,100,193,10,318,0,328
test4sub25of100,test4pub26of100,100,193,10,319,1,330
test4sub95of100,test4pub1of100,100,12977,24,8058,42,8124
test4sub55of100,test4pub26of100,100,193,10,329,41,380
test4sub67of100,test4pub24of100,100,193,19,972,39,1030
test4sub17of100,test4pub26of100,100,193,10,332,40,382
test4sub60of100,test4pub26of100,100,193,10,337,35,382
test4sub5of100,test4pub25of100,100,193,16,567,24,607
test4sub100of100,test4pub26of100,100,193,10,355,18,383
test4sub87of100,test4pub26of100,100,193,10,363,10,383
test4sub86of100,test4pub24of100,100,193,19,1005,9,1033
test4sub39of100,test4pub16of100,100,193,10,2503,6,2519
test4sub3of100,test4pub25of100,100,193,16,587,6,609
test4sub67of100,test4pub25of100,100,193,16,589,5,610
test4sub95of100,test4pub4of100,100,192,11,6626,8,6645
test4sub39of100,test4pub17of100,100,193,11,2376,3,2390
test4sub3of100,test4pub26of100,100,193,10,376,5,391
test4sub22of100,test4pub25of100,100,193,16,595,5,616
test4sub52of100,test4pub18of100,100,193,18,2193,4,2215
test4sub9of100,test4pub24of100,100,193,19,1020,4,1043
test4sub39of100,test4pub18of100,100,193,18,2194,4,2216
test4sub95of100,test4pub5of100,100,192,14,5638,5,5657
test4sub80of100,test4pub26of100,100,193,10,381,6,397
test4sub44of100,test4pub26of100,100,193,10,382,6,398
test4sub39of100,test4pub19of100,100,193,11,1990,3,2004
test4sub43of100,test4pub26of100,100,193,10,386,4,400
test4sub15of100,test4pub24of100,100,193,19,1027,4,1050
test4sub95of100,test4pub6of100,100,192,26,5320,3,5349
test4sub12of100,test4pub26of100,100,193,10,389,3,402
test4sub39of100,test4pub20of100,100,193,10,1552,2,1564
test4sub46of100,test4pub26of100,100,193,10,390,2,402
test4sub45of100,test4pub26of100,100,193,10,394,0,404
test4sub95of100,test4pub7of100,100,192,14,4692,3,4709
test4sub39of100,test4pub21of100,100,193,10,1469,2,1481
test4sub39of100,test4pub22of100,100,193,10,1340,0,1350
test4sub39of100,test4pub23of100,100,193,11,1168,1,1180
test4sub93of100,test4pub26of100,100,193,10,398,1,409
test4sub42of100,test4pub26of100,100,193,10,399,1,410
test4sub30of100,test4pub1of100,100,12977,24,8136,44,8204
test4sub95of100,test4pub8of100,100,192,12,4443,45,4500
test4sub7of100,test4pub26of100,100,193,10,413,39,462
test4sub77of100,test4pub27of100,100,193,10,91,39,140
test4sub20of100,test4pub26of100,100,193,10,414,38,462
test4sub28of100,test4pub26of100,100,193,10,416,38,464
test4sub66of100,test4pub26of100,100,193,10,430,23,463
test4sub67of100,test4pub26of100,100,193,10,431,23,464
test4sub71of100,test4pub26of100,100,193,10,433,22,465
test4sub90of100,test4pub27of100,100,193,10,111,21,142
test4sub55of100,test4pub27of100,100,193,10,116,17,143
test4sub50of100,test4pub26of100,100,193,10,440,17,467
test4sub91of100,test4pub26of100,100,193,10,443,15,468
test4sub62of100,test4pub26of100,100,193,10,443,14,467
test4sub51of100,test4pub25of100,100,193,16,667,8,691
test4sub47of100,test4pub25of100,100,193,16,674,11,701
test4sub60of100,test4pub27of100,100,193,10,146,1,157
test4sub95of100,test4pub9of100,100,192,20,4303,19,4342
test4sub30of100,test4pub4of100,100,192,11,6706,22,6739
test4sub47of100,test4pub26of100,100,193,10,469,5,484
test4sub5of100,test4pub26of100,100,193,10,469,5,484
test4sub51of100,test4pub26of100,100,193,10,459,6,475
test4sub95of100,test4pub10of100,100,193,11,3959,3,3973
test4sub30of100,test4pub5of100,100,192,14,5732,2,5748
test4sub100of100,test4pub27of100,100,193,10,153,3,166
test4sub30of100,test4pub6of100,100,192,26,5411,2,5439
test4sub95of100,test4pub11of100,100,193,10,3725,2,3737
test4sub25of100,test4pub27of100,100,193,10,156,2,168
test4sub30of100,test4pub7of100,100,192,14,4779,2,4795
test4sub95of100,test4pub12of100,100,193,11,3285,2,3298
test4sub17of100,test4pub27of100,100,193,10,159,2,171
test4sub30of100,test4pub8of100,100,192,12,4518,0,4530
test4sub95of100,test4pub13of100,100,193,10,3083,1,3094
test4sub87of100,test4pub27of100,100,193,10,162,2,174
test4sub30of100,test4pub9of100,100,192,20,4334,2,4356
test4sub30of100,test4pub10of100,100,193,11,3972,1,3984
test4sub95of100,test4pub14of100,100,193,10,2918,1,2929
test4sub95of100,test4pub15of100,100,193,11,2782,5,2798
test4sub86of100,test4pub25of100,100,193,16,707,5,728
test4sub86of100,test4pub26of100,100,193,10,494,0,504
test4sub86of100,test4pub27of100,100,193,10,173,1,184
test4sub39of100,test4pub24of100,100,193,19,1139,1,1159
test4sub39of100,test4pub25of100,100,193,16,718,1,735
test4sub39of100,test4pub26of100,100,193,10,501,1,512
test4sub22of100,test4pub26of100,100,193,10,503,1,514
test4sub22of100,test4pub27of100,100,193,10,182,1,193
test4sub9of100,test4pub25of100,100,193,16,726,1,743
test4sub9of100,test4pub26of100,100,193,10,509,0,519
test4sub9of100,test4pub27of100,100,193,10,188,0,198
test4sub43of100,test4pub27of100,100,193,10,191,1,202
test4sub15of100,test4pub25of100,100,193,16,732,0,748
test4sub15of100,test4pub26of100,100,193,10,516,1,527
test4sub15of100,test4pub27of100,100,193,10,196,1,207
test4sub8of100,test4pub10of100,100,193,11,4007,1,4019
test4sub8of100,test4pub11of100,100,193,10,3771,1,3782
test4sub12of100,test4pub27of100,100,193,10,201,1,212
test4sub93of100,test4pub27of100,100,193,10,202,1,213
test4sub8of100,test4pub12of100,100,193,11,3330,0,3341
test4sub8of100,test4pub13of100,100,193,10,3127,1,3138
test4sub8of100,test4pub14of100,100,193,10,2961,1,2972
test4sub8of100,test4pub15of100,100,193,11,2823,0,2834
test4sub10of100,test4pub20of100,100,193,10,1697,0,1707
test4sub10of100,test4pub21of100,100,193,10,1611,1,1622
test4sub82of100,test4pub24of100,100,193,19,1177,1,1197
test4sub42of100,test4pub27of100,100,193,10,215,1,226
test4sub10of100,test4pub22of100,100,193,10,1481,1,1492
test4sub82of100,test4pub25of100,100,193,16,757,1,774
test4sub82of100,test4pub26of100,100,193,10,540,1,551
test4sub30of100,test4pub11of100,100,193,10,3790,1,3801
test4sub30of100,test4pub12of100,100,193,11,3348,1,3360
test4sub30of100,test4pub13of100,100,193,10,3145,0,3155
test4sub30of100,test4pub14of100,100,193,10,2979,1,2990
test4sub30of100,test4pub15of100,100,193,11,2841,1,2853
test4sub30of100,test4pub16of100,100,193,10,2684,0,2694
test4sub30of100,test4pub17of100,100,193,11,2551,1,2563
test4sub30of100,test4pub18of100,100,193,18,2366,1,2385
test4sub95of100,test4pub16of100,100,193,10,2688,0,2698
test4sub95of100,test4pub17of100,100,193,11,2555,1,2567
test4sub30of100,test4pub19of100,100,193,11,2158,0,2169
test4sub30of100,test4pub20of100,100,193,10,1719,1,1730
test4sub95of100,test4pub18of100,100,193,18,2370,1,2389
test4sub95of100,test4pub19of100,100,193,11,2162,1,2174
test4sub30of100,test4pub21of100,100,193,10,1633,2,1645
test4sub63of100,test4pub25of100,100,193,16,777,1,794
test4sub95of100,test4pub20of100,100,193,10,1722,2,1734
test4sub63of100,test4pub26of100,100,193,10,561,1,572
test4sub63of100,test4pub27of100,100,193,10,240,0,250
test4sub7of100,test4pub27of100,100,193,10,248,1,259
test4sub95of100,test4pub21of100,100,193,10,1646,2,1658
test4sub95of100,test4pub22of100,100,193,10,1516,0,1526
test4sub95of100,test4pub23of100,100,193,11,1345,0,1356
test4sub66of100,test4pub27of100,100,193,10,258,1,269
test4sub67of100,test4pub27of100,100,193,10,260,2,272
test4sub71of100,test4pub27of100,100,193,10,261,2,273
test4sub90of100,test4pub26of100,100,193,10,583,1,594
test4sub50of100,test4pub27of100,100,193,10,262,1,273
test4sub54of100,test4pub18of100,100,193,18,2402,1,2421
test4sub91of100,test4pub27of100,100,193,10,265,1,276
test4sub54of100,test4pub19of100,100,193,11,2194,1,2206
test4sub54of100,test4pub20of100,100,193,10,1753,1,1764
test4sub96of100,test4pub26of100,100,193,10,591,3,604
test4sub54of100,test4pub21of100,100,193,10,1667,3,1680
test4sub29of100,test4pub26of100,100,193,10,592,4,606
test4sub51of100,test4pub27of100,100,193,10,271,4,285
test4sub47of100,test4pub27of100,100,193,10,272,3,285
test4sub54of100,test4pub22of100,100,193,10,1539,2,1551
test4sub5of100,test4pub27of100,100,193,10,273,4,287
test4sub96of100,test4pub27of100,100,193,10,272,6,288
test4sub29of100,test4pub27of100,100,193,10,275,4,289
test4sub54of100,test4pub23of100,100,193,11,1369,3,1383
test4sub33of100,test4pub1of100,100,12977,24,8333,44,8401
test4sub54of100,test4pub24of100,100,193,19,1243,43,1305
test4sub100of100,test4pub28of100,100,193,10,188,34,232
test4sub60of100,test4pub28of100,100,193,10,196,28,234
test4sub86of100,test4pub28of100,100,193,10,197,27,234
test4sub55of100,test4pub28of100,100,193,10,198,27,235
test4sub43of100,test4pub28of100,100,193,10,221,3,234
test4sub33of100,test4pub3of100,100,192,28,8246,2,8276
test4sub54of100,test4pub25of100,100,193,16,864,4,884
test4sub56of100,test4pub21of100,100,193,10,1723,3,1736
test4sub33of100,test4pub4of100,100,192,11,6906,2,6919
test4sub54of100,test4pub26of100,100,193,10,651,1,662
test4sub56of100,test4pub22of100,100,193,10,1595,1,1606
test4sub56of100,test4pub23of100,100,193,11,1424,0,1435
test4sub15of100,test4pub28of100,100,193,10,234,1,245
test4sub80of100,test4pub27of100,100,193,10,337,1,348
test4sub80of100,test4pub28of100,100,193,10,236,0,246
test4sub8of100,test4pub16of100,100,193,10,2797,1,2808
test4sub8of100,test4pub17of100,100,193,11,2663,0,2674
test4sub8of100,test4pub18of100,100,193,18,2479,1,2498
test4sub10of100,test4pub23of100,100,193,11,1434,1,1446
test4sub10of100,test4pub24of100,100,193,19,1306,1,1326
test4sub8of100,test4pub19of100,100,193,11,2270,1,2282
test4sub10of100,test4pub25of100,100,193,16,885,1,902
test4sub8of100,test4pub20of100,100,193,10,1830,2,1842
test4sub46of100,test4pub27of100,100,193,10,346,3,359
test4sub82of100,test4pub27of100,100,193,10,347,2,359
test4sub10of100,test4pub26of100,100,193,10,669,3,682
test4sub8of100,test4pub21of100,100,193,10,1746,2,1758
test4sub46of100,test4pub28of100,100,193,10,248,2,260
test4sub82of100,test4pub28of100,100,193,10,248,2,260
test4sub10of100,test4pub27of100,100,193,10,351,1,362
test4sub10of100,test4pub28of100,100,193,10,251,1,262
test4sub42of100,test4pub28of100,100,193,10,253,0,263
test4sub30of100,test4pub22of100,100,193,10,1627,1,1638
test4sub30of100,test4pub23of100,100,193,11,1455,1,1467
test4sub30of100,test4pub24of100,100,193,19,1326,0,1345
test4sub30of100,test4pub25of100,100,193,16,905,1,922
test4sub30of100,test4pub26of100,100,193,10,688,0,698
test4sub30of100,test4pub27of100,100,193,10,368,1,379
test4sub30of100,test4pub28of100,100,193,10,267,1,278
test4sub95of100,test4pub24of100,100,193,19,1335,1,1355
test4sub95of100,test4pub25of100,100,193,16,913,0,929
test4sub25of100,test4pub28of100,100,193,10,273,2,285
test4sub95of100,test4pub26of100,100,193,10,697,3,710
test4sub7of100,test4pub28of100,100,193,10,274,2,286
test4sub62of100,test4pub27of100,100,193,10,377,1,388
test4sub95of100,test4pub27of100,100,193,10,378,1,389
test4sub62of100,test4pub28of100,100,193,10,277,1,288
test4sub95of100,test4pub28of100,100,193,10,279,1,290
test4sub67of100,test4pub28of100,100,193,10,285,1,296
test4sub71of100,test4pub28of100,100,193,10,288,1,299
test4sub90of100,test4pub28of100,100,193,10,290,1,301
test4sub50of100,test4pub28of100,100,193,10,293,0,303
test4sub54of100,test4pub27of100,100,193,10,396,0,406
test4sub54of100,test4pub28of100,100,193,10,296,1,307
test4sub91of100,test4pub28of100,100,193,10,299,1,310
test4sub29of100,test4pub28of100,100,193,10,304,1,315
test4sub51of100,test4pub28of100,100,193,10,306,0,316
test4sub47of100,test4pub28of100,100,193,10,310,1,321
test4sub5of100,test4pub28of100,100,193,10,310,0,320
test4sub33of100,test4pub5of100,100,192,14,5994,0,6008
test4sub33of100,test4pub6of100,100,192,26,5672,1,5699
test4sub33of100,test4pub7of100,100,192,14,5039,1,5054
test4sub3of100,test4pub27of100,100,193,10,419,0,429
test4sub3of100,test4pub28of100,100,193,10,318,1,329
test4sub77of100,test4pub26of100,100,193,10,742,1,753
test4sub77of100,test4pub28of100,100,193,10,320,0,330
test4sub28of100,test4pub27of100,100,193,10,426,1,437
test4sub28of100,test4pub28of100,100,193,10,325,0,335
test4sub100of100,test4pub29of100,100,193,11,160,1,172
test4sub45of100,test4pub27of100,100,193,10,429,0,439
test4sub45of100,test4pub28of100,100,193,10,328,0,338
test4sub44of100,test4pub27of100,100,193,10,435,1,446
test4sub68of100,test4pub25of100,100,193,16,976,1,993
test4sub44of100,test4pub28of100,100,193,10,334,1,345
test4sub68of100,test4pub26of100,100,193,10,760,1,771
test4sub60of100,test4pub29of100,100,193,11,170,0,181
test4sub68of100,test4pub27of100,100,193,10,439,1,450
test4sub86of100,test4pub29of100,100,193,11,172,1,184
test4sub43of100,test4pub29of100,100,193,11,181,1,193
test4sub56of100,test4pub24of100,100,193,19,1416,1,1436
test4sub56of100,test4pub25of100,100,193,16,994,1,1011
test4sub89of100,test4pub24of100,100,193,19,1418,1,1438
test4sub89of100,test4pub25of100,100,193,16,996,1,1013
test4sub56of100,test4pub26of100,100,193,10,778,1,789
test4sub55of100,test4pub29of100,100,193,11,189,2,202
test4sub89of100,test4pub26of100,100,193,10,780,1,791
test4sub56of100,test4pub27of100,100,193,10,458,1,469
test4sub56of100,test4pub28of100,100,193,10,358,1,369
test4sub56of100,test4pub29of100,100,193,11,194,1,206
test4sub15of100,test4pub29of100,100,193,11,197,1,209
test4sub8of100,test4pub22of100,100,193,10,1734,1,1745
test4sub8of100,test4pub23of100,100,193,11,1562,0,1573
test4sub8of100,test4pub24of100,100,193,19,1433,0,1452
test4sub8of100,test4pub25of100,100,193,16,1015,1,1032
test4sub8of100,test4pub26of100,100,193,10,799,1,810
test4sub8of100,test4pub27of100,100,193,10,478,0,488
test4sub8of100,test4pub28of100,100,193,10,378,1,389
test4sub8of100,test4pub29of100,100,193,11,213,1,225
test4sub10of100,test4pub29of100,100,193,11,213,2,226
test4sub82of100,test4pub29of100,100,193,11,214,1,226
test4sub30of100,test4pub29of100,100,193,11,218,1,230
test4sub95of100,test4pub29of100,100,193,11,231,1,243
test4sub7of100,test4pub29of100,100,193,11,232,0,243
test4sub67of100,test4pub29of100,100,193,11,254,1,266
test4sub71of100,test4pub29of100,100,193,11,255,0,266
test4sub90of100,test4pub29of100,100,193,11,257,1,269
test4sub29of100,test4pub29of100,100,193,11,258,0,269
test4sub47of100,test4pub29of100,100,193,11,260,1,272
test4sub5of100,test4pub29of100,100,193,11,262,1,274
test4sub96of100,test4pub28of100,100,193,10,429,0,439
test4sub96of100,test4pub29of100,100,193,11,265,1,277
test4sub3of100,test4pub29of100,100,193,11,286,2,299
test4sub77of100,test4pub29of100,100,193,11,287,1,299
test4sub83of100,test4pub26of100,100,193,10,879,1,890
test4sub100of100,test4pub30of100,100,193,15,153,1,169
test4sub45of100,test4pub29of100,100,193,11,292,1,304
test4sub66of100,test4pub28of100,100,193,10,459,1,470
test4sub66of100,test4pub29of100,100,193,11,295,1,307
test4sub68of100,test4pub28of100,100,193,10,466,1,477
test4sub60of100,test4pub30of100,100,193,15,164,1,180
test4sub68of100,test4pub29of100,100,193,11,302,1,314
test4sub68of100,test4pub30of100,100,193,15,167,1,183
test4sub63of100,test4pub28of100,100,193,10,476,1,487
test4sub12of100,test4pub28of100,100,193,10,478,2,490
test4sub63of100,test4pub29of100,100,193,11,312,2,325
test4sub26of100,test4pub24of100,100,193,19,1544,2,1565
test4sub12of100,test4pub29of100,100,193,11,314,0,325
test4sub40of100,test4pub12of100,100,193,11,3712,1,3724
test4sub40of100,test4pub13of100,100,193,10,3510,1,3521
test4sub40of100,test4pub14of100,100,193,10,3343,0,3353
test4sub40of100,test4pub15of100,100,193,11,3206,1,3218
test4sub40of100,test4pub16of100,100,193,10,3049,1,3060
test4sub40of100,test4pub17of100,100,193,11,2915,0,2926
test4sub38of100,test4pub19of100,100,193,11,2521,1,2533
test4sub28of100,test4pub29of100,100,193,11,327,2,340
test4sub38of100,test4pub20of100,100,193,10,2080,1,2091
test4sub56of100,test4pub30of100,100,193,15,191,4,210
test4sub28of100,test4pub30of100,100,193,15,192,3,210
test4sub38of100,test4pub21of100,100,193,10,1996,4,2010
test4sub86of100,test4pub30of100,100,193,15,194,3,212
test4sub8of100,test4pub30of100,100,193,15,194,5,214
test4sub80of100,test4pub29of100,100,193,11,332,5,348
test4sub38of100,test4pub22of100,100,193,10,1868,2,1880
test4sub15of100,test4pub30of100,100,193,15,198,4,217
test4sub82of100,test4pub30of100,100,193,15,198,3,216
test4sub80of100,test4pub30of100,100,193,15,200,2,217
test4sub38of100,test4pub23of100,100,193,11,1698,2,1711
test4sub93of100,test4pub28of100,100,193,10,505,2,517
test4sub30of100,test4pub30of100,100,193,15,203,1,219
test4sub93of100,test4pub29of100,100,193,11,341,1,353
test4sub38of100,test4pub24of100,100,193,19,1571,2,1592
test4sub38of100,test4pub25of100,100,193,16,1152,1,1169
test4sub38of100,test4pub26of100,100,193,10,935,0,945
test4sub46of100,test4pub29of100,100,193,11,357,0,368
test4sub46of100,test4pub30of100,100,193,15,222,1,238
test4sub57of100,test4pub1of100,100,12977,24,8683,45,8752
test4sub25of100,test4pub29of100,100,193,11,363,45,419
test4sub67of100,test4pub30of100,100,193,15,228,46,289
test4sub71of100,test4pub30of100,100,193,15,228,45,288
test4sub90of100,test4pub30of100,100,193,15,231,44,290
test4sub29of100,test4pub30of100,100,193,15,232,42,289
test4sub47of100,test4pub30of100,100,193,15,237,38,290
test4sub96of100,test4pub30of100,100,193,15,242,34,291
test4sub33of100,test4pub8of100,100,192,12,5021,18,5051
test4sub77of100,test4pub30of100,100,193,15,261,15,291
test4sub3of100,test4pub30of100,100,193,15,259,17,291
test4sub45of100,test4pub30of100,100,193,15,266,10,291
test4sub75of100,test4pub22of100,100,193,10,1940,9,1959
test4sub63of100,test4pub30of100,100,193,15,270,7,292
test4sub57of100,test4pub3of100,100,192,28,8599,7,8634
test4sub12of100,test4pub30of100,100,193,15,272,7,294
test4sub25of100,test4pub30of100,100,193,15,272,7,294
test4sub26of100,test4pub25of100,100,193,16,1218,6,1240
test4sub33of100,test4pub9of100,100,192,20,4854,3,4877
test4sub57of100,test4pub4of100,100,192,11,7262,3,7276
test4sub26of100,test4pub26of100,100,193,10,1007,1,1018
test4sub33of100,test4pub10of100,100,193,11,4494,2,4507
test4sub57of100,test4pub5of100,100,192,14,6267,1,6282
test4sub33of100,test4pub11of100,100,193,10,4259,1,4270
test4sub33of100,test4pub12of100,100,193,11,3817,1,3829
test4sub57of100,test4pub6of100,100,192,26,5946,1,5973
test4sub33of100,test4pub13of100,100,193,10,3614,1,3625
test4sub57of100,test4pub7of100,100,192,14,5313,1,5328
test4sub57of100,test4pub8of100,100,192,12,5051,0,5063
test4sub33of100,test4pub14of100,100,193,10,3448,1,3459
test4sub26of100,test4pub27of100,100,193,10,695,2,707
test4sub33of100,test4pub15of100,100,193,11,3311,3,3325
test4sub26of100,test4pub28of100,100,193,10,596,2,608
test4sub57of100,test4pub9of100,100,192,20,4868,5,4893
test4sub26of100,test4pub29of100,100,193,11,433,1,445
test4sub33of100,test4pub16of100,100,193,10,3158,1,3169
test4sub93of100,test4pub30of100,100,193,15,298,1,314
test4sub40of100,test4pub18of100,100,193,18,2841,2,2861
test4sub57of100,test4pub10of100,100,193,11,4514,1,4526
test4sub40of100,test4pub19of100,100,193,11,2634,1,2646
test4sub33of100,test4pub17of100,100,193,11,3028,5,3044
test4sub57of100,test4pub11of100,100,193,10,4279,5,4294
test4sub40of100,test4pub20of100,100,193,10,2194,4,2208
test4sub57of100,test4pub12of100,100,193,11,3840,2,3853
test4sub40of100,test4pub21of100,100,193,10,2112,1,2123
test4sub33of100,test4pub18of100,100,193,18,2848,7,2873
test4sub40of100,test4pub22of100,100,193,10,1983,3,1996
test4sub57of100,test4pub13of100,100,193,10,3639,5,3654
test4sub13of100,test4pub12of100,100,193,11,3847,5,3863
test4sub40of100,test4pub23of100,100,193,11,1814,4,1829
test4sub33of100,test4pub19of100,100,193,11,2646,4,2661
test4sub13of100,test4pub13of100,100,193,10,3648,3,3661
test4sub57of100,test4pub14of100,100,193,10,3479,6,3495
test4sub13of100,test4pub14of100,100,193,10,3484,2,3496
test4sub33of100,test4pub20of100,100,193,10,2212,5,2227
test4sub13of100,test4pub15of100,100,193,11,3347,1,3359
test4sub57of100,test4pub15of100,100,193,11,3346,4,3361
test4sub13of100,test4pub16of100,100,193,10,3192,2,3204
test4sub13of100,test4pub17of100,100,193,11,3059,1,3071
test4sub57of100,test4pub16of100,100,193,10,3193,2,3205
test4sub57of100,test4pub17of100,100,193,11,3062,0,3073
test4sub57of100,test4pub18of100,100,193,18,2878,6,2902
test4sub33of100,test4pub21of100,100,193,10,2143,3,2156
test4sub57of100,test4pub19of100,100,193,11,2674,3,2688
test4sub83of100,test4pub27of100,100,193,10,749,2,761
test4sub33of100,test4pub22of100,100,193,10,2014,3,2027
test4sub83of100,test4pub28of100,100,193,10,649,2,661
test4sub57of100,test4pub20of100,100,193,10,2236,2,2248
test4sub75of100,test4pub23of100,100,193,11,1845,2,1858
test4sub33of100,test4pub23of100,100,193,11,1846,3,1860
test4sub83of100,test4pub29of100,100,193,11,486,1,498
test4sub75of100,test4pub24of100,100,193,19,1718,2,1739
test4sub33of100,test4pub24of100,100,193,19,1719,2,1740
test4sub83of100,test4pub30of100,100,193,15,352,1,368
test4sub33of100,test4pub25of100,100,193,16,1299,0,1315
test4sub33of100,test4pub27of100,100,193,10,760,1,771
test4sub75of100,test4pub25of100,100,193,16,1323,1,1340
test4sub75of100,test4pub26of100,100,193,10,1107,1,1118
test4sub75of100,test4pub27of100,100,193,10,786,0,796
test4sub26of100,test4pub30of100,100,193,15,388,1,404
test4sub40of100,test4pub24of100,100,193,19,1765,1,1785
test4sub40of100,test4pub25of100,100,193,16,1343,0,1359
test4sub40of100,test4pub26of100,100,193,10,1139,1,1150
test4sub40of100,test4pub27of100,100,193,10,818,0,828
test4sub40of100,test4pub28of100,100,193,10,718,1,729
test4sub40of100,test4pub29of100,100,193,11,553,1,565
test4sub40of100,test4pub30of100,100,193,15,417,0,432
test4sub57of100,test4pub21of100,100,193,10,2234,0,2244
test4sub17of100,test4pub28of100,100,193,10,735,1,746
test4sub57of100,test4pub22of100,100,193,10,2104,1,2115
test4sub57of100,test4pub23of100,100,193,11,1933,1,1945
test4sub57of100,test4pub24of100,100,193,19,1804,0,1823
test4sub57of100,test4pub25of100,100,193,16,1382,1,1399
test4sub57of100,test4pub26of100,100,193,10,1166,1,1177
test4sub57of100,test4pub27of100,100,193,10,845,0,855
test4sub57of100,test4pub28of100,100,193,10,744,0,754
test4sub57of100,test4pub29of100,100,193,11,580,1,592
test4sub57of100,test4pub30of100,100,193,15,444,1,460
test4sub13of100,test4pub18of100,100,193,18,2991,0,3009
test4sub13of100,test4pub19of100,100,193,11,2782,0,2793
test4sub13of100,test4pub20of100,100,193,10,2342,1,2353
test4sub24of100,test4pub27of100,100,193,10,863,0,873
test4sub13of100,test4pub21of100,100,193,10,2261,1,2272
test4sub24of100,test4pub28of100,100,193,10,763,1,774
test4sub13of100,test4pub22of100,100,193,10,2131,2,2143
test4sub33of100,test4pub26of100,100,193,10,1188,2,1200
test4sub24of100,test4pub29of100,100,193,11,599,2,612
test4sub13of100,test4pub24of100,100,193,19,1830,1,1850
test4sub33of100,test4pub28of100,100,193,10,766,1,777
test4sub33of100,test4pub29of100,100,193,11,602,1,614
test4sub33of100,test4pub30of100,100,193,15,467,1,483
test4sub75of100,test4pub28of100,100,193,10,776,1,787
test4sub75of100,test4pub29of100,100,193,11,611,0,622
test4sub75of100,test4pub30of100,100,193,15,475,0,490
test4sub45of100,test4pub31of100,100,193,10,344,1,355
test4sub87of100,test4pub28of100,100,193,10,783,1,794
test4sub22of100,test4pub28of100,100,193,10,784,1,795
test4sub65of100,test4pub6of100,100,192,26,6145,1,6172
test4sub65of100,test4pub7of100,100,192,14,5512,0,5526
test4sub65of100,test4pub8of100,100,192,12,5250,1,5263
test4sub65of100,test4pub9of100,100,192,20,5066,1,5087
test4sub28of100,test4pub31of100,100,193,10,355,3,368
test4sub93of100,test4pub31of100,100,193,10,355,2,367
test4sub65of100,test4pub10of100,100,193,11,4703,2,4716
test4sub86of100,test4pub31of100,100,193,10,357,2,369
test4sub65of100,test4pub11of100,100,193,10,4469,1,4480
test4sub15of100,test4pub31of100,100,193,10,360,0,370
test4sub56of100,test4pub31of100,100,193,10,361,1,372
test4sub8of100,test4pub31of100,100,193,10,362,0,372
test4sub80of100,test4pub31of100,100,193,10,365,1,376
test4sub77of100,test4pub31of100,100,193,10,374,1,385
test4sub67of100,test4pub31of100,100,193,10,375,2,387
test4sub63of100,test4pub31of100,100,193,10,377,2,389
test4sub3of100,test4pub31of100,100,193,10,378,1,389
test4sub60of100,test4pub31of100,100,193,10,386,0,396
test4sub30of100,test4pub31of100,100,193,10,389,0,399
test4sub50of100,test4pub29of100,100,193,11,662,1,674
test4sub50of100,test4pub30of100,100,193,15,526,0,541
test4sub68of100,test4pub31of100,100,193,10,393,0,403
test4sub90of100,test4pub31of100,100,193,10,392,1,403
test4sub100of100,test4pub31of100,100,193,10,395,0,405
test4sub47of100,test4pub31of100,100,193,10,397,1,408
test4sub71of100,test4pub31of100,100,193,10,405,0,415
test4sub12of100,test4pub31of100,100,193,10,407,1,418
test4sub29of100,test4pub31of100,100,193,10,407,0,417
test4sub74of100,test4pub16of100,100,193,10,3408,1,3419
test4sub74of100,test4pub17of100,100,193,11,3274,1,3286
test4sub48of100,test4pub22of100,100,193,10,2218,1,2229
test4sub74of100,test4pub18of100,100,193,18,3090,1,3109
test4sub74of100,test4pub19of100,100,193,11,2882,1,2894
test4sub74of100,test4pub20of100,100,193,10,2441,1,2452
test4sub74of100,test4pub21of100,100,193,10,2355,0,2365
test4sub17of100,test4pub29of100,100,193,11,715,0,726
test4sub17of100,test4pub30of100,100,193,15,580,1,596
test4sub17of100,test4pub31of100,100,193,10,447,0,457
test4sub23of100,test4pub9of100,100,192,20,5160,1,5181
test4sub23of100,test4pub10of100,100,193,11,4796,0,4807
test4sub23of100,test4pub11of100,100,193,10,4560,1,4571
test4sub23of100,test4pub12of100,100,193,11,4118,1,4130
test4sub23of100,test4pub13of100,100,193,10,3915,0,3925
test4sub13of100,test4pub23of100,100,193,11,2086,1,2098
test4sub23of100,test4pub14of100,100,193,10,3749,1,3760
test4sub13of100,test4pub25of100,100,193,16,1535,1,1552
test4sub23of100,test4pub15of100,100,193,11,3612,1,3624
test4sub23of100,test4pub16of100,100,193,10,3455,1,3466
test4sub13of100,test4pub26of100,100,193,10,1319,1,1330
test4sub24of100,test4pub30of100,100,193,15,594,1,610
test4sub13of100,test4pub27of100,100,193,10,1000,1,1011
test4sub24of100,test4pub31of100,100,193,10,461,1,472
test4sub13of100,test4pub28of100,100,193,10,900,1,911
test4sub33of100,test4pub31of100,100,193,10,464,1,475
test4sub13of100,test4pub29of100,100,193,11,735,0,746
test4sub75of100,test4pub31of100,100,193,10,466,1,477
test4sub13of100,test4pub30of100,100,193,15,601,1,617
test4sub13of100,test4pub31of100,100,193,10,468,1,479
test4sub87of100,test4pub29of100,100,193,11,746,1,758
test4sub87of100,test4pub30of100,100,193,15,611,1,627
test4sub87of100,test4pub31of100,100,193,10,478,0,488
test4sub93of100,test4pub32of100,100,193,11,136,0,147
test4sub15of100,test4pub32of100,100,193,11,147,1,159
test4sub28of100,test4pub32of100,100,193,11,150,1,162
test4sub67of100,test4pub32of100,100,193,11,151,0,162
test4sub3of100,test4pub32of100,100,193,11,153,0,164
test4sub60of100,test4pub32of100,100,193,11,155,1,167
test4sub50of100,test4pub31of100,100,193,10,508,1,519
test4sub90of100,test4pub32of100,100,193,11,158,1,170
test4sub68of100,test4pub32of100,100,193,11,158,1,170
test4sub47of100,test4pub32of100,100,193,11,161,0,172
test4sub63of100,test4pub32of100,100,193,11,163,0,174
test4sub45of100,test4pub32of100,100,193,11,188,1,200
test4sub95of100,test4pub30of100,100,193,15,679,1,695
test4sub95of100,test4pub31of100,100,193,10,546,0,556
test4sub77of100,test4pub32of100,100,193,11,195,1,207
test4sub5of100,test4pub30of100,100,193,15,685,0,700
test4sub100of100,test4pub32of100,100,193,11,199,1,211
test4sub12of100,test4pub32of100,100,193,11,200,1,212
test4sub71of100,test4pub32of100,100,193,11,201,1,213
test4sub4of100,test4pub19of100,100,193,11,3021,0,3032
test4sub74of100,test4pub22of100,100,193,10,2362,1,2373
test4sub4of100,test4pub20of100,100,193,10,2581,1,2592
test4sub4of100,test4pub21of100,100,193,10,2495,1,2506
test4sub74of100,test4pub23of100,100,193,11,2190,1,2202
test4sub74of100,test4pub24of100,100,193,19,2062,0,2081
test4sub74of100,test4pub25of100,100,193,16,1641,1,1658
test4sub74of100,test4pub26of100,100,193,10,1424,0,1434
test4sub74of100,test4pub27of100,100,193,10,1103,0,1113
test4sub74of100,test4pub28of100,100,193,10,1003,2,1015
test4sub48of100,test4pub23of100,100,193,11,2199,1,2211
test4sub48of100,test4pub24of100,100,193,19,2070,0,2089
test4sub74of100,test4pub29of100,100,193,11,839,1,851
test4sub48of100,test4pub25of100,100,193,16,1650,1,1667
test4sub48of100,test4pub27of100,100,193,10,1111,0,1121
test4sub48of100,test4pub26of100,100,193,10,1435,1,1446
test4sub8of100,test4pub32of100,100,193,11,222,1,234
test4sub56of100,test4pub32of100,100,193,11,223,1,235
test4sub17of100,test4pub32of100,100,193,11,227,1,239
test4sub29of100,test4pub32of100,100,193,11,252,0,263
test4sub13of100,test4pub32of100,100,193,11,253,0,264
test4sub85of100,test4pub25of100,100,193,16,1687,1,1704
test4sub24of100,test4pub32of100,100,193,11,256,1,268
test4sub85of100,test4pub26of100,100,193,10,1470,1,1481
test4sub33of100,test4pub32of100,100,193,11,257,2,270
test4sub85of100,test4pub27of100,100,193,10,1151,2,1163
test4sub7of100,test4pub30of100,100,193,15,746,3,764
test4sub80of100,test4pub32of100,100,193,11,260,3,274
test4sub85of100,test4pub28of100,100,193,10,1051,3,1064
test4sub30of100,test4pub32of100,100,193,11,262,2,275
test4sub75of100,test4pub32of100,100,193,11,261,3,275
test4sub7of100,test4pub31of100,100,193,10,616,3,629
test4sub1of100,test4pub17of100,100,193,11,3479,3,3493
test4sub85of100,test4pub29of100,100,193,11,889,1,901
test4sub1of100,test4pub18of100,100,193,18,3296,1,3315
test4sub85of100,test4pub30of100,100,193,15,755,1,771
test4sub1of100,test4pub19of100,100,193,11,3088,0,3099
test4sub1of100,test4pub20of100,100,193,10,2648,1,2659
test4sub1of100,test4pub21of100,100,193,10,2562,1,2573
test4sub87of100,test4pub32of100,100,193,11,294,1,306
test4sub59of100,test4pub24of100,100,193,19,2154,1,2174
test4sub59of100,test4pub25of100,100,193,16,1733,1,1750
test4sub86of100,test4pub32of100,100,193,11,302,1,314
test4sub59of100,test4pub26of100,100,193,10,1516,1,1527
test4sub59of100,test4pub27of100,100,193,10,1196,1,1207
test4sub59of100,test4pub28of100,100,193,10,1095,1,1106
test4sub50of100,test4pub32of100,100,193,11,306,1,318
test4sub59of100,test4pub29of100,100,193,11,931,1,943
test4sub66of100,test4pub30of100,100,193,15,807,0,822
test4sub66of100,test4pub31of100,100,193,10,674,1,685
test4sub66of100,test4pub32of100,100,193,11,323,1,335
test4sub43of100,test4pub30of100,100,193,15,813,1,829
test4sub55of100,test4pub30of100,100,193,15,815,1,831
test4sub95of100,test4pub32of100,100,193,11,441,1,453
test4sub5of100,test4pub31of100,100,193,10,878,0,888
test4sub5of100,test4pub32of100,100,193,11,527,1,539
test4sub4of100,test4pub22of100,100,193,10,2685,1,2696
test4sub4of100,test4pub23of100,100,193,11,2513,1,2525
test4sub4of100,test4pub24of100,100,193,19,2385,1,2405
test4sub4of100,test4pub25of100,100,193,16,2001,1,2018
test4sub4of100,test4pub26of100,100,193,10,1784,0,1794
test4sub4of100,test4pub27of100,100,193,10,1464,1,1475
test4sub74of100,test4pub30of100,100,193,15,1060,1,1076
test4sub74of100,test4pub31of100,100,193,10,927,0,937
test4sub74of100,test4pub32of100,100,193,11,576,1,588
test4sub48of100,test4pub28of100,100,193,10,1481,1,1492
test4sub48of100,test4pub29of100,100,193,11,1317,1,1329
test4sub48of100,test4pub30of100,100,193,15,1181,1,1197
test4sub48of100,test4pub31of100,100,193,10,1050,1,1061
test4sub48of100,test4pub32of100,100,193,11,698,0,709
test4sub10of100,test4pub30of100,100,193,15,1216,0,1231
test4sub23of100,test4pub17of100,100,193,11,3948,1,3960
test4sub23of100,test4pub18of100,100,193,18,3763,1,3782
test4sub23of100,test4pub19of100,100,193,11,3554,0,3565
test4sub23of100,test4pub20of100,100,193,10,3125,0,3135
test4sub23of100,test4pub21of100,100,193,10,3040,1,3051
test4sub23of100,test4pub22of100,100,193,10,2909,0,2919
test4sub23of100,test4pub23of100,100,193,11,2738,1,2750
test4sub23of100,test4pub24of100,100,193,19,2609,1,2629
test4sub23of100,test4pub25of100,100,193,16,2187,0,2203
test4sub23of100,test4pub26of100,100,193,10,1970,1,1981
test4sub23of100,test4pub27of100,100,193,10,1661,0,1671
test4sub23of100,test4pub28of100,100,193,10,1561,1,1572
test4sub23of100,test4pub29of100,100,193,11,1396,0,1407
test4sub91of100,test4pub29of100,100,193,11,1409,0,1420
test4sub85of100,test4pub31of100,100,193,10,1139,1,1150
test4sub91of100,test4pub30of100,100,193,15,1274,1,1290
test4sub85of100,test4pub32of100,100,193,11,788,0,799
test4sub91of100,test4pub31of100,100,193,10,1141,1,1152
test4sub91of100,test4pub32of100,100,193,11,790,0,801
test4sub7of100,test4pub32of100,100,193,11,814,1,826
test4sub1of100,test4pub22of100,100,193,10,2975,0,2985
test4sub1of100,test4pub24of100,100,193,19,2674,1,2694
test4sub1of100,test4pub23of100,100,193,11,2805,0,2816
test4sub1of100,test4pub25of100,100,193,16,2254,1,2271
test4sub1of100,test4pub26of100,100,193,10,2038,1,2049
test4sub1of100,test4pub27of100,100,193,10,1717,0,1727
test4sub1of100,test4pub28of100,100,193,10,1616,0,1626
test4sub1of100,test4pub29of100,100,193,11,1452,1,1464
test4sub1of100,test4pub30of100,100,193,15,1316,0,1331
test4sub1of100,test4pub31of100,100,193,10,1184,1,1195
test4sub1of100,test4pub32of100,100,193,11,832,1,844
test4sub44of100,test4pub29of100,100,193,11,1461,0,1472
test4sub44of100,test4pub30of100,100,193,15,1326,1,1342
test4sub70of100,test4pub16of100,100,193,10,4189,1,4200
test4sub70of100,test4pub17of100,100,193,11,4055,1,4067
test4sub44of100,test4pub31of100,100,193,10,1193,2,1205
test4sub26of100,test4pub31of100,100,193,10,1195,1,1206
test4sub70of100,test4pub18of100,100,193,18,3871,2,3891
test4sub59of100,test4pub30of100,100,193,15,1331,1,1347
test4sub70of100,test4pub19of100,100,193,11,3664,0,3675
test4sub59of100,test4pub31of100,100,193,10,1198,1,1209
test4sub59of100,test4pub32of100,100,193,11,847,1,859
test4sub70of100,test4pub20of100,100,193,10,3224,1,3235
test4sub70of100,test4pub21of100,100,193,10,3138,1,3149
test4sub51of100,test4pub29of100,100,193,11,1482,0,1493
test4sub43of100,test4pub31of100,100,193,10,1212,1,1223
test4sub51of100,test4pub30of100,100,193,15,1347,1,1363
test4sub43of100,test4pub32of100,100,193,11,861,1,873
test4sub51of100,test4pub31of100,100,193,10,1214,1,1225
test4sub51of100,test4pub32of100,100,193,11,863,1,875
test4sub83of100,test4pub31of100,100,193,10,1222,0,1232
test4sub34of100,test4pub22of100,100,193,10,3029,0,3039
test4sub38of100,test4pub27of100,100,193,10,1768,1,1779
test4sub38of100,test4pub28of100,100,193,10,1667,1,1678
test4sub38of100,test4pub29of100,100,193,11,1502,0,1513
test4sub100of100,test4pub33of100,100,193,11,738,1,750
test4sub87of100,test4pub33of100,100,193,11,746,1,758
test4sub28of100,test4pub33of100,100,193,11,751,1,763
test4sub47of100,test4pub33of100,100,193,11,752,1,764
test4sub13of100,test4pub33of100,100,193,11,763,1,775
test4sub71of100,test4pub33of100,100,193,11,763,2,776
test4sub3of100,test4pub33of100,100,193,11,764,0,775
test4sub63of100,test4pub33of100,100,193,11,769,0,780
test4sub56of100,test4pub33of100,100,193,11,769,1,781
test4sub77of100,test4pub33of100,100,193,11,773,1,785
test4sub33of100,test4pub33of100,100,193,11,775,1,787
test4sub55of100,test4pub31of100,100,193,10,1272,1,1283
test4sub55of100,test4pub32of100,100,193,11,920,1,932
test4sub75of100,test4pub33of100,100,193,11,780,0,791
test4sub55of100,test4pub33of100,100,193,11,780,1,792
test4sub80of100,test4pub33of100,100,193,11,785,0,796
test4sub45of100,test4pub33of100,100,193,11,788,0,799
test4sub89of100,test4pub27of100,100,193,10,1828,0,1838
test4sub89of100,test4pub28of100,100,193,10,1728,1,1739
test4sub89of100,test4pub29of100,100,193,11,1563,1,1575
test4sub89of100,test4pub30of100,100,193,15,1427,0,1442
test4sub89of100,test4pub31of100,100,193,10,1295,1,1306
test4sub48of100,test4pub33of100,100,193,11,803,1,815
test4sub10of100,test4pub31of100,100,193,10,1299,0,1309
test4sub10of100,test4pub32of100,100,193,11,947,0,958
test4sub10of100,test4pub33of100,100,193,11,807,1,819
test4sub23of100,test4pub30of100,100,193,15,1438,1,1454
test4sub23of100,test4pub31of100,100,193,10,1306,1,1317
test4sub23of100,test4pub32of100,100,193,11,954,0,965
test4sub15of100,test4pub33of100,100,193,11,911,0,922
test4sub96of100,test4pub31of100,100,193,10,1571,1,1582
test4sub91of100,test4pub33of100,100,193,11,1426,1,1438
test4sub12of100,test4pub33of100,100,193,11,1929,1,1941
test4sub17of100,test4pub33of100,100,193,11,1931,1,1943
test4sub40of100,test4pub31of100,100,193,10,2432,0,2442
test4sub29of100,test4pub33of100,100,193,11,1942,0,1953
test4sub7of100,test4pub33of100,100,193,11,1969,0,1980
test4sub1of100,test4pub33of100,100,193,11,2153,1,2165
test4sub44of100,test4pub32of100,100,193,11,2299,1,2311
test4sub44of100,test4pub33of100,100,193,11,2158,0,2169
test4sub26of100,test4pub32of100,100,193,11,2321,1,2333
test4sub26of100,test4pub33of100,100,193,11,2180,0,2191
test4sub89of100,test4pub32of100,100,193,11,3529,1,3541
test4sub89of100,test4pub33of100,100,193,11,3388,0,3399
test4sub93of100,test4pub33of100,100,193,11,3668,1,3680
test4sub3of100,test4pub34of100,100,193,12,2895,1,2908
test4sub24of100,test4pub33of100,100,193,11,3951,1,3963
test4sub47of100,test4pub34of100,100,193,12,3188,1,3201
test4sub75of100,test4pub34of100,100,193,12,3218,0,3230
test4sub77of100,test4pub34of100,100,193,12,3232,1,3245
test4sub87of100,test4pub34of100,100,193,12,3237,1,3250
test4sub100of100,test4pub34of100,100,193,12,3237,1,3250
test4sub68of100,test4pub33of100,100,193,11,4027,0,4038
test4sub13of100,test4pub34of100,100,193,12,3255,1,3268
test4sub10of100,test4pub34of100,100,193,12,3260,0,3272
test4sub33of100,test4pub34of100,100,193,12,3267,1,3280
test4sub71of100,test4pub34of100,100,193,12,3292,0,3304
test4sub56of100,test4pub34of100,100,193,12,3292,1,3305
test4sub63of100,test4pub34of100,100,193,12,3310,1,3323
test4sub48of100,test4pub34of100,100,193,12,3315,1,3328
test4sub25of100,test4pub31of100,100,193,10,4599,1,4610
test4sub25of100,test4pub32of100,100,193,11,4247,0,4258
test4sub25of100,test4pub33of100,100,193,11,4107,1,4119
test4sub55of100,test4pub34of100,100,193,12,3352,0,3364
test4sub28of100,test4pub34of100,100,193,12,3358,1,3371
test4sub45of100,test4pub34of100,100,193,12,3362,1,3375
test4sub15of100,test4pub34of100,100,193,12,3367,0,3379
test4sub5of100,test4pub33of100,100,193,11,4169,1,4181
test4sub50of100,test4pub33of100,100,193,11,4174,1,4186
test4sub80of100,test4pub34of100,100,193,12,3395,1,3408
test4sub39of100,test4pub27of100,100,193,10,5213,1,5224
test4sub9of100,test4pub28of100,100,193,10,5116,1,5127
test4sub9of100,test4pub29of100,100,193,11,4952,1,4964
test4sub9of100,test4pub30of100,100,193,15,4816,1,4832
test4sub86of100,test4pub33of100,100,193,11,4188,1,4200
test4sub67of100,test4pub33of100,100,193,11,4192,1,4204
test4sub76of100,test4pub24of100,100,193,19,6195,1,6215
test4sub76of100,test4pub25of100,100,193,16,5773,0,5789
test4sub76of100,test4pub26of100,100,193,10,5556,1,5567
test4sub96of100,test4pub32of100,100,193,11,4343,1,4355
test4sub96of100,test4pub33of100,100,193,11,4202,1,4214
test4sub96of100,test4pub34of100,100,193,12,3423,1,3436
test4sub58of100,test4pub5of100,100,192,14,10859,0,10873
test4sub58of100,test4pub6of100,100,192,26,10537,1,10564
test4sub58of100,test4pub7of100,100,192,14,9904,0,9918
test4sub58of100,test4pub8of100,100,192,12,9641,1,9654
test4sub97of100,test4pub3of100,100,192,28,13207,1,13236
test4sub58of100,test4pub9of100,100,192,20,9458,0,9478
test4sub58of100,test4pub10of100,100,193,11,9094,0,9105
test4sub58of100,test4pub11of100,100,193,10,8859,1,8870
test4sub58of100,test4pub12of100,100,193,11,8416,0,8427
test4sub8of100,test4pub33of100,100,193,11,4257,1,4269
test4sub4of100,test4pub28of100,100,193,10,5190,1,5201
test4sub4of100,test4pub29of100,100,193,11,5026,0,5037
test4sub4of100,test4pub30of100,100,193,15,4890,1,4906
test4sub4of100,test4pub31of100,100,193,10,4758,1,4769
test4sub4of100,test4pub32of100,100,193,11,4406,0,4417
test4sub4of100,test4pub33of100,100,193,11,4265,0,4276
test4sub66of100,test4pub33of100,100,193,11,4272,1,4284
test4sub60of100,test4pub33of100,100,193,11,4274,1,4286
test4sub95of100,test4pub33of100,100,193,11,4274,0,4285
test4sub91of100,test4pub34of100,100,193,12,3496,0,3508
test4sub82of100,test4pub31of100,100,193,10,4782,1,4793
test4sub46of100,test4pub31of100,100,193,10,4785,0,4795
test4sub90of100,test4pub33of100,100,193,11,4292,1,4304
test4sub62of100,test4pub29of100,100,193,11,5100,1,5112
test4sub62of100,test4pub30of100,100,193,15,4965,1,4981
test4sub12of100,test4pub34of100,100,193,12,3557,1,3570
test4sub62of100,test4pub31of100,100,193,10,4833,1,4844
test4sub62of100,test4pub32of100,100,193,11,4484,1,4496
test4sub62of100,test4pub33of100,100,193,11,4344,1,4356
test4sub23of100,test4pub33of100,100,193,11,4345,1,4357
test4sub42of100,test4pub29of100,100,193,11,5114,1,5126
test4sub42of100,test4pub30of100,100,193,15,4979,1,4995
test4sub42of100,test4pub31of100,100,193,10,4846,1,4857
test4sub42of100,test4pub32of100,100,193,11,4495,0,4506
test4sub42of100,test4pub33of100,100,193,11,4355,1,4367
test4sub44of100,test4pub34of100,100,193,12,3577,0,3589
test4sub27of100,test4pub1of100,100,12977,24,13453,44,13521
test4sub92of100,test4pub2of100,100,192,10,13431,33,13474
test4sub43of100,test4pub33of100,100,193,11,4382,28,4421
test4sub29of100,test4pub34of100,100,193,12,3620,9,3641
test4sub89of100,test4pub34of100,100,193,12,3624,5,3641
test4sub38of100,test4pub30of100,100,193,15,5035,6,5056
test4sub27of100,test4pub3of100,100,192,28,13366,3,13397
test4sub43of100,test4pub34of100,100,193,12,3630,6,3648
test4sub89of100,test4pub35of100,100,193,12,1276,5,1293
test4sub38of100,test4pub31of100,100,193,10,4908,3,4921
test4sub27of100,test4pub4of100,100,192,11,12025,4,12040
test4sub22of100,test4pub29of100,100,193,11,5181,4,5196
test4sub75of100,test4pub35of100,100,193,12,1279,3,1294
test4sub77of100,test4pub35of100,100,193,12,1280,4,1296
test4sub38of100,test4pub32of100,100,193,11,4560,3,4574
test4sub27of100,test4pub5of100,100,192,14,11032,4,11050
test4sub22of100,test4pub30of100,100,193,15,5048,4,5067
test4sub87of100,test4pub35of100,100,193,12,1285,2,1299
test4sub27of100,test4pub6of100,100,192,26,10712,1,10739
test4sub27of100,test4pub7of100,100,192,14,10081,1,10096
test4sub27of100,test4pub8of100,100,192,12,9818,0,9830
test4sub27of100,test4pub9of100,100,192,20,9634,0,9654
test4sub100of100,test4pub35of100,100,193,12,1338,1,1351
test4sub68of100,test4pub34of100,100,193,12,3706,1,3719
test4sub13of100,test4pub35of100,100,193,12,1352,1,1365
test4sub68of100,test4pub35of100,100,193,12,1353,1,1366
test4sub10of100,test4pub35of100,100,193,12,1397,1,1410
test4sub33of100,test4pub35of100,100,193,12,1398,1,1411
test4sub71of100,test4pub35of100,100,193,12,1408,1,1421
test4sub56of100,test4pub35of100,100,193,12,1419,1,1432
test4sub63of100,test4pub35of100,100,193,12,1423,1,1436
test4sub48of100,test4pub35of100,100,193,12,1426,0,1438
test4sub25of100,test4pub34of100,100,193,12,3789,1,3802
test4sub25of100,test4pub35of100,100,193,12,1435,1,1448
test4sub55of100,test4pub35of100,100,193,12,1447,1,1460
test4sub28of100,test4pub35of100,100,193,12,1448,1,1461
test4sub45of100,test4pub35of100,100,193,12,1450,1,1463
test4sub15of100,test4pub35of100,100,193,12,1453,1,1466
test4sub5of100,test4pub34of100,100,193,12,3809,0,3821
test4sub5of100,test4pub35of100,100,193,12,1455,0,1467
test4sub50of100,test4pub34of100,100,193,12,3814,0,3826
test4sub26of100,test4pub34of100,100,193,12,3815,1,3828
test4sub50of100,test4pub35of100,100,193,12,1461,1,1474
test4sub80of100,test4pub35of100,100,193,12,1465,1,1478
test4sub30of100,test4pub33of100,100,193,11,4601,1,4613
test4sub83of100,test4pub32of100,100,193,11,4745,1,4757
test4sub83of100,test4pub33of100,100,193,11,4604,0,4615
test4sub83of100,test4pub34of100,100,193,12,3826,1,3839
test4sub83of100,test4pub35of100,100,193,12,1473,1,1486
test4sub9of100,test4pub31of100,100,193,10,5125,1,5136
test4sub9of100,test4pub32of100,100,193,11,4773,0,4784
test4sub9of100,test4pub33of100,100,193,11,4633,1,4645
test4sub9of100,test4pub34of100,100,193,12,3857,1,3870
test4sub9of100,test4pub35of100,100,193,12,1503,0,1515
test4sub86of100,test4pub34of100,100,193,12,3870,0,3882
test4sub67of100,test4pub34of100,100,193,12,3871,2,3885
test4sub86of100,test4pub35of100,100,193,12,1517,1,1530
test4sub67of100,test4pub35of100,100,193,12,1518,0,1530
test4sub76of100,test4pub27of100,100,193,10,5689,1,5700
test4sub76of100,test4pub28of100,100,193,10,5588,1,5599
test4sub76of100,test4pub29of100,100,193,11,5424,1,5436
test4sub76of100,test4pub30of100,100,193,15,5288,0,5303
test4sub76of100,test4pub31of100,100,193,10,5156,1,5167
test4sub96of100,test4pub35of100,100,193,12,1526,1,1539
test4sub76of100,test4pub32of100,100,193,11,4804,2,4817
test4sub7of100,test4pub34of100,100,193,12,3886,1,3899
test4sub1of100,test4pub34of100,100,193,12,3889,1,3902
test4sub36of100,test4pub1of100,100,12977,24,13766,43,13833
test4sub66of100,test4pub34of100,100,193,12,3902,38,3952
test4sub82of100,test4pub32of100,100,193,11,4827,37,4875
test4sub90of100,test4pub34of100,100,193,12,3905,38,3955
test4sub27of100,test4pub10of100,100,193,11,9529,37,9577
test4sub8of100,test4pub34of100,100,193,12,3918,26,3956
test4sub54of100,test4pub29of100,100,193,11,5468,23,5502
test4sub38of100,test4pub33of100,100,193,11,4708,18,4737
test4sub66of100,test4pub35of100,100,193,12,1586,4,1602
test4sub82of100,test4pub33of100,100,193,11,4723,5,4739
test4sub36of100,test4pub4of100,100,192,11,12334,5,12350
test4sub90of100,test4pub35of100,100,193,12,1588,5,1605
test4sub27of100,test4pub11of100,100,193,10,9330,5,9345
test4sub8of100,test4pub35of100,100,193,12,1590,4,1606
test4sub54of100,test4pub30of100,100,193,15,5355,5,5375
test4sub38of100,test4pub34of100,100,193,12,3946,3,3961
test4sub36of100,test4pub5of100,100,192,14,11343,4,11361
test4sub27of100,test4pub12of100,100,193,11,8891,3,8905
test4sub54of100,test4pub31of100,100,193,10,5226,3,5239
test4sub38of100,test4pub35of100,100,193,12,1596,3,1611
test4sub36of100,test4pub6of100,100,192,26,11023,2,11051
test4sub54of100,test4pub32of100,100,193,11,4876,2,4889
test4sub60of100,test4pub34of100,100,193,12,3953,3,3968
test4sub54of100,test4pub33of100,100,193,11,4737,1,4749
test4sub36of100,test4pub7of100,100,192,14,10392,1,10407
test4sub60of100,test4pub35of100,100,193,12,1602,1,1615
test4sub36of100,test4pub8of100,100,192,12,10131,1,10144
test4sub77of100,test4pub36of100,100,193,10,336,1,347
test4sub75of100,test4pub36of100,100,193,10,341,1,352
test4sub71of100,test4pub36of100,100,193,10,344,1,355
test4sub63of100,test4pub36of100,100,193,10,345,2,357
test4sub25of100,test4pub36of100,100,193,10,345,2,357
test4sub28of100,test4pub36of100,100,193,10,346,2,358
test4sub45of100,test4pub36of100,100,193,10,347,1,358
test4sub80of100,test4pub36of100,100,193,10,355,0,365
test4sub30of100,test4pub34of100,100,193,12,3988,1,4001
test4sub30of100,test4pub35of100,100,193,12,1634,0,1646
test4sub30of100,test4pub36of100,100,193,10,367,0,377
test4sub83of100,test4pub36of100,100,193,10,378,0,388
test4sub39of100,test4pub28of100,100,193,10,5780,1,5791
test4sub86of100,test4pub36of100,100,193,10,437,1,448
test4sub39of100,test4pub29of100,100,193,11,5617,1,5629
test4sub39of100,test4pub30of100,100,193,15,5481,0,5496
test4sub67of100,test4pub36of100,100,193,10,442,0,452
test4sub39of100,test4pub31of100,100,193,10,5349,1,5360
test4sub39of100,test4pub32of100,100,193,11,4998,1,5010
test4sub39of100,test4pub33of100,100,193,11,4857,0,4868
test4sub39of100,test4pub34of100,100,193,12,4078,1,4091
test4sub39of100,test4pub35of100,100,193,12,1724,1,1737
test4sub76of100,test4pub33of100,100,193,11,4886,0,4897
test4sub76of100,test4pub34of100,100,193,12,4107,1,4120
test4sub73of100,test4pub24of100,100,193,19,6885,1,6905
test4sub73of100,test4pub23of100,100,193,11,7016,1,7028
test4sub76of100,test4pub35of100,100,193,12,1753,1,1766
test4sub76of100,test4pub36of100,100,193,10,479,0,489
test4sub96of100,test4pub36of100,100,193,10,481,0,491
test4sub7of100,test4pub35of100,100,193,12,1759,1,1772
test4sub7of100,test4pub36of100,100,193,10,484,0,494
test4sub1of100,test4pub35of100,100,193,12,1762,1,1775
test4sub1of100,test4pub36of100,100,193,10,487,0,497
test4sub36of100,test4pub9of100,100,192,20,10106,1,10127
test4sub36of100,test4pub10of100,100,193,11,9743,0,9754
test4sub36of100,test4pub11of100,100,193,10,9508,1,9519
test4sub36of100,test4pub12of100,100,193,11,9065,0,9076
test4sub66of100,test4pub36of100,100,193,10,493,1,504
test4sub90of100,test4pub36of100,100,193,10,494,1,505
test4sub36of100,test4pub13of100,100,193,10,8863,1,8874
test4sub36of100,test4pub14of100,100,193,10,8697,0,8707
test4sub36of100,test4pub15of100,100,193,11,8560,1,8572
test4sub36of100,test4pub16of100,100,193,10,8403,0,8413
test4sub36of100,test4pub17of100,100,193,11,8269,0,8280
test4sub36of100,test4pub18of100,100,193,18,8085,1,8104
test4sub36of100,test4pub19of100,100,193,11,7876,0,7887
test4sub8of100,test4pub36of100,100,193,10,511,0,521
test4sub54of100,test4pub34of100,100,193,12,4150,0,4162
test4sub54of100,test4pub35of100,100,193,12,1797,1,1810
test4sub34of100,test4pub23of100,100,193,11,7061,1,7073
test4sub54of100,test4pub36of100,100,193,10,522,2,534
test4sub34of100,test4pub24of100,100,193,19,6933,1,6953
test4sub34of100,test4pub25of100,100,193,16,6511,0,6527
test4sub34of100,test4pub26of100,100,193,10,6294,0,6304
test4sub34of100,test4pub27of100,100,193,10,5974,1,5985
test4sub34of100,test4pub28of100,100,193,10,5873,0,5883
test4sub34of100,test4pub29of100,100,193,11,5708,0,5719
test4sub34of100,test4pub30of100,100,193,15,5573,1,5589
test4sub34of100,test4pub31of100,100,193,10,5444,1,5455
test4sub34of100,test4pub32of100,100,193,11,5092,0,5103
test4sub34of100,test4pub33of100,100,193,11,4952,1,4964
test4sub34of100,test4pub34of100,100,193,12,4191,1,4204
test4sub34of100,test4pub35of100,100,193,12,1838,0,1850
test4sub38of100,test4pub36of100,100,193,10,567,0,577
test4sub60of100,test4pub36of100,100,193,10,569,1,580
test4sub37of100,test4pub2of100,100,192,10,14040,1,14051
test4sub42of100,test4pub34of100,100,193,12,4214,0,4226
test4sub42of100,test4pub35of100,100,193,12,1861,1,1874
test4sub42of100,test4pub36of100,100,193,10,586,0,596
test4sub75of100,test4pub37of100,100,193,23,229,1,253
test4sub39of100,test4pub36of100,100,193,10,591,0,601
test4sub63of100,test4pub37of100,100,193,23,232,1,256
test4sub30of100,test4pub37of100,100,193,23,236,1,260
test4sub71of100,test4pub37of100,100,193,23,237,1,261
test4sub25of100,test4pub37of100,100,193,23,242,1,266
test4sub45of100,test4pub37of100,100,193,23,243,0,266
test4sub67of100,test4pub37of100,100,193,23,248,1,272
test4sub80of100,test4pub37of100,100,193,23,249,1,273
test4sub77of100,test4pub37of100,100,193,23,248,2,273
test4sub76of100,test4pub37of100,100,193,23,250,1,274
test4sub73of100,test4pub25of100,100,193,16,6612,0,6628
test4sub73of100,test4pub26of100,100,193,10,6395,0,6405
test4sub73of100,test4pub27of100,100,193,10,6075,1,6086
test4sub73of100,test4pub28of100,100,193,10,5974,0,5984
test4sub86of100,test4pub37of100,100,193,23,270,1,294
test4sub73of100,test4pub29of100,100,193,11,5810,1,5822
test4sub28of100,test4pub37of100,100,193,23,276,1,300
test4sub96of100,test4pub37of100,100,193,23,277,1,301
test4sub7of100,test4pub37of100,100,193,23,279,1,303
test4sub36of100,test4pub20of100,100,193,10,7572,0,7582
test4sub36of100,test4pub21of100,100,193,10,7487,1,7498
test4sub36of100,test4pub22of100,100,193,10,7356,1,7367
test4sub36of100,test4pub23of100,100,193,11,7187,1,7199
test4sub36of100,test4pub24of100,100,193,19,7058,0,7077
test4sub66of100,test4pub37of100,100,193,23,315,0,338
test4sub90of100,test4pub37of100,100,193,23,319,1,343
test4sub27of100,test4pub13of100,100,193,10,9053,1,9064
test4sub27of100,test4pub14of100,100,193,10,8887,1,8898
test4sub27of100,test4pub15of100,100,193,11,8749,0,8760
test4sub8of100,test4pub37of100,100,193,23,333,2,358
test4sub54of100,test4pub37of100,100,193,23,334,1,358
test4sub34of100,test4pub36of100,100,193,10,703,0,713
test4sub34of100,test4pub37of100,100,193,23,344,1,368
test4sub38of100,test4pub37of100,100,193,23,345,1,369
test4sub60of100,test4pub37of100,100,193,23,346,1,370
test4sub59of100,test4pub33of100,100,193,11,5128,0,5139
test4sub59of100,test4pub34of100,100,193,12,4349,1,4362
test4sub59of100,test4pub35of100,100,193,12,2004,1,2017
test4sub59of100,test4pub36of100,100,193,10,729,0,739
test4sub59of100,test4pub37of100,100,193,23,370,1,394
test4sub42of100,test4pub37of100,100,193,23,373,1,397
test4sub39of100,test4pub37of100,100,193,23,375,1,399
test4sub73of100,test4pub30of100,100,193,15,5780,0,5795
test4sub73of100,test4pub31of100,100,193,10,5648,1,5659
test4sub73of100,test4pub32of100,100,193,11,5296,0,5307
test4sub73of100,test4pub33of100,100,193,11,5156,1,5168
test4sub73of100,test4pub34of100,100,193,12,4376,1,4389
test4sub73of100,test4pub35of100,100,193,12,2022,0,2034
test4sub73of100,test4pub36of100,100,193,10,748,1,759
test4sub73of100,test4pub37of100,100,193,23,388,1,412
test4sub9of100,test4pub36of100,100,193,10,759,1,770
test4sub9of100,test4pub37of100,100,193,23,399,1,423
test4sub36of100,test4pub25of100,100,193,16,6750,0,6766
test4sub36of100,test4pub26of100,100,193,10,6534,1,6545
test4sub36of100,test4pub27of100,100,193,10,6213,1,6224
test4sub36of100,test4pub28of100,100,193,10,6112,0,6122
test4sub36of100,test4pub29of100,100,193,11,5948,1,5960
test4sub36of100,test4pub30of100,100,193,15,5812,0,5827
test4sub36of100,test4pub31of100,100,193,10,5679,1,5690
test4sub66of100,test4pub38of100,100,193,31,152,1,184
test4sub36of100,test4pub32of100,100,193,11,5328,1,5340
test4sub77of100,test4pub38of100,100,193,31,154,0,185
test4sub36of100,test4pub33of100,100,193,11,5188,0,5199
test4sub36of100,test4pub34of100,100,193,12,4409,1,4422
test4sub36of100,test4pub35of100,100,193,12,2055,0,2067
test4sub36of100,test4pub36of100,100,193,10,780,0,790
test4sub36of100,test4pub37of100,100,193,23,421,1,445
test4sub90of100,test4pub38of100,100,193,31,165,1,197
test4sub27of100,test4pub16of100,100,193,10,8695,1,8706
test4sub27of100,test4pub17of100,100,193,11,8561,0,8572
test4sub27of100,test4pub18of100,100,193,18,8377,1,8396
test4sub27of100,test4pub19of100,100,193,11,8168,1,8180
test4sub27of100,test4pub20of100,100,193,10,7727,0,7737
test4sub27of100,test4pub21of100,100,193,10,7641,1,7652
test4sub28of100,test4pub38of100,100,193,31,177,1,209
test4sub27of100,test4pub22of100,100,193,10,7511,0,7521
test4sub27of100,test4pub24of100,100,193,19,7210,1,7230
test4sub27of100,test4pub23of100,100,193,11,7341,1,7353
test4sub27of100,test4pub25of100,100,193,16,6789,1,6806
test4sub75of100,test4pub38of100,100,193,31,184,0,215
test4sub27of100,test4pub26of100,100,193,10,6573,1,6584
test4sub27of100,test4pub27of100,100,193,10,6253,0,6263
test4sub27of100,test4pub28of100,100,193,10,6153,1,6164
test4sub27of100,test4pub29of100,100,193,11,5988,1,6000
test4sub86of100,test4pub38of100,100,193,31,192,1,224
test4sub30of100,test4pub38of100,100,193,31,194,1,226
test4sub25of100,test4pub38of100,100,193,31,197,0,228
test4sub7of100,test4pub38of100,100,193,31,203,1,235
test4sub96of100,test4pub38of100,100,193,31,203,1,235
test4sub38of100,test4pub38of100,100,193,31,205,1,237
test4sub60of100,test4pub38of100,100,193,31,208,1,240
test4sub54of100,test4pub38of100,100,193,31,214,1,246
test4sub34of100,test4pub38of100,100,193,31,220,0,251
test4sub76of100,test4pub38of100,100,193,31,232,2,265
test4sub59of100,test4pub38of100,100,193,31,233,42,306
test4sub42of100,test4pub38of100,100,193,31,235,41,307
test4sub37of100,test4pub1of100,100,12977,24,14354,43,14421
test4sub39of100,test4pub38of100,100,193,31,238,39,308
test4sub63of100,test4pub38of100,100,193,31,250,28,309
test4sub80of100,test4pub38of100,100,193,31,257,21,309
test4sub71of100,test4pub38of100,100,193,31,263,16,310
test4sub8of100,test4pub38of100,100,193,31,268,11,310
test4sub73of100,test4pub38of100,100,193,31,274,5,310
test4sub36of100,test4pub38of100,100,193,31,276,3,310
test4sub37of100,test4pub4of100,100,192,11,12923,3,12937
test4sub90of100,test4pub39of100,100,193,28,144,1,173
test4sub27of100,test4pub30of100,100,193,15,5958,1,5974
test4sub27of100,test4pub31of100,100,193,10,5826,1,5837
test4sub27of100,test4pub32of100,100,193,11,5487,1,5499
test4sub27of100,test4pub33of100,100,193,11,5346,1,5358
test4sub27of100,test4pub34of100,100,193,12,4567,1,4580
test4sub27of100,test4pub35of100,100,193,12,2213,0,2225
test4sub27of100,test4pub36of100,100,193,10,938,0,948
test4sub27of100,test4pub37of100,100,193,23,579,1,603
test4sub86of100,test4pub39of100,100,193,28,176,1,205
test4sub25of100,test4pub39of100,100,193,28,180,1,209
test4sub96of100,test4pub39of100,100,193,28,181,0,209
test4sub38of100,test4pub39of100,100,193,28,183,1,212
test4sub77of100,test4pub39of100,100,193,28,187,1,216
test4sub30of100,test4pub39of100,100,193,28,188,0,216
test4sub60of100,test4pub39of100,100,193,28,201,1,230
test4sub28of100,test4pub39of100,100,193,28,205,1,234
test4sub66of100,test4pub39of100,100,193,28,220,0,248
test4sub75of100,test4pub39of100,100,193,28,224,1,253
test4sub54of100,test4pub39of100,100,193,28,228,0,256
test4sub34of100,test4pub39of100,100,193,28,233,1,262
test4sub37of100,test4pub5of100,100,192,14,12030,0,12044
test4sub37of100,test4pub6of100,100,192,26,11708,1,11735
test4sub37of100,test4pub7of100,100,192,14,11075,1,11090
test4sub7of100,test4pub39of100,100,193,28,239,1,268
test4sub37of100,test4pub8of100,100,192,12,10812,1,10825
test4sub83of100,test4pub37of100,100,193,23,649,1,673
test4sub37of100,test4pub9of100,100,192,20,10630,1,10651
test4sub83of100,test4pub38of100,100,193,31,391,1,423
test4sub76of100,test4pub39of100,100,193,28,244,1,273
test4sub37of100,test4pub10of100,100,193,11,10269,1,10281
test4sub59of100,test4pub39of100,100,193,28,246,1,275
test4sub80of100,test4pub39of100,100,193,28,247,1,276
test4sub71of100,test4pub39of100,100,193,28,248,1,277
test4sub8of100,test4pub39of100,100,193,28,249,1,278
test4sub37of100,test4pub11of100,100,193,10,10033,0,10043
test4sub37of100,test4pub12of100,100,193,11,9594,1,9606
test4sub37of100,test4pub13of100,100,193,10,9391,0,9401
test4sub37of100,test4pub14of100,100,193,10,9224,1,9235
test4sub37of100,test4pub15of100,100,193,11,9087,1,9099
test4sub27of100,test4pub38of100,100,193,31,410,0,441
test4sub27of100,test4pub39of100,100,193,28,263,1,292
test4sub92of100,test4pub1of100,100,12977,24,14544,41,14609
test4sub86of100,test4pub40of100,100,193,49,110,26,185
test4sub96of100,test4pub40of100,100,193,49,115,22,186
test4sub54of100,test4pub40of100,100,193,49,121,15,185
test4sub37of100,test4pub16of100,100,193,10,8977,15,9002
test4sub7of100,test4pub40of100,100,193,49,128,9,186
test4sub83of100,test4pub39of100,100,193,28,312,7,347
test4sub92of100,test4pub3of100,100,192,28,14455,2,14485
test4sub37of100,test4pub17of100,100,193,11,8857,2,8870
test4sub37of100,test4pub18of100,100,193,18,8674,1,8693
test4sub92of100,test4pub4of100,100,192,11,13114,2,13127
test4sub37of100,test4pub19of100,100,193,11,8465,1,8477
test4sub92of100,test4pub5of100,100,192,14,12118,1,12133
test4sub37of100,test4pub20of100,100,193,10,8025,0,8035
test4sub76of100,test4pub40of100,100,193,49,145,3,197
test4sub92of100,test4pub6of100,100,192,26,11796,4,11826
test4sub59of100,test4pub40of100,100,193,49,146,2,197
test4sub37of100,test4pub21of100,100,193,10,7940,3,7953
test4sub80of100,test4pub40of100,100,193,49,148,3,200
test4sub92of100,test4pub7of100,100,192,14,11167,2,11183
test4sub37of100,test4pub22of100,100,193,10,7812,1,7823
test4sub37of100,test4pub23of100,100,193,11,7641,0,7652
test4sub92of100,test4pub8of100,100,192,12,10906,1,10919
test4sub92of100,test4pub9of100,100,192,20,10723,1,10744
test4sub37of100,test4pub24of100,100,193,19,7513,1,7533
test4sub92of100,test4pub10of100,100,193,11,10359,1,10371
test4sub37of100,test4pub25of100,100,193,16,7092,1,7109
test4sub92of100,test4pub11of100,100,193,10,10124,0,10134
test4sub37of100,test4pub26of100,100,193,10,6875,1,6886
test4sub92of100,test4pub12of100,100,193,11,9682,3,9696
test4sub70of100,test4pub22of100,100,193,10,7822,1,7833
test4sub70of100,test4pub23of100,100,193,11,7651,1,7663
test4sub92of100,test4pub13of100,100,193,10,9481,1,9492
test4sub70of100,test4pub24of100,100,193,19,7523,1,7543
test4sub92of100,test4pub14of100,100,193,10,9315,1,9326
test4sub92of100,test4pub15of100,100,193,11,9178,1,9190
test4sub70of100,test4pub25of100,100,193,16,7101,1,7118
test4sub70of100,test4pub26of100,100,193,10,6885,1,6896
test4sub92of100,test4pub16of100,100,193,10,9021,1,9032
test4sub70of100,test4pub27of100,100,193,10,6565,0,6575
test4sub92of100,test4pub17of100,100,193,11,8888,1,8900
test4sub70of100,test4pub28of100,100,193,10,6465,1,6476
test4sub92of100,test4pub18of100,100,193,18,8704,1,8723
test4sub70of100,test4pub29of100,100,193,11,6300,1,6312
test4sub70of100,test4pub30of100,100,193,15,6165,1,6181
test4sub70of100,test4pub31of100,100,193,10,6032,0,6042
test4sub27of100,test4pub40of100,100,193,49,177,0,226
test4sub70of100,test4pub32of100,100,193,11,5681,1,5693
test4sub70of100,test4pub33of100,100,193,11,5541,0,5552
test4sub70of100,test4pub34of100,100,193,12,4761,1,4774
test4sub70of100,test4pub35of100,100,193,12,2408,1,2421
test4sub28of100,test4pub40of100,100,193,49,183,0,232
test4sub70of100,test4pub36of100,100,193,10,1133,1,1144
test4sub70of100,test4pub37of100,100,193,23,774,0,797
test4sub70of100,test4pub38of100,100,193,31,515,1,547
test4sub34of100,test4pub40of100,100,193,49,187,1,237
test4sub70of100,test4pub39of100,100,193,28,368,0,396
test4sub92of100,test4pub19of100,100,193,11,8513,0,8524
test4sub92of100,test4pub20of100,100,193,10,8073,1,8084
test4sub92of100,test4pub21of100,100,193,10,7987,1,7998
test4sub92of100,test4pub22of100,100,193,10,7856,0,7866
test4sub92of100,test4pub23of100,100,193,11,7685,1,7697
test4sub92of100,test4pub24of100,100,193,19,7562,0,7581
test4sub92of100,test4pub25of100,100,193,16,7141,1,7158
test4sub92of100,test4pub26of100,100,193,10,6924,0,6934
test4sub8of100,test4pub40of100,100,193,49,209,1,259
test4sub66of100,test4pub40of100,100,193,49,211,11,271
test4sub90of100,test4pub40of100,100,193,49,210,13,272
test4sub71of100,test4pub40of100,100,193,49,221,1,271
test4sub75of100,test4pub40of100,100,193,49,211,12,272
test4sub25of100,test4pub40of100,100,193,49,221,4,274
test4sub60of100,test4pub40of100,100,193,49,222,4,275
test4sub99of100,test4pub76of100,10,192,10,27749,1,27760
test4sub99of100,test4pub77of100,10,192,10,27290,0,27300
test4sub37of100,test4pub27of100,100,193,10,6630,1,6641
test4sub37of100,test4pub28of100,100,193,10,6530,1,6541
test4sub37of100,test4pub29of100,100,193,11,6365,0,6376
test4sub37of100,test4pub30of100,100,193,15,6230,1,6246
test4sub37of100,test4pub31of100,100,193,10,6097,1,6108
test4sub83of100,test4pub40of100,100,193,49,240,1,290
test4sub37of100,test4pub32of100,100,193,11,5746,1,5758
test4sub37of100,test4pub33of100,100,193,11,5606,1,5618
test4sub37of100,test4pub34of100,100,193,12,4826,0,4838
test4sub37of100,test4pub35of100,100,193,12,2473,1,2486
test4sub37of100,test4pub36of100,100,193,10,1198,1,1209
test4sub37of100,test4pub37of100,100,193,23,838,0,861
test4sub37of100,test4pub38of100,100,193,31,579,0,610
test4sub73of100,test4pub39of100,100,193,28,432,1,461
test4sub37of100,test4pub39of100,100,193,28,432,2,462
test4sub73of100,test4pub40of100,100,193,49,254,1,304
test4sub37of100,test4pub40of100,100,193,49,254,1,304
test4sub7of100,test4pub41of100,100,193,27,135,1,163
test4sub54of100,test4pub41of100,100,193,27,136,1,164
test4sub70of100,test4pub40of100,100,193,49,265,1,315
test4sub36of100,test4pub39of100,100,193,28,450,1,479
test4sub36of100,test4pub40of100,100,193,49,271,1,321
test4sub28of100,test4pub41of100,100,193,27,146,1,174
test4sub34of100,test4pub41of100,100,193,27,147,1,175
test4sub92of100,test4pub27of100,100,193,10,6686,1,6697
test4sub92of100,test4pub28of100,100,193,10,6585,0,6595
test4sub92of100,test4pub29of100,100,193,11,6421,1,6433
test4sub92of100,test4pub30of100,100,193,15,6287,1,6303
test4sub92of100,test4pub31of100,100,193,10,6154,0,6164
test4sub92of100,test4pub32of100,100,193,11,5809,0,5820
test4sub92of100,test4pub33of100,100,193,11,5669,1,5681
test4sub92of100,test4pub34of100,100,193,12,4889,0,4901
test4sub76of100,test4pub41of100,100,193,27,195,0,222
test4sub86of100,test4pub41of100,100,193,27,198,1,226
test4sub90of100,test4pub41of100,100,193,27,202,1,230
test4sub66of100,test4pub41of100,100,193,27,203,1,231
test4sub75of100,test4pub41of100,100,193,27,208,2,237
test4sub60of100,test4pub41of100,100,193,27,209,1,237
test4sub25of100,test4pub41of100,100,193,27,211,1,239
test4sub8of100,test4pub41of100,100,193,27,211,1,239
test4sub71of100,test4pub41of100,100,193,27,214,1,242
test4sub80of100,test4pub41of100,100,193,27,224,1,252
test4sub96of100,test4pub41of100,100,193,27,229,1,257
test4sub27of100,test4pub41of100,100,193,27,240,1,268
test4sub83of100,test4pub41of100,100,193,27,248,1,276
test4sub37of100,test4pub41of100,100,193,27,249,0,276
test4sub73of100,test4pub41of100,100,193,27,250,1,278
test4sub22of100,test4pub31of100,100,193,10,6236,1,6247
test4sub22of100,test4pub32of100,100,193,11,5884,0,5895
test4sub70of100,test4pub41of100,100,193,27,255,1,283
test4sub22of100,test4pub33of100,100,193,11,5744,1,5756
test4sub22of100,test4pub34of100,100,193,12,4964,1,4977
test4sub38of100,test4pub40of100,100,193,49,384,1,434
test4sub22of100,test4pub35of100,100,193,12,2611,0,2623
test4sub38of100,test4pub41of100,100,193,27,259,1,287
test4sub22of100,test4pub36of100,100,193,10,1337,1,1348
test4sub22of100,test4pub37of100,100,193,23,977,0,1000
test4sub22of100,test4pub38of100,100,193,31,719,1,751
test4sub36of100,test4pub41of100,100,193,27,263,1,291
test4sub22of100,test4pub39of100,100,193,28,571,0,599
test4sub22of100,test4pub40of100,100,193,49,393,1,443
test4sub92of100,test4pub35of100,100,193,12,2645,0,2657
test4sub92of100,test4pub36of100,100,193,10,1371,1,1382
test4sub92of100,test4pub37of100,100,193,23,1011,1,1035
test4sub92of100,test4pub38of100,100,193,31,754,1,786
test4sub92of100,test4pub39of100,100,193,28,606,1,635
test4sub92of100,test4pub40of100,100,193,49,428,1,478
test4sub34of100,test4pub42of100,100,193,31,159,0,190
test4sub92of100,test4pub41of100,100,193,27,303,1,331
test4sub92of100,test4pub42of100,100,193,31,161,1,193
test4sub7of100,test4pub42of100,100,193,31,178,1,210
test4sub28of100,test4pub42of100,100,193,31,182,0,213
test4sub76of100,test4pub42of100,100,193,31,184,0,215
test4sub86of100,test4pub42of100,100,193,31,186,1,218
test4sub90of100,test4pub42of100,100,193,31,190,1,222
test4sub66of100,test4pub42of100,100,193,31,191,0,222
test4sub8of100,test4pub42of100,100,193,31,193,0,224
test4sub54of100,test4pub42of100,100,193,31,197,1,229
test4sub60of100,test4pub42of100,100,193,31,206,0,237
test4sub30of100,test4pub40of100,100,193,49,478,1,528
test4sub30of100,test4pub41of100,100,193,27,353,1,381
test4sub25of100,test4pub42of100,100,193,31,210,1,242
test4sub71of100,test4pub42of100,100,193,31,223,0,254
test4sub23of100,test4pub34of100,100,193,12,5078,1,5091
test4sub23of100,test4pub35of100,100,193,12,2725,0,2737
test4sub75of100,test4pub42of100,100,193,31,229,1,261
test4sub77of100,test4pub40of100,100,193,49,512,1,562
test4sub77of100,test4pub41of100,100,193,27,388,1,416
test4sub80of100,test4pub42of100,100,193,31,246,1,278
test4sub96of100,test4pub42of100,100,193,31,258,1,290
test4sub51of100,test4pub33of100,100,193,11,5894,1,5906
test4sub27of100,test4pub42of100,100,193,31,264,2,297
test4sub51of100,test4pub34of100,100,193,12,5116,2,5130
test4sub51of100,test4pub35of100,100,193,12,2763,1,2776
test4sub51of100,test4pub36of100,100,193,10,1488,1,1499
test4sub51of100,test4pub37of100,100,193,23,1129,1,1153
test4sub51of100,test4pub38of100,100,193,31,870,1,902
test4sub51of100,test4pub39of100,100,193,28,723,0,751
test4sub51of100,test4pub40of100,100,193,49,545,1,595
test4sub99of100,test4pub78of100,10,192,12,27555,0,27567
test4sub83of100,test4pub42of100,100,193,31,298,1,330
test4sub99of100,test4pub79of100,10,191,9,27478,1,27488
test4sub99of100,test4pub80of100,10,192,10,27080,1,27091
test4sub99of100,test4pub81of100,10,192,17,26966,1,26984
test4sub99of100,test4pub82of100,10,192,10,26812,0,26822
test4sub99of100,test4pub83of100,10,192,10,26663,0,26673
test4sub37of100,test4pub42of100,100,193,31,311,0,342
test4sub37of100,test4pub43of100,100,193,28,171,0,199
test4sub73of100,test4pub42of100,100,193,31,316,1,348
test4sub22of100,test4pub41of100,100,193,27,463,1,491
test4sub22of100,test4pub42of100,100,193,31,320,0,351
test4sub70of100,test4pub42of100,100,193,31,322,0,353
test4sub38of100,test4pub42of100,100,193,31,322,1,354
test4sub36of100,test4pub42of100,100,193,31,325,0,356
test4sub36of100,test4pub43of100,100,193,28,186,1,215
test4sub92of100,test4pub43of100,100,193,28,191,1,220
test4sub7of100,test4pub43of100,100,193,28,191,1,220
test4sub66of100,test4pub43of100,100,193,28,198,0,226
test4sub90of100,test4pub43of100,100,193,28,202,1,231
test4sub8of100,test4pub43of100,100,193,28,204,1,233
test4sub85of100,test4pub33of100,100,193,11,5983,0,5994
test4sub54of100,test4pub43of100,100,193,28,211,2,241
test4sub85of100,test4pub34of100,100,193,12,5204,1,5217
test4sub85of100,test4pub35of100,100,193,12,2850,1,2863
test4sub71of100,test4pub43of100,100,193,28,215,1,244
test4sub85of100,test4pub36of100,100,193,10,1576,1,1587
test4sub34of100,test4pub43of100,100,193,28,219,1,248
test4sub60of100,test4pub43of100,100,193,28,219,1,248
test4sub96of100,test4pub43of100,100,193,28,226,1,255
test4sub51of100,test4pub41of100,100,193,27,513,1,541
test4sub27of100,test4pub43of100,100,193,28,228,1,257
test4sub51of100,test4pub42of100,100,193,31,371,1,403
test4sub51of100,test4pub43of100,100,193,28,231,0,259
test4sub83of100,test4pub43of100,100,193,28,261,1,290
test4sub73of100,test4pub43of100,100,193,28,263,0,291
test4sub22of100,test4pub43of100,100,193,28,265,1,294
test4sub70of100,test4pub43of100,100,193,28,265,1,294
test4sub38of100,test4pub43of100,100,193,28,276,0,304
test4sub98of100,test4pub1of100,100,12977,24,15152,45,15221
test4sub98of100,test4pub4of100,100,192,11,13721,1,13733
test4sub98of100,test4pub5of100,100,192,14,12725,1,12740
test4sub98of100,test4pub6of100,100,192,26,12402,0,12428
test4sub98of100,test4pub7of100,100,192,14,11770,1,11785
test4sub90of100,test4pub44of100,100,193,17,275,0,292
test4sub54of100,test4pub44of100,100,193,17,288,1,306
test4sub71of100,test4pub44of100,100,193,17,292,0,309
test4sub51of100,test4pub44of100,100,193,17,294,1,312
test4sub96of100,test4pub44of100,100,193,17,306,1,324
test4sub27of100,test4pub44of100,100,193,17,316,1,334
test4sub8of100,test4pub44of100,100,193,17,317,0,334
test4sub36of100,test4pub44of100,100,193,17,322,0,339
test4sub66of100,test4pub44of100,100,193,17,338,0,355
test4sub92of100,test4pub44of100,100,193,17,346,1,364
test4sub83of100,test4pub44of100,100,193,17,425,1,443
test4sub73of100,test4pub44of100,100,193,17,431,1,449
test4sub22of100,test4pub44of100,100,193,17,446,0,463
test4sub37of100,test4pub44of100,100,193,17,451,1,469
test4sub70of100,test4pub44of100,100,193,17,453,1,471
test4sub7of100,test4pub44of100,100,193,17,457,0,474
test4sub4of100,test4pub34of100,100,193,12,5599,1,5612
test4sub4of100,test4pub35of100,100,193,12,3245,0,3257
test4sub4of100,test4pub36of100,100,193,10,1970,1,1981
test4sub4of100,test4pub37of100,100,193,23,1611,1,1635
test4sub38of100,test4pub44of100,100,193,17,463,0,480
test4sub4of100,test4pub38of100,100,193,31,1352,0,1383
test4sub98of100,test4pub8of100,100,192,12,11779,1,11792
test4sub4of100,test4pub39of100,100,193,28,1205,1,1234
test4sub98of100,test4pub9of100,100,192,20,11596,0,11616
test4sub4of100,test4pub40of100,100,193,49,1027,0,1076
test4sub4of100,test4pub41of100,100,193,27,903,1,931
test4sub4of100,test4pub42of100,100,193,31,760,0,791
test4sub4of100,test4pub43of100,100,193,28,620,0,648
test4sub60of100,test4pub44of100,100,193,17,508,0,525
test4sub98of100,test4pub10of100,100,193,11,11273,1,11285
test4sub98of100,test4pub11of100,100,193,10,11038,1,11049
test4sub98of100,test4pub12of100,100,193,11,10595,0,10606
test4sub98of100,test4pub13of100,100,193,10,10396,1,10407
test4sub98of100,test4pub14of100,100,193,10,10229,1,10240
test4sub98of100,test4pub15of100,100,193,11,10091,1,10103
test4sub34of100,test4pub45of100,100,193,20,391,1,412
test4sub25of100,test4pub43of100,100,193,28,696,0,724
test4sub25of100,test4pub44of100,100,193,17,550,1,568
test4sub28of100,test4pub43of100,100,193,28,699,1,728
test4sub28of100,test4pub44of100,100,193,17,553,1,571
test4sub86of100,test4pub43of100,100,193,28,705,1,734
test4sub86of100,test4pub44of100,100,193,17,558,1,576
test4sub76of100,test4pub43of100,100,193,28,710,0,738
test4sub80of100,test4pub43of100,100,193,28,711,1,740
test4sub76of100,test4pub44of100,100,193,17,564,1,582
test4sub80of100,test4pub44of100,100,193,17,565,0,582
test4sub75of100,test4pub43of100,100,193,28,718,1,747
test4sub75of100,test4pub44of100,100,193,17,571,0,588
test4sub77of100,test4pub42of100,100,193,31,869,1,901
test4sub77of100,test4pub43of100,100,193,28,729,0,757
test4sub3of100,test4pub35of100,100,193,12,3366,2,3380
test4sub71of100,test4pub45of100,100,193,20,453,2,475
test4sub77of100,test4pub44of100,100,193,17,583,2,602
test4sub3of100,test4pub36of100,100,193,10,2093,0,2103
test4sub3of100,test4pub37of100,100,193,23,1734,1,1758
test4sub3of100,test4pub38of100,100,193,31,1475,1,1507
test4sub3of100,test4pub39of100,100,193,28,1327,2,1357
test4sub47of100,test4pub35of100,100,193,12,3374,2,3388
test4sub36of100,test4pub45of100,100,193,20,461,2,483
test4sub3of100,test4pub40of100,100,193,49,1150,1,1200
test4sub47of100,test4pub36of100,100,193,10,2100,1,2111
test4sub47of100,test4pub37of100,100,193,23,1741,1,1765
test4sub3of100,test4pub41of100,100,193,27,1026,1,1054
test4sub3of100,test4pub42of100,100,193,31,884,0,915
test4sub47of100,test4pub38of100,100,193,31,1483,2,1516
test4sub3of100,test4pub43of100,100,193,28,745,1,774
test4sub47of100,test4pub39of100,100,193,28,1336,1,1365
test4sub47of100,test4pub40of100,100,193,49,1158,1,1208
test4sub47of100,test4pub41of100,100,193,27,1033,1,1061
test4sub43of100,test4pub35of100,100,193,12,3386,1,3399
test4sub66of100,test4pub45of100,100,193,20,472,1,493
test4sub43of100,test4pub36of100,100,193,10,2112,1,2123
test4sub47of100,test4pub42of100,100,193,31,892,1,924
test4sub43of100,test4pub37of100,100,193,23,1753,1,1777
test4sub47of100,test4pub43of100,100,193,28,753,1,782
test4sub43of100,test4pub38of100,100,193,31,1494,1,1526
test4sub43of100,test4pub39of100,100,193,28,1347,1,1376
test4sub43of100,test4pub40of100,100,193,49,1168,0,1217
test4sub92of100,test4pub45of100,100,193,20,480,1,501
test4sub43of100,test4pub41of100,100,193,27,1044,1,1072
test4sub43of100,test4pub42of100,100,193,31,901,0,932
test4sub43of100,test4pub43of100,100,193,28,761,0,789
test4sub73of100,test4pub45of100,100,193,20,486,1,507
test4sub44of100,test4pub35of100,100,193,12,3402,1,3415
test4sub44of100,test4pub36of100,100,193,10,2128,1,2139
test4sub44of100,test4pub37of100,100,193,23,1768,0,1791
test4sub44of100,test4pub38of100,100,193,31,1510,1,1542
test4sub44of100,test4pub39of100,100,193,28,1362,1,1391
test4sub29of100,test4pub35of100,100,193,12,3409,1,3422
test4sub44of100,test4pub40of100,100,193,49,1184,1,1234
test4sub29of100,test4pub36of100,100,193,10,2134,1,2145
test4sub37of100,test4pub45of100,100,193,20,497,4,521
test4sub29of100,test4pub37of100,100,193,23,1775,3,1801
test4sub44of100,test4pub41of100,100,193,27,1060,6,1093
test4sub6of100,test4pub1of100,100,12977,24,15639,43,15706
test4sub29of100,test4pub38of100,100,193,31,1520,44,1595
test4sub44of100,test4pub42of100,100,193,31,924,42,997
test4sub48of100,test4pub36of100,100,193,10,2154,36,2200
test4sub60of100,test4pub45of100,100,193,20,521,31,572
test4sub55of100,test4pub36of100,100,193,10,2161,29,2200
test4sub62of100,test4pub34of100,100,193,12,5794,30,5836
test4sub98of100,test4pub16of100,100,193,10,10069,28,10107
test4sub15of100,test4pub36of100,100,193,10,2176,18,2204
test4sub89of100,test4pub36of100,100,193,10,2176,18,2204
test4sub25of100,test4pub45of100,100,193,20,540,18,578
test4sub28of100,test4pub45of100,100,193,20,540,17,577
test4sub86of100,test4pub45of100,100,193,20,541,17,578
test4sub76of100,test4pub45of100,100,193,20,543,16,579
test4sub80of100,test4pub45of100,100,193,20,544,15,579
test4sub87of100,test4pub36of100,100,193,10,2183,15,2208
test4sub75of100,test4pub45of100,100,193,20,545,14,579
test4sub6of100,test4pub2of100,100,192,10,15649,15,15674
test4sub33of100,test4pub36of100,100,193,10,2185,15,2210
test4sub29of100,test4pub39of100,100,193,28,1415,14,1457
test4sub30of100,test4pub42of100,100,193,31,966,16,1013
test4sub44of100,test4pub43of100,100,193,28,826,16,870
test4sub50of100,test4pub36of100,100,193,10,2188,16,2214
test4sub100of100,test4pub36of100,100,193,10,2188,16,2214
test4sub48of100,test4pub37of100,100,193,23,1829,15,1867
test4sub55of100,test4pub37of100,100,193,23,1830,15,1868
test4sub77of100,test4pub45of100,100,193,20,553,15,588
test4sub13of100,test4pub36of100,100,193,10,2192,16,2218
test4sub62of100,test4pub35of100,100,193,12,3469,14,3495
test4sub98of100,test4pub17of100,100,193,11,9962,16,9989
test4sub89of100,test4pub37of100,100,193,23,1834,15,1872
test4sub15of100,test4pub37of100,100,193,23,1834,17,1874
test4sub87of100,test4pub37of100,100,193,23,1837,13,1873
test4sub6of100,test4pub3of100,100,192,28,15568,13,15609
test4sub33of100,test4pub37of100,100,193,23,1840,12,1875
test4sub29of100,test4pub40of100,100,193,49,1251,14,1314
test4sub3of100,test4pub44of100,100,193,17,692,13,722
test4sub47of100,test4pub44of100,100,193,17,693,13,723
test4sub30of100,test4pub43of100,100,193,28,843,13,884
test4sub50of100,test4pub37of100,100,193,23,1844,13,1880
test4sub43of100,test4pub44of100,100,193,17,697,11,725
test4sub55of100,test4pub38of100,100,193,31,1585,13,1629
test4sub48of100,test4pub38of100,100,193,31,1585,13,1629
test4sub13of100,test4pub37of100,100,193,23,1847,12,1882
test4sub62of100,test4pub36of100,100,193,10,2209,13,2232
test4sub89of100,test4pub38of100,100,193,31,1589,12,1632
test4sub98of100,test4pub18of100,100,193,18,9793,12,9823
test4sub87of100,test4pub38of100,100,193,31,1591,13,1635
test4sub15of100,test4pub38of100,100,193,31,1591,13,1635
test4sub6of100,test4pub4of100,100,192,11,14237,12,14260
test4sub33of100,test4pub38of100,100,193,31,1593,13,1637
test4sub29of100,test4pub41of100,100,193,27,1139,12,1178
test4sub3of100,test4pub45of100,100,193,20,577,14,611
test4sub47of100,test4pub45of100,100,193,20,579,13,612
test4sub30of100,test4pub44of100,100,193,17,708,13,738
test4sub50of100,test4pub38of100,100,193,31,1597,12,1640
test4sub43of100,test4pub45of100,100,193,20,581,13,614
test4sub55of100,test4pub39of100,100,193,28,1450,12,1490
test4sub48of100,test4pub39of100,100,193,28,1450,13,1491
test4sub13of100,test4pub38of100,100,193,31,1601,13,1645
test4sub62of100,test4pub37of100,100,193,23,1861,14,1898
test4sub89of100,test4pub39of100,100,193,28,1453,13,1494
test4sub98of100,test4pub19of100,100,193,11,9597,14,9622
test4sub87of100,test4pub39of100,100,193,28,1455,13,1496
test4sub15of100,test4pub39of100,100,193,28,1455,14,1497
test4sub6of100,test4pub5of100,100,192,14,13253,13,13280
test4sub33of100,test4pub39of100,100,193,28,1457,15,1500
test4sub26of100,test4pub35of100,100,193,12,3504,13,3529
test4sub29of100,test4pub42of100,100,193,31,1009,15,1055
test4sub30of100,test4pub45of100,100,193,20,593,13,626
test4sub50of100,test4pub39of100,100,193,28,1461,13,1502
test4sub55of100,test4pub40of100,100,193,49,1283,12,1344
test4sub58of100,test4pub13of100,100,193,10,10602,14,10626
test4sub48of100,test4pub40of100,100,193,49,1285,12,1346
test4sub13of100,test4pub39of100,100,193,28,1465,12,1505
test4sub62of100,test4pub38of100,100,193,31,1616,12,1659
test4sub89of100,test4pub40of100,100,193,49,1287,13,1349
test4sub98of100,test4pub20of100,100,193,10,9170,11,9191
test4sub87of100,test4pub40of100,100,193,49,1289,13,1351
test4sub6of100,test4pub6of100,100,192,26,12943,11,12980
test4sub15of100,test4pub40of100,100,193,49,1290,13,1352
test4sub33of100,test4pub40of100,100,193,49,1292,11,1352
test4sub26of100,test4pub36of100,100,193,10,2242,13,2265
test4sub29of100,test4pub43of100,100,193,28,883,12,923
test4sub50of100,test4pub40of100,100,193,49,1295,13,1357
test4sub55of100,test4pub41of100,100,193,27,1169,12,1208
test4sub58of100,test4pub14of100,100,193,10,10448,11,10469
test4sub48of100,test4pub41of100,100,193,27,1171,12,1210
test4sub13of100,test4pub40of100,100,193,49,1299,12,1360
test4sub62of100,test4pub39of100,100,193,28,1479,12,1519
test4sub89of100,test4pub41of100,100,193,27,1174,12,1213
test4sub98of100,test4pub21of100,100,193,10,9095,12,9117
test4sub87of100,test4pub41of100,100,193,27,1176,11,1214
test4sub6of100,test4pub7of100,100,192,14,12321,12,12347
test4sub33of100,test4pub41of100,100,193,27,1179,11,1217
test4sub15of100,test4pub41of100,100,193,27,1179,12,1218
test4sub26of100,test4pub37of100,100,193,23,1895,11,1929
test4sub29of100,test4pub44of100,100,193,17,748,11,776
test4sub50of100,test4pub41of100,100,193,27,1182,12,1221
test4sub55of100,test4pub42of100,100,193,31,1038,11,1080
test4sub58of100,test4pub15of100,100,193,11,10321,12,10344
test4sub48of100,test4pub42of100,100,193,31,1040,11,1082
test4sub13of100,test4pub41of100,100,193,27,1185,11,1223
test4sub62of100,test4pub40of100,100,193,49,1312,12,1373
test4sub89of100,test4pub42of100,100,193,31,1043,11,1085
test4sub98of100,test4pub22of100,100,193,10,8975,11,8996
test4sub87of100,test4pub42of100,100,193,31,1045,12,1088
test4sub6of100,test4pub8of100,100,192,12,12069,11,12092
test4sub33of100,test4pub42of100,100,193,31,1046,12,1089
test4sub15of100,test4pub42of100,100,193,31,1047,11,1089
test4sub26of100,test4pub38of100,100,193,31,1647,11,1689
test4sub29of100,test4pub45of100,100,193,20,631,11,662
test4sub50of100,test4pub42of100,100,193,31,1050,10,1091
test4sub55of100,test4pub43of100,100,193,28,910,12,950
test4sub58of100,test4pub16of100,100,193,10,10176,10,10196
test4sub48of100,test4pub43of100,100,193,28,911,11,950
test4sub13of100,test4pub42of100,100,193,31,1054,11,1096
test4sub62of100,test4pub41of100,100,193,27,1198,13,1238
test4sub98of100,test4pub23of100,100,193,11,8815,11,8837
test4sub89of100,test4pub43of100,100,193,28,914,12,954
test4sub87of100,test4pub43of100,100,193,28,916,11,955
test4sub6of100,test4pub9of100,100,192,20,11897,12,11929
test4sub33of100,test4pub43of100,100,193,28,918,11,957
test4sub15of100,test4pub43of100,100,193,28,918,12,958
test4sub26of100,test4pub39of100,100,193,28,1510,11,1549
test4sub50of100,test4pub43of100,100,193,28,920,12,960
test4sub55of100,test4pub44of100,100,193,17,774,10,801
test4sub58of100,test4pub17of100,100,193,11,10052,12,10075
test4sub48of100,test4pub44of100,100,193,17,776,11,804
test4sub13of100,test4pub43of100,100,193,28,924,12,964
test4sub62of100,test4pub42of100,100,193,31,1067,10,1108
test4sub98of100,test4pub24of100,100,193,19,8696,12,8727
test4sub87of100,test4pub44of100,100,193,17,780,11,808
test4sub89of100,test4pub44of100,100,193,17,780,13,810
test4sub6of100,test4pub10of100,100,193,11,11544,11,11566
test4sub33of100,test4pub44of100,100,193,17,782,12,811
test4sub15of100,test4pub45of100,100,193,20,654,12,686
test4sub26of100,test4pub40of100,100,193,49,1343,12,1404
test4sub50of100,test4pub44of100,100,193,17,786,12,815
test4sub55of100,test4pub45of100,100,193,20,657,12,689
test4sub58of100,test4pub18of100,100,193,18,9879,11,9908
test4sub48of100,test4pub45of100,100,193,20,659,11,690
test4sub13of100,test4pub44of100,100,193,17,789,10,816
test4sub62of100,test4pub43of100,100,193,28,938,11,977
test4sub98of100,test4pub25of100,100,193,16,8286,10,8312
test4sub87of100,test4pub45of100,100,193,20,663,11,694
test4sub6of100,test4pub11of100,100,193,10,11320,10,11340
test4sub89of100,test4pub45of100,100,193,20,664,10,694
test4sub33of100,test4pub45of100,100,193,20,666,9,695
test4sub15of100,test4pub44of100,100,193,17,796,8,821
test4sub26of100,test4pub41of100,100,193,27,1229,8,1264
test4sub50of100,test4pub45of100,100,193,20,669,7,696
test4sub58of100,test4pub19of100,100,193,11,9682,6,9699
test4sub13of100,test4pub45of100,100,193,20,672,6,698
test4sub62of100,test4pub44of100,100,193,17,801,6,824
test4sub98of100,test4pub27of100,100,193,10,7758,5,7773
test4sub6of100,test4pub12of100,100,193,11,10886,5,10902
test4sub26of100,test4pub42of100,100,193,31,1095,3,1129
test4sub58of100,test4pub20of100,100,193,10,9247,4,9261
test4sub62of100,test4pub45of100,100,193,20,679,3,702
test4sub98of100,test4pub26of100,100,193,10,8085,3,8098
test4sub26of100,test4pub43of100,100,193,28,958,4,990
test4sub58of100,test4pub21of100,100,193,10,9164,2,9176
test4sub6of100,test4pub13of100,100,193,10,10687,3,10700
test4sub98of100,test4pub28of100,100,193,10,7665,2,7677
test4sub26of100,test4pub44of100,100,193,17,814,2,833
test4sub6of100,test4pub14of100,100,193,10,10525,1,10536
test4sub98of100,test4pub29of100,100,193,11,7503,3,7517
test4sub58of100,test4pub22of100,100,193,10,9036,2,9048
test4sub26of100,test4pub45of100,100,193,20,688,1,709
test4sub6of100,test4pub15of100,100,193,11,10389,2,10402
test4sub98of100,test4pub30of100,100,193,15,7369,2,7386
test4sub58of100,test4pub23of100,100,193,11,8868,1,8880
test4sub6of100,test4pub16of100,100,193,10,10234,2,10246
test4sub58of100,test4pub24of100,100,193,19,8740,1,8760
test4sub98of100,test4pub31of100,100,193,10,7238,2,7250
test4sub6of100,test4pub17of100,100,193,11,10102,2,10115
test4sub98of100,test4pub32of100,100,193,11,6888,0,6899
test4sub58of100,test4pub25of100,100,193,16,8319,1,8336
test4sub6of100,test4pub18of100,100,193,18,9918,1,9937
test4sub98of100,test4pub33of100,100,193,11,6748,2,6761
test4sub58of100,test4pub26of100,100,193,10,8104,2,8116
test4sub98of100,test4pub34of100,100,193,12,5969,1,5982
test4sub6of100,test4pub19of100,100,193,11,9710,1,9722
test4sub98of100,test4pub35of100,100,193,12,3615,1,3628
test4sub6of100,test4pub20of100,100,193,10,9271,1,9282
test4sub98of100,test4pub36of100,100,193,10,2341,0,2351
test4sub6of100,test4pub21of100,100,193,10,9185,1,9196
test4sub98of100,test4pub37of100,100,193,23,1982,1,2006
test4sub6of100,test4pub22of100,100,193,10,9055,1,9066
test4sub6of100,test4pub23of100,100,193,11,8884,11,8906
test4sub98of100,test4pub38of100,100,193,31,1723,11,1765
test4sub6of100,test4pub24of100,100,193,19,8765,0,8784
test4sub98of100,test4pub39of100,100,193,28,1586,0,1614
test4sub98of100,test4pub40of100,100,193,49,1408,1,1458
test4sub6of100,test4pub25of100,100,193,16,8344,1,8361
test4sub98of100,test4pub41of100,100,193,27,1283,0,1310
test4sub98of100,test4pub42of100,100,193,31,1141,1,1173
test4sub100of100,test4pub37of100,100,193,23,2020,1,2044
test4sub100of100,test4pub38of100,100,193,31,1761,0,1792
test4sub100of100,test4pub39of100,100,193,28,1614,1,1643
test4sub100of100,test4pub40of100,100,193,49,1435,1,1485
test4sub100of100,test4pub41of100,100,193,27,1310,0,1337
test4sub100of100,test4pub42of100,100,193,31,1167,1,1199
test4sub100of100,test4pub43of100,100,193,28,1028,1,1057
test4sub100of100,test4pub44of100,100,193,17,881,0,898
test4sub100of100,test4pub45of100,100,193,20,754,1,775
test4sub6of100,test4pub26of100,100,193,10,8173,1,8184
test4sub6of100,test4pub27of100,100,193,10,7852,0,7862
test4sub6of100,test4pub28of100,100,193,10,7752,1,7763
test4sub6of100,test4pub29of100,100,193,11,7590,0,7601
test4sub6of100,test4pub30of100,100,193,15,7455,1,7471
test4sub6of100,test4pub31of100,100,193,10,7322,0,7332
test4sub37of100,test4pub46of100,100,193,12,429,1,442
test4sub80of100,test4pub46of100,100,193,12,430,1,443
test4sub6of100,test4pub32of100,100,193,11,6971,2,6984
test4sub58of100,test4pub27of100,100,193,10,7865,1,7876
test4sub58of100,test4pub28of100,100,193,10,7765,1,7776
test4sub6of100,test4pub33of100,100,193,11,6833,2,6846
test4sub58of100,test4pub29of100,100,193,11,7601,1,7613
test4sub58of100,test4pub30of100,100,193,15,7465,0,7480
test4sub58of100,test4pub31of100,100,193,10,7332,0,7342
test4sub58of100,test4pub32of100,100,193,11,6981,1,6993
test4sub58of100,test4pub33of100,100,193,11,6840,0,6851
test4sub58of100,test4pub34of100,100,193,12,6060,0,6072
test4sub98of100,test4pub43of100,100,193,28,1105,1,1134
test4sub55of100,test4pub46of100,100,193,12,479,2,493
test4sub30of100,test4pub46of100,100,193,12,480,2,494
test4sub98of100,test4pub44of100,100,193,17,959,2,978
test4sub14of100,test4pub11of100,100,193,10,11486,1,11497
test4sub14of100,test4pub12of100,100,193,11,11044,1,11056
test4sub98of100,test4pub45of100,100,193,20,833,1,854
test4sub14of100,test4pub13of100,100,193,10,10841,0,10851
test4sub62of100,test4pub46of100,100,193,12,485,2,499
test4sub13of100,test4pub46of100,100,193,12,486,1,499
test4sub14of100,test4pub14of100,100,193,10,10675,0,10685
test4sub14of100,test4pub15of100,100,193,11,10539,1,10551
test4sub75of100,test4pub46of100,100,193,12,497,0,509
test4sub66of100,test4pub46of100,100,193,12,506,3,521
test4sub60of100,test4pub46of100,100,193,12,507,2,521
test4sub92of100,test4pub46of100,100,193,12,508,1,521
test4sub43of100,test4pub46of100,100,193,12,511,0,523
test4sub48of100,test4pub46of100,100,193,12,515,0,527
test4sub33of100,test4pub46of100,100,193,12,531,1,544
test4sub77of100,test4pub46of100,100,193,12,533,1,546
test4sub100of100,test4pub46of100,100,193,12,537,1,550
test4sub89of100,test4pub46of100,100,193,12,541,1,554
test4sub76of100,test4pub46of100,100,193,12,545,0,557
test4sub71of100,test4pub46of100,100,193,12,547,1,560
test4sub40of100,test4pub32of100,100,193,11,7092,0,7103
test4sub40of100,test4pub33of100,100,193,11,6951,0,6962
test4sub29of100,test4pub46of100,100,193,12,554,1,567
test4sub26of100,test4pub46of100,100,193,12,557,1,570
test4sub50of100,test4pub46of100,100,193,12,557,1,570
test4sub28of100,test4pub46of100,100,193,12,558,1,571
test4sub6of100,test4pub34of100,100,193,12,6194,0,6206
test4sub6of100,test4pub35of100,100,193,12,3841,1,3854
test4sub6of100,test4pub36of100,100,193,10,2566,1,2577
test4sub6of100,test4pub37of100,100,193,23,2207,1,2231
test4sub6of100,test4pub38of100,100,193,31,1948,0,1979
test4sub6of100,test4pub39of100,100,193,28,1801,1,1830
test4sub6of100,test4pub40of100,100,193,49,1634,1,1684
test4sub6of100,test4pub41of100,100,193,27,1509,1,1537
test4sub58of100,test4pub35of100,100,193,12,3862,1,3875
test4sub6of100,test4pub42of100,100,193,31,1367,2,1400
test4sub58of100,test4pub36of100,100,193,10,2587,1,2598
test4sub58of100,test4pub37of100,100,193,23,2228,0,2251
test4sub86of100,test4pub46of100,100,193,12,604,1,617
test4sub3of100,test4pub47of100,100,193,10,190,1,201
test4sub58of100,test4pub38of100,100,193,31,1976,1,2008
test4sub58of100,test4pub39of100,100,193,28,1828,0,1856
test4sub58of100,test4pub40of100,100,193,49,1650,2,1701
test4sub25of100,test4pub46of100,100,193,12,613,1,626
test4sub47of100,test4pub46of100,100,193,12,613,2,627
test4sub58of100,test4pub41of100,100,193,27,1526,0,1553
test4sub58of100,test4pub42of100,100,193,31,1384,1,1416
test4sub87of100,test4pub46of100,100,193,12,620,1,633
test4sub15of100,test4pub46of100,100,193,12,624,1,637
test4sub80of100,test4pub47of100,100,193,10,215,1,226
test4sub7of100,test4pub45of100,100,193,20,985,0,1005
test4sub7of100,test4pub46of100,100,193,12,637,1,650
test4sub13of100,test4pub47of100,100,193,10,239,2,251
test4sub75of100,test4pub47of100,100,193,10,240,2,252
test4sub66of100,test4pub47of100,100,193,10,241,2,253
test4sub60of100,test4pub47of100,100,193,10,242,1,253
test4sub37of100,test4pub47of100,100,193,10,243,0,253
test4sub92of100,test4pub47of100,100,193,10,249,0,259
test4sub43of100,test4pub47of100,100,193,10,250,2,262
test4sub48of100,test4pub47of100,100,193,10,251,1,262
test4sub33of100,test4pub47of100,100,193,10,274,0,284
test4sub77of100,test4pub47of100,100,193,10,281,1,292
test4sub89of100,test4pub47of100,100,193,10,281,1,292
test4sub76of100,test4pub47of100,100,193,10,282,1,293
test4sub71of100,test4pub47of100,100,193,10,285,1,296
test4sub29of100,test4pub47of100,100,193,10,290,1,301
test4sub26of100,test4pub47of100,100,193,10,293,1,304
test4sub6of100,test4pub43of100,100,193,28,1381,0,1409
test4sub6of100,test4pub44of100,100,193,17,1234,1,1252
test4sub6of100,test4pub45of100,100,193,20,1107,1,1128
test4sub6of100,test4pub46of100,100,193,12,758,0,770
test4sub6of100,test4pub47of100,100,193,10,345,1,356
test4sub58of100,test4pub43of100,100,193,28,1399,0,1427
test4sub58of100,test4pub44of100,100,193,17,1253,1,1271
test4sub86of100,test4pub47of100,100,193,10,360,0,370
test4sub58of100,test4pub45of100,100,193,20,1126,0,1146
test4sub58of100,test4pub46of100,100,193,12,777,0,789
test4sub58of100,test4pub47of100,100,193,10,364,1,375
test4sub3of100,test4pub46of100,100,193,12,782,1,795
test4sub9of100,test4pub38of100,100,193,31,2150,1,2182
test4sub3of100,test4pub48of100,100,193,10,208,1,219
test4sub9of100,test4pub39of100,100,193,28,2002,1,2031
test4sub9of100,test4pub40of100,100,193,49,1824,1,1874
test4sub9of100,test4pub41of100,100,193,27,1699,0,1726
test4sub25of100,test4pub47of100,100,193,10,372,1,383
test4sub9of100,test4pub42of100,100,193,31,1557,1,1589
test4sub9of100,test4pub43of100,100,193,28,1417,0,1445
test4sub47of100,test4pub47of100,100,193,10,377,1,388
test4sub9of100,test4pub44of100,100,193,17,1271,0,1288
test4sub9of100,test4pub45of100,100,193,20,1144,1,1165
test4sub9of100,test4pub46of100,100,193,12,795,0,807
test4sub87of100,test4pub47of100,100,193,10,383,0,393
test4sub87of100,test4pub48of100,100,193,10,224,1,235
test4sub15of100,test4pub47of100,100,193,10,402,1,413
test4sub80of100,test4pub48of100,100,193,10,245,1,256
test4sub7of100,test4pub47of100,100,193,10,414,1,425
test4sub52of100,test4pub19of100,100,193,11,10195,1,10207
test4sub52of100,test4pub20of100,100,193,10,9755,1,9766
test4sub52of100,test4pub21of100,100,193,10,9674,1,9685
test4sub52of100,test4pub22of100,100,193,10,9544,1,9555
test4sub52of100,test4pub24of100,100,193,19,9242,1,9262
test4sub73of100,test4pub46of100,100,193,12,846,0,858
test4sub73of100,test4pub47of100,100,193,10,433,1,444
test4sub13of100,test4pub48of100,100,193,10,285,1,296
test4sub66of100,test4pub48of100,100,193,10,287,1,298
test4sub60of100,test4pub48of100,100,193,10,287,0,297
test4sub43of100,test4pub48of100,100,193,10,291,0,301
test4sub48of100,test4pub48of100,100,193,10,294,0,304
test4sub94of100,test4pub83of100,10,192,10,28006,1,28017
test4sub94of100,test4pub84of100,10,192,11,27528,1,27540
test4sub94of100,test4pub85of100,10,192,23,25997,0,26020
test4sub33of100,test4pub48of100,100,193,10,311,1,322
test4sub77of100,test4pub48of100,100,193,10,314,1,325
test4sub89of100,test4pub48of100,100,193,10,316,1,327
test4sub76of100,test4pub48of100,100,193,10,327,1,338
test4sub40of100,test4pub34of100,100,193,12,6526,1,6539
test4sub40of100,test4pub35of100,100,193,12,4172,1,4185
test4sub40of100,test4pub36of100,100,193,10,2897,1,2908
test4sub40of100,test4pub37of100,100,193,23,2538,1,2562
test4sub6of100,test4pub48of100,100,193,10,339,1,350
test4sub65of100,test4pub12of100,100,193,11,11482,0,11493
test4sub58of100,test4pub48of100,100,193,10,352,1,363
test4sub9of100,test4pub47of100,100,193,10,516,1,527
test4sub25of100,test4pub48of100,100,193,10,356,1,367
test4sub47of100,test4pub48of100,100,193,10,356,1,367
test4sub63of100,test4pub39of100,100,193,28,2152,0,2180
test4sub15of100,test4pub48of100,100,193,10,360,0,370
test4sub7of100,test4pub48of100,100,193,10,366,1,377
test4sub80of100,test4pub49of100,100,193,11,170,1,182
test4sub52of100,test4pub23of100,100,193,11,9473,1,9485
test4sub73of100,test4pub48of100,100,193,10,377,1,388
test4sub28of100,test4pub47of100,100,193,10,538,1,549
test4sub3of100,test4pub49of100,100,193,11,187,1,199
test4sub13of100,test4pub49of100,100,193,11,188,0,199
test4sub66of100,test4pub49of100,100,193,11,190,0,201
test4sub43of100,test4pub49of100,100,193,11,195,0,206
test4sub65of100,test4pub13of100,100,193,10,11335,3,11348
test4sub87of100,test4pub49of100,100,193,11,206,3,220
test4sub9of100,test4pub48of100,100,193,10,403,4,417
test4sub40of100,test4pub38of100,100,193,31,2345,4,2380
test4sub63of100,test4pub40of100,100,193,49,2018,4,2071
test4sub28of100,test4pub48of100,100,193,10,405,4,419
test4sub52of100,test4pub25of100,100,193,16,8954,3,8973
test4sub65of100,test4pub14of100,100,193,10,11171,3,11184
test4sub40of100,test4pub39of100,100,193,28,2202,3,2233
test4sub63of100,test4pub41of100,100,193,27,1896,2,1925
test4sub52of100,test4pub26of100,100,193,10,8742,2,8754
test4sub65of100,test4pub15of100,100,193,11,11036,2,11049
test4sub63of100,test4pub42of100,100,193,31,1756,2,1789
test4sub52of100,test4pub27of100,100,193,10,8422,2,8434
test4sub65of100,test4pub16of100,100,193,10,10881,1,10892
test4sub63of100,test4pub43of100,100,193,28,1617,2,1647
test4sub52of100,test4pub28of100,100,193,10,8323,1,8334
test4sub65of100,test4pub17of100,100,193,11,10749,2,10762
test4sub63of100,test4pub44of100,100,193,17,1472,1,1490
test4sub52of100,test4pub29of100,100,193,11,8159,1,8171
test4sub63of100,test4pub45of100,100,193,20,1345,1,1366
test4sub52of100,test4pub30of100,100,193,15,8025,1,8041
test4sub52of100,test4pub31of100,100,193,10,7892,0,7902
test4sub63of100,test4pub46of100,100,193,12,997,0,1009
test4sub63of100,test4pub47of100,100,193,10,584,1,595
test4sub77of100,test4pub49of100,100,193,11,239,0,250
test4sub33of100,test4pub49of100,100,193,11,241,1,253
test4sub50of100,test4pub47of100,100,193,10,604,1,615
test4sub76of100,test4pub49of100,100,193,11,247,2,260
test4sub50of100,test4pub48of100,100,193,10,445,1,456
test4sub6of100,test4pub49of100,100,193,11,255,1,267
test4sub48of100,test4pub49of100,100,193,11,258,5,274
test4sub38of100,test4pub45of100,100,193,20,1387,1,1408
test4sub38of100,test4pub46of100,100,193,12,1038,0,1050
test4sub38of100,test4pub47of100,100,193,10,625,1,636
test4sub38of100,test4pub48of100,100,193,10,465,0,475
test4sub65of100,test4pub18of100,100,193,18,10618,1,10637
test4sub65of100,test4pub19of100,100,193,11,10409,0,10420
test4sub65of100,test4pub20of100,100,193,10,9970,1,9981
test4sub65of100,test4pub21of100,100,193,10,9884,1,9895
test4sub65of100,test4pub22of100,100,193,10,9754,0,9764
test4sub89of100,test4pub49of100,100,193,11,282,1,294
test4sub60of100,test4pub49of100,100,193,11,290,1,302
test4sub65of100,test4pub23of100,100,193,11,9592,1,9604
test4sub65of100,test4pub24of100,100,193,19,9463,1,9483
test4sub58of100,test4pub49of100,100,193,11,294,1,306
test4sub65of100,test4pub25of100,100,193,16,9042,1,9059
test4sub9of100,test4pub49of100,100,193,11,296,1,308
test4sub25of100,test4pub49of100,100,193,11,300,1,312
test4sub47of100,test4pub49of100,100,193,11,302,1,314
test4sub63of100,test4pub48of100,100,193,10,500,0,510
test4sub63of100,test4pub49of100,100,193,11,305,1,317
test4sub15of100,test4pub49of100,100,193,11,308,1,320
test4sub7of100,test4pub49of100,100,193,11,309,1,321
test4sub52of100,test4pub32of100,100,193,11,7635,1,7647
test4sub52of100,test4pub33of100,100,193,11,7494,0,7505
test4sub52of100,test4pub34of100,100,193,12,6715,1,6728
test4sub37of100,test4pub48of100,100,193,10,522,1,533
test4sub52of100,test4pub35of100,100,193,12,4361,1,4374
test4sub37of100,test4pub49of100,100,193,11,326,0,337
test4sub52of100,test4pub36of100,100,193,10,3087,1,3098
test4sub52of100,test4pub37of100,100,193,23,2728,1,2752
test4sub52of100,test4pub38of100,100,193,31,2473,0,2504
test4sub52of100,test4pub39of100,100,193,28,2326,1,2355
test4sub52of100,test4pub40of100,100,193,49,2147,1,2197
test4sub28of100,test4pub49of100,100,193,11,344,1,356
test4sub73of100,test4pub49of100,100,193,11,345,1,357
test4sub3of100,test4pub50of100,100,193,17,174,1,192
test4sub73of100,test4pub50of100,100,193,17,175,0,192
test4sub87of100,test4pub50of100,100,193,17,187,0,204
test4sub29of100,test4pub48of100,100,193,10,571,0,581
test4sub29of100,test4pub49of100,100,193,11,376,1,388
test4sub80of100,test4pub50of100,100,193,17,208,1,226
test4sub26of100,test4pub48of100,100,193,10,579,1,590
test4sub43of100,test4pub50of100,100,193,17,211,1,229
test4sub26of100,test4pub49of100,100,193,11,383,1,395
test4sub33of100,test4pub50of100,100,193,17,217,1,235
test4sub50of100,test4pub49of100,100,193,11,392,0,403
test4sub50of100,test4pub50of100,100,193,17,221,1,239
test4sub6of100,test4pub50of100,100,193,17,226,0,243
test4sub48of100,test4pub50of100,100,193,17,229,1,247
test4sub38of100,test4pub49of100,100,193,11,402,0,413
test4sub38of100,test4pub50of100,100,193,17,231,0,248
test4sub65of100,test4pub26of100,100,193,10,8938,0,8948
test4sub65of100,test4pub27of100,100,193,10,8618,1,8629
test4sub65of100,test4pub28of100,100,193,10,8517,1,8528
test4sub65of100,test4pub29of100,100,193,11,8376,0,8387
test4sub85of100,test4pub37of100,100,193,23,2839,1,2863
test4sub65of100,test4pub30of100,100,193,15,8242,2,8259
test4sub89of100,test4pub50of100,100,193,17,268,1,286
test4sub85of100,test4pub38of100,100,193,31,2581,2,2614
test4sub76of100,test4pub50of100,100,193,17,270,1,288
test4sub85of100,test4pub39of100,100,193,28,2434,2,2464
test4sub60of100,test4pub50of100,100,193,17,272,0,289
test4sub85of100,test4pub40of100,100,193,49,2256,0,2305
test4sub85of100,test4pub41of100,100,193,27,2132,1,2160
test4sub85of100,test4pub42of100,100,193,31,1989,1,2021
test4sub65of100,test4pub31of100,100,193,10,8117,2,8129
test4sub85of100,test4pub43of100,100,193,28,1850,1,1879
test4sub58of100,test4pub50of100,100,193,17,277,2,296
test4sub85of100,test4pub44of100,100,193,17,1703,1,1721
test4sub65of100,test4pub32of100,100,193,11,7766,1,7778
test4sub9of100,test4pub50of100,100,193,17,281,1,299
test4sub47of100,test4pub50of100,100,193,17,283,1,301
test4sub65of100,test4pub33of100,100,193,11,7626,1,7638
test4sub63of100,test4pub50of100,100,193,17,284,3,304
test4sub15of100,test4pub50of100,100,193,17,285,2,304
test4sub7of100,test4pub50of100,100,193,17,286,1,304
test4sub54of100,test4pub45of100,100,193,20,1582,2,1604
test4sub52of100,test4pub41of100,100,193,27,2152,0,2179
test4sub52of100,test4pub42of100,100,193,31,2009,1,2041
test4sub52of100,test4pub43of100,100,193,28,1870,0,1898
test4sub28of100,test4pub50of100,100,193,17,300,1,318
test4sub52of100,test4pub44of100,100,193,17,1724,0,1741
test4sub52of100,test4pub45of100,100,193,20,1596,1,1617
test4sub52of100,test4pub46of100,100,193,12,1248,1,1261
test4sub52of100,test4pub47of100,100,193,10,834,0,844
test4sub52of100,test4pub48of100,100,193,10,675,1,686
test4sub14of100,test4pub16of100,100,193,10,11144,1,11155
test4sub14of100,test4pub17of100,100,193,11,11010,0,11021
test4sub14of100,test4pub18of100,100,193,18,10826,1,10845
test4sub29of100,test4pub50of100,100,193,17,366,1,384
test4sub26of100,test4pub50of100,100,193,17,376,1,394
test4sub45of100,test4pub38of100,100,193,31,2695,0,2726
test4sub45of100,test4pub39of100,100,193,28,2548,1,2577
test4sub45of100,test4pub40of100,100,193,49,2369,1,2419
test4sub45of100,test4pub41of100,100,193,27,2244,1,2272
test4sub73of100,test4pub51of100,100,193,16,218,1,235
test4sub45of100,test4pub42of100,100,193,31,2102,1,2134
test4sub45of100,test4pub43of100,100,193,28,1962,1,1991
test4sub33of100,test4pub51of100,100,193,16,226,0,242
test4sub80of100,test4pub51of100,100,193,16,231,1,248
test4sub40of100,test4pub40of100,100,193,49,2385,1,2435
test4sub40of100,test4pub41of100,100,193,27,2261,1,2289
test4sub40of100,test4pub42of100,100,193,31,2118,0,2149
test4sub43of100,test4pub51of100,100,193,16,237,1,254
test4sub40of100,test4pub43of100,100,193,28,1979,0,2007
test4sub40of100,test4pub44of100,100,193,17,1833,1,1851
test4sub40of100,test4pub45of100,100,193,20,1705,0,1725
test4sub40of100,test4pub46of100,100,193,12,1357,1,1370
test4sub50of100,test4pub51of100,100,193,16,242,1,259
test4sub40of100,test4pub47of100,100,193,10,943,1,954
test4sub40of100,test4pub48of100,100,193,10,784,0,794
test4sub40of100,test4pub49of100,100,193,11,588,0,599
test4sub40of100,test4pub50of100,100,193,17,418,1,436
test4sub87of100,test4pub51of100,100,193,16,251,0,267
test4sub6of100,test4pub51of100,100,193,16,254,0,270
test4sub48of100,test4pub51of100,100,193,16,261,1,278
test4sub38of100,test4pub51of100,100,193,16,262,1,279
test4sub65of100,test4pub34of100,100,193,12,6999,1,7012
test4sub65of100,test4pub35of100,100,193,12,4646,1,4659
test4sub65of100,test4pub36of100,100,193,10,3371,1,3382
test4sub65of100,test4pub37of100,100,193,23,3012,1,3036
test4sub85of100,test4pub45of100,100,193,20,1736,1,1757
test4sub65of100,test4pub38of100,100,193,31,2753,1,2785
test4sub85of100,test4pub46of100,100,193,12,1388,1,1401
test4sub65of100,test4pub39of100,100,193,28,2606,0,2634
test4sub85of100,test4pub47of100,100,193,10,974,1,985
test4sub85of100,test4pub48of100,100,193,10,815,0,825
test4sub85of100,test4pub49of100,100,193,11,619,0,630
test4sub85of100,test4pub50of100,100,193,17,449,1,467
test4sub89of100,test4pub51of100,100,193,16,279,0,295
test4sub85of100,test4pub51of100,100,193,16,280,1,297
test4sub65of100,test4pub40of100,100,193,49,2434,0,2483
test4sub65of100,test4pub41of100,100,193,27,2309,0,2336
test4sub58of100,test4pub51of100,100,193,16,288,1,305
test4sub47of100,test4pub51of100,100,193,16,291,2,309
test4sub63of100,test4pub51of100,100,193,16,291,1,308
test4sub15of100,test4pub51of100,100,193,16,292,1,309
test4sub98of100,test4pub46of100,100,193,12,1417,0,1429
test4sub98of100,test4pub47of100,100,193,10,1004,1,1015
test4sub98of100,test4pub48of100,100,193,10,844,0,854
test4sub98of100,test4pub49of100,100,193,11,648,0,659
test4sub7of100,test4pub51of100,100,193,16,315,1,332
test4sub52of100,test4pub49of100,100,193,11,662,1,674
test4sub52of100,test4pub50of100,100,193,17,491,1,509
test4sub52of100,test4pub51of100,100,193,16,323,1,340
test4sub37of100,test4pub50of100,100,193,17,495,1,513
test4sub37of100,test4pub51of100,100,193,16,326,0,342
test4sub37of100,test4pub52of100,100,193,10,181,1,192
test4sub25of100,test4pub50of100,100,193,17,500,0,517
test4sub25of100,test4pub51of100,100,193,16,331,1,348
test4sub60of100,test4pub51of100,100,193,16,347,1,364
test4sub76of100,test4pub51of100,100,193,16,349,1,366
test4sub26of100,test4pub51of100,100,193,16,350,1,367
test4sub76of100,test4pub52of100,100,193,10,205,2,217
test4sub26of100,test4pub52of100,100,193,10,206,1,217
test4sub73of100,test4pub52of100,100,193,10,207,0,217
test4sub33of100,test4pub52of100,100,193,10,209,1,220
test4sub40of100,test4pub51of100,100,193,16,356,0,372
test4sub43of100,test4pub52of100,100,193,10,211,1,222
test4sub50of100,test4pub52of100,100,193,10,212,0,222
test4sub87of100,test4pub52of100,100,193,10,214,1,225
test4sub6of100,test4pub52of100,100,193,10,215,1,226
test4sub48of100,test4pub52of100,100,193,10,220,1,231
test4sub38of100,test4pub52of100,100,193,10,220,0,230
test4sub65of100,test4pub42of100,100,193,31,2254,1,2286
test4sub65of100,test4pub43of100,100,193,28,2115,1,2144
test4sub89of100,test4pub52of100,100,193,10,228,1,239
test4sub65of100,test4pub44of100,100,193,17,1969,1,1987
test4sub65of100,test4pub45of100,100,193,20,1841,0,1861
test4sub65of100,test4pub46of100,100,193,12,1493,1,1506
test4sub47of100,test4pub52of100,100,193,10,232,1,243
test4sub65of100,test4pub47of100,100,193,10,1079,1,1090
test4sub65of100,test4pub48of100,100,193,10,920,0,930
test4sub63of100,test4pub52of100,100,193,10,236,1,247
test4sub65of100,test4pub49of100,100,193,11,724,2,737
test4sub15of100,test4pub52of100,100,193,10,237,1,248
test4sub65of100,test4pub50of100,100,193,17,555,1,573
test4sub65of100,test4pub51of100,100,193,16,386,0,402
test4sub65of100,test4pub52of100,100,193,10,242,1,253
test4sub98of100,test4pub50of100,100,193,17,572,0,589
test4sub98of100,test4pub51of100,100,193,16,404,1,421
test4sub90of100,test4pub45of100,100,193,20,1869,1,1890
test4sub98of100,test4pub52of100,100,193,10,259,1,270
test4sub7of100,test4pub52of100,100,193,10,266,0,276
test4sub54of100,test4pub46of100,100,193,12,1529,1,1542
test4sub54of100,test4pub47of100,100,193,10,1115,0,1125
test4sub52of100,test4pub52of100,100,193,10,272,3,285
test4sub31of100,test4pub12of100,100,193,11,12096,2,12109
test4sub54of100,test4pub48of100,100,193,10,958,2,970
test4sub31of100,test4pub13of100,100,193,10,11894,1,11905
test4sub58of100,test4pub52of100,100,193,10,277,1,288
test4sub54of100,test4pub49of100,100,193,11,765,2,778
test4sub31of100,test4pub14of100,100,193,10,11728,1,11739
test4sub25of100,test4pub52of100,100,193,10,280,1,291
test4sub31of100,test4pub15of100,100,193,11,11591,1,11603
test4sub54of100,test4pub50of100,100,193,17,596,1,614
test4sub31of100,test4pub16of100,100,193,10,11435,1,11446
test4sub54of100,test4pub51of100,100,193,16,429,1,446
test4sub54of100,test4pub52of100,100,193,10,284,0,294
test4sub31of100,test4pub17of100,100,193,11,11302,1,11314
test4sub14of100,test4pub19of100,100,193,11,10925,1,10937
test4sub14of100,test4pub20of100,100,193,10,10484,1,10495
test4sub14of100,test4pub21of100,100,193,10,10399,1,10410
test4sub14of100,test4pub22of100,100,193,10,10268,0,10278
test4sub14of100,test4pub23of100,100,193,11,10097,1,10109
test4sub14of100,test4pub24of100,100,193,19,9968,0,9987
test4sub14of100,test4pub25of100,100,193,16,9546,1,9563
test4sub14of100,test4pub26of100,100,193,10,9330,1,9341
test4sub14of100,test4pub27of100,100,193,10,9009,0,9019
test4sub14of100,test4pub28of100,100,193,10,8908,1,8919
test4sub14of100,test4pub29of100,100,193,11,8744,1,8756
test4sub14of100,test4pub30of100,100,193,15,8608,0,8623
test4sub14of100,test4pub31of100,100,193,10,8476,1,8487
test4sub14of100,test4pub32of100,100,193,11,8124,0,8135
test4sub40of100,test4pub52of100,100,193,10,322,0,332
test4sub14of100,test4pub33of100,100,193,11,7984,1,7996
test4sub14of100,test4pub34of100,100,193,12,7204,0,7216
test4sub32of100,test4pub10of100,100,193,11,12827,1,12839
test4sub32of100,test4pub11of100,100,193,10,12592,1,12603
test4sub32of100,test4pub12of100,100,193,11,12150,1,12162
test4sub32of100,test4pub13of100,100,193,10,11947,1,11958
test4sub30of100,test4pub47of100,100,193,10,1176,1,1187
test4sub32of100,test4pub14of100,100,193,10,11781,0,11791
test4sub32of100,test4pub15of100,100,193,11,11643,1,11655
test4sub30of100,test4pub48of100,100,193,10,1017,2,1029
test4sub31of100,test4pub18of100,100,193,18,11165,1,11184
test4sub30of100,test4pub49of100,100,193,11,823,2,836
test4sub32of100,test4pub16of100,100,193,10,11488,3,11501
test4sub31of100,test4pub19of100,100,193,11,10958,2,10971
test4sub32of100,test4pub17of100,100,193,11,11357,0,11368
test4sub31of100,test4pub20of100,100,193,10,10519,0,10529
test4sub31of100,test4pub21of100,100,193,10,10434,1,10445
test4sub32of100,test4pub18of100,100,193,18,11173,1,11192
test4sub31of100,test4pub22of100,100,193,10,10303,1,10314
test4sub32of100,test4pub19of100,100,193,11,10964,1,10976
test4sub32of100,test4pub20of100,100,193,10,10524,0,10534
test4sub31of100,test4pub23of100,100,193,11,10132,1,10144
test4sub32of100,test4pub21of100,100,193,10,10439,1,10450
test4sub60of100,test4pub52of100,100,193,10,346,1,357
test4sub31of100,test4pub24of100,100,193,19,10004,0,10023
test4sub32of100,test4pub22of100,100,193,10,10309,0,10319
test4sub31of100,test4pub25of100,100,193,16,9584,1,9601
test4sub95of100,test4pub34of100,100,193,12,7256,1,7269
test4sub95of100,test4pub35of100,100,193,12,4902,0,4914
test4sub95of100,test4pub36of100,100,193,10,3627,0,3637
test4sub95of100,test4pub37of100,100,193,23,3268,1,3292
test4sub95of100,test4pub38of100,100,193,31,3009,1,3041
test4sub14of100,test4pub35of100,100,193,12,4907,1,4920
test4sub95of100,test4pub39of100,100,193,28,2862,0,2890
test4sub14of100,test4pub36of100,100,193,10,3632,1,3643
test4sub14of100,test4pub37of100,100,193,23,3273,1,3297
test4sub95of100,test4pub40of100,100,193,49,2684,1,2734
test4sub84of100,test4pub3of100,100,192,28,17005,1,17034
test4sub14of100,test4pub38of100,100,193,31,3015,1,3047
test4sub14of100,test4pub39of100,100,193,28,2868,1,2897
test4sub14of100,test4pub40of100,100,193,49,2689,0,2738
test4sub14of100,test4pub41of100,100,193,27,2564,1,2592
test4sub14of100,test4pub42of100,100,193,31,2422,1,2454
test4sub14of100,test4pub43of100,100,193,28,2282,1,2311
test4sub41of100,test4pub8of100,100,192,12,13450,1,13463
test4sub41of100,test4pub9of100,100,192,20,13267,1,13288
test4sub41of100,test4pub10of100,100,193,11,12903,0,12914
test4sub41of100,test4pub11of100,100,193,10,12668,1,12679
test4sub41of100,test4pub12of100,100,193,11,12225,1,12237
test4sub32of100,test4pub23of100,100,193,11,10198,0,10209
test4sub32of100,test4pub24of100,100,193,19,10070,1,10090
test4sub32of100,test4pub25of100,100,193,16,9648,1,9665
test4sub32of100,test4pub26of100,100,193,10,9517,0,9527
test4sub32of100,test4pub27of100,100,193,10,9197,1,9208
test4sub32of100,test4pub28of100,100,193,10,9096,1,9107
test4sub90of100,test4pub46of100,100,193,12,1765,1,1778
test4sub30of100,test4pub50of100,100,193,17,821,1,839
test4sub90of100,test4pub47of100,100,193,10,1352,1,1363
test4sub32of100,test4pub29of100,100,193,11,8932,2,8945
test4sub30of100,test4pub51of100,100,193,16,653,1,670
test4sub90of100,test4pub48of100,100,193,10,1192,2,1204
test4sub32of100,test4pub30of100,100,193,15,8799,2,8816
test4sub30of100,test4pub52of100,100,193,10,509,2,521
test4sub90of100,test4pub49of100,100,193,11,999,1,1011
test4sub31of100,test4pub26of100,100,193,10,9528,1,9539
test4sub90of100,test4pub50of100,100,193,17,829,1,847
test4sub32of100,test4pub31of100,100,193,10,8668,2,8680
test4sub31of100,test4pub27of100,100,193,10,9209,1,9220
test4sub90of100,test4pub51of100,100,193,16,660,1,677
test4sub31of100,test4pub28of100,100,193,10,9109,0,9119
test4sub90of100,test4pub52of100,100,193,10,516,1,527
test4sub31of100,test4pub29of100,100,193,11,8945,1,8957
test4sub31of100,test4pub30of100,100,193,15,8809,1,8825
test4sub31of100,test4pub31of100,100,193,10,8677,1,8688
test4sub31of100,test4pub32of100,100,193,11,8325,0,8336
test4sub31of100,test4pub33of100,100,193,11,8185,1,8197
test4sub47of100,test4pub53of100,100,193,10,156,1,167
test4sub52of100,test4pub53of100,100,193,10,157,1,168
test4sub95of100,test4pub41of100,100,193,27,2701,1,2729
test4sub95of100,test4pub42of100,100,193,31,2558,1,2590
test4sub95of100,test4pub43of100,100,193,28,2418,0,2446
test4sub95of100,test4pub44of100,100,193,17,2282,1,2300
test4sub95of100,test4pub45of100,100,193,20,2155,1,2176
test4sub95of100,test4pub46of100,100,193,12,1806,0,1818
test4sub3of100,test4pub51of100,100,193,16,691,1,708
test4sub3of100,test4pub52of100,100,193,10,547,1,558
test4sub14of100,test4pub44of100,100,193,17,2291,1,2309
test4sub14of100,test4pub45of100,100,193,20,2163,0,2183
test4sub14of100,test4pub46of100,100,193,12,1817,0,1829
test4sub14of100,test4pub47of100,100,193,10,1404,1,1415
test4sub14of100,test4pub48of100,100,193,10,1244,1,1255
test4sub14of100,test4pub49of100,100,193,11,1051,0,1062
test4sub14of100,test4pub50of100,100,193,17,880,1,898
test4sub14of100,test4pub51of100,100,193,16,712,1,729
test4sub41of100,test4pub13of100,100,193,10,12191,1,12202
test4sub41of100,test4pub14of100,100,193,10,12024,0,12034
test4sub41of100,test4pub15of100,100,193,11,11887,1,11899
test4sub41of100,test4pub16of100,100,193,10,11730,0,11740
test4sub41of100,test4pub17of100,100,193,11,11596,1,11608
test4sub41of100,test4pub18of100,100,193,18,11412,1,11431
test4sub41of100,test4pub19of100,100,193,11,11203,0,11214
test4sub41of100,test4pub20of100,100,193,10,10763,1,10774
test4sub63of100,test4pub53of100,100,193,10,229,1,240
test4sub65of100,test4pub53of100,100,193,10,231,0,241
test4sub32of100,test4pub32of100,100,193,11,8405,1,8417
test4sub32of100,test4pub33of100,100,193,11,8264,1,8276
test4sub38of100,test4pub53of100,100,193,10,237,2,249
test4sub7of100,test4pub53of100,100,193,10,238,1,249
test4sub50of100,test4pub53of100,100,193,10,239,1,250
test4sub73of100,test4pub53of100,100,193,10,240,1,251
test4sub89of100,test4pub53of100,100,193,10,242,0,252
test4sub43of100,test4pub53of100,100,193,10,246,1,257
test4sub29of100,test4pub51of100,100,193,16,762,1,779
test4sub29of100,test4pub52of100,100,193,10,617,1,628
test4sub15of100,test4pub53of100,100,193,10,302,1,313
test4sub6of100,test4pub53of100,100,193,10,336,0,346
test4sub87of100,test4pub53of100,100,193,10,337,1,348
test4sub33of100,test4pub53of100,100,193,10,339,1,350
test4sub58of100,test4pub53of100,100,193,10,339,2,351
test4sub40of100,test4pub53of100,100,193,10,340,1,351
test4sub76of100,test4pub53of100,100,193,10,355,1,366
test4sub98of100,test4pub53of100,100,193,10,356,1,367
test4sub54of100,test4pub53of100,100,193,10,363,1,374
test4sub28of100,test4pub51of100,100,193,16,880,0,896
test4sub25of100,test4pub53of100,100,193,10,366,1,377
test4sub28of100,test4pub52of100,100,193,10,736,1,747
test4sub68of100,test4pub36of100,100,193,10,3992,1,4003
test4sub48of100,test4pub53of100,100,193,10,374,1,385
test4sub68of100,test4pub37of100,100,193,23,3632,0,3655
test4sub68of100,test4pub38of100,100,193,31,3373,0,3404
test4sub68of100,test4pub39of100,100,193,28,3226,1,3255
test4sub68of100,test4pub40of100,100,193,49,3047,0,3096
test4sub68of100,test4pub41of100,100,193,27,2922,0,2949
test4sub26of100,test4pub53of100,100,193,10,384,1,395
test4sub37of100,test4pub53of100,100,193,10,388,1,399
test4sub42of100,test4pub39of100,100,193,28,3246,0,3274
test4sub42of100,test4pub40of100,100,193,49,3068,1,3118
test4sub42of100,test4pub41of100,100,193,27,2943,0,2970
test4sub42of100,test4pub42of100,100,193,31,2801,1,2833
test4sub42of100,test4pub43of100,100,193,28,2661,1,2690
test4sub42of100,test4pub44of100,100,193,17,2514,0,2531
test4sub60of100,test4pub53of100,100,193,10,418,0,428
test4sub80of100,test4pub52of100,100,193,10,791,1,802
test4sub80of100,test4pub53of100,100,193,10,423,0,433
test4sub59of100,test4pub41of100,100,193,27,2967,0,2994
test4sub59of100,test4pub42of100,100,193,31,2825,1,2857
test4sub59of100,test4pub43of100,100,193,28,2685,1,2714
test4sub85of100,test4pub52of100,100,193,10,804,0,814
test4sub85of100,test4pub53of100,100,193,10,437,1,448
test4sub83of100,test4pub45of100,100,193,20,2418,1,2439
test4sub83of100,test4pub46of100,100,193,12,2069,0,2081
test4sub83of100,test4pub47of100,100,193,10,1655,0,1665
test4sub83of100,test4pub48of100,100,193,10,1496,1,1507
test4sub83of100,test4pub49of100,100,193,11,1300,0,1311
test4sub83of100,test4pub50of100,100,193,17,1129,0,1146
test4sub83of100,test4pub51of100,100,193,16,961,1,978
test4sub83of100,test4pub52of100,100,193,10,816,1,827
test4sub32of100,test4pub34of100,100,193,12,7697,0,7709
test4sub83of100,test4pub53of100,100,193,10,449,1,460
test4sub32of100,test4pub35of100,100,193,12,5343,1,5356
test4sub32of100,test4pub36of100,100,193,10,4069,0,4079
test4sub32of100,test4pub37of100,100,193,23,3709,0,3732
test4sub32of100,test4pub38of100,100,193,31,3451,1,3483
test4sub32of100,test4pub39of100,100,193,28,3303,0,3331
test4sub90of100,test4pub53of100,100,193,10,455,0,465
test4sub90of100,test4pub54of100,100,193,11,291,1,303
test4sub30of100,test4pub53of100,100,193,10,457,1,468
test4sub30of100,test4pub54of100,100,193,11,293,1,305
test4sub31of100,test4pub34of100,100,193,12,7708,1,7721
test4sub31of100,test4pub35of100,100,193,12,5354,1,5367
test4sub31of100,test4pub36of100,100,193,10,4080,0,4090
test4sub31of100,test4pub37of100,100,193,23,3720,0,3743
test4sub31of100,test4pub38of100,100,193,31,3462,1,3494
test4sub31of100,test4pub39of100,100,193,28,3314,0,3342
test4sub31of100,test4pub40of100,100,193,49,3136,1,3186
test4sub31of100,test4pub41of100,100,193,27,3011,1,3039
test4sub52of100,test4pub54of100,100,193,11,318,0,329
test4sub95of100,test4pub47of100,100,193,10,1701,1,1712
test4sub95of100,test4pub48of100,100,193,10,1541,1,1552
test4sub95of100,test4pub49of100,100,193,11,1346,0,1357
test4sub3of100,test4pub53of100,100,193,10,489,1,500
test4sub14of100,test4pub52of100,100,193,10,860,1,871
test4sub95of100,test4pub50of100,100,193,17,1176,1,1194
test4sub14of100,test4pub53of100,100,193,10,492,1,503
test4sub95of100,test4pub51of100,100,193,16,1008,1,1025
test4sub95of100,test4pub52of100,100,193,10,863,0,873
test4sub14of100,test4pub54of100,100,193,11,328,1,340
test4sub95of100,test4pub53of100,100,193,10,496,1,507
test4sub41of100,test4pub21of100,100,193,10,10967,1,10978
test4sub41of100,test4pub22of100,100,193,10,10836,0,10846
test4sub41of100,test4pub23of100,100,193,11,10665,1,10677
test4sub63of100,test4pub54of100,100,193,11,349,1,361
test4sub47of100,test4pub54of100,100,193,11,350,1,362
test4sub65of100,test4pub54of100,100,193,11,351,1,363
test4sub32of100,test4pub40of100,100,193,49,3186,1,3236
test4sub32of100,test4pub41of100,100,193,27,3062,1,3090
test4sub32of100,test4pub42of100,100,193,31,2919,0,2950
test4sub38of100,test4pub54of100,100,193,11,357,1,369
test4sub7of100,test4pub54of100,100,193,11,358,2,371
test4sub89of100,test4pub54of100,100,193,11,359,1,371
test4sub15of100,test4pub54of100,100,193,11,362,2,375
test4sub6of100,test4pub54of100,100,193,11,363,2,376
test4sub87of100,test4pub54of100,100,193,11,363,1,375
test4sub33of100,test4pub54of100,100,193,11,371,1,383
test4sub40of100,test4pub54of100,100,193,11,374,0,385
test4sub76of100,test4pub54of100,100,193,11,375,0,386
test4sub98of100,test4pub54of100,100,193,11,376,1,388
test4sub48of100,test4pub54of100,100,193,11,396,0,407
test4sub26of100,test4pub54of100,100,193,11,398,1,410
test4sub37of100,test4pub54of100,100,193,11,404,1,416
test4sub27of100,test4pub45of100,100,193,20,2553,0,2573
test4sub71of100,test4pub48of100,100,193,10,1628,1,1639
test4sub27of100,test4pub46of100,100,193,12,2204,1,2217
test4sub71of100,test4pub49of100,100,193,11,1432,1,1444
test4sub27of100,test4pub47of100,100,193,10,1791,0,1801
test4sub71of100,test4pub50of100,100,193,17,1261,1,1279
test4sub27of100,test4pub48of100,100,193,10,1632,1,1643
test4sub27of100,test4pub49of100,100,193,11,1436,2,1449
test4sub59of100,test4pub44of100,100,193,17,2689,1,2707
test4sub27of100,test4pub50of100,100,193,17,1267,1,1285
test4sub59of100,test4pub45of100,100,193,20,2562,1,2583
test4sub59of100,test4pub46of100,100,193,12,2214,1,2227
test4sub27of100,test4pub51of100,100,193,16,1099,4,1119
test4sub36of100,test4pub46of100,100,193,12,2215,3,2230
test4sub83of100,test4pub54of100,100,193,11,420,3,434
test4sub59of100,test4pub47of100,100,193,10,1801,4,1815
test4sub51of100,test4pub45of100,100,193,20,2566,4,2590
test4sub27of100,test4pub52of100,100,193,10,957,3,970
test4sub36of100,test4pub47of100,100,193,10,1805,3,1818
test4sub59of100,test4pub48of100,100,193,10,1645,3,1658
test4sub32of100,test4pub43of100,100,193,28,2847,3,2878
test4sub51of100,test4pub46of100,100,193,12,2222,3,2237
test4sub27of100,test4pub53of100,100,193,10,593,3,606
test4sub36of100,test4pub48of100,100,193,10,1648,3,1661
test4sub59of100,test4pub49of100,100,193,11,1452,3,1466
test4sub32of100,test4pub44of100,100,193,17,2704,4,2725
test4sub51of100,test4pub47of100,100,193,10,1811,3,1824
test4sub36of100,test4pub49of100,100,193,11,1454,2,1467
test4sub32of100,test4pub45of100,100,193,20,2579,3,2602
test4sub36of100,test4pub50of100,100,193,17,1286,1,1304
test4sub51of100,test4pub48of100,100,193,10,1654,2,1666
test4sub32of100,test4pub46of100,100,193,12,2232,1,2245
test4sub51of100,test4pub49of100,100,193,11,1460,1,1472
test4sub32of100,test4pub47of100,100,193,10,1819,1,1830
test4sub51of100,test4pub50of100,100,193,17,1290,0,1307
test4sub32of100,test4pub48of100,100,193,10,1660,0,1670
test4sub51of100,test4pub51of100,100,193,16,1122,1,1139
test4sub32of100,test4pub49of100,100,193,11,1465,1,1477
test4sub51of100,test4pub52of100,100,193,10,977,0,987
test4sub31of100,test4pub42of100,100,193,31,3008,1,3040
test4sub32of100,test4pub50of100,100,193,17,1295,1,1313
test4sub31of100,test4pub43of100,100,193,28,2868,1,2897
test4sub31of100,test4pub44of100,100,193,17,2722,1,2740
test4sub51of100,test4pub53of100,100,193,10,613,0,623
test4sub31of100,test4pub45of100,100,193,20,2595,0,2615
test4sub31of100,test4pub46of100,100,193,12,2247,1,2260
test4sub31of100,test4pub47of100,100,193,10,1833,1,1844
test4sub23of100,test4pub36of100,100,193,10,4237,1,4248
test4sub31of100,test4pub48of100,100,193,10,1674,0,1684
test4sub23of100,test4pub37of100,100,193,23,3878,1,3902
test4sub31of100,test4pub49of100,100,193,11,1479,1,1491
test4sub23of100,test4pub38of100,100,193,31,3620,1,3652
test4sub31of100,test4pub50of100,100,193,17,1308,1,1326
test4sub23of100,test4pub39of100,100,193,28,3473,6,3507
test4sub31of100,test4pub51of100,100,193,16,1140,7,1163
test4sub52of100,test4pub55of100,100,193,10,196,3,209
test4sub58of100,test4pub54of100,100,193,11,465,3,479
test4sub23of100,test4pub40of100,100,193,49,3301,2,3352
test4sub31of100,test4pub52of100,100,193,10,1002,3,1015
test4sub95of100,test4pub54of100,100,193,11,469,2,482
test4sub23of100,test4pub41of100,100,193,27,3179,1,3207
test4sub23of100,test4pub42of100,100,193,31,3036,0,3067
test4sub23of100,test4pub43of100,100,193,28,2897,1,2926
test4sub23of100,test4pub44of100,100,193,17,2750,0,2767
test4sub23of100,test4pub45of100,100,193,20,2623,1,2644
test4sub23of100,test4pub46of100,100,193,12,2274,0,2286
test4sub23of100,test4pub47of100,100,193,10,1861,1,1872
test4sub3of100,test4pub54of100,100,193,11,480,1,492
test4sub80of100,test4pub54of100,100,193,11,484,0,495
test4sub14of100,test4pub55of100,100,193,10,220,1,231
test4sub63of100,test4pub55of100,100,193,10,230,1,241
test4sub15of100,test4pub55of100,100,193,10,231,0,241
test4sub87of100,test4pub55of100,100,193,10,236,1,247
test4sub6of100,test4pub55of100,100,193,10,235,1,246
test4sub33of100,test4pub55of100,100,193,10,240,1,251
test4sub40of100,test4pub55of100,100,193,10,242,1,253
test4sub98of100,test4pub55of100,100,193,10,243,1,254
test4sub68of100,test4pub42of100,100,193,31,3079,0,3110
test4sub68of100,test4pub43of100,100,193,28,2940,1,2969
test4sub68of100,test4pub44of100,100,193,17,2793,1,2811
test4sub68of100,test4pub45of100,100,193,20,2665,1,2686
test4sub68of100,test4pub46of100,100,193,12,2317,0,2329
test4sub48of100,test4pub55of100,100,193,10,254,2,266
test4sub68of100,test4pub47of100,100,193,10,1904,2,1916
test4sub26of100,test4pub55of100,100,193,10,255,2,267
test4sub68of100,test4pub48of100,100,193,10,1745,1,1756
test4sub68of100,test4pub49of100,100,193,11,1550,0,1561
test4sub68of100,test4pub50of100,100,193,17,1380,1,1398
test4sub68of100,test4pub51of100,100,193,16,1211,0,1227
test4sub68of100,test4pub52of100,100,193,10,1067,1,1078
test4sub37of100,test4pub55of100,100,193,10,265,1,276
test4sub68of100,test4pub53of100,100,193,10,699,0,709
test4sub68of100,test4pub54of100,100,193,11,536,1,548
test4sub68of100,test4pub55of100,100,193,10,269,1,280
test4sub27of100,test4pub54of100,100,193,11,540,0,551
test4sub27of100,test4pub55of100,100,193,10,274,1,285
test4sub59of100,test4pub50of100,100,193,17,1412,2,1431
test4sub83of100,test4pub55of100,100,193,10,294,3,307
test4sub59of100,test4pub51of100,100,193,16,1245,2,1263
test4sub36of100,test4pub51of100,100,193,16,1245,2,1263
test4sub31of100,test4pub53of100,100,193,10,731,2,743
test4sub59of100,test4pub52of100,100,193,10,1101,1,1112
test4sub36of100,test4pub52of100,100,193,10,1101,2,1113
test4sub31of100,test4pub54of100,100,193,11,568,1,580
test4sub59of100,test4pub53of100,100,193,10,734,2,746
test4sub36of100,test4pub53of100,100,193,10,735,1,746
test4sub31of100,test4pub55of100,100,193,10,302,1,313
test4sub59of100,test4pub54of100,100,193,11,571,0,582
test4sub59of100,test4pub55of100,100,193,10,305,1,316
test4sub23of100,test4pub48of100,100,193,10,1794,1,1805
test4sub23of100,test4pub49of100,100,193,11,1599,1,1611
test4sub23of100,test4pub50of100,100,193,17,1428,1,1446
test4sub23of100,test4pub51of100,100,193,16,1260,1,1277
test4sub23of100,test4pub52of100,100,193,10,1115,0,1125
test4sub23of100,test4pub53of100,100,193,10,748,1,759
test4sub23of100,test4pub54of100,100,193,11,583,1,595
test4sub23of100,test4pub55of100,100,193,10,316,0,326
test4sub95of100,test4pub55of100,100,193,10,316,1,327
test4sub75of100,test4pub48of100,100,193,10,1817,1,1828
test4sub75of100,test4pub49of100,100,193,11,1621,0,1632
test4sub75of100,test4pub50of100,100,193,17,1450,0,1467
test4sub75of100,test4pub51of100,100,193,16,1282,1,1299
test4sub75of100,test4pub52of100,100,193,10,1137,1,1148
test4sub75of100,test4pub53of100,100,193,10,769,0,779
test4sub3of100,test4pub55of100,100,193,10,354,0,364
test4sub80of100,test4pub55of100,100,193,10,358,0,368
test4sub84of100,test4pub1of100,100,12977,24,17926,43,17993
test4sub76of100,test4pub55of100,100,193,10,389,28,427
test4sub16of100,test4pub1of100,100,12977,24,17951,62,18037
test4sub71of100,test4pub51of100,100,193,16,1351,59,1426
test4sub36of100,test4pub54of100,100,193,11,672,59,742
test4sub75of100,test4pub54of100,100,193,11,679,51,741
test4sub58of100,test4pub55of100,100,193,10,413,50,473
test4sub84of100,test4pub4of100,100,192,11,16494,47,16552
test4sub41of100,test4pub24of100,100,193,19,10888,38,10945
test4sub60of100,test4pub54of100,100,193,11,699,35,745
test4sub71of100,test4pub52of100,100,193,10,1265,5,1280
test4sub16of100,test4pub2of100,100,192,10,17980,6,17996
test4sub36of100,test4pub55of100,100,193,10,463,4,477
test4sub75of100,test4pub55of100,100,193,10,463,5,478
test4sub84of100,test4pub5of100,100,192,14,15543,4,15561
test4sub41of100,test4pub25of100,100,193,16,10503,4,10523
test4sub71of100,test4pub53of100,100,193,10,901,4,915
test4sub60of100,test4pub55of100,100,193,10,467,4,481
test4sub16of100,test4pub3of100,100,192,28,17889,3,17920
test4sub41of100,test4pub26of100,100,193,10,10290,3,10303
test4sub84of100,test4pub6of100,100,192,26,15224,4,15254
test4sub71of100,test4pub54of100,100,193,11,739,3,753
test4sub16of100,test4pub4of100,100,192,11,16548,2,16561
test4sub84of100,test4pub7of100,100,192,14,14594,2,14610
test4sub71of100,test4pub55of100,100,193,10,475,1,486
test4sub16of100,test4pub5of100,100,192,14,15554,1,15569
test4sub84of100,test4pub8of100,100,192,12,14333,2,14347
test4sub16of100,test4pub6of100,100,192,26,15232,1,15259
test4sub16of100,test4pub7of100,100,192,14,14600,1,14615
test4sub84of100,test4pub9of100,100,192,20,14150,1,14171
test4sub16of100,test4pub8of100,100,192,12,14337,0,14349
test4sub84of100,test4pub10of100,100,193,11,13787,1,13799
test4sub84of100,test4pub11of100,100,193,10,13552,1,13563
test4sub16of100,test4pub9of100,100,192,20,14154,1,14175
test4sub84of100,test4pub12of100,100,193,11,13109,1,13121
test4sub16of100,test4pub10of100,100,193,11,13791,1,13803
test4sub84of100,test4pub13of100,100,193,10,12907,0,12917
test4sub16of100,test4pub11of100,100,193,10,13555,1,13566
test4sub16of100,test4pub12of100,100,193,11,13113,1,13125
test4sub84of100,test4pub14of100,100,193,10,12741,1,12752
test4sub16of100,test4pub13of100,100,193,10,12910,3,12923
test4sub84of100,test4pub15of100,100,193,11,12604,3,12618
test4sub16of100,test4pub14of100,100,193,10,12746,0,12756
test4sub84of100,test4pub16of100,100,193,10,12449,0,12459
test4sub16of100,test4pub15of100,100,193,11,12609,1,12621
test4sub16of100,test4pub16of100,100,193,10,12452,7,12469
test4sub84of100,test4pub17of100,100,193,11,12316,2,12329
test4sub16of100,test4pub17of100,100,193,11,12325,2,12338
test4sub84of100,test4pub18of100,100,193,18,12141,3,12162
test4sub16of100,test4pub18of100,100,193,18,12142,2,12162
test4sub84of100,test4pub19of100,100,193,11,11934,2,11947
test4sub16of100,test4pub19of100,100,193,11,11936,2,11949
test4sub84of100,test4pub20of100,100,193,10,11495,2,11507
test4sub16of100,test4pub20of100,100,193,10,11497,2,11509
test4sub16of100,test4pub21of100,100,193,10,11412,1,11423
test4sub84of100,test4pub21of100,100,193,10,11411,3,11424
test4sub16of100,test4pub22of100,100,193,10,11282,2,11294
test4sub84of100,test4pub22of100,100,193,10,11283,2,11295
test4sub16of100,test4pub23of100,100,193,11,11112,2,11125
test4sub84of100,test4pub23of100,100,193,11,11113,2,11126
test4sub16of100,test4pub24of100,100,193,19,10985,2,11006
test4sub84of100,test4pub24of100,100,193,19,10987,2,11008
test4sub16of100,test4pub25of100,100,193,16,10565,2,10583
test4sub84of100,test4pub25of100,100,193,16,10567,11,10594
test4sub11of100,test4pub1of100,100,12977,24,18082,51,18157
test4sub20of100,test4pub27of100,100,193,10,10036,44,10090
test4sub84of100,test4pub26of100,100,193,10,10360,42,10412
test4sub8of100,test4pub45of100,100,193,20,2961,35,3016
test4sub16of100,test4pub26of100,100,193,10,10372,32,10414
test4sub7of100,test4pub55of100,100,193,10,556,28,594
test4sub22of100,test4pub45of100,100,193,20,2975,23,3018
test4sub11of100,test4pub2of100,100,192,10,18101,4,18115
test4sub20of100,test4pub28of100,100,193,10,9978,4,9992
test4sub84of100,test4pub27of100,100,193,10,10081,3,10094
test4sub16of100,test4pub27of100,100,193,10,10082,3,10095
test4sub11of100,test4pub3of100,100,192,28,18007,2,18037
test4sub20of100,test4pub29of100,100,193,11,9816,2,9829
test4sub84of100,test4pub28of100,100,193,10,9984,3,9997
test4sub16of100,test4pub28of100,100,193,10,9984,3,9997
test4sub11of100,test4pub4of100,100,192,11,16665,2,16678
test4sub20of100,test4pub30of100,100,193,15,9682,3,9700
test4sub16of100,test4pub29of100,100,193,11,9821,2,9834
test4sub84of100,test4pub29of100,100,193,11,9821,2,9834
test4sub20of100,test4pub31of100,100,193,10,9552,3,9565
test4sub16of100,test4pub30of100,100,193,15,9688,2,9705
test4sub11of100,test4pub5of100,100,192,14,15671,3,15688
test4sub84of100,test4pub30of100,100,193,15,9688,2,9705
test4sub20of100,test4pub32of100,100,193,11,9202,2,9215
test4sub16of100,test4pub31of100,100,193,10,9556,3,9569
test4sub84of100,test4pub31of100,100,193,10,9558,2,9570
test4sub11of100,test4pub6of100,100,192,26,15352,3,15381
test4sub20of100,test4pub33of100,100,193,11,9063,3,9077
test4sub16of100,test4pub32of100,100,193,11,9207,1,9219
test4sub84of100,test4pub32of100,100,193,11,9208,2,9221
test4sub11of100,test4pub7of100,100,192,14,14722,2,14738
test4sub20of100,test4pub34of100,100,193,12,8286,2,8300
test4sub16of100,test4pub33of100,100,193,11,9068,3,9082
test4sub84of100,test4pub33of100,100,193,11,9069,2,9082
test4sub11of100,test4pub8of100,100,192,12,14461,2,14475
test4sub20of100,test4pub35of100,100,193,12,5934,2,5948
test4sub84of100,test4pub34of100,100,193,12,8291,1,8304
test4sub20of100,test4pub36of100,100,193,10,4661,1,4672
test4sub84of100,test4pub35of100,100,193,12,5937,1,5950
test4sub20of100,test4pub37of100,100,193,23,4302,1,4326
test4sub38of100,test4pub55of100,100,193,10,611,1,622
test4sub84of100,test4pub36of100,100,193,10,4663,3,4676
test4sub41of100,test4pub27of100,100,193,10,10112,1,10123
test4sub20of100,test4pub38of100,100,193,31,4044,4,4079
test4sub84of100,test4pub37of100,100,193,23,4307,2,4332
test4sub41of100,test4pub28of100,100,193,10,10012,1,10023
test4sub41of100,test4pub29of100,100,193,11,9849,1,9861
test4sub20of100,test4pub39of100,100,193,28,3900,1,3929
test4sub41of100,test4pub30of100,100,193,15,9713,1,9729
test4sub20of100,test4pub40of100,100,193,49,3722,2,3773
test4sub41of100,test4pub31of100,100,193,10,9581,1,9592
test4sub11of100,test4pub9of100,100,192,20,14289,3,14312
test4sub41of100,test4pub32of100,100,193,11,9229,1,9241
test4sub11of100,test4pub10of100,100,193,11,13930,2,13943
test4sub20of100,test4pub41of100,100,193,27,3599,2,3628
test4sub41of100,test4pub33of100,100,193,11,9089,2,9102
test4sub20of100,test4pub42of100,100,193,31,3460,1,3492
test4sub41of100,test4pub34of100,100,193,12,8311,0,8323
test4sub11of100,test4pub11of100,100,193,10,13695,1,13706
test4sub11of100,test4pub12of100,100,193,11,13255,1,13267
test4sub20of100,test4pub43of100,100,193,28,3320,1,3349
test4sub41of100,test4pub35of100,100,193,12,5958,2,5972
test4sub11of100,test4pub13of100,100,193,10,13052,1,13063
test4sub20of100,test4pub44of100,100,193,17,3175,2,3194
test4sub41of100,test4pub36of100,100,193,10,4686,1,4697
test4sub11of100,test4pub14of100,100,193,10,12887,1,12898
test4sub20of100,test4pub45of100,100,193,20,3049,1,3070
test4sub41of100,test4pub37of100,100,193,23,4326,1,4350
test4sub11of100,test4pub15of100,100,193,11,12750,2,12763
test4sub20of100,test4pub46of100,100,193,12,2702,1,2715
test4sub11of100,test4pub16of100,100,193,10,12595,0,12605
test4sub20of100,test4pub47of100,100,193,10,2289,4,2303
test4sub11of100,test4pub17of100,100,193,11,12462,5,12478
test4sub20of100,test4pub48of100,100,193,10,2134,1,2145
test4sub20of100,test4pub49of100,100,193,11,1938,0,1949
test4sub20of100,test4pub50of100,100,193,17,1768,1,1786
test4sub20of100,test4pub51of100,100,193,16,1599,1,1616
test4sub16of100,test4pub34of100,100,193,12,8334,1,8347
test4sub20of100,test4pub52of100,100,193,10,1454,1,1465
test4sub16of100,test4pub35of100,100,193,12,5981,1,5994
test4sub20of100,test4pub53of100,100,193,10,1087,0,1097
test4sub20of100,test4pub54of100,100,193,11,922,1,934
test4sub16of100,test4pub36of100,100,193,10,4706,1,4717
test4sub16of100,test4pub37of100,100,193,23,4347,0,4370
test4sub20of100,test4pub55of100,100,193,10,656,1,667
test4sub16of100,test4pub38of100,100,193,31,4089,1,4121
test4sub16of100,test4pub39of100,100,193,28,3949,1,3978
test4sub16of100,test4pub40of100,100,193,49,3770,0,3819
test4sub16of100,test4pub41of100,100,193,27,3646,1,3674
test4sub16of100,test4pub42of100,100,193,31,3503,0,3534
test4sub16of100,test4pub43of100,100,193,28,3364,1,3393
test4sub96of100,test4pub45of100,100,193,20,3088,1,3109
test4sub16of100,test4pub44of100,100,193,17,3217,1,3235
test4sub84of100,test4pub38of100,100,193,31,4108,1,4140
test4sub84of100,test4pub39of100,100,193,28,3960,1,3989
test4sub84of100,test4pub40of100,100,193,49,3781,0,3830
test4sub84of100,test4pub41of100,100,193,27,3657,0,3684
test4sub84of100,test4pub42of100,100,193,31,3515,1,3547
test4sub84of100,test4pub43of100,100,193,28,3379,0,3407
test4sub34of100,test4pub44of100,100,193,17,3233,1,3251
test4sub84of100,test4pub44of100,100,193,17,3232,1,3250
test4sub84of100,test4pub45of100,100,193,20,3106,1,3127
test4sub73of100,test4pub54of100,100,193,11,960,1,972
test4sub34of100,test4pub46of100,100,193,12,2755,2,2769
test4sub34of100,test4pub47of100,100,193,10,2343,0,2353
test4sub84of100,test4pub46of100,100,193,12,2780,1,2793
test4sub84of100,test4pub47of100,100,193,10,2367,1,2378
test4sub41of100,test4pub38of100,100,193,31,4149,1,4181
test4sub41of100,test4pub39of100,100,193,28,4002,1,4031
test4sub84of100,test4pub48of100,100,193,10,2208,1,2219
test4sub11of100,test4pub18of100,100,193,18,12357,1,12376
test4sub41of100,test4pub40of100,100,193,49,3823,2,3874
test4sub11of100,test4pub19of100,100,193,11,12149,1,12161
test4sub11of100,test4pub20of100,100,193,10,11708,0,11718
test4sub11of100,test4pub21of100,100,193,10,11623,1,11634
test4sub85of100,test4pub54of100,100,193,11,995,1,1007
test4sub11of100,test4pub22of100,100,193,10,11492,2,11504
test4sub8of100,test4pub46of100,100,193,12,2793,2,2807
test4sub85of100,test4pub55of100,100,193,10,730,1,741
test4sub11of100,test4pub23of100,100,193,11,11322,3,11336
test4sub8of100,test4pub47of100,100,193,10,2381,2,2393
test4sub16of100,test4pub45of100,100,193,20,3147,3,3170
test4sub11of100,test4pub24of100,100,193,19,11195,1,11215
test4sub8of100,test4pub48of100,100,193,10,2223,2,2235
test4sub16of100,test4pub46of100,100,193,12,2800,1,2813
test4sub11of100,test4pub25of100,100,193,16,10775,2,10793
test4sub8of100,test4pub49of100,100,193,11,2029,2,2042
test4sub16of100,test4pub47of100,100,193,10,2387,1,2398
test4sub8of100,test4pub50of100,100,193,17,1859,0,1876
test4sub8of100,test4pub51of100,100,193,16,1690,0,1706
test4sub8of100,test4pub52of100,100,193,10,1546,1,1557
test4sub8of100,test4pub53of100,100,193,10,1178,1,1189
test4sub8of100,test4pub54of100,100,193,11,1013,3,1027
test4sub8of100,test4pub55of100,100,193,10,750,1,761
test4sub16of100,test4pub48of100,100,193,10,2243,0,2253
test4sub16of100,test4pub49of100,100,193,11,2048,1,2060
test4sub16of100,test4pub50of100,100,193,17,1878,1,1896
test4sub16of100,test4pub51of100,100,193,16,1709,0,1725
test4sub16of100,test4pub52of100,100,193,10,1565,1,1576
test4sub22of100,test4pub47of100,100,193,10,2412,1,2423
test4sub16of100,test4pub53of100,100,193,10,1197,1,1208
test4sub22of100,test4pub46of100,100,193,12,2829,1,2842
test4sub16of100,test4pub54of100,100,193,11,1033,1,1045
test4sub22of100,test4pub48of100,100,193,10,2255,1,2266
test4sub16of100,test4pub55of100,100,193,10,767,1,778
test4sub22of100,test4pub49of100,100,193,11,2059,0,2070
test4sub22of100,test4pub50of100,100,193,17,1889,1,1907
test4sub22of100,test4pub51of100,100,193,16,1731,1,1748
test4sub22of100,test4pub52of100,100,193,10,1587,0,1597
test4sub22of100,test4pub53of100,100,193,10,1219,0,1229
test4sub22of100,test4pub54of100,100,193,11,1055,1,1067
test4sub22of100,test4pub55of100,100,193,10,788,0,798
test4sub84of100,test4pub49of100,100,193,11,2085,0,2096
test4sub84of100,test4pub50of100,100,193,17,1915,1,1933
test4sub84of100,test4pub51of100,100,193,16,1746,1,1763
test4sub84of100,test4pub52of100,100,193,10,1611,1,1622
test4sub84of100,test4pub53of100,100,193,10,1243,0,1253
test4sub84of100,test4pub54of100,100,193,11,1078,1,1090
test4sub84of100,test4pub55of100,100,193,10,812,1,823
test4sub34of100,test4pub48of100,100,193,10,2307,1,2318
test4sub34of100,test4pub49of100,100,193,11,2111,0,2122
test4sub34of100,test4pub50of100,100,193,17,1940,0,1957
test4sub34of100,test4pub51of100,100,193,16,1777,0,1793
test4sub34of100,test4pub52of100,100,193,10,1633,1,1644
test4sub34of100,test4pub53of100,100,193,10,1265,1,1276
test4sub41of100,test4pub41of100,100,193,27,3818,1,3846
test4sub41of100,test4pub42of100,100,193,31,3675,0,3706
test4sub41of100,test4pub43of100,100,193,28,3536,1,3565
test4sub41of100,test4pub44of100,100,193,17,3389,0,3406
test4sub41of100,test4pub45of100,100,193,20,3262,1,3283
test4sub11of100,test4pub26of100,100,193,10,10677,1,10688
test4sub11of100,test4pub27of100,100,193,10,10357,1,10368
test4sub11of100,test4pub28of100,100,193,10,10256,0,10266
test4sub11of100,test4pub29of100,100,193,11,10107,0,10118
test4sub11of100,test4pub30of100,100,193,15,9972,1,9988
test4sub11of100,test4pub31of100,100,193,10,9839,0,9849
test4sub11of100,test4pub32of100,100,193,11,9488,1,9500
test4sub11of100,test4pub33of100,100,193,11,9347,1,9359
test4sub11of100,test4pub34of100,100,193,12,8567,0,8579
test4sub11of100,test4pub35of100,100,193,12,6213,0,6225
test4sub11of100,test4pub36of100,100,193,10,4939,1,4950
test4sub77of100,test4pub50of100,100,193,17,2028,0,2045
test4sub77of100,test4pub51of100,100,193,16,1860,1,1877
test4sub46of100,test4pub32of100,100,193,11,9517,0,9528
test4sub77of100,test4pub52of100,100,193,10,1715,1,1726
test4sub46of100,test4pub33of100,100,193,11,9377,1,9389
test4sub44of100,test4pub44of100,100,193,17,3466,1,3484
test4sub44of100,test4pub45of100,100,193,20,3339,1,3360
test4sub44of100,test4pub46of100,100,193,12,2990,0,3002
test4sub100of100,test4pub47of100,100,193,10,2583,1,2594
test4sub100of100,test4pub48of100,100,193,10,2423,0,2433
test4sub100of100,test4pub49of100,100,193,11,2228,0,2239
test4sub47of100,test4pub55of100,100,193,10,939,0,949
test4sub100of100,test4pub50of100,100,193,17,2058,1,2076
test4sub100of100,test4pub51of100,100,193,16,1890,1,1907
test4sub4of100,test4pub44of100,100,193,17,3485,0,3502
test4sub4of100,test4pub45of100,100,193,20,3357,1,3378
test4sub4of100,test4pub46of100,100,193,12,3009,1,3022
test4sub91of100,test4pub35of100,100,193,12,6340,1,6353
test4sub91of100,test4pub36of100,100,193,10,5065,0,5075
test4sub65of100,test4pub55of100,100,193,10,1016,1,1027
test4sub43of100,test4pub54of100,100,193,11,1292,1,1304
test4sub75of100,test4pub56of100,100,193,11,137,1,149
test4sub63of100,test4pub56of100,100,193,11,138,1,150
test4sub33of100,test4pub56of100,100,193,11,157,0,168
test4sub15of100,test4pub56of100,100,193,11,158,0,169
test4sub27of100,test4pub56of100,100,193,11,159,0,170
test4sub12of100,test4pub35of100,100,193,12,6398,1,6411
test4sub12of100,test4pub36of100,100,193,10,5124,1,5135
test4sub12of100,test4pub37of100,100,193,23,4764,0,4787
test4sub12of100,test4pub38of100,100,193,31,4506,1,4538
test4sub12of100,test4pub39of100,100,193,28,4358,1,4387
test4sub80of100,test4pub56of100,100,193,11,206,0,217
test4sub89of100,test4pub55of100,100,193,10,1105,1,1116
test4sub7of100,test4pub56of100,100,193,11,213,1,225
test4sub37of100,test4pub56of100,100,193,11,215,1,227
test4sub40of100,test4pub56of100,100,193,11,216,1,228
test4sub54of100,test4pub54of100,100,193,11,1379,0,1390
test4sub68of100,test4pub56of100,100,193,11,223,1,235
test4sub85of100,test4pub56of100,100,193,11,225,1,237
test4sub96of100,test4pub46of100,100,193,12,3184,0,3196
test4sub96of100,test4pub47of100,100,193,10,2771,1,2782
test4sub96of100,test4pub48of100,100,193,10,2611,1,2622
test4sub14of100,test4pub56of100,100,193,11,229,3,243
test4sub60of100,test4pub56of100,100,193,11,230,3,244
test4sub96of100,test4pub49of100,100,193,11,2416,3,2430
test4sub58of100,test4pub56of100,100,193,11,232,4,247
test4sub22of100,test4pub56of100,100,193,11,233,2,246
test4sub83of100,test4pub56of100,100,193,11,234,1,246
test4sub96of100,test4pub50of100,100,193,17,2248,2,2267
test4sub76of100,test4pub56of100,100,193,11,236,1,248
test4sub96of100,test4pub51of100,100,193,16,2080,1,2097
test4sub96of100,test4pub52of100,100,193,10,1936,1,1947
test4sub96of100,test4pub53of100,100,193,10,1568,0,1578
test4sub96of100,test4pub54of100,100,193,11,1404,1,1416
test4sub96of100,test4pub55of100,100,193,10,1137,1,1148
test4sub41of100,test4pub46of100,100,193,12,3209,1,3222
test4sub41of100,test4pub47of100,100,193,10,2795,0,2805
test4sub41of100,test4pub48of100,100,193,10,2636,1,2647
test4sub41of100,test4pub49of100,100,193,11,2440,0,2451
test4sub84of100,test4pub56of100,100,193,11,256,1,268
test4sub41of100,test4pub50of100,100,193,17,2270,0,2287
test4sub41of100,test4pub51of100,100,193,16,2102,1,2119
test4sub41of100,test4pub52of100,100,193,10,1957,0,1967
test4sub41of100,test4pub53of100,100,193,10,1589,0,1599
test4sub11of100,test4pub37of100,100,193,23,4852,1,4876
test4sub11of100,test4pub38of100,100,193,31,4594,1,4626
test4sub11of100,test4pub39of100,100,193,28,4446,1,4475
test4sub11of100,test4pub40of100,100,193,49,4268,1,4318
test4sub11of100,test4pub41of100,100,193,27,4144,1,4172
test4sub11of100,test4pub42of100,100,193,31,4001,0,4032
test4sub11of100,test4pub43of100,100,193,28,3861,1,3890
test4sub11of100,test4pub44of100,100,193,17,3715,1,3733
test4sub11of100,test4pub45of100,100,193,20,3587,0,3607
test4sub11of100,test4pub46of100,100,193,12,3239,1,3252
test4sub11of100,test4pub47of100,100,193,10,2825,1,2836
test4sub44of100,test4pub47of100,100,193,10,2825,1,2836
test4sub44of100,test4pub48of100,100,193,10,2666,1,2677
test4sub44of100,test4pub49of100,100,193,11,2470,0,2481
test4sub4of100,test4pub47of100,100,193,10,2830,1,2841
test4sub44of100,test4pub50of100,100,193,17,2300,1,2318
test4sub4of100,test4pub48of100,100,193,10,2670,1,2681
test4sub44of100,test4pub51of100,100,193,16,2132,1,2149
test4sub4of100,test4pub49of100,100,193,11,2475,1,2487
test4sub4of100,test4pub50of100,100,193,17,2305,1,2323
test4sub4of100,test4pub51of100,100,193,16,2136,0,2152
test4sub43of100,test4pub55of100,100,193,10,1211,0,1221
test4sub43of100,test4pub56of100,100,193,11,318,0,329
test4sub42of100,test4pub45of100,100,193,20,3633,0,3653
test4sub42of100,test4pub46of100,100,193,12,3285,1,3298
test4sub42of100,test4pub47of100,100,193,10,2871,1,2882
test4sub42of100,test4pub48of100,100,193,10,2711,0,2721
test4sub42of100,test4pub49of100,100,193,11,2516,1,2528
test4sub42of100,test4pub50of100,100,193,17,2345,1,2363
test4sub42of100,test4pub51of100,100,193,16,2176,0,2192
test4sub42of100,test4pub52of100,100,193,10,2031,0,2041
test4sub42of100,test4pub53of100,100,193,10,1664,1,1675
test4sub42of100,test4pub54of100,100,193,11,1499,0,1510
test4sub42of100,test4pub55of100,100,193,10,1232,1,1243
test4sub12of100,test4pub40of100,100,193,49,4335,0,4384
test4sub12of100,test4pub41of100,100,193,27,4211,1,4239
test4sub12of100,test4pub42of100,100,193,31,4068,1,4100
test4sub12of100,test4pub43of100,100,193,28,3929,1,3958
test4sub12of100,test4pub44of100,100,193,17,3782,0,3799
test4sub12of100,test4pub45of100,100,193,20,3655,1,3676
test4sub12of100,test4pub46of100,100,193,12,3306,1,3319
test4sub89of100,test4pub56of100,100,193,11,349,1,361
test4sub12of100,test4pub47of100,100,193,10,2893,1,2904
test4sub54of100,test4pub55of100,100,193,10,1246,1,1257
test4sub54of100,test4pub56of100,100,193,11,353,0,364
test4sub25of100,test4pub54of100,100,193,11,1518,0,1529
test4sub96of100,test4pub56of100,100,193,11,360,1,372
test4sub41of100,test4pub54of100,100,193,11,1533,0,1544
test4sub41of100,test4pub55of100,100,193,10,1266,0,1276
test4sub41of100,test4pub56of100,100,193,11,374,1,386
test4sub11of100,test4pub48of100,100,193,10,2761,1,2772
test4sub11of100,test4pub49of100,100,193,11,2565,0,2576
test4sub11of100,test4pub50of100,100,193,17,2394,0,2411
test4sub11of100,test4pub51of100,100,193,16,2227,1,2244
test4sub11of100,test4pub52of100,100,193,10,2082,1,2093
test4sub82of100,test4pub34of100,100,193,12,8970,1,8983
test4sub82of100,test4pub35of100,100,193,12,6617,1,6630
test4sub11of100,test4pub53of100,100,193,10,1723,0,1733
test4sub11of100,test4pub54of100,100,193,11,1559,1,1571
test4sub82of100,test4pub36of100,100,193,10,5342,1,5353
test4sub11of100,test4pub55of100,100,193,10,1292,1,1303
test4sub82of100,test4pub37of100,100,193,23,4984,2,5009
test4sub45of100,test4pub44of100,100,193,17,3837,1,3855
test4sub11of100,test4pub56of100,100,193,11,400,1,412
test4sub45of100,test4pub45of100,100,193,20,3710,2,3732
test4sub44of100,test4pub52of100,100,193,10,2100,1,2111
test4sub82of100,test4pub38of100,100,193,31,4726,3,4760
test4sub45of100,test4pub46of100,100,193,12,3362,2,3376
test4sub44of100,test4pub53of100,100,193,10,1733,3,1746
test4sub4of100,test4pub52of100,100,193,10,2102,3,2115
test4sub82of100,test4pub39of100,100,193,28,4583,3,4614
test4sub45of100,test4pub47of100,100,193,10,2950,3,2963
test4sub44of100,test4pub54of100,100,193,11,1570,3,1584
test4sub4of100,test4pub53of100,100,193,10,1737,3,1750
test4sub82of100,test4pub40of100,100,193,49,4406,2,4457
test4sub45of100,test4pub48of100,100,193,10,2793,3,2806
test4sub44of100,test4pub55of100,100,193,10,1306,3,1319
test4sub4of100,test4pub54of100,100,193,11,1575,3,1589
test4sub45of100,test4pub49of100,100,193,11,2600,3,2614
test4sub82of100,test4pub41of100,100,193,27,4284,2,4313
test4sub44of100,test4pub56of100,100,193,11,416,2,429
test4sub4of100,test4pub55of100,100,193,10,1311,3,1324
test4sub82of100,test4pub42of100,100,193,31,4145,2,4178
test4sub4of100,test4pub56of100,100,193,11,420,0,431
test4sub45of100,test4pub50of100,100,193,17,2431,2,2450
test4sub45of100,test4pub51of100,100,193,16,2265,0,2281
test4sub62of100,test4pub47of100,100,193,10,2965,1,2976
test4sub82of100,test4pub43of100,100,193,28,4006,3,4037
test4sub62of100,test4pub48of100,100,193,10,2806,1,2817
test4sub45of100,test4pub52of100,100,193,10,2121,1,2132
test4sub62of100,test4pub49of100,100,193,11,2611,1,2623
test4sub45of100,test4pub53of100,100,193,10,1754,0,1764
test4sub45of100,test4pub54of100,100,193,11,1590,1,1602
test4sub62of100,test4pub50of100,100,193,17,2441,1,2459
test4sub62of100,test4pub51of100,100,193,16,2272,1,2289
test4sub62of100,test4pub52of100,100,193,10,2128,1,2139
test4sub90of100,test4pub55of100,100,193,10,1338,1,1349
test4sub42of100,test4pub56of100,100,193,11,450,1,462
test4sub12of100,test4pub48of100,100,193,10,2833,0,2843
test4sub12of100,test4pub49of100,100,193,11,2637,1,2649
test4sub12of100,test4pub50of100,100,193,17,2467,1,2485
test4sub12of100,test4pub51of100,100,193,16,2298,1,2315
test4sub12of100,test4pub52of100,100,193,10,2154,1,2165
test4sub12of100,test4pub53of100,100,193,10,1786,0,1796
test4sub12of100,test4pub54of100,100,193,11,1622,1,1634
test4sub12of100,test4pub55of100,100,193,10,1355,1,1366
test4sub12of100,test4pub56of100,100,193,11,462,0,473
test4sub29of100,test4pub53of100,100,193,10,1800,2,1812
test4sub29of100,test4pub54of100,100,193,11,1636,1,1648
test4sub25of100,test4pub55of100,100,193,10,1371,1,1382
test4sub25of100,test4pub56of100,100,193,11,478,1,490
test4sub82of100,test4pub44of100,100,193,17,3916,0,3933
test4sub82of100,test4pub45of100,100,193,20,3788,1,3809
test4sub82of100,test4pub46of100,100,193,12,3440,1,3453
test4sub82of100,test4pub47of100,100,193,10,3026,0,3036
test4sub82of100,test4pub48of100,100,193,10,2867,1,2878
test4sub45of100,test4pub55of100,100,193,10,1380,1,1391
test4sub74of100,test4pub33of100,100,193,11,9845,1,9857
test4sub45of100,test4pub56of100,100,193,11,488,0,499
test4sub97of100,test4pub1of100,100,12977,24,19011,42,19077
test4sub79of100,test4pub1of100,100,12977,24,19023,69,19116
test4sub13of100,test4pub50of100,100,193,17,2603,56,2676
test4sub93of100,test4pub34of100,100,193,12,9174,51,9237
test4sub97of100,test4pub4of100,100,192,11,17578,40,17629
test4sub91of100,test4pub37of100,100,193,23,5195,39,5257
test4sub90of100,test4pub56of100,100,193,11,612,38,661
test4sub29of100,test4pub55of100,100,193,10,1519,25,1554
test4sub52of100,test4pub56of100,100,193,11,633,20,664
test4sub82of100,test4pub49of100,100,193,11,2830,8,2849
test4sub79of100,test4pub3of100,100,192,28,18962,8,18998
test4sub13of100,test4pub51of100,100,193,16,2490,9,2515
test4sub93of100,test4pub35of100,100,193,12,6870,7,6889
test4sub97of100,test4pub5of100,100,192,14,16621,9,16644
test4sub91of100,test4pub38of100,100,193,31,4975,7,5013
test4sub29of100,test4pub56of100,100,193,11,651,7,669
test4sub24of100,test4pub34of100,100,193,12,9229,7,9248
test4sub28of100,test4pub53of100,100,193,10,1981,8,1999
test4sub82of100,test4pub50of100,100,193,17,2668,6,2691
test4sub79of100,test4pub4of100,100,192,11,17625,8,17644
test4sub13of100,test4pub52of100,100,193,10,2353,6,2369
test4sub93of100,test4pub36of100,100,193,10,5603,7,5620
test4sub97of100,test4pub6of100,100,192,26,16306,6,16338
test4sub91of100,test4pub39of100,100,193,28,4834,7,4869
test4sub24of100,test4pub35of100,100,193,12,6882,7,6901
test4sub74of100,test4pub34of100,100,193,12,9237,7,9256
test4sub28of100,test4pub54of100,100,193,11,1823,6,1840
test4sub82of100,test4pub51of100,100,193,16,2505,7,2528
test4sub79of100,test4pub5of100,100,192,14,16635,5,16654
test4sub93of100,test4pub37of100,100,193,23,5249,6,5278
test4sub97of100,test4pub7of100,100,192,14,15680,5,15699
test4sub91of100,test4pub40of100,100,193,49,4662,6,4717
test4sub74of100,test4pub35of100,100,193,12,6889,5,6906
test4sub24of100,test4pub36of100,100,193,10,5613,6,5629
test4sub79of100,test4pub6of100,100,192,26,16317,4,16347
test4sub82of100,test4pub52of100,100,193,10,2366,6,2382
test4sub93of100,test4pub38of100,100,193,31,4996,4,5031
test4sub97of100,test4pub8of100,100,192,12,15422,6,15440
test4sub91of100,test4pub41of100,100,193,27,4542,5,4574
test4sub74of100,test4pub36of100,100,193,10,5619,7,5636
test4sub24of100,test4pub37of100,100,193,23,5259,5,5287
test4sub79of100,test4pub7of100,100,192,14,15689,7,15710
test4sub82of100,test4pub53of100,100,193,10,2004,6,2020
test4sub93of100,test4pub39of100,100,193,28,4853,7,4888
test4sub97of100,test4pub9of100,100,192,20,15243,6,15269
test4sub91of100,test4pub42of100,100,193,31,4404,6,4441
test4sub62of100,test4pub53of100,100,193,10,2007,7,2024
test4sub74of100,test4pub37of100,100,193,23,5265,6,5294
test4sub98of100,test4pub56of100,100,193,11,681,8,700
test4sub24of100,test4pub38of100,100,193,31,5007,8,5046
test4sub79of100,test4pub8of100,100,192,12,15432,7,15451
test4sub82of100,test4pub54of100,100,193,11,1846,8,1865
test4sub93of100,test4pub40of100,100,193,49,4680,8,4737
test4sub97of100,test4pub10of100,100,193,11,14885,8,14904
test4sub91of100,test4pub43of100,100,193,28,4271,8,4307
test4sub62of100,test4pub54of100,100,193,11,1849,7,1867
test4sub74of100,test4pub38of100,100,193,31,5012,8,5051
test4sub38of100,test4pub56of100,100,193,11,688,8,707
test4sub24of100,test4pub39of100,100,193,28,4866,6,4900
test4sub79of100,test4pub9of100,100,192,20,15256,7,15283
test4sub82of100,test4pub55of100,100,193,10,1586,6,1602
test4sub93of100,test4pub41of100,100,193,27,4562,6,4595
test4sub91of100,test4pub44of100,100,193,17,4131,6,4154
test4sub62of100,test4pub55of100,100,193,10,1590,6,1606
test4sub97of100,test4pub11of100,100,193,10,14657,6,14673
test4sub24of100,test4pub40of100,100,193,49,4693,6,4748
test4sub79of100,test4pub10of100,100,193,11,14898,7,14916
test4sub93of100,test4pub42of100,100,193,31,4426,6,4463
test4sub82of100,test4pub56of100,100,193,11,699,7,717
test4sub91of100,test4pub45of100,100,193,20,4009,5,4034
test4sub62of100,test4pub56of100,100,193,11,702,5,718
test4sub97of100,test4pub12of100,100,193,11,14222,5,14238
test4sub24of100,test4pub41of100,100,193,27,4575,5,4607
test4sub79of100,test4pub11of100,100,193,10,14668,4,14682
test4sub93of100,test4pub43of100,100,193,28,4292,5,4325
test4sub91of100,test4pub46of100,100,193,12,3666,4,3682
test4sub55of100,test4pub47of100,100,193,10,3252,4,3266
test4sub97of100,test4pub13of100,100,193,10,14024,4,14038
test4sub24of100,test4pub42of100,100,193,31,4436,4,4471
test4sub79of100,test4pub12of100,100,193,11,14230,5,14246
test4sub93of100,test4pub44of100,100,193,17,4149,4,4170
test4sub91of100,test4pub47of100,100,193,10,3256,5,3271
test4sub55of100,test4pub48of100,100,193,10,3096,4,3110
test4sub97of100,test4pub14of100,100,193,10,13861,4,13875
test4sub24of100,test4pub43of100,100,193,28,4301,5,4334
test4sub79of100,test4pub13of100,100,193,10,14031,5,14046
test4sub91of100,test4pub48of100,100,193,10,3100,4,3114
test4sub93of100,test4pub45of100,100,193,20,4026,5,4051
test4sub55of100,test4pub49of100,100,193,11,2904,3,2918
test4sub97of100,test4pub15of100,100,193,11,13728,5,13744
test4sub79of100,test4pub14of100,100,193,10,13868,3,13881
test4sub91of100,test4pub49of100,100,193,11,2907,3,2921
test4sub55of100,test4pub50of100,100,193,17,2737,3,2757
test4sub93of100,test4pub46of100,100,193,12,3681,4,3697
test4sub79of100,test4pub15of100,100,193,11,13733,3,13747
test4sub97of100,test4pub16of100,100,193,10,13575,4,13589
test4sub91of100,test4pub50of100,100,193,17,2740,3,2760
test4sub55of100,test4pub51of100,100,193,16,2570,5,2591
test4sub79of100,test4pub16of100,100,193,10,13579,3,13592
test4sub93of100,test4pub47of100,100,193,10,3272,4,3286
test4sub91of100,test4pub51of100,100,193,16,2574,3,2593
test4sub97of100,test4pub17of100,100,193,11,13445,4,13460
test4sub55of100,test4pub52of100,100,193,10,2429,2,2441
test4sub79of100,test4pub17of100,100,193,11,13447,3,13461
test4sub93of100,test4pub48of100,100,193,10,3116,3,3129
test4sub91of100,test4pub52of100,100,193,10,2431,3,2444
test4sub97of100,test4pub18of100,100,193,18,13265,2,13285
test4sub79of100,test4pub18of100,100,193,18,13266,2,13286
test4sub91of100,test4pub53of100,100,193,10,2066,2,2078
test4sub97of100,test4pub19of100,100,193,11,13057,2,13070
test4sub79of100,test4pub19of100,100,193,11,13058,2,13071
test4sub91of100,test4pub54of100,100,193,11,1902,1,1914
test4sub79of100,test4pub20of100,100,193,10,12619,1,12630
test4sub91of100,test4pub55of100,100,193,10,1637,1,1648
test4sub91of100,test4pub56of100,100,193,11,744,1,756
test4sub24of100,test4pub44of100,100,193,17,4186,1,4204
test4sub24of100,test4pub45of100,100,193,20,4059,1,4080
test4sub24of100,test4pub46of100,100,193,12,3710,0,3722
test4sub24of100,test4pub47of100,100,193,10,3297,1,3308
test4sub28of100,test4pub55of100,100,193,10,1649,0,1659
test4sub24of100,test4pub48of100,100,193,10,3137,2,3149
test4sub28of100,test4pub56of100,100,193,11,757,1,769
test4sub74of100,test4pub39of100,100,193,28,4941,1,4970
test4sub74of100,test4pub40of100,100,193,49,4762,0,4811
test4sub74of100,test4pub41of100,100,193,27,4638,1,4666
test4sub74of100,test4pub42of100,100,193,31,4495,0,4526
test4sub74of100,test4pub43of100,100,193,28,4356,1,4385
test4sub74of100,test4pub44of100,100,193,17,4209,1,4227
test4sub74of100,test4pub45of100,100,193,20,4084,0,4104
test4sub74of100,test4pub46of100,100,193,12,3736,1,3749
test4sub97of100,test4pub20of100,100,193,10,12656,0,12666
test4sub97of100,test4pub21of100,100,193,10,12571,1,12582
test4sub97of100,test4pub22of100,100,193,10,12442,1,12453
test4sub97of100,test4pub23of100,100,193,11,12271,1,12283
test4sub97of100,test4pub24of100,100,193,19,12142,0,12161
test4sub97of100,test4pub25of100,100,193,16,11732,1,11749
test4sub97of100,test4pub26of100,100,193,10,11515,1,11526
test4sub97of100,test4pub27of100,100,193,10,11195,1,11206
test4sub79of100,test4pub21of100,100,193,10,12594,0,12604
test4sub97of100,test4pub28of100,100,193,10,11095,1,11106
test4sub97of100,test4pub29of100,100,193,11,10930,1,10942
test4sub79of100,test4pub22of100,100,193,10,12464,1,12475
test4sub79of100,test4pub23of100,100,193,11,12293,1,12305
test4sub97of100,test4pub30of100,100,193,15,10794,1,10810
test4sub79of100,test4pub24of100,100,193,19,12164,0,12183
test4sub79of100,test4pub25of100,100,193,16,11743,1,11760
test4sub79of100,test4pub26of100,100,193,10,11526,1,11537
test4sub69of100,test4pub100of100,10,193,15,24458,0,24473
test4sub69of100,test4pub2of100,100,192,10,19227,0,19237
test4sub13of100,test4pub53of100,100,193,10,2161,1,2172
test4sub13of100,test4pub54of100,100,193,11,1996,0,2007
test4sub13of100,test4pub55of100,100,193,10,1730,1,1741
test4sub13of100,test4pub56of100,100,193,11,837,1,849
test4sub93of100,test4pub49of100,100,193,11,3076,1,3088
test4sub93of100,test4pub50of100,100,193,17,2906,1,2924
test4sub93of100,test4pub51of100,100,193,16,2737,0,2753
test4sub93of100,test4pub52of100,100,193,10,2597,0,2607
test4sub93of100,test4pub53of100,100,193,10,2230,1,2241
test4sub93of100,test4pub54of100,100,193,11,2065,1,2077
test4sub93of100,test4pub55of100,100,193,10,1799,1,1810
test4sub93of100,test4pub56of100,100,193,11,906,1,918
test4sub14of100,test4pub57of100,100,193,11,764,1,776
test4sub80of100,test4pub57of100,100,193,11,772,1,784
test4sub75of100,test4pub57of100,100,193,11,772,1,784
test4sub79of100,test4pub27of100,100,193,10,11310,1,11321
test4sub79of100,test4pub28of100,100,193,10,11209,0,11219
test4sub79of100,test4pub29of100,100,193,11,11044,1,11056
test4sub79of100,test4pub30of100,100,193,15,10909,1,10925
test4sub79of100,test4pub31of100,100,193,10,10776,0,10786
test4sub79of100,test4pub32of100,100,193,11,10425,1,10437
test4sub79of100,test4pub33of100,100,193,11,10284,1,10296
test4sub79of100,test4pub34of100,100,193,12,9504,0,9516
test4sub9of100,test4pub51of100,100,193,16,2773,0,2789
test4sub68of100,test4pub57of100,100,193,11,795,0,806
test4sub25of100,test4pub57of100,100,193,11,796,1,808
test4sub54of100,test4pub57of100,100,193,11,798,1,810
test4sub7of100,test4pub57of100,100,193,11,800,1,812
test4sub62of100,test4pub57of100,100,193,11,803,1,815
test4sub96of100,test4pub57of100,100,193,11,804,1,816
test4sub22of100,test4pub57of100,100,193,11,810,1,822
test4sub38of100,test4pub57of100,100,193,11,810,0,821
test4sub44of100,test4pub57of100,100,193,11,821,1,833
test4sub24of100,test4pub49of100,100,193,11,3156,1,3168
test4sub24of100,test4pub50of100,100,193,17,2985,0,3002
test4sub24of100,test4pub51of100,100,193,16,2816,0,2832
test4sub78of100,test4pub73of100,10,192,11,33976,1,33988
test4sub78of100,test4pub74of100,10,192,10,33350,0,33360
test4sub78of100,test4pub75of100,10,192,10,32668,1,32679
test4sub78of100,test4pub76of100,10,192,10,32502,0,32512
test4sub78of100,test4pub77of100,10,192,10,32043,1,32054
test4sub78of100,test4pub78of100,10,192,12,31977,1,31990
test4sub78of100,test4pub79of100,10,191,9,31899,0,31908
test4sub78of100,test4pub80of100,10,192,10,31502,1,31513
test4sub74of100,test4pub47of100,100,193,10,3539,0,3549
test4sub74of100,test4pub48of100,100,193,10,3380,1,3391
test4sub97of100,test4pub31of100,100,193,10,10852,1,10863
test4sub74of100,test4pub49of100,100,193,11,3184,2,3197
test4sub97of100,test4pub32of100,100,193,11,10501,1,10513
test4sub97of100,test4pub33of100,100,193,11,10360,0,10371
test4sub97of100,test4pub34of100,100,193,12,9580,1,9593
test4sub97of100,test4pub35of100,100,193,12,7227,1,7240
test4sub79of100,test4pub35of100,100,193,12,7228,0,7240
test4sub97of100,test4pub36of100,100,193,10,5953,1,5964
test4sub79of100,test4pub36of100,100,193,10,5954,1,5965
test4sub97of100,test4pub37of100,100,193,23,5593,1,5617
test4sub97of100,test4pub38of100,100,193,31,5335,1,5367
test4sub79of100,test4pub37of100,100,193,23,5594,1,5618
test4sub97of100,test4pub39of100,100,193,28,5187,0,5215
test4sub97of100,test4pub40of100,100,193,49,5009,1,5059
test4sub97of100,test4pub41of100,100,193,27,4884,0,4911
test4sub13of100,test4pub57of100,100,193,11,877,0,888
test4sub79of100,test4pub38of100,100,193,31,5403,1,5435
test4sub79of100,test4pub39of100,100,193,28,5256,1,5285
test4sub79of100,test4pub40of100,100,193,49,5077,1,5127
test4sub79of100,test4pub41of100,100,193,27,4953,1,4981
test4sub79of100,test4pub42of100,100,193,31,4810,0,4841
test4sub79of100,test4pub43of100,100,193,28,4671,1,4700
test4sub79of100,test4pub44of100,100,193,17,4524,1,4542
test4sub79of100,test4pub45of100,100,193,20,4396,1,4417
test4sub50of100,test4pub54of100,100,193,11,2251,1,2263
test4sub55of100,test4pub53of100,100,193,10,2419,1,2430
test4sub55of100,test4pub54of100,100,193,11,2254,0,2265
test4sub55of100,test4pub55of100,100,193,10,1988,1,1999
test4sub55of100,test4pub56of100,100,193,11,1095,1,1107
test4sub86of100,test4pub48of100,100,193,10,3481,1,3492
test4sub86of100,test4pub49of100,100,193,11,3285,0,3296
test4sub86of100,test4pub50of100,100,193,17,3114,1,3132
test4sub34of100,test4pub54of100,100,193,11,2264,1,2276
test4sub86of100,test4pub51of100,100,193,16,2946,1,2963
test4sub34of100,test4pub55of100,100,193,10,1998,1,2009
test4sub86of100,test4pub52of100,100,193,10,2802,1,2813
test4sub34of100,test4pub56of100,100,193,11,1106,1,1118
test4sub86of100,test4pub53of100,100,193,10,2435,0,2445
test4sub86of100,test4pub54of100,100,193,11,2270,0,2281
test4sub86of100,test4pub55of100,100,193,10,2004,1,2015
test4sub86of100,test4pub56of100,100,193,11,1111,1,1123
test4sub26of100,test4pub56of100,100,193,11,1117,1,1129
test4sub23of100,test4pub56of100,100,193,11,1118,0,1129
test4sub6of100,test4pub56of100,100,193,11,1123,1,1135
test4sub79of100,test4pub46of100,100,193,12,4085,2,4099
test4sub27of100,test4pub57of100,100,193,11,984,1,996
test4sub79of100,test4pub47of100,100,193,10,3672,0,3682
test4sub79of100,test4pub48of100,100,193,10,3513,1,3524
test4sub74of100,test4pub50of100,100,193,17,3382,1,3400
test4sub74of100,test4pub51of100,100,193,16,3214,0,3230
test4sub74of100,test4pub52of100,100,193,10,3069,1,3080
test4sub74of100,test4pub53of100,100,193,10,2719,0,2729
test4sub74of100,test4pub54of100,100,193,11,2555,2,2568
test4sub97of100,test4pub42of100,100,193,31,5120,0,5151
test4sub97of100,test4pub43of100,100,193,28,4980,0,5008
test4sub74of100,test4pub55of100,100,193,10,2289,1,2300
test4sub74of100,test4pub56of100,100,193,11,1397,0,1408
test4sub74of100,test4pub57of100,100,193,11,1255,1,1267
test4sub97of100,test4pub44of100,100,193,17,4840,1,4858
test4sub97of100,test4pub45of100,100,193,20,4713,1,4734
test4sub97of100,test4pub46of100,100,193,12,4364,0,4376
test4sub97of100,test4pub47of100,100,193,10,3954,1,3965
test4sub97of100,test4pub48of100,100,193,10,3794,0,3804
test4sub97of100,test4pub49of100,100,193,11,3599,1,3611
test4sub97of100,test4pub50of100,100,193,17,3438,1,3456
test4sub97of100,test4pub51of100,100,193,16,3270,0,3286
test4sub97of100,test4pub52of100,100,193,10,3125,0,3135
test4sub97of100,test4pub53of100,100,193,10,2766,1,2777
test4sub97of100,test4pub54of100,100,193,11,2601,0,2612
test4sub69of100,test4pub1of100,100,12977,24,19894,291,20209
test4sub81of100,test4pub83of100,10,192,10,31550,275,31835
test4sub79of100,test4pub49of100,100,193,11,3759,166,3936
test4sub9of100,test4pub52of100,100,193,10,3284,153,3447
test4sub55of100,test4pub57of100,100,193,11,1445,153,1609
test4sub86of100,test4pub57of100,100,193,11,1447,150,1608
test4sub19of100,test4pub89of100,10,192,39,27796,149,27984
test4sub34of100,test4pub57of100,100,193,11,1473,126,1610
test4sub26of100,test4pub57of100,100,193,11,1525,74,1610
test4sub13of100,test4pub58of100,100,193,11,574,60,645
test4sub23of100,test4pub57of100,100,193,11,1542,59,1612
test4sub6of100,test4pub57of100,100,193,11,1563,38,1612
test4sub69of100,test4pub3of100,100,192,28,20054,6,20088
test4sub81of100,test4pub84of100,10,192,11,31346,6,31363
test4sub79of100,test4pub50of100,100,193,17,3754,5,3776
test4sub9of100,test4pub53of100,100,193,10,3069,6,3085
test4sub19of100,test4pub90of100,10,192,23,27785,5,27813
test4sub69of100,test4pub4of100,100,192,11,18716,3,18730
test4sub81of100,test4pub85of100,10,192,23,29820,4,29847
test4sub79of100,test4pub51of100,100,193,16,3591,3,3610
test4sub9of100,test4pub54of100,100,193,11,2910,3,2924
test4sub19of100,test4pub91of100,10,192,26,27627,3,27656
test4sub69of100,test4pub5of100,100,192,14,17722,3,17739
test4sub81of100,test4pub86of100,10,192,21,29398,2,29421
test4sub79of100,test4pub52of100,100,193,10,3448,3,3461
test4sub9of100,test4pub55of100,100,193,10,2646,2,2658
test4sub81of100,test4pub87of100,10,192,10,29170,2,29182
test4sub69of100,test4pub6of100,100,192,26,17402,3,17431
test4sub9of100,test4pub56of100,100,193,11,1756,2,1769
test4sub79of100,test4pub53of100,100,193,10,3084,2,3096
test4sub69of100,test4pub7of100,100,192,14,16771,1,16786
test4sub9of100,test4pub57of100,100,193,11,1614,1,1626
test4sub79of100,test4pub54of100,100,193,11,2921,2,2934
test4sub69of100,test4pub8of100,100,192,12,16510,1,16523
test4sub79of100,test4pub55of100,100,193,10,2655,1,2666
test4sub69of100,test4pub9of100,100,192,20,16326,0,16346
test4sub69of100,test4pub10of100,100,193,11,15963,1,15975
test4sub79of100,test4pub56of100,100,193,11,1762,1,1774
test4sub79of100,test4pub57of100,100,193,11,1620,0,1631
test4sub69of100,test4pub11of100,100,193,10,15727,1,15738
test4sub71of100,test4pub56of100,100,193,11,1806,1,1818
test4sub25of100,test4pub58of100,100,193,11,701,0,712
test4sub38of100,test4pub58of100,100,193,11,705,1,717
test4sub66of100,test4pub50of100,100,193,17,3835,0,3852
test4sub66of100,test4pub51of100,100,193,16,3666,0,3682
test4sub66of100,test4pub52of100,100,193,10,3522,1,3533
test4sub68of100,test4pub58of100,100,193,11,730,1,742
test4sub44of100,test4pub58of100,100,193,11,732,1,744
test4sub27of100,test4pub58of100,100,193,11,735,1,747
test4sub80of100,test4pub58of100,100,193,11,738,0,749
test4sub54of100,test4pub58of100,100,193,11,738,1,750
test4sub96of100,test4pub58of100,100,193,11,740,1,752
test4sub16of100,test4pub56of100,100,193,11,1861,1,1873
test4sub7of100,test4pub58of100,100,193,11,772,1,784
test4sub22of100,test4pub58of100,100,193,11,772,1,784
test4sub62of100,test4pub58of100,100,193,11,799,1,811
test4sub47of100,test4pub56of100,100,193,11,1916,1,1928
test4sub75of100,test4pub58of100,100,193,11,806,0,817
test4sub47of100,test4pub57of100,100,193,11,1773,0,1784
test4sub60of100,test4pub57of100,100,193,11,1776,1,1788
test4sub52of100,test4pub57of100,100,193,11,1780,1,1792
test4sub98of100,test4pub57of100,100,193,11,1786,0,1797
test4sub37of100,test4pub57of100,100,193,11,1790,1,1802
test4sub78of100,test4pub81of100,10,192,17,32337,1,32355
test4sub48of100,test4pub56of100,100,193,11,1947,1,1959
test4sub78of100,test4pub82of100,10,192,10,32185,1,32196
test4sub78of100,test4pub83of100,10,192,10,32036,0,32046
test4sub78of100,test4pub84of100,10,192,11,31557,0,31568
test4sub78of100,test4pub85of100,10,192,23,30027,1,30051
test4sub74of100,test4pub58of100,100,193,11,845,1,857
test4sub78of100,test4pub86of100,10,192,21,29601,0,29622
test4sub78of100,test4pub87of100,10,192,10,29372,1,29383
test4sub78of100,test4pub88of100,10,192,11,29148,1,29160
test4sub78of100,test4pub89of100,10,192,39,28161,0,28200
test4sub78of100,test4pub90of100,10,192,23,28002,1,28026
test4sub97of100,test4pub55of100,100,193,10,2855,1,2866
test4sub78of100,test4pub91of100,10,192,26,27840,0,27866
test4sub97of100,test4pub56of100,100,193,11,1963,1,1975
test4sub78of100,test4pub92of100,10,192,12,27669,1,27682
test4sub78of100,test4pub93of100,10,192,13,27341,0,27354
test4sub97of100,test4pub57of100,100,193,11,1821,1,1833
test4sub97of100,test4pub58of100,100,193,11,857,1,869
test4sub78of100,test4pub94of100,10,192,10,26752,1,26763
test4sub49of100,test4pub95of100,10,192,17,26399,0,26416
test4sub87of100,test4pub56of100,100,193,11,1974,1,1986
test4sub49of100,test4pub96of100,10,192,10,26237,1,26248
test4sub69of100,test4pub12of100,100,193,11,15494,1,15506
test4sub69of100,test4pub13of100,100,193,10,15292,0,15302
test4sub69of100,test4pub14of100,100,193,10,15125,1,15136
test4sub69of100,test4pub15of100,100,193,11,14988,1,15000
test4sub69of100,test4pub16of100,100,193,10,14831,0,14841
test4sub69of100,test4pub17of100,100,193,11,14698,1,14710
test4sub69of100,test4pub18of100,100,193,18,14513,1,14532
test4sub69of100,test4pub19of100,100,193,11,14304,0,14315
test4sub73of100,test4pub55of100,100,193,10,2880,1,2891
test4sub69of100,test4pub20of100,100,193,10,13864,1,13875
test4sub73of100,test4pub56of100,100,193,11,1988,1,2000
test4sub73of100,test4pub57of100,100,193,11,1846,1,1858
test4sub86of100,test4pub58of100,100,193,11,880,1,892
test4sub69of100,test4pub21of100,100,193,10,13779,2,13791
test4sub73of100,test4pub58of100,100,193,11,881,1,893
test4sub34of100,test4pub58of100,100,193,11,883,2,896
test4sub69of100,test4pub22of100,100,193,10,13651,2,13663
test4sub30of100,test4pub55of100,100,193,10,2889,1,2900
test4sub69of100,test4pub23of100,100,193,11,13481,1,13493
test4sub30of100,test4pub56of100,100,193,11,1997,1,2009
test4sub30of100,test4pub57of100,100,193,11,1854,0,1865
test4sub69of100,test4pub24of100,100,193,19,13353,1,13373
test4sub11of100,test4pub57of100,100,193,11,1873,0,1884
test4sub71of100,test4pub57of100,100,193,11,1876,1,1888
test4sub71of100,test4pub58of100,100,193,11,911,1,923
test4sub44of100,test4pub59of100,100,193,12,362,2,376
test4sub27of100,test4pub59of100,100,193,12,363,2,377
test4sub71of100,test4pub59of100,100,193,12,364,3,379
test4sub80of100,test4pub59of100,100,193,12,365,1,378
test4sub96of100,test4pub59of100,100,193,12,573,1,586
test4sub83of100,test4pub57of100,100,193,11,2110,0,2121
test4sub62of100,test4pub59of100,100,193,12,600,0,612
test4sub47of100,test4pub58of100,100,193,11,1151,1,1163
test4sub47of100,test4pub59of100,100,193,12,603,0,615
test4sub75of100,test4pub59of100,100,193,12,608,1,621
test4sub60of100,test4pub58of100,100,193,11,1158,0,1169
test4sub37of100,test4pub58of100,100,193,11,1159,1,1171
test4sub60of100,test4pub59of100,100,193,12,611,2,625
test4sub78of100,test4pub95of100,10,192,17,26698,2,26717
test4sub37of100,test4pub59of100,100,193,12,612,2,626
test4sub78of100,test4pub96of100,10,192,10,26536,1,26547
test4sub74of100,test4pub59of100,100,193,12,614,1,627
test4sub97of100,test4pub59of100,100,193,12,615,2,629
test4sub78of100,test4pub97of100,10,192,10,26399,2,26411
test4sub63of100,test4pub57of100,100,193,11,2132,1,2144
test4sub78of100,test4pub98of100,10,192,11,26254,1,26266
test4sub63of100,test4pub58of100,100,193,11,1168,2,1181
test4sub33of100,test4pub57of100,100,193,11,2135,2,2148
test4sub78of100,test4pub99of100,10,192,10,26047,1,26058
test4sub63of100,test4pub59of100,100,193,12,622,2,636
test4sub33of100,test4pub58of100,100,193,11,1172,1,1184
test4sub33of100,test4pub59of100,100,193,12,625,1,638
test4sub87of100,test4pub57of100,100,193,11,2154,1,2166
test4sub87of100,test4pub58of100,100,193,11,1189,0,1200
test4sub87of100,test4pub59of100,100,193,12,641,1,654
test4sub69of100,test4pub25of100,100,193,16,13266,1,13283
test4sub69of100,test4pub26of100,100,193,10,13049,0,13059
test4sub73of100,test4pub59of100,100,193,12,676,1,689
test4sub69of100,test4pub27of100,100,193,10,12729,1,12740
test4sub57of100,test4pub31of100,100,193,10,12191,2,12203
test4sub86of100,test4pub59of100,100,193,12,680,1,693
test4sub57of100,test4pub32of100,100,193,11,11841,1,11853
test4sub57of100,test4pub33of100,100,193,11,11700,0,11711
test4sub57of100,test4pub34of100,100,193,12,10921,1,10934
test4sub57of100,test4pub35of100,100,193,12,8567,1,8580
test4sub57of100,test4pub36of100,100,193,10,7292,0,7302
test4sub57of100,test4pub37of100,100,193,23,6932,0,6955
test4sub57of100,test4pub38of100,100,193,31,6674,1,6706
test4sub57of100,test4pub39of100,100,193,28,6526,0,6554
test4sub57of100,test4pub40of100,100,193,49,6347,0,6396
test4sub57of100,test4pub41of100,100,193,27,6223,1,6251
test4sub19of100,test4pub92of100,10,192,12,28209,0,28221
test4sub19of100,test4pub93of100,10,192,13,27882,1,27896
test4sub19of100,test4pub94of100,10,192,10,27292,0,27302
test4sub19of100,test4pub95of100,10,192,17,26936,1,26954
test4sub34of100,test4pub59of100,100,193,12,850,2,864
test4sub30of100,test4pub58of100,100,193,11,1400,1,1412
test4sub19of100,test4pub96of100,10,192,10,26774,2,26786
test4sub30of100,test4pub59of100,100,193,12,853,1,866
test4sub19of100,test4pub97of100,10,192,10,26637,1,26648
test4sub19of100,test4pub98of100,10,192,11,26490,1,26502
test4sub19of100,test4pub99of100,10,192,10,26283,1,26294
test4sub19of100,test4pub100of100,10,193,15,26162,0,26177
test4sub19of100,test4pub2of100,100,192,10,20932,1,20943
test4sub80of100,test4pub60of100,100,193,18,513,0,531
test4sub11of100,test4pub58of100,100,193,11,1436,1,1448
test4sub11of100,test4pub59of100,100,193,12,888,1,901
test4sub27of100,test4pub60of100,100,193,18,543,1,562
test4sub29of100,test4pub57of100,100,193,11,2563,5,2579
test4sub71of100,test4pub60of100,100,193,18,688,6,712
test4sub44of100,test4pub60of100,100,193,18,692,3,713
test4sub29of100,test4pub58of100,100,193,11,1603,2,1616
test4sub85of100,test4pub57of100,100,193,11,2656,7,2674
test4sub29of100,test4pub59of100,100,193,12,1141,8,1161
test4sub59of100,test4pub56of100,100,193,11,2802,7,2820
test4sub96of100,test4pub60of100,100,193,18,788,2,808
test4sub85of100,test4pub58of100,100,193,11,1699,1,1711
test4sub85of100,test4pub59of100,100,193,12,1151,1,1164
test4sub83of100,test4pub58of100,100,193,11,1702,0,1713
test4sub83of100,test4pub59of100,100,193,12,1155,1,1168
test4sub62of100,test4pub60of100,100,193,18,796,1,815
test4sub83of100,test4pub60of100,100,193,18,796,1,815
test4sub47of100,test4pub60of100,100,193,18,797,1,816
test4sub75of100,test4pub60of100,100,193,18,803,0,821
test4sub60of100,test4pub60of100,100,193,18,804,0,822
test4sub37of100,test4pub60of100,100,193,18,807,0,825
test4sub78of100,test4pub100of100,10,193,15,26480,1,26496
test4sub74of100,test4pub60of100,100,193,18,889,0,907
test4sub97of100,test4pub60of100,100,193,18,892,1,911
test4sub63of100,test4pub60of100,100,193,18,894,0,912
test4sub33of100,test4pub60of100,100,193,18,895,1,914
test4sub49of100,test4pub97of100,10,192,10,27221,0,27231
test4sub49of100,test4pub98of100,10,192,11,27075,1,27087
test4sub49of100,test4pub99of100,10,192,10,26867,0,26877
test4sub49of100,test4pub100of100,10,193,15,26747,1,26763
test4sub49of100,test4pub2of100,100,192,10,21516,1,21527
test4sub49of100,test4pub3of100,100,192,28,21419,0,21447
test4sub87of100,test4pub60of100,100,193,18,1200,1,1219
test4sub69of100,test4pub28of100,100,193,10,13514,1,13525
test4sub69of100,test4pub29of100,100,193,11,13350,1,13362
test4sub69of100,test4pub30of100,100,193,15,13214,0,13229
test4sub69of100,test4pub31of100,100,193,10,13082,1,13093
test4sub69of100,test4pub32of100,100,193,11,12730,0,12741
test4sub69of100,test4pub33of100,100,193,11,12590,1,12602
test4sub69of100,test4pub34of100,100,193,12,11810,1,11823
test4sub69of100,test4pub35of100,100,193,12,9456,0,9468
test4sub69of100,test4pub36of100,100,193,10,8181,0,8191
test4sub69of100,test4pub37of100,100,193,23,7822,1,7846
test4sub69of100,test4pub38of100,100,193,31,7563,0,7594
test4sub69of100,test4pub39of100,100,193,28,7416,1,7445
test4sub69of100,test4pub40of100,100,193,49,7237,0,7286
test4sub69of100,test4pub41of100,100,193,27,7112,0,7139
test4sub69of100,test4pub42of100,100,193,31,6970,1,7002
test4sub69of100,test4pub43of100,100,193,28,6830,1,6859
test4sub69of100,test4pub44of100,100,193,17,6683,0,6700
test4sub69of100,test4pub45of100,100,193,20,6556,1,6577
test4sub69of100,test4pub46of100,100,193,12,6207,1,6220
test4sub73of100,test4pub60of100,100,193,18,1232,1,1251
test4sub69of100,test4pub47of100,100,193,10,5793,1,5804
test4sub69of100,test4pub48of100,100,193,10,5634,1,5645
test4sub69of100,test4pub49of100,100,193,11,5439,1,5451
test4sub69of100,test4pub50of100,100,193,17,5268,0,5285
test4sub69of100,test4pub51of100,100,193,16,5100,1,5117
test4sub69of100,test4pub52of100,100,193,10,4955,1,4966
test4sub69of100,test4pub53of100,100,193,10,4587,0,4597
test4sub69of100,test4pub54of100,100,193,11,4422,1,4434
test4sub69of100,test4pub55of100,100,193,10,4156,1,4167
test4sub86of100,test4pub60of100,100,193,18,1243,1,1262
test4sub69of100,test4pub56of100,100,193,11,3263,1,3275
test4sub69of100,test4pub57of100,100,193,11,3121,1,3133
test4sub69of100,test4pub58of100,100,193,11,2156,0,2167
test4sub69of100,test4pub59of100,100,193,12,1608,0,1620
test4sub69of100,test4pub60of100,100,193,18,1250,1,1269
test4sub8of100,test4pub56of100,100,193,11,3282,0,3293
test4sub95of100,test4pub56of100,100,193,11,3288,1,3300
test4sub95of100,test4pub57of100,100,193,11,3145,0,3156
test4sub95of100,test4pub58of100,100,193,11,2180,0,2191
test4sub89of100,test4pub57of100,100,193,11,3153,1,3165
test4sub89of100,test4pub58of100,100,193,11,2188,0,2199
test4sub17of100,test4pub34of100,100,193,12,11876,1,11889
test4sub89of100,test4pub59of100,100,193,12,1641,1,1654
test4sub34of100,test4pub60of100,100,193,18,1288,1,1307
test4sub30of100,test4pub60of100,100,193,18,1289,1,1308
test4sub11of100,test4pub60of100,100,193,18,1305,1,1324
test4sub25of100,test4pub59of100,100,193,12,1666,1,1679
test4sub25of100,test4pub60of100,100,193,18,1307,1,1326
test4sub80of100,test4pub61of100,100,193,11,814,0,825
test4sub26of100,test4pub58of100,100,193,11,2283,1,2295
test4sub85of100,test4pub60of100,100,193,18,1448,1,1467
test4sub85of100,test4pub61of100,100,193,11,939,1,951
test4sub59of100,test4pub57of100,100,193,11,3338,0,3349
test4sub59of100,test4pub58of100,100,193,11,2374,1,2386
test4sub59of100,test4pub59of100,100,193,12,1826,0,1838
test4sub59of100,test4pub60of100,100,193,18,1467,1,1486
test4sub14of100,test4pub58of100,100,193,11,2377,1,2389
test4sub59of100,test4pub61of100,100,193,11,959,1,971
test4sub14of100,test4pub59of100,100,193,12,1829,1,1842
test4sub14of100,test4pub60of100,100,193,18,1471,2,1491
test4sub18of100,test4pub83of100,10,192,10,33577,1,33588
test4sub18of100,test4pub84of100,10,192,11,33099,1,33111
test4sub14of100,test4pub61of100,100,193,11,964,1,976
test4sub18of100,test4pub85of100,10,192,23,31568,0,31591
test4sub18of100,test4pub86of100,10,192,21,31143,1,31165
test4sub18of100,test4pub87of100,10,192,10,30913,0,30923
test4sub96of100,test4pub61of100,100,193,11,969,1,981
test4sub98of100,test4pub58of100,100,193,11,2407,1,2419
test4sub98of100,test4pub59of100,100,193,12,1860,1,1873
test4sub83of100,test4pub61of100,100,193,11,990,4,1005
test4sub62of100,test4pub61of100,100,193,11,991,3,1005
test4sub47of100,test4pub61of100,100,193,11,992,3,1006
test4sub98of100,test4pub60of100,100,193,18,1502,3,1523
test4sub75of100,test4pub61of100,100,193,11,993,5,1009
test4sub60of100,test4pub61of100,100,193,11,994,4,1009
test4sub37of100,test4pub61of100,100,193,11,996,3,1010
test4sub38of100,test4pub59of100,100,193,12,1867,2,1881
test4sub98of100,test4pub61of100,100,193,11,997,2,1010
test4sub74of100,test4pub61of100,100,193,11,1082,1,1094
test4sub63of100,test4pub61of100,100,193,11,1083,2,1096
test4sub33of100,test4pub61of100,100,193,11,1084,1,1096
test4sub70of100,test4pub45of100,100,193,20,6922,1,6943
test4sub70of100,test4pub46of100,100,193,12,6574,0,6586
test4sub84of100,test4pub57of100,100,193,11,3472,1,3484
test4sub70of100,test4pub47of100,100,193,10,6161,1,6172
test4sub70of100,test4pub48of100,100,193,10,6001,0,6011
test4sub70of100,test4pub49of100,100,193,11,5806,1,5818
test4sub70of100,test4pub50of100,100,193,17,5635,1,5653
test4sub70of100,test4pub51of100,100,193,16,5466,0,5482
test4sub70of100,test4pub52of100,100,193,10,5322,1,5333
test4sub70of100,test4pub53of100,100,193,10,4954,0,4964
test4sub97of100,test4pub61of100,100,193,11,1300,0,1311
test4sub76of100,test4pub57of100,100,193,11,3686,1,3698
test4sub66of100,test4pub53of100,100,193,10,5444,0,5454
test4sub66of100,test4pub54of100,100,193,11,5279,1,5291
test4sub66of100,test4pub55of100,100,193,10,5013,1,5024
test4sub87of100,test4pub61of100,100,193,11,1942,1,1954
test4sub69of100,test4pub61of100,100,193,11,1947,1,1959
test4sub73of100,test4pub61of100,100,193,11,1949,1,1961
test4sub86of100,test4pub61of100,100,193,11,1950,0,1961
test4sub82of100,test4pub57of100,100,193,11,4343,2,4356
test4sub95of100,test4pub59of100,100,193,12,2830,2,2844
test4sub89of100,test4pub60of100,100,193,18,2471,1,2490
test4sub82of100,test4pub58of100,100,193,11,3380,1,3392
test4sub95of100,test4pub60of100,100,193,18,2472,1,2491
test4sub89of100,test4pub61of100,100,193,11,1962,2,1975
test4sub82of100,test4pub59of100,100,193,12,2833,1,2846
test4sub95of100,test4pub61of100,100,193,11,1964,1,1976
test4sub17of100,test4pub35of100,100,193,12,10718,1,10731
test4sub17of100,test4pub36of100,100,193,10,9443,1,9454
test4sub17of100,test4pub37of100,100,193,23,9084,1,9108
test4sub17of100,test4pub38of100,100,193,31,8825,1,8857
test4sub17of100,test4pub39of100,100,193,28,8677,0,8705
test4sub34of100,test4pub61of100,100,193,11,2010,1,2022
test4sub30of100,test4pub61of100,100,193,11,2015,0,2026
test4sub42of100,test4pub57of100,100,193,11,4402,0,4413
test4sub42of100,test4pub58of100,100,193,11,3437,1,3449
test4sub43of100,test4pub57of100,100,193,11,4403,1,4415
test4sub42of100,test4pub59of100,100,193,12,2890,0,2902
test4sub8of100,test4pub57of100,100,193,11,4413,1,4425
test4sub8of100,test4pub58of100,100,193,11,3449,1,3461
test4sub8of100,test4pub59of100,100,193,12,2909,1,2922
test4sub8of100,test4pub60of100,100,193,18,2550,0,2568
test4sub8of100,test4pub61of100,100,193,11,2042,1,2054
test4sub11of100,test4pub61of100,100,193,11,2048,1,2060
test4sub25of100,test4pub61of100,100,193,11,2051,0,2062
test4sub28of100,test4pub57of100,100,193,11,4440,0,4451
test4sub28of100,test4pub58of100,100,193,11,3476,1,3488
test4sub28of100,test4pub59of100,100,193,12,2928,1,2941
test4sub28of100,test4pub60of100,100,193,18,2569,0,2587
test4sub26of100,test4pub59of100,100,193,12,2944,1,2957
test4sub26of100,test4pub60of100,100,193,18,2585,0,2603
test4sub26of100,test4pub61of100,100,193,11,2077,1,2089
test4sub7of100,test4pub59of100,100,193,12,2948,0,2960
test4sub7of100,test4pub60of100,100,193,18,2590,1,2609
test4sub7of100,test4pub61of100,100,193,11,2081,1,2093
test4sub40of100,test4pub57of100,100,193,11,4471,0,4482
test4sub50of100,test4pub55of100,100,193,10,5533,1,5544
test4sub13of100,test4pub59of100,100,193,12,2981,1,2994
test4sub50of100,test4pub56of100,100,193,11,4641,1,4653
test4sub13of100,test4pub60of100,100,193,18,2622,1,2641
test4sub13of100,test4pub61of100,100,193,11,2114,0,2125
test4sub50of100,test4pub57of100,100,193,11,4499,1,4511
test4sub50of100,test4pub58of100,100,193,11,3535,0,3546
test4sub50of100,test4pub59of100,100,193,12,2988,1,3001
test4sub85of100,test4pub62of100,100,193,12,1347,1,1360
test4sub80of100,test4pub62of100,100,193,12,1348,1,1361
test4sub59of100,test4pub62of100,100,193,12,1356,1,1369
test4sub14of100,test4pub62of100,100,193,12,1356,1,1369
test4sub18of100,test4pub88of100,10,192,11,31869,1,31881
test4sub18of100,test4pub89of100,10,192,39,30883,1,30923
test4sub18of100,test4pub90of100,10,192,23,30724,0,30747
test4sub18of100,test4pub91of100,10,192,26,30567,1,30594
test4sub96of100,test4pub62of100,100,193,12,1369,1,1382
test4sub18of100,test4pub92of100,10,192,12,30395,1,30408
test4sub18of100,test4pub93of100,10,192,13,30068,1,30082
test4sub65of100,test4pub56of100,100,193,11,4695,1,4707
test4sub18of100,test4pub94of100,10,192,10,29479,2,29491
test4sub98of100,test4pub62of100,100,193,12,1374,1,1387
test4sub18of100,test4pub95of100,10,192,17,29123,0,29140
test4sub18of100,test4pub96of100,10,192,10,28961,1,28972
test4sub83of100,test4pub62of100,100,193,12,1379,1,1392
test4sub62of100,test4pub62of100,100,193,12,1381,2,1395
test4sub90of100,test4pub57of100,100,193,11,4559,1,4571
test4sub47of100,test4pub62of100,100,193,12,1382,2,1396
test4sub75of100,test4pub62of100,100,193,12,1385,0,1397
test4sub60of100,test4pub62of100,100,193,12,1386,1,1399
test4sub38of100,test4pub60of100,100,193,18,2691,1,2710
test4sub37of100,test4pub62of100,100,193,12,1387,1,1400
test4sub38of100,test4pub61of100,100,193,11,2182,0,2193
test4sub38of100,test4pub62of100,100,193,12,1391,1,1404
test4sub9of100,test4pub58of100,100,193,11,3621,1,3633
test4sub9of100,test4pub59of100,100,193,12,3074,1,3087
test4sub9of100,test4pub60of100,100,193,18,2715,0,2733
test4sub51of100,test4pub54of100,100,193,11,5898,1,5910
test4sub51of100,test4pub55of100,100,193,10,5632,1,5643
test4sub58of100,test4pub57of100,100,193,11,4594,1,4606
test4sub74of100,test4pub62of100,100,193,12,1419,1,1432
test4sub78of100,test4pub1of100,100,12977,24,23188,44,23256
test4sub63of100,test4pub62of100,100,193,12,1430,34,1476
test4sub33of100,test4pub62of100,100,193,12,1433,33,1478
test4sub70of100,test4pub54of100,100,193,11,5918,32,5961
test4sub84of100,test4pub58of100,100,193,11,3649,30,3690
test4sub78of100,test4pub2of100,100,192,10,23200,2,23212
test4sub70of100,test4pub55of100,100,193,10,5683,1,5694
test4sub84of100,test4pub59of100,100,193,12,3130,1,3143
test4sub70of100,test4pub56of100,100,193,11,4791,1,4803
test4sub70of100,test4pub57of100,100,193,11,4648,0,4659
test4sub70of100,test4pub58of100,100,193,11,3684,1,3696
test4sub36of100,test4pub56of100,100,193,11,4795,0,4806
test4sub36of100,test4pub57of100,100,193,11,4652,2,4665
test4sub68of100,test4pub59of100,100,193,12,3138,1,3151
test4sub27of100,test4pub61of100,100,193,11,2269,12,2292
test4sub36of100,test4pub58of100,100,193,11,3689,1,3701
test4sub36of100,test4pub59of100,100,193,12,3152,0,3164
test4sub36of100,test4pub60of100,100,193,18,2794,1,2813
test4sub68of100,test4pub60of100,100,193,18,2780,5,2803
test4sub36of100,test4pub61of100,100,193,11,2285,0,2296
test4sub68of100,test4pub61of100,100,193,11,2286,2,2299
test4sub49of100,test4pub1of100,100,12977,24,23264,44,23332
test4sub6of100,test4pub58of100,100,193,11,3721,31,3763
test4sub87of100,test4pub62of100,100,193,12,1513,30,1555
test4sub69of100,test4pub62of100,100,193,12,1515,28,1555
test4sub73of100,test4pub62of100,100,193,12,1517,26,1555
test4sub57of100,test4pub42of100,100,193,31,8567,25,8623
test4sub86of100,test4pub62of100,100,193,12,1533,11,1556
test4sub23of100,test4pub58of100,100,193,11,3748,9,3768
test4sub82of100,test4pub60of100,100,193,18,2840,9,2867
test4sub49of100,test4pub4of100,100,192,11,21833,5,21849
test4sub6of100,test4pub59of100,100,193,12,3205,5,3222
test4sub57of100,test4pub43of100,100,193,28,8451,4,8483
test4sub89of100,test4pub62of100,100,193,12,1545,3,1560
test4sub82of100,test4pub61of100,100,193,11,2339,4,2354
test4sub6of100,test4pub60of100,100,193,18,2851,3,2872
test4sub49of100,test4pub5of100,100,192,14,20842,3,20859
test4sub57of100,test4pub44of100,100,193,17,8308,3,8328
test4sub82of100,test4pub62of100,100,193,12,1550,3,1565
test4sub49of100,test4pub6of100,100,192,26,20522,3,20551
test4sub17of100,test4pub40of100,100,193,49,8871,3,8923
test4sub57of100,test4pub45of100,100,193,20,8183,3,8206
test4sub49of100,test4pub7of100,100,192,14,19891,2,19907
test4sub17of100,test4pub41of100,100,193,27,8748,1,8776
test4sub57of100,test4pub46of100,100,193,12,7837,2,7851
test4sub49of100,test4pub8of100,100,192,12,19630,1,19643
test4sub17of100,test4pub42of100,100,193,31,8607,2,8640
test4sub57of100,test4pub47of100,100,193,10,7425,1,7436
test4sub17of100,test4pub43of100,100,193,28,8469,1,8498
test4sub49of100,test4pub9of100,100,192,20,19448,1,19469
test4sub57of100,test4pub48of100,100,193,10,7266,1,7277
test4sub49of100,test4pub10of100,100,193,11,19086,1,19098
test4sub17of100,test4pub44of100,100,193,17,8323,1,8341
test4sub57of100,test4pub49of100,100,193,11,7072,1,7084
test4sub17of100,test4pub45of100,100,193,20,8197,0,8217
test4sub49of100,test4pub11of100,100,193,10,18852,2,18864
test4sub49of100,test4pub12of100,100,193,11,18410,0,18421
test4sub34of100,test4pub62of100,100,193,12,1571,2,1585
test4sub49of100,test4pub13of100,100,193,10,18207,1,18218
test4sub43of100,test4pub58of100,100,193,11,3784,2,3797
test4sub43of100,test4pub59of100,100,193,12,3237,1,3250
test4sub28of100,test4pub61of100,100,193,11,2379,1,2391
test4sub28of100,test4pub62of100,100,193,12,1587,0,1599
test4sub26of100,test4pub62of100,100,193,12,1606,1,1619
test4sub7of100,test4pub62of100,100,193,12,1611,1,1624
test4sub22of100,test4pub59of100,100,193,12,3275,0,3287
test4sub22of100,test4pub60of100,100,193,18,2917,1,2936
test4sub22of100,test4pub61of100,100,193,11,2408,1,2420
test4sub40of100,test4pub58of100,100,193,11,3829,1,3841
test4sub40of100,test4pub59of100,100,193,12,3281,0,3293
test4sub40of100,test4pub60of100,100,193,18,2923,1,2942
test4sub40of100,test4pub61of100,100,193,11,2415,1,2427
test4sub40of100,test4pub62of100,100,193,12,1623,0,1635
test4sub50of100,test4pub60of100,100,193,18,2930,1,2949
test4sub13of100,test4pub62of100,100,193,12,1628,1,1641
test4sub50of100,test4pub61of100,100,193,11,2421,1,2433
test4sub50of100,test4pub62of100,100,193,12,1630,1,1643
test4sub13of100,test4pub63of100,100,193,15,365,1,381
test4sub92of100,test4pub48of100,100,193,10,7342,1,7353
test4sub92of100,test4pub49of100,100,193,11,7146,0,7157
test4sub85of100,test4pub63of100,100,193,15,375,1,391
test4sub96of100,test4pub63of100,100,193,15,376,2,393
test4sub98of100,test4pub63of100,100,193,15,377,2,394
test4sub92of100,test4pub50of100,100,193,17,6978,1,6996
test4sub92of100,test4pub51of100,100,193,16,6809,0,6825
test4sub92of100,test4pub52of100,100,193,10,6665,1,6676
test4sub90of100,test4pub58of100,100,193,11,3867,1,3879
test4sub90of100,test4pub59of100,100,193,12,3319,0,3331
test4sub90of100,test4pub60of100,100,193,18,2961,1,2980
test4sub47of100,test4pub63of100,100,193,15,395,1,411
test4sub90of100,test4pub61of100,100,193,11,2452,0,2463
test4sub90of100,test4pub62of100,100,193,12,1662,1,1675
test4sub75of100,test4pub63of100,100,193,15,400,1,416
test4sub60of100,test4pub63of100,100,193,15,400,1,416
test4sub37of100,test4pub63of100,100,193,15,401,1,417
test4sub6of100,test4pub61of100,100,193,11,2463,1,2475
test4sub6of100,test4pub62of100,100,193,12,1672,0,1684
test4sub69of100,test4pub63of100,100,193,15,407,1,423
test4sub87of100,test4pub63of100,100,193,15,406,2,423
test4sub6of100,test4pub63of100,100,193,15,409,1,425
test4sub57of100,test4pub50of100,100,193,17,7022,1,7040
test4sub86of100,test4pub63of100,100,193,15,422,1,438
test4sub82of100,test4pub63of100,100,193,15,423,2,440
test4sub57of100,test4pub51of100,100,193,16,6853,2,6871
test4sub89of100,test4pub63of100,100,193,15,425,1,441
test4sub57of100,test4pub52of100,100,193,10,6710,0,6720
test4sub28of100,test4pub63of100,100,193,15,456,0,471
test4sub7of100,test4pub63of100,100,193,15,467,1,483
test4sub22of100,test4pub62of100,100,193,12,1735,1,1748
test4sub22of100,test4pub63of100,100,193,15,471,0,486
test4sub40of100,test4pub63of100,100,193,15,472,1,488
test4sub50of100,test4pub63of100,100,193,15,475,0,490
test4sub90of100,test4pub63of100,100,193,15,505,1,521
test4sub49of100,test4pub14of100,100,193,10,18247,1,18258
test4sub49of100,test4pub15of100,100,193,11,18109,0,18120
test4sub49of100,test4pub16of100,100,193,10,17953,1,17964
test4sub57of100,test4pub53of100,100,193,10,6439,1,6450
test4sub57of100,test4pub54of100,100,193,11,6275,1,6287
test4sub57of100,test4pub55of100,100,193,10,6011,0,6021
test4sub57of100,test4pub56of100,100,193,11,5119,1,5131
test4sub57of100,test4pub57of100,100,193,11,4976,0,4987
test4sub17of100,test4pub46of100,100,193,12,8081,1,8094
test4sub17of100,test4pub47of100,100,193,10,7667,3,7680
test4sub38of100,test4pub63of100,100,193,15,540,2,557
test4sub64of100,test4pub1of100,100,12977,24,23574,43,23641
test4sub17of100,test4pub48of100,100,193,10,7511,42,7563
test4sub33of100,test4pub63of100,100,193,15,546,39,600
test4sub92of100,test4pub53of100,100,193,10,6462,39,6511
test4sub74of100,test4pub63of100,100,193,15,559,28,602
test4sub77of100,test4pub53of100,100,193,10,6476,27,6513
test4sub49of100,test4pub17of100,100,193,11,17881,9,17901
test4sub57of100,test4pub58of100,100,193,11,4059,7,4077
test4sub64of100,test4pub3of100,100,192,28,23486,4,23518
test4sub17of100,test4pub49of100,100,193,11,7357,6,7374
test4sub92of100,test4pub54of100,100,193,11,6335,4,6350
test4sub77of100,test4pub54of100,100,193,11,6337,4,6352
test4sub49of100,test4pub18of100,100,193,18,17704,4,17726
test4sub57of100,test4pub59of100,100,193,12,3517,4,3533
test4sub64of100,test4pub4of100,100,192,11,22147,4,22162
test4sub17of100,test4pub50of100,100,193,17,7191,3,7211
test4sub92of100,test4pub55of100,100,193,10,6072,5,6087
test4sub49of100,test4pub19of100,100,193,11,17499,4,17514
test4sub77of100,test4pub55of100,100,193,10,6074,5,6089
test4sub64of100,test4pub5of100,100,192,14,21154,3,21171
test4sub57of100,test4pub60of100,100,193,18,3162,4,3184
test4sub17of100,test4pub51of100,100,193,16,7026,4,7046
test4sub92of100,test4pub56of100,100,193,11,5184,4,5199
test4sub77of100,test4pub56of100,100,193,11,5185,3,5199
test4sub64of100,test4pub6of100,100,192,26,20834,4,20864
test4sub57of100,test4pub61of100,100,193,11,2658,2,2671
test4sub17of100,test4pub52of100,100,193,10,6884,4,6898
test4sub92of100,test4pub57of100,100,193,11,5045,3,5059
test4sub64of100,test4pub7of100,100,192,14,20204,3,20221
test4sub57of100,test4pub62of100,100,193,12,1869,3,1884
test4sub17of100,test4pub53of100,100,193,10,6520,2,6532
test4sub92of100,test4pub58of100,100,193,11,4082,2,4095
test4sub64of100,test4pub8of100,100,192,12,19944,3,19959
test4sub57of100,test4pub63of100,100,193,15,607,2,624
test4sub17of100,test4pub54of100,100,193,11,6357,2,6370
test4sub92of100,test4pub59of100,100,193,12,3537,3,3552
test4sub64of100,test4pub9of100,100,192,20,19762,2,19784
test4sub17of100,test4pub55of100,100,193,10,6092,2,6104
test4sub92of100,test4pub60of100,100,193,18,3181,1,3200
test4sub64of100,test4pub10of100,100,193,11,19400,1,19412
test4sub92of100,test4pub61of100,100,193,11,2673,2,2686
test4sub17of100,test4pub56of100,100,193,11,5202,1,5214
test4sub64of100,test4pub11of100,100,193,10,19166,1,19177
test4sub17of100,test4pub57of100,100,193,11,5061,1,5073
test4sub64of100,test4pub12of100,100,193,11,18724,1,18736
test4sub92of100,test4pub62of100,100,193,12,1882,1,1895
test4sub64of100,test4pub13of100,100,193,10,18522,0,18532
test4sub92of100,test4pub63of100,100,193,15,620,1,636
test4sub17of100,test4pub58of100,100,193,11,4097,2,4110
test4sub64of100,test4pub14of100,100,193,10,18355,9,18374
test4sub17of100,test4pub59of100,100,193,12,3551,7,3570
test4sub17of100,test4pub60of100,100,193,18,3199,0,3217
test4sub64of100,test4pub15of100,100,193,11,18226,0,18237
test4sub17of100,test4pub61of100,100,193,11,2691,1,2703
test4sub17of100,test4pub62of100,100,193,12,1899,1,1912
test4sub17of100,test4pub63of100,100,193,15,636,1,652
test4sub3of100,test4pub56of100,100,193,11,5247,0,5258
test4sub3of100,test4pub57of100,100,193,11,5105,1,5117
test4sub3of100,test4pub58of100,100,193,11,4140,1,4152
test4sub76of100,test4pub58of100,100,193,11,4182,1,4194
test4sub64of100,test4pub16of100,100,193,10,18143,0,18153
test4sub76of100,test4pub59of100,100,193,12,3635,1,3648
test4sub64of100,test4pub17of100,100,193,11,18010,1,18022
test4sub76of100,test4pub60of100,100,193,18,3276,1,3295
test4sub64of100,test4pub18of100,100,193,18,17825,1,17844
test4sub76of100,test4pub61of100,100,193,11,2768,1,2780
test4sub76of100,test4pub62of100,100,193,12,1976,0,1988
test4sub64of100,test4pub19of100,100,193,11,17621,0,17632
test4sub64of100,test4pub20of100,100,193,10,17181,1,17192
test4sub64of100,test4pub21of100,100,193,10,17095,0,17105
test4sub64of100,test4pub22of100,100,193,10,16965,1,16976
test4sub64of100,test4pub23of100,100,193,11,16793,1,16805
test4sub64of100,test4pub24of100,100,193,19,16664,0,16683
test4sub64of100,test4pub25of100,100,193,16,16243,1,16260
test4sub64of100,test4pub26of100,100,193,10,16026,1,16037
test4sub77of100,test4pub57of100,100,193,11,5190,1,5202
test4sub77of100,test4pub58of100,100,193,11,4225,0,4236
test4sub77of100,test4pub59of100,100,193,12,3678,1,3691
test4sub77of100,test4pub60of100,100,193,18,3319,0,3337
test4sub77of100,test4pub61of100,100,193,11,2811,1,2823
test4sub77of100,test4pub62of100,100,193,12,2019,1,2032
test4sub77of100,test4pub63of100,100,193,15,755,0,770
test4sub49of100,test4pub20of100,100,193,10,17272,1,17283
test4sub49of100,test4pub21of100,100,193,10,17186,0,17196
test4sub49of100,test4pub22of100,100,193,10,17055,0,17065
test4sub3of100,test4pub59of100,100,193,12,3770,1,3783
test4sub3of100,test4pub60of100,100,193,18,3411,0,3429
test4sub3of100,test4pub61of100,100,193,11,2903,1,2915
test4sub3of100,test4pub62of100,100,193,12,2111,0,2123
test4sub3of100,test4pub63of100,100,193,15,847,1,863
test4sub94of100,test4pub86of100,10,192,21,33087,1,33109
test4sub76of100,test4pub63of100,100,193,15,853,0,868
test4sub94of100,test4pub87of100,10,192,10,32857,1,32868
test4sub64of100,test4pub27of100,100,193,10,15834,1,15845
test4sub94of100,test4pub88of100,10,192,11,32633,0,32644
test4sub64of100,test4pub28of100,100,193,10,15734,1,15745
test4sub94of100,test4pub89of100,10,192,39,31647,1,31687
test4sub94of100,test4pub90of100,10,192,23,31488,0,31511
test4sub64of100,test4pub29of100,100,193,11,15570,1,15582
test4sub64of100,test4pub30of100,100,193,15,15435,0,15450
test4sub94of100,test4pub91of100,10,192,26,31326,2,31354
test4sub64of100,test4pub31of100,100,193,10,15303,1,15314
test4sub94of100,test4pub92of100,10,192,12,31156,1,31169
test4sub64of100,test4pub32of100,100,193,11,14951,1,14963
test4sub94of100,test4pub93of100,10,192,13,30829,0,30842
test4sub64of100,test4pub33of100,100,193,11,14811,0,14822
test4sub64of100,test4pub34of100,100,193,12,14032,1,14045
test4sub64of100,test4pub35of100,100,193,12,11678,0,11690
test4sub64of100,test4pub36of100,100,193,10,10403,0,10413
test4sub64of100,test4pub37of100,100,193,23,10044,1,10068
test4sub91of100,test4pub57of100,100,193,11,5338,1,5350
test4sub91of100,test4pub58of100,100,193,11,4373,0,4384
test4sub49of100,test4pub23of100,100,193,11,16968,1,16980
test4sub91of100,test4pub59of100,100,193,12,3826,1,3839
test4sub49of100,test4pub24of100,100,193,19,16840,1,16860
test4sub91of100,test4pub60of100,100,193,18,3467,1,3486
test4sub49of100,test4pub25of100,100,193,16,16419,1,16436
test4sub49of100,test4pub26of100,100,193,10,16203,1,16214
test4sub91of100,test4pub61of100,100,193,11,2959,1,2971
test4sub49of100,test4pub27of100,100,193,10,15883,1,15894
test4sub91of100,test4pub62of100,100,193,12,2169,1,2182
test4sub94of100,test4pub94of100,10,192,10,30298,0,30308
test4sub94of100,test4pub95of100,10,192,17,29942,1,29960
test4sub94of100,test4pub96of100,10,192,10,29779,0,29789
test4sub94of100,test4pub97of100,10,192,10,29642,1,29653
test4sub94of100,test4pub98of100,10,192,11,29495,0,29506
test4sub94of100,test4pub99of100,10,192,10,29287,0,29297
test4sub94of100,test4pub100of100,10,193,15,29167,1,29183
test4sub94of100,test4pub1of100,100,12977,24,23971,42,24037
test4sub64of100,test4pub38of100,100,193,31,9857,35,9923
test4sub94of100,test4pub2of100,100,192,10,23981,0,23991
test4sub64of100,test4pub39of100,100,193,28,9744,1,9773
test4sub94of100,test4pub3of100,100,192,28,23885,1,23914
test4sub64of100,test4pub40of100,100,193,49,9566,1,9616
test4sub64of100,test4pub41of100,100,193,27,9442,1,9470
test4sub94of100,test4pub4of100,100,192,11,22541,1,22553
test4sub64of100,test4pub42of100,100,193,31,9299,1,9331
test4sub94of100,test4pub5of100,100,192,14,21545,1,21560
test4sub64of100,test4pub43of100,100,193,28,9160,0,9188
test4sub94of100,test4pub6of100,100,192,26,21223,0,21249
test4sub64of100,test4pub44of100,100,193,17,9014,1,9032
test4sub94of100,test4pub7of100,100,192,14,20591,1,20606
test4sub94of100,test4pub8of100,100,192,12,20329,1,20342
test4sub64of100,test4pub45of100,100,193,20,8886,1,8907
test4sub94of100,test4pub9of100,100,192,20,20145,0,20165
test4sub94of100,test4pub10of100,100,193,11,19782,1,19794
test4sub94of100,test4pub11of100,100,193,10,19546,0,19556
test4sub94of100,test4pub12of100,100,193,11,19103,0,19114
test4sub94of100,test4pub13of100,100,193,10,18901,0,18911
test4sub91of100,test4pub63of100,100,193,15,1000,1,1016
test4sub64of100,test4pub46of100,100,193,12,8544,1,8557
test4sub94of100,test4pub14of100,100,193,10,18735,0,18745
test4sub64of100,test4pub47of100,100,193,10,8132,1,8143
test4sub94of100,test4pub15of100,100,193,11,18598,1,18610
test4sub94of100,test4pub16of100,100,193,10,18441,0,18451
test4sub64of100,test4pub48of100,100,193,10,7973,1,7984
test4sub94of100,test4pub17of100,100,193,11,18308,0,18319
test4sub94of100,test4pub18of100,100,193,18,18123,0,18141
test4sub94of100,test4pub19of100,100,193,11,17915,1,17927
test4sub94of100,test4pub20of100,100,193,10,17474,0,17484
test4sub94of100,test4pub21of100,100,193,10,17388,1,17399
test4sub94of100,test4pub22of100,100,193,10,17258,1,17269
test4sub94of100,test4pub23of100,100,193,11,17086,0,17097
test4sub94of100,test4pub24of100,100,193,19,16957,1,16977
test4sub64of100,test4pub49of100,100,193,11,7788,0,7799
test4sub94of100,test4pub25of100,100,193,16,16536,1,16553
test4sub64of100,test4pub50of100,100,193,17,7617,1,7635
test4sub94of100,test4pub26of100,100,193,10,16320,0,16330
test4sub64of100,test4pub51of100,100,193,16,7449,1,7466
test4sub94of100,test4pub27of100,100,193,10,16000,1,16011
test4sub94of100,test4pub28of100,100,193,10,15899,0,15909
test4sub94of100,test4pub29of100,100,193,11,15735,1,15747
test4sub94of100,test4pub30of100,100,193,15,15599,1,15615
test4sub94of100,test4pub31of100,100,193,10,15466,0,15476
test4sub94of100,test4pub32of100,100,193,11,15114,0,15125
test4sub94of100,test4pub33of100,100,193,11,15014,0,15025
test4sub94of100,test4pub34of100,100,193,12,14236,1,14249
test4sub94of100,test4pub35of100,100,193,12,11882,1,11895
test4sub94of100,test4pub36of100,100,193,10,10607,1,10618
test4sub94of100,test4pub37of100,100,193,23,10248,1,10272
test4sub94of100,test4pub38of100,100,193,31,9989,0,10020
test4sub64of100,test4pub52of100,100,193,10,7362,1,7373
test4sub64of100,test4pub53of100,100,193,10,6994,0,7004
test4sub64of100,test4pub54of100,100,193,11,6830,1,6842
test4sub64of100,test4pub55of100,100,193,10,6563,0,6573
test4sub64of100,test4pub56of100,100,193,11,5671,1,5683
test4sub64of100,test4pub57of100,100,193,11,5528,0,5539
test4sub64of100,test4pub58of100,100,193,11,4564,1,4576
test4sub64of100,test4pub59of100,100,193,12,4016,0,4028
test4sub64of100,test4pub60of100,100,193,18,3657,0,3675
test4sub64of100,test4pub61of100,100,193,11,3149,1,3161
test4sub64of100,test4pub62of100,100,193,12,2357,0,2369
test4sub52of100,test4pub58of100,100,193,11,4576,0,4587
test4sub52of100,test4pub59of100,100,193,12,4029,1,4042
test4sub64of100,test4pub63of100,100,193,15,1139,1,1155
test4sub94of100,test4pub39of100,100,193,28,9952,1,9981
test4sub94of100,test4pub40of100,100,193,49,9774,0,9823
test4sub94of100,test4pub41of100,100,193,27,9650,1,9678
test4sub94of100,test4pub42of100,100,193,31,9507,0,9538
test4sub94of100,test4pub43of100,100,193,28,9368,1,9397
test4sub94of100,test4pub44of100,100,193,17,9221,1,9239
test4sub94of100,test4pub45of100,100,193,20,9093,1,9114
test4sub94of100,test4pub46of100,100,193,12,8745,2,8759
test4sub49of100,test4pub28of100,100,193,10,16078,1,16089
test4sub49of100,test4pub29of100,100,193,11,15914,1,15926
test4sub49of100,test4pub30of100,100,193,15,15778,1,15794
test4sub49of100,test4pub31of100,100,193,10,15645,0,15655
test4sub94of100,test4pub47of100,100,193,10,8336,1,8347
test4sub49of100,test4pub32of100,100,193,11,15294,1,15306
test4sub94of100,test4pub48of100,100,193,10,8177,1,8188
test4sub49of100,test4pub33of100,100,193,11,15153,1,15165
test4sub94of100,test4pub49of100,100,193,11,7982,0,7993
test4sub49of100,test4pub34of100,100,193,12,14375,0,14387
test4sub94of100,test4pub50of100,100,193,17,7811,1,7829
test4sub94of100,test4pub51of100,100,193,16,7643,1,7660
test4sub94of100,test4pub52of100,100,193,10,7499,4,7513
test4sub52of100,test4pub60of100,100,193,18,3788,1,3807
test4sub49of100,test4pub35of100,100,193,12,12030,2,12044
test4sub52of100,test4pub61of100,100,193,11,3280,4,3295
test4sub94of100,test4pub53of100,100,193,10,7139,3,7152
test4sub49of100,test4pub36of100,100,193,10,10756,4,10770
test4sub52of100,test4pub62of100,100,193,12,2491,4,2507
test4sub94of100,test4pub54of100,100,193,11,6977,4,6992
test4sub49of100,test4pub37of100,100,193,23,10402,4,10429
test4sub52of100,test4pub63of100,100,193,15,1232,4,1251
test4sub94of100,test4pub55of100,100,193,10,6715,2,6727
test4sub49of100,test4pub38of100,100,193,31,10148,3,10182
test4sub94of100,test4pub56of100,100,193,11,5825,2,5838
test4sub49of100,test4pub39of100,100,193,28,10003,2,10033
test4sub94of100,test4pub57of100,100,193,11,5684,1,5696
test4sub94of100,test4pub58of100,100,193,11,4721,1,4733
test4sub49of100,test4pub40of100,100,193,49,9826,2,9877
test4sub49of100,test4pub41of100,100,193,27,9704,1,9732
test4sub94of100,test4pub59of100,100,193,12,4174,2,4188
test4sub49of100,test4pub42of100,100,193,31,9563,8,9602
test4sub94of100,test4pub60of100,100,193,18,3818,10,3846
test4sub49of100,test4pub43of100,100,193,28,9431,1,9460
test4sub49of100,test4pub44of100,100,193,17,9285,1,9303
test4sub49of100,test4pub45of100,100,193,20,9329,1,9350
test4sub49of100,test4pub46of100,100,193,12,8980,0,8992
test4sub94of100,test4pub61of100,100,193,11,3495,2,3508
test4sub49of100,test4pub47of100,100,193,10,8567,2,8579
test4sub4of100,test4pub57of100,100,193,11,5881,1,5893
test4sub94of100,test4pub62of100,100,193,12,2705,2,2719
test4sub4of100,test4pub58of100,100,193,11,4918,1,4930
test4sub4of100,test4pub59of100,100,193,12,4370,1,4383
test4sub94of100,test4pub63of100,100,193,15,1442,2,1459
test4sub39of100,test4pub39of100,100,193,28,10206,1,10235
test4sub4of100,test4pub60of100,100,193,18,4013,2,4033
test4sub39of100,test4pub40of100,100,193,49,10028,1,10078
test4sub4of100,test4pub61of100,100,193,11,3505,0,3516
test4sub39of100,test4pub41of100,100,193,27,9904,1,9932
test4sub4of100,test4pub62of100,100,193,12,2714,1,2727
test4sub44of100,test4pub61of100,100,193,11,3517,0,3528
test4sub49of100,test4pub48of100,100,193,10,8456,1,8467
test4sub49of100,test4pub49of100,100,193,11,8261,1,8273
test4sub49of100,test4pub50of100,100,193,17,8090,0,8107
test4sub49of100,test4pub51of100,100,193,16,7922,1,7939
test4sub49of100,test4pub52of100,100,193,10,7777,1,7788
test4sub54of100,test4pub59of100,100,193,12,4452,0,4464
test4sub54of100,test4pub60of100,100,193,18,4093,1,4112
test4sub49of100,test4pub53of100,100,193,10,7457,1,7468
test4sub49of100,test4pub54of100,100,193,11,7292,0,7303
test4sub49of100,test4pub55of100,100,193,10,7026,1,7037
test4sub49of100,test4pub56of100,100,193,11,6141,1,6153
test4sub49of100,test4pub57of100,100,193,11,5998,0,6009
test4sub49of100,test4pub58of100,100,193,11,5034,1,5046
test4sub31of100,test4pub56of100,100,193,11,6169,1,6181
test4sub4of100,test4pub63of100,100,193,15,1583,1,1599
test4sub44of100,test4pub62of100,100,193,12,2864,0,2876
test4sub44of100,test4pub63of100,100,193,15,1601,1,1617
test4sub49of100,test4pub59of100,100,193,12,4532,0,4544
test4sub49of100,test4pub60of100,100,193,18,4174,1,4193
test4sub49of100,test4pub61of100,100,193,11,3665,0,3676
test4sub49of100,test4pub62of100,100,193,12,2874,1,2887
test4sub49of100,test4pub63of100,100,193,15,1610,1,1626
test4sub16of100,test4pub57of100,100,193,11,6069,1,6081
test4sub16of100,test4pub58of100,100,193,11,5104,1,5116
test4sub39of100,test4pub42of100,100,193,31,9956,1,9988
test4sub39of100,test4pub43of100,100,193,28,9816,0,9844
test4sub39of100,test4pub44of100,100,193,17,9670,1,9688
test4sub39of100,test4pub45of100,100,193,20,9542,0,9562
test4sub39of100,test4pub46of100,100,193,12,9194,1,9207
test4sub39of100,test4pub47of100,100,193,10,8780,1,8791
test4sub39of100,test4pub48of100,100,193,10,8620,0,8630
test4sub39of100,test4pub49of100,100,193,11,8425,1,8437
test4sub39of100,test4pub50of100,100,193,17,8254,1,8272
test4sub39of100,test4pub51of100,100,193,16,8085,1,8102
test4sub39of100,test4pub52of100,100,193,10,7941,0,7951
test4sub39of100,test4pub53of100,100,193,10,7573,1,7584
test4sub39of100,test4pub54of100,100,193,11,7409,1,7421
test4sub39of100,test4pub55of100,100,193,10,7142,0,7152
test4sub54of100,test4pub61of100,100,193,11,3724,1,3736
test4sub54of100,test4pub62of100,100,193,12,2933,1,2946
test4sub54of100,test4pub63of100,100,193,15,1669,1,1685
test4sub31of100,test4pub57of100,100,193,11,6138,1,6150
test4sub31of100,test4pub58of100,100,193,11,5173,1,5185
test4sub39of100,test4pub56of100,100,193,11,6284,1,6296
test4sub31of100,test4pub59of100,100,193,12,4626,1,4639
test4sub39of100,test4pub57of100,100,193,11,6143,1,6155
test4sub31of100,test4pub60of100,100,193,18,4268,1,4287
test4sub31of100,test4pub61of100,100,193,11,3760,1,3772
test4sub39of100,test4pub58of100,100,193,11,5179,1,5191
test4sub31of100,test4pub62of100,100,193,12,2968,1,2981
test4sub39of100,test4pub59of100,100,193,12,4632,1,4645
test4sub31of100,test4pub63of100,100,193,15,1705,0,1720
test4sub39of100,test4pub60of100,100,193,18,4274,1,4293
test4sub39of100,test4pub61of100,100,193,11,3765,0,3776
test4sub39of100,test4pub62of100,100,193,12,2987,1,3000
test4sub39of100,test4pub63of100,100,193,15,1723,0,1738
test4sub43of100,test4pub60of100,100,193,18,4293,1,4312
test4sub43of100,test4pub61of100,100,193,11,3784,0,3795
test4sub43of100,test4pub62of100,100,193,12,2992,0,3004
test4sub43of100,test4pub63of100,100,193,15,1729,1,1745
test4sub16of100,test4pub59of100,100,193,12,4679,1,4692
test4sub16of100,test4pub60of100,100,193,18,4320,1,4339
test4sub16of100,test4pub61of100,100,193,11,3811,0,3822
test4sub16of100,test4pub62of100,100,193,12,3020,1,3033
test4sub16of100,test4pub63of100,100,193,15,1756,1,1772
test4sub97of100,test4pub62of100,100,193,12,3029,1,3042
test4sub41of100,test4pub57of100,100,193,11,6220,0,6231
test4sub41of100,test4pub58of100,100,193,11,5256,1,5268
test4sub41of100,test4pub59of100,100,193,12,4708,1,4721
test4sub41of100,test4pub60of100,100,193,18,4350,1,4369
test4sub97of100,test4pub63of100,100,193,15,1782,1,1798
test4sub41of100,test4pub61of100,100,193,11,3842,1,3854
test4sub41of100,test4pub62of100,100,193,12,3050,0,3062
test4sub41of100,test4pub63of100,100,193,15,1786,0,1801
test4sub91of100,test4pub64of100,100,193,11,1536,1,1548
test4sub38of100,test4pub64of100,100,193,11,1552,1,1564
test4sub57of100,test4pub64of100,100,193,11,1553,1,1565
test4sub86of100,test4pub64of100,100,193,11,1570,0,1581
test4sub52of100,test4pub65of100,100,193,11,35,1,47
test4sub50of100,test4pub65of100,100,193,11,48,1,60
test4sub60of100,test4pub65of100,100,193,11,55,0,66
test4sub13of100,test4pub65of100,100,193,11,55,1,67
test4sub28of100,test4pub65of100,100,193,11,63,0,74
test4sub75of100,test4pub65of100,100,193,11,65,1,77
test4sub96of100,test4pub64of100,100,193,11,1607,1,1619
test4sub64of100,test4pub64of100,100,193,11,1609,1,1621
test4sub85of100,test4pub65of100,100,193,11,77,1,89
test4sub87of100,test4pub64of100,100,193,11,1619,0,1630
test4sub54of100,test4pub64of100,100,193,11,1630,1,1642
test4sub22of100,test4pub64of100,100,193,11,1635,0,1646
test4sub82of100,test4pub64of100,100,193,11,1635,1,1647
test4sub44of100,test4pub65of100,100,193,11,103,0,114
test4sub77of100,test4pub64of100,100,193,11,1654,1,1666
test4sub74of100,test4pub64of100,100,193,11,1655,0,1666
test4sub98of100,test4pub64of100,100,193,11,1661,1,1673
test4sub39of100,test4pub64of100,100,193,11,1666,1,1678
test4sub6of100,test4pub66of100,100,193,16,107,1,124
test4sub16of100,test4pub64of100,100,193,11,1672,0,1683
test4sub56of100,test4pub36of100,100,193,10,11534,0,11544
test4sub56of100,test4pub37of100,100,193,23,11175,1,11199
test4sub97of100,test4pub64of100,100,193,11,1675,1,1687
test4sub56of100,test4pub38of100,100,193,31,10916,0,10947
test4sub56of100,test4pub39of100,100,193,28,10769,1,10798
test4sub56of100,test4pub40of100,100,193,49,10590,0,10639
test4sub4of100,test4pub65of100,100,193,11,139,2,152
test4sub56of100,test4pub41of100,100,193,27,10465,1,10493
test4sub57of100,test4pub65of100,100,193,11,141,1,153
test4sub3of100,test4pub64of100,100,193,11,1682,1,1694
test4sub47of100,test4pub64of100,100,193,11,1688,0,1699
test4sub86of100,test4pub65of100,100,193,11,149,2,162
test4sub33of100,test4pub65of100,100,193,11,151,1,163
test4sub71of100,test4pub61of100,100,193,11,4078,1,4090
test4sub26of100,test4pub63of100,100,193,15,2035,0,2050
test4sub26of100,test4pub64of100,100,193,11,1709,1,1721
test4sub34of100,test4pub63of100,100,193,15,2042,1,2058
test4sub34of100,test4pub64of100,100,193,11,1715,1,1727
test4sub89of100,test4pub64of100,100,193,11,1716,1,1728
test4sub7of100,test4pub65of100,100,193,11,178,1,190
test4sub92of100,test4pub66of100,100,193,16,157,0,173
test4sub37of100,test4pub66of100,100,193,16,183,0,199
test4sub15of100,test4pub57of100,100,193,11,6524,0,6535
test4sub15of100,test4pub58of100,100,193,11,5560,1,5572
test4sub60of100,test4pub64of100,100,193,11,1755,1,1767
test4sub60of100,test4pub66of100,100,193,16,195,2,213
test4sub90of100,test4pub65of100,100,193,11,216,1,228
test4sub52of100,test4pub64of100,100,193,11,1764,0,1775
test4sub91of100,test4pub65of100,100,193,11,226,0,237
test4sub27of100,test4pub62of100,100,193,12,3369,0,3381
test4sub27of100,test4pub63of100,100,193,15,2106,1,2122
test4sub75of100,test4pub64of100,100,193,11,1797,1,1809
test4sub75of100,test4pub66of100,100,193,16,236,0,252
test4sub96of100,test4pub65of100,100,193,11,258,0,269
test4sub13of100,test4pub64of100,100,193,11,1810,1,1822
test4sub54of100,test4pub65of100,100,193,11,273,1,285
test4sub54of100,test4pub66of100,100,193,16,253,0,269
test4sub22of100,test4pub65of100,100,193,11,277,1,289
test4sub22of100,test4pub66of100,100,193,16,257,0,273
test4sub77of100,test4pub65of100,100,193,11,284,1,296
test4sub77of100,test4pub66of100,100,193,16,264,1,281
test4sub39of100,test4pub65of100,100,193,11,287,0,298
test4sub39of100,test4pub66of100,100,193,16,268,1,285
test4sub6of100,test4pub64of100,100,193,11,1835,1,1847
test4sub16of100,test4pub65of100,100,193,11,294,0,305
test4sub6of100,test4pub65of100,100,193,11,295,1,307
test4sub16of100,test4pub66of100,100,193,16,275,1,292
test4sub4of100,test4pub66of100,100,193,16,283,1,300
test4sub57of100,test4pub66of100,100,193,16,285,0,301
test4sub4of100,test4pub64of100,100,193,11,1846,1,1858
test4sub29of100,test4pub60of100,100,193,18,4751,1,4770
test4sub3of100,test4pub66of100,100,193,16,294,1,311
test4sub29of100,test4pub61of100,100,193,11,4242,1,4254
test4sub3of100,test4pub65of100,100,193,11,317,1,329
test4sub86of100,test4pub66of100,100,193,16,302,1,319
test4sub33of100,test4pub66of100,100,193,16,305,1,322
test4sub33of100,test4pub64of100,100,193,11,1868,0,1879
test4sub30of100,test4pub62of100,100,193,12,3555,1,3568
test4sub30of100,test4pub63of100,100,193,15,2291,0,2306
test4sub30of100,test4pub65of100,100,193,11,424,1,436
test4sub25of100,test4pub62of100,100,193,12,3558,1,3571
test4sub25of100,test4pub63of100,100,193,15,2295,1,2311
test4sub25of100,test4pub64of100,100,193,11,1968,1,1980
test4sub66of100,test4pub56of100,100,193,11,6894,1,6906
test4sub66of100,test4pub57of100,100,193,11,6751,0,6762
test4sub66of100,test4pub58of100,100,193,11,5786,0,5797
test4sub66of100,test4pub59of100,100,193,12,5239,1,5252
test4sub66of100,test4pub60of100,100,193,18,4880,0,4898
test4sub66of100,test4pub61of100,100,193,11,4371,0,4382
test4sub66of100,test4pub62of100,100,193,12,3580,1,3593
test4sub34of100,test4pub65of100,100,193,11,446,0,457
test4sub66of100,test4pub63of100,100,193,15,2316,1,2332
test4sub34of100,test4pub66of100,100,193,16,427,1,444
test4sub66of100,test4pub65of100,100,193,11,449,0,460
test4sub89of100,test4pub65of100,100,193,11,453,1,465
test4sub7of100,test4pub66of100,100,193,16,433,1,450
test4sub89of100,test4pub66of100,100,193,16,434,1,451
test4sub7of100,test4pub64of100,100,193,11,1998,1,2010
test4sub92of100,test4pub65of100,100,193,11,461,0,472
test4sub92of100,test4pub64of100,100,193,11,2004,1,2016
test4sub93of100,test4pub57of100,100,193,11,6778,0,6789
test4sub93of100,test4pub58of100,100,193,11,5814,1,5826
test4sub93of100,test4pub59of100,100,193,12,5266,1,5279
test4sub93of100,test4pub60of100,100,193,18,4907,1,4926
test4sub93of100,test4pub61of100,100,193,11,4399,1,4411
test4sub93of100,test4pub62of100,100,193,12,3607,0,3619
test4sub93of100,test4pub63of100,100,193,15,2344,1,2360
test4sub93of100,test4pub66of100,100,193,16,455,1,472
test4sub11of100,test4pub62of100,100,193,12,3611,1,3624
test4sub93of100,test4pub64of100,100,193,11,2019,1,2031
test4sub11of100,test4pub63of100,100,193,15,2348,0,2363
test4sub11of100,test4pub66of100,100,193,16,460,1,477
test4sub37of100,test4pub65of100,100,193,11,485,0,496
test4sub37of100,test4pub64of100,100,193,11,2028,1,2040
test4sub90of100,test4pub64of100,100,193,11,2035,1,2047
test4sub90of100,test4pub66of100,100,193,16,474,1,491
test4sub52of100,test4pub66of100,100,193,16,475,2,493
test4sub91of100,test4pub66of100,100,193,16,475,1,492
test4sub12of100,test4pub57of100,100,193,11,6810,0,6821
test4sub12of100,test4pub58of100,100,193,11,5846,1,5858
test4sub12of100,test4pub59of100,100,193,12,5298,1,5311
test4sub27of100,test4pub65of100,100,193,11,502,2,515
test4sub12of100,test4pub60of100,100,193,18,4939,2,4959
test4sub27of100,test4pub64of100,100,193,11,2045,3,2059
test4sub96of100,test4pub66of100,100,193,16,483,3,502
test4sub12of100,test4pub61of100,100,193,11,4432,3,4446
test4sub13of100,test4pub66of100,100,193,16,484,4,504
test4sub84of100,test4pub60of100,100,193,18,4940,6,4964
test4sub29of100,test4pub62of100,100,193,12,3641,4,3657
test4sub27of100,test4pub66of100,100,193,16,486,4,506
test4sub12of100,test4pub62of100,100,193,12,3643,3,3658
test4sub83of100,test4pub63of100,100,193,15,2378,6,2399
test4sub84of100,test4pub61of100,100,193,11,4438,5,4454
test4sub29of100,test4pub63of100,100,193,15,2380,6,2401
test4sub12of100,test4pub63of100,100,193,15,2382,5,2402
test4sub32of100,test4pub51of100,100,193,16,8812,6,8834
test4sub95of100,test4pub62of100,100,193,12,3648,5,3665
test4sub59of100,test4pub63of100,100,193,15,2384,5,2404
test4sub14of100,test4pub63of100,100,193,15,2385,4,2404
test4sub84of100,test4pub62of100,100,193,12,3650,6,3668
test4sub29of100,test4pub65of100,100,193,11,517,4,532
test4sub12of100,test4pub66of100,100,193,16,497,4,517
test4sub32of100,test4pub52of100,100,193,10,8672,4,8686
test4sub59of100,test4pub65of100,100,193,11,520,3,534
test4sub14of100,test4pub65of100,100,193,11,520,4,535
test4sub29of100,test4pub66of100,100,193,16,501,3,520
test4sub12of100,test4pub64of100,100,193,11,2063,4,2078
test4sub32of100,test4pub53of100,100,193,10,8308,4,8322
test4sub59of100,test4pub66of100,100,193,16,503,3,522
test4sub14of100,test4pub64of100,100,193,11,2066,2,2079
test4sub29of100,test4pub64of100,100,193,11,2067,2,2080
test4sub62of100,test4pub63of100,100,193,15,2395,2,2412
test4sub30of100,test4pub64of100,100,193,11,2078,1,2090
test4sub30of100,test4pub66of100,100,193,16,517,0,533
test4sub25of100,test4pub66of100,100,193,16,520,1,537
test4sub25of100,test4pub65of100,100,193,11,542,0,553
test4sub66of100,test4pub64of100,100,193,11,2087,0,2098
test4sub66of100,test4pub66of100,100,193,16,527,1,544
test4sub73of100,test4pub63of100,100,193,15,2417,1,2433
test4sub80of100,test4pub63of100,100,193,15,2420,0,2435
test4sub67of100,test4pub38of100,100,193,31,11335,0,11366
test4sub67of100,test4pub39of100,100,193,28,11188,1,11217
test4sub93of100,test4pub65of100,100,193,11,556,2,569
test4sub26of100,test4pub66of100,100,193,16,536,1,553
test4sub67of100,test4pub40of100,100,193,49,11010,2,11061
test4sub67of100,test4pub41of100,100,193,27,10886,2,10915
test4sub26of100,test4pub65of100,100,193,11,560,2,573
test4sub11of100,test4pub65of100,100,193,11,561,2,574
test4sub67of100,test4pub42of100,100,193,31,10744,1,10776
test4sub11of100,test4pub64of100,100,193,11,2104,1,2116
test4sub67of100,test4pub43of100,100,193,28,10606,1,10635
test4sub15of100,test4pub59of100,100,193,12,5364,1,5377
test4sub67of100,test4pub44of100,100,193,17,10460,1,10478
test4sub15of100,test4pub60of100,100,193,18,5005,0,5023
test4sub67of100,test4pub45of100,100,193,20,10332,1,10353
test4sub67of100,test4pub46of100,100,193,12,9984,1,9997
test4sub15of100,test4pub61of100,100,193,11,4497,1,4509
test4sub15of100,test4pub62of100,100,193,12,3706,1,3719
test4sub15of100,test4pub63of100,100,193,15,2442,0,2457
test4sub15of100,test4pub65of100,100,193,11,574,0,585
test4sub15of100,test4pub64of100,100,193,11,2117,1,2129
test4sub15of100,test4pub66of100,100,193,16,556,0,572
test4sub12of100,test4pub65of100,100,193,11,703,1,715
test4sub59of100,test4pub64of100,100,193,11,2330,0,2341
test4sub14of100,test4pub66of100,100,193,16,770,1,787
test4sub67of100,test4pub47of100,100,193,10,9811,0,9821
test4sub67of100,test4pub48of100,100,193,10,9652,1,9663
test4sub68of100,test4pub62of100,100,193,12,3948,1,3961
test4sub68of100,test4pub63of100,100,193,15,2685,0,2700
test4sub67of100,test4pub49of100,100,193,11,9457,1,9469
test4sub67of100,test4pub50of100,100,193,17,9287,1,9305
test4sub67of100,test4pub51of100,100,193,16,9118,0,9134
test4sub63of100,test4pub63of100,100,193,15,2691,0,2706
test4sub42of100,test4pub60of100,100,193,18,5261,1,5280
test4sub42of100,test4pub61of100,100,193,11,4752,0,4763
test4sub42of100,test4pub62of100,100,193,12,3960,1,3973
test4sub8of100,test4pub62of100,100,193,12,3962,1,3975
test4sub8of100,test4pub63of100,100,193,15,2698,1,2714
test4sub8of100,test4pub64of100,100,193,11,2371,0,2382
test4sub84of100,test4pub63of100,100,193,15,2710,1,2726
test4sub84of100,test4pub66of100,100,193,16,821,0,837
test4sub84of100,test4pub65of100,100,193,11,844,1,856
test4sub84of100,test4pub64of100,100,193,11,2386,1,2398
test4sub83of100,test4pub65of100,100,193,11,870,1,882
test4sub83of100,test4pub64of100,100,193,11,2412,0,2423
test4sub83of100,test4pub66of100,100,193,16,852,1,869
test4sub32of100,test4pub54of100,100,193,11,8493,0,8504
test4sub32of100,test4pub55of100,100,193,10,8227,1,8238
test4sub32of100,test4pub56of100,100,193,11,7334,0,7345
test4sub32of100,test4pub57of100,100,193,11,7191,0,7202
test4sub32of100,test4pub58of100,100,193,11,6227,1,6239
test4sub32of100,test4pub59of100,100,193,12,5679,0,5691
test4sub32of100,test4pub60of100,100,193,18,5320,0,5338
test4sub32of100,test4pub61of100,100,193,11,4812,1,4824
test4sub32of100,test4pub62of100,100,193,12,4020,0,4032
test4sub32of100,test4pub63of100,100,193,15,2756,0,2771
test4sub32of100,test4pub64of100,100,193,11,2430,1,2442
test4sub32of100,test4pub65of100,100,193,11,890,0,901
test4sub32of100,test4pub66of100,100,193,16,870,0,886
test4sub95of100,test4pub63of100,100,193,15,2763,1,2779
test4sub95of100,test4pub65of100,100,193,11,896,1,908
test4sub95of100,test4pub64of100,100,193,11,2439,0,2450
test4sub95of100,test4pub66of100,100,193,16,879,1,896
test4sub62of100,test4pub64of100,100,193,11,2455,2,2468
test4sub73of100,test4pub64of100,100,193,11,2456,1,2468
test4sub62of100,test4pub65of100,100,193,11,916,3,930
test4sub80of100,test4pub64of100,100,193,11,2458,4,2473
test4sub73of100,test4pub66of100,100,193,16,897,6,919
test4sub62of100,test4pub66of100,100,193,16,898,6,920
test4sub67of100,test4pub52of100,100,193,10,9073,5,9088
test4sub80of100,test4pub66of100,100,193,16,901,5,922
test4sub73of100,test4pub65of100,100,193,11,924,6,941
test4sub67of100,test4pub53of100,100,193,10,8711,4,8725
test4sub80of100,test4pub65of100,100,193,11,929,4,944
test4sub8of100,test4pub65of100,100,193,11,929,4,944
test4sub67of100,test4pub54of100,100,193,11,8550,4,8565
test4sub8of100,test4pub66of100,100,193,16,913,2,931
test4sub67of100,test4pub55of100,100,193,10,8286,1,8297
test4sub67of100,test4pub56of100,100,193,11,7394,1,7406
test4sub67of100,test4pub57of100,100,193,11,7252,1,7264
test4sub67of100,test4pub58of100,100,193,11,6289,1,6301
test4sub67of100,test4pub59of100,100,193,12,5741,1,5754
test4sub67of100,test4pub60of100,100,193,18,5383,1,5402
test4sub67of100,test4pub61of100,100,193,11,4938,1,4950
test4sub67of100,test4pub62of100,100,193,12,4147,0,4159
test4sub67of100,test4pub63of100,100,193,15,2884,1,2900
test4sub67of100,test4pub64of100,100,193,11,2557,1,2569
test4sub68of100,test4pub64of100,100,193,11,2558,1,2570
test4sub68of100,test4pub65of100,100,193,11,1018,1,1030
test4sub63of100,test4pub64of100,100,193,11,2560,2,2573
test4sub67of100,test4pub65of100,100,193,11,1018,3,1032
test4sub42of100,test4pub63of100,100,193,15,2889,2,2906
test4sub68of100,test4pub66of100,100,193,16,999,2,1017
test4sub63of100,test4pub66of100,100,193,16,1001,2,1019
test4sub67of100,test4pub66of100,100,193,16,1001,2,1019
test4sub42of100,test4pub65of100,100,193,11,1023,1,1035
test4sub63of100,test4pub65of100,100,193,11,1024,1,1036
test4sub42of100,test4pub64of100,100,193,11,2566,1,2578
test4sub42of100,test4pub66of100,100,193,16,1006,0,1022
test4sub58of100,test4pub58of100,100,193,11,6408,1,6420
test4sub58of100,test4pub59of100,100,193,12,5861,0,5873
test4sub58of100,test4pub60of100,100,193,18,5503,1,5522
test4sub58of100,test4pub61of100,100,193,11,4994,1,5006
test4sub58of100,test4pub62of100,100,193,12,4202,0,4214
test4sub58of100,test4pub63of100,100,193,15,2953,1,2969
test4sub58of100,test4pub64of100,100,193,11,2626,0,2637
test4sub58of100,test4pub65of100,100,193,11,1087,1,1099
test4sub58of100,test4pub66of100,100,193,16,1069,0,1085
test4sub99of100,test4pub84of100,10,192,11,37154,1,37166
test4sub99of100,test4pub85of100,10,192,23,35624,1,35648
test4sub99of100,test4pub86of100,10,192,21,35198,0,35219
test4sub99of100,test4pub87of100,10,192,10,34969,1,34980
test4sub99of100,test4pub88of100,10,192,11,34744,0,34755
test4sub99of100,test4pub89of100,10,192,39,33758,1,33798
test4sub99of100,test4pub90of100,10,192,23,33599,1,33623
test4sub99of100,test4pub91of100,10,192,26,33436,0,33462
test4sub99of100,test4pub92of100,10,192,12,33264,0,33276
test4sub99of100,test4pub93of100,10,192,13,32937,1,32951
test4sub99of100,test4pub94of100,10,192,10,32347,0,32357
test4sub99of100,test4pub95of100,10,192,17,31991,1,32009
test4sub99of100,test4pub96of100,10,192,10,31828,1,31839
test4sub99of100,test4pub97of100,10,192,10,31690,0,31700
test4sub99of100,test4pub98of100,10,192,11,31543,0,31554
test4sub99of100,test4pub99of100,10,192,10,31336,1,31347
test4sub99of100,test4pub100of100,10,193,15,31215,0,31230
test4sub99of100,test4pub2of100,100,192,10,25985,1,25996
test4sub99of100,test4pub1of100,100,12977,24,26021,44,26089
test4sub99of100,test4pub3of100,100,192,28,25934,1,25963
test4sub99of100,test4pub4of100,100,192,11,24591,0,24602
test4sub99of100,test4pub5of100,100,192,14,23595,1,23610
test4sub99of100,test4pub6of100,100,192,26,23272,1,23299
test4sub99of100,test4pub7of100,100,192,14,22639,0,22653
test4sub99of100,test4pub8of100,100,192,12,22377,1,22390
test4sub99of100,test4pub9of100,100,192,20,22193,1,22214
test4sub99of100,test4pub10of100,100,193,11,21829,0,21840
test4sub99of100,test4pub11of100,100,193,10,21594,1,21605
test4sub99of100,test4pub12of100,100,193,11,21151,1,21163
test4sub99of100,test4pub13of100,100,193,10,20948,0,20958
test4sub99of100,test4pub14of100,100,193,10,20782,1,20793
test4sub99of100,test4pub15of100,100,193,11,20644,0,20655
test4sub99of100,test4pub16of100,100,193,10,20487,0,20497
test4sub99of100,test4pub17of100,100,193,11,20354,1,20366
test4sub99of100,test4pub18of100,100,193,18,20169,1,20188
test4sub99of100,test4pub19of100,100,193,11,19960,0,19971
test4sub99of100,test4pub20of100,100,193,10,19520,1,19531
test4sub99of100,test4pub21of100,100,193,10,19434,1,19445
test4sub99of100,test4pub22of100,100,193,10,19303,0,19313
test4sub99of100,test4pub23of100,100,193,11,19131,0,19142
test4sub99of100,test4pub24of100,100,193,19,19003,1,19023
test4sub99of100,test4pub25of100,100,193,16,18581,1,18598
test4sub99of100,test4pub26of100,100,193,10,18364,0,18374
test4sub99of100,test4pub27of100,100,193,10,18044,1,18055
test4sub99of100,test4pub28of100,100,193,10,17943,0,17953
test4sub99of100,test4pub29of100,100,193,11,17778,0,17789
test4sub99of100,test4pub30of100,100,193,15,17643,1,17659
test4sub99of100,test4pub31of100,100,193,10,17510,0,17520
test4sub99of100,test4pub32of100,100,193,11,17158,0,17169
test4sub99of100,test4pub33of100,100,193,11,17018,1,17030
test4sub99of100,test4pub34of100,100,193,12,16238,1,16251
test4sub99of100,test4pub35of100,100,193,12,13884,0,13896
test4sub99of100,test4pub36of100,100,193,10,12609,0,12619
test4sub64of100,test4pub65of100,100,193,11,1209,0,1220
test4sub99of100,test4pub37of100,100,193,23,12250,1,12274
test4sub64of100,test4pub66of100,100,193,16,1190,1,1207
test4sub99of100,test4pub38of100,100,193,31,11992,1,12024
test4sub99of100,test4pub39of100,100,193,28,11845,1,11874
test4sub99of100,test4pub40of100,100,193,49,11666,1,11716
test4sub99of100,test4pub41of100,100,193,27,11541,0,11568
test4sub99of100,test4pub42of100,100,193,31,11398,1,11430
test4sub99of100,test4pub43of100,100,193,28,11259,1,11288
test4sub99of100,test4pub45of100,100,193,20,10983,0,11003
test4sub99of100,test4pub44of100,100,193,17,11113,1,11131
test4sub99of100,test4pub46of100,100,193,12,10636,1,10649
test4sub99of100,test4pub47of100,100,193,10,10222,0,10232
test4sub99of100,test4pub48of100,100,193,10,10063,1,10074
test4sub99of100,test4pub49of100,100,193,11,9867,1,9879
test4sub99of100,test4pub50of100,100,193,17,9696,0,9713
test4sub99of100,test4pub51of100,100,193,16,9527,0,9543
test4sub99of100,test4pub52of100,100,193,10,9383,1,9394
test4sub99of100,test4pub53of100,100,193,10,9015,0,9025
test4sub99of100,test4pub54of100,100,193,11,8850,0,8861
test4sub99of100,test4pub55of100,100,193,10,8584,1,8595
test4sub99of100,test4pub56of100,100,193,11,7691,1,7703
test4sub99of100,test4pub57of100,100,193,11,7548,0,7559
test4sub99of100,test4pub58of100,100,193,11,6584,1,6596
test4sub99of100,test4pub59of100,100,193,12,6036,0,6048
test4sub99of100,test4pub60of100,100,193,18,5678,1,5697
test4sub99of100,test4pub61of100,100,193,11,5169,1,5181
test4sub99of100,test4pub62of100,100,193,12,4377,0,4389
test4sub99of100,test4pub63of100,100,193,15,3114,1,3130
test4sub99of100,test4pub65of100,100,193,11,1246,0,1257
test4sub99of100,test4pub64of100,100,193,11,2788,0,2799
test4sub99of100,test4pub66of100,100,193,16,1228,1,1245
test4sub9of100,test4pub61of100,100,193,11,5217,1,5229
test4sub9of100,test4pub62of100,100,193,12,4425,0,4437
test4sub76of100,test4pub64of100,100,193,11,2872,1,2884
test4sub74of100,test4pub65of100,100,193,11,1339,0,1350
test4sub71of100,test4pub62of100,100,193,12,4590,0,4602
test4sub65of100,test4pub57of100,100,193,11,7806,1,7818
test4sub40of100,test4pub64of100,100,193,11,3043,1,3055
test4sub9of100,test4pub63of100,100,193,15,3577,2,3594
test4sub10of100,test4pub36of100,100,193,10,12953,1,12964
test4sub43of100,test4pub65of100,100,193,11,1578,1,1590
test4sub70of100,test4pub59of100,100,193,12,6421,1,6434
test4sub76of100,test4pub65of100,100,193,11,1708,4,1723
test4sub74of100,test4pub66of100,100,193,16,1688,5,1709
test4sub65of100,test4pub58of100,100,193,11,7055,5,7071
test4sub40of100,test4pub66of100,100,193,16,1689,5,1710
test4sub71of100,test4pub63of100,100,193,15,3578,5,3598
test4sub9of100,test4pub64of100,100,193,11,3252,4,3267
test4sub10of100,test4pub37of100,100,193,23,12752,5,12780
test4sub76of100,test4pub66of100,100,193,16,1692,5,1713
test4sub70of100,test4pub60of100,100,193,18,6148,6,6172
test4sub43of100,test4pub66of100,100,193,16,1690,7,1713
test4sub40of100,test4pub65of100,100,193,11,1715,6,1732
test4sub65of100,test4pub59of100,100,193,12,6512,6,6530
test4sub71of100,test4pub65of100,100,193,11,1717,6,1734
test4sub9of100,test4pub65of100,100,193,11,1717,6,1734
test4sub10of100,test4pub38of100,100,193,31,12499,5,12535
test4sub70of100,test4pub61of100,100,193,11,5646,5,5662
test4sub43of100,test4pub64of100,100,193,11,3262,5,3278
test4sub65of100,test4pub60of100,100,193,18,6159,4,6181
test4sub9of100,test4pub66of100,100,193,16,1702,3,1721
test4sub71of100,test4pub66of100,100,193,16,1702,4,1722
test4sub10of100,test4pub39of100,100,193,28,12357,3,12388
test4sub70of100,test4pub62of100,100,193,12,4859,5,4876
test4sub65of100,test4pub61of100,100,193,11,5654,3,5668
test4sub71of100,test4pub64of100,100,193,11,3269,2,3282
test4sub10of100,test4pub40of100,100,193,49,12180,2,12231
test4sub65of100,test4pub62of100,100,193,12,4864,1,4877
test4sub70of100,test4pub63of100,100,193,15,3599,2,3616
test4sub10of100,test4pub41of100,100,193,27,12058,2,12087
test4sub65of100,test4pub63of100,100,193,15,3601,2,3618
test4sub70of100,test4pub66of100,100,193,16,1713,1,1730
test4sub10of100,test4pub42of100,100,193,31,11916,1,11948
test4sub65of100,test4pub64of100,100,193,11,3277,1,3289
test4sub70of100,test4pub64of100,100,193,11,3277,2,3290
test4sub65of100,test4pub65of100,100,193,11,1738,1,1750
test4sub10of100,test4pub43of100,100,193,28,11778,1,11807
test4sub70of100,test4pub65of100,100,193,11,1739,1,1751
test4sub65of100,test4pub66of100,100,193,16,1719,1,1736
test4sub10of100,test4pub44of100,100,193,17,11633,1,11651
test4sub10of100,test4pub45of100,100,193,20,11506,0,11526
test4sub10of100,test4pub46of100,100,193,12,11158,1,11171
test4sub10of100,test4pub47of100,100,193,10,10744,0,10754
test4sub79of100,test4pub58of100,100,193,11,7093,1,7105
test4sub5of100,test4pub36of100,100,193,10,13149,1,13160
test4sub49of100,test4pub65of100,100,193,11,1748,1,1760
test4sub10of100,test4pub48of100,100,193,10,10585,4,10599
test4sub5of100,test4pub37of100,100,193,23,12790,1,12814
test4sub5of100,test4pub38of100,100,193,31,12532,0,12563
test4sub10of100,test4pub49of100,100,193,11,10392,1,10404
test4sub10of100,test4pub50of100,100,193,17,10222,0,10239
test4sub5of100,test4pub39of100,100,193,28,12385,1,12414
test4sub10of100,test4pub51of100,100,193,16,10054,1,10071
test4sub5of100,test4pub40of100,100,193,49,12207,1,12257
test4sub5of100,test4pub41of100,100,193,27,12082,1,12110
test4sub10of100,test4pub52of100,100,193,10,9909,1,9920
test4sub10of100,test4pub53of100,100,193,10,9542,0,9552
test4sub5of100,test4pub42of100,100,193,31,11940,1,11972
test4sub10of100,test4pub54of100,100,193,11,9378,0,9389
test4sub5of100,test4pub43of100,100,193,28,11801,0,11829
test4sub5of100,test4pub44of100,100,193,17,11655,1,11673
test4sub10of100,test4pub55of100,100,193,10,9112,1,9123
test4sub10of100,test4pub56of100,100,193,11,8220,1,8232
test4sub10of100,test4pub57of100,100,193,11,8077,1,8089
test4sub10of100,test4pub58of100,100,193,11,7112,0,7123
test4sub10of100,test4pub59of100,100,193,12,6565,1,6578
test4sub10of100,test4pub60of100,100,193,18,6206,1,6225
test4sub10of100,test4pub61of100,100,193,11,5697,0,5708
test4sub10of100,test4pub62of100,100,193,12,4905,0,4917
test4sub10of100,test4pub63of100,100,193,15,3642,1,3658
test4sub10of100,test4pub65of100,100,193,11,1774,1,1786
test4sub10of100,test4pub64of100,100,193,11,3316,0,3327
test4sub10of100,test4pub66of100,100,193,16,1755,1,1772
test4sub28of100,test4pub64of100,100,193,11,3381,0,3392
test4sub50of100,test4pub66of100,100,193,16,1850,1,1867
test4sub5of100,test4pub45of100,100,193,20,11668,1,11689
test4sub5of100,test4pub47of100,100,193,10,10904,1,10915
test4sub5of100,test4pub46of100,100,193,12,11321,1,11334
test4sub5of100,test4pub48of100,100,193,10,10754,0,10764
test4sub5of100,test4pub49of100,100,193,11,10559,1,10571
test4sub49of100,test4pub64of100,100,193,11,3492,1,3504
test4sub28of100,test4pub66of100,100,193,16,1931,2,1949
test4sub49of100,test4pub66of100,100,193,16,1931,1,1948
test4sub23of100,test4pub59of100,100,193,12,6758,0,6770
test4sub23of100,test4pub60of100,100,193,18,6400,1,6419
test4sub23of100,test4pub61of100,100,193,11,5891,0,5902
test4sub23of100,test4pub62of100,100,193,12,5100,1,5113
test4sub23of100,test4pub63of100,100,193,15,3836,0,3851
test4sub50of100,test4pub64of100,100,193,11,3509,0,3520
test4sub5of100,test4pub50of100,100,193,17,10449,0,10466
test4sub5of100,test4pub51of100,100,193,16,10281,1,10298
test4sub5of100,test4pub52of100,100,193,10,10136,0,10146
test4sub5of100,test4pub53of100,100,193,10,9768,1,9779
test4sub5of100,test4pub54of100,100,193,11,9604,1,9616
test4sub5of100,test4pub55of100,100,193,10,9337,0,9347
test4sub5of100,test4pub56of100,100,193,11,8444,1,8456
test4sub5of100,test4pub57of100,100,193,11,8302,1,8314
test4sub5of100,test4pub58of100,100,193,11,7337,0,7348
test4sub79of100,test4pub59of100,100,193,12,6805,1,6818
test4sub79of100,test4pub60of100,100,193,18,6447,1,6466
test4sub79of100,test4pub61of100,100,193,11,5938,0,5949
test4sub79of100,test4pub62of100,100,193,12,5147,1,5160
test4sub79of100,test4pub63of100,100,193,15,3883,1,3899
test4sub23of100,test4pub65of100,100,193,11,2015,2,2028
test4sub79of100,test4pub65of100,100,193,11,2016,1,2028
test4sub23of100,test4pub64of100,100,193,11,3558,1,3570
test4sub79of100,test4pub66of100,100,193,16,1997,1,2014
test4sub23of100,test4pub66of100,100,193,16,1998,1,2015
test4sub79of100,test4pub64of100,100,193,11,3562,1,3574
test4sub87of100,test4pub65of100,100,193,11,2022,1,2034
test4sub87of100,test4pub66of100,100,193,16,2002,1,2019
test4sub5of100,test4pub59of100,100,193,12,6826,0,6838
test4sub5of100,test4pub60of100,100,193,18,6468,1,6487
test4sub5of100,test4pub61of100,100,193,11,5977,1,5989
test4sub5of100,test4pub62of100,100,193,12,5185,0,5197
test4sub5of100,test4pub63of100,100,193,15,3922,1,3938
test4sub5of100,test4pub65of100,100,193,11,2055,1,2067
test4sub5of100,test4pub64of100,100,193,11,3597,0,3608
test4sub5of100,test4pub66of100,100,193,16,2037,1,2054
test4sub97of100,test4pub65of100,100,193,11,2082,1,2094
test4sub97of100,test4pub66of100,100,193,16,2063,1,2080
test4sub85of100,test4pub64of100,100,193,11,3663,1,3675
test4sub85of100,test4pub66of100,100,193,16,2102,0,2118
test4sub47of100,test4pub66of100,100,193,16,2110,1,2127
test4sub47of100,test4pub65of100,100,193,11,2133,1,2145
test4sub98of100,test4pub65of100,100,193,11,2177,0,2188
test4sub98of100,test4pub66of100,100,193,16,2158,1,2175
test4sub82of100,test4pub66of100,100,193,16,2191,1,2208
test4sub82of100,test4pub65of100,100,193,11,2214,1,2226
test4sub38of100,test4pub65of100,100,193,11,2335,1,2347
test4sub38of100,test4pub66of100,100,193,16,2319,0,2335
test4sub46of100,test4pub34of100,100,193,12,17430,0,17442
test4sub46of100,test4pub35of100,100,193,12,15077,1,15090
test4sub46of100,test4pub36of100,100,193,10,13802,0,13812
test4sub46of100,test4pub37of100,100,193,23,13443,1,13467
test4sub46of100,test4pub38of100,100,193,31,13184,1,13216
test4sub55of100,test4pub58of100,100,193,11,7750,1,7762
test4sub46of100,test4pub39of100,100,193,28,13037,1,13066
test4sub55of100,test4pub59of100,100,193,12,7203,1,7216
test4sub46of100,test4pub40of100,100,193,49,12858,1,12908
test4sub46of100,test4pub41of100,100,193,27,12734,1,12762
test4sub55of100,test4pub60of100,100,193,18,6845,1,6864
test4sub46of100,test4pub42of100,100,193,31,12592,1,12624
test4sub46of100,test4pub43of100,100,193,28,12452,0,12480
test4sub46of100,test4pub44of100,100,193,17,12305,0,12322
test4sub46of100,test4pub45of100,100,193,20,12178,1,12199
test4sub46of100,test4pub46of100,100,193,12,11829,0,11841
test4sub46of100,test4pub47of100,100,193,10,11416,1,11427
test4sub46of100,test4pub48of100,100,193,10,11256,0,11266
test4sub46of100,test4pub49of100,100,193,11,11060,0,11071
test4sub46of100,test4pub50of100,100,193,17,10890,1,10908
test4sub46of100,test4pub51of100,100,193,16,10721,0,10737
test4sub46of100,test4pub52of100,100,193,10,10577,1,10588
test4sub46of100,test4pub53of100,100,193,10,10209,0,10219
test4sub46of100,test4pub54of100,100,193,11,10050,1,10062
test4sub46of100,test4pub55of100,100,193,10,9783,1,9794
test4sub55of100,test4pub61of100,100,193,11,6393,1,6405
test4sub17of100,test4pub64of100,100,193,11,4010,1,4022
test4sub55of100,test4pub62of100,100,193,12,5602,3,5617
test4sub55of100,test4pub63of100,100,193,15,4340,6,4361
test4sub55of100,test4pub64of100,100,193,11,4019,1,4031
test4sub55of100,test4pub66of100,100,193,16,2459,0,2475
test4sub55of100,test4pub65of100,100,193,11,2482,1,2494
test4sub46of100,test4pub56of100,100,193,11,8975,1,8987
test4sub46of100,test4pub57of100,100,193,11,8833,1,8845
test4sub46of100,test4pub58of100,100,193,11,7868,0,7879
test4sub46of100,test4pub59of100,100,193,12,7329,0,7341
test4sub46of100,test4pub60of100,100,193,18,6971,1,6990
test4sub46of100,test4pub61of100,100,193,11,6462,0,6473
test4sub46of100,test4pub62of100,100,193,12,5685,1,5698
test4sub46of100,test4pub63of100,100,193,15,4421,1,4437
test4sub46of100,test4pub65of100,100,193,11,2554,0,2565
test4sub46of100,test4pub64of100,100,193,11,4096,0,4107
test4sub46of100,test4pub66of100,100,193,16,2536,1,2553
test4sub17of100,test4pub66of100,100,193,16,2546,1,2563
test4sub17of100,test4pub65of100,100,193,11,2568,0,2579
test4sub44of100,test4pub64of100,100,193,11,4224,0,4235
test4sub44of100,test4pub66of100,100,193,16,2664,1,2681
test4sub72of100,test4pub71of100,10,192,11,47904,0,47915
test4sub72of100,test4pub72of100,10,192,18,43062,1,43081
test4sub72of100,test4pub73of100,10,192,11,42185,0,42196
test4sub72of100,test4pub74of100,10,192,10,41559,1,41570
test4sub72of100,test4pub75of100,10,192,10,40877,1,40888
test4sub72of100,test4pub76of100,10,192,10,40711,0,40721
test4sub72of100,test4pub77of100,10,192,10,40252,1,40263
test4sub72of100,test4pub78of100,10,192,12,40205,1,40218
test4sub72of100,test4pub79of100,10,191,9,40127,0,40136
test4sub72of100,test4pub80of100,10,192,10,39730,1,39741
test4sub72of100,test4pub81of100,10,192,17,39615,1,39633
test4sub72of100,test4pub82of100,10,192,10,39462,1,39473
test4sub72of100,test4pub83of100,10,192,10,39313,0,39323
test4sub72of100,test4pub84of100,10,192,11,38835,1,38847
test4sub72of100,test4pub85of100,10,192,23,37304,0,37327
test4sub72of100,test4pub86of100,10,192,21,36878,0,36899
test4sub72of100,test4pub87of100,10,192,10,36649,1,36660
test4sub72of100,test4pub88of100,10,192,11,36424,0,36435
test4sub72of100,test4pub89of100,10,192,39,35443,0,35482
test4sub72of100,test4pub90of100,10,192,23,35285,1,35309
test4sub72of100,test4pub91of100,10,192,26,35122,0,35148
test4sub72of100,test4pub92of100,10,192,12,34960,1,34973
test4sub72of100,test4pub93of100,10,192,13,34632,0,34645
test4sub72of100,test4pub94of100,10,192,10,34042,1,34053
test4sub72of100,test4pub95of100,10,192,17,33698,1,33716
test4sub72of100,test4pub96of100,10,192,10,33535,0,33545
test4sub72of100,test4pub97of100,10,192,10,33401,0,33411
test4sub72of100,test4pub98of100,10,192,11,33255,1,33267
test4sub72of100,test4pub99of100,10,192,10,33047,0,33057
test4sub72of100,test4pub100of100,10,193,15,32950,1,32966
test4sub72of100,test4pub2of100,100,192,10,27719,0,27729
test4sub72of100,test4pub3of100,100,192,28,27622,0,27650
test4sub48of100,test4pub57of100,100,193,11,9224,0,9235
test4sub48of100,test4pub58of100,100,193,11,8259,1,8271
test4sub48of100,test4pub59of100,100,193,12,7712,0,7724
test4sub48of100,test4pub60of100,100,193,18,7353,1,7372
test4sub48of100,test4pub61of100,100,193,11,6845,1,6857
test4sub48of100,test4pub62of100,100,193,12,6100,1,6113
test4sub72of100,test4pub1of100,100,12977,24,27868,44,27936
test4sub1of100,test4pub37of100,100,193,23,14009,44,14076
test4sub48of100,test4pub63of100,100,193,15,4838,44,4897
test4sub1of100,test4pub38of100,100,193,31,13793,1,13825
test4sub72of100,test4pub4of100,100,192,11,26437,2,26450
test4sub72of100,test4pub5of100,100,192,14,25442,1,25457
test4sub1of100,test4pub39of100,100,193,28,13646,1,13675
test4sub48of100,test4pub66of100,100,193,16,2993,2,3011
test4sub72of100,test4pub6of100,100,192,26,25120,2,25148
test4sub1of100,test4pub40of100,100,193,49,13469,1,13519
test4sub48of100,test4pub65of100,100,193,11,3019,1,3031
test4sub1of100,test4pub41of100,100,193,27,13346,2,13375
test4sub1of100,test4pub42of100,100,193,31,13204,1,13236
test4sub48of100,test4pub64of100,100,193,11,4562,2,4575
test4sub72of100,test4pub7of100,100,192,14,24491,4,24509
test4sub1of100,test4pub43of100,100,193,28,13065,1,13094
test4sub1of100,test4pub44of100,100,193,17,12919,1,12937
test4sub72of100,test4pub8of100,100,192,12,24232,1,24245
test4sub1of100,test4pub45of100,100,193,20,12792,1,12813
test4sub72of100,test4pub9of100,100,192,20,24049,1,24070
test4sub1of100,test4pub46of100,100,193,12,12443,1,12456
test4sub72of100,test4pub10of100,100,193,11,23685,1,23697
test4sub1of100,test4pub47of100,100,193,10,12030,7,12047
test4sub72of100,test4pub11of100,100,193,10,23451,7,23468
test4sub1of100,test4pub48of100,100,193,10,11877,0,11887
test4sub72of100,test4pub12of100,100,193,11,23014,1,23026
test4sub1of100,test4pub49of100,100,193,11,11682,1,11694
test4sub72of100,test4pub13of100,100,193,10,22812,1,22823
test4sub72of100,test4pub14of100,100,193,10,22646,1,22657
test4sub1of100,test4pub50of100,100,193,17,11512,1,11530
test4sub72of100,test4pub15of100,100,193,11,22508,9,22528
test4sub1of100,test4pub51of100,100,193,16,11344,9,11369
test4sub1of100,test4pub52of100,100,193,10,11207,1,11218
test4sub72of100,test4pub16of100,100,193,10,22360,2,22372
test4sub1of100,test4pub53of100,100,193,10,10840,0,10850
test4sub72of100,test4pub17of100,100,193,11,22227,1,22239
test4sub72of100,test4pub18of100,100,193,18,22043,0,22061
test4sub1of100,test4pub54of100,100,193,11,10676,1,10688
test4sub72of100,test4pub19of100,100,193,11,21835,1,21847
test4sub1of100,test4pub55of100,100,193,10,10410,1,10421
test4sub72of100,test4pub20of100,100,193,10,21394,1,21405
test4sub1of100,test4pub56of100,100,193,11,9518,1,9530
test4sub72of100,test4pub21of100,100,193,10,21309,1,21320
test4sub1of100,test4pub57of100,100,193,11,9376,1,9388
test4sub1of100,test4pub58of100,100,193,11,8411,0,8422
test4sub72of100,test4pub22of100,100,193,10,21179,1,21190
test4sub72of100,test4pub23of100,100,193,11,21008,11,21030
test4sub1of100,test4pub59of100,100,193,12,7864,11,7887
test4sub72of100,test4pub24of100,100,193,19,20889,0,20908
test4sub72of100,test4pub25of100,100,193,16,20468,1,20485
test4sub72of100,test4pub26of100,100,193,10,20251,0,20261
test4sub1of100,test4pub60of100,100,193,18,7518,0,7536
test4sub1of100,test4pub61of100,100,193,11,7010,1,7022
test4sub72of100,test4pub27of100,100,193,10,19931,1,19942
test4sub72of100,test4pub28of100,100,193,10,19831,1,19842
test4sub72of100,test4pub29of100,100,193,11,19666,1,19678
test4sub72of100,test4pub30of100,100,193,15,19530,0,19545
test4sub72of100,test4pub31of100,100,193,10,19398,1,19409
test4sub72of100,test4pub32of100,100,193,11,19046,1,19058
test4sub72of100,test4pub33of100,100,193,11,18905,0,18916
test4sub72of100,test4pub34of100,100,193,12,18125,0,18137
test4sub72of100,test4pub35of100,100,193,12,15772,1,15785
test4sub72of100,test4pub36of100,100,193,10,14497,0,14507
test4sub72of100,test4pub37of100,100,193,23,14137,1,14161
test4sub72of100,test4pub38of100,100,193,31,13879,1,13911
test4sub1of100,test4pub62of100,100,193,12,6264,1,6277
test4sub1of100,test4pub63of100,100,193,15,5001,1,5017
test4sub1of100,test4pub64of100,100,193,11,4674,1,4686
test4sub72of100,test4pub39of100,100,193,28,13766,0,13794
test4sub1of100,test4pub65of100,100,193,11,3135,1,3147
test4sub72of100,test4pub40of100,100,193,49,13588,1,13638
test4sub72of100,test4pub41of100,100,193,27,13474,1,13502
test4sub72of100,test4pub42of100,100,193,31,13332,4,13367
test4sub1of100,test4pub66of100,100,193,16,3116,4,3136
test4sub72of100,test4pub43of100,100,193,28,13195,0,13223
test4sub72of100,test4pub44of100,100,193,17,13049,1,13067
test4sub72of100,test4pub45of100,100,193,20,12921,0,12941
test4sub72of100,test4pub46of100,100,193,12,12572,1,12585
test4sub72of100,test4pub47of100,100,193,10,12159,1,12170
test4sub72of100,test4pub48of100,100,193,10,11999,0,12009
test4sub72of100,test4pub49of100,100,193,11,11804,1,11816
test4sub72of100,test4pub50of100,100,193,17,11655,1,11673
test4sub72of100,test4pub51of100,100,193,16,11486,1,11503
test4sub72of100,test4pub52of100,100,193,10,11342,1,11353
test4sub72of100,test4pub53of100,100,193,10,10974,0,10984
test4sub72of100,test4pub54of100,100,193,11,10810,1,10822
test4sub72of100,test4pub55of100,100,193,10,10543,1,10554
test4sub72of100,test4pub56of100,100,193,11,9670,0,9681
test4sub72of100,test4pub57of100,100,193,11,9527,1,9539
test4sub72of100,test4pub58of100,100,193,11,8563,0,8574
test4sub72of100,test4pub59of100,100,193,12,8016,1,8029
test4sub72of100,test4pub60of100,100,193,18,7657,1,7676
test4sub72of100,test4pub61of100,100,193,11,7148,1,7160
test4sub72of100,test4pub62of100,100,193,12,6357,1,6370
test4sub72of100,test4pub63of100,100,193,15,5093,0,5108
test4sub72of100,test4pub66of100,100,193,16,3204,1,3221
test4sub72of100,test4pub65of100,100,193,11,3227,1,3239
test4sub72of100,test4pub64of100,100,193,11,4769,0,4780
test4sub30of100,test4pub67of100,100,193,11,3748,1,3760
test4sub76of100,test4pub67of100,100,193,11,3757,1,3769
test4sub59of100,test4pub67of100,100,193,11,3787,1,3799
test4sub52of100,test4pub67of100,100,193,11,3792,0,3803
test4sub55of100,test4pub67of100,100,193,11,3808,0,3819
test4sub54of100,test4pub67of100,100,193,11,3816,1,3828
test4sub43of100,test4pub67of100,100,193,11,3819,2,3832
test4sub29of100,test4pub67of100,100,193,11,3819,1,3831
test4sub4of100,test4pub67of100,100,193,11,3820,1,3832
test4sub13of100,test4pub67of100,100,193,11,3826,1,3838
test4sub22of100,test4pub67of100,100,193,11,3830,1,3842
test4sub71of100,test4pub67of100,100,193,11,3836,1,3848
test4sub14of100,test4pub67of100,100,193,11,3853,1,3865
test4sub17of100,test4pub67of100,100,193,11,3856,1,3868
test4sub27of100,test4pub67of100,100,193,11,3857,2,3870
test4sub85of100,test4pub67of100,100,193,11,3858,1,3870
test4sub15of100,test4pub67of100,100,193,11,3860,1,3872
test4sub97of100,test4pub67of100,100,193,11,3863,1,3875
test4sub12of100,test4pub67of100,100,193,11,3863,1,3875
test4sub64of100,test4pub67of100,100,193,11,3877,1,3889
test4sub45of100,test4pub57of100,100,193,11,10316,0,10327
test4sub45of100,test4pub58of100,100,193,11,9352,1,9364
test4sub45of100,test4pub59of100,100,193,12,8804,1,8817
test4sub73of100,test4pub67of100,100,193,11,3888,2,3901
test4sub3of100,test4pub67of100,100,193,11,3890,2,3903
test4sub50of100,test4pub67of100,100,193,11,3891,2,3904
test4sub86of100,test4pub67of100,100,193,11,3895,1,3907
test4sub37of100,test4pub67of100,100,193,11,3899,1,3911
test4sub95of100,test4pub67of100,100,193,11,3912,3,3926
test4sub38of100,test4pub67of100,100,193,11,3913,3,3927
test4sub79of100,test4pub67of100,100,193,11,3914,7,3932
test4sub84of100,test4pub67of100,100,193,11,3915,7,3933
test4sub5of100,test4pub67of100,100,193,11,3916,7,3934
test4sub23of100,test4pub67of100,100,193,11,3917,6,3934
test4sub75of100,test4pub67of100,100,193,11,3917,6,3934
test4sub57of100,test4pub67of100,100,193,11,3918,5,3934
test4sub62of100,test4pub67of100,100,193,11,3919,4,3934
test4sub77of100,test4pub67of100,100,193,11,3920,4,3935
test4sub80of100,test4pub67of100,100,193,11,3921,3,3935
test4sub58of100,test4pub67of100,100,193,11,3922,4,3937
test4sub91of100,test4pub67of100,100,193,11,3925,0,3936
test4sub28of100,test4pub68of100,100,193,11,168,1,180
test4sub93of100,test4pub67of100,100,193,11,3934,1,3946
test4sub44of100,test4pub67of100,100,193,11,3934,0,3945
test4sub66of100,test4pub67of100,100,193,11,3943,0,3954
test4sub96of100,test4pub67of100,100,193,11,3946,1,3958
test4sub8of100,test4pub67of100,100,193,11,3952,1,3964
test4sub68of100,test4pub68of100,100,193,11,199,0,210
test4sub33of100,test4pub67of100,100,193,11,3962,1,3974
test4sub87of100,test4pub67of100,100,193,11,3963,1,3975
test4sub59of100,test4pub68of100,100,193,11,205,1,217
test4sub52of100,test4pub68of100,100,193,11,207,1,219
test4sub76of100,test4pub68of100,100,193,11,221,1,233
test4sub22of100,test4pub68of100,100,193,11,261,0,272
test4sub17of100,test4pub68of100,100,193,11,269,1,281
test4sub27of100,test4pub68of100,100,193,11,276,1,288
test4sub85of100,test4pub68of100,100,193,11,281,0,292
test4sub15of100,test4pub68of100,100,193,11,283,0,294
test4sub97of100,test4pub68of100,100,193,11,294,1,306
test4sub73of100,test4pub68of100,100,193,11,297,1,309
test4sub3of100,test4pub68of100,100,193,11,297,0,308
test4sub37of100,test4pub68of100,100,193,11,312,0,323
test4sub95of100,test4pub68of100,100,193,11,315,1,327
test4sub38of100,test4pub68of100,100,193,11,320,1,332
test4sub79of100,test4pub68of100,100,193,11,321,1,333
test4sub84of100,test4pub68of100,100,193,11,322,1,334
test4sub5of100,test4pub68of100,100,193,11,329,1,341
test4sub23of100,test4pub68of100,100,193,11,331,0,342
test4sub75of100,test4pub68of100,100,193,11,335,1,347
test4sub57of100,test4pub68of100,100,193,11,335,1,347
test4sub62of100,test4pub68of100,100,193,11,339,1,351
test4sub77of100,test4pub68of100,100,193,11,354,1,366
test4sub80of100,test4pub68of100,100,193,11,355,0,366
test4sub58of100,test4pub68of100,100,193,11,359,1,371
test4sub91of100,test4pub68of100,100,193,11,375,0,386
test4sub28of100,test4pub67of100,100,193,11,4137,1,4149
test4sub44of100,test4pub68of100,100,193,11,380,1,392
test4sub93of100,test4pub68of100,100,193,11,379,1,391
test4sub66of100,test4pub68of100,100,193,11,385,1,397
test4sub96of100,test4pub68of100,100,193,11,386,1,398
test4sub8of100,test4pub68of100,100,193,11,387,1,399
test4sub33of100,test4pub68of100,100,193,11,389,0,400
test4sub68of100,test4pub67of100,100,193,11,4148,1,4160
test4sub31of100,test4pub66of100,100,193,16,4250,0,4266
test4sub31of100,test4pub65of100,100,193,11,4273,1,4285
test4sub31of100,test4pub64of100,100,193,11,5815,1,5827
test4sub87of100,test4pub68of100,100,193,11,396,1,408
test4sub52of100,test4pub69of100,100,193,10,218,1,229
test4sub87of100,test4pub69of100,100,193,10,218,1,229
test4sub22of100,test4pub69of100,100,193,10,240,1,251
test4sub59of100,test4pub69of100,100,193,10,242,0,252
test4sub27of100,test4pub69of100,100,193,10,244,1,255
test4sub17of100,test4pub69of100,100,193,10,243,2,255
test4sub85of100,test4pub69of100,100,193,10,248,2,260
test4sub15of100,test4pub69of100,100,193,10,249,1,260
test4sub41of100,test4pub64of100,100,193,11,5867,1,5879
test4sub41of100,test4pub65of100,100,193,11,4327,0,4338
test4sub41of100,test4pub66of100,100,193,16,4308,1,4325
test4sub97of100,test4pub69of100,100,193,10,272,1,283
test4sub3of100,test4pub69of100,100,193,10,273,0,283
test4sub37of100,test4pub69of100,100,193,10,284,0,294
test4sub95of100,test4pub69of100,100,193,10,293,1,304
test4sub38of100,test4pub69of100,100,193,10,301,1,312
test4sub79of100,test4pub69of100,100,193,10,311,1,322
test4sub84of100,test4pub69of100,100,193,10,312,1,323
test4sub5of100,test4pub69of100,100,193,10,314,1,325
test4sub23of100,test4pub69of100,100,193,10,315,1,326
test4sub75of100,test4pub69of100,100,193,10,316,2,328
test4sub57of100,test4pub69of100,100,193,10,316,1,327
test4sub62of100,test4pub69of100,100,193,10,317,1,328
test4sub94of100,test4pub65of100,100,193,11,4435,0,4446
test4sub94of100,test4pub66of100,100,193,16,4416,1,4433
test4sub77of100,test4pub69of100,100,193,10,380,1,391
test4sub94of100,test4pub64of100,100,193,11,5979,2,5992
test4sub80of100,test4pub69of100,100,193,10,381,0,391
test4sub58of100,test4pub69of100,100,193,10,382,2,394
test4sub91of100,test4pub69of100,100,193,10,383,1,394
test4sub93of100,test4pub69of100,100,193,10,385,0,395
test4sub28of100,test4pub69of100,100,193,10,384,2,396
test4sub44of100,test4pub69of100,100,193,10,397,1,408
test4sub66of100,test4pub69of100,100,193,10,399,1,410
test4sub96of100,test4pub69of100,100,193,10,401,1,412
test4sub8of100,test4pub69of100,100,193,10,402,1,413
test4sub68of100,test4pub69of100,100,193,10,403,0,413
test4sub33of100,test4pub69of100,100,193,10,405,1,416
test4sub31of100,test4pub67of100,100,193,11,4346,1,4358
test4sub31of100,test4pub68of100,100,193,11,588,1,600
test4sub55of100,test4pub68of100,100,193,11,589,0,600
test4sub31of100,test4pub69of100,100,193,10,411,1,422
test4sub55of100,test4pub69of100,100,193,10,412,1,423
test4sub17of100,test4pub70of100,100,193,10,202,0,212
test4sub27of100,test4pub70of100,100,193,10,209,0,219
test4sub29of100,test4pub68of100,100,193,11,614,1,626
test4sub29of100,test4pub69of100,100,193,10,436,0,446
test4sub41of100,test4pub67of100,100,193,11,4380,1,4392
test4sub41of100,test4pub68of100,100,193,11,622,0,633
test4sub41of100,test4pub69of100,100,193,10,444,0,454
test4sub52of100,test4pub70of100,100,193,10,232,0,242
test4sub85of100,test4pub70of100,100,193,10,237,0,247
test4sub22of100,test4pub70of100,100,193,10,247,1,258
test4sub64of100,test4pub68of100,100,193,11,778,1,790
test4sub64of100,test4pub69of100,100,193,10,601,1,612
test4sub14of100,test4pub68of100,100,193,11,789,2,802
test4sub87of100,test4pub70of100,100,193,10,392,1,403
test4sub14of100,test4pub69of100,100,193,10,612,1,623
test4sub37of100,test4pub70of100,100,193,10,398,1,409
test4sub95of100,test4pub70of100,100,193,10,406,1,417
test4sub43of100,test4pub68of100,100,193,11,807,0,818
test4sub43of100,test4pub69of100,100,193,10,630,1,641
test4sub3of100,test4pub70of100,100,193,10,411,1,422
test4sub4of100,test4pub68of100,100,193,11,818,0,829
test4sub4of100,test4pub69of100,100,193,10,641,1,652
test4sub13of100,test4pub68of100,100,193,11,824,1,836
test4sub13of100,test4pub69of100,100,193,10,646,0,656
test4sub38of100,test4pub70of100,100,193,10,462,1,473
test4sub12of100,test4pub68of100,100,193,11,870,1,882
test4sub12of100,test4pub69of100,100,193,10,692,0,702
test4sub59of100,test4pub70of100,100,193,10,500,1,511
test4sub15of100,test4pub70of100,100,193,10,504,1,515
test4sub79of100,test4pub70of100,100,193,10,507,2,519
test4sub84of100,test4pub70of100,100,193,10,507,2,519
test4sub5of100,test4pub70of100,100,193,10,508,1,519
test4sub23of100,test4pub70of100,100,193,10,516,0,526
test4sub71of100,test4pub68of100,100,193,11,917,0,928
test4sub71of100,test4pub69of100,100,193,10,740,1,751
test4sub97of100,test4pub70of100,100,193,10,524,1,535
test4sub75of100,test4pub70of100,100,193,10,524,1,535
test4sub57of100,test4pub70of100,100,193,10,526,1,537
test4sub62of100,test4pub70of100,100,193,10,527,1,538
test4sub94of100,test4pub67of100,100,193,11,4687,0,4698
test4sub94of100,test4pub68of100,100,193,11,930,1,942
test4sub94of100,test4pub69of100,100,193,10,752,0,762
test4sub94of100,test4pub70of100,100,193,10,534,1,545
test4sub77of100,test4pub70of100,100,193,10,535,0,545
test4sub80of100,test4pub70of100,100,193,10,540,1,551
test4sub58of100,test4pub70of100,100,193,10,545,1,556
test4sub91of100,test4pub70of100,100,193,10,547,1,558
test4sub28of100,test4pub70of100,100,193,10,553,1,564
test4sub93of100,test4pub70of100,100,193,10,554,2,566
test4sub44of100,test4pub70of100,100,193,10,555,1,566
test4sub66of100,test4pub70of100,100,193,10,557,1,568
test4sub96of100,test4pub70of100,100,193,10,557,1,568
test4sub8of100,test4pub70of100,100,193,10,570,1,581
test4sub68of100,test4pub70of100,100,193,10,572,1,583
test4sub33of100,test4pub70of100,100,193,10,599,1,610
test4sub31of100,test4pub70of100,100,193,10,601,1,612
test4sub55of100,test4pub70of100,100,193,10,602,1,613
test4sub29of100,test4pub70of100,100,193,10,603,1,614
test4sub41of100,test4pub70of100,100,193,10,606,1,617
test4sub52of100,test4pub71of100,100,193,10,408,0,418
test4sub17of100,test4pub71of100,100,193,10,419,1,430
test4sub76of100,test4pub69of100,100,193,10,840,0,850
test4sub76of100,test4pub70of100,100,193,10,623,1,634
test4sub85of100,test4pub71of100,100,193,10,424,2,436
test4sub22of100,test4pub71of100,100,193,10,425,1,436
test4sub14of100,test4pub70of100,100,193,10,630,1,641
test4sub37of100,test4pub71of100,100,193,10,431,1,442
test4sub14of100,test4pub71of100,100,193,10,432,1,443
test4sub95of100,test4pub71of100,100,193,10,434,1,445
test4sub3of100,test4pub71of100,100,193,10,435,1,446
test4sub4of100,test4pub70of100,100,193,10,635,0,645
test4sub4of100,test4pub71of100,100,193,10,438,1,449
test4sub13of100,test4pub70of100,100,193,10,639,1,650
test4sub13of100,test4pub71of100,100,193,10,442,1,453
test4sub38of100,test4pub71of100,100,193,10,445,0,455
test4sub12of100,test4pub70of100,100,193,10,646,1,657
test4sub12of100,test4pub71of100,100,193,10,448,1,459
test4sub59of100,test4pub71of100,100,193,10,455,0,465
test4sub15of100,test4pub71of100,100,193,10,460,0,470
test4sub79of100,test4pub71of100,100,193,10,464,1,475
test4sub84of100,test4pub71of100,100,193,10,465,0,475
test4sub5of100,test4pub71of100,100,193,10,466,1,477
test4sub6of100,test4pub67of100,100,193,11,4883,1,4895
test4sub6of100,test4pub68of100,100,193,11,1125,1,1137
test4sub23of100,test4pub71of100,100,193,10,529,1,540
test4sub71of100,test4pub70of100,100,193,10,729,1,740
test4sub6of100,test4pub69of100,100,193,10,948,1,959
test4sub97of100,test4pub71of100,100,193,10,531,2,543
test4sub71of100,test4pub71of100,100,193,10,532,1,543
test4sub75of100,test4pub71of100,100,193,10,535,0,545
test4sub57of100,test4pub71of100,100,193,10,543,1,554
test4sub51of100,test4pub56of100,100,193,11,11479,1,11491
test4sub51of100,test4pub57of100,100,193,11,11336,0,11347
test4sub51of100,test4pub58of100,100,193,11,10380,1,10392
test4sub51of100,test4pub59of100,100,193,12,9832,0,9844
test4sub62of100,test4pub71of100,100,193,10,558,1,569
test4sub51of100,test4pub60of100,100,193,18,9474,1,9493
test4sub94of100,test4pub71of100,100,193,10,569,0,579
test4sub77of100,test4pub71of100,100,193,10,578,1,589
test4sub80of100,test4pub71of100,100,193,10,579,1,590
test4sub58of100,test4pub71of100,100,193,10,583,0,593
test4sub91of100,test4pub71of100,100,193,10,586,1,597
test4sub28of100,test4pub71of100,100,193,10,591,1,602
test4sub93of100,test4pub71of100,100,193,10,592,1,603
test4sub93of100,test4pub72of100,100,193,12,218,0,230
test4sub44of100,test4pub71of100,100,193,10,598,0,608
test4sub66of100,test4pub71of100,100,193,10,601,1,612
test4sub66of100,test4pub72of100,100,193,12,227,1,240
test4sub68of100,test4pub71of100,100,193,10,609,0,619
test4sub33of100,test4pub71of100,100,193,10,610,0,620
test4sub33of100,test4pub72of100,100,193,12,236,1,249
test4sub31of100,test4pub71of100,100,193,10,616,1,627
test4sub31of100,test4pub72of100,100,193,12,243,2,257
test4sub55of100,test4pub71of100,100,193,10,619,1,630
test4sub29of100,test4pub71of100,100,193,10,632,1,643
test4sub29of100,test4pub72of100,100,193,12,258,1,271
test4sub41of100,test4pub71of100,100,193,10,634,1,645
test4sub41of100,test4pub72of100,100,193,12,260,0,272
test4sub52of100,test4pub72of100,100,193,12,264,1,277
test4sub76of100,test4pub71of100,100,193,10,642,1,653
test4sub85of100,test4pub72of100,100,193,12,271,0,283
test4sub22of100,test4pub72of100,100,193,12,277,1,290
test4sub48of100,test4pub67of100,100,193,11,5012,1,5024
test4sub72of100,test4pub67of100,100,193,11,5012,2,5025
test4sub17of100,test4pub72of100,100,193,12,282,3,297
test4sub48of100,test4pub68of100,100,193,11,1254,4,1269
test4sub14of100,test4pub72of100,100,193,12,283,5,300
test4sub95of100,test4pub72of100,100,193,12,284,5,301
test4sub72of100,test4pub68of100,100,193,11,1256,5,1272
test4sub3of100,test4pub72of100,100,193,12,285,6,303
test4sub13of100,test4pub72of100,100,193,12,286,6,304
test4sub38of100,test4pub72of100,100,193,12,287,6,305
test4sub48of100,test4pub69of100,100,193,10,1080,6,1096
test4sub12of100,test4pub72of100,100,193,12,288,7,307
test4sub59of100,test4pub72of100,100,193,12,288,6,306
test4sub72of100,test4pub69of100,100,193,10,1083,4,1097
test4sub53of100,test4pub1of100,100,12977,24,30047,46,30117
test4sub6of100,test4pub70of100,100,193,10,870,43,923
test4sub71of100,test4pub72of100,100,193,12,309,31,352
test4sub97of100,test4pub72of100,100,193,12,311,29,352
test4sub57of100,test4pub72of100,100,193,12,312,29,353
test4sub51of100,test4pub61of100,100,193,11,9093,28,9132
test4sub62of100,test4pub72of100,100,193,12,324,19,355
test4sub6of100,test4pub71of100,100,193,10,715,3,728
test4sub53of100,test4pub4of100,100,192,11,28618,4,28633
test4sub51of100,test4pub62of100,100,193,12,8328,3,8343
test4sub94of100,test4pub72of100,100,193,12,343,2,357
test4sub6of100,test4pub72of100,100,193,12,345,2,359
test4sub53of100,test4pub5of100,100,192,14,27625,1,27640
test4sub51of100,test4pub63of100,100,193,15,7067,2,7084
test4sub53of100,test4pub6of100,100,192,26,27304,1,27331
test4sub51of100,test4pub64of100,100,193,11,6742,0,6753
test4sub51of100,test4pub65of100,100,193,11,5203,1,5215
test4sub51of100,test4pub66of100,100,193,16,5183,1,5200
test4sub51of100,test4pub67of100,100,193,11,5084,0,5095
test4sub90of100,test4pub67of100,100,193,11,5086,1,5098
test4sub51of100,test4pub68of100,100,193,11,1328,2,1341
test4sub90of100,test4pub68of100,100,193,11,1328,1,1340
test4sub90of100,test4pub69of100,100,193,10,1151,0,1161
test4sub77of100,test4pub72of100,100,193,12,364,1,377
test4sub58of100,test4pub72of100,100,193,12,365,1,378
test4sub91of100,test4pub72of100,100,193,12,367,2,381
test4sub28of100,test4pub72of100,100,193,12,368,0,380
test4sub44of100,test4pub72of100,100,193,12,370,1,383
test4sub68of100,test4pub72of100,100,193,12,374,1,387
test4sub55of100,test4pub72of100,100,193,12,377,1,390
test4sub33of100,test4pub73of100,100,193,11,164,1,176
test4sub76of100,test4pub72of100,100,193,12,395,0,407
test4sub29of100,test4pub73of100,100,193,11,173,1,185
test4sub41of100,test4pub73of100,100,193,11,174,1,186
test4sub48of100,test4pub70of100,100,193,10,978,1,989
test4sub48of100,test4pub71of100,100,193,10,780,1,791
test4sub48of100,test4pub72of100,100,193,12,407,1,420
test4sub48of100,test4pub73of100,100,193,11,182,0,193
test4sub72of100,test4pub70of100,100,193,10,991,1,1002
test4sub17of100,test4pub73of100,100,193,11,192,1,204
test4sub72of100,test4pub71of100,100,193,10,794,1,805
test4sub85of100,test4pub73of100,100,193,11,193,1,205
test4sub72of100,test4pub72of100,100,193,12,421,1,434
test4sub93of100,test4pub73of100,100,193,11,196,2,209
test4sub96of100,test4pub71of100,100,193,10,798,2,810
test4sub72of100,test4pub73of100,100,193,11,197,1,209
test4sub96of100,test4pub72of100,100,193,12,425,0,437
test4sub3of100,test4pub73of100,100,193,11,204,1,216
test4sub52of100,test4pub73of100,100,193,11,205,0,216
test4sub13of100,test4pub73of100,100,193,11,204,2,217
test4sub95of100,test4pub73of100,100,193,11,209,1,221
test4sub54of100,test4pub68of100,100,193,11,1420,0,1431
test4sub54of100,test4pub69of100,100,193,10,1243,1,1254
test4sub54of100,test4pub70of100,100,193,10,1025,1,1036
test4sub38of100,test4pub73of100,100,193,11,231,1,243
test4sub49of100,test4pub67of100,100,193,11,5196,1,5208
test4sub49of100,test4pub68of100,100,193,11,1438,0,1449
test4sub49of100,test4pub69of100,100,193,10,1260,1,1271
test4sub31of100,test4pub73of100,100,193,11,243,1,255
test4sub49of100,test4pub70of100,100,193,10,1043,1,1054
test4sub49of100,test4pub71of100,100,193,10,846,1,857
test4sub49of100,test4pub72of100,100,193,12,472,0,484
test4sub12of100,test4pub73of100,100,193,11,256,1,268
test4sub59of100,test4pub73of100,100,193,11,269,0,280
test4sub6of100,test4pub73of100,100,193,11,279,1,291
test4sub14of100,test4pub73of100,100,193,11,294,1,306
test4sub8of100,test4pub71of100,100,193,10,897,1,908
test4sub8of100,test4pub72of100,100,193,12,523,0,535
test4sub22of100,test4pub73of100,100,193,11,319,1,331
test4sub71of100,test4pub73of100,100,193,11,326,0,337
test4sub97of100,test4pub73of100,100,193,11,327,1,339
test4sub66of100,test4pub73of100,100,193,11,328,0,339
test4sub51of100,test4pub69of100,100,193,10,1356,1,1367
test4sub51of100,test4pub70of100,100,193,10,1138,0,1148
test4sub51of100,test4pub71of100,100,193,10,941,1,952
test4sub51of100,test4pub72of100,100,193,12,567,1,580
test4sub51of100,test4pub73of100,100,193,11,342,0,353
test4sub62of100,test4pub73of100,100,193,11,349,1,361
test4sub20of100,test4pub56of100,100,193,11,11884,1,11896
test4sub20of100,test4pub57of100,100,193,11,11741,0,11752
test4sub20of100,test4pub58of100,100,193,11,10776,0,10787
test4sub20of100,test4pub59of100,100,193,12,10229,1,10242
test4sub20of100,test4pub60of100,100,193,18,9870,0,9888
test4sub20of100,test4pub61of100,100,193,11,9361,1,9373
test4sub94of100,test4pub73of100,100,193,11,360,1,372
test4sub90of100,test4pub70of100,100,193,10,1161,1,1172
test4sub90of100,test4pub71of100,100,193,10,964,1,975
test4sub90of100,test4pub72of100,100,193,12,590,0,602
test4sub77of100,test4pub73of100,100,193,11,366,1,378
test4sub90of100,test4pub73of100,100,193,11,367,1,379
test4sub58of100,test4pub73of100,100,193,11,381,0,392
test4sub91of100,test4pub73of100,100,193,11,383,1,395
test4sub28of100,test4pub73of100,100,193,11,385,1,397
test4sub44of100,test4pub73of100,100,193,11,388,1,400
test4sub92of100,test4pub67of100,100,193,11,5346,0,5357
test4sub92of100,test4pub68of100,100,193,11,1589,1,1601
test4sub92of100,test4pub69of100,100,193,10,1411,1,1422
test4sub92of100,test4pub70of100,100,193,10,1193,0,1203
test4sub92of100,test4pub71of100,100,193,10,996,1,1007
test4sub92of100,test4pub72of100,100,193,12,622,1,635
test4sub68of100,test4pub73of100,100,193,11,403,0,414
test4sub55of100,test4pub73of100,100,193,11,406,0,417
test4sub55of100,test4pub74of100,100,193,11,247,0,258
test4sub16of100,test4pub67of100,100,193,11,5369,1,5381
test4sub76of100,test4pub73of100,100,193,11,413,1,425
test4sub16of100,test4pub68of100,100,193,11,1611,0,1622
test4sub76of100,test4pub74of100,100,193,11,254,1,266
test4sub16of100,test4pub69of100,100,193,10,1434,1,1445
test4sub16of100,test4pub70of100,100,193,10,1216,0,1226
test4sub16of100,test4pub71of100,100,193,10,1019,1,1030
test4sub16of100,test4pub72of100,100,193,12,645,0,657
test4sub80of100,test4pub72of100,100,193,12,652,1,665
test4sub29of100,test4pub74of100,100,193,11,267,1,279
test4sub80of100,test4pub73of100,100,193,11,429,1,441
test4sub48of100,test4pub74of100,100,193,11,269,1,281
test4sub33of100,test4pub74of100,100,193,11,272,1,284
test4sub41of100,test4pub74of100,100,193,11,276,1,288
test4sub72of100,test4pub74of100,100,193,11,418,0,429
test4sub17of100,test4pub74of100,100,193,11,420,1,432
test4sub85of100,test4pub74of100,100,193,11,423,1,435
test4sub93of100,test4pub74of100,100,193,11,424,0,435
test4sub96of100,test4pub73of100,100,193,11,586,1,598
test4sub96of100,test4pub74of100,100,193,11,428,2,441
test4sub3of100,test4pub74of100,100,193,11,427,2,440
test4sub13of100,test4pub74of100,100,193,11,428,2,441
test4sub52of100,test4pub74of100,100,193,11,429,2,442
test4sub64of100,test4pub70of100,100,193,10,1390,2,1402
test4sub95of100,test4pub74of100,100,193,11,431,1,443
test4sub64of100,test4pub71of100,100,193,10,1193,1,1204
test4sub54of100,test4pub71of100,100,193,10,1194,1,1205
test4sub64of100,test4pub72of100,100,193,12,820,2,834
test4sub54of100,test4pub72of100,100,193,12,821,2,835
test4sub38of100,test4pub74of100,100,193,11,435,2,448
test4sub54of100,test4pub73of100,100,193,11,597,1,609
test4sub64of100,test4pub73of100,100,193,11,597,1,609
test4sub31of100,test4pub74of100,100,193,11,440,0,451
test4sub49of100,test4pub73of100,100,193,11,599,0,610
test4sub49of100,test4pub74of100,100,193,11,442,1,454
test4sub54of100,test4pub74of100,100,193,11,439,2,452
test4sub12of100,test4pub74of100,100,193,11,449,1,461
test4sub59of100,test4pub74of100,100,193,11,452,1,464
test4sub1of100,test4pub67of100,100,193,11,5588,1,5600
test4sub1of100,test4pub68of100,100,193,11,1830,1,1842
test4sub1of100,test4pub69of100,100,193,10,1653,1,1664
test4sub1of100,test4pub70of100,100,193,10,1435,0,1445
test4sub1of100,test4pub71of100,100,193,10,1238,1,1249
test4sub1of100,test4pub72of100,100,193,12,864,1,877
test4sub6of100,test4pub74of100,100,193,11,511,1,523
test4sub69of100,test4pub64of100,100,193,11,7291,1,7303
test4sub14of100,test4pub74of100,100,193,11,514,0,525
test4sub8of100,test4pub73of100,100,193,11,676,1,688
test4sub8of100,test4pub74of100,100,193,11,517,1,529
test4sub22of100,test4pub74of100,100,193,11,518,1,530
test4sub71of100,test4pub74of100,100,193,11,522,0,533
test4sub97of100,test4pub74of100,100,193,11,529,1,541
test4sub66of100,test4pub74of100,100,193,11,531,1,543
test4sub51of100,test4pub74of100,100,193,11,532,0,543
test4sub62of100,test4pub74of100,100,193,11,534,1,546
test4sub20of100,test4pub62of100,100,193,12,8932,0,8944
test4sub20of100,test4pub63of100,100,193,15,7669,1,7685
test4sub20of100,test4pub65of100,100,193,11,5801,1,5813
test4sub20of100,test4pub64of100,100,193,11,7343,1,7355
test4sub20of100,test4pub66of100,100,193,16,5783,1,5800
test4sub20of100,test4pub67of100,100,193,11,5684,1,5696
test4sub94of100,test4pub74of100,100,193,11,568,1,580
test4sub90of100,test4pub74of100,100,193,11,591,0,602
test4sub77of100,test4pub74of100,100,193,11,593,1,605
test4sub58of100,test4pub74of100,100,193,11,594,1,606
test4sub91of100,test4pub74of100,100,193,11,596,1,608
test4sub28of100,test4pub74of100,100,193,11,597,1,609
test4sub44of100,test4pub74of100,100,193,11,599,0,610
test4sub92of100,test4pub73of100,100,193,11,761,1,773
test4sub92of100,test4pub74of100,100,193,11,603,1,615
test4sub68of100,test4pub74of100,100,193,11,603,1,615
test4sub16of100,test4pub73of100,100,193,11,770,0,781
test4sub16of100,test4pub74of100,100,193,11,612,1,624
test4sub80of100,test4pub74of100,100,193,11,613,1,625
test4sub16of100,test4pub75of100,100,193,14,390,1,405
test4sub29of100,test4pub75of100,100,193,14,391,1,406
test4sub33of100,test4pub75of100,100,193,14,394,1,409
test4sub76of100,test4pub75of100,100,193,14,395,1,410
test4sub50of100,test4pub68of100,100,193,11,1982,1,1994
test4sub50of100,test4pub69of100,100,193,10,1805,1,1816
test4sub50of100,test4pub70of100,100,193,10,1587,0,1597
test4sub50of100,test4pub71of100,100,193,10,1390,1,1401
test4sub50of100,test4pub72of100,100,193,12,1016,0,1028
test4sub50of100,test4pub73of100,100,193,11,792,1,804
test4sub55of100,test4pub75of100,100,193,14,409,1,424
test4sub48of100,test4pub75of100,100,193,14,518,1,533
test4sub41of100,test4pub75of100,100,193,14,519,1,534
test4sub57of100,test4pub73of100,100,193,11,907,2,920
test4sub39of100,test4pub67of100,100,193,11,5865,0,5876
test4sub57of100,test4pub74of100,100,193,11,749,1,761
test4sub39of100,test4pub68of100,100,193,11,2108,2,2121
test4sub27of100,test4pub71of100,100,193,10,1511,2,1523
test4sub32of100,test4pub67of100,100,193,11,5868,2,5881
test4sub72of100,test4pub75of100,100,193,14,530,2,546
test4sub32of100,test4pub68of100,100,193,11,2112,2,2125
test4sub39of100,test4pub69of100,100,193,10,1932,1,1943
test4sub27of100,test4pub72of100,100,193,12,1139,3,1154
test4sub32of100,test4pub69of100,100,193,10,1935,2,1947
test4sub39of100,test4pub70of100,100,193,10,1717,4,1731
test4sub17of100,test4pub75of100,100,193,14,534,4,552
test4sub27of100,test4pub73of100,100,193,11,918,4,933
test4sub85of100,test4pub75of100,100,193,14,536,5,555
test4sub93of100,test4pub75of100,100,193,14,537,4,555
test4sub32of100,test4pub70of100,100,193,10,1720,4,1734
test4sub39of100,test4pub71of100,100,193,10,1523,3,1536
test4sub23of100,test4pub72of100,100,193,12,1149,3,1164
test4sub96of100,test4pub75of100,100,193,14,541,5,560
test4sub39of100,test4pub72of100,100,193,12,1151,4,1167
test4sub32of100,test4pub71of100,100,193,10,1526,5,1541
test4sub3of100,test4pub75of100,100,193,14,543,6,563
test4sub23of100,test4pub73of100,100,193,11,927,8,946
test4sub13of100,test4pub75of100,100,193,14,545,8,567
test4sub52of100,test4pub75of100,100,193,14,546,8,568
test4sub64of100,test4pub74of100,100,193,11,770,8,789
test4sub95of100,test4pub75of100,100,193,14,547,8,569
test4sub54of100,test4pub75of100,100,193,14,548,8,570
test4sub32of100,test4pub72of100,100,193,12,1158,7,1177
test4sub38of100,test4pub75of100,100,193,14,550,8,572
test4sub49of100,test4pub75of100,100,193,14,551,7,572
test4sub31of100,test4pub75of100,100,193,14,552,6,572
test4sub12of100,test4pub75of100,100,193,14,552,6,572
test4sub23of100,test4pub74of100,100,193,11,776,5,792
test4sub59of100,test4pub75of100,100,193,14,554,4,572
test4sub64of100,test4pub75of100,100,193,14,556,4,574
test4sub1of100,test4pub73of100,100,193,11,939,3,953
test4sub1of100,test4pub74of100,100,193,11,783,0,794
test4sub1of100,test4pub75of100,100,193,14,562,1,577
test4sub86of100,test4pub68of100,100,193,11,2287,1,2299
test4sub86of100,test4pub69of100,100,193,10,2109,0,2119
test4sub86of100,test4pub70of100,100,193,10,1892,1,1903
test4sub86of100,test4pub71of100,100,193,10,1694,1,1705
test4sub86of100,test4pub72of100,100,193,12,1320,0,1332
test4sub86of100,test4pub73of100,100,193,11,1095,1,1107
test4sub6of100,test4pub75of100,100,193,14,714,0,728
test4sub14of100,test4pub75of100,100,193,14,725,1,740
test4sub8of100,test4pub75of100,100,193,14,726,1,741
test4sub22of100,test4pub75of100,100,193,14,727,1,742
test4sub71of100,test4pub75of100,100,193,14,729,1,744
test4sub97of100,test4pub75of100,100,193,14,730,0,744
test4sub66of100,test4pub75of100,100,193,14,732,0,746
test4sub51of100,test4pub75of100,100,193,14,735,1,750
test4sub62of100,test4pub75of100,100,193,14,735,1,750
test4sub60of100,test4pub67of100,100,193,11,6081,0,6092
test4sub60of100,test4pub68of100,100,193,11,2324,1,2336
test4sub60of100,test4pub69of100,100,193,10,2146,0,2156
test4sub20of100,test4pub68of100,100,193,11,2326,1,2338
test4sub20of100,test4pub69of100,100,193,10,2148,0,2158
test4sub60of100,test4pub70of100,100,193,10,1929,1,1940
test4sub60of100,test4pub71of100,100,193,10,1732,0,1742
test4sub60of100,test4pub72of100,100,193,12,1359,1,1372
test4sub20of100,test4pub70of100,100,193,10,1934,1,1945
test4sub82of100,test4pub67of100,100,193,11,6092,1,6104
test4sub20of100,test4pub71of100,100,193,10,1737,1,1748
test4sub89of100,test4pub68of100,100,193,11,2334,2,2347
test4sub82of100,test4pub68of100,100,193,11,2335,2,2348
test4sub20of100,test4pub72of100,100,193,12,1364,2,1378
test4sub89of100,test4pub67of100,100,193,11,6097,1,6109
test4sub82of100,test4pub69of100,100,193,10,2159,3,2172
test4sub89of100,test4pub69of100,100,193,10,2160,1,2171
test4sub20of100,test4pub73of100,100,193,11,1141,2,1154
test4sub82of100,test4pub70of100,100,193,10,1943,0,1953
test4sub20of100,test4pub74of100,100,193,11,984,1,996
test4sub82of100,test4pub71of100,100,193,10,1746,0,1756
test4sub20of100,test4pub75of100,100,193,14,763,3,780
test4sub82of100,test4pub72of100,100,193,12,1373,2,1387
test4sub94of100,test4pub75of100,100,193,14,765,2,781
test4sub26of100,test4pub67of100,100,193,11,6105,1,6117
test4sub26of100,test4pub68of100,100,193,11,2348,0,2359
test4sub26of100,test4pub69of100,100,193,10,2171,1,2182
test4sub83of100,test4pub68of100,100,193,11,2351,2,2364
test4sub34of100,test4pub67of100,100,193,11,6111,1,6123
test4sub34of100,test4pub68of100,100,193,11,2354,0,2365
test4sub26of100,test4pub70of100,100,193,10,1953,1,1964
test4sub83of100,test4pub67of100,100,193,11,6113,2,6126
test4sub90of100,test4pub75of100,100,193,14,772,2,788
test4sub26of100,test4pub71of100,100,193,10,1759,2,1771
test4sub34of100,test4pub69of100,100,193,10,2177,3,2190
test4sub83of100,test4pub69of100,100,193,10,2178,2,2190
test4sub26of100,test4pub72of100,100,193,12,1386,2,1400
test4sub34of100,test4pub70of100,100,193,10,1962,2,1974
test4sub83of100,test4pub70of100,100,193,10,1962,1,1973
test4sub34of100,test4pub71of100,100,193,10,1765,3,1778
test4sub25of100,test4pub67of100,100,193,11,6122,2,6135
test4sub83of100,test4pub71of100,100,193,10,1766,4,1780
test4sub77of100,test4pub75of100,100,193,14,783,4,801
test4sub58of100,test4pub75of100,100,193,14,784,4,802
test4sub34of100,test4pub72of100,100,193,12,1393,4,1409
test4sub25of100,test4pub68of100,100,193,11,2367,3,2381
test4sub83of100,test4pub72of100,100,193,12,1395,3,1410
test4sub91of100,test4pub75of100,100,193,14,787,2,803
test4sub28of100,test4pub75of100,100,193,14,788,2,804
test4sub25of100,test4pub69of100,100,193,10,2192,1,2203
test4sub25of100,test4pub70of100,100,193,10,1975,1,1986
test4sub25of100,test4pub71of100,100,193,10,1777,0,1787
test4sub25of100,test4pub72of100,100,193,12,1403,0,1415
test4sub44of100,test4pub75of100,100,193,14,818,0,832
test4sub92of100,test4pub75of100,100,193,14,820,0,834
test4sub92of100,test4pub76of100,100,193,10,451,0,461
test4sub98of100,test4pub67of100,100,193,11,6178,1,6190
test4sub98of100,test4pub68of100,100,193,11,2421,1,2433
test4sub98of100,test4pub69of100,100,193,10,2243,1,2254
test4sub47of100,test4pub67of100,100,193,11,6182,1,6194
test4sub98of100,test4pub70of100,100,193,10,2026,1,2037
test4sub47of100,test4pub68of100,100,193,11,2425,1,2437
test4sub98of100,test4pub71of100,100,193,10,1829,1,1840
test4sub47of100,test4pub69of100,100,193,10,2248,0,2258
test4sub98of100,test4pub72of100,100,193,12,1455,1,1468
test4sub47of100,test4pub70of100,100,193,10,2031,0,2041
test4sub47of100,test4pub71of100,100,193,10,1833,0,1843
test4sub47of100,test4pub72of100,100,193,12,1460,2,1474
test4sub11of100,test4pub67of100,100,193,11,6192,1,6204
test4sub11of100,test4pub68of100,100,193,11,2434,1,2446
test4sub47of100,test4pub73of100,100,193,11,1236,1,1248
test4sub11of100,test4pub69of100,100,193,10,2257,1,2268
test4sub47of100,test4pub74of100,100,193,11,1078,1,1090
test4sub73of100,test4pub69of100,100,193,10,2259,0,2269
test4sub11of100,test4pub70of100,100,193,10,2039,1,2050
test4sub73of100,test4pub70of100,100,193,10,2042,1,2053
test4sub47of100,test4pub75of100,100,193,14,857,2,873
test4sub11of100,test4pub71of100,100,193,10,1843,2,1855
test4sub73of100,test4pub71of100,100,193,10,1844,1,1855
test4sub73of100,test4pub72of100,100,193,12,1471,0,1483
test4sub11of100,test4pub72of100,100,193,12,1471,1,1484
test4sub73of100,test4pub73of100,100,193,11,1247,1,1259
test4sub68of100,test4pub75of100,100,193,14,865,1,880
test4sub73of100,test4pub74of100,100,193,11,1088,2,1101
test4sub7of100,test4pub67of100,100,193,11,6207,1,6219
test4sub7of100,test4pub68of100,100,193,11,2449,0,2460
test4sub7of100,test4pub69of100,100,193,10,2272,1,2283
test4sub30of100,test4pub68of100,100,193,11,2451,1,2463
test4sub7of100,test4pub70of100,100,193,10,2054,1,2065
test4sub30of100,test4pub69of100,100,193,10,2274,1,2285
test4sub7of100,test4pub71of100,100,193,10,1857,1,1868
test4sub30of100,test4pub70of100,100,193,10,2057,1,2068
test4sub30of100,test4pub71of100,100,193,10,1859,1,1870
test4sub7of100,test4pub72of100,100,193,12,1484,1,1497
test4sub30of100,test4pub72of100,100,193,12,1486,1,1499
test4sub7of100,test4pub73of100,100,193,11,1260,2,1273
test4sub67of100,test4pub67of100,100,193,11,6218,2,6231
test4sub30of100,test4pub73of100,100,193,11,1262,1,1274
test4sub7of100,test4pub74of100,100,193,11,1103,1,1115
test4sub67of100,test4pub68of100,100,193,11,2462,0,2473
test4sub67of100,test4pub69of100,100,193,10,2285,1,2296
test4sub7of100,test4pub75of100,100,193,14,882,0,896
test4sub67of100,test4pub70of100,100,193,10,2067,0,2077
test4sub67of100,test4pub71of100,100,193,10,1870,1,1881
test4sub67of100,test4pub72of100,100,193,12,1496,1,1509
test4sub16of100,test4pub76of100,100,193,10,524,1,535
test4sub80of100,test4pub75of100,100,193,14,896,2,912
test4sub29of100,test4pub76of100,100,193,10,527,2,539
test4sub80of100,test4pub76of100,100,193,10,528,1,539
test4sub33of100,test4pub76of100,100,193,10,528,2,540
test4sub76of100,test4pub76of100,100,193,10,529,1,540
test4sub50of100,test4pub74of100,100,193,11,1124,1,1136
test4sub55of100,test4pub76of100,100,193,10,532,1,543
test4sub50of100,test4pub75of100,100,193,14,903,1,918
test4sub50of100,test4pub76of100,100,193,10,534,1,545
test4sub48of100,test4pub76of100,100,193,10,535,1,546
test4sub41of100,test4pub76of100,100,193,10,539,1,550
test4sub43of100,test4pub70of100,100,193,10,2095,1,2106
test4sub43of100,test4pub71of100,100,193,10,1897,1,1908
test4sub57of100,test4pub75of100,100,193,14,915,1,930
test4sub43of100,test4pub72of100,100,193,12,1524,3,1539
test4sub39of100,test4pub73of100,100,193,11,1299,2,1312
test4sub57of100,test4pub76of100,100,193,10,547,3,560
test4sub43of100,test4pub73of100,100,193,11,1301,2,1314
test4sub27of100,test4pub74of100,100,193,11,1141,2,1154
test4sub39of100,test4pub74of100,100,193,11,1142,2,1155
test4sub32of100,test4pub73of100,100,193,11,1303,3,1317
test4sub27of100,test4pub75of100,100,193,14,922,1,937
test4sub39of100,test4pub75of100,100,193,14,922,2,938
test4sub32of100,test4pub74of100,100,193,11,1146,1,1158
test4sub27of100,test4pub76of100,100,193,10,554,2,566
test4sub39of100,test4pub76of100,100,193,10,555,2,567
test4sub32of100,test4pub75of100,100,193,14,925,1,940
test4sub32of100,test4pub76of100,100,193,10,557,1,568
test4sub63of100,test4pub67of100,100,193,11,6290,0,6301
test4sub63of100,test4pub68of100,100,193,11,2532,1,2544
test4sub63of100,test4pub69of100,100,193,10,2355,1,2366
test4sub87of100,test4pub71of100,100,193,10,1938,1,1949
test4sub63of100,test4pub70of100,100,193,10,2137,1,2148
test4sub87of100,test4pub72of100,100,193,12,1565,2,1579
test4sub63of100,test4pub71of100,100,193,10,1941,1,1952
test4sub87of100,test4pub73of100,100,193,11,1341,1,1353
test4sub63of100,test4pub72of100,100,193,12,1567,0,1579
test4sub63of100,test4pub73of100,100,193,11,1343,1,1355
test4sub85of100,test4pub76of100,100,193,10,592,2,604
test4sub63of100,test4pub74of100,100,193,11,1184,1,1196
test4sub93of100,test4pub76of100,100,193,10,593,1,604
test4sub23of100,test4pub75of100,100,193,14,964,1,979
test4sub63of100,test4pub75of100,100,193,14,965,1,980
test4sub15of100,test4pub72of100,100,193,12,1574,1,1587
test4sub15of100,test4pub73of100,100,193,11,1351,1,1363
test4sub23of100,test4pub76of100,100,193,10,597,3,610
test4sub95of100,test4pub76of100,100,193,10,597,3,610
test4sub38of100,test4pub76of100,100,193,10,599,2,611
test4sub15of100,test4pub74of100,100,193,11,1193,2,1206
test4sub59of100,test4pub76of100,100,193,10,600,1,611
test4sub37of100,test4pub72of100,100,193,12,1584,0,1596
test4sub37of100,test4pub73of100,100,193,11,1360,1,1372
test4sub14of100,test4pub76of100,100,193,10,606,2,618
test4sub8of100,test4pub76of100,100,193,10,607,2,619
test4sub37of100,test4pub74of100,100,193,11,1201,1,1213
test4sub5of100,test4pub72of100,100,193,12,1588,1,1601
test4sub22of100,test4pub76of100,100,193,10,611,0,621
test4sub5of100,test4pub73of100,100,193,11,1364,1,1376
test4sub5of100,test4pub74of100,100,193,11,1206,1,1218
test4sub97of100,test4pub76of100,100,193,10,614,1,625
test4sub71of100,test4pub76of100,100,193,10,613,2,625
test4sub94of100,test4pub76of100,100,193,10,639,0,649
test4sub58of100,test4pub76of100,100,193,10,649,1,660
test4sub91of100,test4pub76of100,100,193,10,650,1,661
test4sub91of100,test4pub77of100,100,193,11,231,1,243
test4sub70of100,test4pub67of100,100,193,11,6367,1,6379
test4sub70of100,test4pub68of100,100,193,11,2609,1,2621
test4sub98of100,test4pub73of100,100,193,11,1411,1,1423
test4sub98of100,test4pub74of100,100,193,11,1253,1,1265
test4sub70of100,test4pub69of100,100,193,10,2431,1,2442
test4sub98of100,test4pub75of100,100,193,14,1031,2,1047
test4sub47of100,test4pub76of100,100,193,10,662,2,674
test4sub70of100,test4pub70of100,100,193,10,2214,3,2227
test4sub99of100,test4pub67of100,100,193,11,6373,4,6388
test4sub47of100,test4pub77of100,100,193,11,243,2,256
test4sub98of100,test4pub76of100,100,193,10,664,3,677
test4sub70of100,test4pub71of100,100,193,10,2020,2,2032
test4sub99of100,test4pub68of100,100,193,11,2618,1,2630
test4sub99of100,test4pub69of100,100,193,10,2441,1,2452
test4sub70of100,test4pub72of100,100,193,12,1648,1,1661
test4sub99of100,test4pub70of100,100,193,10,2223,0,2233
test4sub70of100,test4pub73of100,100,193,11,1423,1,1435
test4sub99of100,test4pub71of100,100,193,10,2026,1,2037
test4sub70of100,test4pub74of100,100,193,11,1265,1,1277
test4sub99of100,test4pub72of100,100,193,12,1652,1,1665
test4sub70of100,test4pub75of100,100,193,14,1044,1,1059
test4sub99of100,test4pub73of100,100,193,11,1428,0,1439
test4sub99of100,test4pub74of100,100,193,11,1269,0,1280
test4sub99of100,test4pub75of100,100,193,14,1048,1,1063
test4sub73of100,test4pub75of100,100,193,14,1055,1,1070
test4sub73of100,test4pub76of100,100,193,10,686,0,696
test4sub73of100,test4pub77of100,100,193,11,266,1,278
test4sub46of100,test4pub67of100,100,193,11,6400,1,6412
test4sub46of100,test4pub68of100,100,193,11,2642,2,2655
test4sub68of100,test4pub76of100,100,193,10,692,2,704
test4sub7of100,test4pub76of100,100,193,10,693,3,706
test4sub30of100,test4pub74of100,100,193,11,1287,1,1299
test4sub68of100,test4pub77of100,100,193,11,274,2,287
test4sub46of100,test4pub69of100,100,193,10,2466,3,2479
test4sub7of100,test4pub77of100,100,193,11,275,1,287
test4sub30of100,test4pub75of100,100,193,14,1066,2,1082
test4sub67of100,test4pub73of100,100,193,11,1452,2,1465
test4sub30of100,test4pub76of100,100,193,10,699,1,710
test4sub46of100,test4pub70of100,100,193,10,2251,2,2263
test4sub67of100,test4pub74of100,100,193,11,1294,1,1306
test4sub30of100,test4pub77of100,100,193,11,280,2,293
test4sub46of100,test4pub71of100,100,193,10,2057,1,2068
test4sub67of100,test4pub75of100,100,193,14,1073,3,1090
test4sub46of100,test4pub72of100,100,193,12,1684,1,1697
test4sub67of100,test4pub76of100,100,193,10,706,1,717
test4sub46of100,test4pub73of100,100,193,11,1459,0,1470
test4sub46of100,test4pub74of100,100,193,11,1301,1,1313
test4sub67of100,test4pub77of100,100,193,11,286,1,298
test4sub65of100,test4pub67of100,100,193,11,6419,1,6431
test4sub46of100,test4pub75of100,100,193,14,1079,1,1094
test4sub65of100,test4pub68of100,100,193,11,2662,1,2674
test4sub16of100,test4pub77of100,100,193,11,291,3,305
test4sub75of100,test4pub72of100,100,193,12,1692,3,1707
test4sub80of100,test4pub77of100,100,193,11,292,3,306
test4sub76of100,test4pub77of100,100,193,11,293,2,306
test4sub50of100,test4pub77of100,100,193,11,294,2,307
test4sub65of100,test4pub69of100,100,193,10,2486,2,2498
test4sub75of100,test4pub73of100,100,193,11,1470,2,1483
test4sub75of100,test4pub74of100,100,193,11,1312,0,1323
test4sub43of100,test4pub74of100,100,193,11,1325,0,1336
test4sub43of100,test4pub75of100,100,193,14,1103,0,1117
test4sub43of100,test4pub76of100,100,193,10,735,1,746
test4sub43of100,test4pub77of100,100,193,11,315,1,327
test4sub57of100,test4pub77of100,100,193,11,316,1,328
test4sub39of100,test4pub77of100,100,193,11,320,1,332
test4sub27of100,test4pub77of100,100,193,11,321,1,333
test4sub32of100,test4pub77of100,100,193,11,322,1,334
test4sub36of100,test4pub62of100,100,193,12,9709,1,9722
test4sub36of100,test4pub63of100,100,193,15,8446,1,8462
test4sub63of100,test4pub76of100,100,193,10,747,0,757
test4sub36of100,test4pub64of100,100,193,11,8120,1,8132
test4sub63of100,test4pub77of100,100,193,11,328,2,341
test4sub36of100,test4pub65of100,100,193,11,6580,2,6593
test4sub87of100,test4pub74of100,100,193,11,1343,2,1356
test4sub36of100,test4pub66of100,100,193,16,6561,1,6578
test4sub87of100,test4pub75of100,100,193,14,1122,1,1137
test4sub87of100,test4pub76of100,100,193,10,753,1,764
test4sub36of100,test4pub68of100,100,193,11,2704,1,2716
test4sub87of100,test4pub77of100,100,193,11,334,0,345
test4sub85of100,test4pub77of100,100,193,11,363,1,375
test4sub93of100,test4pub77of100,100,193,11,363,1,375
test4sub23of100,test4pub77of100,100,193,11,366,1,378
test4sub15of100,test4pub75of100,100,193,14,1158,1,1173
test4sub15of100,test4pub76of100,100,193,10,789,0,799
test4sub15of100,test4pub77of100,100,193,11,369,1,381
test4sub95of100,test4pub77of100,100,193,11,370,1,382
test4sub38of100,test4pub77of100,100,193,11,371,2,384
test4sub59of100,test4pub77of100,100,193,11,372,2,385
test4sub14of100,test4pub77of100,100,193,11,374,0,385
test4sub37of100,test4pub75of100,100,193,14,1164,2,1180
test4sub37of100,test4pub76of100,100,193,10,797,1,808
test4sub37of100,test4pub77of100,100,193,11,377,1,389
test4sub8of100,test4pub77of100,100,193,11,472,0,483
test4sub5of100,test4pub75of100,100,193,14,1265,0,1279
test4sub5of100,test4pub76of100,100,193,10,897,1,908
test4sub5of100,test4pub77of100,100,193,11,477,1,489
test4sub22of100,test4pub77of100,100,193,11,478,0,489
test4sub71of100,test4pub77of100,100,193,11,497,1,509
test4sub97of100,test4pub77of100,100,193,11,506,0,517
test4sub10of100,test4pub67of100,100,193,11,6643,1,6655
test4sub10of100,test4pub68of100,100,193,11,2885,0,2896
test4sub10of100,test4pub69of100,100,193,10,2708,1,2719
test4sub10of100,test4pub70of100,100,193,10,2490,1,2501
test4sub94of100,test4pub77of100,100,193,11,516,1,528
test4sub10of100,test4pub71of100,100,193,10,2292,0,2302
test4sub10of100,test4pub72of100,100,193,12,1919,2,1933
test4sub58of100,test4pub77of100,100,193,11,520,1,532
test4sub10of100,test4pub73of100,100,193,11,1695,0,1706
test4sub10of100,test4pub74of100,100,193,11,1537,1,1549
test4sub10of100,test4pub75of100,100,193,14,1315,1,1330
test4sub70of100,test4pub76of100,100,193,10,956,1,967
test4sub70of100,test4pub77of100,100,193,11,536,0,547
test4sub98of100,test4pub77of100,100,193,11,537,1,549
test4sub99of100,test4pub76of100,100,193,10,959,1,970
test4sub46of100,test4pub76of100,100,193,10,960,1,971
test4sub99of100,test4pub77of100,100,193,11,540,1,552
test4sub46of100,test4pub77of100,100,193,11,541,1,553
test4sub75of100,test4pub75of100,100,193,14,1334,1,1349
test4sub77of100,test4pub76of100,100,193,10,965,1,976
test4sub75of100,test4pub76of100,100,193,10,966,1,977
test4sub77of100,test4pub77of100,100,193,11,546,0,557
test4sub75of100,test4pub77of100,100,193,11,546,1,558
test4sub36of100,test4pub67of100,100,193,11,6708,1,6720
test4sub36of100,test4pub69of100,100,193,10,2772,0,2782
test4sub36of100,test4pub70of100,100,193,10,2555,1,2566
test4sub79of100,test4pub72of100,100,193,12,1982,1,1995
test4sub36of100,test4pub71of100,100,193,10,2357,1,2368
test4sub88of100,test4pub2of100,100,192,10,31704,3,31717
test4sub79of100,test4pub73of100,100,193,11,1758,1,1770
test4sub36of100,test4pub72of100,100,193,12,1985,3,2000
test4sub79of100,test4pub74of100,100,193,11,1600,1,1612
test4sub88of100,test4pub3of100,100,192,28,31609,1,31638
test4sub36of100,test4pub73of100,100,193,11,1762,0,1773
test4sub36of100,test4pub74of100,100,193,11,1604,1,1616
test4sub36of100,test4pub75of100,100,193,14,1382,1,1397
test4sub3of100,test4pub76of100,100,193,10,1141,0,1151
test4sub52of100,test4pub76of100,100,193,10,1142,1,1153
test4sub10of100,test4pub76of100,100,193,10,1164,1,1175
test4sub10of100,test4pub77of100,100,193,11,744,1,756
test4sub65of100,test4pub70of100,100,193,10,2821,1,2832
test4sub65of100,test4pub71of100,100,193,10,2623,1,2634
test4sub65of100,test4pub72of100,100,193,12,2250,1,2263
test4sub65of100,test4pub73of100,100,193,11,2025,1,2037
test4sub65of100,test4pub74of100,100,193,11,1867,3,1881
test4sub94of100,test4pub78of100,100,193,11,302,1,314
test4sub65of100,test4pub75of100,100,193,14,1649,2,1665
test4sub65of100,test4pub76of100,100,193,10,1281,1,1292
test4sub65of100,test4pub77of100,100,193,11,861,1,873
test4sub85of100,test4pub78of100,100,193,11,349,1,361
test4sub30of100,test4pub78of100,100,193,11,350,1,362
test4sub63of100,test4pub78of100,100,193,11,493,0,504
test4sub76of100,test4pub78of100,100,193,11,510,1,522
test4sub14of100,test4pub78of100,100,193,11,511,1,523
test4sub97of100,test4pub78of100,100,193,11,512,0,523
test4sub80of100,test4pub78of100,100,193,11,513,0,524
test4sub36of100,test4pub76of100,100,193,10,1491,1,1502
test4sub36of100,test4pub77of100,100,193,11,1071,0,1082
test4sub32of100,test4pub78of100,100,193,11,520,1,532
test4sub77of100,test4pub78of100,100,193,11,520,1,532
test4sub5of100,test4pub78of100,100,193,11,525,1,537
test4sub43of100,test4pub78of100,100,193,11,526,1,538
test4sub28of100,test4pub76of100,100,193,10,1511,0,1521
test4sub79of100,test4pub75of100,100,193,14,1883,1,1898
test4sub28of100,test4pub77of100,100,193,11,1092,1,1104
test4sub79of100,test4pub76of100,100,193,10,1514,0,1524
test4sub79of100,test4pub77of100,100,193,11,1095,1,1107
test4sub33of100,test4pub77of100,100,193,11,1098,0,1109
test4sub50of100,test4pub78of100,100,193,11,555,1,567
test4sub90of100,test4pub76of100,100,193,10,1538,0,1548
test4sub48of100,test4pub77of100,100,193,11,1118,1,1130
test4sub90of100,test4pub77of100,100,193,11,1119,1,1131
test4sub48of100,test4pub78of100,100,193,11,565,1,577
test4sub15of100,test4pub78of100,100,193,11,573,1,585
test4sub72of100,test4pub76of100,100,193,10,1549,1,1560
test4sub39of100,test4pub78of100,100,193,11,581,0,592
test4sub75of100,test4pub78of100,100,193,11,586,1,598
test4sub6of100,test4pub76of100,100,193,10,1562,0,1572
test4sub71of100,test4pub78of100,100,193,11,588,1,600
test4sub98of100,test4pub78of100,100,193,11,590,0,601
test4sub59of100,test4pub78of100,100,193,11,591,1,603
test4sub70of100,test4pub78of100,100,193,11,592,1,604
test4sub64of100,test4pub76of100,100,193,10,1569,0,1579
test4sub67of100,test4pub78of100,100,193,11,596,4,611
test4sub58of100,test4pub78of100,100,193,11,600,1,612
test4sub99of100,test4pub78of100,100,193,11,601,1,613
test4sub87of100,test4pub78of100,100,193,11,603,2,616
test4sub73of100,test4pub78of100,100,193,11,604,1,616
test4sub95of100,test4pub78of100,100,193,11,605,0,616
test4sub37of100,test4pub78of100,100,193,11,607,1,619
test4sub47of100,test4pub78of100,100,193,11,609,1,621
test4sub22of100,test4pub78of100,100,193,11,610,0,621
test4sub57of100,test4pub78of100,100,193,11,611,0,622
test4sub20of100,test4pub76of100,100,193,10,1591,0,1601
test4sub7of100,test4pub78of100,100,193,11,616,1,628
test4sub20of100,test4pub77of100,100,193,11,1172,1,1184
test4sub8of100,test4pub78of100,100,193,11,619,1,631
test4sub54of100,test4pub76of100,100,193,10,1597,1,1608
test4sub29of100,test4pub77of100,100,193,11,1177,1,1189
test4sub29of100,test4pub78of100,100,193,11,624,1,636
test4sub52of100,test4pub77of100,100,193,11,1180,0,1191
test4sub100of100,test4pub52of100,100,193,10,15587,1,15598
test4sub52of100,test4pub78of100,100,193,11,627,1,639
test4sub100of100,test4pub53of100,100,193,10,15219,0,15229
test4sub100of100,test4pub54of100,100,193,11,15054,1,15066
test4sub100of100,test4pub55of100,100,193,10,14788,1,14799
test4sub100of100,test4pub56of100,100,193,11,13895,0,13906
test4sub10of100,test4pub78of100,100,193,11,644,1,656
test4sub65of100,test4pub78of100,100,193,11,648,1,660
test4sub41of100,test4pub77of100,100,193,11,1232,1,1244
test4sub41of100,test4pub78of100,100,193,11,678,0,689
test4sub30of100,test4pub79of100,100,193,14,387,0,401
test4sub94of100,test4pub79of100,100,193,14,403,1,418
test4sub85of100,test4pub79of100,100,193,14,413,1,428
test4sub96of100,test4pub76of100,100,193,10,1709,0,1719
test4sub96of100,test4pub77of100,100,193,11,1290,1,1302
test4sub66of100,test4pub76of100,100,193,10,1712,1,1723
test4sub96of100,test4pub78of100,100,193,11,736,0,747
test4sub66of100,test4pub77of100,100,193,11,1292,1,1304
test4sub63of100,test4pub79of100,100,193,14,422,1,437
test4sub66of100,test4pub78of100,100,193,11,739,2,752
test4sub76of100,test4pub79of100,100,193,14,423,0,437
test4sub14of100,test4pub79of100,100,193,14,425,1,440
test4sub97of100,test4pub79of100,100,193,14,428,1,443
test4sub80of100,test4pub79of100,100,193,14,440,1,455
test4sub36of100,test4pub78of100,100,193,11,758,0,769
test4sub36of100,test4pub79of100,100,193,14,443,1,458
test4sub32of100,test4pub79of100,100,193,14,447,1,462
test4sub77of100,test4pub79of100,100,193,14,448,0,462
test4sub5of100,test4pub79of100,100,193,14,451,1,466
test4sub43of100,test4pub79of100,100,193,14,454,1,469
test4sub28of100,test4pub78of100,100,193,11,772,0,783
test4sub28of100,test4pub79of100,100,193,14,457,1,472
test4sub33of100,test4pub78of100,100,193,11,783,0,794
test4sub33of100,test4pub79of100,100,193,14,467,1,482
test4sub48of100,test4pub79of100,100,193,14,472,1,487
test4sub72of100,test4pub77of100,100,193,11,1348,1,1360
test4sub72of100,test4pub78of100,100,193,11,795,1,807
test4sub72of100,test4pub79of100,100,193,14,479,0,493
test4sub39of100,test4pub79of100,100,193,14,484,1,499
test4sub75of100,test4pub79of100,100,193,14,485,1,500
test4sub6of100,test4pub77of100,100,193,11,1360,1,1372
test4sub6of100,test4pub78of100,100,193,11,807,1,819
test4sub98of100,test4pub79of100,100,193,14,494,0,508
test4sub58of100,test4pub79of100,100,193,14,496,2,512
test4sub99of100,test4pub79of100,100,193,14,497,2,513
test4sub37of100,test4pub79of100,100,193,14,497,1,512
test4sub20of100,test4pub78of100,100,193,11,824,1,836
test4sub20of100,test4pub79of100,100,193,14,509,0,523
test4sub7of100,test4pub79of100,100,193,14,519,1,534
test4sub8of100,test4pub79of100,100,193,14,520,1,535
test4sub55of100,test4pub77of100,100,193,11,1476,1,1488
test4sub55of100,test4pub78of100,100,193,11,923,1,935
test4sub55of100,test4pub79of100,100,193,14,608,1,623
test4sub54of100,test4pub77of100,100,193,11,1483,1,1495
test4sub54of100,test4pub78of100,100,193,11,929,0,940
test4sub54of100,test4pub79of100,100,193,14,614,1,629
test4sub29of100,test4pub79of100,100,193,14,615,0,629
test4sub52of100,test4pub79of100,100,193,14,616,0,630
test4sub100of100,test4pub57of100,100,193,11,14056,0,14067
test4sub100of100,test4pub58of100,100,193,11,13091,1,13103
test4sub31of100,test4pub76of100,100,193,10,1916,2,1928
test4sub100of100,test4pub59of100,100,193,12,12544,1,12557
test4sub62of100,test4pub76of100,100,193,10,1917,2,1929
test4sub31of100,test4pub77of100,100,193,11,1497,1,1509
test4sub100of100,test4pub60of100,100,193,18,12186,2,12206
test4sub62of100,test4pub77of100,100,193,11,1499,1,1511
test4sub31of100,test4pub78of100,100,193,11,944,2,957
test4sub62of100,test4pub78of100,100,193,11,946,1,958
test4sub100of100,test4pub61of100,100,193,11,11679,1,11691
test4sub100of100,test4pub62of100,100,193,12,10889,1,10902
test4sub40of100,test4pub67of100,100,193,11,7667,1,7679
test4sub40of100,test4pub68of100,100,193,11,3909,0,3920
test4sub40of100,test4pub69of100,100,193,10,3732,1,3743
test4sub100of100,test4pub63of100,100,193,15,9662,0,9677
test4sub100of100,test4pub65of100,100,193,11,7795,1,7807
test4sub100of100,test4pub66of100,100,193,16,7775,1,7792
test4sub10of100,test4pub79of100,100,193,14,674,1,689
test4sub65of100,test4pub79of100,100,193,14,675,1,690
test4sub4of100,test4pub72of100,100,193,12,2948,1,2961
test4sub30of100,test4pub80of100,100,193,10,329,2,341
test4sub9of100,test4pub67of100,100,193,11,7681,1,7693
test4sub4of100,test4pub73of100,100,193,11,2724,2,2737
test4sub9of100,test4pub68of100,100,193,11,3924,1,3936
test4sub4of100,test4pub74of100,100,193,11,2566,3,2580
test4sub96of100,test4pub79of100,100,193,14,681,3,698
test4sub9of100,test4pub69of100,100,193,10,3747,3,3760
test4sub63of100,test4pub80of100,100,193,10,335,3,348
test4sub4of100,test4pub75of100,100,193,14,2347,2,2363
test4sub9of100,test4pub70of100,100,193,10,3531,1,3542
test4sub4of100,test4pub76of100,100,193,10,1980,0,1990
test4sub9of100,test4pub71of100,100,193,10,3334,1,3345
test4sub4of100,test4pub77of100,100,193,11,1561,0,1572
test4sub9of100,test4pub72of100,100,193,12,2961,0,2973
test4sub76of100,test4pub80of100,100,193,10,343,2,355
test4sub14of100,test4pub80of100,100,193,10,343,1,354
test4sub9of100,test4pub73of100,100,193,11,2738,2,2751
test4sub97of100,test4pub80of100,100,193,10,345,1,356
test4sub9of100,test4pub74of100,100,193,11,2580,0,2591
test4sub9of100,test4pub75of100,100,193,14,2359,1,2374
test4sub9of100,test4pub76of100,100,193,10,1990,1,2001
test4sub9of100,test4pub77of100,100,193,11,1570,0,1581
test4sub9of100,test4pub78of100,100,193,11,1017,1,1029
test4sub80of100,test4pub80of100,100,193,10,356,1,367
test4sub36of100,test4pub80of100,100,193,10,361,1,372
test4sub32of100,test4pub80of100,100,193,10,361,0,371
test4sub77of100,test4pub80of100,100,193,10,375,1,386
test4sub5of100,test4pub80of100,100,193,10,377,0,387
test4sub43of100,test4pub80of100,100,193,10,379,1,390
test4sub28of100,test4pub80of100,100,193,10,384,1,395
test4sub33of100,test4pub80of100,100,193,10,390,2,402
test4sub48of100,test4pub80of100,100,193,10,391,2,403
test4sub72of100,test4pub80of100,100,193,10,392,2,404
test4sub75of100,test4pub80of100,100,193,10,393,2,405
test4sub98of100,test4pub80of100,100,193,10,394,1,405
test4sub58of100,test4pub80of100,100,193,10,397,1,408
test4sub99of100,test4pub80of100,100,193,10,398,1,409
test4sub37of100,test4pub80of100,100,193,10,398,1,409
test4sub91of100,test4pub78of100,100,193,11,1065,1,1077
test4sub91of100,test4pub79of100,100,193,14,749,0,763
test4sub91of100,test4pub80of100,100,193,10,414,1,425
test4sub20of100,test4pub80of100,100,193,10,415,1,426
test4sub39of100,test4pub80of100,100,193,10,417,1,428
test4sub7of100,test4pub80of100,100,193,10,418,0,428
test4sub8of100,test4pub80of100,100,193,10,421,1,432
test4sub23of100,test4pub78of100,100,193,11,1087,0,1098
test4sub38of100,test4pub78of100,100,193,11,1088,1,1100
test4sub86of100,test4pub74of100,100,193,11,2658,0,2669
test4sub55of100,test4pub80of100,100,193,10,425,1,436
test4sub86of100,test4pub75of100,100,193,14,2437,1,2452
test4sub86of100,test4pub76of100,100,193,10,2068,0,2078
test4sub86of100,test4pub77of100,100,193,11,1649,1,1661
test4sub86of100,test4pub78of100,100,193,11,1095,1,1107
test4sub54of100,test4pub80of100,100,193,10,446,1,457
test4sub29of100,test4pub80of100,100,193,10,447,1,458
test4sub52of100,test4pub80of100,100,193,10,447,1,458
test4sub100of100,test4pub64of100,100,193,11,9468,0,9479
test4sub100of100,test4pub67of100,100,193,11,7807,0,7818
test4sub100of100,test4pub68of100,100,193,11,4054,1,4066
test4sub31of100,test4pub79of100,100,193,14,810,0,824
test4sub31of100,test4pub80of100,100,193,10,464,1,475
test4sub100of100,test4pub69of100,100,193,10,3876,1,3887
test4sub100of100,test4pub70of100,100,193,10,3659,1,3670
test4sub62of100,test4pub79of100,100,193,14,818,1,833
test4sub62of100,test4pub80of100,100,193,10,471,0,481
test4sub3of100,test4pub77of100,100,193,11,1694,1,1706
test4sub3of100,test4pub78of100,100,193,11,1140,1,1152
test4sub40of100,test4pub70of100,100,193,10,3675,1,3686
test4sub40of100,test4pub71of100,100,193,10,3477,0,3487
test4sub40of100,test4pub72of100,100,193,12,3103,0,3115
test4sub40of100,test4pub73of100,100,193,11,2885,1,2897
test4sub40of100,test4pub74of100,100,193,11,2726,1,2738
test4sub100of100,test4pub71of100,100,193,10,3488,0,3498
test4sub100of100,test4pub72of100,100,193,12,3115,2,3129
test4sub40of100,test4pub75of100,100,193,14,2515,2,2531
test4sub10of100,test4pub80of100,100,193,10,494,5,509
test4sub65of100,test4pub80of100,100,193,10,507,2,519
test4sub100of100,test4pub73of100,100,193,11,2901,3,2915
test4sub4of100,test4pub78of100,100,193,11,1173,2,1186
test4sub9of100,test4pub79of100,100,193,14,858,2,874
test4sub4of100,test4pub79of100,100,193,14,859,2,875
test4sub96of100,test4pub80of100,100,193,10,513,1,524
test4sub9of100,test4pub80of100,100,193,10,513,1,524
test4sub4of100,test4pub80of100,100,193,10,515,1,526
test4sub41of100,test4pub79of100,100,193,14,868,0,882
test4sub41of100,test4pub80of100,100,193,10,522,1,533
test4sub63of100,test4pub81of100,100,193,17,180,1,198
test4sub27of100,test4pub78of100,100,193,11,1188,0,1199
test4sub27of100,test4pub79of100,100,193,14,872,0,886
test4sub27of100,test4pub80of100,100,193,10,526,1,537
test4sub28of100,test4pub81of100,100,193,17,190,1,208
test4sub36of100,test4pub81of100,100,193,17,190,1,208
test4sub14of100,test4pub81of100,100,193,17,191,0,208
test4sub48of100,test4pub81of100,100,193,17,193,1,211
test4sub43of100,test4pub81of100,100,193,17,194,1,212
test4sub75of100,test4pub81of100,100,193,17,195,1,213
test4sub77of100,test4pub81of100,100,193,17,205,0,222
test4sub58of100,test4pub81of100,100,193,17,354,1,372
test4sub50of100,test4pub79of100,100,193,14,1084,0,1098
test4sub50of100,test4pub80of100,100,193,10,738,1,749
test4sub72of100,test4pub81of100,100,193,17,396,2,415
test4sub91of100,test4pub81of100,100,193,17,398,1,416
test4sub32of100,test4pub81of100,100,193,17,397,1,415
test4sub20of100,test4pub81of100,100,193,17,401,0,418
test4sub99of100,test4pub81of100,100,193,17,415,1,433
test4sub39of100,test4pub81of100,100,193,17,416,1,434
test4sub33of100,test4pub81of100,100,193,17,420,1,438
test4sub76of100,test4pub81of100,100,193,17,421,1,439
test4sub30of100,test4pub81of100,100,193,17,427,1,445
test4sub7of100,test4pub81of100,100,193,17,439,1,457
test4sub37of100,test4pub81of100,100,193,17,441,1,459
test4sub5of100,test4pub81of100,100,193,17,469,1,487
test4sub98of100,test4pub81of100,100,193,17,470,1,488
test4sub68of100,test4pub78of100,100,193,11,1478,0,1489
test4sub80of100,test4pub81of100,100,193,17,471,2,490
test4sub97of100,test4pub81of100,100,193,17,475,1,493
test4sub8of100,test4pub81of100,100,193,17,475,0,492
test4sub23of100,test4pub79of100,100,193,14,1167,1,1182
test4sub23of100,test4pub80of100,100,193,10,820,1,831
test4sub38of100,test4pub79of100,100,193,14,1169,1,1184
test4sub23of100,test4pub81of100,100,193,17,480,1,498
test4sub38of100,test4pub80of100,100,193,10,822,1,833
test4sub86of100,test4pub79of100,100,193,14,1172,1,1187
test4sub38of100,test4pub81of100,100,193,17,483,2,502
test4sub86of100,test4pub80of100,100,193,10,826,1,837
test4sub55of100,test4pub81of100,100,193,17,484,1,502
test4sub86of100,test4pub81of100,100,193,17,486,1,504
test4sub54of100,test4pub81of100,100,193,17,487,1,505
test4sub29of100,test4pub81of100,100,193,17,498,1,516
test4sub52of100,test4pub81of100,100,193,17,502,1,520
test4sub100of100,test4pub74of100,100,193,11,3093,1,3105
test4sub100of100,test4pub75of100,100,193,14,2871,0,2885
test4sub100of100,test4pub76of100,100,193,10,2503,1,2514
test4sub100of100,test4pub77of100,100,193,11,2087,1,2099
test4sub31of100,test4pub81of100,100,193,17,526,1,544
test4sub100of100,test4pub78of100,100,193,11,1534,2,1547
test4sub62of100,test4pub81of100,100,193,17,528,0,545
test4sub3of100,test4pub79of100,100,193,14,1223,0,1237
test4sub3of100,test4pub80of100,100,193,10,876,1,887
test4sub3of100,test4pub81of100,100,193,17,536,1,554
test4sub40of100,test4pub76of100,100,193,10,2519,1,2530
test4sub40of100,test4pub77of100,100,193,11,2099,1,2111
test4sub40of100,test4pub78of100,100,193,11,1546,0,1557
test4sub40of100,test4pub79of100,100,193,14,1230,0,1244
test4sub40of100,test4pub80of100,100,193,10,884,1,895
test4sub40of100,test4pub81of100,100,193,17,543,0,560
test4sub100of100,test4pub79of100,100,193,14,1243,1,1258
test4sub100of100,test4pub80of100,100,193,10,896,0,906
test4sub100of100,test4pub81of100,100,193,17,555,4,576
test4sub10of100,test4pub81of100,100,193,17,556,3,576
test4sub65of100,test4pub81of100,100,193,17,557,4,578
test4sub4of100,test4pub81of100,100,193,17,558,3,578
test4sub9of100,test4pub81of100,100,193,17,560,1,578
test4sub96of100,test4pub81of100,100,193,17,571,1,589
test4sub41of100,test4pub81of100,100,193,17,574,0,591
test4sub27of100,test4pub81of100,100,193,17,582,1,600
test4sub36of100,test4pub82of100,100,193,11,407,1,419
test4sub94of100,test4pub80of100,100,193,10,941,0,951
test4sub94of100,test4pub81of100,100,193,17,601,1,619
test4sub48of100,test4pub82of100,100,193,11,422,1,434
test4sub77of100,test4pub82of100,100,193,11,423,1,435
test4sub16of100,test4pub78of100,100,193,11,1618,1,1630
test4sub16of100,test4pub79of100,100,193,14,1302,1,1317
test4sub63of100,test4pub82of100,100,193,11,428,1,440
test4sub16of100,test4pub80of100,100,193,10,956,0,966
test4sub14of100,test4pub82of100,100,193,11,434,0,445
test4sub43of100,test4pub82of100,100,193,11,452,1,464
test4sub60of100,test4pub73of100,100,193,11,3421,1,3433
test4sub51of100,test4pub76of100,100,193,10,2670,2,2682
test4sub60of100,test4pub74of100,100,193,11,3263,2,3276
test4sub51of100,test4pub77of100,100,193,11,2251,1,2263
test4sub58of100,test4pub82of100,100,193,11,504,3,518
test4sub60of100,test4pub75of100,100,193,14,3043,1,3058
test4sub51of100,test4pub78of100,100,193,11,1698,1,1710
test4sub51of100,test4pub79of100,100,193,14,1383,1,1398
test4sub51of100,test4pub80of100,100,193,10,1036,0,1046
test4sub51of100,test4pub81of100,100,193,17,695,1,713
test4sub50of100,test4pub81of100,100,193,17,716,1,734
test4sub50of100,test4pub82of100,100,193,11,532,0,543
test4sub22of100,test4pub79of100,100,193,14,1429,0,1443
test4sub22of100,test4pub80of100,100,193,10,1083,2,1095
test4sub72of100,test4pub82of100,100,193,11,557,1,569
test4sub22of100,test4pub81of100,100,193,17,743,1,761
test4sub32of100,test4pub82of100,100,193,11,564,0,575
test4sub91of100,test4pub82of100,100,193,11,566,2,579
test4sub20of100,test4pub82of100,100,193,11,567,1,579
test4sub99of100,test4pub82of100,100,193,11,571,1,583
test4sub39of100,test4pub82of100,100,193,11,634,1,646
test4sub33of100,test4pub82of100,100,193,11,636,1,648
test4sub76of100,test4pub82of100,100,193,11,637,2,650
test4sub30of100,test4pub82of100,100,193,11,638,2,651
test4sub7of100,test4pub82of100,100,193,11,639,3,653
test4sub37of100,test4pub82of100,100,193,11,643,0,654
test4sub90of100,test4pub78of100,100,193,11,1849,0,1860
test4sub71of100,test4pub79of100,100,193,14,1532,2,1548
test4sub90of100,test4pub79of100,100,193,14,1534,2,1550
test4sub5of100,test4pub82of100,100,193,11,662,4,677
test4sub98of100,test4pub82of100,100,193,11,663,4,678
test4sub59of100,test4pub79of100,100,193,14,1540,3,1557
test4sub80of100,test4pub82of100,100,193,11,666,4,681
test4sub59of100,test4pub80of100,100,193,10,1196,2,1208
test4sub59of100,test4pub81of100,100,193,17,856,0,873
test4sub68of100,test4pub79of100,100,193,14,1603,1,1618
test4sub68of100,test4pub80of100,100,193,10,1257,1,1268
test4sub68of100,test4pub81of100,100,193,17,917,1,935
test4sub97of100,test4pub82of100,100,193,11,732,1,744
test4sub68of100,test4pub82of100,100,193,11,733,1,745
test4sub8of100,test4pub82of100,100,193,11,767,2,780
test4sub23of100,test4pub82of100,100,193,11,768,2,781
test4sub38of100,test4pub82of100,100,193,11,769,2,782
test4sub86of100,test4pub82of100,100,193,11,770,1,782
test4sub55of100,test4pub82of100,100,193,11,777,1,789
test4sub54of100,test4pub82of100,100,193,11,784,1,796
test4sub29of100,test4pub82of100,100,193,11,786,1,798
test4sub95of100,test4pub79of100,100,193,14,1664,1,1679
test4sub95of100,test4pub80of100,100,193,10,1317,0,1327
test4sub95of100,test4pub81of100,100,193,17,976,1,994
test4sub52of100,test4pub82of100,100,193,11,793,1,805
test4sub31of100,test4pub82of100,100,193,11,801,1,813
test4sub3of100,test4pub82of100,100,193,11,802,1,814
test4sub40of100,test4pub82of100,100,193,11,803,1,815
test4sub21of100,test4pub10of100,100,193,11,29459,0,29470
test4sub21of100,test4pub11of100,100,193,10,29224,1,29235
test4sub100of100,test4pub82of100,100,193,11,806,1,818
test4sub10of100,test4pub82of100,100,193,11,808,1,820
test4sub65of100,test4pub82of100,100,193,11,839,2,852
test4sub4of100,test4pub82of100,100,193,11,840,1,852
test4sub9of100,test4pub82of100,100,193,11,841,1,853
test4sub64of100,test4pub77of100,100,193,11,2593,1,2605
test4sub64of100,test4pub78of100,100,193,11,2040,1,2052
test4sub96of100,test4pub82of100,100,193,11,849,1,861
test4sub41of100,test4pub82of100,100,193,11,852,1,864
test4sub27of100,test4pub82of100,100,193,11,853,1,865
test4sub44of100,test4pub76of100,100,193,10,3032,1,3043
test4sub12of100,test4pub76of100,100,193,10,3033,2,3045
test4sub44of100,test4pub77of100,100,193,11,2613,1,2625
test4sub15of100,test4pub79of100,100,193,14,1741,3,1758
test4sub44of100,test4pub78of100,100,193,11,2060,1,2072
test4sub12of100,test4pub77of100,100,193,11,2615,3,2629
test4sub15of100,test4pub80of100,100,193,10,1396,1,1407
test4sub44of100,test4pub79of100,100,193,14,1745,2,1761
test4sub12of100,test4pub78of100,100,193,11,2063,1,2075
test4sub15of100,test4pub81of100,100,193,17,1056,2,1075
test4sub12of100,test4pub79of100,100,193,14,1748,1,1763
test4sub44of100,test4pub80of100,100,193,10,1400,2,1412
test4sub12of100,test4pub80of100,100,193,10,1402,1,1413
test4sub44of100,test4pub81of100,100,193,17,1060,1,1078
test4sub12of100,test4pub81of100,100,193,17,1061,1,1079
test4sub85of100,test4pub80of100,100,193,10,1455,0,1465
test4sub85of100,test4pub81of100,100,193,17,1114,2,1133
test4sub6of100,test4pub79of100,100,193,14,1806,1,1821
test4sub94of100,test4pub82of100,100,193,11,931,3,945
test4sub85of100,test4pub82of100,100,193,11,932,1,944
test4sub6of100,test4pub80of100,100,193,10,1460,1,1471
test4sub6of100,test4pub81of100,100,193,17,1120,1,1138
test4sub16of100,test4pub81of100,100,193,17,1130,1,1148
test4sub16of100,test4pub82of100,100,193,11,946,1,958
test4sub84of100,test4pub72of100,100,193,12,4094,0,4106
test4sub84of100,test4pub73of100,100,193,11,3870,1,3882
test4sub14of100,test4pub83of100,100,193,14,538,2,554
test4sub48of100,test4pub83of100,100,193,14,539,1,554
test4sub84of100,test4pub74of100,100,193,11,3712,1,3724
test4sub77of100,test4pub83of100,100,193,14,549,1,564
test4sub63of100,test4pub83of100,100,193,14,549,0,563
test4sub43of100,test4pub83of100,100,193,14,554,1,569
test4sub51of100,test4pub82of100,100,193,11,976,1,988
test4sub51of100,test4pub83of100,100,193,14,567,1,582
test4sub58of100,test4pub83of100,100,193,14,570,1,585
test4sub50of100,test4pub83of100,100,193,14,592,1,607
test4sub22of100,test4pub82of100,100,193,11,1007,1,1019
test4sub72of100,test4pub83of100,100,193,14,597,2,613
test4sub32of100,test4pub83of100,100,193,14,598,2,614
test4sub22of100,test4pub83of100,100,193,14,598,3,615
test4sub91of100,test4pub83of100,100,193,14,599,2,615
test4sub20of100,test4pub83of100,100,193,14,600,2,616
test4sub99of100,test4pub83of100,100,193,14,602,1,617
test4sub36of100,test4pub83of100,100,193,14,603,1,618
test4sub87of100,test4pub79of100,100,193,14,1891,1,1906
test4sub39of100,test4pub83of100,100,193,14,606,1,621
test4sub87of100,test4pub80of100,100,193,10,1544,2,1556
test4sub33of100,test4pub83of100,100,193,14,608,2,624
test4sub76of100,test4pub83of100,100,193,14,608,1,623
test4sub87of100,test4pub81of100,100,193,17,1206,1,1224
test4sub30of100,test4pub83of100,100,193,14,611,1,626
test4sub7of100,test4pub83of100,100,193,14,612,1,627
test4sub37of100,test4pub83of100,100,193,14,613,1,628
test4sub5of100,test4pub83of100,100,193,14,637,0,651
test4sub98of100,test4pub83of100,100,193,14,638,1,653
test4sub59of100,test4pub82of100,100,193,11,1051,1,1063
test4sub59of100,test4pub83of100,100,193,14,641,0,655
test4sub80of100,test4pub83of100,100,193,14,645,1,660
test4sub93of100,test4pub78of100,100,193,11,2249,0,2260
test4sub93of100,test4pub79of100,100,193,14,1933,1,1948
test4sub79of100,test4pub78of100,100,193,11,2252,1,2264
test4sub93of100,test4pub80of100,100,193,10,1587,1,1598
test4sub28of100,test4pub82of100,100,193,11,1061,2,1074
test4sub79of100,test4pub79of100,100,193,14,1937,1,1952
test4sub68of100,test4pub83of100,100,193,14,653,1,668
test4sub97of100,test4pub83of100,100,193,14,654,1,669
test4sub8of100,test4pub83of100,100,193,14,655,1,670
test4sub23of100,test4pub83of100,100,193,14,656,3,673
test4sub38of100,test4pub83of100,100,193,14,657,2,673
test4sub86of100,test4pub83of100,100,193,14,657,2,673
test4sub55of100,test4pub83of100,100,193,14,658,2,674
test4sub54of100,test4pub83of100,100,193,14,659,2,675
test4sub29of100,test4pub83of100,100,193,14,660,1,675
test4sub95of100,test4pub82of100,100,193,11,1076,1,1088
test4sub52of100,test4pub83of100,100,193,14,666,1,681
test4sub95of100,test4pub83of100,100,193,14,667,1,682
test4sub3of100,test4pub83of100,100,193,14,668,1,683
test4sub31of100,test4pub83of100,100,193,14,667,2,683
test4sub40of100,test4pub83of100,100,193,14,669,1,684
test4sub100of100,test4pub83of100,100,193,14,674,1,689
test4sub65of100,test4pub83of100,100,193,14,675,1,690
test4sub12of100,test4pub82of100,100,193,11,1090,0,1101
test4sub12of100,test4pub83of100,100,193,14,681,1,696
test4sub15of100,test4pub82of100,100,193,11,1115,1,1127
test4sub17of100,test4pub76of100,100,193,10,3284,1,3295
test4sub15of100,test4pub83of100,100,193,14,705,1,720
test4sub62of100,test4pub82of100,100,193,11,1118,2,1131
test4sub85of100,test4pub83of100,100,193,14,708,2,724
test4sub73of100,test4pub79of100,100,193,14,1995,2,2011
test4sub85of100,test4pub84of100,100,193,14,233,1,248
test4sub62of100,test4pub83of100,100,193,14,710,1,725
test4sub73of100,test4pub80of100,100,193,10,1650,1,1661
test4sub73of100,test4pub81of100,100,193,17,1309,0,1326
test4sub6of100,test4pub82of100,100,193,11,1130,1,1142
test4sub94of100,test4pub83of100,100,193,14,720,1,735
test4sub6of100,test4pub83of100,100,193,14,721,1,736
test4sub6of100,test4pub84of100,100,193,14,245,1,260
test4sub16of100,test4pub83of100,100,193,14,723,1,738
test4sub16of100,test4pub84of100,100,193,14,248,1,263
test4sub84of100,test4pub75of100,100,193,14,3675,0,3689
test4sub84of100,test4pub76of100,100,193,10,3307,1,3318
test4sub84of100,test4pub77of100,100,193,11,2887,0,2898
test4sub14of100,test4pub84of100,100,193,14,253,2,269
test4sub84of100,test4pub78of100,100,193,11,2334,1,2346
test4sub84of100,test4pub79of100,100,193,14,2018,0,2032
test4sub84of100,test4pub80of100,100,193,10,1672,1,1683
test4sub48of100,test4pub84of100,100,193,14,387,1,402
test4sub77of100,test4pub84of100,100,193,14,388,1,403
test4sub63of100,test4pub84of100,100,193,14,390,0,404
test4sub67of100,test4pub79of100,100,193,14,2155,0,2169
test4sub43of100,test4pub84of100,100,193,14,393,2,409
test4sub67of100,test4pub80of100,100,193,10,1809,1,1820
test4sub75of100,test4pub82of100,100,193,11,1282,2,1295
test4sub67of100,test4pub81of100,100,193,17,1469,1,1487
test4sub60of100,test4pub76of100,100,193,10,3480,1,3491
test4sub60of100,test4pub77of100,100,193,11,3061,1,3073
test4sub60of100,test4pub78of100,100,193,11,2507,0,2518
test4sub60of100,test4pub79of100,100,193,14,2192,1,2207
test4sub60of100,test4pub80of100,100,193,10,1845,0,1855
test4sub60of100,test4pub81of100,100,193,17,1504,1,1522
test4sub51of100,test4pub84of100,100,193,14,432,2,448
test4sub50of100,test4pub84of100,100,193,14,433,1,448
test4sub22of100,test4pub84of100,100,193,14,434,1,449
test4sub72of100,test4pub84of100,100,193,14,436,0,450
test4sub32of100,test4pub84of100,100,193,14,437,2,453
test4sub20of100,test4pub84of100,100,193,14,438,1,453
test4sub99of100,test4pub84of100,100,193,14,448,1,463
test4sub58of100,test4pub84of100,100,193,14,482,1,497
test4sub33of100,test4pub84of100,100,193,14,483,1,498
test4sub76of100,test4pub84of100,100,193,14,485,1,500
test4sub30of100,test4pub84of100,100,193,14,485,1,500
test4sub7of100,test4pub84of100,100,193,14,494,0,508
test4sub37of100,test4pub84of100,100,193,14,495,0,509
test4sub90of100,test4pub80of100,100,193,10,1912,0,1922
test4sub90of100,test4pub81of100,100,193,17,1571,1,1589
test4sub90of100,test4pub82of100,100,193,11,1388,1,1400
test4sub90of100,test4pub83of100,100,193,14,978,0,992
test4sub71of100,test4pub80of100,100,193,10,1920,1,1931
test4sub5of100,test4pub84of100,100,193,14,505,0,519
test4sub71of100,test4pub81of100,100,193,17,1579,1,1597
test4sub98of100,test4pub84of100,100,193,14,507,3,524
test4sub59of100,test4pub84of100,100,193,14,508,2,524
test4sub71of100,test4pub82of100,100,193,11,1397,1,1409
test4sub71of100,test4pub83of100,100,193,14,988,1,1003
test4sub80of100,test4pub84of100,100,193,14,543,1,558
test4sub93of100,test4pub81of100,100,193,17,1617,0,1634
test4sub93of100,test4pub82of100,100,193,11,1434,1,1446
test4sub93of100,test4pub83of100,100,193,14,1024,0,1038
test4sub93of100,test4pub84of100,100,193,14,548,0,562
test4sub28of100,test4pub83of100,100,193,14,1051,1,1066
test4sub28of100,test4pub84of100,100,193,14,575,1,590
test4sub68of100,test4pub84of100,100,193,14,575,1,590
test4sub8of100,test4pub84of100,100,193,14,584,0,598
test4sub49of100,test4pub76of100,100,193,10,3645,1,3656
test4sub23of100,test4pub84of100,100,193,14,590,2,606
test4sub38of100,test4pub84of100,100,193,14,591,1,606
test4sub86of100,test4pub84of100,100,193,14,592,1,607
test4sub55of100,test4pub84of100,100,193,14,594,1,609
test4sub54of100,test4pub84of100,100,193,14,610,1,625
test4sub29of100,test4pub84of100,100,193,14,610,1,625
test4sub95of100,test4pub84of100,100,193,14,612,0,626
test4sub52of100,test4pub84of100,100,193,14,637,1,652
test4sub31of100,test4pub84of100,100,193,14,641,1,656
test4sub3of100,test4pub84of100,100,193,14,647,1,662
test4sub40of100,test4pub84of100,100,193,14,648,0,662
test4sub21of100,test4pub12of100,100,193,11,29520,1,29532
test4sub21of100,test4pub13of100,100,193,10,29317,0,29327
test4sub21of100,test4pub14of100,100,193,10,29151,1,29162
test4sub21of100,test4pub15of100,100,193,11,29013,0,29024
test4sub21of100,test4pub16of100,100,193,10,28857,1,28868
test4sub21of100,test4pub17of100,100,193,11,28723,1,28735
test4sub21of100,test4pub18of100,100,193,18,28538,0,28556
test4sub21of100,test4pub19of100,100,193,11,28330,1,28342
test4sub21of100,test4pub20of100,100,193,10,27889,1,27900
test4sub21of100,test4pub21of100,100,193,10,27803,0,27813
test4sub21of100,test4pub22of100,100,193,10,27673,1,27684
test4sub21of100,test4pub23of100,100,193,11,27501,0,27512
test4sub21of100,test4pub24of100,100,193,19,27372,1,27392
test4sub21of100,test4pub25of100,100,193,16,26951,1,26968
test4sub21of100,test4pub26of100,100,193,10,26734,0,26744
test4sub21of100,test4pub27of100,100,193,10,26414,1,26425
test4sub21of100,test4pub28of100,100,193,10,26313,1,26324
test4sub13of100,test4pub76of100,100,193,10,3741,0,3751
test4sub21of100,test4pub29of100,100,193,11,26158,1,26170
test4sub21of100,test4pub30of100,100,193,15,26023,1,26039
test4sub21of100,test4pub31of100,100,193,10,25890,0,25900
test4sub100of100,test4pub84of100,100,193,14,754,1,769
test4sub65of100,test4pub84of100,100,193,14,761,1,776
test4sub60of100,test4pub82of100,100,193,11,1652,1,1664
test4sub12of100,test4pub84of100,100,193,14,765,1,780
test4sub60of100,test4pub83of100,100,193,14,1243,0,1257
test4sub60of100,test4pub84of100,100,193,14,767,1,782
test4sub97of100,test4pub84of100,100,193,14,778,1,793
test4sub15of100,test4pub84of100,100,193,14,779,1,794
test4sub97of100,test4pub85of100,100,193,10,538,0,548
test4sub15of100,test4pub85of100,100,193,10,539,1,550
test4sub17of100,test4pub77of100,100,193,11,3432,1,3444
test4sub17of100,test4pub78of100,100,193,11,2878,0,2889
test4sub17of100,test4pub79of100,100,193,14,2563,1,2578
test4sub17of100,test4pub80of100,100,193,10,2216,0,2226
test4sub17of100,test4pub81of100,100,193,17,1876,1,1894
test4sub62of100,test4pub84of100,100,193,14,833,1,848
test4sub62of100,test4pub85of100,100,193,10,594,1,605
test4sub73of100,test4pub82of100,100,193,11,1733,0,1744
test4sub73of100,test4pub83of100,100,193,14,1324,1,1339
test4sub73of100,test4pub84of100,100,193,14,848,1,863
test4sub73of100,test4pub85of100,100,193,10,618,0,628
test4sub47of100,test4pub79of100,100,193,14,2624,1,2639
test4sub6of100,test4pub85of100,100,193,10,622,1,633
test4sub47of100,test4pub80of100,100,193,10,2277,1,2288
test4sub85of100,test4pub85of100,100,193,10,624,1,635
test4sub47of100,test4pub81of100,100,193,17,1937,0,1954
test4sub47of100,test4pub82of100,100,193,11,1755,1,1767
test4sub47of100,test4pub83of100,100,193,14,1345,0,1359
test4sub47of100,test4pub84of100,100,193,14,869,0,883
test4sub94of100,test4pub84of100,100,193,14,918,0,932
test4sub16of100,test4pub85of100,100,193,10,678,1,689
test4sub94of100,test4pub85of100,100,193,10,679,1,690
test4sub84of100,test4pub81of100,100,193,17,1996,1,2014
test4sub84of100,test4pub82of100,100,193,11,1812,1,1824
test4sub84of100,test4pub83of100,100,193,14,1403,1,1418
test4sub84of100,test4pub84of100,100,193,14,974,1,989
test4sub14of100,test4pub85of100,100,193,10,733,1,744
test4sub84of100,test4pub85of100,100,193,10,734,1,745
test4sub57of100,test4pub79of100,100,193,14,2742,0,2756
test4sub48of100,test4pub85of100,100,193,10,759,1,770
test4sub77of100,test4pub85of100,100,193,10,774,1,785
test4sub63of100,test4pub85of100,100,193,10,774,1,785
test4sub67of100,test4pub82of100,100,193,11,1914,0,1925
test4sub67of100,test4pub83of100,100,193,14,1505,1,1520
test4sub43of100,test4pub85of100,100,193,10,788,0,798
test4sub67of100,test4pub84of100,100,193,14,1029,1,1044
test4sub67of100,test4pub85of100,100,193,10,790,0,800
test4sub75of100,test4pub83of100,100,193,14,1509,1,1524
test4sub75of100,test4pub84of100,100,193,14,1033,0,1047
test4sub75of100,test4pub85of100,100,193,10,798,1,809
test4sub60of100,test4pub85of100,100,193,10,803,0,813
test4sub51of100,test4pub85of100,100,193,10,808,0,818
test4sub50of100,test4pub85of100,100,193,10,813,0,823
test4sub22of100,test4pub85of100,100,193,10,814,1,825
test4sub72of100,test4pub85of100,100,193,10,815,1,826
test4sub32of100,test4pub85of100,100,193,10,838,1,849
test4sub20of100,test4pub85of100,100,193,10,855,0,865
test4sub99of100,test4pub85of100,100,193,10,857,1,868
test4sub33of100,test4pub85of100,100,193,10,866,1,877
test4sub76of100,test4pub85of100,100,193,10,868,1,879
test4sub30of100,test4pub85of100,100,193,10,869,1,880
test4sub7of100,test4pub85of100,100,193,10,870,0,880
test4sub37of100,test4pub85of100,100,193,10,882,0,892
test4sub90of100,test4pub84of100,100,193,14,1144,1,1159
test4sub90of100,test4pub85of100,100,193,10,904,0,914
test4sub71of100,test4pub84of100,100,193,14,1148,1,1163
test4sub5of100,test4pub85of100,100,193,10,908,2,920
test4sub71of100,test4pub85of100,100,193,10,910,1,921
test4sub98of100,test4pub85of100,100,193,10,909,2,921
test4sub59of100,test4pub85of100,100,193,10,910,2,922
test4sub80of100,test4pub85of100,100,193,10,911,2,923
test4sub93of100,test4pub85of100,100,193,10,912,1,923
test4sub79of100,test4pub80of100,100,193,10,2619,1,2630
test4sub58of100,test4pub85of100,100,193,10,963,1,974
test4sub79of100,test4pub81of100,100,193,17,2279,1,2297
test4sub28of100,test4pub85of100,100,193,10,966,0,976
test4sub79of100,test4pub82of100,100,193,11,2095,1,2107
test4sub79of100,test4pub83of100,100,193,14,1686,1,1701
test4sub79of100,test4pub84of100,100,193,14,1210,0,1224
test4sub68of100,test4pub85of100,100,193,10,987,1,998
test4sub8of100,test4pub85of100,100,193,10,987,0,997
test4sub49of100,test4pub77of100,100,193,11,3865,0,3876
test4sub49of100,test4pub78of100,100,193,11,3312,1,3324
test4sub49of100,test4pub79of100,100,193,14,3017,1,3032
test4sub49of100,test4pub80of100,100,193,10,2670,1,2681
test4sub23of100,test4pub85of100,100,193,10,1013,2,1025
test4sub38of100,test4pub85of100,100,193,10,1014,1,1025
test4sub49of100,test4pub81of100,100,193,17,2330,0,2347
test4sub86of100,test4pub85of100,100,193,10,1035,1,1046
test4sub70of100,test4pub79of100,100,193,14,3040,0,3054
test4sub70of100,test4pub80of100,100,193,10,2694,1,2705
test4sub70of100,test4pub81of100,100,193,17,2353,1,2371
test4sub70of100,test4pub82of100,100,193,11,2169,0,2180
test4sub70of100,test4pub83of100,100,193,14,1760,1,1775
test4sub70of100,test4pub84of100,100,193,14,1284,1,1299
test4sub55of100,test4pub85of100,100,193,10,1048,1,1059
test4sub54of100,test4pub85of100,100,193,10,1060,2,1072
test4sub29of100,test4pub85of100,100,193,10,1061,2,1073
test4sub95of100,test4pub85of100,100,193,10,1063,1,1074
test4sub31of100,test4pub85of100,100,193,10,1096,1,1107
test4sub3of100,test4pub85of100,100,193,10,1099,0,1109
test4sub40of100,test4pub85of100,100,193,10,1101,1,1112
test4sub21of100,test4pub32of100,100,193,11,26187,1,26199
test4sub21of100,test4pub33of100,100,193,11,26046,1,26058
test4sub21of100,test4pub34of100,100,193,12,25267,0,25279
test4sub21of100,test4pub35of100,100,193,12,22914,1,22927
test4sub21of100,test4pub36of100,100,193,10,21639,0,21649
test4sub52of100,test4pub85of100,100,193,10,1119,0,1129
test4sub13of100,test4pub77of100,100,193,11,4004,0,4015
test4sub13of100,test4pub78of100,100,193,11,3451,1,3463
test4sub13of100,test4pub79of100,100,193,14,3135,0,3149
test4sub13of100,test4pub80of100,100,193,10,2789,1,2800
test4sub13of100,test4pub81of100,100,193,17,2448,1,2466
test4sub21of100,test4pub37of100,100,193,23,21321,0,21344
test4sub21of100,test4pub38of100,100,193,31,21063,1,21095
test4sub21of100,test4pub39of100,100,193,28,20915,0,20943
test4sub100of100,test4pub85of100,100,193,10,1178,1,1189
test4sub65of100,test4pub85of100,100,193,10,1180,1,1191
test4sub12of100,test4pub85of100,100,193,10,1181,0,1191
test4sub64of100,test4pub79of100,100,193,14,3189,0,3203
test4sub64of100,test4pub80of100,100,193,10,2843,1,2854
test4sub64of100,test4pub81of100,100,193,17,2502,0,2519
test4sub17of100,test4pub82of100,100,193,11,2318,1,2330
test4sub64of100,test4pub82of100,100,193,11,2319,1,2331
test4sub17of100,test4pub83of100,100,193,14,1909,0,1923
test4sub64of100,test4pub83of100,100,193,14,1909,1,1924
test4sub64of100,test4pub84of100,100,193,14,1434,0,1448
test4sub17of100,test4pub84of100,100,193,14,1434,1,1449
test4sub17of100,test4pub85of100,100,193,10,1195,0,1205
test4sub15of100,test4pub86of100,100,193,16,705,1,722
test4sub96of100,test4pub83of100,100,193,14,1971,1,1986
test4sub97of100,test4pub86of100,100,193,16,730,1,747
test4sub47of100,test4pub85of100,100,193,10,1263,1,1274
test4sub6of100,test4pub86of100,100,193,16,738,1,755
test4sub85of100,test4pub86of100,100,193,16,741,1,758
test4sub62of100,test4pub86of100,100,193,16,746,1,763
test4sub36of100,test4pub84of100,100,193,14,1522,1,1537
test4sub27of100,test4pub83of100,100,193,14,2000,1,2015
test4sub36of100,test4pub85of100,100,193,10,1282,2,1294
test4sub73of100,test4pub86of100,100,193,16,750,1,767
test4sub27of100,test4pub84of100,100,193,14,1525,2,1541
test4sub27of100,test4pub85of100,100,193,10,1286,1,1297
test4sub94of100,test4pub86of100,100,193,16,761,0,777
test4sub16of100,test4pub86of100,100,193,16,762,2,780
test4sub84of100,test4pub86of100,100,193,16,763,1,780
test4sub14of100,test4pub86of100,100,193,16,765,0,781
test4sub44of100,test4pub82of100,100,193,11,2448,0,2459
test4sub44of100,test4pub83of100,100,193,14,2039,1,2054
test4sub44of100,test4pub84of100,100,193,14,1563,0,1577
test4sub44of100,test4pub85of100,100,193,10,1323,0,1333
test4sub66of100,test4pub79of100,100,193,14,3330,1,3345
test4sub66of100,test4pub80of100,100,193,10,2983,0,2993
test4sub48of100,test4pub86of100,100,193,16,795,1,812
test4sub66of100,test4pub81of100,100,193,17,2643,2,2662
test4sub92of100,test4pub77of100,100,193,11,4205,1,4217
test4sub92of100,test4pub78of100,100,193,11,3652,1,3664
test4sub66of100,test4pub82of100,100,193,11,2460,3,2474
test4sub77of100,test4pub86of100,100,193,16,800,3,819
test4sub92of100,test4pub79of100,100,193,14,3337,3,3354
test4sub63of100,test4pub86of100,100,193,16,802,3,821
test4sub66of100,test4pub83of100,100,193,14,2053,3,2070
test4sub67of100,test4pub86of100,100,193,16,803,3,822
test4sub43of100,test4pub86of100,100,193,16,804,4,824
test4sub92of100,test4pub80of100,100,193,10,2994,3,3007
test4sub66of100,test4pub84of100,100,193,14,1581,2,1597
test4sub92of100,test4pub81of100,100,193,17,2656,1,2674
test4sub75of100,test4pub86of100,100,193,16,815,1,832
test4sub60of100,test4pub86of100,100,193,16,816,1,833
test4sub51of100,test4pub86of100,100,193,16,819,1,836
test4sub50of100,test4pub86of100,100,193,16,820,0,836
test4sub22of100,test4pub86of100,100,193,16,822,1,839
test4sub72of100,test4pub86of100,100,193,16,825,1,842
test4sub1of100,test4pub76of100,100,193,10,4656,1,4667
test4sub1of100,test4pub77of100,100,193,11,4236,0,4247
test4sub1of100,test4pub78of100,100,193,11,3683,2,3696
test4sub32of100,test4pub86of100,100,193,16,830,1,847
test4sub20of100,test4pub86of100,100,193,16,831,1,848
test4sub99of100,test4pub86of100,100,193,16,832,1,849
test4sub33of100,test4pub86of100,100,193,16,834,1,851
test4sub30of100,test4pub86of100,100,193,16,838,1,855
test4sub7of100,test4pub86of100,100,193,16,841,1,858
test4sub10of100,test4pub83of100,100,193,14,2093,0,2107
test4sub10of100,test4pub84of100,100,193,14,1618,1,1633
test4sub10of100,test4pub85of100,100,193,10,1378,1,1389
test4sub37of100,test4pub86of100,100,193,16,848,1,865
test4sub90of100,test4pub86of100,100,193,16,849,0,865
test4sub91of100,test4pub84of100,100,193,14,1628,1,1643
test4sub91of100,test4pub85of100,100,193,10,1388,0,1398
test4sub76of100,test4pub86of100,100,193,16,855,1,872
test4sub71of100,test4pub86of100,100,193,16,857,2,875
test4sub5of100,test4pub86of100,100,193,16,857,2,875
test4sub91of100,test4pub86of100,100,193,16,858,2,876
test4sub98of100,test4pub86of100,100,193,16,859,2,877
test4sub59of100,test4pub86of100,100,193,16,860,1,877
test4sub93of100,test4pub86of100,100,193,16,863,1,880
test4sub80of100,test4pub86of100,100,193,16,865,0,881
test4sub79of100,test4pub85of100,100,193,10,1400,1,1411
test4sub79of100,test4pub86of100,100,193,16,869,1,886
test4sub28of100,test4pub86of100,100,193,16,871,1,888
test4sub68of100,test4pub86of100,100,193,16,872,0,888
test4sub8of100,test4pub86of100,100,193,16,874,0,890
test4sub49of100,test4pub82of100,100,193,11,2543,1,2555
test4sub49of100,test4pub83of100,100,193,14,2133,0,2147
test4sub49of100,test4pub84of100,100,193,14,1658,1,1673
test4sub49of100,test4pub85of100,100,193,10,1418,0,1428
test4sub49of100,test4pub86of100,100,193,16,886,0,902
test4sub70of100,test4pub85of100,100,193,10,1433,1,1444
test4sub70of100,test4pub86of100,100,193,16,901,1,918
test4sub29of100,test4pub86of100,100,193,16,912,1,929
test4sub95of100,test4pub86of100,100,193,16,917,1,934
test4sub31of100,test4pub86of100,100,193,16,918,0,934
test4sub3of100,test4pub86of100,100,193,16,920,1,937
test4sub82of100,test4pub73of100,100,193,11,5507,1,5519
test4sub82of100,test4pub74of100,100,193,11,5348,0,5359
test4sub82of100,test4pub75of100,100,193,14,5127,1,5142
test4sub58of100,test4pub86of100,100,193,16,930,0,946
test4sub83of100,test4pub73of100,100,193,11,5524,1,5536
test4sub83of100,test4pub74of100,100,193,11,5365,0,5376
test4sub83of100,test4pub75of100,100,193,14,5144,1,5159
test4sub83of100,test4pub76of100,100,193,10,4775,0,4785
test4sub83of100,test4pub77of100,100,193,11,4355,0,4366
test4sub83of100,test4pub78of100,100,193,11,3802,0,3813
test4sub39of100,test4pub84of100,100,193,14,1722,1,1737
test4sub39of100,test4pub85of100,100,193,10,1483,2,1495
test4sub26of100,test4pub73of100,100,193,11,5533,1,5545
test4sub39of100,test4pub86of100,100,193,16,952,0,968
test4sub26of100,test4pub74of100,100,193,11,5375,1,5387
test4sub26of100,test4pub75of100,100,193,14,5154,0,5168
test4sub26of100,test4pub76of100,100,193,10,4785,0,4795
test4sub26of100,test4pub77of100,100,193,11,4366,1,4378
test4sub26of100,test4pub78of100,100,193,11,3812,0,3823
test4sub65of100,test4pub86of100,100,193,16,968,1,985
test4sub12of100,test4pub86of100,100,193,16,969,0,985
test4sub34of100,test4pub73of100,100,193,11,5554,1,5566
test4sub34of100,test4pub74of100,100,193,11,5395,1,5407
test4sub34of100,test4pub75of100,100,193,14,5173,0,5187
test4sub34of100,test4pub76of100,100,193,10,4805,1,4816
test4sub34of100,test4pub77of100,100,193,11,4385,0,4396
test4sub34of100,test4pub78of100,100,193,11,3831,0,3842
test4sub97of100,test4pub87of100,100,193,11,317,0,328
test4sub4of100,test4pub83of100,100,193,14,2233,1,2248
test4sub11of100,test4pub73of100,100,193,11,5567,1,5579
test4sub4of100,test4pub84of100,100,193,14,1758,2,1774
test4sub11of100,test4pub74of100,100,193,11,5408,1,5420
test4sub62of100,test4pub87of100,100,193,11,322,1,334
test4sub11of100,test4pub75of100,100,193,14,5187,1,5202
test4sub4of100,test4pub85of100,100,193,10,1519,1,1530
test4sub73of100,test4pub87of100,100,193,11,325,1,337
test4sub94of100,test4pub87of100,100,193,11,326,0,337
test4sub57of100,test4pub80of100,100,193,10,3183,0,3193
test4sub57of100,test4pub81of100,100,193,17,2843,1,2861
test4sub66of100,test4pub85of100,100,193,10,1530,2,1542
test4sub57of100,test4pub82of100,100,193,11,2659,1,2671
test4sub48of100,test4pub87of100,100,193,11,334,3,348
test4sub66of100,test4pub86of100,100,193,16,999,1,1016
test4sub57of100,test4pub83of100,100,193,14,2251,1,2266
test4sub66of100,test4pub87of100,100,193,11,337,1,349
test4sub57of100,test4pub84of100,100,193,14,1776,1,1791
test4sub57of100,test4pub85of100,100,193,10,1536,1,1547
test4sub57of100,test4pub86of100,100,193,16,1005,1,1022
test4sub92of100,test4pub82of100,100,193,11,2677,0,2688
test4sub92of100,test4pub83of100,100,193,14,2268,2,2284
test4sub77of100,test4pub87of100,100,193,11,354,1,366
test4sub92of100,test4pub84of100,100,193,14,1793,1,1808
test4sub92of100,test4pub85of100,100,193,10,1554,1,1565
test4sub92of100,test4pub86of100,100,193,16,1022,1,1039
test4sub92of100,test4pub87of100,100,193,11,359,0,370
test4sub50of100,test4pub87of100,100,193,11,362,1,374
test4sub32of100,test4pub87of100,100,193,11,368,0,379
test4sub20of100,test4pub87of100,100,193,11,369,1,381
test4sub99of100,test4pub87of100,100,193,11,370,1,382
test4sub33of100,test4pub87of100,100,193,11,376,1,388
test4sub30of100,test4pub87of100,100,193,11,389,1,401
test4sub7of100,test4pub87of100,100,193,11,393,1,405
test4sub10of100,test4pub86of100,100,193,16,1058,0,1074
test4sub10of100,test4pub87of100,100,193,11,395,1,407
test4sub37of100,test4pub87of100,100,193,11,397,1,409
test4sub90of100,test4pub87of100,100,193,11,400,1,412
test4sub91of100,test4pub87of100,100,193,11,400,0,411
test4sub71of100,test4pub87of100,100,193,11,402,1,414
test4sub5of100,test4pub87of100,100,193,11,403,1,415
test4sub98of100,test4pub87of100,100,193,11,418,1,430
test4sub59of100,test4pub87of100,100,193,11,420,0,431
test4sub93of100,test4pub87of100,100,193,11,421,1,433
test4sub79of100,test4pub87of100,100,193,11,422,0,433
test4sub28of100,test4pub87of100,100,193,11,423,1,435
test4sub8of100,test4pub87of100,100,193,11,428,0,439
test4sub49of100,test4pub87of100,100,193,11,431,0,442
test4sub70of100,test4pub87of100,100,193,11,435,0,446
test4sub89of100,test4pub70of100,100,193,10,6497,0,6507
test4sub89of100,test4pub71of100,100,193,10,6300,1,6311
test4sub95of100,test4pub87of100,100,193,11,453,0,464
test4sub89of100,test4pub72of100,100,193,12,5926,1,5939
test4sub89of100,test4pub73of100,100,193,11,5702,1,5714
test4sub89of100,test4pub74of100,100,193,11,5543,0,5554
test4sub31of100,test4pub87of100,100,193,11,457,1,469
test4sub89of100,test4pub75of100,100,193,14,5322,1,5337
test4sub3of100,test4pub87of100,100,193,11,460,1,472
test4sub89of100,test4pub76of100,100,193,10,4953,0,4963
test4sub89of100,test4pub77of100,100,193,11,4535,1,4547
test4sub89of100,test4pub78of100,100,193,11,3981,0,3992
test4sub58of100,test4pub87of100,100,193,11,471,1,483
test4sub83of100,test4pub79of100,100,193,14,3675,0,3689
test4sub83of100,test4pub80of100,100,193,10,3329,1,3340
test4sub83of100,test4pub81of100,100,193,17,2988,1,3006
test4sub83of100,test4pub82of100,100,193,11,2804,0,2815
test4sub83of100,test4pub83of100,100,193,14,2395,1,2410
test4sub83of100,test4pub84of100,100,193,14,1919,1,1934
test4sub80of100,test4pub87of100,100,193,11,482,2,495
test4sub83of100,test4pub85of100,100,193,10,1679,1,1690
test4sub39of100,test4pub87of100,100,193,11,483,1,495
test4sub26of100,test4pub79of100,100,193,14,3685,1,3700
test4sub83of100,test4pub86of100,100,193,16,1149,1,1166
test4sub26of100,test4pub80of100,100,193,10,3339,0,3349
test4sub26of100,test4pub81of100,100,193,17,2998,1,3016
test4sub26of100,test4pub82of100,100,193,11,2815,1,2827
test4sub26of100,test4pub83of100,100,193,14,2405,0,2419
test4sub26of100,test4pub84of100,100,193,14,1953,1,1968
test4sub65of100,test4pub87of100,100,193,11,516,1,528
test4sub34of100,test4pub79of100,100,193,14,3719,1,3734
test4sub26of100,test4pub85of100,100,193,10,1713,2,1725
test4sub34of100,test4pub80of100,100,193,10,3372,1,3383
test4sub26of100,test4pub86of100,100,193,16,1184,1,1201
test4sub34of100,test4pub81of100,100,193,17,3032,1,3050
test4sub46of100,test4pub78of100,100,193,11,4040,1,4052
test4sub34of100,test4pub82of100,100,193,11,2850,1,2862
test4sub46of100,test4pub79of100,100,193,14,3725,0,3739
test4sub46of100,test4pub80of100,100,193,10,3379,1,3390
test4sub34of100,test4pub83of100,100,193,14,2441,1,2456
test4sub34of100,test4pub84of100,100,193,14,1965,0,1979
test4sub46of100,test4pub81of100,100,193,17,3038,1,3056
test4sub46of100,test4pub82of100,100,193,11,2855,0,2866
test4sub34of100,test4pub85of100,100,193,10,1726,0,1736
test4sub34of100,test4pub86of100,100,193,16,1195,1,1212
test4sub46of100,test4pub83of100,100,193,14,2446,1,2461
test4sub46of100,test4pub84of100,100,193,14,1970,1,1985
test4sub46of100,test4pub85of100,100,193,10,1731,1,1742
test4sub46of100,test4pub86of100,100,193,16,1199,0,1215
test4sub21of100,test4pub40of100,100,193,49,21323,1,21373
test4sub21of100,test4pub41of100,100,193,27,21198,1,21226
test4sub21of100,test4pub42of100,100,193,31,21056,1,21088
test4sub21of100,test4pub43of100,100,193,28,20916,0,20944
test4sub83of100,test4pub87of100,100,193,11,551,1,563
test4sub21of100,test4pub44of100,100,193,17,20770,1,20788
test4sub21of100,test4pub45of100,100,193,20,20642,0,20662
test4sub26of100,test4pub87of100,100,193,11,555,1,567
test4sub21of100,test4pub46of100,100,193,12,20294,0,20306
test4sub21of100,test4pub47of100,100,193,10,19881,1,19892
test4sub21of100,test4pub48of100,100,193,10,19721,0,19731
test4sub21of100,test4pub49of100,100,193,11,19525,1,19537
test4sub21of100,test4pub50of100,100,193,17,19355,1,19373
test4sub34of100,test4pub87of100,100,193,11,563,1,575
test4sub46of100,test4pub87of100,100,193,11,565,0,576
test4sub89of100,test4pub79of100,100,193,14,3791,0,3805
test4sub89of100,test4pub80of100,100,193,10,3444,1,3455
test4sub82of100,test4pub76of100,100,193,10,5087,1,5098
test4sub89of100,test4pub81of100,100,193,17,3105,2,3124
test4sub82of100,test4pub77of100,100,193,11,4668,1,4680
test4sub21of100,test4pub51of100,100,193,16,19219,2,19237
test4sub82of100,test4pub78of100,100,193,11,4115,2,4128
test4sub89of100,test4pub82of100,100,193,11,2922,2,2935
test4sub21of100,test4pub52of100,100,193,10,19076,3,19089
test4sub89of100,test4pub83of100,100,193,14,2514,1,2529
test4sub82of100,test4pub79of100,100,193,14,3800,2,3816
test4sub89of100,test4pub84of100,100,193,14,2039,1,2054
test4sub82of100,test4pub80of100,100,193,10,3455,1,3466
test4sub21of100,test4pub53of100,100,193,10,18710,1,18721
test4sub89of100,test4pub85of100,100,193,10,1800,2,1812
test4sub82of100,test4pub81of100,100,193,17,3116,1,3134
test4sub89of100,test4pub86of100,100,193,16,1269,0,1285
test4sub82of100,test4pub82of100,100,193,11,2932,1,2944
test4sub89of100,test4pub87of100,100,193,11,607,1,619
test4sub82of100,test4pub83of100,100,193,14,2523,0,2537
test4sub82of100,test4pub84of100,100,193,14,2048,1,2063
test4sub82of100,test4pub85of100,100,193,10,1808,1,1819
test4sub82of100,test4pub86of100,100,193,16,1276,0,1292
test4sub82of100,test4pub87of100,100,193,11,614,1,626
test4sub21of100,test4pub54of100,100,193,11,18563,1,18575
test4sub21of100,test4pub55of100,100,193,10,18297,0,18307
test4sub21of100,test4pub56of100,100,193,11,17404,1,17416
test4sub21of100,test4pub57of100,100,193,11,17262,1,17274
test4sub21of100,test4pub58of100,100,193,11,16297,0,16308
test4sub16of100,test4pub87of100,100,193,11,629,1,641
test4sub14of100,test4pub87of100,100,193,11,640,1,652
test4sub21of100,test4pub59of100,100,193,12,15770,1,15783
test4sub21of100,test4pub60of100,100,193,18,15411,0,15429
test4sub21of100,test4pub61of100,100,193,11,14903,1,14915
test4sub21of100,test4pub62of100,100,193,12,14111,0,14123
test4sub21of100,test4pub63of100,100,193,15,12848,1,12864
test4sub21of100,test4pub66of100,100,193,16,10959,0,10975
test4sub21of100,test4pub65of100,100,193,11,10981,0,10992
test4sub21of100,test4pub64of100,100,193,11,12524,2,12537
test4sub22of100,test4pub87of100,100,193,11,659,1,671
test4sub21of100,test4pub67of100,100,193,11,10870,0,10881
test4sub21of100,test4pub68of100,100,193,11,7113,1,7125
test4sub21of100,test4pub69of100,100,193,10,6936,1,6947
test4sub72of100,test4pub87of100,100,193,11,670,1,682
test4sub21of100,test4pub70of100,100,193,10,6719,1,6730
test4sub21of100,test4pub71of100,100,193,10,6521,0,6531
test4sub21of100,test4pub72of100,100,193,12,6147,0,6159
test4sub21of100,test4pub73of100,100,193,11,5923,1,5935
test4sub21of100,test4pub74of100,100,193,11,5764,0,5775
test4sub21of100,test4pub75of100,100,193,14,5542,0,5556
test4sub87of100,test4pub82of100,100,193,11,3052,0,3063
test4sub87of100,test4pub83of100,100,193,14,2642,1,2657
test4sub87of100,test4pub84of100,100,193,14,2167,1,2182
test4sub87of100,test4pub85of100,100,193,10,1927,0,1937
test4sub87of100,test4pub86of100,100,193,16,1396,1,1413
test4sub87of100,test4pub87of100,100,193,11,733,0,744
test4sub21of100,test4pub76of100,100,193,10,5228,0,5238
test4sub21of100,test4pub77of100,100,193,11,4809,1,4821
test4sub21of100,test4pub78of100,100,193,11,4270,1,4282
test4sub21of100,test4pub79of100,100,193,14,3954,0,3968
test4sub21of100,test4pub80of100,100,193,10,3608,1,3619
test4sub21of100,test4pub81of100,100,193,17,3276,0,3293
test4sub43of100,test4pub87of100,100,193,11,766,2,779
test4sub21of100,test4pub82of100,100,193,11,3093,1,3105
test4sub21of100,test4pub83of100,100,193,14,2683,0,2697
test4sub76of100,test4pub87of100,100,193,11,782,1,794
test4sub21of100,test4pub84of100,100,193,14,2226,0,2240
test4sub21of100,test4pub85of100,100,193,10,1987,1,1998
test4sub21of100,test4pub86of100,100,193,16,1455,0,1471
test4sub21of100,test4pub87of100,100,193,11,793,1,805
test4sub68of100,test4pub87of100,100,193,11,800,1,812
test4sub38of100,test4pub86of100,100,193,16,1474,0,1490
test4sub84of100,test4pub87of100,100,193,11,812,1,824
test4sub38of100,test4pub87of100,100,193,11,866,1,878
test4sub23of100,test4pub86of100,100,193,16,1540,1,1557
test4sub63of100,test4pub87of100,100,193,11,877,0,888
test4sub23of100,test4pub87of100,100,193,11,904,1,916
test4sub42of100,test4pub67of100,100,193,11,11166,1,11178
test4sub75of100,test4pub87of100,100,193,11,962,1,974
test4sub42of100,test4pub68of100,100,193,11,7408,2,7421
test4sub55of100,test4pub86of100,100,193,16,1628,2,1646
test4sub86of100,test4pub86of100,100,193,16,1629,1,1646
test4sub42of100,test4pub69of100,100,193,10,7233,1,7244
test4sub42of100,test4pub70of100,100,193,10,7015,0,7025
test4sub42of100,test4pub71of100,100,193,10,6817,1,6828
test4sub54of100,test4pub86of100,100,193,16,1635,1,1652
test4sub42of100,test4pub72of100,100,193,12,6444,1,6457
test4sub42of100,test4pub73of100,100,193,11,6220,0,6231
test4sub42of100,test4pub74of100,100,193,11,6062,1,6074
test4sub42of100,test4pub75of100,100,193,14,5840,0,5854
test4sub42of100,test4pub76of100,100,193,10,5532,0,5542
test4sub42of100,test4pub77of100,100,193,11,5112,1,5124
test4sub42of100,test4pub78of100,100,193,11,4559,1,4571
test4sub42of100,test4pub79of100,100,193,14,4243,1,4258
test4sub42of100,test4pub80of100,100,193,10,3897,1,3908
test4sub51of100,test4pub87of100,100,193,11,1048,1,1060
test4sub55of100,test4pub87of100,100,193,11,1048,1,1060
test4sub86of100,test4pub87of100,100,193,11,1051,1,1063
test4sub54of100,test4pub87of100,100,193,11,1059,1,1071
test4sub42of100,test4pub81of100,100,193,17,3613,1,3631
test4sub42of100,test4pub82of100,100,193,11,3429,0,3440
test4sub42of100,test4pub83of100,100,193,14,3019,0,3033
test4sub42of100,test4pub84of100,100,193,14,2553,1,2568
test4sub42of100,test4pub85of100,100,193,10,2313,0,2323
test4sub42of100,test4pub86of100,100,193,16,1782,1,1799
test4sub42of100,test4pub87of100,100,193,11,1130,1,1142
test4sub40of100,test4pub86of100,100,193,16,1794,1,1811
test4sub96of100,test4pub84of100,100,193,14,2571,1,2586
test4sub96of100,test4pub85of100,100,193,10,2331,1,2342
test4sub67of100,test4pub87of100,100,193,11,1143,1,1155
test4sub40of100,test4pub87of100,100,193,11,1165,0,1176
test4sub96of100,test4pub86of100,100,193,16,1833,1,1850
test4sub96of100,test4pub87of100,100,193,11,1170,0,1181
test4sub52of100,test4pub86of100,100,193,16,1856,0,1872
test4sub60of100,test4pub87of100,100,193,11,1205,0,1216
test4sub15of100,test4pub87of100,100,193,11,1217,1,1229
test4sub13of100,test4pub82of100,100,193,11,3608,1,3620
test4sub13of100,test4pub83of100,100,193,14,3198,1,3213
test4sub13of100,test4pub84of100,100,193,14,2723,1,2738
test4sub13of100,test4pub85of100,100,193,10,2483,0,2493
test4sub13of100,test4pub86of100,100,193,16,1952,1,1969
test4sub17of100,test4pub86of100,100,193,16,1955,0,1971
test4sub13of100,test4pub87of100,100,193,11,1323,1,1335
test4sub17of100,test4pub87of100,100,193,11,1327,1,1339
test4sub52of100,test4pub87of100,100,193,11,1339,1,1351
test4sub88of100,test4pub1of100,100,12977,24,36604,41,36669
test4sub21of100,test4pub88of100,100,193,11,16,11,38
test4sub8of100,test4pub88of100,100,193,11,27,2,40
test4sub88of100,test4pub4of100,100,192,11,35170,2,35183
test4sub88of100,test4pub5of100,100,192,14,34176,1,34191
test4sub88of100,test4pub6of100,100,192,26,33854,0,33880
test4sub49of100,test4pub88of100,100,193,11,33,2,46
test4sub88of100,test4pub7of100,100,192,14,33223,1,33238
test4sub88of100,test4pub8of100,100,192,12,32962,1,32975
test4sub88of100,test4pub9of100,100,192,20,32778,8,32806
test4sub88of100,test4pub10of100,100,193,11,32422,0,32433
test4sub88of100,test4pub11of100,100,193,10,32187,1,32198
test4sub88of100,test4pub12of100,100,193,11,31745,1,31757
test4sub88of100,test4pub13of100,100,193,10,31542,1,31553
test4sub88of100,test4pub14of100,100,193,10,31376,0,31386
test4sub88of100,test4pub15of100,100,193,11,31239,1,31251
test4sub88of100,test4pub16of100,100,193,10,31082,1,31093
test4sub88of100,test4pub17of100,100,193,11,30949,4,30964
test4sub88of100,test4pub18of100,100,193,18,30769,0,30787
test4sub88of100,test4pub19of100,100,193,11,30560,1,30572
test4sub88of100,test4pub20of100,100,193,10,30120,1,30131
test4sub88of100,test4pub21of100,100,193,10,30034,0,30044
test4sub88of100,test4pub22of100,100,193,10,29903,1,29914
test4sub88of100,test4pub23of100,100,193,11,29732,1,29744
test4sub88of100,test4pub24of100,100,193,19,29603,0,29622
test4sub88of100,test4pub25of100,100,193,16,29182,1,29199
test4sub88of100,test4pub26of100,100,193,10,28965,0,28975
test4sub29of100,test4pub87of100,100,193,11,1471,2,1484
test4sub88of100,test4pub27of100,100,193,10,28645,1,28656
test4sub88of100,test4pub28of100,100,193,10,28544,1,28555
test4sub88of100,test4pub29of100,100,193,11,28380,1,28392
test4sub88of100,test4pub30of100,100,193,15,28244,0,28259
test4sub88of100,test4pub31of100,100,193,10,28112,1,28123
test4sub88of100,test4pub32of100,100,193,11,27760,1,27772
test4sub88of100,test4pub33of100,100,193,11,27619,1,27631
test4sub91of100,test4pub88of100,100,193,11,88,2,101
test4sub6of100,test4pub87of100,100,193,11,1482,2,1495
test4sub82of100,test4pub88of100,100,193,11,90,1,102
test4sub88of100,test4pub34of100,100,193,12,26841,2,26855
test4sub88of100,test4pub35of100,100,193,12,24488,0,24500
test4sub34of100,test4pub88of100,100,193,11,93,1,105
test4sub54of100,test4pub88of100,100,193,11,94,2,107
test4sub88of100,test4pub36of100,100,193,10,23214,1,23225
test4sub64of100,test4pub85of100,100,193,10,2685,2,2697
test4sub64of100,test4pub86of100,100,193,16,2154,1,2171
test4sub94of100,test4pub88of100,100,193,11,97,1,109
test4sub88of100,test4pub37of100,100,193,23,22856,1,22880
test4sub83of100,test4pub88of100,100,193,11,102,1,114
test4sub84of100,test4pub88of100,100,193,11,108,1,120
test4sub30of100,test4pub88of100,100,193,11,146,1,158
test4sub13of100,test4pub88of100,100,193,11,148,1,160
test4sub43of100,test4pub88of100,100,193,11,167,1,179
test4sub79of100,test4pub89of100,100,193,11,145,1,157
test4sub5of100,test4pub88of100,100,193,11,174,1,186
test4sub60of100,test4pub88of100,100,193,11,175,0,186
test4sub67of100,test4pub89of100,100,193,11,149,1,161
test4sub21of100,test4pub89of100,100,193,11,151,1,163
test4sub58of100,test4pub88of100,100,193,11,185,1,197
test4sub86of100,test4pub88of100,100,193,11,186,1,198
test4sub23of100,test4pub89of100,100,193,11,159,1,171
test4sub7of100,test4pub89of100,100,193,11,160,0,171
test4sub8of100,test4pub89of100,100,193,11,161,1,173
test4sub16of100,test4pub88of100,100,193,11,191,1,203
test4sub26of100,test4pub89of100,100,193,11,164,0,175
test4sub75of100,test4pub89of100,100,193,11,166,1,178
test4sub88of100,test4pub38of100,100,193,31,22697,0,22728
test4sub17of100,test4pub88of100,100,193,11,199,2,212
test4sub88of100,test4pub39of100,100,193,28,22550,2,22580
test4sub85of100,test4pub87of100,100,193,11,1594,1,1606
test4sub89of100,test4pub88of100,100,193,11,200,2,213
test4sub88of100,test4pub40of100,100,193,49,22372,0,22421
test4sub10of100,test4pub89of100,100,193,11,176,1,188
test4sub88of100,test4pub41of100,100,193,27,22249,2,22278
test4sub68of100,test4pub88of100,100,193,11,205,1,217
test4sub88of100,test4pub42of100,100,193,31,22107,0,22138
test4sub96of100,test4pub89of100,100,193,11,181,1,193
test4sub22of100,test4pub89of100,100,193,11,181,1,193
test4sub48of100,test4pub89of100,100,193,11,182,1,194
test4sub42of100,test4pub89of100,100,193,11,183,0,194
test4sub57of100,test4pub87of100,100,193,11,1606,1,1618
test4sub95of100,test4pub88of100,100,193,11,214,1,226
test4sub57of100,test4pub89of100,100,193,11,187,1,199
test4sub31of100,test4pub89of100,100,193,11,255,1,267
test4sub72of100,test4pub88of100,100,193,11,284,1,296
test4sub70of100,test4pub88of100,100,193,11,287,0,298
test4sub98of100,test4pub89of100,100,193,11,260,2,273
test4sub3of100,test4pub88of100,100,193,11,289,2,302
test4sub90of100,test4pub88of100,100,193,11,289,1,301
test4sub12of100,test4pub87of100,100,193,11,1685,1,1697
test4sub12of100,test4pub89of100,100,193,11,266,1,278
test4sub55of100,test4pub88of100,100,193,11,296,1,308
test4sub65of100,test4pub88of100,100,193,11,297,2,310
test4sub15of100,test4pub89of100,100,193,11,270,2,283
test4sub71of100,test4pub89of100,100,193,11,272,2,285
test4sub76of100,test4pub88of100,100,193,11,299,4,314
test4sub39of100,test4pub88of100,100,193,11,301,3,315
test4sub97of100,test4pub88of100,100,193,11,301,2,314
test4sub80of100,test4pub89of100,100,193,11,275,1,287
test4sub38of100,test4pub88of100,100,193,11,313,0,324
test4sub14of100,test4pub89of100,100,193,11,297,1,309
test4sub37of100,test4pub89of100,100,193,11,298,1,310
test4sub88of100,test4pub43of100,100,193,28,22087,1,22116
test4sub88of100,test4pub44of100,100,193,17,21940,0,21957
test4sub88of100,test4pub45of100,100,193,20,21813,1,21834
test4sub27of100,test4pub86of100,100,193,16,2390,0,2406
test4sub27of100,test4pub87of100,100,193,11,1728,1,1740
test4sub29of100,test4pub89of100,100,193,11,307,2,320
test4sub88of100,test4pub46of100,100,193,12,21468,1,21481
test4sub29of100,test4pub88of100,100,193,11,337,2,350
test4sub91of100,test4pub89of100,100,193,11,310,2,323
test4sub6of100,test4pub89of100,100,193,11,310,3,324
test4sub88of100,test4pub47of100,100,193,10,21055,4,21069
test4sub46of100,test4pub88of100,100,193,11,339,4,354
test4sub63of100,test4pub88of100,100,193,11,341,3,355
test4sub82of100,test4pub89of100,100,193,11,314,3,328
test4sub6of100,test4pub88of100,100,193,11,343,3,357
test4sub88of100,test4pub48of100,100,193,10,20900,1,20911
test4sub52of100,test4pub88of100,100,193,11,392,1,404
test4sub52of100,test4pub89of100,100,193,11,365,0,376
test4sub64of100,test4pub87of100,100,193,11,1788,1,1800
test4sub64of100,test4pub88of100,100,193,11,396,0,407
test4sub69of100,test4pub65of100,100,193,11,12117,1,12129
test4sub69of100,test4pub66of100,100,193,16,12098,0,12114
test4sub69of100,test4pub67of100,100,193,11,11999,1,12011
test4sub69of100,test4pub68of100,100,193,11,8242,1,8254
test4sub69of100,test4pub69of100,100,193,10,8064,0,8074
test4sub69of100,test4pub70of100,100,193,10,7847,1,7858
test4sub69of100,test4pub71of100,100,193,10,7649,1,7660
test4sub69of100,test4pub72of100,100,193,12,7275,0,7287
test4sub69of100,test4pub73of100,100,193,11,7051,1,7063
test4sub69of100,test4pub74of100,100,193,11,6892,1,6904
test4sub69of100,test4pub75of100,100,193,14,6670,0,6684
test4sub51of100,test4pub88of100,100,193,11,434,1,446
test4sub94of100,test4pub89of100,100,193,11,406,1,418
test4sub40of100,test4pub89of100,100,193,11,413,0,424
test4sub54of100,test4pub89of100,100,193,11,415,0,426
test4sub83of100,test4pub89of100,100,193,11,416,1,428
test4sub87of100,test4pub88of100,100,193,11,452,0,463
test4sub59of100,test4pub89of100,100,193,11,429,0,440
test4sub49of100,test4pub89of100,100,193,11,434,1,446
test4sub84of100,test4pub89of100,100,193,11,436,1,448
test4sub93of100,test4pub88of100,100,193,11,466,1,478
test4sub34of100,test4pub89of100,100,193,11,440,0,451
test4sub30of100,test4pub89of100,100,193,11,445,1,457
test4sub13of100,test4pub89of100,100,193,11,446,0,457
test4sub28of100,test4pub89of100,100,193,11,448,1,460
test4sub28of100,test4pub88of100,100,193,11,478,1,490
test4sub43of100,test4pub89of100,100,193,11,470,0,481
test4sub79of100,test4pub88of100,100,193,11,501,1,513
test4sub5of100,test4pub89of100,100,193,11,474,1,486
test4sub60of100,test4pub89of100,100,193,11,476,0,487
test4sub67of100,test4pub88of100,100,193,11,507,0,518
test4sub33of100,test4pub89of100,100,193,11,481,1,493
test4sub33of100,test4pub88of100,100,193,11,510,2,523
test4sub58of100,test4pub89of100,100,193,11,483,1,495
test4sub86of100,test4pub89of100,100,193,11,485,1,497
test4sub23of100,test4pub88of100,100,193,11,518,0,529
test4sub7of100,test4pub88of100,100,193,11,520,0,531
test4sub8of100,test4pub90of100,100,193,11,335,1,347
test4sub16of100,test4pub89of100,100,193,11,495,2,508
test4sub26of100,test4pub88of100,100,193,11,523,2,536
test4sub75of100,test4pub88of100,100,193,11,524,1,536
test4sub16of100,test4pub90of100,100,193,11,340,2,353
test4sub88of100,test4pub49of100,100,193,11,20886,2,20899
test4sub17of100,test4pub89of100,100,193,11,499,2,512
test4sub89of100,test4pub89of100,100,193,11,500,2,513
test4sub85of100,test4pub89of100,100,193,11,502,1,514
test4sub88of100,test4pub50of100,100,193,17,20717,3,20737
test4sub92of100,test4pub89of100,100,193,11,504,3,518
test4sub85of100,test4pub88of100,100,193,11,532,2,545
test4sub73of100,test4pub89of100,100,193,11,505,2,518
test4sub88of100,test4pub51of100,100,193,16,20551,3,20570
test4sub92of100,test4pub88of100,100,193,11,535,2,548
test4sub73of100,test4pub88of100,100,193,11,536,1,548
test4sub88of100,test4pub52of100,100,193,10,20410,0,20420
test4sub88of100,test4pub53of100,100,193,10,20043,1,20054
test4sub10of100,test4pub88of100,100,193,11,551,1,563
test4sub68of100,test4pub89of100,100,193,11,524,1,536
test4sub68of100,test4pub90of100,100,193,11,367,1,379
test4sub62of100,test4pub88of100,100,193,11,554,1,566
test4sub62of100,test4pub89of100,100,193,11,528,2,541
test4sub77of100,test4pub89of100,100,193,11,528,1,540
test4sub96of100,test4pub88of100,100,193,11,558,1,570
test4sub77of100,test4pub88of100,100,193,11,559,2,572
test4sub96of100,test4pub90of100,100,193,11,373,1,385
test4sub22of100,test4pub88of100,100,193,11,570,1,582
test4sub22of100,test4pub90of100,100,193,11,385,0,396
test4sub48of100,test4pub88of100,100,193,11,594,1,606
test4sub42of100,test4pub88of100,100,193,11,597,1,609
test4sub42of100,test4pub90of100,100,193,11,412,0,423
test4sub57of100,test4pub88of100,100,193,11,610,2,623
test4sub57of100,test4pub90of100,100,193,11,436,1,448
test4sub21of100,test4pub90of100,100,193,11,434,4,449
test4sub95of100,test4pub89of100,100,193,11,596,1,608
test4sub95of100,test4pub90of100,100,193,11,439,0,450
test4sub31of100,test4pub88of100,100,193,11,627,1,639
test4sub31of100,test4pub90of100,100,193,11,443,1,455
test4sub47of100,test4pub86of100,100,193,16,2688,1,2705
test4sub72of100,test4pub89of100,100,193,11,604,1,616
test4sub47of100,test4pub87of100,100,193,11,2026,1,2038
test4sub72of100,test4pub90of100,100,193,11,448,2,461
test4sub47of100,test4pub89of100,100,193,11,606,1,618
test4sub66of100,test4pub88of100,100,193,11,636,0,647
test4sub66of100,test4pub89of100,100,193,11,610,1,622
test4sub70of100,test4pub89of100,100,193,11,622,0,633
test4sub70of100,test4pub90of100,100,193,11,465,1,477
test4sub98of100,test4pub88of100,100,193,11,652,1,664
test4sub98of100,test4pub90of100,100,193,11,468,1,480
test4sub3of100,test4pub89of100,100,193,11,630,1,642
test4sub3of100,test4pub90of100,100,193,11,473,1,485
test4sub90of100,test4pub89of100,100,193,11,632,2,645
test4sub12of100,test4pub88of100,100,193,11,661,0,672
test4sub90of100,test4pub90of100,100,193,11,476,1,488
test4sub12of100,test4pub90of100,100,193,11,477,2,490
test4sub55of100,test4pub89of100,100,193,11,636,2,649
test4sub65of100,test4pub89of100,100,193,11,637,1,649
test4sub55of100,test4pub90of100,100,193,11,480,3,494
test4sub15of100,test4pub88of100,100,193,11,666,3,680
test4sub65of100,test4pub90of100,100,193,11,481,2,494
test4sub76of100,test4pub89of100,100,193,11,639,3,653
test4sub71of100,test4pub88of100,100,193,11,669,4,684
test4sub15of100,test4pub90of100,100,193,11,484,2,497
test4sub39of100,test4pub89of100,100,193,11,643,1,655
test4sub76of100,test4pub90of100,100,193,11,485,2,498
test4sub71of100,test4pub90of100,100,193,11,487,2,500
test4sub39of100,test4pub90of100,100,193,11,488,3,502
test4sub97of100,test4pub89of100,100,193,11,647,2,660
test4sub80of100,test4pub88of100,100,193,11,676,2,689
test4sub97of100,test4pub90of100,100,193,11,491,1,503
test4sub38of100,test4pub89of100,100,193,11,650,1,662
test4sub80of100,test4pub90of100,100,193,11,493,1,505
test4sub38of100,test4pub90of100,100,193,11,494,1,506
test4sub14of100,test4pub88of100,100,193,11,685,1,697
test4sub14of100,test4pub90of100,100,193,11,500,1,512
test4sub37of100,test4pub88of100,100,193,11,687,1,699
test4sub88of100,test4pub54of100,100,193,11,20024,0,20035
test4sub37of100,test4pub90of100,100,193,11,502,1,514
test4sub88of100,test4pub55of100,100,193,10,19758,1,19769
test4sub27of100,test4pub88of100,100,193,11,691,0,702
test4sub29of100,test4pub90of100,100,193,11,506,1,518
test4sub27of100,test4pub89of100,100,193,11,665,2,678
test4sub88of100,test4pub56of100,100,193,11,18866,1,18878
test4sub91of100,test4pub90of100,100,193,11,507,3,521
test4sub88of100,test4pub57of100,100,193,11,18726,1,18738
test4sub6of100,test4pub90of100,100,193,11,510,2,523
test4sub27of100,test4pub90of100,100,193,11,509,1,521
test4sub88of100,test4pub58of100,100,193,11,17762,0,17773
test4sub88of100,test4pub59of100,100,193,12,17214,0,17226
test4sub46of100,test4pub89of100,100,193,11,676,1,688
test4sub63of100,test4pub89of100,100,193,11,678,0,689
test4sub46of100,test4pub90of100,100,193,11,519,1,531
test4sub82of100,test4pub90of100,100,193,11,522,1,534
test4sub63of100,test4pub90of100,100,193,11,522,1,534
test4sub88of100,test4pub60of100,100,193,18,16864,1,16883
test4sub64of100,test4pub89of100,100,193,11,684,1,696
test4sub88of100,test4pub61of100,100,193,11,16356,1,16368
test4sub88of100,test4pub62of100,100,193,12,15565,1,15578
test4sub64of100,test4pub90of100,100,193,11,527,1,539
test4sub69of100,test4pub76of100,100,193,10,6627,1,6638
test4sub69of100,test4pub77of100,100,193,11,6207,0,6218
test4sub69of100,test4pub78of100,100,193,11,5654,0,5665
test4sub69of100,test4pub79of100,100,193,14,5339,1,5354
test4sub32of100,test4pub88of100,100,193,11,746,2,759
test4sub69of100,test4pub80of100,100,193,10,4993,1,5004
test4sub32of100,test4pub89of100,100,193,11,720,1,732
test4sub32of100,test4pub90of100,100,193,11,564,1,576
test4sub51of100,test4pub89of100,100,193,11,722,1,734
test4sub51of100,test4pub90of100,100,193,11,566,1,578
test4sub94of100,test4pub90of100,100,193,11,568,0,579
test4sub40of100,test4pub88of100,100,193,11,767,1,779
test4sub74of100,test4pub67of100,100,193,11,12366,0,12377
test4sub40of100,test4pub90of100,100,193,11,582,1,594
test4sub74of100,test4pub68of100,100,193,11,8608,1,8620
test4sub74of100,test4pub69of100,100,193,10,8430,0,8440
test4sub54of100,test4pub90of100,100,193,11,589,1,601
test4sub83of100,test4pub90of100,100,193,11,590,0,601
test4sub87of100,test4pub89of100,100,193,11,757,1,769
test4sub87of100,test4pub90of100,100,193,11,600,1,612
test4sub59of100,test4pub88of100,100,193,11,787,0,798
test4sub59of100,test4pub90of100,100,193,11,603,0,614
test4sub49of100,test4pub90of100,100,193,11,605,2,618
test4sub84of100,test4pub90of100,100,193,11,606,2,619
test4sub93of100,test4pub89of100,100,193,11,765,0,776
test4sub93of100,test4pub90of100,100,193,11,608,1,620
test4sub34of100,test4pub90of100,100,193,11,648,1,660
test4sub13of100,test4pub90of100,100,193,11,649,0,660
test4sub28of100,test4pub90of100,100,193,11,650,1,662
test4sub20of100,test4pub88of100,100,193,11,840,0,851
test4sub20of100,test4pub89of100,100,193,11,814,1,826
test4sub43of100,test4pub90of100,100,193,11,657,2,670
test4sub79of100,test4pub90of100,100,193,11,657,1,669
test4sub20of100,test4pub90of100,100,193,11,658,1,670
test4sub23of100,test4pub90of100,100,193,11,669,1,681
test4sub23of100,test4pub91of100,100,193,11,336,0,347
test4sub7of100,test4pub90of100,100,193,11,672,0,683
test4sub16of100,test4pub91of100,100,193,11,339,1,351
test4sub7of100,test4pub91of100,100,193,11,340,1,352
test4sub26of100,test4pub90of100,100,193,11,675,0,686
test4sub26of100,test4pub91of100,100,193,11,343,2,356
test4sub85of100,test4pub90of100,100,193,11,677,3,691
test4sub92of100,test4pub90of100,100,193,11,678,2,691
test4sub10of100,test4pub90of100,100,193,11,679,3,693
test4sub92of100,test4pub91of100,100,193,11,346,3,360
test4sub85of100,test4pub91of100,100,193,11,346,5,362
test4sub68of100,test4pub91of100,100,193,11,347,4,362
test4sub42of100,test4pub91of100,100,193,11,348,3,362
test4sub10of100,test4pub91of100,100,193,11,349,3,363
test4sub31of100,test4pub91of100,100,193,11,349,3,363
test4sub47of100,test4pub88of100,100,193,11,871,2,884
test4sub47of100,test4pub90of100,100,193,11,687,1,699
test4sub9of100,test4pub83of100,100,193,14,4183,2,4199
test4sub47of100,test4pub91of100,100,193,11,355,1,367
test4sub72of100,test4pub91of100,100,193,11,356,2,369
test4sub9of100,test4pub84of100,100,193,14,3708,1,3723
test4sub9of100,test4pub85of100,100,193,10,3468,1,3479
test4sub66of100,test4pub90of100,100,193,11,693,1,705
test4sub9of100,test4pub86of100,100,193,16,2937,1,2954
test4sub66of100,test4pub91of100,100,193,11,361,1,373
test4sub70of100,test4pub91of100,100,193,11,361,1,373
test4sub3of100,test4pub91of100,100,193,11,363,1,375
test4sub9of100,test4pub87of100,100,193,11,2276,1,2288
test4sub90of100,test4pub91of100,100,193,11,365,1,377
test4sub9of100,test4pub89of100,100,193,11,857,2,870
test4sub12of100,test4pub91of100,100,193,11,366,2,379
test4sub55of100,test4pub91of100,100,193,11,367,1,379
test4sub65of100,test4pub91of100,100,193,11,369,1,381
test4sub15of100,test4pub91of100,100,193,11,370,1,382
test4sub76of100,test4pub91of100,100,193,11,371,0,382
test4sub71of100,test4pub91of100,100,193,11,376,1,388
test4sub39of100,test4pub91of100,100,193,11,377,0,388
test4sub97of100,test4pub91of100,100,193,11,394,1,406
test4sub80of100,test4pub91of100,100,193,11,394,1,406
test4sub38of100,test4pub91of100,100,193,11,397,1,409
test4sub14of100,test4pub91of100,100,193,11,398,1,410
test4sub37of100,test4pub91of100,100,193,11,400,1,412
test4sub27of100,test4pub91of100,100,193,11,415,1,427
test4sub29of100,test4pub91of100,100,193,11,417,1,429
test4sub91of100,test4pub91of100,100,193,11,418,1,430
test4sub21of100,test4pub91of100,100,193,11,424,1,436
test4sub34of100,test4pub91of100,100,193,11,446,1,458
test4sub43of100,test4pub91of100,100,193,11,468,1,480
test4sub79of100,test4pub91of100,100,193,11,469,1,481
test4sub9of100,test4pub88of100,100,193,11,1005,1,1017
test4sub9of100,test4pub90of100,100,193,11,821,1,833
test4sub9of100,test4pub91of100,100,193,11,488,0,499
test4sub71of100,test4pub92of100,100,193,10,145,1,156
test4sub72of100,test4pub92of100,100,193,10,150,1,161
test4sub39of100,test4pub92of100,100,193,10,157,1,168
test4sub38of100,test4pub92of100,100,193,10,159,1,170
test4sub37of100,test4pub92of100,100,193,10,160,2,172
test4sub70of100,test4pub92of100,100,193,10,161,1,172
test4sub90of100,test4pub92of100,100,193,10,168,0,178
test4sub91of100,test4pub92of100,100,193,10,168,1,179
test4sub68of100,test4pub92of100,100,193,10,169,1,180
test4sub29of100,test4pub92of100,100,193,10,175,1,186
test4sub15of100,test4pub92of100,100,193,10,184,1,195
test4sub10of100,test4pub92of100,100,193,10,186,1,197
test4sub16of100,test4pub92of100,100,193,10,191,1,202
test4sub66of100,test4pub92of100,100,193,10,199,2,211
test4sub55of100,test4pub92of100,100,193,10,200,2,212
test4sub7of100,test4pub92of100,100,193,10,201,1,212
test4sub85of100,test4pub92of100,100,193,10,203,3,216
test4sub79of100,test4pub92of100,100,193,10,208,1,219
test4sub97of100,test4pub92of100,100,193,10,210,1,221
test4sub14of100,test4pub92of100,100,193,10,211,0,221
test4sub3of100,test4pub92of100,100,193,10,224,1,235
test4sub31of100,test4pub92of100,100,193,10,231,1,242
test4sub26of100,test4pub92of100,100,193,10,231,1,242
test4sub47of100,test4pub92of100,100,193,10,233,1,244
test4sub9of100,test4pub92of100,100,193,10,452,1,463
test4sub76of100,test4pub92of100,100,193,10,501,0,511
test4sub23of100,test4pub92of100,100,193,10,504,1,515
test4sub42of100,test4pub92of100,100,193,10,505,1,516
test4sub43of100,test4pub92of100,100,193,10,517,0,527
test4sub54of100,test4pub91of100,100,193,11,902,1,914
test4sub54of100,test4pub92of100,100,193,10,522,1,533
test4sub12of100,test4pub92of100,100,193,10,524,1,535
test4sub41of100,test4pub83of100,100,193,14,4735,1,4750
test4sub41of100,test4pub84of100,100,193,14,4259,0,4273
test4sub41of100,test4pub85of100,100,193,10,4020,2,4032
test4sub92of100,test4pub92of100,100,193,10,529,1,540
test4sub65of100,test4pub93of100,100,193,10,418,1,429
test4sub80of100,test4pub92of100,100,193,10,532,1,543
test4sub71of100,test4pub93of100,100,193,10,423,0,433
test4sub13of100,test4pub91of100,100,193,11,920,1,932
test4sub13of100,test4pub92of100,100,193,10,539,0,549
test4sub63of100,test4pub91of100,100,193,11,922,1,934
test4sub63of100,test4pub92of100,100,193,10,541,0,551
test4sub72of100,test4pub93of100,100,193,10,431,1,442
test4sub40of100,test4pub91of100,100,193,11,957,1,969
test4sub40of100,test4pub92of100,100,193,10,577,1,588
test4sub59of100,test4pub91of100,100,193,11,968,1,980
test4sub39of100,test4pub93of100,100,193,10,475,1,486
test4sub59of100,test4pub92of100,100,193,10,588,1,599
test4sub37of100,test4pub93of100,100,193,10,489,1,500
test4sub70of100,test4pub93of100,100,193,10,501,1,512
test4sub91of100,test4pub93of100,100,193,10,506,1,517
test4sub68of100,test4pub93of100,100,193,10,508,1,519
test4sub29of100,test4pub93of100,100,193,10,509,1,520
test4sub15of100,test4pub93of100,100,193,10,510,0,520
test4sub10of100,test4pub93of100,100,193,10,511,1,522
test4sub21of100,test4pub92of100,100,193,10,625,0,635
test4sub21of100,test4pub93of100,100,193,10,514,1,525
test4sub16of100,test4pub93of100,100,193,10,515,0,525
test4sub66of100,test4pub93of100,100,193,10,518,1,529
test4sub28of100,test4pub91of100,100,193,11,1017,1,1029
test4sub28of100,test4pub92of100,100,193,10,636,1,647
test4sub38of100,test4pub93of100,100,193,10,581,0,591
test4sub55of100,test4pub93of100,100,193,10,584,3,597
test4sub7of100,test4pub93of100,100,193,10,584,3,597
test4sub85of100,test4pub93of100,100,193,10,586,2,598
test4sub79of100,test4pub93of100,100,193,10,586,3,599
test4sub97of100,test4pub93of100,100,193,10,587,3,600
test4sub51of100,test4pub91of100,100,193,11,1084,1,1096
test4sub51of100,test4pub92of100,100,193,10,705,1,716
test4sub87of100,test4pub91of100,100,193,11,1087,2,1100
test4sub87of100,test4pub92of100,100,193,10,707,1,718
test4sub14of100,test4pub93of100,100,193,10,596,1,607
test4sub3of100,test4pub93of100,100,193,10,597,0,607
test4sub94of100,test4pub91of100,100,193,11,1104,1,1116
test4sub94of100,test4pub92of100,100,193,10,724,0,734
test4sub83of100,test4pub91of100,100,193,11,1106,1,1118
test4sub83of100,test4pub92of100,100,193,10,726,1,737
test4sub90of100,test4pub93of100,100,193,10,615,1,626
test4sub31of100,test4pub93of100,100,193,10,615,0,625
test4sub26of100,test4pub93of100,100,193,10,621,1,632
test4sub47of100,test4pub93of100,100,193,10,623,0,633
test4sub9of100,test4pub93of100,100,193,10,624,1,635
test4sub76of100,test4pub93of100,100,193,10,635,0,645
test4sub23of100,test4pub93of100,100,193,10,642,1,653
test4sub42of100,test4pub93of100,100,193,10,648,1,659
test4sub43of100,test4pub93of100,100,193,10,651,0,661
test4sub54of100,test4pub93of100,100,193,10,651,1,662
test4sub12of100,test4pub93of100,100,193,10,654,0,664
test4sub41of100,test4pub86of100,100,193,16,3728,1,3745
test4sub41of100,test4pub87of100,100,193,11,3065,1,3077
test4sub41of100,test4pub88of100,100,193,11,1673,0,1684
test4sub41of100,test4pub89of100,100,193,11,1657,1,1669
test4sub92of100,test4pub93of100,100,193,10,671,1,682
test4sub41of100,test4pub90of100,100,193,11,1501,1,1513
test4sub41of100,test4pub91of100,100,193,11,1169,1,1181
test4sub65of100,test4pub92of100,100,193,10,792,1,803
test4sub80of100,test4pub93of100,100,193,10,680,1,691
test4sub71of100,test4pub94of100,100,193,11,268,0,279
test4sub13of100,test4pub93of100,100,193,10,690,0,700
test4sub63of100,test4pub93of100,100,193,10,730,1,741
test4sub34of100,test4pub92of100,100,193,10,869,0,879
test4sub91of100,test4pub94of100,100,193,11,339,1,351
test4sub34of100,test4pub93of100,100,193,10,758,1,769
test4sub86of100,test4pub90of100,100,193,11,1602,1,1614
test4sub86of100,test4pub91of100,100,193,11,1269,1,1281
test4sub8of100,test4pub91of100,100,193,11,1270,1,1282
test4sub86of100,test4pub92of100,100,193,10,889,1,900
test4sub29of100,test4pub94of100,100,193,11,361,0,372
test4sub66of100,test4pub94of100,100,193,11,365,1,377
test4sub30of100,test4pub90of100,100,193,11,1612,1,1624
test4sub38of100,test4pub94of100,100,193,11,367,1,379
test4sub30of100,test4pub91of100,100,193,11,1280,1,1292
test4sub33of100,test4pub90of100,100,193,11,1615,1,1627
test4sub30of100,test4pub92of100,100,193,10,899,0,909
test4sub33of100,test4pub91of100,100,193,11,1282,1,1294
test4sub55of100,test4pub94of100,100,193,11,371,0,382
test4sub33of100,test4pub92of100,100,193,10,903,1,914
test4sub7of100,test4pub94of100,100,193,11,373,1,385
test4sub79of100,test4pub94of100,100,193,11,374,2,387
test4sub58of100,test4pub90of100,100,193,11,1622,1,1634
test4sub97of100,test4pub94of100,100,193,11,377,1,389
test4sub58of100,test4pub91of100,100,193,11,1290,3,1304
test4sub51of100,test4pub93of100,100,193,10,795,3,808
test4sub87of100,test4pub93of100,100,193,10,796,2,808
test4sub96of100,test4pub91of100,100,193,11,1292,3,1306
test4sub95of100,test4pub91of100,100,193,11,1292,3,1306
test4sub51of100,test4pub94of100,100,193,11,382,3,396
test4sub87of100,test4pub94of100,100,193,11,382,3,396
test4sub96of100,test4pub92of100,100,193,10,914,2,926
test4sub3of100,test4pub94of100,100,193,11,384,2,397
test4sub94of100,test4pub93of100,100,193,10,804,2,816
test4sub96of100,test4pub93of100,100,193,10,805,2,817
test4sub83of100,test4pub93of100,100,193,10,805,3,818
test4sub90of100,test4pub94of100,100,193,11,389,2,402
test4sub94of100,test4pub94of100,100,193,11,390,2,403
test4sub83of100,test4pub94of100,100,193,11,391,1,403
test4sub31of100,test4pub94of100,100,193,11,391,1,403
test4sub26of100,test4pub94of100,100,193,11,393,1,405
test4sub47of100,test4pub94of100,100,193,11,399,0,410
test4sub9of100,test4pub94of100,100,193,11,404,1,416
test4sub76of100,test4pub94of100,100,193,11,404,1,416
test4sub23of100,test4pub94of100,100,193,11,405,0,416
test4sub54of100,test4pub94of100,100,193,11,407,0,418
test4sub41of100,test4pub92of100,100,193,10,938,1,949
test4sub21of100,test4pub94of100,100,193,11,409,1,421
test4sub92of100,test4pub94of100,100,193,11,410,1,422
test4sub41of100,test4pub93of100,100,193,10,827,1,838
test4sub41of100,test4pub94of100,100,193,11,412,0,423
test4sub60of100,test4pub90of100,100,193,11,1667,1,1679
test4sub17of100,test4pub90of100,100,193,11,1668,1,1680
test4sub60of100,test4pub91of100,100,193,11,1335,1,1347
test4sub17of100,test4pub91of100,100,193,11,1336,1,1348
test4sub60of100,test4pub92of100,100,193,10,955,1,966
test4sub17of100,test4pub92of100,100,193,10,956,1,967
test4sub17of100,test4pub93of100,100,193,10,844,0,854
test4sub98of100,test4pub91of100,100,193,11,1349,1,1361
test4sub98of100,test4pub92of100,100,193,10,968,1,979
test4sub98of100,test4pub93of100,100,193,10,856,0,866
test4sub63of100,test4pub94of100,100,193,11,454,1,466
test4sub52of100,test4pub90of100,100,193,11,1703,0,1714
test4sub67of100,test4pub90of100,100,193,11,1704,1,1716
test4sub52of100,test4pub91of100,100,193,11,1371,1,1383
test4sub67of100,test4pub91of100,100,193,11,1372,1,1384
test4sub52of100,test4pub92of100,100,193,10,990,1,1001
test4sub34of100,test4pub94of100,100,193,11,461,3,475
test4sub67of100,test4pub92of100,100,193,10,992,1,1003
test4sub52of100,test4pub93of100,100,193,10,880,2,892
test4sub93of100,test4pub91of100,100,193,11,1381,1,1393
test4sub86of100,test4pub93of100,100,193,10,887,1,898
test4sub86of100,test4pub94of100,100,193,11,472,1,484
test4sub77of100,test4pub90of100,100,193,11,1719,0,1730
test4sub77of100,test4pub91of100,100,193,11,1386,1,1398
test4sub77of100,test4pub92of100,100,193,10,1006,0,1016
test4sub77of100,test4pub93of100,100,193,10,894,0,904
test4sub30of100,test4pub93of100,100,193,10,902,1,913
test4sub48of100,test4pub90of100,100,193,11,1732,0,1743
test4sub30of100,test4pub94of100,100,193,11,486,2,499
test4sub33of100,test4pub93of100,100,193,10,904,1,915
test4sub48of100,test4pub91of100,100,193,11,1400,1,1412
test4sub33of100,test4pub94of100,100,193,11,489,1,501
test4sub60of100,test4pub93of100,100,193,10,925,1,936
test4sub17of100,test4pub94of100,100,193,11,508,0,519
test4sub60of100,test4pub94of100,100,193,11,509,1,521
test4sub84of100,test4pub91of100,100,193,11,1422,0,1433
test4sub84of100,test4pub92of100,100,193,10,1041,1,1052
test4sub20of100,test4pub91of100,100,193,11,1424,0,1435
test4sub84of100,test4pub93of100,100,193,10,930,2,942
test4sub20of100,test4pub92of100,100,193,10,1044,2,1056
test4sub98of100,test4pub94of100,100,193,11,514,3,528
test4sub62of100,test4pub90of100,100,193,11,1762,2,1775
test4sub20of100,test4pub93of100,100,193,10,934,1,945
test4sub62of100,test4pub91of100,100,193,11,1430,1,1442
test4sub20of100,test4pub94of100,100,193,11,519,1,531
test4sub52of100,test4pub94of100,100,193,11,520,1,532
test4sub62of100,test4pub92of100,100,193,10,1050,1,1061
test4sub67of100,test4pub93of100,100,193,10,939,1,950
test4sub62of100,test4pub93of100,100,193,10,939,1,950
test4sub67of100,test4pub94of100,100,193,11,524,0,535
test4sub8of100,test4pub92of100,100,193,10,1071,1,1082
test4sub8of100,test4pub93of100,100,193,10,959,0,969
test4sub77of100,test4pub94of100,100,193,11,542,1,554
test4sub8of100,test4pub94of100,100,193,11,544,1,556
test4sub58of100,test4pub92of100,100,193,10,1076,0,1086
test4sub58of100,test4pub93of100,100,193,10,964,0,974
test4sub58of100,test4pub94of100,100,193,11,549,1,561
test4sub84of100,test4pub94of100,100,193,11,566,0,577
test4sub62of100,test4pub94of100,100,193,11,568,0,579
test4sub49of100,test4pub91of100,100,193,11,1484,0,1495
test4sub93of100,test4pub92of100,100,193,10,1110,0,1120
test4sub93of100,test4pub93of100,100,193,10,999,1,1010
test4sub93of100,test4pub94of100,100,193,11,583,1,595
test4sub6of100,test4pub91of100,100,193,11,1500,1,1512
test4sub6of100,test4pub92of100,100,193,10,1119,1,1130
test4sub48of100,test4pub92of100,100,193,10,1120,0,1130
test4sub6of100,test4pub93of100,100,193,10,1008,1,1019
test4sub48of100,test4pub93of100,100,193,10,1009,1,1020
test4sub48of100,test4pub94of100,100,193,11,593,1,605
test4sub6of100,test4pub94of100,100,193,11,631,1,643
test4sub4of100,test4pub86of100,100,193,16,4126,0,4142
test4sub4of100,test4pub87of100,100,193,11,3463,0,3474
test4sub4of100,test4pub89of100,100,193,11,2044,1,2056
test4sub4of100,test4pub88of100,100,193,11,2073,0,2084
test4sub4of100,test4pub90of100,100,193,11,1888,1,1900
test4sub4of100,test4pub91of100,100,193,11,1556,1,1568
test4sub73of100,test4pub90of100,100,193,11,1891,1,1903
test4sub98of100,test4pub95of100,100,193,11,374,1,386
test4sub73of100,test4pub91of100,100,193,11,1559,1,1571
test4sub73of100,test4pub92of100,100,193,10,1179,1,1190
test4sub73of100,test4pub93of100,100,193,10,1067,0,1077
test4sub52of100,test4pub95of100,100,193,11,383,0,394
test4sub93of100,test4pub95of100,100,193,11,396,1,408
test4sub9of100,test4pub95of100,100,193,11,404,0,415
test4sub7of100,test4pub95of100,100,193,11,407,1,419
test4sub49of100,test4pub92of100,100,193,10,1209,0,1219
test4sub21of100,test4pub95of100,100,193,11,409,1,421
test4sub49of100,test4pub93of100,100,193,10,1098,1,1109
test4sub49of100,test4pub94of100,100,193,11,682,0,693
test4sub30of100,test4pub95of100,100,193,11,417,0,428
test4sub66of100,test4pub95of100,100,193,11,419,1,431
test4sub34of100,test4pub95of100,100,193,11,430,1,442
test4sub17of100,test4pub95of100,100,193,11,431,1,443
test4sub67of100,test4pub95of100,100,193,11,432,1,444
test4sub76of100,test4pub95of100,100,193,11,433,1,445
test4sub92of100,test4pub95of100,100,193,11,435,1,447
test4sub84of100,test4pub95of100,100,193,11,435,0,446
test4sub58of100,test4pub95of100,100,193,11,441,1,453
test4sub54of100,test4pub95of100,100,193,11,442,0,453
test4sub48of100,test4pub95of100,100,193,11,443,1,455
test4sub63of100,test4pub95of100,100,193,11,448,1,460
test4sub62of100,test4pub95of100,100,193,11,448,1,460
test4sub29of100,test4pub95of100,100,193,11,450,1,462
test4sub33of100,test4pub95of100,100,193,11,452,1,464
test4sub86of100,test4pub95of100,100,193,11,482,0,493
test4sub6of100,test4pub95of100,100,193,11,482,1,494
test4sub4of100,test4pub92of100,100,193,10,1292,0,1302
test4sub4of100,test4pub93of100,100,193,10,1181,1,1192
test4sub4of100,test4pub94of100,100,193,11,765,1,777
test4sub4of100,test4pub95of100,100,193,11,498,1,510
test4sub23of100,test4pub95of100,100,193,11,499,2,512
test4sub20of100,test4pub95of100,100,193,11,499,1,511
test4sub97of100,test4pub95of100,100,193,11,503,1,515
test4sub8of100,test4pub95of100,100,193,11,507,0,518
test4sub79of100,test4pub95of100,100,193,11,508,0,519
test4sub64of100,test4pub91of100,100,193,11,1695,1,1707
test4sub64of100,test4pub93of100,100,193,10,1201,0,1211
test4sub64of100,test4pub92of100,100,193,10,1315,0,1325
test4sub73of100,test4pub94of100,100,193,11,791,1,803
test4sub77of100,test4pub95of100,100,193,11,521,2,534
test4sub73of100,test4pub95of100,100,193,11,521,1,533
test4sub38of100,test4pub95of100,100,193,11,524,1,536
test4sub60of100,test4pub95of100,100,193,11,529,1,541
test4sub98of100,test4pub96of100,100,193,11,143,1,155
test4sub41of100,test4pub95of100,100,193,11,533,1,545
test4sub9of100,test4pub96of100,100,193,11,148,1,160
test4sub55of100,test4pub95of100,100,193,11,538,1,550
test4sub7of100,test4pub96of100,100,193,11,152,0,163
test4sub34of100,test4pub96of100,100,193,11,154,1,166
test4sub49of100,test4pub95of100,100,193,11,540,3,554
test4sub17of100,test4pub96of100,100,193,11,155,2,168
test4sub67of100,test4pub96of100,100,193,11,155,1,167
test4sub66of100,test4pub96of100,100,193,11,160,0,171
test4sub84of100,test4pub96of100,100,193,11,163,1,175
test4sub54of100,test4pub96of100,100,193,11,169,1,181
test4sub57of100,test4pub91of100,100,193,11,1739,0,1750
test4sub57of100,test4pub92of100,100,193,10,1359,1,1370
test4sub93of100,test4pub96of100,100,193,11,173,0,184
test4sub57of100,test4pub93of100,100,193,10,1247,1,1258
test4sub80of100,test4pub94of100,100,193,11,839,1,851
test4sub80of100,test4pub95of100,100,193,11,569,1,581
test4sub29of100,test4pub96of100,100,193,11,184,1,196
test4sub48of100,test4pub96of100,100,193,11,186,1,198
test4sub92of100,test4pub96of100,100,193,11,186,0,197
test4sub63of100,test4pub96of100,100,193,11,195,0,206
test4sub62of100,test4pub96of100,100,193,11,197,0,208
test4sub52of100,test4pub96of100,100,193,11,198,1,210
test4sub33of100,test4pub96of100,100,193,11,205,1,217
test4sub6of100,test4pub96of100,100,193,11,212,1,224
test4sub86of100,test4pub96of100,100,193,11,214,0,225
test4sub4of100,test4pub96of100,100,193,11,219,1,231
test4sub97of100,test4pub96of100,100,193,11,219,1,231
test4sub8of100,test4pub96of100,100,193,11,221,1,233
test4sub79of100,test4pub96of100,100,193,11,221,1,233
test4sub64of100,test4pub94of100,100,193,11,880,1,892
test4sub64of100,test4pub95of100,100,193,11,611,1,623
test4sub64of100,test4pub96of100,100,193,11,226,0,237
test4sub27of100,test4pub92of100,100,193,10,1429,1,1440
test4sub73of100,test4pub96of100,100,193,11,242,0,253
test4sub27of100,test4pub93of100,100,193,10,1317,0,1327
test4sub27of100,test4pub94of100,100,193,11,902,1,914
test4sub77of100,test4pub96of100,100,193,11,246,2,259
test4sub100of100,test4pub86of100,100,193,16,4393,1,4410
test4sub38of100,test4pub96of100,100,193,11,247,1,259
test4sub100of100,test4pub87of100,100,193,11,3731,1,3743
test4sub100of100,test4pub89of100,100,193,11,2311,1,2323
test4sub100of100,test4pub88of100,100,193,11,2340,0,2351
test4sub100of100,test4pub90of100,100,193,11,2156,1,2168
test4sub100of100,test4pub91of100,100,193,11,1823,1,1835
test4sub100of100,test4pub92of100,100,193,10,1442,0,1452
test4sub100of100,test4pub93of100,100,193,10,1330,0,1340
test4sub100of100,test4pub94of100,100,193,11,915,1,927
test4sub60of100,test4pub96of100,100,193,11,259,0,270
test4sub41of100,test4pub96of100,100,193,11,260,1,272
test4sub55of100,test4pub96of100,100,193,11,264,1,276
test4sub49of100,test4pub96of100,100,193,11,265,1,277
test4sub57of100,test4pub94of100,100,193,11,924,1,936
test4sub57of100,test4pub95of100,100,193,11,654,0,665
test4sub57of100,test4pub96of100,100,193,11,269,0,280
test4sub21of100,test4pub96of100,100,193,11,271,0,282
test4sub51of100,test4pub95of100,100,193,11,659,1,671
test4sub80of100,test4pub96of100,100,193,11,274,1,286
test4sub51of100,test4pub96of100,100,193,11,275,1,287
test4sub80of100,test4pub97of100,100,193,11,120,0,131
test4sub83of100,test4pub95of100,100,193,11,670,1,682
test4sub83of100,test4pub96of100,100,193,11,285,1,297
test4sub98of100,test4pub97of100,100,193,11,131,0,142
test4sub87of100,test4pub95of100,100,193,11,675,1,687
test4sub87of100,test4pub96of100,100,193,11,290,0,301
test4sub9of100,test4pub97of100,100,193,11,138,1,150
test4sub91of100,test4pub95of100,100,193,11,696,0,707
test4sub52of100,test4pub97of100,100,193,11,155,1,167
test4sub91of100,test4pub96of100,100,193,11,312,3,326
test4sub92of100,test4pub97of100,100,193,11,157,2,170
test4sub47of100,test4pub95of100,100,193,11,699,1,711
test4sub7of100,test4pub97of100,100,193,11,159,1,171
test4sub47of100,test4pub96of100,100,193,11,316,1,328
test4sub27of100,test4pub95of100,100,193,11,706,0,717
test4sub27of100,test4pub96of100,100,193,11,322,1,334
test4sub34of100,test4pub97of100,100,193,11,167,0,178
test4sub33of100,test4pub97of100,100,193,11,172,1,184
test4sub62of100,test4pub97of100,100,193,11,172,1,184
test4sub26of100,test4pub95of100,100,193,11,721,1,733
test4sub26of100,test4pub96of100,100,193,11,337,1,349
test4sub71of100,test4pub95of100,100,193,11,738,1,750
test4sub84of100,test4pub97of100,100,193,11,197,2,210
test4sub71of100,test4pub96of100,100,193,11,353,1,365
test4sub39of100,test4pub94of100,100,193,11,1011,2,1024
test4sub67of100,test4pub97of100,100,193,11,199,1,211
test4sub17of100,test4pub97of100,100,193,11,203,1,215
test4sub6of100,test4pub97of100,100,193,11,217,1,229
test4sub4of100,test4pub97of100,100,193,11,218,1,230
test4sub54of100,test4pub97of100,100,193,11,219,1,231
test4sub29of100,test4pub97of100,100,193,11,232,1,244
test4sub72of100,test4pub94of100,100,193,11,1045,1,1057
test4sub72of100,test4pub95of100,100,193,11,776,1,788
test4sub72of100,test4pub96of100,100,193,11,391,0,402
test4sub27of100,test4pub97of100,100,193,11,245,0,256
test4sub68of100,test4pub94of100,100,193,11,1062,1,1074
test4sub73of100,test4pub97of100,100,193,11,250,1,262
test4sub68of100,test4pub95of100,100,193,11,792,2,805
test4sub77of100,test4pub97of100,100,193,11,251,1,263
test4sub68of100,test4pub96of100,100,193,11,409,0,420
test4sub60of100,test4pub97of100,100,193,11,256,1,268
test4sub41of100,test4pub97of100,100,193,11,257,1,269
test4sub55of100,test4pub97of100,100,193,11,258,1,270
test4sub57of100,test4pub97of100,100,193,11,260,0,271
test4sub37of100,test4pub94of100,100,193,11,1077,0,1088
test4sub20of100,test4pub96of100,100,193,11,422,1,434
test4sub20of100,test4pub97of100,100,193,11,267,1,279
test4sub51of100,test4pub97of100,100,193,11,268,0,279
test4sub83of100,test4pub97of100,100,193,11,270,1,282
test4sub83of100,test4pub98of100,100,193,11,150,2,163
test4sub40of100,test4pub93of100,100,193,10,1502,2,1514
test4sub23of100,test4pub96of100,100,193,11,429,1,441
test4sub40of100,test4pub94of100,100,193,11,1087,0,1098
test4sub23of100,test4pub97of100,100,193,11,274,1,286
test4sub40of100,test4pub95of100,100,193,11,818,1,830
test4sub40of100,test4pub96of100,100,193,11,433,0,444
test4sub87of100,test4pub97of100,100,193,11,285,0,296
test4sub98of100,test4pub98of100,100,193,11,180,0,191
test4sub91of100,test4pub97of100,100,193,11,302,1,314
test4sub52of100,test4pub98of100,100,193,11,183,1,195
test4sub47of100,test4pub97of100,100,193,11,305,1,317
test4sub47of100,test4pub98of100,100,193,11,185,0,196
test4sub9of100,test4pub98of100,100,193,11,186,1,198
test4sub92of100,test4pub98of100,100,193,11,190,1,202
test4sub39of100,test4pub95of100,100,193,11,855,1,867
test4sub39of100,test4pub96of100,100,193,11,470,0,481
test4sub39of100,test4pub97of100,100,193,11,316,1,328
test4sub39of100,test4pub98of100,100,193,11,197,1,209
test4sub67of100,test4pub98of100,100,193,11,199,0,210
test4sub34of100,test4pub98of100,100,193,11,200,1,212
test4sub16of100,test4pub94of100,100,193,11,1138,0,1149
test4sub16of100,test4pub95of100,100,193,11,869,1,881
test4sub16of100,test4pub96of100,100,193,11,484,0,495
test4sub7of100,test4pub98of100,100,193,11,211,0,222
test4sub17of100,test4pub98of100,100,193,11,215,0,226
test4sub6of100,test4pub98of100,100,193,11,227,1,239
test4sub4of100,test4pub98of100,100,193,11,228,2,241
test4sub54of100,test4pub98of100,100,193,11,228,1,240
test4sub10of100,test4pub94of100,100,193,11,1166,0,1177
test4sub27of100,test4pub98of100,100,193,11,235,1,247
test4sub71of100,test4pub97of100,100,193,11,357,0,368
test4sub68of100,test4pub97of100,100,193,11,359,1,371
test4sub71of100,test4pub98of100,100,193,11,238,1,250
test4sub68of100,test4pub98of100,100,193,11,239,1,251
test4sub73of100,test4pub98of100,100,193,11,240,1,252
test4sub77of100,test4pub98of100,100,193,11,243,1,255
test4sub60of100,test4pub98of100,100,193,11,244,1,256
test4sub41of100,test4pub98of100,100,193,11,249,1,261
test4sub55of100,test4pub98of100,100,193,11,252,1,264
test4sub57of100,test4pub98of100,100,193,11,253,1,265
test4sub43of100,test4pub94of100,100,193,11,1195,1,1207
test4sub20of100,test4pub98of100,100,193,11,261,0,272
test4sub43of100,test4pub95of100,100,193,11,925,1,937
test4sub21of100,test4pub97of100,100,193,11,384,1,396
test4sub43of100,test4pub96of100,100,193,11,541,3,555
test4sub51of100,test4pub98of100,100,193,11,265,3,279
test4sub15of100,test4pub94of100,100,193,11,1199,3,1213
test4sub21of100,test4pub98of100,100,193,11,266,3,280
test4sub40of100,test4pub97of100,100,193,11,388,2,401
test4sub87of100,test4pub98of100,100,193,11,269,2,282
test4sub40of100,test4pub98of100,100,193,11,271,1,283
test4sub93of100,test4pub97of100,100,193,11,417,0,428
test4sub93of100,test4pub98of100,100,193,11,298,1,310
test4sub79of100,test4pub97of100,100,193,11,419,1,431
test4sub79of100,test4pub98of100,100,193,11,299,1,311
test4sub28of100,test4pub93of100,100,193,10,1651,1,1662
test4sub28of100,test4pub94of100,100,193,11,1235,1,1247
test4sub28of100,test4pub95of100,100,193,11,966,1,978
test4sub28of100,test4pub96of100,100,193,11,581,1,593
test4sub98of100,test4pub99of100,100,193,10,154,1,165
test4sub91of100,test4pub98of100,100,193,11,308,1,320
test4sub52of100,test4pub99of100,100,193,10,157,1,168
test4sub97of100,test4pub97of100,100,193,11,433,0,444
test4sub97of100,test4pub98of100,100,193,11,314,1,326
test4sub47of100,test4pub99of100,100,193,10,164,1,175
test4sub9of100,test4pub99of100,100,193,10,166,1,177
test4sub23of100,test4pub98of100,100,193,11,320,2,333
test4sub92of100,test4pub99of100,100,193,10,168,1,179
test4sub39of100,test4pub99of100,100,193,10,170,1,181
test4sub67of100,test4pub99of100,100,193,10,225,1,236
test4sub16of100,test4pub97of100,100,193,11,500,1,512
test4sub16of100,test4pub98of100,100,193,11,380,1,392
test4sub7of100,test4pub99of100,100,193,10,228,1,239
test4sub16of100,test4pub99of100,100,193,10,229,0,239
test4sub17of100,test4pub99of100,100,193,10,232,1,243
test4sub38of100,test4pub97of100,100,193,11,509,0,520
test4sub65of100,test4pub94of100,100,193,11,1324,1,1336
test4sub38of100,test4pub98of100,100,193,11,390,1,402
test4sub6of100,test4pub99of100,100,193,10,246,1,257
test4sub4of100,test4pub99of100,100,193,10,260,0,270
test4sub54of100,test4pub99of100,100,193,10,261,1,272
test4sub27of100,test4pub99of100,100,193,10,272,2,284
test4sub68of100,test4pub99of100,100,193,10,273,2,285
test4sub73of100,test4pub99of100,100,193,10,274,2,286
test4sub77of100,test4pub99of100,100,193,10,275,1,286
test4sub60of100,test4pub99of100,100,193,10,276,1,287
test4sub41of100,test4pub99of100,100,193,10,281,1,292
test4sub55of100,test4pub99of100,100,193,10,282,1,293
test4sub57of100,test4pub99of100,100,193,10,282,1,293
test4sub37of100,test4pub95of100,100,193,11,1102,1,1114
test4sub37of100,test4pub96of100,100,193,11,718,1,730
test4sub43of100,test4pub97of100,100,193,11,563,2,576
test4sub20of100,test4pub99of100,100,193,10,290,1,301
test4sub37of100,test4pub97of100,100,193,11,564,2,577
test4sub43of100,test4pub98of100,100,193,11,444,1,456
test4sub37of100,test4pub98of100,100,193,11,445,1,457
test4sub43of100,test4pub99of100,100,193,10,294,1,305
test4sub40of100,test4pub99of100,100,193,10,294,1,305
test4sub87of100,test4pub99of100,100,193,10,308,0,318
test4sub51of100,test4pub100of100,100,194,10,209,0,219
test4sub88of100,test4pub63of100,100,193,15,16434,1,16450
test4sub88of100,test4pub65of100,100,193,11,14567,1,14579
test4sub8of100,test4pub97of100,100,193,11,605,1,617
test4sub83of100,test4pub99of100,100,193,10,333,1,344
test4sub8of100,test4pub98of100,100,193,11,486,1,498
test4sub71of100,test4pub99of100,100,193,10,336,0,346
test4sub93of100,test4pub99of100,100,193,10,357,1,368
test4sub93of100,test4pub100of100,100,194,10,242,0,252
test4sub79of100,test4pub99of100,100,193,10,373,1,384
test4sub34of100,test4pub99of100,100,193,10,377,1,388
test4sub84of100,test4pub98of100,100,193,11,532,1,544
test4sub28of100,test4pub97of100,100,193,11,654,0,665
test4sub84of100,test4pub100of100,100,194,10,265,1,276
test4sub28of100,test4pub98of100,100,193,11,535,0,546
test4sub28of100,test4pub99of100,100,193,10,383,1,394
test4sub26of100,test4pub97of100,100,193,11,877,1,889
test4sub26of100,test4pub98of100,100,193,11,758,1,770
test4sub33of100,test4pub98of100,100,193,11,758,3,772
test4sub26of100,test4pub99of100,100,193,10,607,2,619
test4sub33of100,test4pub99of100,100,193,10,609,2,621
test4sub80of100,test4pub98of100,100,193,11,765,1,777
test4sub29of100,test4pub98of100,100,193,11,767,2,780
test4sub80of100,test4pub99of100,100,193,10,615,3,628
test4sub29of100,test4pub99of100,100,193,10,617,2,629
test4sub62of100,test4pub98of100,100,193,11,772,1,784
test4sub62of100,test4pub99of100,100,193,10,621,1,632
test4sub98of100,test4pub100of100,100,194,10,519,6,535
test4sub91of100,test4pub99of100,100,193,10,637,4,651
test4sub85of100,test4pub94of100,100,193,11,1723,5,1739
test4sub52of100,test4pub100of100,100,194,10,550,0,560
test4sub97of100,test4pub99of100,100,193,10,668,1,679
test4sub97of100,test4pub100of100,100,194,10,553,0,563
test4sub70of100,test4pub94of100,100,193,11,1764,1,1776
test4sub70of100,test4pub95of100,100,193,11,1494,0,1505
test4sub70of100,test4pub96of100,100,193,11,1110,1,1122
test4sub70of100,test4pub97of100,100,193,11,955,0,966
test4sub70of100,test4pub98of100,100,193,11,835,0,846
test4sub70of100,test4pub100of100,100,194,10,568,1,579
test4sub14of100,test4pub94of100,100,193,11,1774,1,1786
test4sub14of100,test4pub95of100,100,193,11,1504,0,1515
test4sub14of100,test4pub96of100,100,193,11,1119,0,1130
test4sub14of100,test4pub97of100,100,193,11,965,1,977
test4sub14of100,test4pub98of100,100,193,11,845,1,857
test4sub14of100,test4pub99of100,100,193,10,693,0,703
test4sub12of100,test4pub94of100,100,193,11,1790,0,1801
test4sub12of100,test4pub95of100,100,193,11,1521,1,1533
test4sub47of100,test4pub100of100,100,194,10,590,1,601
test4sub12of100,test4pub96of100,100,193,11,1136,0,1147
test4sub12of100,test4pub97of100,100,193,11,982,1,994
test4sub9of100,test4pub100of100,100,194,10,593,1,604
test4sub12of100,test4pub98of100,100,193,11,862,2,875
test4sub23of100,test4pub99of100,100,193,10,711,2,723
test4sub92of100,test4pub100of100,100,194,10,596,1,607
test4sub12of100,test4pub99of100,100,193,10,712,2,724
test4sub23of100,test4pub100of100,100,194,10,597,1,608
test4sub39of100,test4pub100of100,100,194,10,603,1,614
test4sub67of100,test4pub100of100,100,194,10,604,1,615
test4sub16of100,test4pub100of100,100,194,10,606,0,616
test4sub7of100,test4pub100of100,100,194,10,608,0,618
test4sub17of100,test4pub100of100,100,194,10,609,1,620
test4sub38of100,test4pub99of100,100,193,10,727,1,738
test4sub38of100,test4pub100of100,100,194,10,612,1,623
test4sub6of100,test4pub100of100,100,194,10,615,1,626
test4sub21of100,test4pub99of100,100,193,10,734,1,745
test4sub4of100,test4pub100of100,100,194,10,619,0,629
test4sub21of100,test4pub100of100,100,194,10,619,1,630
test4sub54of100,test4pub100of100,100,194,10,624,0,634
test4sub10of100,test4pub95of100,100,193,11,1559,0,1570
test4sub27of100,test4pub100of100,100,194,10,628,1,639
test4sub10of100,test4pub96of100,100,193,11,1175,1,1187
test4sub68of100,test4pub100of100,100,194,10,629,3,642
test4sub73of100,test4pub100of100,100,194,10,631,2,643
test4sub77of100,test4pub100of100,100,194,10,632,2,644
test4sub10of100,test4pub97of100,100,193,11,1021,2,1034
test4sub10of100,test4pub98of100,100,193,11,904,1,916
test4sub60of100,test4pub100of100,100,194,10,633,5,648
test4sub41of100,test4pub100of100,100,194,10,634,4,648
test4sub55of100,test4pub100of100,100,194,10,635,4,649
test4sub57of100,test4pub100of100,100,194,10,636,4,650
test4sub10of100,test4pub99of100,100,193,10,753,3,766
test4sub37of100,test4pub99of100,100,193,10,753,3,766
test4sub43of100,test4pub100of100,100,194,10,638,3,651
test4sub87of100,test4pub100of100,100,194,10,639,3,652
test4sub37of100,test4pub100of100,100,194,10,641,2,653
test4sub51of100,test4pub99of100,100,193,10,759,1,770
test4sub8of100,test4pub99of100,100,193,10,765,1,776
test4sub79of100,test4pub100of100,100,194,10,649,1,660
test4sub8of100,test4pub100of100,100,194,10,650,0,660
test4sub84of100,test4pub99of100,100,193,10,771,0,781
test4sub28of100,test4pub100of100,100,194,10,661,0,671
test4sub46of100,test4pub91of100,100,193,11,2785,0,2796
test4sub26of100,test4pub100of100,100,194,10,671,0,681
test4sub86of100,test4pub97of100,100,193,11,1068,0,1079
test4sub86of100,test4pub98of100,100,193,11,948,1,960
test4sub86of100,test4pub99of100,100,193,10,797,1,808
test4sub33of100,test4pub100of100,100,194,10,685,0,695
test4sub80of100,test4pub100of100,100,194,10,688,1,699
test4sub62of100,test4pub100of100,100,194,10,691,0,701
test4sub91of100,test4pub100of100,100,194,10,694,1,705
test4sub70of100,test4pub99of100,100,193,10,814,1,825
test4sub14of100,test4pub100of100,100,194,10,698,1,709
test4sub48of100,test4pub97of100,100,193,11,1102,1,1114
test4sub49of100,test4pub97of100,100,193,11,1103,2,1116
test4sub48of100,test4pub98of100,100,193,11,983,1,995
test4sub49of100,test4pub98of100,100,193,11,984,1,996
test4sub48of100,test4pub99of100,100,193,10,831,1,842
test4sub49of100,test4pub99of100,100,193,10,832,1,843
test4sub65of100,test4pub95of100,100,193,11,1666,1,1678
test4sub65of100,test4pub96of100,100,193,11,1282,1,1294
test4sub65of100,test4pub97of100,100,193,11,1127,0,1138
test4sub65of100,test4pub98of100,100,193,11,1008,1,1020
test4sub10of100,test4pub100of100,100,194,10,740,2,752
test4sub65of100,test4pub99of100,100,193,10,856,1,867
test4sub65of100,test4pub100of100,100,194,10,742,0,752
test4sub88of100,test4pub66of100,100,193,16,15080,0,15096
test4sub88of100,test4pub64of100,100,193,11,16643,1,16655
test4sub88of100,test4pub67of100,100,193,11,14983,1,14995
test4sub88of100,test4pub68of100,100,193,11,11225,0,11236
test4sub88of100,test4pub69of100,100,193,10,11048,1,11059
test4sub88of100,test4pub70of100,100,193,10,10830,1,10841
test4sub88of100,test4pub71of100,100,193,10,10633,1,10644
test4sub88of100,test4pub72of100,100,193,12,10259,0,10271
test4sub88of100,test4pub73of100,100,193,11,10035,1,10047
test4sub86of100,test4pub100of100,100,194,10,761,0,771
test4sub88of100,test4pub74of100,100,193,11,9876,1,9888
test4sub3of100,test4pub96of100,100,193,11,1309,1,1321
test4sub88of100,test4pub75of100,100,193,14,9655,1,9670
test4sub3of100,test4pub95of100,100,193,11,1697,1,1709
test4sub85of100,test4pub95of100,100,193,11,1698,2,1711
test4sub3of100,test4pub97of100,100,193,11,1157,1,1169
test4sub85of100,test4pub96of100,100,193,11,1314,1,1326
test4sub3of100,test4pub98of100,100,193,11,1038,1,1050
test4sub88of100,test4pub76of100,100,193,10,9287,3,9300
test4sub85of100,test4pub97of100,100,193,11,1160,2,1173
test4sub3of100,test4pub99of100,100,193,10,886,1,897
test4sub88of100,test4pub77of100,100,193,11,8872,2,8885
test4sub85of100,test4pub98of100,100,193,11,1041,1,1053
test4sub3of100,test4pub100of100,100,194,10,772,2,784
test4sub88of100,test4pub78of100,100,193,11,8320,2,8333
test4sub85of100,test4pub99of100,100,193,10,890,2,902
test4sub88of100,test4pub79of100,100,193,14,8005,1,8020
test4sub85of100,test4pub100of100,100,194,10,777,1,788
test4sub88of100,test4pub80of100,100,193,10,7659,0,7669
test4sub88of100,test4pub81of100,100,193,17,7319,1,7337
test4sub88of100,test4pub82of100,100,193,11,7135,1,7147
test4sub88of100,test4pub83of100,100,193,14,6725,0,6739
test4sub88of100,test4pub84of100,100,193,14,6249,1,6264
test4sub88of100,test4pub85of100,100,193,10,6010,1,6021
test4sub88of100,test4pub86of100,100,193,16,5478,0,5494
test4sub88of100,test4pub87of100,100,193,11,4815,1,4827
test4sub48of100,test4pub100of100,100,194,10,808,0,818
test4sub49of100,test4pub100of100,100,194,10,812,1,823
test4sub1of100,test4pub79of100,100,193,14,8049,1,8064
test4sub1of100,test4pub80of100,100,193,10,7703,1,7714
test4sub1of100,test4pub81of100,100,193,17,7362,0,7379
test4sub1of100,test4pub82of100,100,193,11,7179,1,7191
test4sub1of100,test4pub83of100,100,193,14,6769,1,6784
test4sub1of100,test4pub84of100,100,193,14,6293,0,6307
test4sub88of100,test4pub89of100,100,193,11,3452,1,3464
test4sub88of100,test4pub88of100,100,193,11,3482,1,3494
test4sub88of100,test4pub90of100,100,193,11,3297,1,3309
test4sub88of100,test4pub91of100,100,193,11,2964,1,2976
test4sub88of100,test4pub92of100,100,193,10,2584,0,2594
test4sub88of100,test4pub93of100,100,193,10,2472,1,2483
test4sub88of100,test4pub94of100,100,193,11,2057,1,2069
test4sub88of100,test4pub95of100,100,193,11,1787,0,1798
test4sub46of100,test4pub92of100,100,193,10,2589,1,2600
test4sub88of100,test4pub96of100,100,193,11,1403,1,1415
test4sub46of100,test4pub93of100,100,193,10,2478,0,2488
test4sub88of100,test4pub97of100,100,193,11,1248,1,1260
test4sub46of100,test4pub94of100,100,193,11,2063,1,2075
test4sub88of100,test4pub98of100,100,193,11,1129,1,1141
test4sub46of100,test4pub95of100,100,193,11,1793,1,1805
test4sub46of100,test4pub96of100,100,193,11,1409,1,1421
test4sub46of100,test4pub97of100,100,193,11,1254,0,1265
test4sub56of100,test4pub42of100,100,193,31,25400,1,25432
test4sub46of100,test4pub98of100,100,193,11,1135,1,1147
test4sub56of100,test4pub43of100,100,193,28,25261,0,25289
test4sub46of100,test4pub99of100,100,193,10,983,1,994
test4sub56of100,test4pub44of100,100,193,17,25115,1,25133
test4sub46of100,test4pub100of100,100,194,10,869,1,880
test4sub56of100,test4pub45of100,100,193,20,24987,1,25008
test4sub56of100,test4pub46of100,100,193,12,24639,1,24652
test4sub56of100,test4pub47of100,100,193,10,24225,0,24235
test4sub1of100,test4pub85of100,100,193,10,6099,2,6111
test4sub56of100,test4pub48of100,100,193,10,24066,1,24077
test4sub1of100,test4pub86of100,100,193,16,5568,1,5585
test4sub56of100,test4pub49of100,100,193,11,23870,1,23882
test4sub1of100,test4pub87of100,100,193,11,4906,1,4918
test4sub56of100,test4pub50of100,100,193,17,23700,1,23718
test4sub1of100,test4pub88of100,100,193,11,3515,1,3527
test4sub56of100,test4pub51of100,100,193,16,23532,1,23549
test4sub1of100,test4pub89of100,100,193,11,3489,1,3501
test4sub56of100,test4pub52of100,100,193,10,23388,1,23399
test4sub56of100,test4pub53of100,100,193,10,23021,1,23032
test4sub22of100,test4pub91of100,100,193,11,3000,2,3013
test4sub1of100,test4pub90of100,100,193,11,3333,3,3347
test4sub88of100,test4pub99of100,100,193,10,1002,1,1013
test4sub22of100,test4pub92of100,100,193,10,2621,2,2633
test4sub56of100,test4pub54of100,100,193,11,22857,3,22871
test4sub22of100,test4pub93of100,100,193,10,2510,1,2521
test4sub1of100,test4pub91of100,100,193,11,3003,2,3016
test4sub88of100,test4pub100of100,100,194,10,889,2,901
test4sub56of100,test4pub55of100,100,193,10,22594,2,22606
test4sub1of100,test4pub92of100,100,193,10,2625,1,2636
test4sub56of100,test4pub56of100,100,193,11,21706,0,21717
test4sub56of100,test4pub57of100,100,193,11,21563,1,21575
test4sub56of100,test4pub58of100,100,193,11,20599,1,20611
test4sub56of100,test4pub59of100,100,193,12,20051,0,20063
test4sub56of100,test4pub60of100,100,193,18,19693,1,19712
test4sub64of100,test4pub97of100,100,193,11,1293,1,1305
test4sub64of100,test4pub98of100,100,193,11,1174,1,1186
test4sub56of100,test4pub61of100,100,193,11,19186,0,19197
test4sub64of100,test4pub99of100,100,193,10,1023,1,1034
test4sub56of100,test4pub62of100,100,193,12,18395,1,18408
test4sub56of100,test4pub63of100,100,193,15,17131,0,17146
test4sub1of100,test4pub93of100,100,193,10,2530,1,2541
test4sub1of100,test4pub94of100,100,193,11,2115,0,2126
test4sub1of100,test4pub95of100,100,193,11,1846,1,1858
test4sub1of100,test4pub96of100,100,193,11,1461,1,1473
test4sub1of100,test4pub97of100,100,193,11,1306,0,1317
test4sub1of100,test4pub98of100,100,193,11,1187,1,1199
test4sub1of100,test4pub99of100,100,193,10,1035,1,1046
test4sub1of100,test4pub100of100,100,194,10,920,0,930
test4sub22of100,test4pub94of100,100,193,11,2140,1,2152
test4sub22of100,test4pub95of100,100,193,11,1870,1,1882
test4sub22of100,test4pub96of100,100,193,11,1486,1,1498
test4sub56of100,test4pub65of100,100,193,11,15295,1,15307
test4sub22of100,test4pub97of100,100,193,11,1331,1,1343
test4sub56of100,test4pub64of100,100,193,11,16838,1,16850
test4sub22of100,test4pub98of100,100,193,11,1213,0,1224
test4sub22of100,test4pub99of100,100,193,10,1062,1,1073
test4sub64of100,test4pub100of100,100,194,10,946,1,957
test4sub56of100,test4pub66of100,100,193,16,15278,0,15294
test4sub56of100,test4pub67of100,100,193,11,15181,1,15193
test4sub56of100,test4pub68of100,100,193,11,11423,0,11434
test4sub56of100,test4pub69of100,100,193,10,11246,1,11257
test4sub56of100,test4pub70of100,100,193,10,11028,0,11038
test4sub56of100,test4pub71of100,100,193,10,10830,0,10840
test4sub22of100,test4pub100of100,100,194,10,970,1,981
test4sub5of100,test4pub90of100,100,193,11,3426,1,3438
test4sub5of100,test4pub91of100,100,193,11,3093,0,3104
test4sub56of100,test4pub72of100,100,193,12,10480,1,10493
test4sub5of100,test4pub92of100,100,193,10,2713,1,2724
test4sub56of100,test4pub73of100,100,193,11,10256,1,10268
test4sub56of100,test4pub74of100,100,193,11,10097,0,10108
test4sub56of100,test4pub75of100,100,193,14,9876,1,9891
test4sub56of100,test4pub76of100,100,193,10,9507,0,9517
test4sub56of100,test4pub77of100,100,193,11,9088,1,9100
test4sub56of100,test4pub78of100,100,193,11,8534,1,8546
test4sub56of100,test4pub79of100,100,193,14,8218,0,8232
test4sub56of100,test4pub80of100,100,193,10,7872,1,7883
test4sub56of100,test4pub81of100,100,193,17,7531,0,7548
test4sub56of100,test4pub82of100,100,193,11,7348,1,7360
test4sub44of100,test4pub86of100,100,193,16,5689,1,5706
test4sub44of100,test4pub87of100,100,193,11,5026,0,5037
test4sub44of100,test4pub88of100,100,193,11,3635,1,3647
test4sub5of100,test4pub93of100,100,193,10,2638,0,2648
test4sub5of100,test4pub94of100,100,193,11,2223,1,2235
test4sub5of100,test4pub95of100,100,193,11,1953,0,1964
test4sub5of100,test4pub96of100,100,193,11,1569,1,1581
test4sub5of100,test4pub97of100,100,193,11,1414,1,1426
test4sub5of100,test4pub98of100,100,193,11,1294,0,1305
test4sub56of100,test4pub83of100,100,193,14,6975,1,6990
test4sub56of100,test4pub84of100,100,193,14,6500,1,6515
test4sub56of100,test4pub85of100,100,193,10,6260,0,6270
test4sub56of100,test4pub86of100,100,193,16,5729,1,5746
test4sub56of100,test4pub87of100,100,193,11,5066,1,5078
test4sub56of100,test4pub88of100,100,193,11,3674,0,3685
test4sub56of100,test4pub89of100,100,193,11,3669,1,3681
test4sub56of100,test4pub90of100,100,193,11,3512,0,3523
test4sub40of100,test4pub100of100,100,194,10,1064,1,1075
test4sub56of100,test4pub91of100,100,193,11,3180,1,3192
test4sub56of100,test4pub92of100,100,193,10,2799,0,2809
test4sub56of100,test4pub93of100,100,193,10,2688,1,2699
test4sub5of100,test4pub99of100,100,193,10,1194,0,1204
test4sub5of100,test4pub100of100,100,194,10,1080,1,1091
test4sub56of100,test4pub94of100,100,193,11,2289,1,2301
test4sub56of100,test4pub95of100,100,193,11,2020,0,2031
test4sub56of100,test4pub96of100,100,193,11,1636,1,1648
test4sub56of100,test4pub97of100,100,193,11,1481,1,1493
test4sub56of100,test4pub98of100,100,193,11,1361,0,1372
test4sub56of100,test4pub99of100,100,193,10,1210,1,1221
test4sub56of100,test4pub100of100,100,194,10,1095,0,1105
test4sub71of100,test4pub100of100,100,194,10,1132,0,1142
test4sub96of100,test4pub94of100,100,193,11,2363,0,2374
test4sub96of100,test4pub95of100,100,193,11,2094,1,2106
test4sub96of100,test4pub96of100,100,193,11,1709,1,1721
test4sub44of100,test4pub89of100,100,193,11,3772,1,3784
test4sub96of100,test4pub97of100,100,193,11,1554,0,1565
test4sub44of100,test4pub90of100,100,193,11,3615,1,3627
test4sub96of100,test4pub98of100,100,193,11,1436,1,1448
test4sub44of100,test4pub91of100,100,193,11,3283,0,3294
test4sub96of100,test4pub99of100,100,193,10,1284,1,1295
test4sub44of100,test4pub92of100,100,193,10,2903,1,2914
test4sub44of100,test4pub93of100,100,193,10,2791,0,2801
test4sub44of100,test4pub94of100,100,193,11,2376,1,2388
test4sub44of100,test4pub95of100,100,193,11,2106,1,2118
test4sub44of100,test4pub96of100,100,193,11,1722,1,1734
test4sub44of100,test4pub97of100,100,193,11,1567,0,1578
test4sub44of100,test4pub98of100,100,193,11,1447,0,1458
test4sub95of100,test4pub92of100,100,193,10,2927,1,2938
test4sub95of100,test4pub93of100,100,193,10,2815,1,2826
test4sub95of100,test4pub94of100,100,193,11,2400,1,2412
test4sub95of100,test4pub95of100,100,193,11,2130,0,2141
test4sub95of100,test4pub96of100,100,193,11,1746,1,1758
test4sub95of100,test4pub97of100,100,193,11,1591,1,1603
test4sub95of100,test4pub98of100,100,193,11,1471,0,1482
test4sub95of100,test4pub99of100,100,193,10,1320,1,1331
test4sub95of100,test4pub100of100,100,194,10,1205,1,1216
test4sub15of100,test4pub95of100,100,193,11,2138,0,2149
test4sub15of100,test4pub96of100,100,193,11,1754,1,1766
test4sub15of100,test4pub97of100,100,193,11,1599,1,1611
test4sub15of100,test4pub98of100,100,193,11,1479,0,1490
test4sub15of100,test4pub99of100,100,193,10,1327,1,1338
test4sub96of100,test4pub100of100,100,194,10,1237,1,1248
test4sub44of100,test4pub99of100,100,193,10,1361,0,1371
test4sub44of100,test4pub100of100,100,194,10,1247,1,1258
test4sub15of100,test4pub100of100,100,194,10,1252,1,1263
test4sub31of100,test4pub95of100,100,193,11,2283,1,2295
test4sub31of100,test4pub96of100,100,193,11,1898,0,1909
test4sub32of100,test4pub91of100,100,193,11,3521,1,3533
test4sub32of100,test4pub92of100,100,193,10,3141,1,3152
test4sub32of100,test4pub93of100,100,193,10,3031,0,3041
test4sub32of100,test4pub94of100,100,193,11,2615,1,2627
test4sub32of100,test4pub95of100,100,193,11,2346,1,2358
test4sub29of100,test4pub100of100,100,194,10,1419,1,1430
test4sub75of100,test4pub90of100,100,193,11,3872,0,3883
test4sub75of100,test4pub91of100,100,193,11,3539,0,3550
test4sub31of100,test4pub97of100,100,193,11,1818,0,1829
test4sub31of100,test4pub98of100,100,193,11,1698,0,1709
test4sub31of100,test4pub99of100,100,193,10,1547,1,1558
test4sub31of100,test4pub100of100,100,194,10,1436,0,1446
test4sub32of100,test4pub96of100,100,193,11,1990,1,2002
test4sub32of100,test4pub97of100,100,193,11,1835,1,1847
test4sub32of100,test4pub98of100,100,193,11,1716,1,1728
test4sub32of100,test4pub99of100,100,193,10,1564,0,1574
test4sub32of100,test4pub100of100,100,194,10,1450,1,1461
test4sub13of100,test4pub94of100,100,193,11,2665,1,2677
test4sub13of100,test4pub95of100,100,193,11,2405,1,2417
test4sub13of100,test4pub96of100,100,193,11,2020,0,2031
test4sub13of100,test4pub97of100,100,193,11,1865,1,1877
test4sub13of100,test4pub98of100,100,193,11,1746,1,1758
test4sub13of100,test4pub99of100,100,193,10,1594,0,1604
test4sub13of100,test4pub100of100,100,194,10,1480,1,1491
test4sub99of100,test4pub88of100,100,193,11,4133,0,4144
test4sub99of100,test4pub89of100,100,193,11,4106,0,4117
test4sub50of100,test4pub89of100,100,193,11,4125,0,4136
test4sub50of100,test4pub88of100,100,193,11,4154,0,4165
test4sub75of100,test4pub92of100,100,193,10,3279,1,3290
test4sub75of100,test4pub93of100,100,193,10,3168,1,3179
test4sub75of100,test4pub94of100,100,193,11,2752,0,2763
test4sub75of100,test4pub95of100,100,193,11,2482,0,2493
test4sub75of100,test4pub96of100,100,193,11,2098,1,2110
test4sub75of100,test4pub97of100,100,193,11,1943,0,1954
test4sub75of100,test4pub98of100,100,193,11,1823,0,1834
test4sub75of100,test4pub99of100,100,193,10,1672,1,1683
test4sub75of100,test4pub100of100,100,194,10,1579,1,1590
test4sub72of100,test4pub97of100,100,193,11,1990,1,2002
test4sub72of100,test4pub98of100,100,193,11,1870,0,1881
test4sub72of100,test4pub99of100,100,193,10,1718,1,1729
test4sub72of100,test4pub100of100,100,194,10,1604,1,1615
test4sub66of100,test4pub97of100,100,193,11,1997,1,2009
test4sub66of100,test4pub98of100,100,193,11,1877,0,1888
test4sub66of100,test4pub99of100,100,193,10,1725,1,1736
test4sub99of100,test4pub90of100,100,193,11,4103,1,4115
test4sub99of100,test4pub91of100,100,193,11,3770,0,3781
test4sub99of100,test4pub92of100,100,193,10,3389,0,3399
test4sub99of100,test4pub93of100,100,193,10,3278,1,3289
test4sub99of100,test4pub94of100,100,193,11,2862,0,2873
test4sub99of100,test4pub95of100,100,193,11,2592,1,2604
test4sub99of100,test4pub96of100,100,193,11,2241,1,2253
test4sub99of100,test4pub97of100,100,193,11,2086,0,2097
test4sub99of100,test4pub98of100,100,193,11,1967,1,1979
test4sub66of100,test4pub100of100,100,194,10,1699,1,1710
test4sub50of100,test4pub90of100,100,193,11,4149,1,4161
test4sub50of100,test4pub91of100,100,193,11,3816,0,3827
test4sub50of100,test4pub92of100,100,193,10,3435,0,3445
test4sub50of100,test4pub93of100,100,193,10,3324,1,3335
test4sub50of100,test4pub94of100,100,193,11,2908,0,2919
test4sub50of100,test4pub95of100,100,193,11,2639,1,2651
test4sub99of100,test4pub99of100,100,193,10,1824,1,1835
test4sub50of100,test4pub96of100,100,193,11,2254,1,2266
test4sub99of100,test4pub100of100,100,194,10,1709,1,1720
test4sub50of100,test4pub97of100,100,193,11,2100,0,2111
test4sub50of100,test4pub98of100,100,193,11,1981,1,1993
test4sub59of100,test4pub93of100,100,193,10,3337,1,3348
test4sub59of100,test4pub94of100,100,193,11,2921,0,2932
test4sub59of100,test4pub95of100,100,193,11,2652,1,2664
test4sub50of100,test4pub99of100,100,193,10,1863,1,1874
test4sub50of100,test4pub100of100,100,194,10,1749,0,1759
test4sub59of100,test4pub96of100,100,193,11,2299,0,2310
test4sub59of100,test4pub97of100,100,193,11,2145,1,2157
test4sub59of100,test4pub98of100,100,193,11,2025,0,2036
test4sub59of100,test4pub99of100,100,193,10,1895,1,1906
test4sub59of100,test4pub100of100,100,194,10,1780,0,1790
test4sub76of100,test4pub96of100,100,193,11,2373,1,2385
test4sub76of100,test4pub97of100,100,193,11,2218,0,2229
test4sub76of100,test4pub98of100,100,193,11,2099,1,2111
test4sub76of100,test4pub99of100,100,193,10,1952,1,1963
test4sub76of100,test4pub100of100,100,194,10,1838,1,1849
test4sub20of100,test4pub100of100,100,194,10,1890,1,1901
test4sub34of100,test4pub100of100,100,194,10,1974,1,1985
test4sub24of100,test4pub52of100,100,193,10,24522,0,24532
test4sub24of100,test4pub53of100,100,193,10,24155,1,24166
test4sub63of100,test4pub97of100,100,193,11,2452,1,2464
test4sub25of100,test4pub73of100,100,193,11,11404,1,11416
test4sub12of100,test4pub100of100,100,194,10,2208,0,2218
test4sub30of100,test4pub96of100,100,193,11,2808,1,2820
test4sub45of100,test4pub60of100,100,193,18,21068,1,21087
test4sub11of100,test4pub76of100,100,193,10,10833,1,10844
test4sub25of100,test4pub74of100,100,193,11,11499,2,11512
test4sub58of100,test4pub96of100,100,193,11,2879,0,2890
test4sub82of100,test4pub91of100,100,193,11,4500,3,4514
test4sub63of100,test4pub98of100,100,193,11,2653,4,2668
test4sub30of100,test4pub97of100,100,193,11,2774,5,2790
test4sub45of100,test4pub61of100,100,193,11,20665,4,20680
test4sub24of100,test4pub54of100,100,193,11,24354,7,24372
test4sub11of100,test4pub77of100,100,193,11,10487,5,10503
test4sub58of100,test4pub97of100,100,193,11,2777,4,2792
test4sub25of100,test4pub75of100,100,193,14,11279,6,11299
test4sub63of100,test4pub99of100,100,193,10,2505,4,2519
test4sub30of100,test4pub98of100,100,193,11,2659,6,2676
test4sub24of100,test4pub55of100,100,193,10,24094,5,24109
test4sub45of100,test4pub62of100,100,193,12,19878,5,19895
test4sub11of100,test4pub78of100,100,193,11,9938,5,9954
test4sub58of100,test4pub98of100,100,193,11,2662,5,2678
test4sub25of100,test4pub76of100,100,193,10,10916,5,10931
test4sub63of100,test4pub100of100,100,194,10,2395,5,2410
test4sub30of100,test4pub99of100,100,193,10,2512,4,2526
test4sub24of100,test4pub56of100,100,193,11,23206,4,23221
test4sub45of100,test4pub63of100,100,193,15,18619,4,18638
test4sub58of100,test4pub100of100,100,194,10,2399,5,2414
test4sub11of100,test4pub79of100,100,193,14,9627,5,9646
test4sub25of100,test4pub77of100,100,193,11,10501,5,10517
test4sub30of100,test4pub100of100,100,194,10,2401,4,2415
test4sub45of100,test4pub64of100,100,193,11,18297,4,18312
test4sub24of100,test4pub57of100,100,193,11,23068,5,23084
test4sub58of100,test4pub99of100,100,193,10,2520,3,2533
test4sub11of100,test4pub80of100,100,193,10,9286,4,9300
test4sub25of100,test4pub78of100,100,193,11,9952,3,9966
test4sub45of100,test4pub65of100,100,193,11,16760,4,16775
test4sub24of100,test4pub58of100,100,193,11,22107,3,22121
test4sub11of100,test4pub81of100,100,193,17,8948,2,8967
test4sub25of100,test4pub79of100,100,193,14,9640,1,9655
test4sub45of100,test4pub66of100,100,193,16,16743,2,16761
test4sub11of100,test4pub82of100,100,193,11,8767,2,8780
test4sub24of100,test4pub59of100,100,193,12,21563,1,21576
test4sub45of100,test4pub67of100,100,193,11,16646,2,16659
test4sub25of100,test4pub80of100,100,193,10,9295,2,9307
test4sub11of100,test4pub83of100,100,193,14,8360,2,8376
test4sub24of100,test4pub60of100,100,193,18,21207,3,21228
test4sub45of100,test4pub68of100,100,193,11,12891,1,12903
test4sub25of100,test4pub81of100,100,193,17,8957,3,8977
test4sub45of100,test4pub69of100,100,193,10,12714,2,12726
test4sub24of100,test4pub61of100,100,193,11,20701,3,20715
test4sub11of100,test4pub84of100,100,193,14,7886,4,7904
test4sub25of100,test4pub82of100,100,193,11,8776,2,8789
test4sub45of100,test4pub70of100,100,193,10,12498,3,12511
test4sub24of100,test4pub62of100,100,193,12,19911,2,19925
test4sub11of100,test4pub85of100,100,193,10,7650,3,7663
test4sub25of100,test4pub83of100,100,193,14,8369,3,8386
test4sub24of100,test4pub63of100,100,193,15,18650,2,18667
test4sub45of100,test4pub71of100,100,193,10,12303,2,12315
test4sub11of100,test4pub86of100,100,193,16,7121,3,7140
test4sub25of100,test4pub84of100,100,193,14,7896,2,7912
test4sub24of100,test4pub64of100,100,193,11,18325,1,18337
test4sub45of100,test4pub72of100,100,193,12,11932,2,11946
test4sub11of100,test4pub87of100,100,193,11,6460,3,6474
test4sub25of100,test4pub85of100,100,193,10,7658,3,7671
test4sub45of100,test4pub73of100,100,193,11,11710,3,11724
test4sub24of100,test4pub66of100,100,193,16,16766,3,16785
test4sub11of100,test4pub88of100,100,193,11,5071,3,5085
test4sub25of100,test4pub86of100,100,193,16,7129,2,7147
test4sub45of100,test4pub74of100,100,193,11,11553,1,11565
test4sub24of100,test4pub65of100,100,193,11,16791,2,16804
test4sub11of100,test4pub89of100,100,193,11,5046,3,5060
test4sub25of100,test4pub87of100,100,193,11,6469,2,6482
test4sub24of100,test4pub67of100,100,193,11,16674,2,16687
test4sub45of100,test4pub75of100,100,193,14,11334,3,11351
test4sub25of100,test4pub88of100,100,193,11,5079,2,5092
test4sub11of100,test4pub90of100,100,193,11,4892,3,4906
test4sub24of100,test4pub68of100,100,193,11,12919,2,12932
test4sub25of100,test4pub89of100,100,193,11,5055,2,5068
test4sub45of100,test4pub76of100,100,193,10,10968,2,10980
test4sub11of100,test4pub91of100,100,193,11,4563,1,4575
test4sub24of100,test4pub69of100,100,193,10,12743,1,12754
test4sub45of100,test4pub77of100,100,193,11,10551,1,10563
test4sub25of100,test4pub90of100,100,193,11,4899,2,4912
test4sub11of100,test4pub92of100,100,193,10,4184,1,4195
test4sub24of100,test4pub70of100,100,193,10,12527,1,12538
test4sub45of100,test4pub78of100,100,193,11,9999,3,10013
test4sub25of100,test4pub91of100,100,193,11,4568,1,4580
test4sub11of100,test4pub93of100,100,193,10,4074,3,4087
test4sub24of100,test4pub71of100,100,193,10,12331,2,12343
test4sub11of100,test4pub94of100,100,193,11,3660,1,3672
test4sub45of100,test4pub79of100,100,193,14,9687,1,9702
test4sub25of100,test4pub92of100,100,193,10,4189,1,4200
test4sub24of100,test4pub72of100,100,193,12,11960,0,11972
test4sub25of100,test4pub93of100,100,193,10,4080,1,4091
test4sub11of100,test4pub95of100,100,193,11,3391,2,3404
test4sub45of100,test4pub80of100,100,193,10,9340,3,9353
test4sub11of100,test4pub96of100,100,193,11,3009,1,3021
test4sub25of100,test4pub94of100,100,193,11,3666,1,3678
test4sub24of100,test4pub73of100,100,193,11,11737,4,11752
test4sub45of100,test4pub81of100,100,193,17,9003,3,9023
test4sub11of100,test4pub97of100,100,193,11,2855,3,2869
test4sub24of100,test4pub74of100,100,193,11,11581,3,11595
test4sub25of100,test4pub95of100,100,193,11,3397,3,3411
test4sub45of100,test4pub82of100,100,193,11,8821,2,8834
test4sub11of100,test4pub98of100,100,193,11,2737,3,2751
test4sub24of100,test4pub75of100,100,193,14,11361,2,11377
test4sub25of100,test4pub96of100,100,193,11,3016,3,3030
test4sub45of100,test4pub83of100,100,193,14,8414,3,8431
test4sub11of100,test4pub99of100,100,193,10,2588,2,2600
test4sub24of100,test4pub76of100,100,193,10,10995,3,11008
test4sub25of100,test4pub97of100,100,193,11,2864,2,2877
test4sub45of100,test4pub84of100,100,193,14,7941,3,7958
test4sub11of100,test4pub100of100,100,194,10,2475,3,2488
test4sub24of100,test4pub77of100,100,193,11,10578,2,10591
test4sub25of100,test4pub98of100,100,193,11,2746,2,2759
test4sub45of100,test4pub85of100,100,193,10,7704,2,7716
test4sub25of100,test4pub99of100,100,193,10,2596,1,2607
test4sub45of100,test4pub86of100,100,193,16,7173,1,7190
test4sub25of100,test4pub100of100,100,194,10,2482,0,2492
test4sub24of100,test4pub78of100,100,193,11,10026,3,10040
test4sub24of100,test4pub79of100,100,193,14,9713,0,9727
test4sub45of100,test4pub87of100,100,193,11,6511,1,6523
test4sub45of100,test4pub89of100,100,193,11,5093,1,5105
test4sub24of100,test4pub80of100,100,193,10,9367,1,9378
test4sub24of100,test4pub81of100,100,193,17,9027,9,9053
test4sub45of100,test4pub88of100,100,193,11,5122,9,5142
test4sub24of100,test4pub82of100,100,193,11,8851,0,8862
test4sub45of100,test4pub90of100,100,193,11,4946,1,4958
test4sub24of100,test4pub83of100,100,193,14,8442,1,8457
test4sub45of100,test4pub91of100,100,193,11,4614,1,4626
test4sub45of100,test4pub92of100,100,193,10,4233,1,4244
test4sub24of100,test4pub84of100,100,193,14,7966,1,7981
test4sub24of100,test4pub85of100,100,193,10,7727,0,7737
test4sub45of100,test4pub93of100,100,193,10,4122,1,4133
test4sub24of100,test4pub86of100,100,193,16,7196,0,7212
test4sub45of100,test4pub94of100,100,193,11,3707,1,3719
test4sub24of100,test4pub87of100,100,193,11,6534,1,6546
test4sub45of100,test4pub95of100,100,193,11,3438,0,3449
test4sub24of100,test4pub89of100,100,193,11,5114,9,5134
test4sub45of100,test4pub96of100,100,193,11,3054,10,3075
test4sub24of100,test4pub88of100,100,193,11,5152,1,5164
test4sub82of100,test4pub92of100,100,193,10,4250,2,4262
test4sub45of100,test4pub97of100,100,193,11,2908,2,2921
test4sub24of100,test4pub90of100,100,193,11,4968,1,4980
test4sub82of100,test4pub93of100,100,193,10,4140,3,4153
test4sub24of100,test4pub91of100,100,193,11,4637,1,4649
test4sub45of100,test4pub98of100,100,193,11,2790,2,2803
test4sub82of100,test4pub94of100,100,193,11,3726,1,3738
test4sub24of100,test4pub92of100,100,193,10,4256,2,4268
test4sub82of100,test4pub95of100,100,193,11,3457,1,3469
test4sub45of100,test4pub99of100,100,193,10,2641,2,2653
test4sub82of100,test4pub96of100,100,193,11,3073,1,3085
test4sub24of100,test4pub93of100,100,193,10,4147,3,4160
test4sub45of100,test4pub100of100,100,194,10,2529,1,2540
test4sub82of100,test4pub97of100,100,193,11,2919,2,2932
test4sub24of100,test4pub94of100,100,193,11,3733,1,3745
test4sub82of100,test4pub98of100,100,193,11,2800,1,2812
test4sub24of100,test4pub95of100,100,193,11,3464,1,3476
test4sub82of100,test4pub99of100,100,193,10,2648,1,2659
test4sub82of100,test4pub100of100,100,194,10,2534,0,2544
test4sub24of100,test4pub96of100,100,193,11,3080,1,3092
test4sub24of100,test4pub97of100,100,193,11,2926,0,2937
test4sub24of100,test4pub98of100,100,193,11,2807,1,2819
test4sub24of100,test4pub99of100,100,193,10,2655,1,2666
test4sub24of100,test4pub100of100,100,194,10,2540,0,2550
test4sub69of100,test4pub81of100,100,193,17,9132,1,9150
test4sub69of100,test4pub82of100,100,193,11,8948,0,8959
test4sub69of100,test4pub83of100,100,193,14,8539,1,8554
test4sub69of100,test4pub84of100,100,193,14,8063,0,8077
test4sub69of100,test4pub85of100,100,193,10,7824,1,7835
test4sub69of100,test4pub86of100,100,193,16,7292,1,7309
test4sub69of100,test4pub87of100,100,193,11,6821,1,6833
test4sub69of100,test4pub88of100,100,193,11,5430,1,5442
test4sub69of100,test4pub89of100,100,193,11,5475,0,5486
test4sub69of100,test4pub90of100,100,193,11,5319,1,5331
test4sub69of100,test4pub91of100,100,193,11,4986,1,4998
test4sub69of100,test4pub92of100,100,193,10,4605,0,4615
test4sub69of100,test4pub93of100,100,193,10,4494,1,4505
test4sub69of100,test4pub94of100,100,193,11,4078,0,4089
test4sub69of100,test4pub95of100,100,193,11,3809,1,3821
test4sub69of100,test4pub96of100,100,193,11,3424,1,3436
test4sub69of100,test4pub97of100,100,193,11,3269,0,3280
test4sub83of100,test4pub100of100,100,194,10,2880,1,2891
test4sub89of100,test4pub90of100,100,193,11,5334,1,5346
test4sub89of100,test4pub91of100,100,193,11,5001,0,5012
test4sub90of100,test4pub95of100,100,193,11,3944,1,3956
test4sub42of100,test4pub94of100,100,193,11,4216,1,4228
test4sub90of100,test4pub96of100,100,193,11,3560,0,3571
test4sub90of100,test4pub97of100,100,193,11,3406,1,3418
test4sub42of100,test4pub95of100,100,193,11,3947,1,3959
test4sub42of100,test4pub96of100,100,193,11,3564,1,3576
test4sub90of100,test4pub98of100,100,193,11,3286,1,3298
test4sub42of100,test4pub97of100,100,193,11,3409,1,3421
test4sub90of100,test4pub99of100,100,193,10,3136,1,3147
test4sub42of100,test4pub98of100,100,193,11,3290,1,3302
test4sub90of100,test4pub100of100,100,194,10,3022,0,3032
test4sub42of100,test4pub99of100,100,193,10,3139,1,3150
test4sub69of100,test4pub98of100,100,193,11,3302,1,3314
test4sub69of100,test4pub99of100,100,193,10,3150,0,3160
test4sub69of100,test4pub100of100,100,194,10,3036,1,3047
test4sub42of100,test4pub100of100,100,194,10,3106,1,3117
test4sub94of100,test4pub95of100,100,193,11,4045,0,4056
test4sub94of100,test4pub96of100,100,193,11,3660,1,3672
test4sub94of100,test4pub97of100,100,193,11,3506,1,3518
test4sub94of100,test4pub98of100,100,193,11,3386,0,3397
test4sub89of100,test4pub92of100,100,193,10,4851,1,4862
test4sub94of100,test4pub99of100,100,193,10,3235,3,3248
test4sub89of100,test4pub93of100,100,193,10,4740,1,4751
test4sub94of100,test4pub100of100,100,194,10,3122,1,3133
test4sub89of100,test4pub94of100,100,193,11,4325,1,4337
test4sub89of100,test4pub95of100,100,193,11,4056,0,4067
test4sub89of100,test4pub96of100,100,193,11,3672,1,3684
test4sub89of100,test4pub97of100,100,193,11,3517,0,3528
test4sub89of100,test4pub98of100,100,193,11,3398,1,3410
test4sub89of100,test4pub99of100,100,193,10,3246,1,3257
test4sub89of100,test4pub100of100,100,194,10,3131,0,3141
test4sub78of100,test4pub3of100,100,192,28,43324,0,43352
test4sub78of100,test4pub4of100,100,192,11,41981,1,41993
test4sub78of100,test4pub5of100,100,192,14,40984,0,40998
test4sub78of100,test4pub6of100,100,192,26,40672,0,40698
test4sub78of100,test4pub7of100,100,192,14,40040,1,40055
test4sub78of100,test4pub8of100,100,192,12,39777,0,39789
test4sub78of100,test4pub9of100,100,192,20,39593,1,39614
test4sub78of100,test4pub10of100,100,193,11,39230,1,39242
test4sub78of100,test4pub11of100,100,193,10,38994,0,39004
test4sub78of100,test4pub12of100,100,193,11,38551,1,38563
test4sub78of100,test4pub13of100,100,193,10,38349,1,38360
test4sub78of100,test4pub14of100,100,193,10,38182,0,38192
test4sub78of100,test4pub15of100,100,193,11,38045,1,38057
test4sub78of100,test4pub16of100,100,193,10,37888,1,37899
test4sub78of100,test4pub17of100,100,193,11,37754,0,37765
test4sub78of100,test4pub18of100,100,193,18,37570,1,37589
test4sub78of100,test4pub19of100,100,193,11,37361,0,37372
test4sub78of100,test4pub20of100,100,193,10,36920,0,36930
test4sub78of100,test4pub21of100,100,193,10,36835,1,36846
test4sub78of100,test4pub22of100,100,193,10,36704,1,36715
test4sub78of100,test4pub24of100,100,193,19,36411,0,36430
test4sub78of100,test4pub23of100,100,193,11,36543,1,36555
test4sub78of100,test4pub25of100,100,193,16,36011,1,36028
test4sub78of100,test4pub26of100,100,193,10,35795,0,35805
test4sub78of100,test4pub27of100,100,193,10,35474,1,35485
test4sub78of100,test4pub28of100,100,193,10,35374,1,35385
test4sub78of100,test4pub29of100,100,193,11,35209,0,35220
test4sub78of100,test4pub30of100,100,193,15,35074,1,35090
test4sub78of100,test4pub31of100,100,193,10,34941,0,34951
test4sub78of100,test4pub32of100,100,193,11,34590,1,34602
test4sub78of100,test4pub33of100,100,193,11,34449,0,34460
test4sub78of100,test4pub34of100,100,193,12,33670,1,33683
test4sub78of100,test4pub35of100,100,193,12,31316,1,31329
test4sub78of100,test4pub36of100,100,193,10,30041,0,30051
test4sub78of100,test4pub37of100,100,193,23,29684,1,29708
test4sub78of100,test4pub38of100,100,193,31,29425,1,29457
test4sub78of100,test4pub39of100,100,193,28,29292,1,29321
test4sub78of100,test4pub40of100,100,193,49,29113,0,29162
test4sub78of100,test4pub41of100,100,193,27,28989,1,29017
test4sub78of100,test4pub42of100,100,193,31,28859,0,28890
test4sub78of100,test4pub43of100,100,193,28,28720,1,28749
test4sub78of100,test4pub44of100,100,193,17,28573,0,28590
test4sub78of100,test4pub45of100,100,193,20,28459,1,28480
test4sub78of100,test4pub46of100,100,193,12,28110,0,28122
test4sub78of100,test4pub47of100,100,193,10,27697,1,27708
test4sub78of100,test4pub48of100,100,193,10,27537,0,27547
test4sub78of100,test4pub49of100,100,193,11,27341,1,27353
test4sub78of100,test4pub50of100,100,193,17,27186,0,27203
test4sub78of100,test4pub51of100,100,193,16,27018,1,27035
test4sub78of100,test4pub52of100,100,193,10,26873,1,26884
test4sub78of100,test4pub53of100,100,193,10,26509,1,26520
test4sub78of100,test4pub54of100,100,193,11,26344,0,26355
test4sub78of100,test4pub55of100,100,193,10,26078,1,26089
test4sub78of100,test4pub56of100,100,193,11,25188,1,25200
test4sub78of100,test4pub57of100,100,193,11,25045,0,25056
test4sub78of100,test4pub58of100,100,193,11,24081,1,24093
test4sub78of100,test4pub59of100,100,193,12,23548,1,23561
test4sub78of100,test4pub60of100,100,193,18,23189,1,23208
test4sub78of100,test4pub61of100,100,193,11,22681,1,22693
test4sub78of100,test4pub62of100,100,193,12,21889,0,21901
test4sub78of100,test4pub63of100,100,193,15,20626,1,20642
test4sub78of100,test4pub65of100,100,193,11,18758,1,18770
test4sub78of100,test4pub64of100,100,193,11,20300,0,20311
test4sub78of100,test4pub66of100,100,193,16,18740,1,18757
test4sub78of100,test4pub67of100,100,193,11,18641,0,18652
test4sub78of100,test4pub68of100,100,193,11,14883,1,14895
test4sub78of100,test4pub69of100,100,193,10,14706,1,14717
test4sub78of100,test4pub70of100,100,193,10,14488,0,14498
test4sub78of100,test4pub71of100,100,193,10,14291,1,14302
test4sub78of100,test4pub72of100,100,193,12,13926,1,13939
test4sub78of100,test4pub73of100,100,193,11,13701,0,13712
test4sub78of100,test4pub74of100,100,193,11,13543,1,13555
test4sub78of100,test4pub75of100,100,193,14,13321,0,13335
test4sub78of100,test4pub76of100,100,193,10,12953,1,12964
test4sub78of100,test4pub77of100,100,193,11,12533,0,12544
test4sub78of100,test4pub78of100,100,193,11,11979,1,11991
test4sub78of100,test4pub79of100,100,193,14,11664,1,11679
test4sub78of100,test4pub80of100,100,193,10,11317,0,11327
test4sub78of100,test4pub81of100,100,193,17,11007,0,11024
test4sub78of100,test4pub82of100,100,193,11,10824,1,10836
test4sub78of100,test4pub83of100,100,193,14,10414,0,10428
test4sub78of100,test4pub84of100,100,193,14,9939,1,9954
test4sub78of100,test4pub85of100,100,193,10,9699,0,9709
test4sub78of100,test4pub86of100,100,193,16,9168,1,9185
test4sub78of100,test4pub87of100,100,193,11,8505,0,8516
test4sub78of100,test4pub88of100,100,193,11,7113,0,7124
test4sub78of100,test4pub89of100,100,193,11,7087,1,7099
test4sub78of100,test4pub90of100,100,193,11,6930,0,6941
test4sub78of100,test4pub91of100,100,193,11,6598,1,6610
test4sub78of100,test4pub92of100,100,193,10,6231,1,6242
test4sub78of100,test4pub93of100,100,193,10,6120,0,6130
test4sub78of100,test4pub94of100,100,193,11,5705,1,5717
test4sub78of100,test4pub95of100,100,193,11,5435,1,5447
test4sub78of100,test4pub96of100,100,193,11,5050,1,5062
test4sub78of100,test4pub97of100,100,193,11,4896,1,4908
test4sub78of100,test4pub98of100,100,193,11,4776,0,4787
test4sub78of100,test4pub99of100,100,193,10,4625,1,4636
test4sub78of100,test4pub100of100,100,194,10,4510,1,4521
test4sub36of100,test4pub86of100,100,193,16,9666,0,9682
test4sub36of100,test4pub87of100,100,193,11,9004,1,9016
test4sub36of100,test4pub88of100,100,193,11,7612,0,7623
test4sub36of100,test4pub89of100,100,193,11,7585,0,7596
test4sub36of100,test4pub90of100,100,193,11,7429,1,7441
test4sub36of100,test4pub91of100,100,193,11,7096,0,7107
test4sub36of100,test4pub92of100,100,193,10,6716,1,6727
test4sub36of100,test4pub93of100,100,193,10,6636,0,6646
test4sub36of100,test4pub94of100,100,193,11,6221,1,6233
test4sub36of100,test4pub95of100,100,193,11,5951,0,5962
test4sub36of100,test4pub96of100,100,193,11,5567,1,5579
test4sub36of100,test4pub97of100,100,193,11,5412,0,5423
test4sub36of100,test4pub98of100,100,193,11,5292,1,5304
test4sub36of100,test4pub99of100,100,193,10,5141,1,5152
test4sub36of100,test4pub100of100,100,194,10,5026,0,5036
test4sub19of100,test4pub1of100,100,12977,24,44551,42,44617
test4sub19of100,test4pub3of100,100,192,28,44463,1,44492
test4sub19of100,test4pub4of100,100,192,11,43119,0,43130
test4sub19of100,test4pub5of100,100,192,14,42123,1,42138
test4sub19of100,test4pub6of100,100,192,26,41800,0,41826
test4sub19of100,test4pub7of100,100,192,14,41167,0,41181
test4sub19of100,test4pub8of100,100,192,12,40905,1,40918
test4sub19of100,test4pub9of100,100,192,20,40721,0,40741
test4sub19of100,test4pub10of100,100,193,11,40357,0,40368
test4sub19of100,test4pub11of100,100,193,10,40122,1,40133
test4sub19of100,test4pub12of100,100,193,11,39679,1,39691
test4sub19of100,test4pub13of100,100,193,10,39476,0,39486
test4sub19of100,test4pub14of100,100,193,10,39310,1,39321
test4sub19of100,test4pub15of100,100,193,11,39172,0,39183
test4sub19of100,test4pub16of100,100,193,10,39015,0,39025
test4sub19of100,test4pub17of100,100,193,11,38882,1,38894
test4sub19of100,test4pub18of100,100,193,18,38697,0,38715
test4sub19of100,test4pub19of100,100,193,11,38489,1,38501
test4sub19of100,test4pub20of100,100,193,10,38048,1,38059
test4sub19of100,test4pub21of100,100,193,10,37962,0,37972
test4sub19of100,test4pub22of100,100,193,10,37832,1,37843
test4sub19of100,test4pub23of100,100,193,11,37660,1,37672
test4sub19of100,test4pub24of100,100,193,19,37531,0,37550
test4sub19of100,test4pub25of100,100,193,16,37110,1,37127
test4sub19of100,test4pub26of100,100,193,10,36893,1,36904
test4sub19of100,test4pub27of100,100,193,10,36572,0,36582
test4sub19of100,test4pub28of100,100,193,10,36471,0,36481
test4sub19of100,test4pub29of100,100,193,11,36307,1,36319
test4sub19of100,test4pub30of100,100,193,15,36171,0,36186
test4sub19of100,test4pub31of100,100,193,10,36038,1,36049
test4sub19of100,test4pub32of100,100,193,11,35687,1,35699
test4sub19of100,test4pub33of100,100,193,11,35546,0,35557
test4sub19of100,test4pub34of100,100,193,12,34766,0,34778
test4sub19of100,test4pub35of100,100,193,12,32413,1,32426
test4sub19of100,test4pub36of100,100,193,10,31138,0,31148
test4sub19of100,test4pub37of100,100,193,23,30779,1,30803
test4sub19of100,test4pub38of100,100,193,31,30520,0,30551
test4sub19of100,test4pub39of100,100,193,28,30372,1,30401
test4sub19of100,test4pub40of100,100,193,49,30194,0,30243
test4sub19of100,test4pub41of100,100,193,27,30069,0,30096
test4sub19of100,test4pub42of100,100,193,31,29927,1,29959
test4sub19of100,test4pub43of100,100,193,28,29787,1,29816
test4sub19of100,test4pub44of100,100,193,17,29641,1,29659
test4sub19of100,test4pub45of100,100,193,20,29513,0,29533
test4sub19of100,test4pub46of100,100,193,12,29165,1,29178
test4sub19of100,test4pub47of100,100,193,10,28751,1,28762
test4sub19of100,test4pub48of100,100,193,10,28591,0,28601
test4sub19of100,test4pub49of100,100,193,11,28396,1,28408
test4sub19of100,test4pub50of100,100,193,17,28225,0,28242
test4sub19of100,test4pub51of100,100,193,16,28057,1,28074
test4sub19of100,test4pub52of100,100,193,10,27912,0,27922
test4sub19of100,test4pub53of100,100,193,10,27544,0,27554
test4sub19of100,test4pub54of100,100,193,11,27380,1,27392
test4sub19of100,test4pub55of100,100,193,10,27113,1,27124
test4sub19of100,test4pub56of100,100,193,11,26280,1,26292
test4sub19of100,test4pub57of100,100,193,11,26137,1,26149
test4sub19of100,test4pub58of100,100,193,11,25173,1,25185
test4sub19of100,test4pub59of100,100,193,12,24628,0,24640
test4sub19of100,test4pub60of100,100,193,18,24270,1,24289
test4sub19of100,test4pub61of100,100,193,11,23761,0,23772
test4sub19of100,test4pub62of100,100,193,12,22970,1,22983
test4sub19of100,test4pub63of100,100,193,15,21706,0,21721
test4sub19of100,test4pub64of100,100,193,11,21403,0,21414
test4sub19of100,test4pub65of100,100,193,11,19864,1,19876
test4sub19of100,test4pub66of100,100,193,16,19844,0,19860
test4sub19of100,test4pub67of100,100,193,11,19764,0,19775
test4sub19of100,test4pub68of100,100,193,11,16007,1,16019
test4sub19of100,test4pub69of100,100,193,10,15829,0,15839
test4sub19of100,test4pub70of100,100,193,10,15623,1,15634
test4sub19of100,test4pub71of100,100,193,10,15426,0,15436
test4sub19of100,test4pub72of100,100,193,12,15052,1,15065
test4sub19of100,test4pub73of100,100,193,11,14828,1,14840
test4sub19of100,test4pub74of100,100,193,11,14669,0,14680
test4sub19of100,test4pub75of100,100,193,14,14450,1,14465
test4sub19of100,test4pub76of100,100,193,10,14081,0,14091
test4sub19of100,test4pub77of100,100,193,11,13661,1,13673
test4sub19of100,test4pub78of100,100,193,11,13108,0,13119
test4sub19of100,test4pub79of100,100,193,14,12792,1,12807
test4sub19of100,test4pub80of100,100,193,10,12446,1,12457
test4sub19of100,test4pub81of100,100,193,17,12134,1,12152
test4sub19of100,test4pub82of100,100,193,11,11951,1,11963
test4sub19of100,test4pub83of100,100,193,14,11541,0,11555
test4sub19of100,test4pub84of100,100,193,14,11068,1,11083
test4sub19of100,test4pub85of100,100,193,10,10829,1,10840
test4sub19of100,test4pub86of100,100,193,16,10349,1,10366
test4sub19of100,test4pub87of100,100,193,11,9686,0,9697
test4sub19of100,test4pub89of100,100,193,11,8267,1,8279
test4sub74of100,test4pub70of100,100,193,10,17372,1,17383
test4sub74of100,test4pub71of100,100,193,10,17285,0,17295
test4sub74of100,test4pub72of100,100,193,12,16912,1,16925
test4sub74of100,test4pub73of100,100,193,11,16687,1,16699
test4sub74of100,test4pub74of100,100,193,11,16528,1,16540
test4sub74of100,test4pub75of100,100,193,14,16307,1,16322
test4sub74of100,test4pub76of100,100,193,10,15938,0,15948
test4sub74of100,test4pub77of100,100,193,11,15519,1,15531
test4sub74of100,test4pub78of100,100,193,11,14965,0,14976
test4sub74of100,test4pub79of100,100,193,14,14649,0,14663
test4sub74of100,test4pub80of100,100,193,10,14303,1,14314
test4sub74of100,test4pub81of100,100,193,17,13962,0,13979
test4sub74of100,test4pub82of100,100,193,11,13778,0,13789
test4sub74of100,test4pub83of100,100,193,14,13369,1,13384
test4sub74of100,test4pub84of100,100,193,14,12893,1,12908
test4sub74of100,test4pub85of100,100,193,10,12653,0,12663
test4sub74of100,test4pub86of100,100,193,16,12122,1,12139
test4sub74of100,test4pub87of100,100,193,11,11459,1,11471
test4sub74of100,test4pub88of100,100,193,11,10067,0,10078
test4sub74of100,test4pub89of100,100,193,11,10041,1,10053
test4sub74of100,test4pub90of100,100,193,11,9884,1,9896
test4sub74of100,test4pub91of100,100,193,11,9551,0,9562
test4sub74of100,test4pub92of100,100,193,10,9171,1,9182
test4sub74of100,test4pub93of100,100,193,10,9059,0,9069
test4sub74of100,test4pub94of100,100,193,11,8644,1,8656
test4sub74of100,test4pub95of100,100,193,11,8374,0,8385
test4sub74of100,test4pub96of100,100,193,11,7989,1,8001
test4sub74of100,test4pub97of100,100,193,11,7835,1,7847
test4sub74of100,test4pub98of100,100,193,11,7715,0,7726
test4sub74of100,test4pub99of100,100,193,10,7563,0,7573
test4sub74of100,test4pub100of100,100,194,10,7449,1,7460
test4sub2of100,test4pub65of100,10,192,10,68950,1,68961
test4sub2of100,test4pub66of100,10,192,17,68825,1,68843
test4sub2of100,test4pub67of100,10,192,11,68648,1,68660
test4sub2of100,test4pub68of100,10,192,10,68431,1,68442
test4sub2of100,test4pub69of100,10,192,14,68182,1,68197
test4sub2of100,test4pub70of100,10,192,10,68084,1,68095
test4sub2of100,test4pub71of100,10,192,11,67948,1,67960
test4sub2of100,test4pub72of100,10,192,18,63106,0,63124
test4sub2of100,test4pub73of100,10,192,11,62229,1,62241
test4sub2of100,test4pub74of100,10,192,10,61603,0,61613
test4sub2of100,test4pub75of100,10,192,10,60921,1,60932
test4sub2of100,test4pub76of100,10,192,10,60771,1,60782
test4sub2of100,test4pub77of100,10,192,10,60311,0,60321
test4sub2of100,test4pub78of100,10,192,12,60246,1,60259
test4sub2of100,test4pub79of100,10,191,9,60168,0,60177
test4sub2of100,test4pub80of100,10,192,10,59771,1,59782
test4sub2of100,test4pub81of100,10,192,17,59667,1,59685
test4sub2of100,test4pub82of100,10,192,10,59513,0,59523
test4sub2of100,test4pub83of100,10,192,10,59365,1,59376
test4sub2of100,test4pub84of100,10,192,11,58886,1,58898
test4sub2of100,test4pub85of100,10,192,23,57355,0,57378
test4sub2of100,test4pub86of100,10,192,21,56930,1,56952
test4sub2of100,test4pub87of100,10,192,10,56705,0,56715
test4sub2of100,test4pub88of100,10,192,11,56481,1,56493
test4sub2of100,test4pub89of100,10,192,39,55504,1,55544
test4sub2of100,test4pub90of100,10,192,23,55346,1,55370
test4sub2of100,test4pub91of100,10,192,26,55183,0,55209
test4sub2of100,test4pub92of100,10,192,12,55014,0,55026
test4sub2of100,test4pub93of100,10,192,13,54687,1,54701
test4sub2of100,test4pub94of100,10,192,10,54097,0,54107
test4sub2of100,test4pub95of100,10,192,17,53750,0,53767
test4sub2of100,test4pub96of100,10,192,10,53588,1,53599
test4sub2of100,test4pub97of100,10,192,10,53450,1,53461
test4sub2of100,test4pub98of100,10,192,11,53311,1,53323
test4sub2of100,test4pub99of100,10,192,10,53104,1,53115
test4sub2of100,test4pub100of100,10,193,15,52983,1,52999
test4sub2of100,test4pub2of100,100,192,10,47755,0,47765
test4sub2of100,test4pub1of100,100,12977,24,47836,45,47905
test4sub2of100,test4pub3of100,100,192,28,47751,1,47780
test4sub2of100,test4pub4of100,100,192,11,46407,1,46419
test4sub2of100,test4pub5of100,100,192,14,45411,1,45426
test4sub2of100,test4pub6of100,100,192,26,45088,0,45114
test4sub2of100,test4pub7of100,100,192,14,44456,1,44471
test4sub2of100,test4pub8of100,100,192,12,44193,0,44205
test4sub2of100,test4pub9of100,100,192,20,44009,1,44030
test4sub2of100,test4pub10of100,100,193,11,43646,1,43658
test4sub2of100,test4pub11of100,100,193,10,43410,0,43420
test4sub2of100,test4pub12of100,100,193,11,42968,1,42980
test4sub2of100,test4pub13of100,100,193,10,42765,1,42776
test4sub2of100,test4pub14of100,100,193,10,42598,0,42608
test4sub2of100,test4pub15of100,100,193,11,42461,1,42473
test4sub2of100,test4pub16of100,100,193,10,42304,1,42315
test4sub2of100,test4pub17of100,100,193,11,42170,0,42181
test4sub2of100,test4pub18of100,100,193,18,41986,1,42005
test4sub2of100,test4pub19of100,100,193,11,41777,1,41789
test4sub2of100,test4pub20of100,100,193,10,41336,0,41346
test4sub2of100,test4pub21of100,100,193,10,41251,1,41262
test4sub2of100,test4pub22of100,100,193,10,41120,0,41130
test4sub2of100,test4pub23of100,100,193,11,40948,0,40959
test4sub2of100,test4pub24of100,100,193,19,40820,1,40840
test4sub2of100,test4pub25of100,100,193,16,40398,0,40414
test4sub2of100,test4pub27of100,100,193,10,39859,0,39869
test4sub2of100,test4pub26of100,100,193,10,40183,1,40194
test4sub2of100,test4pub28of100,100,193,10,39760,0,39770
test4sub2of100,test4pub29of100,100,193,11,39595,0,39606
test4sub2of100,test4pub30of100,100,193,15,39460,1,39476
test4sub2of100,test4pub31of100,100,193,10,39327,0,39337
test4sub2of100,test4pub32of100,100,193,11,38975,1,38987
test4sub2of100,test4pub33of100,100,193,11,38835,1,38847
test4sub2of100,test4pub34of100,100,193,12,38055,0,38067
test4sub2of100,test4pub35of100,100,193,12,35702,1,35715
test4sub2of100,test4pub36of100,100,193,10,34427,1,34438
test4sub2of100,test4pub37of100,100,193,23,34067,0,34090
test4sub2of100,test4pub38of100,100,193,31,33808,0,33839
test4sub2of100,test4pub39of100,100,193,28,33661,1,33690
test4sub2of100,test4pub40of100,100,193,49,33482,0,33531
test4sub2of100,test4pub41of100,100,193,27,33357,0,33384
test4sub2of100,test4pub42of100,100,193,31,33215,1,33247
test4sub2of100,test4pub43of100,100,193,28,33075,0,33103
test4sub2of100,test4pub44of100,100,193,17,32928,0,32945
test4sub2of100,test4pub45of100,100,193,20,32801,1,32822
test4sub2of100,test4pub46of100,100,193,12,32452,0,32464
test4sub2of100,test4pub47of100,100,193,10,32038,0,32048
test4sub2of100,test4pub48of100,100,193,10,31892,0,31902
test4sub2of100,test4pub49of100,100,193,11,31697,1,31709
test4sub2of100,test4pub50of100,100,193,17,31526,1,31544
test4sub2of100,test4pub51of100,100,193,16,31358,1,31375
test4sub2of100,test4pub52of100,100,193,10,31213,0,31223
test4sub2of100,test4pub53of100,100,193,10,30846,1,30857
test4sub2of100,test4pub54of100,100,193,11,30681,1,30693
test4sub2of100,test4pub55of100,100,193,10,30414,0,30424
test4sub2of100,test4pub56of100,100,193,11,29522,1,29534
test4sub2of100,test4pub57of100,100,193,11,29379,0,29390
test4sub2of100,test4pub58of100,100,193,11,28414,1,28426
test4sub2of100,test4pub59of100,100,193,12,27867,1,27880
test4sub2of100,test4pub60of100,100,193,18,27508,0,27526
test4sub2of100,test4pub61of100,100,193,11,27000,1,27012
test4sub2of100,test4pub62of100,100,193,12,26208,1,26221
test4sub2of100,test4pub63of100,100,193,15,24944,0,24959
test4sub2of100,test4pub64of100,100,193,11,24618,1,24630
test4sub2of100,test4pub65of100,100,193,11,23102,0,23113
test4sub61of100,test4pub86of100,10,192,21,57205,1,57227
test4sub61of100,test4pub87of100,10,192,10,56976,0,56986
test4sub2of100,test4pub66of100,100,193,16,23083,1,23100
test4sub61of100,test4pub88of100,10,192,11,56752,1,56764
test4sub2of100,test4pub67of100,100,193,11,22985,1,22997
test4sub2of100,test4pub68of100,100,193,11,19230,1,19242
test4sub2of100,test4pub69of100,100,193,10,19053,1,19064
test4sub2of100,test4pub70of100,100,193,10,18835,0,18845
test4sub2of100,test4pub71of100,100,193,10,18638,1,18649
test4sub2of100,test4pub72of100,100,193,12,18264,1,18277
test4sub2of100,test4pub73of100,100,193,11,18040,1,18052
test4sub2of100,test4pub74of100,100,193,11,17881,0,17892
test4sub2of100,test4pub75of100,100,193,14,17659,1,17674
test4sub2of100,test4pub76of100,100,193,10,17291,0,17301
test4sub2of100,test4pub77of100,100,193,11,16871,1,16883
test4sub2of100,test4pub78of100,100,193,11,16318,1,16330
test4sub2of100,test4pub79of100,100,193,14,16002,0,16016
test4sub2of100,test4pub80of100,100,193,10,15656,1,15667
test4sub2of100,test4pub81of100,100,193,17,15340,0,15357
test4sub2of100,test4pub82of100,100,193,11,15157,1,15169
test4sub2of100,test4pub83of100,100,193,14,14747,1,14762
test4sub2of100,test4pub84of100,100,193,14,14272,1,14287
test4sub2of100,test4pub85of100,100,193,10,14032,0,14042
test4sub2of100,test4pub86of100,100,193,16,13501,1,13518
test4sub2of100,test4pub87of100,100,193,11,12838,1,12850
test4sub2of100,test4pub89of100,100,193,11,11419,0,11430
test4sub2of100,test4pub88of100,100,193,11,11448,1,11460
test4sub2of100,test4pub90of100,100,193,11,11264,1,11276
test4sub2of100,test4pub91of100,100,193,11,10931,0,10942
test4sub2of100,test4pub92of100,100,193,10,10552,1,10563
test4sub2of100,test4pub93of100,100,193,10,10440,0,10450
test4sub2of100,test4pub94of100,100,193,11,10025,1,10037
test4sub2of100,test4pub95of100,100,193,11,9755,1,9767
test4sub2of100,test4pub96of100,100,193,11,9370,0,9381
test4sub2of100,test4pub97of100,100,193,11,9216,1,9228
test4sub61of100,test4pub89of100,10,192,39,55840,1,55880
test4sub61of100,test4pub90of100,10,192,23,55682,1,55706
test4sub61of100,test4pub91of100,10,192,26,55519,1,55546
test4sub61of100,test4pub92of100,10,192,12,55347,1,55360
test4sub61of100,test4pub93of100,10,192,13,55020,1,55034
test4sub61of100,test4pub94of100,10,192,10,54430,0,54440
test4sub61of100,test4pub95of100,10,192,17,54074,1,54092
test4sub61of100,test4pub96of100,10,192,10,53911,1,53922
test4sub61of100,test4pub97of100,10,192,10,53773,0,53783
test4sub61of100,test4pub98of100,10,192,11,53627,1,53639
test4sub61of100,test4pub99of100,10,192,10,53419,1,53430
test4sub61of100,test4pub100of100,10,193,15,53298,0,53313
test4sub61of100,test4pub2of100,100,192,10,48068,1,48079
test4sub61of100,test4pub3of100,100,192,28,47971,1,48000
test4sub2of100,test4pub98of100,100,193,11,9118,1,9130
test4sub2of100,test4pub99of100,100,193,10,8966,0,8976
test4sub2of100,test4pub100of100,100,194,10,8852,1,8863
test4sub61of100,test4pub1of100,100,12977,24,48159,136,48319
test4sub61of100,test4pub4of100,100,192,11,46821,3,46835
test4sub61of100,test4pub5of100,100,192,14,45828,1,45843
test4sub61of100,test4pub6of100,100,192,26,45505,0,45531
test4sub61of100,test4pub7of100,100,192,14,44873,1,44888
test4sub61of100,test4pub8of100,100,192,12,44610,0,44622
test4sub61of100,test4pub9of100,100,192,20,44427,1,44448
test4sub61of100,test4pub10of100,100,193,11,44063,0,44074
test4sub61of100,test4pub11of100,100,193,10,43828,1,43839
test4sub61of100,test4pub12of100,100,193,11,43385,0,43396
test4sub61of100,test4pub13of100,100,193,10,43182,1,43193
test4sub61of100,test4pub14of100,100,193,10,43016,0,43026
test4sub61of100,test4pub15of100,100,193,11,42878,1,42890
test4sub61of100,test4pub16of100,100,193,10,42722,1,42733
test4sub61of100,test4pub17of100,100,193,11,42588,1,42600
test4sub61of100,test4pub18of100,100,193,18,42404,1,42423
test4sub61of100,test4pub19of100,100,193,11,42195,0,42206
test4sub61of100,test4pub20of100,100,193,10,41755,1,41766
test4sub61of100,test4pub21of100,100,193,10,41669,0,41679
test4sub61of100,test4pub22of100,100,193,10,41538,1,41549
test4sub61of100,test4pub23of100,100,193,11,41367,1,41379
test4sub61of100,test4pub24of100,100,193,19,41238,0,41257
test4sub61of100,test4pub25of100,100,193,16,40817,1,40834
test4sub61of100,test4pub26of100,100,193,10,40600,1,40611
test4sub61of100,test4pub27of100,100,193,10,40279,0,40289
test4sub61of100,test4pub28of100,100,193,10,40179,1,40190
test4sub61of100,test4pub29of100,100,193,11,40014,0,40025
test4sub61of100,test4pub30of100,100,193,15,39879,1,39895
test4sub61of100,test4pub31of100,100,193,10,39746,0,39756
test4sub61of100,test4pub32of100,100,193,11,39395,1,39407
test4sub61of100,test4pub33of100,100,193,11,39254,0,39265
test4sub61of100,test4pub34of100,100,193,12,38474,0,38486
test4sub61of100,test4pub35of100,100,193,12,36121,1,36134
test4sub61of100,test4pub36of100,100,193,10,34846,0,34856
test4sub61of100,test4pub37of100,100,193,23,34487,1,34511
test4sub61of100,test4pub38of100,100,193,31,34228,0,34259
test4sub61of100,test4pub39of100,100,193,28,34080,1,34109
test4sub61of100,test4pub40of100,100,193,49,33902,0,33951
test4sub61of100,test4pub41of100,100,193,27,33778,1,33806
test4sub61of100,test4pub42of100,100,193,31,33635,1,33667
test4sub61of100,test4pub43of100,100,193,28,33495,1,33524
test4sub61of100,test4pub44of100,100,193,17,33349,1,33367
test4sub61of100,test4pub45of100,100,193,20,33221,1,33242
test4sub61of100,test4pub46of100,100,193,12,32873,1,32886
test4sub61of100,test4pub47of100,100,193,10,32459,0,32469
test4sub61of100,test4pub48of100,100,193,10,32300,1,32311
test4sub61of100,test4pub49of100,100,193,11,32104,0,32115
test4sub61of100,test4pub50of100,100,193,17,31933,1,31951
test4sub61of100,test4pub51of100,100,193,16,31765,1,31782
test4sub61of100,test4pub52of100,100,193,10,31620,0,31630
test4sub61of100,test4pub53of100,100,193,10,31253,1,31264
test4sub61of100,test4pub54of100,100,193,11,31088,1,31100
test4sub61of100,test4pub55of100,100,193,10,30821,0,30831
test4sub61of100,test4pub56of100,100,193,11,29929,1,29941
test4sub61of100,test4pub57of100,100,193,11,29786,1,29798
test4sub61of100,test4pub58of100,100,193,11,28821,0,28832
test4sub61of100,test4pub59of100,100,193,12,28274,1,28287
test4sub61of100,test4pub60of100,100,193,18,27915,0,27933
test4sub61of100,test4pub61of100,100,193,11,27406,0,27417
test4sub61of100,test4pub62of100,100,193,12,26615,1,26628
test4sub61of100,test4pub63of100,100,193,15,25351,0,25366
test4sub61of100,test4pub65of100,100,193,11,23483,0,23494
test4sub61of100,test4pub64of100,100,193,11,25026,1,25038
test4sub61of100,test4pub66of100,100,193,16,23465,0,23481
test4sub61of100,test4pub67of100,100,193,11,23366,1,23378
test4sub61of100,test4pub68of100,100,193,11,19609,1,19621
test4sub61of100,test4pub69of100,100,193,10,19431,0,19441
test4sub61of100,test4pub70of100,100,193,10,19214,1,19225
test4sub61of100,test4pub71of100,100,193,10,19016,1,19027
test4sub61of100,test4pub72of100,100,193,12,18642,0,18654
test4sub61of100,test4pub73of100,100,193,11,18418,1,18430
test4sub61of100,test4pub74of100,100,193,11,18259,0,18270
test4sub61of100,test4pub75of100,100,193,14,18037,0,18051
test4sub61of100,test4pub76of100,100,193,10,17669,1,17680
test4sub61of100,test4pub77of100,100,193,11,17249,0,17260
test4sub61of100,test4pub78of100,100,193,11,16695,0,16706
test4sub61of100,test4pub79of100,100,193,14,16380,1,16395
test4sub61of100,test4pub80of100,100,193,10,16033,0,16043
test4sub61of100,test4pub81of100,100,193,17,15692,0,15709
test4sub61of100,test4pub82of100,100,193,11,15509,1,15521
test4sub61of100,test4pub83of100,100,193,14,15099,0,15113
test4sub61of100,test4pub84of100,100,193,14,14623,0,14637
test4sub61of100,test4pub85of100,100,193,10,14384,1,14395
test4sub61of100,test4pub86of100,100,193,16,13852,0,13868
test4sub61of100,test4pub87of100,100,193,11,13189,0,13200
test4sub61of100,test4pub89of100,100,193,11,11770,1,11782
test4sub61of100,test4pub88of100,100,193,11,11799,0,11810
test4sub61of100,test4pub90of100,100,193,11,11615,1,11627
test4sub61of100,test4pub91of100,100,193,11,11282,1,11294
test4sub61of100,test4pub92of100,100,193,10,10902,1,10913
test4sub61of100,test4pub93of100,100,193,10,10790,1,10801
test4sub61of100,test4pub94of100,100,193,11,10375,1,10387
test4sub61of100,test4pub95of100,100,193,11,10105,1,10117
test4sub61of100,test4pub96of100,100,193,11,9721,1,9733
test4sub61of100,test4pub97of100,100,193,11,9566,0,9577
test4sub61of100,test4pub98of100,100,193,11,9447,1,9459
test4sub61of100,test4pub99of100,100,193,10,9295,1,9306
test4sub61of100,test4pub100of100,100,194,10,9180,0,9190
test4sub19of100,test4pub88of100,100,193,11,11863,1,11875
test4sub19of100,test4pub90of100,100,193,11,11678,1,11690
test4sub19of100,test4pub91of100,100,193,11,11346,1,11358
test4sub19of100,test4pub92of100,100,193,10,10965,0,10975
test4sub19of100,test4pub93of100,100,193,10,10854,1,10865
test4sub19of100,test4pub94of100,100,193,11,10438,0,10449
test4sub19of100,test4pub95of100,100,193,11,10168,1,10180
test4sub19of100,test4pub96of100,100,193,11,9784,1,9796
test4sub19of100,test4pub97of100,100,193,11,9629,0,9640
test4sub19of100,test4pub98of100,100,193,11,9509,0,9520
test4sub19of100,test4pub99of100,100,193,10,9358,1,9369
test4sub19of100,test4pub100of100,100,194,10,9243,1,9254
test4sub35of100,test4pub1of100,100,12977,24,49619,45,49688
test4sub35of100,test4pub3of100,100,192,28,49535,1,49564
test4sub35of100,test4pub4of100,100,192,11,48191,1,48203
test4sub35of100,test4pub5of100,100,192,14,47195,1,47210
test4sub35of100,test4pub6of100,100,192,26,46872,0,46898
test4sub35of100,test4pub7of100,100,192,14,46240,1,46255
test4sub35of100,test4pub8of100,100,192,12,45977,0,45989
test4sub35of100,test4pub9of100,100,192,20,45793,1,45814
test4sub35of100,test4pub10of100,100,193,11,45430,1,45442
test4sub35of100,test4pub11of100,100,193,10,45194,0,45204
test4sub35of100,test4pub12of100,100,193,11,44752,1,44764
test4sub35of100,test4pub13of100,100,193,10,44549,1,44560
test4sub35of100,test4pub14of100,100,193,10,44382,0,44392
test4sub35of100,test4pub15of100,100,193,11,44245,1,44257
test4sub35of100,test4pub16of100,100,193,10,44088,0,44098
test4sub35of100,test4pub17of100,100,193,11,43954,0,43965
test4sub35of100,test4pub18of100,100,193,18,43770,1,43789
test4sub35of100,test4pub19of100,100,193,11,43561,0,43572
test4sub35of100,test4pub20of100,100,193,10,43121,1,43132
test4sub35of100,test4pub21of100,100,193,10,43035,1,43046
test4sub35of100,test4pub22of100,100,193,10,42904,0,42914
test4sub35of100,test4pub23of100,100,193,11,42732,1,42744
test4sub35of100,test4pub24of100,100,193,19,42604,1,42624
test4sub35of100,test4pub25of100,100,193,16,42182,0,42198
test4sub35of100,test4pub26of100,100,193,10,41965,0,41975
test4sub35of100,test4pub27of100,100,193,10,41645,1,41656
test4sub35of100,test4pub28of100,100,193,10,41544,0,41554
test4sub35of100,test4pub29of100,100,193,11,41379,0,41390
test4sub35of100,test4pub30of100,100,193,15,41244,1,41260
test4sub35of100,test4pub31of100,100,193,10,41111,0,41121
test4sub35of100,test4pub32of100,100,193,11,40759,0,40770
test4sub35of100,test4pub33of100,100,193,11,40619,1,40631
test4sub35of100,test4pub34of100,100,193,12,39839,1,39852
test4sub35of100,test4pub35of100,100,193,12,37485,0,37497
test4sub35of100,test4pub36of100,100,193,10,36211,1,36222
test4sub35of100,test4pub37of100,100,193,23,35851,0,35874
test4sub35of100,test4pub38of100,100,193,31,35645,0,35676
test4sub35of100,test4pub39of100,100,193,28,35498,1,35527
test4sub35of100,test4pub40of100,100,193,49,35319,0,35368
test4sub35of100,test4pub41of100,100,193,27,35195,1,35223
test4sub35of100,test4pub42of100,100,193,31,35052,0,35083
test4sub35of100,test4pub43of100,100,193,28,34926,1,34955
test4sub35of100,test4pub44of100,100,193,17,34779,0,34796
test4sub35of100,test4pub45of100,100,193,20,34652,1,34673
test4sub35of100,test4pub46of100,100,193,12,34323,0,34335
test4sub35of100,test4pub47of100,100,193,10,33910,1,33921
test4sub35of100,test4pub48of100,100,193,10,33750,0,33760
test4sub35of100,test4pub49of100,100,193,11,33555,1,33567
test4sub35of100,test4pub50of100,100,193,17,33384,0,33401
test4sub35of100,test4pub51of100,100,193,16,33216,1,33233
test4sub35of100,test4pub52of100,100,193,10,33071,0,33081
test4sub35of100,test4pub53of100,100,193,10,32704,1,32715
test4sub35of100,test4pub54of100,100,193,11,32539,0,32550
test4sub35of100,test4pub55of100,100,193,10,32272,0,32282
test4sub35of100,test4pub56of100,100,193,11,31380,1,31392
test4sub35of100,test4pub57of100,100,193,11,31237,0,31248
test4sub35of100,test4pub58of100,100,193,11,30273,1,30285
test4sub35of100,test4pub59of100,100,193,12,29725,1,29738
test4sub35of100,test4pub60of100,100,193,18,29371,1,29390
test4sub35of100,test4pub61of100,100,193,11,28863,0,28874
test4sub35of100,test4pub62of100,100,193,12,28072,1,28085
test4sub35of100,test4pub63of100,100,193,15,26808,0,26823
test4sub35of100,test4pub66of100,100,193,16,24920,1,24937
test4sub35of100,test4pub65of100,100,193,11,24944,0,24955
test4sub35of100,test4pub64of100,100,193,11,26487,1,26499
test4sub35of100,test4pub67of100,100,193,11,24826,0,24837
test4sub35of100,test4pub68of100,100,193,11,21069,1,21081
test4sub35of100,test4pub69of100,100,193,10,20891,0,20901
test4sub35of100,test4pub70of100,100,193,10,20673,1,20684
test4sub35of100,test4pub71of100,100,193,10,20513,1,20524
test4sub35of100,test4pub72of100,100,193,12,20139,0,20151
test4sub35of100,test4pub73of100,100,193,11,19915,1,19927
test4sub35of100,test4pub74of100,100,193,11,19756,0,19767
test4sub35of100,test4pub75of100,100,193,14,19535,1,19550
test4sub35of100,test4pub76of100,100,193,10,19172,0,19182
test4sub35of100,test4pub77of100,100,193,11,18753,1,18765
test4sub35of100,test4pub78of100,100,193,11,18199,0,18210
test4sub35of100,test4pub79of100,100,193,14,17884,1,17899
test4sub35of100,test4pub80of100,100,193,10,17537,0,17547
test4sub35of100,test4pub81of100,100,193,17,17196,0,17213
test4sub35of100,test4pub82of100,100,193,11,17023,1,17035
test4sub35of100,test4pub83of100,100,193,14,16613,0,16627
test4sub35of100,test4pub84of100,100,193,14,16138,1,16153
test4sub35of100,test4pub85of100,100,193,10,15898,0,15908
test4sub35of100,test4pub86of100,100,193,16,15367,1,15384
test4sub35of100,test4pub87of100,100,193,11,14704,0,14715
test4sub35of100,test4pub89of100,100,193,11,13285,1,13297
test4sub35of100,test4pub88of100,100,193,11,13315,1,13327
test4sub35of100,test4pub90of100,100,193,11,13131,1,13143
test4sub35of100,test4pub91of100,100,193,11,12798,0,12809
test4sub35of100,test4pub92of100,100,193,10,12417,0,12427
test4sub35of100,test4pub93of100,100,193,10,12317,0,12327
test4sub35of100,test4pub94of100,100,193,11,11902,0,11913
test4sub35of100,test4pub95of100,100,193,11,11632,1,11644
test4sub35of100,test4pub96of100,100,193,11,11248,0,11259
test4sub35of100,test4pub97of100,100,193,11,11093,0,11104
test4sub35of100,test4pub98of100,100,193,11,10974,1,10986
test4sub35of100,test4pub99of100,100,193,10,10832,0,10842
test4sub35of100,test4pub100of100,100,194,10,10718,1,10729
test4sub100of100,test4pub95of100,100,193,11,14563,0,14574
test4sub100of100,test4pub96of100,100,193,11,14179,1,14191
test4sub100of100,test4pub97of100,100,193,11,14028,1,14040
test4sub100of100,test4pub98of100,100,193,11,13909,1,13921
test4sub100of100,test4pub99of100,100,193,10,13757,0,13767
test4sub100of100,test4pub100of100,100,194,10,13643,1,13654
test4sub81of100,test4pub88of100,10,192,11,63006,0,63017
test4sub81of100,test4pub89of100,10,192,39,62020,1,62060
test4sub81of100,test4pub90of100,10,192,23,61861,0,61884
test4sub81of100,test4pub91of100,10,192,26,61707,1,61734
test4sub81of100,test4pub92of100,10,192,12,61535,1,61548
test4sub81of100,test4pub93of100,10,192,13,61208,1,61222
test4sub81of100,test4pub94of100,10,192,10,60618,1,60629
test4sub81of100,test4pub95of100,10,192,17,60262,1,60280
test4sub81of100,test4pub96of100,10,192,10,60099,0,60109
test4sub81of100,test4pub97of100,10,192,10,59962,1,59973
test4sub81of100,test4pub98of100,10,192,11,59815,1,59827
test4sub81of100,test4pub99of100,10,192,10,59607,0,59617
test4sub81of100,test4pub100of100,10,193,15,59487,1,59503
test4sub81of100,test4pub2of100,100,192,10,54256,1,54267
test4sub81of100,test4pub1of100,100,12977,24,54325,43,54392
test4sub81of100,test4pub3of100,100,192,28,54238,1,54267
test4sub81of100,test4pub4of100,100,192,11,52895,0,52906
test4sub81of100,test4pub5of100,100,192,14,51899,1,51914
test4sub81of100,test4pub6of100,100,192,26,51576,1,51603
test4sub81of100,test4pub7of100,100,192,14,50953,1,50968
test4sub81of100,test4pub8of100,100,192,12,50691,1,50704
test4sub81of100,test4pub9of100,100,192,20,50508,1,50529
test4sub81of100,test4pub10of100,100,193,11,50144,0,50155
test4sub81of100,test4pub11of100,100,193,10,49909,1,49920
test4sub81of100,test4pub12of100,100,193,11,49466,0,49477
test4sub81of100,test4pub13of100,100,193,10,49264,1,49275
test4sub81of100,test4pub14of100,100,193,10,49097,0,49107
test4sub81of100,test4pub15of100,100,193,11,48959,0,48970
test4sub81of100,test4pub16of100,100,193,10,48803,1,48814
test4sub81of100,test4pub17of100,100,193,11,48669,0,48680
test4sub81of100,test4pub18of100,100,193,18,48485,1,48504
test4sub81of100,test4pub19of100,100,193,11,48276,1,48288
test4sub81of100,test4pub20of100,100,193,10,47835,0,47845
test4sub81of100,test4pub21of100,100,193,10,47750,1,47761
test4sub81of100,test4pub22of100,100,193,10,47619,0,47629
test4sub81of100,test4pub23of100,100,193,11,47447,0,47458
test4sub81of100,test4pub24of100,100,193,19,47319,1,47339
test4sub81of100,test4pub25of100,100,193,16,46897,0,46913
test4sub81of100,test4pub26of100,100,193,10,46680,0,46690
test4sub81of100,test4pub27of100,100,193,10,46360,1,46371
test4sub81of100,test4pub28of100,100,193,10,46259,1,46270
test4sub81of100,test4pub29of100,100,193,11,46094,0,46105
test4sub81of100,test4pub30of100,100,193,15,45959,1,45975
test4sub81of100,test4pub31of100,100,193,10,45826,0,45836
test4sub81of100,test4pub32of100,100,193,11,45475,1,45487
test4sub81of100,test4pub33of100,100,193,11,45334,0,45345
test4sub81of100,test4pub34of100,100,193,12,44555,1,44568
test4sub81of100,test4pub35of100,100,193,12,42201,0,42213
test4sub81of100,test4pub36of100,100,193,10,40927,1,40938
test4sub81of100,test4pub37of100,100,193,23,40567,0,40590
test4sub81of100,test4pub38of100,100,193,31,40309,1,40341
test4sub81of100,test4pub39of100,100,193,28,40161,0,40189
test4sub81of100,test4pub40of100,100,193,49,39983,1,40033
test4sub81of100,test4pub41of100,100,193,27,39858,0,39885
test4sub81of100,test4pub42of100,100,193,31,39716,1,39748
test4sub81of100,test4pub43of100,100,193,28,39576,1,39605
test4sub81of100,test4pub44of100,100,193,17,39429,0,39446
test4sub81of100,test4pub45of100,100,193,20,39301,0,39321
test4sub81of100,test4pub46of100,100,193,12,38953,1,38966
test4sub81of100,test4pub47of100,100,193,10,38539,1,38550
test4sub81of100,test4pub48of100,100,193,10,38379,0,38389
test4sub81of100,test4pub49of100,100,193,11,38184,1,38196
test4sub81of100,test4pub50of100,100,193,17,38013,0,38030
test4sub81of100,test4pub51of100,100,193,16,37845,1,37862
test4sub81of100,test4pub52of100,100,193,10,37700,1,37711
test4sub81of100,test4pub53of100,100,193,10,37332,0,37342
test4sub81of100,test4pub54of100,100,193,11,37168,1,37180
test4sub81of100,test4pub55of100,100,193,10,36901,1,36912
test4sub81of100,test4pub56of100,100,193,11,36009,1,36021
test4sub81of100,test4pub57of100,100,193,11,35866,0,35877
test4sub81of100,test4pub58of100,100,193,11,34902,1,34914
test4sub81of100,test4pub59of100,100,193,12,34354,0,34366
test4sub81of100,test4pub60of100,100,193,18,33995,1,34014
test4sub81of100,test4pub61of100,100,193,11,33487,1,33499
test4sub81of100,test4pub62of100,100,193,12,32695,0,32707
test4sub81of100,test4pub63of100,100,193,15,31432,1,31448
test4sub81of100,test4pub64of100,100,193,11,31105,0,31116
test4sub81of100,test4pub65of100,100,193,11,29566,1,29578
test4sub81of100,test4pub66of100,100,193,16,29546,1,29563
test4sub81of100,test4pub67of100,100,193,11,29447,0,29458
test4sub81of100,test4pub68of100,100,193,11,25690,1,25702
test4sub81of100,test4pub69of100,100,193,10,25512,1,25523
test4sub81of100,test4pub70of100,100,193,10,25294,0,25304
test4sub81of100,test4pub71of100,100,193,10,25097,1,25108
test4sub81of100,test4pub72of100,100,193,12,24741,1,24754
test4sub81of100,test4pub73of100,100,193,11,24516,1,24528
test4sub81of100,test4pub74of100,100,193,11,24358,1,24370
test4sub81of100,test4pub75of100,100,193,14,24136,0,24150
test4sub81of100,test4pub76of100,100,193,10,23768,1,23779
test4sub81of100,test4pub77of100,100,193,11,23351,0,23362
test4sub81of100,test4pub78of100,100,193,11,22798,1,22810
test4sub81of100,test4pub79of100,100,193,14,22482,0,22496
test4sub81of100,test4pub80of100,100,193,10,22136,1,22147
test4sub81of100,test4pub81of100,100,193,17,21795,0,21812
test4sub81of100,test4pub82of100,100,193,11,21611,1,21623
test4sub81of100,test4pub83of100,100,193,14,21202,1,21217
test4sub81of100,test4pub84of100,100,193,14,20726,1,20741
test4sub81of100,test4pub85of100,100,193,10,20486,0,20496
test4sub81of100,test4pub86of100,100,193,16,19955,1,19972
test4sub81of100,test4pub87of100,100,193,11,19292,1,19304
test4sub81of100,test4pub88of100,100,193,11,17909,1,17921
test4sub81of100,test4pub89of100,100,193,11,17882,1,17894
test4sub81of100,test4pub90of100,100,193,11,17726,1,17738
test4sub81of100,test4pub91of100,100,193,11,17393,0,17404
test4sub81of100,test4pub92of100,100,193,10,17012,0,17022
test4sub81of100,test4pub93of100,100,193,10,16901,1,16912
test4sub81of100,test4pub94of100,100,193,11,16488,1,16500
test4sub81of100,test4pub95of100,100,193,11,16218,1,16230
test4sub81of100,test4pub96of100,100,193,11,15834,1,15846
test4sub81of100,test4pub97of100,100,193,11,15679,0,15690
test4sub81of100,test4pub98of100,100,193,11,15560,1,15572
test4sub81of100,test4pub99of100,100,193,10,15408,1,15419
test4sub81of100,test4pub100of100,100,194,10,15293,0,15303
test4sub18of100,test4pub97of100,10,192,10,63012,1,63023
test4sub18of100,test4pub98of100,10,192,11,62866,0,62877
test4sub18of100,test4pub99of100,10,192,10,62665,1,62676
test4sub18of100,test4pub100of100,10,193,15,62545,1,62561
test4sub18of100,test4pub2of100,100,192,10,57314,1,57325
test4sub18of100,test4pub3of100,100,192,28,57218,1,57247
test4sub18of100,test4pub1of100,100,12977,24,57366,43,57433
test4sub18of100,test4pub4of100,100,192,11,55933,1,55945
test4sub18of100,test4pub5of100,100,192,14,54937,0,54951
test4sub18of100,test4pub6of100,100,192,26,54615,1,54642
test4sub18of100,test4pub7of100,100,192,14,53982,1,53997
test4sub18of100,test4pub8of100,100,192,12,53720,1,53733
test4sub18of100,test4pub9of100,100,192,20,53536,0,53556
test4sub18of100,test4pub10of100,100,193,11,53173,1,53185
test4sub18of100,test4pub11of100,100,193,10,52937,1,52948
test4sub18of100,test4pub12of100,100,193,11,52494,1,52506
test4sub18of100,test4pub13of100,100,193,10,52292,1,52303
test4sub18of100,test4pub14of100,100,193,10,52125,0,52135
test4sub18of100,test4pub15of100,100,193,11,51988,1,52000
test4sub18of100,test4pub16of100,100,193,10,51831,1,51842
test4sub18of100,test4pub17of100,100,193,11,51697,1,51709
test4sub18of100,test4pub18of100,100,193,18,51513,1,51532
test4sub18of100,test4pub19of100,100,193,11,51304,0,51315
test4sub18of100,test4pub20of100,100,193,10,50863,1,50874
test4sub18of100,test4pub21of100,100,193,10,50778,1,50789
test4sub18of100,test4pub22of100,100,193,10,50647,1,50658
test4sub18of100,test4pub23of100,100,193,11,50476,0,50487
test4sub18of100,test4pub24of100,100,193,19,50347,1,50367
test4sub18of100,test4pub25of100,100,193,16,49926,1,49943
test4sub18of100,test4pub26of100,100,193,10,49709,0,49719
test4sub18of100,test4pub27of100,100,193,10,49389,1,49400
test4sub18of100,test4pub28of100,100,193,10,49288,0,49298
test4sub18of100,test4pub29of100,100,193,11,49123,0,49134
test4sub18of100,test4pub30of100,100,193,15,48988,1,49004
test4sub18of100,test4pub31of100,100,193,10,48855,0,48865
test4sub18of100,test4pub32of100,100,193,11,48503,0,48514
test4sub18of100,test4pub33of100,100,193,11,48363,1,48375
test4sub18of100,test4pub34of100,100,193,12,47583,1,47596
test4sub18of100,test4pub35of100,100,193,12,45229,0,45241
test4sub18of100,test4pub36of100,100,193,10,43955,1,43966
test4sub18of100,test4pub37of100,100,193,23,43595,1,43619
test4sub18of100,test4pub38of100,100,193,31,43336,0,43367
test4sub18of100,test4pub39of100,100,193,28,43189,1,43218
test4sub18of100,test4pub40of100,100,193,49,43010,0,43059
test4sub18of100,test4pub41of100,100,193,27,42885,0,42912
test4sub18of100,test4pub42of100,100,193,31,42743,1,42775
test4sub18of100,test4pub43of100,100,193,28,42603,0,42631
test4sub18of100,test4pub44of100,100,193,17,42456,1,42474
test4sub18of100,test4pub45of100,100,193,20,42329,1,42350
test4sub18of100,test4pub46of100,100,193,12,41980,0,41992
test4sub18of100,test4pub47of100,100,193,10,41566,0,41576
test4sub18of100,test4pub48of100,100,193,10,41407,1,41418
test4sub18of100,test4pub49of100,100,193,11,41211,0,41222
test4sub18of100,test4pub50of100,100,193,17,41040,0,41057
test4sub18of100,test4pub51of100,100,193,16,40872,1,40889
test4sub18of100,test4pub52of100,100,193,10,40727,0,40737
test4sub18of100,test4pub53of100,100,193,10,40359,0,40369
test4sub18of100,test4pub54of100,100,193,11,40195,1,40207
test4sub18of100,test4pub55of100,100,193,10,39928,0,39938
test4sub18of100,test4pub56of100,100,193,11,39036,1,39048
test4sub18of100,test4pub57of100,100,193,11,38893,1,38905
test4sub18of100,test4pub58of100,100,193,11,37928,0,37939
test4sub18of100,test4pub59of100,100,193,12,37380,0,37392
test4sub18of100,test4pub60of100,100,193,18,37022,1,37041
test4sub18of100,test4pub61of100,100,193,11,36513,0,36524
test4sub18of100,test4pub62of100,100,193,12,35721,0,35733
test4sub18of100,test4pub63of100,100,193,15,34458,1,34474
test4sub18of100,test4pub65of100,100,193,11,32590,0,32601
test4sub18of100,test4pub66of100,100,193,16,32570,0,32586
test4sub18of100,test4pub64of100,100,193,11,34134,1,34146
test4sub18of100,test4pub67of100,100,193,11,32473,0,32484
test4sub18of100,test4pub68of100,100,193,11,28715,1,28727
test4sub18of100,test4pub69of100,100,193,10,28538,1,28549
test4sub18of100,test4pub70of100,100,193,10,28320,0,28330
test4sub18of100,test4pub71of100,100,193,10,28122,0,28132
test4sub18of100,test4pub72of100,100,193,12,27749,1,27762
test4sub18of100,test4pub73of100,100,193,11,27524,0,27535
test4sub18of100,test4pub74of100,100,193,11,27365,1,27377
test4sub18of100,test4pub75of100,100,193,14,27144,1,27159
test4sub18of100,test4pub76of100,100,193,10,26775,0,26785
test4sub18of100,test4pub77of100,100,193,11,26356,1,26368
test4sub18of100,test4pub78of100,100,193,11,25802,1,25814
test4sub18of100,test4pub79of100,100,193,14,25486,0,25500
test4sub18of100,test4pub80of100,100,193,10,25140,1,25151
test4sub18of100,test4pub81of100,100,193,17,24799,0,24816
test4sub18of100,test4pub82of100,100,193,11,24615,0,24626
test4sub18of100,test4pub83of100,100,193,14,24206,1,24221
test4sub18of100,test4pub84of100,100,193,14,23730,0,23744
test4sub18of100,test4pub85of100,100,193,10,23490,0,23500
test4sub18of100,test4pub86of100,100,193,16,22959,1,22976
test4sub18of100,test4pub87of100,100,193,11,22296,0,22307
test4sub18of100,test4pub89of100,100,193,11,20876,0,20887
test4sub18of100,test4pub88of100,100,193,11,20906,1,20918
test4sub18of100,test4pub90of100,100,193,11,20721,0,20732
test4sub18of100,test4pub91of100,100,193,11,20388,1,20400
test4sub18of100,test4pub92of100,100,193,10,20008,1,20019
test4sub18of100,test4pub93of100,100,193,10,19896,0,19906
test4sub18of100,test4pub94of100,100,193,11,19480,0,19491
test4sub18of100,test4pub95of100,100,193,11,19211,1,19223
test4sub18of100,test4pub96of100,100,193,11,18826,0,18837
test4sub18of100,test4pub97of100,100,193,11,18672,1,18684
test4sub18of100,test4pub98of100,100,193,11,18552,0,18563
test4sub18of100,test4pub99of100,100,193,10,18400,0,18410
test4sub18of100,test4pub100of100,100,194,10,18286,1,18297
test4sub53of100,test4pub7of100,100,192,14,55118,0,55132
test4sub53of100,test4pub8of100,100,192,12,54856,1,54869
test4sub53of100,test4pub9of100,100,192,20,54672,0,54692
test4sub53of100,test4pub10of100,100,193,11,54309,1,54321
test4sub53of100,test4pub11of100,100,193,10,54073,0,54083
test4sub53of100,test4pub12of100,100,193,11,53630,0,53641
test4sub53of100,test4pub13of100,100,193,10,53428,1,53439
test4sub53of100,test4pub14of100,100,193,10,53261,0,53271
test4sub53of100,test4pub15of100,100,193,11,53123,0,53134
test4sub53of100,test4pub16of100,100,193,10,52967,1,52978
test4sub53of100,test4pub17of100,100,193,11,52833,0,52844
test4sub53of100,test4pub18of100,100,193,18,52649,1,52668
test4sub53of100,test4pub19of100,100,193,11,52440,1,52452
test4sub53of100,test4pub20of100,100,193,10,51999,0,52009
test4sub53of100,test4pub21of100,100,193,10,51914,1,51925
test4sub53of100,test4pub22of100,100,193,10,51783,0,51793
test4sub53of100,test4pub23of100,100,193,11,51611,0,51622
test4sub53of100,test4pub24of100,100,193,19,51483,1,51503
test4sub53of100,test4pub25of100,100,193,16,51061,0,51077
test4sub53of100,test4pub26of100,100,193,10,50844,1,50855
test4sub53of100,test4pub27of100,100,193,10,50524,1,50535
test4sub53of100,test4pub28of100,100,193,10,50423,0,50433
test4sub53of100,test4pub29of100,100,193,11,50259,1,50271
test4sub53of100,test4pub30of100,100,193,15,50123,0,50138
test4sub53of100,test4pub31of100,100,193,10,49990,0,50000
test4sub53of100,test4pub32of100,100,193,11,49639,1,49651
test4sub53of100,test4pub33of100,100,193,11,49498,1,49510
test4sub53of100,test4pub34of100,100,193,12,48718,0,48730
test4sub53of100,test4pub35of100,100,193,12,46365,1,46378
test4sub53of100,test4pub36of100,100,193,10,45090,0,45100
test4sub53of100,test4pub37of100,100,193,23,44730,0,44753
test4sub53of100,test4pub38of100,100,193,31,44472,1,44504
test4sub53of100,test4pub39of100,100,193,28,44324,1,44353
test4sub53of100,test4pub40of100,100,193,49,44145,0,44194
test4sub53of100,test4pub41of100,100,193,27,44021,1,44049
test4sub53of100,test4pub42of100,100,193,31,43878,1,43910
test4sub53of100,test4pub43of100,100,193,28,43738,1,43767
test4sub53of100,test4pub44of100,100,193,17,43592,0,43609
test4sub53of100,test4pub45of100,100,193,20,43464,1,43485
test4sub53of100,test4pub46of100,100,193,12,43116,1,43129
test4sub53of100,test4pub47of100,100,193,10,42702,0,42712
test4sub53of100,test4pub48of100,100,193,10,42543,1,42554
test4sub53of100,test4pub49of100,100,193,11,42347,0,42358
test4sub53of100,test4pub50of100,100,193,17,42177,0,42194
test4sub53of100,test4pub51of100,100,193,16,42008,1,42025
test4sub53of100,test4pub52of100,100,193,10,41863,0,41873
test4sub53of100,test4pub53of100,100,193,10,41495,1,41506
test4sub53of100,test4pub54of100,100,193,11,41331,1,41343
test4sub53of100,test4pub55of100,100,193,10,41064,0,41074
test4sub53of100,test4pub56of100,100,193,11,40171,1,40183
test4sub53of100,test4pub57of100,100,193,11,40029,1,40041
test4sub53of100,test4pub58of100,100,193,11,39064,0,39075
test4sub53of100,test4pub59of100,100,193,12,38517,1,38530
test4sub53of100,test4pub60of100,100,193,18,38158,1,38177
test4sub53of100,test4pub61of100,100,193,11,37649,0,37660
test4sub53of100,test4pub62of100,100,193,12,36860,1,36873
test4sub53of100,test4pub63of100,100,193,15,35596,1,35612
test4sub53of100,test4pub64of100,100,193,11,35270,0,35281
test4sub53of100,test4pub65of100,100,193,11,33730,1,33742
test4sub53of100,test4pub66of100,100,193,16,33711,0,33727
test4sub53of100,test4pub67of100,100,193,11,33612,1,33624
test4sub53of100,test4pub68of100,100,193,11,29855,1,29867
test4sub53of100,test4pub69of100,100,193,10,29677,0,29687
test4sub53of100,test4pub70of100,100,193,10,29460,1,29471
test4sub53of100,test4pub71of100,100,193,10,29267,1,29278
test4sub53of100,test4pub72of100,100,193,12,28894,0,28906
test4sub53of100,test4pub73of100,100,193,11,28677,1,28689
test4sub53of100,test4pub74of100,100,193,11,28518,0,28529
test4sub53of100,test4pub75of100,100,193,14,28297,1,28312
test4sub53of100,test4pub76of100,100,193,10,27928,0,27938
test4sub53of100,test4pub77of100,100,193,11,27508,1,27520
test4sub53of100,test4pub78of100,100,193,11,26955,1,26967
test4sub53of100,test4pub79of100,100,193,14,26639,0,26653
test4sub53of100,test4pub80of100,100,193,10,26292,1,26303
test4sub53of100,test4pub81of100,100,193,17,25952,1,25970
test4sub53of100,test4pub82of100,100,193,11,25774,1,25786
test4sub53of100,test4pub83of100,100,193,14,25364,0,25378
test4sub53of100,test4pub84of100,100,193,14,24889,0,24903
test4sub53of100,test4pub85of100,100,193,10,24653,1,24664
test4sub53of100,test4pub86of100,100,193,16,24121,0,24137
test4sub53of100,test4pub87of100,100,193,11,23459,1,23471
test4sub53of100,test4pub88of100,100,193,11,22068,1,22080
test4sub53of100,test4pub89of100,100,193,11,22041,1,22053
test4sub53of100,test4pub90of100,100,193,11,21885,1,21897
test4sub53of100,test4pub91of100,100,193,11,21552,1,21564
test4sub53of100,test4pub93of100,100,193,10,21059,1,21070
test4sub53of100,test4pub92of100,100,193,10,21174,1,21185
test4sub53of100,test4pub94of100,100,193,11,20645,0,20656
test4sub53of100,test4pub95of100,100,193,11,20376,1,20388
test4sub53of100,test4pub96of100,100,193,11,19991,0,20002
test4sub53of100,test4pub97of100,100,193,11,19836,1,19848
test4sub53of100,test4pub98of100,100,193,11,19717,1,19729
test4sub53of100,test4pub99of100,100,193,10,19566,1,19577
test4sub53of100,test4pub100of100,100,194,10,19451,1,19462
