test4sub75of100,test4pub1of1,1,316,27,17,40,84
test4sub13of100,test4pub1of1,1,316,27,20,79,126
test4sub1of100,test4pub1of1,1,316,27,33,104,164
test4sub87of100,test4pub1of1,1,316,27,46,132,205
test4sub48of100,test4pub1of1,1,316,27,50,168,245
test4sub14of100,test4pub1of1,1,316,27,56,202,285
test4sub7of100,test4pub1of1,1,316,27,60,237,324
test4sub28of100,test4pub1of1,1,316,27,62,275,364
test4sub20of100,test4pub1of1,1,316,27,97,280,404
test4sub5of100,test4pub1of1,1,316,27,98,320,445
test4sub98of100,test4pub1of1,1,316,27,111,346,484
test4sub66of100,test4pub1of1,1,316,27,117,381,525
test4sub74of100,test4pub1of1,1,316,27,120,418,565
test4sub41of100,test4pub1of1,1,316,27,144,433,604
test4sub78of100,test4pub1of1,1,316,27,148,470,645
test4sub17of100,test4pub1of1,1,316,27,152,506,685
test4sub16of100,test4pub1of1,1,316,27,156,542,725
test4sub34of100,test4pub1of1,1,316,27,160,577,764
test4sub60of100,test4pub1of1,1,316,27,167,611,805
test4sub37of100,test4pub1of1,1,316,27,167,651,845
test4sub32of100,test4pub1of1,1,316,27,172,686,885
test4sub3of100,test4pub1of1,1,316,27,178,719,924
test4sub18of100,test4pub1of1,1,316,27,186,752,965
test4sub51of100,test4pub1of1,1,316,27,205,773,1005
test4sub31of100,test4pub1of1,1,316,27,218,799,1044
test4sub44of100,test4pub1of1,1,316,27,225,833,1085
test4sub35of100,test4pub1of1,1,316,27,225,873,1125
test4sub6of100,test4pub1of1,1,316,27,231,907,1165
test4sub84of100,test4pub1of1,1,316,27,232,945,1204
test4sub11of100,test4pub1of1,1,316,27,233,984,1244
test4sub24of100,test4pub1of1,1,316,27,235,1022,1284
test4sub50of100,test4pub1of1,1,316,27,237,1060,1324
test4sub59of100,test4pub1of1,1,316,27,275,1063,1365
test4sub71of100,test4pub1of1,1,316,27,276,1102,1405
test4sub97of100,test4pub1of1,1,316,27,277,1141,1445
test4sub99of100,test4pub1of1,1,316,27,281,1177,1485
test4sub38of100,test4pub1of1,1,316,27,286,1211,1524
test4sub95of100,test4pub1of1,1,316,27,290,1248,1565
test4sub57of100,test4pub1of1,1,316,27,293,1284,1604
test4sub36of100,test4pub1of1,1,316,27,297,1321,1645
test4sub61of100,test4pub1of1,1,316,27,304,1354,1685
test4sub79of100,test4pub1of1,1,316,27,306,1391,1724
test4sub68of100,test4pub1of1,1,316,27,328,1409,1764
test4sub89of100,test4pub1of1,1,316,27,335,1442,1804
test4sub15of100,test4pub1of1,1,316,27,342,1476,1845
test4sub25of100,test4pub1of1,1,316,27,345,1513,1885
test4sub29of100,test4pub1of1,1,316,27,345,1552,1924
test4sub43of100,test4pub1of1,1,316,27,352,1586,1965
test4sub93of100,test4pub1of1,1,316,27,359,1619,2005
test4sub40of100,test4pub1of1,1,316,27,367,1651,2045
test4sub42of100,test4pub1of1,1,316,27,370,1687,2084
test4sub76of100,test4pub1of1,1,316,27,373,1725,2125
test4sub69of100,test4pub1of1,1,316,27,375,1763,2165
test4sub100of100,test4pub1of1,1,316,27,381,1797,2205
test4sub26of100,test4pub1of1,1,316,27,384,1833,2244
test4sub83of100,test4pub1of1,1,316,27,429,1828,2284
test4sub2of100,test4pub1of1,1,316,27,431,1866,2324
test4sub92of100,test4pub1of1,1,316,27,432,1905,2364
test4sub58of100,test4pub1of1,1,316,27,436,1941,2404
test4sub65of100,test4pub1of1,1,316,27,442,1975,2444
test4sub86of100,test4pub1of1,1,316,27,442,2015,2484
test4sub85of100,test4pub1of1,1,316,27,443,2054,2524
test4sub47of100,test4pub1of1,1,316,27,444,2094,2565
test4sub55of100,test4pub1of1,1,316,27,451,2126,2604
test4sub80of100,test4pub1of1,1,316,27,452,2165,2644
test4sub72of100,test4pub1of1,1,316,27,452,2205,2684
test4sub88of100,test4pub1of1,1,316,27,453,2244,2724
test4sub49of100,test4pub1of1,1,316,27,454,2284,2765
test4sub39of100,test4pub1of1,1,316,27,455,2322,2804
test4sub8of100,test4pub1of1,1,316,27,476,2342,2845
test4sub56of100,test4pub1of1,1,316,27,476,2382,2885
test4sub67of100,test4pub1of1,1,316,27,477,2421,2925
test4sub96of100,test4pub1of1,1,316,27,484,2453,2964
test4sub77of100,test4pub1of1,1,316,27,485,2493,3005
test4sub12of100,test4pub1of1,1,316,27,486,2531,3044
test4sub54of100,test4pub1of1,1,316,27,493,2565,3085
test4sub81of100,test4pub1of1,1,316,27,494,2604,3125
test4sub19of100,test4pub1of1,1,316,27,497,2640,3164
test4sub30of100,test4pub1of1,1,316,27,503,2674,3204
test4sub9of100,test4pub1of1,1,316,27,514,2703,3244
test4sub82of100,test4pub1of1,1,316,27,519,2738,3284
test4sub45of100,test4pub1of1,1,316,27,522,2775,3324
test4sub10of100,test4pub1of1,1,316,27,526,2811,3364
test4sub4of100,test4pub1of1,1,316,27,527,2851,3405
test4sub33of100,test4pub1of1,1,316,27,527,2890,3444
test4sub70of100,test4pub1of1,1,316,27,544,2914,3485
test4sub94of100,test4pub1of1,1,316,27,544,2953,3524
test4sub63of100,test4pub1of1,1,316,27,563,2974,3564
test4sub73of100,test4pub1of1,1,316,27,566,3011,3604
test4sub27of100,test4pub1of1,1,316,27,606,3012,3645
test4sub22of100,test4pub1of1,1,316,27,624,3034,3685
test4sub64of100,test4pub1of1,1,316,27,668,3030,3725
test4sub53of100,test4pub1of1,1,316,27,571,3166,3764
test4sub52of100,test4pub1of1,1,316,27,627,3151,3805
test4sub91of100,test4pub1of1,1,316,27,633,3185,3845
test4sub21of100,test4pub1of1,1,316,27,636,3221,3884
test4sub90of100,test4pub1of1,1,316,27,642,3256,3925
test4sub46of100,test4pub1of1,1,316,27,645,3293,3965
test4sub23of100,test4pub1of1,1,316,27,647,3331,4005
test4sub62of100,test4pub1of1,1,316,27,651,3367,4045
test4sub75of100,test4pub1of1,10,1467,12,19,42,73
test4sub13of100,test4pub1of1,10,1467,12,22,77,111
test4sub1of100,test4pub1of1,10,1467,12,33,106,151
test4sub87of100,test4pub1of1,10,1467,12,47,133,192
test4sub48of100,test4pub1of1,10,1467,12,77,142,231
test4sub14of100,test4pub1of1,10,1467,12,83,175,270
test4sub7of100,test4pub1of1,10,1467,12,87,212,311
test4sub28of100,test4pub1of1,10,1467,12,92,247,351
test4sub20of100,test4pub1of1,10,1467,12,92,289,393
test4sub5of100,test4pub1of1,10,1467,12,107,313,432
test4sub98of100,test4pub1of1,10,1467,12,116,343,471
test4sub66of100,test4pub1of1,10,1467,12,123,376,511
test4sub74of100,test4pub1of1,10,1467,12,126,413,551
test4sub41of100,test4pub1of1,10,1467,12,151,428,591
test4sub78of100,test4pub1of1,10,1467,12,155,465,632
test4sub17of100,test4pub1of1,10,1467,12,162,498,672
test4sub16of100,test4pub1of1,10,1467,12,165,535,712
test4sub34of100,test4pub1of1,10,1467,12,169,570,751
test4sub60of100,test4pub1of1,10,1467,12,173,606,791
test4sub37of100,test4pub1of1,10,1467,12,173,645,830
test4sub32of100,test4pub1of1,10,1467,12,176,683,871
test4sub3of100,test4pub1of1,10,1467,12,185,714,911
test4sub18of100,test4pub1of1,10,1467,12,200,739,951
test4sub51of100,test4pub1of1,10,1467,12,216,763,991
test4sub31of100,test4pub1of1,10,1467,12,230,788,1030
test4sub35of100,test4pub1of1,10,1467,12,233,826,1071
test4sub44of100,test4pub1of1,10,1467,12,235,863,1110
test4sub6of100,test4pub1of1,10,1467,12,236,902,1150
test4sub84of100,test4pub1of1,10,1467,12,248,930,1190
test4sub11of100,test4pub1of1,10,1467,12,250,969,1231
test4sub24of100,test4pub1of1,10,1467,12,252,1006,1270
test4sub50of100,test4pub1of1,10,1467,12,254,1045,1311
test4sub59of100,test4pub1of1,10,1467,12,284,1054,1350
test4sub71of100,test4pub1of1,10,1467,12,287,1091,1390
test4sub97of100,test4pub1of1,10,1467,12,290,1129,1431
test4sub99of100,test4pub1of1,10,1467,12,299,1160,1471
test4sub38of100,test4pub1of1,10,1467,12,304,1194,1510
test4sub95of100,test4pub1of1,10,1467,12,307,1232,1551
test4sub57of100,test4pub1of1,10,1467,12,322,1256,1590
test4sub36of100,test4pub1of1,10,1467,12,326,1293,1631
test4sub61of100,test4pub1of1,10,1467,12,328,1330,1670
test4sub79of100,test4pub1of1,10,1467,12,335,1363,1710
test4sub68of100,test4pub1of1,10,1467,12,348,1391,1751
test4sub89of100,test4pub1of1,10,1467,12,355,1424,1791
test4sub15of100,test4pub1of1,10,1467,12,364,1455,1831
test4sub25of100,test4pub1of1,10,1467,12,366,1492,1870
test4sub29of100,test4pub1of1,10,1467,12,367,1532,1911
test4sub43of100,test4pub1of1,10,1467,12,374,1564,1950
test4sub93of100,test4pub1of1,10,1467,12,382,1596,1990
test4sub40of100,test4pub1of1,10,1467,12,387,1631,2030
test4sub42of100,test4pub1of1,10,1467,12,397,1661,2070
test4sub76of100,test4pub1of1,10,1467,12,399,1700,2111
test4sub69of100,test4pub1of1,10,1467,12,400,1738,2150
test4sub100of100,test4pub1of1,10,1467,12,409,1769,2190
test4sub26of100,test4pub1of1,10,1467,12,440,1779,2231
test4sub83of100,test4pub1of1,10,1467,12,444,1814,2270
test4sub2of100,test4pub1of1,10,1467,12,455,1843,2310
test4sub92of100,test4pub1of1,10,1467,12,461,1877,2350
test4sub58of100,test4pub1of1,10,1467,12,463,1915,2390
test4sub65of100,test4pub1of1,10,1467,12,464,1954,2430
test4sub86of100,test4pub1of1,10,1467,12,466,1993,2471
test4sub85of100,test4pub1of1,10,1467,12,468,2031,2511
test4sub47of100,test4pub1of1,10,1467,12,470,2070,2552
test4sub55of100,test4pub1of1,10,1467,12,477,2101,2590
test4sub80of100,test4pub1of1,10,1467,12,479,2140,2631
test4sub72of100,test4pub1of1,10,1467,12,481,2177,2670
test4sub88of100,test4pub1of1,10,1467,12,492,2207,2711
test4sub49of100,test4pub1of1,10,1467,12,493,2245,2750
test4sub39of100,test4pub1of1,10,1467,12,497,2281,2790
test4sub8of100,test4pub1of1,10,1467,12,516,2302,2830
test4sub56of100,test4pub1of1,10,1467,12,520,2339,2871
test4sub67of100,test4pub1of1,10,1467,12,522,2376,2910
test4sub96of100,test4pub1of1,10,1467,12,523,2415,2950
test4sub77of100,test4pub1of1,10,1467,12,526,2453,2991
test4sub12of100,test4pub1of1,10,1467,12,528,2490,3030
test4sub54of100,test4pub1of1,10,1467,12,536,2523,3071
test4sub81of100,test4pub1of1,10,1467,12,538,2561,3111
test4sub19of100,test4pub1of1,10,1467,12,541,2598,3151
test4sub30of100,test4pub1of1,10,1467,12,545,2633,3190
test4sub9of100,test4pub1of1,10,1467,12,568,2651,3231
test4sub82of100,test4pub1of1,10,1467,12,573,2685,3270
test4sub45of100,test4pub1of1,10,1467,12,578,2721,3311
test4sub10of100,test4pub1of1,10,1467,12,580,2758,3350
test4sub4of100,test4pub1of1,10,1467,12,586,2792,3390
test4sub33of100,test4pub1of1,10,1467,12,587,2831,3430
test4sub70of100,test4pub1of1,10,1467,12,601,2857,3470
test4sub94of100,test4pub1of1,10,1467,12,602,2896,3510
test4sub63of100,test4pub1of1,10,1467,12,620,2918,3550
test4sub73of100,test4pub1of1,10,1467,12,625,2954,3591
test4sub53of100,test4pub1of1,10,1467,12,629,2989,3630
test4sub27of100,test4pub1of1,10,1467,12,665,2994,3671
test4sub22of100,test4pub1of1,10,1467,12,683,3015,3710
test4sub21of100,test4pub1of1,10,1467,12,699,3040,3751
test4sub52of100,test4pub1of1,10,1467,12,687,3091,3790
test4sub91of100,test4pub1of1,10,1467,12,695,3124,3831
test4sub90of100,test4pub1of1,10,1467,12,705,3154,3871
test4sub46of100,test4pub1of1,10,1467,12,708,3190,3910
test4sub23of100,test4pub1of1,10,1467,12,713,3225,3950
test4sub62of100,test4pub1of1,10,1467,12,717,3262,3991
test4sub64of100,test4pub1of1,10,1467,12,734,3286,4032
test4sub75of100,test4pub1of1,100,12975,12,76,43,131
test4sub13of100,test4pub1of1,100,12975,12,86,77,175
test4sub1of100,test4pub1of1,100,12975,12,133,74,219
test4sub87of100,test4pub1of1,100,12975,12,168,82,262
test4sub48of100,test4pub1of1,100,12975,12,205,84,301
test4sub7of100,test4pub1of1,100,12975,12,217,113,342
test4sub14of100,test4pub1of1,100,12975,12,217,156,385
test4sub28of100,test4pub1of1,100,12975,12,255,160,427
test4sub20of100,test4pub1of1,100,12975,12,257,204,473
test4sub5of100,test4pub1of1,100,12975,12,315,188,515
test4sub98of100,test4pub1of1,100,12975,12,346,200,558
test4sub66of100,test4pub1of1,100,12975,12,363,227,602
test4sub74of100,test4pub1of1,100,12975,12,372,262,646
test4sub41of100,test4pub1of1,100,12975,12,460,218,690
test4sub37of100,test4pub1of1,100,12975,12,591,127,730
test4sub78of100,test4pub1of1,100,12975,12,752,42,806
test4sub84of100,test4pub1of1,100,12975,12,822,43,877
test4sub32of100,test4pub1of1,100,12975,12,940,41,993
test4sub69of100,test4pub1of1,100,12975,12,1027,42,1081
test4sub60of100,test4pub1of1,100,12975,12,1149,42,1203
test4sub8of100,test4pub1of1,100,12975,12,1182,51,1245
test4sub56of100,test4pub1of1,100,12975,12,1184,90,1286
test4sub81of100,test4pub1of1,100,12975,12,1311,43,1366
test4sub77of100,test4pub1of1,100,12975,12,1435,43,1490
test4sub12of100,test4pub1of1,100,12975,12,1444,79,1535
test4sub16of100,test4pub1of1,100,12975,12,1480,86,1578
test4sub85of100,test4pub1of1,100,12975,12,1501,105,1618
test4sub79of100,test4pub1of1,100,12975,12,1504,146,1662
test4sub91of100,test4pub1of1,100,12975,12,1519,174,1705
test4sub21of100,test4pub1of1,100,12975,12,1519,218,1749
test4sub18of100,test4pub1of1,100,12975,12,1564,219,1795
test4sub49of100,test4pub1of1,100,12975,12,1596,234,1842
test4sub96of100,test4pub1of1,100,12975,12,1603,268,1883
test4sub72of100,test4pub1of1,100,12975,12,1629,285,1926
test4sub90of100,test4pub1of1,100,12975,12,1642,313,1967
test4sub38of100,test4pub1of1,100,12975,12,1654,346,2012
test4sub80of100,test4pub1of1,100,12975,12,1697,347,2056
test4sub24of100,test4pub1of1,100,12975,12,1709,377,2098
test4sub59of100,test4pub1of1,100,12975,12,1740,386,2138
test4sub93of100,test4pub1of1,100,12975,12,1747,420,2179
test4sub11of100,test4pub1of1,100,12975,12,1754,457,2223
test4sub76of100,test4pub1of1,100,12975,12,1767,483,2262
test4sub97of100,test4pub1of1,100,12975,12,1772,518,2302
test4sub15of100,test4pub1of1,100,12975,12,1773,561,2346
test4sub45of100,test4pub1of1,100,12975,12,1771,604,2387
test4sub51of100,test4pub1of1,100,12975,12,1788,634,2434
test4sub30of100,test4pub1of1,100,12975,12,1786,674,2472
test4sub53of100,test4pub1of1,100,12975,12,1789,716,2517
test4sub33of100,test4pub1of1,100,12975,12,1823,724,2559
test4sub17of100,test4pub1of1,100,12975,12,1823,767,2602
test4sub35of100,test4pub1of1,100,12975,12,1840,790,2642
test4sub92of100,test4pub1of1,100,12975,12,1856,814,2682
test4sub2of100,test4pub1of1,100,12975,12,1858,852,2722
test4sub25of100,test4pub1of1,100,12975,12,1862,891,2765
test4sub46of100,test4pub1of1,100,12975,12,1864,930,2806
test4sub42of100,test4pub1of1,100,12975,12,1877,956,2845
test4sub63of100,test4pub1of1,100,12975,12,1897,977,2886
test4sub54of100,test4pub1of1,100,12975,12,1900,1014,2926
test4sub29of100,test4pub1of1,100,12975,12,1903,1050,2965
test4sub23of100,test4pub1of1,100,12975,12,1906,1089,3007
test4sub70of100,test4pub1of1,100,12975,12,1908,1125,3045
test4sub31of100,test4pub1of1,100,12975,12,1923,1151,3086
test4sub43of100,test4pub1of1,100,12975,12,1926,1188,3126
test4sub4of100,test4pub1of1,100,12975,12,1939,1215,3166
test4sub58of100,test4pub1of1,100,12975,12,1954,1240,3206
test4sub44of100,test4pub1of1,100,12975,12,1957,1276,3245
test4sub83of100,test4pub1of1,100,12975,12,1963,1311,3286
test4sub100of100,test4pub1of1,100,12975,12,1971,1343,3326
test4sub73of100,test4pub1of1,100,12975,12,1988,1370,3370
test4sub47of100,test4pub1of1,100,12975,12,1990,1407,3409
test4sub64of100,test4pub1of1,100,12975,12,1996,1441,3449
test4sub27of100,test4pub1of1,100,12975,12,1998,1479,3489
test4sub22of100,test4pub1of1,100,12975,12,2009,1509,3530
test4sub39of100,test4pub1of1,100,12975,12,2053,1505,3570
test4sub86of100,test4pub1of1,100,12975,12,2066,1532,3610
test4sub19of100,test4pub1of1,100,12975,12,2089,1552,3653
test4sub67of100,test4pub1of1,100,12975,12,2116,1566,3694
test4sub94of100,test4pub1of1,100,12975,12,2171,1555,3738
test4sub65of100,test4pub1of1,100,12975,12,2176,1590,3778
test4sub71of100,test4pub1of1,100,12975,12,2178,1628,3818
test4sub68of100,test4pub1of1,100,12975,12,2198,1648,3858
test4sub89of100,test4pub1of1,100,12975,12,2208,1678,3898
test4sub95of100,test4pub1of1,100,12975,12,2263,1653,3928
test4sub40of100,test4pub1of1,100,12975,12,2282,1683,3977
test4sub10of100,test4pub1of1,100,12975,12,2300,1706,4018
test4sub6of100,test4pub1of1,100,12975,12,2334,1712,4058
test4sub55of100,test4pub1of1,100,12975,12,2380,1706,4098
test4sub26of100,test4pub1of1,100,12975,12,2453,1673,4138
test4sub50of100,test4pub1of1,100,12975,12,2455,1711,4178
test4sub82of100,test4pub1of1,100,12975,12,2531,1675,4218
test4sub34of100,test4pub1of1,100,12975,12,2531,1714,4257
test4sub9of100,test4pub1of1,100,12975,12,2555,1731,4298
test4sub88of100,test4pub1of1,100,12975,12,2561,1765,4338
test4sub61of100,test4pub1of1,100,12975,12,2594,1772,4378
test4sub62of100,test4pub1of1,100,12975,12,2635,1770,4417
test4sub36of100,test4pub1of1,100,12975,12,2640,1806,4458
test4sub3of100,test4pub1of1,100,12975,12,2706,1780,4498
test4sub52of100,test4pub1of1,100,12975,12,2769,1757,4538
test4sub99of100,test4pub1of1,100,12975,12,2924,1642,4578
test4sub57of100,test4pub1of1,100,12975,12,3280,1326,4618
test4sub75of100,test4pub1of10,1,317,11,9,38,58
test4sub13of100,test4pub1of10,1,317,11,10,77,98
test4sub1of100,test4pub1of10,1,317,11,33,94,138
test4sub87of100,test4pub1of10,1,317,11,44,123,178
test4sub48of100,test4pub1of10,1,317,11,47,160,218
test4sub14of100,test4pub1of10,1,317,11,52,194,257
test4sub7of100,test4pub1of10,1,317,11,62,225,298
test4sub28of100,test4pub1of10,1,317,11,68,258,337
test4sub20of100,test4pub1of10,1,317,11,74,292,377
test4sub5of100,test4pub1of10,1,317,11,93,313,417
test4sub41of100,test4pub1of10,1,317,11,132,314,457
test4sub17of100,test4pub1of10,1,317,11,134,352,497
test4sub37of100,test4pub1of10,1,317,11,139,388,538
test4sub3of100,test4pub1of10,1,317,11,144,424,579
test4sub98of100,test4pub1of10,1,317,11,146,460,617
test4sub66of100,test4pub1of10,1,317,11,146,500,657
test4sub74of100,test4pub1of10,1,317,11,147,539,697
test4sub78of100,test4pub1of10,1,317,11,147,579,737
test4sub16of100,test4pub1of10,1,317,11,148,618,777
test4sub34of100,test4pub1of10,1,317,11,149,658,818
test4sub60of100,test4pub1of10,1,317,11,151,695,857
test4sub32of100,test4pub1of10,1,317,11,151,735,897
test4sub18of100,test4pub1of10,1,317,11,157,770,938
test4sub51of100,test4pub1of10,1,317,11,160,806,977
test4sub31of100,test4pub1of10,1,317,11,167,840,1018
test4sub35of100,test4pub1of10,1,317,11,169,878,1058
test4sub44of100,test4pub1of10,1,317,11,169,918,1098
test4sub6of100,test4pub1of10,1,317,11,170,957,1138
test4sub11of100,test4pub1of10,1,317,11,174,992,1177
test4sub84of100,test4pub1of10,1,317,11,174,1032,1217
test4sub24of100,test4pub1of10,1,317,11,175,1072,1258
test4sub50of100,test4pub1of10,1,317,11,177,1109,1297
test4sub59of100,test4pub1of10,1,317,11,191,1135,1337
test4sub97of100,test4pub1of10,1,317,11,195,1172,1378
test4sub71of100,test4pub1of10,1,317,11,195,1212,1418
test4sub99of100,test4pub1of10,1,317,11,201,1245,1457
test4sub38of100,test4pub1of10,1,317,11,202,1285,1498
test4sub95of100,test4pub1of10,1,317,11,206,1320,1537
test4sub57of100,test4pub1of10,1,317,11,209,1357,1577
test4sub36of100,test4pub1of10,1,317,11,211,1395,1617
test4sub61of100,test4pub1of10,1,317,11,215,1432,1658
test4sub79of100,test4pub1of10,1,317,11,216,1471,1698
test4sub68of100,test4pub1of10,1,317,11,228,1498,1737
test4sub89of100,test4pub1of10,1,317,11,232,1534,1777
test4sub15of100,test4pub1of10,1,317,11,236,1571,1818
test4sub25of100,test4pub1of10,1,317,11,241,1606,1858
test4sub29of100,test4pub1of10,1,317,11,241,1647,1899
test4sub43of100,test4pub1of10,1,317,11,247,1680,1938
test4sub93of100,test4pub1of10,1,317,11,252,1714,1977
test4sub40of100,test4pub1of10,1,317,11,256,1750,2017
test4sub42of100,test4pub1of10,1,317,11,263,1783,2057
test4sub76of100,test4pub1of10,1,317,11,266,1821,2098
test4sub69of100,test4pub1of10,1,317,11,267,1861,2139
test4sub100of100,test4pub1of10,1,317,11,271,1895,2177
test4sub26of100,test4pub1of10,1,317,11,274,1932,2217
test4sub2of100,test4pub1of10,1,317,11,287,1960,2258
test4sub83of100,test4pub1of10,1,317,11,287,1999,2297
test4sub92of100,test4pub1of10,1,317,11,289,2038,2338
test4sub58of100,test4pub1of10,1,317,11,291,2075,2377
test4sub65of100,test4pub1of10,1,317,11,296,2110,2417
test4sub86of100,test4pub1of10,1,317,11,297,2149,2457
test4sub85of100,test4pub1of10,1,317,11,297,2189,2497
test4sub47of100,test4pub1of10,1,317,11,300,2227,2538
test4sub55of100,test4pub1of10,1,317,11,303,2264,2578
test4sub80of100,test4pub1of10,1,317,11,304,2302,2617
test4sub72of100,test4pub1of10,1,317,11,305,2342,2658
test4sub94of100,test4pub2of10,1,188,5,18,2339,2362
test4sub88of100,test4pub2of10,1,188,5,23,2334,2362
test4sub49of100,test4pub1of10,1,317,11,326,2361,2698
test4sub39of100,test4pub1of10,1,317,11,330,2397,2738
test4sub9of100,test4pub2of10,1,188,5,48,2389,2442
test4sub70of100,test4pub2of10,1,188,5,50,2387,2442
test4sub21of100,test4pub2of10,1,188,5,57,2381,2443
test4sub46of100,test4pub2of10,1,188,5,58,2381,2444
test4sub8of100,test4pub1of10,1,317,11,352,2419,2782
test4sub67of100,test4pub1of10,1,317,11,353,2457,2821
test4sub56of100,test4pub1of10,1,317,11,353,2497,2861
test4sub96of100,test4pub1of10,1,317,11,359,2532,2902
test4sub82of100,test4pub2of10,1,188,5,69,2531,2605
test4sub77of100,test4pub1of10,1,317,11,360,2570,2941
test4sub12of100,test4pub1of10,1,317,11,363,2607,2981
test4sub54of100,test4pub1of10,1,317,11,369,2642,3022
test4sub81of100,test4pub1of10,1,317,11,369,2681,3061
test4sub19of100,test4pub1of10,1,317,11,373,2717,3101
test4sub30of100,test4pub1of10,1,317,11,381,2750,3142
test4sub63of100,test4pub1of10,1,317,11,444,2726,3181
test4sub73of100,test4pub1of10,1,317,11,448,2762,3221
test4sub22of100,test4pub1of10,1,317,11,501,2750,3262
test4sub23of100,test4pub1of10,1,317,11,534,2756,3301
test4sub3of100,test4pub2of10,1,188,5,277,2724,3006
test4sub66of100,test4pub2of10,1,188,5,356,2645,3006
test4sub74of100,test4pub2of10,1,188,5,408,2594,3007
test4sub14of100,test4pub2of10,1,188,5,425,2577,3007
test4sub78of100,test4pub2of10,1,188,5,437,2567,3009
test4sub16of100,test4pub2of10,1,188,5,477,2528,3010
test4sub98of100,test4pub2of10,1,188,5,546,2459,3010
test4sub60of100,test4pub2of10,1,188,5,557,2450,3012
test4sub32of100,test4pub2of10,1,188,5,597,2410,3012
test4sub18of100,test4pub2of10,1,188,5,637,2372,3014
test4sub51of100,test4pub2of10,1,188,5,677,2332,3014
test4sub31of100,test4pub2of10,1,188,5,717,2294,3016
test4sub35of100,test4pub2of10,1,188,5,757,2254,3016
test4sub44of100,test4pub3of10,1,188,6,462,2216,2684
test4sub6of100,test4pub2of10,1,188,5,837,2176,3018
test4sub11of100,test4pub2of10,1,188,5,877,2138,3020
test4sub84of100,test4pub2of10,1,188,5,917,2098,3020
test4sub24of100,test4pub2of10,1,188,5,957,2060,3022
test4sub50of100,test4pub3of10,1,188,6,662,2020,2688
test4sub59of100,test4pub2of10,1,188,5,1037,1981,3023
test4sub97of100,test4pub2of10,1,188,5,1077,1942,3024
test4sub71of100,test4pub2of10,1,188,5,1117,1903,3025
test4sub99of100,test4pub2of10,1,188,5,1157,1864,3026
test4sub38of100,test4pub2of10,1,188,5,1197,1825,3027
test4sub95of100,test4pub2of10,1,188,5,1237,1786,3028
test4sub25of100,test4pub2of10,1,188,5,1557,1482,3044
test4sub15of100,test4pub2of10,1,188,5,1517,1522,3044
test4sub89of100,test4pub2of10,1,188,5,1477,1563,3045
test4sub79of100,test4pub2of10,1,188,5,1397,1644,3046
test4sub36of100,test4pub2of10,1,188,5,1317,1725,3047
test4sub68of100,test4pub3of10,1,188,6,1102,1604,2712
test4sub57of100,test4pub2of10,1,188,5,1277,1766,3048
test4sub10of100,test4pub1of10,1,317,11,394,2969,3374
test4sub29of100,test4pub2of10,1,188,5,1597,1475,3077
test4sub43of100,test4pub2of10,1,188,5,1637,1437,3079
test4sub93of100,test4pub2of10,1,188,5,1677,1398,3080
test4sub40of100,test4pub2of10,1,188,5,1717,1359,3081
test4sub42of100,test4pub2of10,1,188,5,1757,1320,3082
test4sub76of100,test4pub2of10,1,188,5,1797,1281,3083
test4sub69of100,test4pub2of10,1,188,5,1837,1240,3082
test4sub100of100,test4pub2of10,1,188,5,1877,1203,3085
test4sub26of100,test4pub3of10,1,188,6,1582,1163,2751
test4sub2of100,test4pub2of10,1,188,5,1957,1125,3087
test4sub83of100,test4pub3of10,1,188,6,1662,1085,2753
test4sub92of100,test4pub2of10,1,188,5,2037,1046,3088
test4sub58of100,test4pub2of10,1,188,5,2077,1007,3089
test4sub65of100,test4pub2of10,1,188,5,2117,968,3090
test4sub86of100,test4pub2of10,1,188,5,2157,928,3090
test4sub85of100,test4pub2of10,1,188,5,2197,890,3092
test4sub47of100,test4pub2of10,1,188,5,2237,850,3092
test4sub55of100,test4pub2of10,1,188,5,2277,811,3093
test4sub80of100,test4pub2of10,1,188,5,2317,772,3094
test4sub72of100,test4pub2of10,1,188,5,2357,733,3095
test4sub88of100,test4pub1of10,1,317,11,2649,769,3429
test4sub49of100,test4pub2of10,1,188,5,2397,732,3134
test4sub39of100,test4pub2of10,1,188,5,2437,693,3135
test4sub9of100,test4pub1of10,1,317,11,2728,730,3469
test4sub21of100,test4pub1of10,1,317,11,2730,769,3510
test4sub70of100,test4pub1of10,1,317,11,2729,809,3549
test4sub46of100,test4pub1of10,1,317,11,2731,847,3589
test4sub8of100,test4pub3of10,1,188,6,2146,808,2960
test4sub67of100,test4pub3of10,1,188,6,2186,769,2961
test4sub56of100,test4pub3of10,1,188,6,2226,729,2961
test4sub94of100,test4pub1of10,1,317,11,2648,970,3629
test4sub96of100,test4pub3of10,1,188,6,2266,728,3000
test4sub82of100,test4pub1of10,1,317,11,2892,770,3673
test4sub77of100,test4pub3of10,1,188,6,2306,731,3043
test4sub12of100,test4pub2of10,1,188,5,2681,693,3379
test4sub54of100,test4pub2of10,1,188,5,2721,653,3379
test4sub81of100,test4pub2of10,1,188,5,2761,615,3381
test4sub19of100,test4pub2of10,1,188,5,2801,575,3381
test4sub30of100,test4pub2of10,1,188,5,2841,537,3383
test4sub63of100,test4pub2of10,1,188,5,2881,497,3383
test4sub73of100,test4pub3of10,1,188,6,2586,458,3050
test4sub22of100,test4pub2of10,1,188,5,2961,419,3385
test4sub23of100,test4pub2of10,1,188,5,3001,380,3386
test4sub3of100,test4pub3of10,1,188,6,2666,380,3052
test4sub66of100,test4pub3of10,1,188,6,2667,380,3053
test4sub74of100,test4pub3of10,1,188,6,2668,380,3054
test4sub14of100,test4pub3of10,1,188,6,2669,381,3056
test4sub78of100,test4pub3of10,1,188,6,2669,380,3055
test4sub16of100,test4pub3of10,1,188,6,2670,380,3056
test4sub60of100,test4pub4of10,1,188,7,2356,378,2741
test4sub32of100,test4pub4of10,1,188,7,2357,380,2744
test4sub18of100,test4pub4of10,1,188,7,2358,378,2743
test4sub51of100,test4pub3of10,1,188,6,2675,380,3061
test4sub31of100,test4pub4of10,1,188,7,2360,378,2745
test4sub35of100,test4pub3of10,1,188,6,2677,379,3062
test4sub44of100,test4pub2of10,1,188,5,3013,377,3395
test4sub6of100,test4pub3of10,1,188,6,2679,379,3064
test4sub11of100,test4pub3of10,1,188,6,2680,377,3063
test4sub84of100,test4pub3of10,1,188,6,2681,379,3066
test4sub24of100,test4pub3of10,1,188,6,2682,377,3065
test4sub50of100,test4pub2of10,1,188,5,3017,378,3400
test4sub59of100,test4pub3of10,1,188,6,2684,377,3067
test4sub97of100,test4pub3of10,1,188,6,2684,378,3068
test4sub71of100,test4pub4of10,1,188,7,2370,377,2754
test4sub99of100,test4pub4of10,1,188,7,2370,378,2755
test4sub38of100,test4pub3of10,1,188,6,2688,361,3055
test4sub95of100,test4pub4of10,1,188,7,2387,362,2756
test4sub25of100,test4pub3of10,1,188,6,2704,362,3072
test4sub15of100,test4pub3of10,1,188,6,2705,363,3074
test4sub89of100,test4pub4of10,1,188,7,2390,362,2759
test4sub79of100,test4pub3of10,1,188,6,2707,363,3076
test4sub36of100,test4pub4of10,1,188,7,2391,362,2760
test4sub68of100,test4pub2of10,1,188,5,3043,363,3411
test4sub57of100,test4pub3of10,1,188,6,2708,362,3076
test4sub10of100,test4pub2of10,1,188,5,3073,335,3413
test4sub29of100,test4pub4of10,1,188,7,2422,334,2763
test4sub43of100,test4pub4of10,1,188,7,2424,335,2766
test4sub93of100,test4pub3of10,1,188,6,2740,334,3080
test4sub40of100,test4pub3of10,1,188,6,2742,334,3082
test4sub42of100,test4pub3of10,1,188,6,2742,335,3083
test4sub76of100,test4pub3of10,1,188,6,2744,334,3084
test4sub69of100,test4pub4of10,1,188,7,2428,334,2769
test4sub100of100,test4pub3of10,1,188,6,2745,334,3085
test4sub26of100,test4pub2of10,1,188,5,3080,334,3419
test4sub2of100,test4pub3of10,1,188,6,2747,333,3086
test4sub83of100,test4pub2of10,1,188,5,3082,334,3421
test4sub92of100,test4pub3of10,1,188,6,2749,334,3089
test4sub58of100,test4pub3of10,1,188,6,2749,334,3089
test4sub65of100,test4pub3of10,1,188,6,2750,334,3090
test4sub86of100,test4pub3of10,1,188,6,2751,334,3091
test4sub85of100,test4pub3of10,1,188,6,2752,334,3092
test4sub47of100,test4pub3of10,1,188,6,2752,334,3092
test4sub55of100,test4pub3of10,1,188,6,2754,334,3094
test4sub80of100,test4pub3of10,1,188,6,2754,334,3094
test4sub72of100,test4pub3of10,1,188,6,2755,334,3095
test4sub4of100,test4pub1of10,1,317,11,394,3360,3765
test4sub88of100,test4pub3of10,1,188,6,2794,336,3136
test4sub39of100,test4pub3of10,1,188,6,2795,335,3136
test4sub53of100,test4pub1of10,1,317,11,454,3341,3806
test4sub9of100,test4pub3of10,1,188,6,2834,336,3176
test4sub21of100,test4pub3of10,1,188,6,2874,297,3177
test4sub70of100,test4pub4of10,1,188,7,2598,257,2862
test4sub46of100,test4pub4of10,1,188,7,2638,219,2864
test4sub67of100,test4pub2of10,1,188,5,3290,217,3512
test4sub56of100,test4pub2of10,1,188,5,3291,218,3514
test4sub33of100,test4pub1of10,1,317,11,397,3441,3849
test4sub96of100,test4pub2of10,1,188,5,3329,220,3554
test4sub82of100,test4pub4of10,1,188,7,2722,177,2906
test4sub77of100,test4pub2of10,1,188,5,3373,177,3555
test4sub12of100,test4pub3of10,1,188,6,3039,177,3222
test4sub54of100,test4pub3of10,1,188,6,3040,177,3223
test4sub81of100,test4pub4of10,1,188,7,2725,176,2908
test4sub19of100,test4pub4of10,1,188,7,2725,177,2909
test4sub30of100,test4pub3of10,1,188,6,3043,177,3226
test4sub63of100,test4pub3of10,1,188,6,3043,177,3226
test4sub73of100,test4pub2of10,1,188,5,3380,177,3562
test4sub22of100,test4pub3of10,1,188,6,3045,177,3228
test4sub23of100,test4pub3of10,1,188,6,3046,177,3229
test4sub3of100,test4pub4of10,1,188,7,2731,177,2915
test4sub66of100,test4pub4of10,1,188,7,2732,177,2916
test4sub74of100,test4pub4of10,1,188,7,2732,177,2916
test4sub78of100,test4pub5of10,1,188,5,2451,177,2633
test4sub14of100,test4pub4of10,1,188,7,2734,178,2919
test4sub16of100,test4pub4of10,1,188,7,2735,177,2919
test4sub60of100,test4pub3of10,1,188,6,3052,178,3236
test4sub18of100,test4pub3of10,1,188,6,3054,177,3237
test4sub32of100,test4pub3of10,1,188,6,3053,177,3236
test4sub51of100,test4pub5of10,1,188,5,2456,178,2639
test4sub31of100,test4pub3of10,1,188,6,3055,177,3238
test4sub44of100,test4pub4of10,1,188,7,2741,178,2926
test4sub35of100,test4pub4of10,1,188,7,2741,178,2926
test4sub6of100,test4pub4of10,1,188,7,2742,178,2927
test4sub11of100,test4pub4of10,1,188,7,2742,178,2927
test4sub84of100,test4pub4of10,1,188,7,2744,178,2929
test4sub24of100,test4pub4of10,1,188,7,2744,179,2930
test4sub50of100,test4pub5of10,1,188,5,2462,178,2645
test4sub59of100,test4pub4of10,1,188,7,2746,178,2931
test4sub97of100,test4pub4of10,1,188,7,2747,178,2932
test4sub71of100,test4pub3of10,1,188,6,3063,178,3247
test4sub38of100,test4pub4of10,1,188,7,2749,177,2933
test4sub99of100,test4pub3of10,1,188,6,3065,178,3249
test4sub25of100,test4pub4of10,1,188,7,2751,178,2936
test4sub95of100,test4pub3of10,1,188,6,3067,178,3251
test4sub15of100,test4pub4of10,1,188,7,2752,178,2937
test4sub89of100,test4pub3of10,1,188,6,3069,178,3253
test4sub79of100,test4pub4of10,1,188,7,2754,178,2939
test4sub36of100,test4pub3of10,1,188,6,3070,178,3254
test4sub68of100,test4pub4of10,1,188,7,2755,178,2940
test4sub57of100,test4pub4of10,1,188,7,2756,178,2941
test4sub10of100,test4pub3of10,1,188,6,3073,178,3257
test4sub29of100,test4pub5of10,1,188,5,2475,178,2658
test4sub93of100,test4pub4of10,1,188,7,2759,178,2944
test4sub43of100,test4pub3of10,1,188,6,3075,178,3259
test4sub42of100,test4pub4of10,1,188,7,2761,178,2946
test4sub40of100,test4pub4of10,1,188,7,2761,179,2947
test4sub76of100,test4pub4of10,1,188,7,2762,178,2947
test4sub69of100,test4pub3of10,1,188,6,3079,178,3263
test4sub100of100,test4pub4of10,1,188,7,2764,178,2949
test4sub26of100,test4pub4of10,1,188,7,2764,178,2949
test4sub83of100,test4pub4of10,1,188,7,2766,178,2951
test4sub2of100,test4pub4of10,1,188,7,2766,179,2952
test4sub58of100,test4pub4of10,1,188,7,2768,178,2953
test4sub92of100,test4pub4of10,1,188,7,2768,178,2953
test4sub86of100,test4pub4of10,1,188,7,2770,178,2955
test4sub65of100,test4pub4of10,1,188,7,2769,178,2954
test4sub85of100,test4pub4of10,1,188,7,2771,178,2956
test4sub47of100,test4pub4of10,1,188,7,2771,178,2956
test4sub55of100,test4pub4of10,1,188,7,2773,178,2958
test4sub80of100,test4pub4of10,1,188,7,2773,178,2958
test4sub72of100,test4pub4of10,1,188,7,2774,178,2959
test4sub20of100,test4pub2of10,1,188,5,437,3166,3608
test4sub4of100,test4pub2of10,1,188,5,3465,141,3611
test4sub39of100,test4pub4of10,1,188,7,2815,139,2961
test4sub53of100,test4pub2of10,1,188,5,3505,102,3612
test4sub9of100,test4pub4of10,1,188,7,2854,103,2964
test4sub21of100,test4pub4of10,1,188,7,2855,102,2964
test4sub70of100,test4pub3of10,1,188,6,3172,102,3280
test4sub46of100,test4pub3of10,1,188,6,3173,102,3281
test4sub67of100,test4pub4of10,1,188,7,2857,102,2966
test4sub56of100,test4pub4of10,1,188,7,2859,102,2968
test4sub37of100,test4pub3of10,1,188,6,176,3101,3283
test4sub33of100,test4pub2of10,1,188,5,3549,65,3619
test4sub82of100,test4pub3of10,1,188,6,3215,63,3284
test4sub77of100,test4pub4of10,1,188,7,2900,65,2972
test4sub12of100,test4pub4of10,1,188,7,2901,63,2971
test4sub54of100,test4pub4of10,1,188,7,2901,64,2972
test4sub81of100,test4pub3of10,1,188,6,3219,64,3289
test4sub19of100,test4pub3of10,1,188,6,3219,65,3290
test4sub63of100,test4pub4of10,1,188,7,2905,63,2975
test4sub30of100,test4pub4of10,1,188,7,2904,65,2976
test4sub22of100,test4pub4of10,1,188,7,2907,63,2977
test4sub73of100,test4pub4of10,1,188,7,2906,64,2977
test4sub3of100,test4pub5of10,1,188,5,2625,63,2693
test4sub23of100,test4pub4of10,1,188,7,2908,64,2979
test4sub66of100,test4pub7of10,1,188,6,2108,63,2177
test4sub74of100,test4pub5of10,1,188,5,2627,64,2696
test4sub78of100,test4pub4of10,1,188,7,2912,63,2982
test4sub14of100,test4pub6of10,1,188,5,2349,65,2419
test4sub16of100,test4pub7of10,1,188,6,2112,63,2181
test4sub60of100,test4pub5of10,1,188,5,2631,64,2700
test4sub18of100,test4pub5of10,1,188,5,2633,63,2701
test4sub32of100,test4pub5of10,1,188,5,2633,64,2702
test4sub31of100,test4pub7of10,1,188,6,2116,62,2184
test4sub51of100,test4pub6of10,1,188,5,2354,63,2422
test4sub44of100,test4pub5of10,1,188,5,2636,62,2703
test4sub35of100,test4pub6of10,1,188,5,2356,63,2424
test4sub28of100,test4pub2of10,1,188,5,566,3068,3639
test4sub6of100,test4pub5of10,1,188,5,2638,63,2706
test4sub84of100,test4pub5of10,1,188,5,2640,62,2707
test4sub24of100,test4pub5of10,1,188,5,2640,64,2709
test4sub59of100,test4pub6of10,1,188,5,2362,62,2429
test4sub50of100,test4pub4of10,1,188,7,2924,63,2994
test4sub97of100,test4pub5of10,1,188,5,2643,62,2710
test4sub71of100,test4pub5of10,1,188,5,2643,62,2710
test4sub38of100,test4pub5of10,1,188,5,2645,63,2713
test4sub99of100,test4pub5of10,1,188,5,2645,63,2713
test4sub25of100,test4pub5of10,1,188,5,2646,62,2713
test4sub95of100,test4pub5of10,1,188,5,2647,63,2715
test4sub15of100,test4pub5of10,1,188,5,2648,62,2715
test4sub89of100,test4pub6of10,1,188,5,2368,62,2435
test4sub79of100,test4pub5of10,1,188,5,2650,63,2718
test4sub36of100,test4pub5of10,1,188,5,2650,62,2717
test4sub68of100,test4pub5of10,1,188,5,2651,62,2718
test4sub57of100,test4pub6of10,1,188,5,2372,63,2440
test4sub10of100,test4pub4of10,1,188,7,2936,62,3005
test4sub29of100,test4pub3of10,1,188,6,3252,62,3320
test4sub93of100,test4pub5of10,1,188,5,2655,62,2722
test4sub43of100,test4pub5of10,1,188,5,2655,62,2722
test4sub40of100,test4pub7of10,1,188,6,2138,62,2206
test4sub42of100,test4pub5of10,1,188,5,2657,63,2725
test4sub76of100,test4pub5of10,1,188,5,2658,62,2725
test4sub69of100,test4pub5of10,1,188,5,2658,62,2725
test4sub26of100,test4pub5of10,1,188,5,2660,62,2727
test4sub100of100,test4pub5of10,1,188,5,2660,62,2727
test4sub83of100,test4pub5of10,1,188,5,2662,62,2729
test4sub2of100,test4pub5of10,1,188,5,2662,62,2729
test4sub58of100,test4pub5of10,1,188,5,2663,62,2730
test4sub92of100,test4pub5of10,1,188,5,2664,62,2731
test4sub86of100,test4pub5of10,1,188,5,2665,62,2732
test4sub65of100,test4pub6of10,1,188,5,2385,62,2452
test4sub85of100,test4pub5of10,1,188,5,2667,61,2733
test4sub47of100,test4pub5of10,1,188,5,2667,62,2734
test4sub80of100,test4pub5of10,1,188,5,2669,62,2736
test4sub55of100,test4pub5of10,1,188,5,2669,62,2736
test4sub34of100,test4pub2of10,1,188,5,597,3070,3672
test4sub72of100,test4pub5of10,1,188,5,2670,62,2737
test4sub4of100,test4pub4of10,1,188,7,2955,61,3023
test4sub39of100,test4pub5of10,1,188,5,2672,62,2739
test4sub9of100,test4pub5of10,1,188,5,2674,62,2741
test4sub53of100,test4pub3of10,1,188,6,3273,62,3341
test4sub21of100,test4pub6of10,1,188,5,2395,62,2462
test4sub70of100,test4pub5of10,1,188,5,2676,62,2743
test4sub46of100,test4pub6of10,1,188,5,2397,61,2463
test4sub67of100,test4pub5of10,1,188,5,2677,62,2744
test4sub37of100,test4pub2of10,1,188,5,3613,62,3680
test4sub56of100,test4pub5of10,1,188,5,2679,63,2747
test4sub82of100,test4pub6of10,1,188,5,2401,62,2468
test4sub33of100,test4pub3of10,1,188,6,3279,62,3347
test4sub77of100,test4pub5of10,1,188,5,2682,62,2749
test4sub12of100,test4pub6of10,1,188,5,2402,62,2469
test4sub54of100,test4pub6of10,1,188,5,2404,62,2471
test4sub81of100,test4pub5of10,1,188,5,2684,63,2752
test4sub19of100,test4pub5of10,1,188,5,2685,62,2752
test4sub63of100,test4pub6of10,1,188,5,2406,62,2473
test4sub30of100,test4pub6of10,1,188,5,2407,62,2474
test4sub22of100,test4pub7of10,1,188,6,2168,62,2236
test4sub73of100,test4pub5of10,1,188,5,2689,63,2757
test4sub3of100,test4pub6of10,1,188,5,2409,62,2476
test4sub66of100,test4pub6of10,1,188,5,2411,62,2478
test4sub23of100,test4pub6of10,1,188,5,2411,63,2479
test4sub74of100,test4pub6of10,1,188,5,2412,62,2479
test4sub78of100,test4pub8of10,1,188,5,1913,62,1980
test4sub14of100,test4pub5of10,1,188,5,2694,62,2761
test4sub16of100,test4pub5of10,1,188,5,2694,62,2761
test4sub60of100,test4pub6of10,1,188,5,2415,63,2483
test4sub18of100,test4pub6of10,1,188,5,2416,63,2484
test4sub31of100,test4pub6of10,1,188,5,2417,62,2484
test4sub32of100,test4pub6of10,1,188,5,2417,63,2485
test4sub51of100,test4pub4of10,1,188,7,2982,63,3052
test4sub44of100,test4pub7of10,1,188,6,2180,62,2248
test4sub35of100,test4pub5of10,1,188,5,2701,63,2769
test4sub28of100,test4pub3of10,1,188,6,3300,63,3369
test4sub84of100,test4pub7of10,1,188,6,2184,62,2252
test4sub6of100,test4pub6of10,1,188,5,2422,63,2490
test4sub24of100,test4pub6of10,1,188,5,2424,62,2491
test4sub59of100,test4pub5of10,1,188,5,2704,62,2771
test4sub98of100,test4pub3of10,1,188,6,2671,697,3374
test4sub97of100,test4pub7of10,1,188,6,2187,62,2255
test4sub71of100,test4pub8of10,1,188,5,1928,63,1996
test4sub38of100,test4pub6of10,1,188,5,2428,62,2495
test4sub99of100,test4pub7of10,1,188,6,2189,63,2258
test4sub25of100,test4pub7of10,1,188,6,2191,62,2259
test4sub95of100,test4pub7of10,1,188,6,2191,64,2261
test4sub15of100,test4pub6of10,1,188,5,2431,62,2498
test4sub89of100,test4pub5of10,1,188,5,2712,63,2780
test4sub79of100,test4pub7of10,1,188,6,2194,63,2263
test4sub36of100,test4pub7of10,1,188,6,2194,64,2264
test4sub68of100,test4pub6of10,1,188,5,2435,62,2502
test4sub57of100,test4pub5of10,1,188,5,2715,64,2784
test4sub10of100,test4pub5of10,1,188,5,2716,62,2783
test4sub29of100,test4pub7of10,1,188,6,2198,63,2267
test4sub93of100,test4pub6of10,1,188,5,2438,62,2505
test4sub43of100,test4pub6of10,1,188,5,2438,63,2506
test4sub42of100,test4pub6of10,1,188,5,2440,62,2507
test4sub40of100,test4pub5of10,1,188,5,2720,64,2789
test4sub76of100,test4pub6of10,1,188,5,2441,62,2508
test4sub69of100,test4pub7of10,1,188,6,2203,63,2272
test4sub26of100,test4pub9of10,1,188,5,1673,62,1740
test4sub100of100,test4pub7of10,1,188,6,2204,63,2273
test4sub83of100,test4pub6of10,1,188,5,2445,62,2512
test4sub2of100,test4pub6of10,1,188,5,2445,64,2514
test4sub92of100,test4pub6of10,1,188,5,2446,62,2513
test4sub58of100,test4pub7of10,1,188,6,2207,64,2277
test4sub86of100,test4pub7of10,1,188,6,2209,63,2278
test4sub65of100,test4pub5of10,1,188,5,2728,63,2796
test4sub47of100,test4pub7of10,1,188,6,2211,63,2280
test4sub85of100,test4pub6of10,1,188,5,2450,64,2519
test4sub80of100,test4pub6of10,1,188,5,2451,62,2518
test4sub55of100,test4pub7of10,1,188,6,2213,64,2283
test4sub34of100,test4pub3of10,1,188,6,3332,62,3400
test4sub72of100,test4pub6of10,1,188,5,2453,64,2522
test4sub4of100,test4pub3of10,1,188,6,3334,63,3403
test4sub39of100,test4pub6of10,1,188,5,2455,64,2524
test4sub9of100,test4pub8of10,1,188,5,1957,63,2025
test4sub53of100,test4pub4of10,1,188,7,3020,64,3091
test4sub21of100,test4pub5of10,1,188,5,2738,62,2805
test4sub70of100,test4pub6of10,1,188,5,2458,64,2527
test4sub67of100,test4pub6of10,1,188,5,2460,63,2528
test4sub46of100,test4pub5of10,1,188,5,2740,63,2808
test4sub37of100,test4pub4of10,1,188,7,3025,63,3095
test4sub56of100,test4pub7of10,1,188,6,2223,64,2293
test4sub82of100,test4pub5of10,1,188,5,2743,62,2810
test4sub33of100,test4pub5of10,1,188,5,2744,64,2813
test4sub77of100,test4pub6of10,1,188,5,2465,62,2532
test4sub12of100,test4pub5of10,1,188,5,2745,63,2813
test4sub54of100,test4pub5of10,1,188,5,2747,62,2814
test4sub81of100,test4pub7of10,1,188,6,2228,64,2298
test4sub19of100,test4pub7of10,1,188,6,2229,62,2297
test4sub63of100,test4pub5of10,1,188,5,2749,64,2818
test4sub22of100,test4pub5of10,1,188,5,2750,62,2817
test4sub30of100,test4pub5of10,1,188,5,2750,63,2818
test4sub73of100,test4pub7of10,1,188,6,2233,62,2301
test4sub3of100,test4pub8of10,1,188,5,1973,63,2041
test4sub66of100,test4pub8of10,1,188,5,1974,62,2041
test4sub23of100,test4pub5of10,1,188,5,2754,64,2823
test4sub74of100,test4pub9of10,1,188,5,1705,62,1772
test4sub78of100,test4pub9of10,1,188,5,1706,64,1775
test4sub14of100,test4pub7of10,1,188,6,2238,62,2306
test4sub16of100,test4pub8of10,1,188,5,1978,63,2046
test4sub18of100,test4pub7of10,1,188,6,2240,61,2307
test4sub60of100,test4pub7of10,1,188,6,2240,63,2309
test4sub31of100,test4pub5of10,1,188,5,2761,62,2828
test4sub32of100,test4pub7of10,1,188,6,2242,63,2311
test4sub44of100,test4pub6of10,1,188,5,2483,62,2550
test4sub51of100,test4pub7of10,1,188,6,2243,63,2312
test4sub35of100,test4pub9of10,1,188,5,1714,62,1781
test4sub98of100,test4pub4of10,1,188,7,3052,72,3131
test4sub59of100,test4pub7of10,1,188,6,2249,74,2329
test4sub24of100,test4pub7of10,1,188,6,2248,75,2329
test4sub97of100,test4pub6of10,1,188,5,2489,73,2567
test4sub6of100,test4pub9of10,1,188,5,1716,78,1799
test4sub28of100,test4pub4of10,1,188,7,3047,79,3133
test4sub84of100,test4pub6of10,1,188,5,2486,78,2569
test4sub38of100,test4pub8of10,1,188,5,1992,76,2073
test4sub71of100,test4pub6of10,1,188,5,2491,76,2572
test4sub25of100,test4pub6of10,1,188,5,2493,75,2573
test4sub99of100,test4pub6of10,1,188,5,2492,76,2573
test4sub15of100,test4pub9of10,1,188,5,1724,75,1804
test4sub95of100,test4pub6of10,1,188,5,2494,75,2574
test4sub79of100,test4pub6of10,1,188,5,2496,76,2577
test4sub89of100,test4pub7of10,1,188,6,2257,76,2339
test4sub68of100,test4pub7of10,1,188,6,2259,76,2341
test4sub36of100,test4pub6of10,1,188,5,2497,76,2578
test4sub57of100,test4pub8of10,1,188,5,2000,76,2081
test4sub10of100,test4pub7of10,1,188,6,2260,76,2342
test4sub29of100,test4pub8of10,1,188,5,2002,76,2083
test4sub93of100,test4pub7of10,1,188,6,2262,77,2345
test4sub42of100,test4pub9of10,1,188,5,1733,76,1814
test4sub43of100,test4pub8of10,1,188,5,2003,76,2084
test4sub76of100,test4pub9of10,1,188,5,1734,76,1815
test4sub40of100,test4pub6of10,1,188,5,2504,76,2585
test4sub69of100,test4pub6of10,1,188,5,2506,76,2587
test4sub26of100,test4pub6of10,1,188,5,2506,76,2587
test4sub100of100,test4pub6of10,1,188,5,2508,76,2589
test4sub83of100,test4pub7of10,1,188,6,2269,77,2352
test4sub2of100,test4pub7of10,1,188,6,2270,76,2352
test4sub92of100,test4pub8of10,1,188,5,2011,76,2092
test4sub58of100,test4pub6of10,1,188,5,2511,76,2592
test4sub86of100,test4pub6of10,1,188,5,2511,76,2592
test4sub65of100,test4pub7of10,1,188,6,2274,77,2357
test4sub47of100,test4pub6of10,1,188,5,2513,77,2595
test4sub85of100,test4pub9of10,1,188,5,1744,76,1825
test4sub80of100,test4pub7of10,1,188,6,2276,77,2359
test4sub55of100,test4pub6of10,1,188,5,2516,76,2597
test4sub34of100,test4pub4of10,1,188,7,3079,76,3162
test4sub72of100,test4pub9of10,1,188,5,1748,76,1829
test4sub4of100,test4pub5of10,1,188,5,2798,76,2879
test4sub9of100,test4pub6of10,1,188,5,2520,77,2602
test4sub39of100,test4pub8of10,1,188,5,2021,77,2103
test4sub53of100,test4pub6of10,1,188,5,2521,76,2602
test4sub21of100,test4pub9of10,1,188,5,1751,77,1833
test4sub67of100,test4pub9of10,1,188,5,1753,76,1834
test4sub70of100,test4pub7of10,1,188,6,2284,76,2366
test4sub46of100,test4pub7of10,1,188,6,2286,77,2369
test4sub37of100,test4pub6of10,1,188,5,2525,77,2607
test4sub56of100,test4pub6of10,1,188,5,2526,77,2608
test4sub82of100,test4pub7of10,1,188,6,2288,77,2371
test4sub33of100,test4pub4of10,1,188,7,3091,76,3174
test4sub77of100,test4pub7of10,1,188,6,2289,77,2372
test4sub12of100,test4pub8of10,1,188,5,2030,77,2112
test4sub54of100,test4pub7of10,1,188,6,2291,77,2374
test4sub19of100,test4pub8of10,1,188,5,2033,77,2115
test4sub81of100,test4pub6of10,1,188,5,2531,77,2613
test4sub63of100,test4pub9of10,1,188,5,1763,78,1846
test4sub22of100,test4pub6of10,1,188,5,2533,77,2615
test4sub30of100,test4pub7of10,1,188,6,2296,77,2379
test4sub73of100,test4pub6of10,1,188,5,2535,78,2618
test4sub3of100,test4pub9of10,1,188,5,1766,77,1848
test4sub66of100,test4pub5of10,1,188,5,2817,77,2899
test4sub23of100,test4pub7of10,1,188,6,2299,77,2382
test4sub74of100,test4pub10of10,1,189,5,1496,77,1578
test4sub78of100,test4pub6of10,1,188,5,2540,77,2622
test4sub14of100,test4pub8of10,1,188,5,2041,77,2123
test4sub16of100,test4pub6of10,1,188,5,2541,77,2623
test4sub18of100,test4pub9of10,1,188,5,1772,78,1855
test4sub60of100,test4pub8of10,1,188,5,2044,77,2126
test4sub31of100,test4pub8of10,1,188,5,2044,77,2126
test4sub32of100,test4pub10of10,1,189,5,1503,78,1586
test4sub44of100,test4pub10of10,1,189,5,1503,78,1586
test4sub51of100,test4pub8of10,1,188,5,2048,63,2116
test4sub35of100,test4pub7of10,1,188,6,2321,64,2391
test4sub59of100,test4pub8of10,1,188,5,2063,63,2131
test4sub98of100,test4pub5of10,1,188,5,2842,64,2911
test4sub24of100,test4pub9of10,1,188,5,1793,64,1862
test4sub97of100,test4pub8of10,1,188,5,2065,64,2134
test4sub6of100,test4pub10of10,1,189,5,1522,65,1592
test4sub28of100,test4pub5of10,1,188,5,2844,65,2914
test4sub84of100,test4pub8of10,1,188,5,2066,66,2137
test4sub38of100,test4pub9of10,1,188,5,1797,64,1866
test4sub71of100,test4pub9of10,1,188,5,1797,65,1867
test4sub25of100,test4pub9of10,1,188,5,1799,65,1869
test4sub99of100,test4pub8of10,1,188,5,2070,66,2141
test4sub15of100,test4pub7of10,1,188,6,2331,65,2402
test4sub95of100,test4pub8of10,1,188,5,2072,66,2143
test4sub79of100,test4pub9of10,1,188,5,1802,64,1871
test4sub89of100,test4pub9of10,1,188,5,1803,66,1874
test4sub68of100,test4pub9of10,1,188,5,1804,64,1873
test4sub36of100,test4pub9of10,1,188,5,1804,65,1874
test4sub57of100,test4pub7of10,1,188,6,2337,65,2408
test4sub10of100,test4pub6of10,1,188,5,2576,65,2646
test4sub29of100,test4pub6of10,1,188,5,2578,65,2648
test4sub93of100,test4pub9of10,1,188,5,1808,66,1879
test4sub42of100,test4pub7of10,1,188,6,2340,64,2410
test4sub43of100,test4pub10of10,1,189,5,1538,66,1609
test4sub76of100,test4pub7of10,1,188,6,2342,64,2412
test4sub40of100,test4pub8of10,1,188,5,2082,65,2152
test4sub69of100,test4pub10of10,1,189,5,1541,65,1611
test4sub26of100,test4pub10of10,1,189,5,1541,65,1611
test4sub100of100,test4pub10of10,1,189,5,1542,64,1611
test4sub83of100,test4pub9of10,1,188,5,1815,66,1886
test4sub2of100,test4pub8of10,1,188,5,2087,64,2156
test4sub92of100,test4pub7of10,1,188,6,2348,66,2420
test4sub58of100,test4pub9of10,1,188,5,1818,64,1887
test4sub86of100,test4pub10of10,1,189,5,1546,66,1617
test4sub65of100,test4pub8of10,1,188,5,2091,65,2161
test4sub47of100,test4pub9of10,1,188,5,1820,66,1891
test4sub85of100,test4pub7of10,1,188,6,2352,65,2423
test4sub80of100,test4pub9of10,1,188,5,1822,66,1893
test4sub55of100,test4pub9of10,1,188,5,1823,65,1893
test4sub34of100,test4pub5of10,1,188,5,2874,66,2945
test4sub72of100,test4pub10of10,1,189,5,1553,64,1622
test4sub4of100,test4pub6of10,1,188,5,2595,66,2666
test4sub9of100,test4pub7of10,1,188,6,2358,65,2429
test4sub39of100,test4pub7of10,1,188,6,2358,66,2430
test4sub53of100,test4pub5of10,1,188,5,2879,65,2949
test4sub21of100,test4pub7of10,1,188,6,2360,66,2432
test4sub67of100,test4pub7of10,1,188,6,2361,65,2432
test4sub70of100,test4pub8of10,1,188,5,2102,66,2173
test4sub46of100,test4pub9of10,1,188,5,1832,65,1902
test4sub37of100,test4pub5of10,1,188,5,2882,66,2953
test4sub56of100,test4pub9of10,1,188,5,1834,64,1903
test4sub82of100,test4pub9of10,1,188,5,1834,66,1905
test4sub33of100,test4pub7of10,1,188,6,2367,65,2438
test4sub77of100,test4pub9of10,1,188,5,1836,66,1907
test4sub12of100,test4pub7of10,1,188,6,2368,65,2439
test4sub54of100,test4pub9of10,1,188,5,1838,66,1909
test4sub19of100,test4pub6of10,1,188,5,2609,65,2679
test4sub81of100,test4pub8of10,1,188,5,2110,66,2181
test4sub63of100,test4pub10of10,1,189,5,1569,64,1638
test4sub22of100,test4pub8of10,1,188,5,2112,66,2183
test4sub30of100,test4pub9of10,1,188,5,1843,65,1913
test4sub73of100,test4pub9of10,1,188,5,1843,67,1915
test4sub3of100,test4pub7of10,1,188,6,2375,65,2446
test4sub66of100,test4pub9of10,1,188,5,1845,66,1916
test4sub23of100,test4pub10of10,1,189,5,1574,65,1644
test4sub74of100,test4pub7of10,1,188,6,2378,66,2450
test4sub78of100,test4pub7of10,1,188,6,2379,65,2450
test4sub14of100,test4pub9of10,1,188,5,1848,66,1919
test4sub16of100,test4pub10of10,1,189,5,1578,65,1648
test4sub18of100,test4pub8of10,1,188,5,2121,67,2193
test4sub20of100,test4pub3of10,1,188,6,3270,296,3572
test4sub60of100,test4pub9of10,1,188,5,1851,66,1922
test4sub32of100,test4pub8of10,1,188,5,2124,65,2194
test4sub44of100,test4pub8of10,1,188,5,2124,66,2195
test4sub51of100,test4pub9of10,1,188,5,1855,66,1926
test4sub35of100,test4pub8of10,1,188,5,2126,66,2197
test4sub59of100,test4pub10of10,1,189,5,1585,65,1655
test4sub98of100,test4pub7of10,1,188,6,2388,67,2461
test4sub24of100,test4pub8of10,1,188,5,2129,65,2199
test4sub97of100,test4pub9of10,1,188,5,1859,67,1931
test4sub75of100,test4pub3of10,1,188,6,263,3312,3581
test4sub6of100,test4pub7of10,1,188,6,2391,66,2463
test4sub84of100,test4pub10of10,1,189,5,1590,66,1661
test4sub38of100,test4pub7of10,1,188,6,2393,66,2465
test4sub71of100,test4pub7of10,1,188,6,2395,66,2467
test4sub25of100,test4pub8of10,1,188,5,2135,66,2206
test4sub99of100,test4pub9of10,1,188,5,1866,65,1936
test4sub15of100,test4pub8of10,1,188,5,2137,67,2209
test4sub95of100,test4pub9of10,1,188,5,1867,65,1937
test4sub79of100,test4pub8of10,1,188,5,2139,66,2210
test4sub89of100,test4pub8of10,1,188,5,2140,65,2210
test4sub68of100,test4pub8of10,1,188,5,2140,66,2211
test4sub36of100,test4pub10of10,1,189,5,1599,66,1670
test4sub57of100,test4pub9of10,1,188,5,1871,66,1942
test4sub10of100,test4pub8of10,1,188,5,2144,65,2214
test4sub29of100,test4pub10of10,1,189,5,1601,67,1673
test4sub93of100,test4pub8of10,1,188,5,2145,65,2215
test4sub42of100,test4pub8of10,1,188,5,2146,66,2217
test4sub43of100,test4pub7of10,1,188,6,2407,65,2478
test4sub76of100,test4pub8of10,1,188,5,2147,66,2218
test4sub40of100,test4pub9of10,1,188,5,1878,65,1948
test4sub69of100,test4pub8of10,1,188,5,2149,67,2221
test4sub26of100,test4pub7of10,1,188,6,2410,65,2481
test4sub100of100,test4pub9of10,1,188,5,1880,67,1952
test4sub83of100,test4pub8of10,1,188,5,2152,65,2222
test4sub2of100,test4pub9of10,1,188,5,1882,66,1953
test4sub92of100,test4pub9of10,1,188,5,1883,65,1953
test4sub58of100,test4pub8of10,1,188,5,2155,66,2226
test4sub86of100,test4pub9of10,1,188,5,1885,64,1954
test4sub65of100,test4pub9of10,1,188,5,1885,66,1956
test4sub47of100,test4pub8of10,1,188,5,2158,65,2228
test4sub85of100,test4pub10of10,1,189,5,1615,66,1686
test4sub80of100,test4pub8of10,1,188,5,2160,65,2230
test4sub55of100,test4pub10of10,1,189,5,1617,66,1688
test4sub34of100,test4pub8of10,1,188,5,2161,65,2231
test4sub72of100,test4pub7of10,1,188,6,2422,66,2494
test4sub4of100,test4pub9of10,1,188,5,1892,65,1962
test4sub9of100,test4pub9of10,1,188,5,1893,66,1964
test4sub39of100,test4pub9of10,1,188,5,1894,64,1963
test4sub53of100,test4pub8of10,1,188,5,2165,66,2236
test4sub21of100,test4pub10of10,1,189,5,1624,65,1694
test4sub67of100,test4pub10of10,1,189,5,1624,65,1694
test4sub70of100,test4pub9of10,1,188,5,1898,65,1968
test4sub46of100,test4pub8of10,1,188,5,2169,66,2240
test4sub37of100,test4pub8of10,1,188,5,2170,65,2240
test4sub56of100,test4pub10of10,1,189,5,1628,66,1699
test4sub82of100,test4pub8of10,1,188,5,2172,64,2241
test4sub33of100,test4pub6of10,1,188,5,2671,66,2742
test4sub77of100,test4pub8of10,1,188,5,2174,65,2244
test4sub12of100,test4pub9of10,1,188,5,1903,66,1974
test4sub54of100,test4pub8of10,1,188,5,2176,65,2246
test4sub19of100,test4pub9of10,1,188,5,1905,66,1976
test4sub81of100,test4pub9of10,1,188,5,1906,64,1975
test4sub63of100,test4pub7of10,1,188,6,2438,66,2510
test4sub22of100,test4pub9of10,1,188,5,1908,64,1977
test4sub30of100,test4pub8of10,1,188,5,2180,66,2251
test4sub73of100,test4pub10of10,1,189,5,1638,64,1707
test4sub3of100,test4pub10of10,1,189,5,1638,65,1708
test4sub66of100,test4pub10of10,1,189,5,1640,65,1710
test4sub23of100,test4pub8of10,1,188,5,2183,64,2252
test4sub74of100,test4pub8of10,1,188,5,2185,64,2254
test4sub78of100,test4pub10of10,1,189,5,1642,64,1711
test4sub14of100,test4pub10of10,1,189,5,1643,63,1711
test4sub16of100,test4pub9of10,1,188,5,1916,63,1984
test4sub18of100,test4pub10of10,1,189,5,1645,62,1712
test4sub20of100,test4pub4of10,1,188,7,3250,62,3319
test4sub60of100,test4pub10of10,1,189,5,1647,61,1713
test4sub32of100,test4pub9of10,1,188,5,1919,61,1985
test4sub44of100,test4pub9of10,1,188,5,1921,61,1987
test4sub51of100,test4pub10of10,1,189,5,1649,61,1715
test4sub35of100,test4pub10of10,1,189,5,1650,59,1714
test4sub59of100,test4pub9of10,1,188,5,1923,60,1988
test4sub98of100,test4pub6of10,1,188,5,2694,58,2757
test4sub24of100,test4pub10of10,1,189,5,1653,59,1717
test4sub97of100,test4pub10of10,1,189,5,1654,58,1717
test4sub75of100,test4pub2of10,1,188,5,3910,58,3973
test4sub6of100,test4pub8of10,1,188,5,2199,57,2261
test4sub84of100,test4pub9of10,1,188,5,1928,57,1990
test4sub38of100,test4pub10of10,1,189,5,1658,57,1720
test4sub71of100,test4pub10of10,1,189,5,1658,57,1720
test4sub25of100,test4pub10of10,1,189,5,1659,55,1719
test4sub99of100,test4pub10of10,1,189,5,1660,56,1721
test4sub15of100,test4pub10of10,1,189,5,1661,54,1720
test4sub95of100,test4pub10of10,1,189,5,1661,54,1720
test4sub79of100,test4pub10of10,1,189,5,1663,54,1722
test4sub89of100,test4pub10of10,1,189,5,1663,53,1721
test4sub68of100,test4pub10of10,1,189,5,1665,52,1722
test4sub36of100,test4pub8of10,1,188,5,2208,52,2265
test4sub57of100,test4pub10of10,1,189,5,1666,51,1722
test4sub10of100,test4pub9of10,1,188,5,1939,51,1995
test4sub29of100,test4pub9of10,1,188,5,1940,50,1995
test4sub93of100,test4pub10of10,1,189,5,1668,50,1723
test4sub42of100,test4pub10of10,1,189,5,1670,50,1725
test4sub43of100,test4pub9of10,1,188,5,1942,49,1996
test4sub76of100,test4pub10of10,1,189,5,1671,49,1725
test4sub40of100,test4pub10of10,1,189,5,1672,49,1726
test4sub69of100,test4pub9of10,1,188,5,1945,47,1997
test4sub26of100,test4pub8of10,1,188,5,2216,48,2269
test4sub100of100,test4pub8of10,1,188,5,2218,46,2269
test4sub83of100,test4pub10of10,1,189,5,1675,47,1727
test4sub2of100,test4pub10of10,1,189,5,1677,46,1728
test4sub92of100,test4pub10of10,1,189,5,1677,45,1727
test4sub58of100,test4pub10of10,1,189,5,1678,45,1728
test4sub86of100,test4pub8of10,1,188,5,2222,45,2272
test4sub65of100,test4pub10of10,1,189,5,1680,43,1728
test4sub47of100,test4pub10of10,1,189,5,1681,43,1729
test4sub85of100,test4pub8of10,1,188,5,2225,42,2272
test4sub80of100,test4pub10of10,1,189,5,1682,42,1729
test4sub55of100,test4pub8of10,1,188,5,2227,41,2273
test4sub34of100,test4pub6of10,1,188,5,2726,41,2772
test4sub72of100,test4pub8of10,1,188,5,2228,40,2273
test4sub4of100,test4pub10of10,1,189,5,1686,41,1732
test4sub9of100,test4pub10of10,1,189,5,1687,40,1732
test4sub39of100,test4pub10of10,1,189,5,1688,40,1733
test4sub53of100,test4pub9of10,1,188,5,1961,39,2005
test4sub21of100,test4pub8of10,1,188,5,2232,39,2276
test4sub67of100,test4pub8of10,1,188,5,2234,39,2278
test4sub70of100,test4pub10of10,1,189,5,1691,38,1734
test4sub46of100,test4pub10of10,1,189,5,1693,38,1736
test4sub37of100,test4pub9of10,1,188,5,1965,38,2008
test4sub56of100,test4pub8of10,1,188,5,2237,37,2279
test4sub82of100,test4pub10of10,1,189,5,1695,38,1738
test4sub33of100,test4pub8of10,1,188,5,2239,36,2280
test4sub77of100,test4pub10of10,1,189,5,1696,37,1738
test4sub12of100,test4pub10of10,1,189,5,1698,36,1739
test4sub54of100,test4pub10of10,1,189,5,1698,36,1739
test4sub19of100,test4pub10of10,1,189,5,1699,35,1739
test4sub81of100,test4pub10of10,1,189,5,1700,36,1741
test4sub63of100,test4pub8of10,1,188,5,2244,34,2283
test4sub22of100,test4pub10of10,1,189,5,1702,34,1741
test4sub30of100,test4pub10of10,1,189,5,1703,33,1741
test4sub73of100,test4pub8of10,1,188,5,2246,33,2284
test4sub23of100,test4pub9of10,1,188,5,1978,31,2014
test4sub20of100,test4pub5of10,1,188,5,3030,29,3064
test4sub98of100,test4pub9of10,1,188,5,1983,26,2014
test4sub75of100,test4pub4of10,1,188,7,3318,25,3350
test4sub10of100,test4pub10of10,1,189,5,1718,21,1744
test4sub34of100,test4pub7of10,1,188,6,2529,13,2548
test4sub4of100,test4pub8of10,1,188,5,2270,13,2288
test4sub53of100,test4pub7of10,1,188,6,2532,13,2551
test4sub37of100,test4pub7of10,1,188,6,2535,11,2552
test4sub33of100,test4pub9of10,1,188,5,2006,10,2021
test4sub20of100,test4pub6of10,1,188,5,2780,6,2791
test4sub98of100,test4pub8of10,1,188,5,2281,7,2293
test4sub75of100,test4pub5of10,1,188,5,3062,7,3074
test4sub34of100,test4pub10of10,1,189,5,1741,7,1753
test4sub4of100,test4pub7of10,1,188,6,2544,6,2556
test4sub53of100,test4pub10of10,1,189,5,1743,5,1753
test4sub37of100,test4pub10of10,1,189,5,1743,6,1754
test4sub33of100,test4pub10of10,1,189,5,1745,5,1755
test4sub20of100,test4pub7of10,1,188,6,2548,5,2559
test4sub98of100,test4pub10of10,1,189,5,1747,4,1756
test4sub75of100,test4pub6of10,1,188,5,2789,5,2799
test4sub94of100,test4pub4of10,1,188,7,2678,680,3365
test4sub34of100,test4pub9of10,1,188,5,2020,5,2030
test4sub20of100,test4pub9of10,1,188,5,2023,3,2031
test4sub75of100,test4pub8of10,1,188,5,2295,2,2302
test4sub94of100,test4pub3of10,1,188,6,3674,2,3682
test4sub20of100,test4pub8of10,1,188,5,2298,2,2305
test4sub75of100,test4pub7of10,1,188,6,2558,2,2566
test4sub94of100,test4pub5of10,1,188,5,3079,1,3085
test4sub20of100,test4pub10of10,1,189,5,1757,3,1765
test4sub75of100,test4pub9of10,1,188,5,2030,1,2036
test4sub94of100,test4pub6of10,1,188,5,2801,2,2808
test4sub75of100,test4pub10of10,1,189,5,1760,1,1766
test4sub94of100,test4pub9of10,1,188,5,2033,1,2039
test4sub94of100,test4pub7of10,1,188,6,2566,1,2573
test4sub94of100,test4pub8of10,1,188,5,2308,1,2314
test4sub94of100,test4pub10of10,1,189,5,1766,1,1772
test4sub61of100,test4pub2of10,1,188,5,1357,3007,4369
test4sub61of100,test4pub3of10,1,188,6,4030,1,4037
test4sub61of100,test4pub4of10,1,188,7,3715,0,3722
test4sub61of100,test4pub6of10,1,188,5,3154,1,3160
test4sub61of100,test4pub5of10,1,188,5,3435,0,3440
test4sub61of100,test4pub7of10,1,188,6,2918,1,2925
test4sub61of100,test4pub9of10,1,188,5,2388,1,2394
test4sub61of100,test4pub8of10,1,188,5,2660,1,2666
test4sub61of100,test4pub10of10,1,189,5,2119,1,2125
test4sub49of100,test4pub3of10,1,188,6,2794,3003,5803
test4sub49of100,test4pub5of10,1,188,5,5199,0,5204
test4sub49of100,test4pub4of10,1,188,7,5484,1,5492
test4sub49of100,test4pub8of10,1,188,5,4423,0,4428
test4sub49of100,test4pub6of10,1,188,5,4923,1,4929
test4sub49of100,test4pub9of10,1,188,5,4155,0,4160
test4sub49of100,test4pub10of10,1,189,5,3885,1,3891
test4sub49of100,test4pub7of10,1,188,6,4689,0,4695
test4sub8of100,test4pub2of10,1,188,5,3289,3003,6297
test4sub8of100,test4pub4of10,1,188,7,5642,1,5650
test4sub8of100,test4pub5of10,1,188,5,5360,0,5365
test4sub8of100,test4pub8of10,1,188,5,4583,1,4589
test4sub8of100,test4pub6of10,1,188,5,5083,0,5088
test4sub8of100,test4pub7of10,1,188,6,4846,1,4853
test4sub8of100,test4pub9of10,1,188,5,4316,0,4321
test4sub8of100,test4pub10of10,1,189,5,4046,1,4052
test4sub88of100,test4pub4of10,1,188,7,2814,3002,5823
test4sub88of100,test4pub5of10,1,188,5,5535,1,5541
test4sub88of100,test4pub6of10,1,188,5,5256,0,5261
test4sub88of100,test4pub8of10,1,188,5,4759,1,4765
test4sub88of100,test4pub7of10,1,188,6,5020,0,5026
test4sub88of100,test4pub9of10,1,188,5,4490,1,4496
test4sub88of100,test4pub10of10,1,189,5,4220,1,4226
test4sub96of100,test4pub4of10,1,188,7,2898,3007,5912
test4sub96of100,test4pub5of10,1,188,5,5623,1,5629
test4sub96of100,test4pub6of10,1,188,5,5344,0,5349
test4sub96of100,test4pub7of10,1,188,6,5107,1,5114
test4sub96of100,test4pub8of10,1,188,5,4848,0,4853
test4sub96of100,test4pub9of10,1,188,5,4579,1,4585
test4sub96of100,test4pub10of10,1,189,5,4308,1,4314
test4sub11of100,test4pub5of10,1,188,5,2638,3007,5650
test4sub11of100,test4pub6of10,1,188,5,5367,1,5373
test4sub11of100,test4pub7of10,1,188,6,5129,0,5135
test4sub11of100,test4pub8of10,1,188,5,4871,1,4877
test4sub11of100,test4pub9of10,1,188,5,4601,0,4606
test4sub11of100,test4pub10of10,1,189,5,4330,0,4335
test4sub50of100,test4pub6of10,1,188,5,2426,3003,5434
test4sub50of100,test4pub9of10,1,188,5,4661,1,4667
test4sub50of100,test4pub7of10,1,188,6,5193,0,5199
test4sub50of100,test4pub8of10,1,188,5,4935,1,4941
test4sub50of100,test4pub10of10,1,189,5,4393,0,4398
test4sub45of100,test4pub1of10,1,317,11,393,6621,7025
test4sub45of100,test4pub2of10,1,188,5,6724,1,6730
test4sub45of100,test4pub3of10,1,188,6,6391,1,6398
test4sub45of100,test4pub5of10,1,188,5,5793,1,5799
test4sub45of100,test4pub6of10,1,188,5,5515,0,5520
test4sub45of100,test4pub4of10,1,188,7,6080,1,6088
test4sub45of100,test4pub7of10,1,188,6,5279,0,5285
test4sub45of100,test4pub10of10,1,189,5,4478,1,4484
test4sub45of100,test4pub9of10,1,188,5,4751,0,4756
test4sub45of100,test4pub8of10,1,188,5,5024,1,5030
test4sub31of100,test4pub9of10,1,188,5,1852,3008,4865
test4sub31of100,test4pub10of10,1,189,5,4589,1,4595
test4sub28of100,test4pub7of10,1,188,6,2392,3007,5405
test4sub28of100,test4pub6of10,1,188,5,5639,1,5645
test4sub28of100,test4pub9of10,1,188,5,4870,0,4875
test4sub28of100,test4pub8of10,1,188,5,5142,1,5148
test4sub28of100,test4pub10of10,1,189,5,4601,0,4606
test4sub75of100,test4pub1of10,10,1468,12,15,40,67
test4sub94of100,test4pub2of10,10,189,6,21,20,47
test4sub88of100,test4pub2of10,10,189,6,36,5,47
test4sub93of100,test4pub2of10,10,189,6,69,29,104
test4sub25of100,test4pub2of10,10,189,6,68,31,105
test4sub68of100,test4pub3of10,10,189,6,50,33,89
test4sub14of100,test4pub1of10,10,1468,12,66,48,126
test4sub96of100,test4pub3of10,10,189,6,54,32,92
test4sub28of100,test4pub1of10,10,1468,12,89,67,168
test4sub73of100,test4pub3of10,10,189,6,71,55,132
test4sub9of100,test4pub2of10,10,189,6,88,55,149
test4sub44of100,test4pub3of10,10,189,6,76,51,133
test4sub51of100,test4pub2of10,10,189,6,100,43,149
test4sub3of100,test4pub2of10,10,189,6,100,43,149
test4sub70of100,test4pub2of10,10,189,6,102,43,151
test4sub92of100,test4pub4of10,10,189,7,40,41,88
test4sub61of100,test4pub2of10,10,189,6,106,38,150
test4sub29of100,test4pub5of10,10,189,5,40,30,75
test4sub21of100,test4pub2of10,10,189,6,116,32,154
test4sub8of100,test4pub3of10,10,189,6,103,28,137
test4sub95of100,test4pub5of10,10,189,5,45,28,78
test4sub46of100,test4pub2of10,10,189,6,125,24,155
test4sub86of100,test4pub5of10,10,189,5,49,24,78
test4sub23of100,test4pub4of10,10,189,7,63,22,92
test4sub20of100,test4pub1of10,10,1468,12,146,57,215
test4sub47of100,test4pub3of10,10,189,6,117,57,180
test4sub69of100,test4pub4of10,10,189,7,71,56,134
test4sub82of100,test4pub2of10,10,189,6,141,49,196
test4sub16of100,test4pub3of10,10,189,6,130,46,182
test4sub51of100,test4pub6of10,10,189,5,36,45,86
test4sub86of100,test4pub2of10,10,189,6,150,42,198
test4sub15of100,test4pub2of10,10,189,6,167,26,199
test4sub84of100,test4pub3of10,10,189,6,152,26,184
test4sub59of100,test4pub4of10,10,189,7,104,25,136
test4sub94of100,test4pub4of10,10,189,7,106,24,137
test4sub50of100,test4pub3of10,10,189,6,157,21,184
test4sub89of100,test4pub6of10,10,189,5,64,20,89
test4sub44of100,test4pub5of10,10,189,5,99,20,124
test4sub81of100,test4pub7of10,10,190,10,29,15,54
test4sub40of100,test4pub7of10,10,190,10,32,11,53
test4sub47of100,test4pub4of10,10,189,7,127,7,141
test4sub59of100,test4pub3of10,10,189,6,178,3,187
test4sub16of100,test4pub2of10,10,189,6,196,2,204
test4sub76of100,test4pub2of10,10,189,6,201,1,208
test4sub44of100,test4pub7of10,10,190,10,56,1,67
test4sub83of100,test4pub3of10,10,189,6,195,1,202
test4sub85of100,test4pub2of10,10,189,6,212,1,219
test4sub54of100,test4pub6of10,10,189,5,102,0,107
test4sub66of100,test4pub8of10,10,190,10,37,0,47
test4sub58of100,test4pub7of10,10,190,10,74,1,85
test4sub82of100,test4pub4of10,10,189,7,168,1,176
test4sub21of100,test4pub3of10,10,189,6,219,1,226
test4sub76of100,test4pub5of10,10,189,5,162,2,169
test4sub75of100,test4pub4of10,10,189,7,175,2,184
test4sub50of100,test4pub5of10,10,189,5,165,1,171
test4sub51of100,test4pub5of10,10,189,5,167,1,173
test4sub37of100,test4pub3of10,10,189,6,234,0,240
test4sub9of100,test4pub8of10,10,190,10,65,2,77
test4sub31of100,test4pub7of10,10,190,10,101,2,113
test4sub69of100,test4pub7of10,10,190,10,101,1,112
test4sub20of100,test4pub6of10,10,189,5,157,1,163
test4sub19of100,test4pub5of10,10,189,5,193,1,199
test4sub26of100,test4pub10of10,10,191,12,30,0,42
test4sub77of100,test4pub4of10,10,189,7,220,1,228
test4sub58of100,test4pub9of10,10,189,6,82,1,89
test4sub78of100,test4pub8of10,10,190,10,107,0,117
test4sub16of100,test4pub8of10,10,190,10,109,1,120
test4sub65of100,test4pub4of10,10,189,7,240,1,248
test4sub100of100,test4pub10of10,10,191,12,60,0,72
test4sub55of100,test4pub5of10,10,189,5,240,0,245
test4sub45of100,test4pub7of10,10,190,10,165,0,175
test4sub92of100,test4pub2of10,10,189,6,321,0,327
test4sub65of100,test4pub6of10,10,189,5,216,1,222
test4sub95of100,test4pub4of10,10,189,7,267,1,275
test4sub98of100,test4pub1of10,10,1468,12,347,40,399
test4sub45of100,test4pub6of10,10,189,5,233,29,267
test4sub36of100,test4pub4of10,10,189,7,283,27,317
test4sub47of100,test4pub7of10,10,190,10,195,26,231
test4sub67of100,test4pub3of10,10,189,6,337,23,366
test4sub14of100,test4pub3of10,10,189,6,339,22,367
test4sub68of100,test4pub4of10,10,189,7,294,19,320
test4sub35of100,test4pub6of10,10,189,5,249,17,271
test4sub66of100,test4pub1of10,10,1468,12,389,42,443
test4sub74of100,test4pub1of10,10,1468,12,399,72,483
test4sub89of100,test4pub2of10,10,189,6,387,71,464
test4sub55of100,test4pub10of10,10,191,12,137,71,220
test4sub19of100,test4pub8of10,10,190,10,201,70,281
test4sub34of100,test4pub10of10,10,191,12,146,63,221
test4sub76of100,test4pub9of10,10,189,6,187,62,255
test4sub39of100,test4pub5of10,10,189,5,331,52,388
test4sub6of100,test4pub10of10,10,191,12,162,50,224
test4sub37of100,test4pub4of10,10,189,7,352,44,403
test4sub66of100,test4pub7of10,10,190,10,265,43,318
test4sub88of100,test4pub3of10,10,189,6,406,40,452
test4sub33of100,test4pub5of10,10,189,5,348,37,390
test4sub4of100,test4pub10of10,10,191,12,179,34,225
test4sub43of100,test4pub10of10,10,191,12,196,18,226
test4sub61of100,test4pub7of10,10,190,10,294,17,321
test4sub96of100,test4pub7of10,10,190,10,299,13,322
test4sub19of100,test4pub7of10,10,190,10,306,5,321
test4sub55of100,test4pub3of10,10,189,6,447,1,454
test4sub45of100,test4pub3of10,10,189,6,451,1,458
test4sub51of100,test4pub3of10,10,189,6,451,1,458
test4sub32of100,test4pub10of10,10,191,12,226,1,239
test4sub86of100,test4pub10of10,10,191,12,227,1,240
test4sub12of100,test4pub6of10,10,189,5,368,1,374
test4sub71of100,test4pub5of10,10,189,5,413,1,419
test4sub19of100,test4pub4of10,10,189,7,426,1,434
test4sub71of100,test4pub8of10,10,190,10,311,0,321
test4sub74of100,test4pub10of10,10,191,12,265,0,277
test4sub65of100,test4pub3of10,10,189,6,502,0,508
test4sub28of100,test4pub7of10,10,190,10,371,1,382
test4sub8of100,test4pub8of10,10,190,10,338,1,349
test4sub35of100,test4pub9of10,10,189,6,320,0,326
test4sub76of100,test4pub4of10,10,189,7,468,0,475
test4sub78of100,test4pub5of10,10,189,5,468,0,473
test4sub78of100,test4pub1of10,10,1468,12,567,41,620
test4sub25of100,test4pub10of10,10,191,12,308,37,357
test4sub99of100,test4pub4of10,10,189,7,497,34,538
test4sub56of100,test4pub7of10,10,190,10,412,29,451
test4sub60of100,test4pub4of10,10,189,7,506,25,538
test4sub57of100,test4pub2of10,10,189,6,576,20,602
test4sub4of100,test4pub4of10,10,189,7,519,13,539
test4sub30of100,test4pub3of10,10,189,6,569,11,586
test4sub53of100,test4pub9of10,10,189,6,376,10,392
test4sub23of100,test4pub10of10,10,191,12,343,5,360
test4sub39of100,test4pub4of10,10,189,7,534,1,542
test4sub16of100,test4pub1of10,10,1468,12,624,39,675
test4sub26of100,test4pub5of10,10,189,5,537,38,580
test4sub25of100,test4pub7of10,10,190,10,465,32,507
test4sub18of100,test4pub2of10,10,189,6,624,27,657
test4sub61of100,test4pub4of10,10,189,7,562,26,595
test4sub10of100,test4pub4of10,10,189,7,564,24,595
test4sub96of100,test4pub6of10,10,189,5,520,21,546
test4sub79of100,test4pub4of10,10,189,7,568,20,595
test4sub11of100,test4pub4of10,10,189,7,576,13,596
test4sub29of100,test4pub7of10,10,190,10,489,12,511
test4sub34of100,test4pub1of10,10,1468,12,663,44,719
test4sub89of100,test4pub4of10,10,189,7,600,29,636
test4sub44of100,test4pub10of10,10,191,12,420,25,457
test4sub60of100,test4pub1of10,10,1468,12,690,56,758
test4sub37of100,test4pub1of10,10,1468,12,694,92,798
test4sub49of100,test4pub5of10,10,189,5,605,93,703
test4sub39of100,test4pub6of10,10,189,5,576,87,668
test4sub32of100,test4pub1of10,10,1468,12,706,121,839
test4sub12of100,test4pub8of10,10,190,10,510,117,637
test4sub30of100,test4pub9of10,10,189,6,483,122,611
test4sub86of100,test4pub7of10,10,190,10,551,110,671
test4sub11of100,test4pub6of10,10,189,5,602,102,709
test4sub21of100,test4pub4of10,10,189,7,672,79,758
test4sub26of100,test4pub9of10,10,189,6,526,80,612
test4sub3of100,test4pub1of10,10,1468,12,764,107,883
test4sub16of100,test4pub7of10,10,190,10,601,103,714
test4sub14of100,test4pub6of10,10,189,5,678,69,752
test4sub78of100,test4pub2of10,10,189,6,793,67,866
test4sub65of100,test4pub2of10,10,189,6,794,66,866
test4sub73of100,test4pub7of10,10,190,10,649,60,719
test4sub72of100,test4pub10of10,10,191,12,559,54,625
test4sub23of100,test4pub3of10,10,189,6,795,52,853
test4sub46of100,test4pub4of10,10,189,7,750,48,805
test4sub21of100,test4pub9of10,10,189,6,607,47,660
test4sub38of100,test4pub9of10,10,189,6,622,32,660
test4sub33of100,test4pub2of10,10,189,6,841,24,871
test4sub98of100,test4pub7of10,10,190,10,701,11,722
test4sub63of100,test4pub3of10,10,189,6,839,10,855
test4sub3of100,test4pub4of10,10,189,7,794,7,808
test4sub14of100,test4pub8of10,10,190,10,672,6,688
test4sub55of100,test4pub7of10,10,190,10,707,7,724
test4sub78of100,test4pub9of10,10,189,6,651,6,663
test4sub23of100,test4pub6of10,10,189,5,752,3,760
test4sub21of100,test4pub10of10,10,191,12,615,3,630
test4sub18of100,test4pub1of10,10,1468,12,883,40,935
test4sub80of100,test4pub5of10,10,189,5,796,38,839
test4sub58of100,test4pub5of10,10,189,5,797,38,840
test4sub96of100,test4pub5of10,10,189,5,800,36,841
test4sub45of100,test4pub5of10,10,189,5,810,26,841
test4sub83of100,test4pub5of10,10,189,5,812,24,841
test4sub71of100,test4pub9of10,10,189,6,699,3,708
test4sub83of100,test4pub4of10,10,189,7,848,1,856
test4sub34of100,test4pub8of10,10,190,10,731,1,742
test4sub57of100,test4pub6of10,10,189,5,809,1,815
test4sub75of100,test4pub3of10,10,189,6,904,1,911
test4sub73of100,test4pub10of10,10,191,12,675,0,687
test4sub83of100,test4pub6of10,10,189,5,820,0,825
test4sub37of100,test4pub6of10,10,189,5,825,0,830
test4sub84of100,test4pub7of10,10,190,10,785,1,796
test4sub56of100,test4pub3of10,10,189,6,928,1,935
test4sub39of100,test4pub8of10,10,190,10,759,1,770
test4sub57of100,test4pub8of10,10,190,10,760,3,773
test4sub70of100,test4pub5of10,10,189,5,872,3,880
test4sub77of100,test4pub3of10,10,189,6,933,3,942
test4sub85of100,test4pub10of10,10,191,12,701,2,715
test4sub4of100,test4pub2of10,10,189,6,961,1,968
test4sub47of100,test4pub5of10,10,189,5,885,2,892
test4sub79of100,test4pub2of10,10,189,6,962,1,969
test4sub47of100,test4pub9of10,10,189,6,754,0,760
test4sub15of100,test4pub5of10,10,189,5,896,1,902
test4sub95of100,test4pub2of10,10,189,6,976,1,983
test4sub53of100,test4pub2of10,10,189,6,977,1,984
test4sub32of100,test4pub4of10,10,189,7,916,0,923
test4sub85of100,test4pub9of10,10,189,6,773,1,780
test4sub59of100,test4pub8of10,10,190,10,798,1,809
test4sub10of100,test4pub8of10,10,190,10,799,0,809
test4sub47of100,test4pub10of10,10,191,12,742,1,755
test4sub59of100,test4pub6of10,10,189,5,882,0,887
test4sub38of100,test4pub8of10,10,190,10,822,1,833
test4sub50of100,test4pub9of10,10,189,6,807,1,814
test4sub63of100,test4pub10of10,10,191,12,769,2,783
test4sub93of100,test4pub6of10,10,189,5,908,1,914
test4sub51of100,test4pub1of10,10,1468,12,1033,42,1087
test4sub43of100,test4pub2of10,10,189,6,1028,34,1068
test4sub94of100,test4pub9of10,10,189,6,823,30,859
test4sub100of100,test4pub5of10,10,189,5,960,27,992
test4sub44of100,test4pub4of10,10,189,7,986,13,1006
test4sub93of100,test4pub4of10,10,189,7,991,8,1006
test4sub51of100,test4pub7of10,10,190,10,909,2,921
test4sub6of100,test4pub9of10,10,189,6,866,1,873
test4sub15of100,test4pub4of10,10,189,7,1012,4,1023
test4sub38of100,test4pub2of10,10,189,6,1077,3,1086
test4sub85of100,test4pub4of10,10,189,7,1014,4,1025
test4sub14of100,test4pub7of10,10,190,10,926,3,939
test4sub20of100,test4pub5of10,10,189,5,1004,2,1011
test4sub22of100,test4pub8of10,10,190,10,893,3,906
test4sub75of100,test4pub5of10,10,189,5,1009,1,1015
test4sub51of100,test4pub8of10,10,190,10,899,0,909
test4sub92of100,test4pub3of10,10,189,6,1072,1,1079
test4sub79of100,test4pub3of10,10,189,6,1073,0,1079
test4sub4of100,test4pub9of10,10,189,6,884,1,891
test4sub80of100,test4pub4of10,10,189,7,1037,1,1045
test4sub61of100,test4pub6of10,10,189,5,992,0,997
test4sub43of100,test4pub5of10,10,189,5,1031,1,1037
test4sub45of100,test4pub10of10,10,191,12,859,1,872
test4sub29of100,test4pub2of10,10,189,6,1109,1,1116
test4sub31of100,test4pub1of10,10,1468,12,1127,40,1179
test4sub71of100,test4pub4of10,10,189,7,1051,40,1098
test4sub88of100,test4pub8of10,10,190,10,929,40,979
test4sub66of100,test4pub10of10,10,191,12,872,35,919
test4sub44of100,test4pub1of10,10,1468,12,1136,72,1220
test4sub82of100,test4pub6of10,10,189,5,1014,68,1087
test4sub30of100,test4pub6of10,10,189,5,1015,69,1089
test4sub6of100,test4pub1of10,10,1468,12,1146,101,1259
test4sub35of100,test4pub1of10,10,1468,12,1148,141,1301
test4sub53of100,test4pub8of10,10,190,10,948,140,1098
test4sub49of100,test4pub10of10,10,191,12,886,140,1038
test4sub93of100,test4pub3of10,10,189,6,1129,130,1265
test4sub38of100,test4pub6of10,10,189,5,1035,129,1169
test4sub96of100,test4pub8of10,10,190,10,964,125,1099
test4sub81of100,test4pub5of10,10,189,5,1078,123,1206
test4sub11of100,test4pub5of10,10,189,5,1082,121,1208
test4sub10of100,test4pub7of10,10,190,10,1009,118,1137
test4sub84of100,test4pub1of10,10,1468,12,1180,152,1344
test4sub76of100,test4pub3of10,10,189,6,1156,145,1307
test4sub26of100,test4pub4of10,10,189,7,1109,146,1262
test4sub24of100,test4pub1of10,10,1468,12,1201,170,1383
test4sub73of100,test4pub5of10,10,189,5,1111,170,1286
test4sub98of100,test4pub9of10,10,189,6,978,169,1153
test4sub22of100,test4pub2of10,10,189,6,1188,170,1364
test4sub50of100,test4pub1of10,10,1468,12,1212,199,1423
test4sub74of100,test4pub9of10,10,189,6,991,196,1193
test4sub32of100,test4pub6of10,10,189,5,1093,193,1291
test4sub72of100,test4pub3of10,10,189,6,1195,188,1389
test4sub55of100,test4pub9of10,10,189,6,1005,183,1194
test4sub4of100,test4pub5of10,10,189,5,1142,181,1328
test4sub3of100,test4pub3of10,10,189,6,1205,178,1389
test4sub85of100,test4pub3of10,10,189,6,1207,177,1390
test4sub54of100,test4pub4of10,10,189,7,1159,177,1343
test4sub100of100,test4pub7of10,10,190,10,1084,163,1257
test4sub31of100,test4pub2of10,10,189,6,1251,151,1408
test4sub70of100,test4pub4of10,10,189,7,1201,138,1346
test4sub29of100,test4pub4of10,10,189,7,1201,138,1346
test4sub15of100,test4pub9of10,10,189,6,1060,133,1199
test4sub38of100,test4pub10of10,10,191,12,1028,128,1168
test4sub43of100,test4pub8of10,10,190,10,1091,126,1227
test4sub10of100,test4pub5of10,10,189,5,1204,126,1335
test4sub11of100,test4pub1of10,10,1468,12,1294,166,1472
test4sub67of100,test4pub10of10,10,191,12,1038,158,1208
test4sub57of100,test4pub4of10,10,189,7,1228,155,1390
test4sub58of100,test4pub2of10,10,189,6,1301,146,1453
test4sub97of100,test4pub10of10,10,191,12,1059,139,1210
test4sub26of100,test4pub3of10,10,189,6,1303,128,1437
test4sub36of100,test4pub7of10,10,190,10,1194,102,1306
test4sub2of100,test4pub2of10,10,189,6,1354,94,1454
test4sub98of100,test4pub3of10,10,189,6,1343,91,1440
test4sub12of100,test4pub3of10,10,189,6,1348,85,1439
test4sub46of100,test4pub6of10,10,189,5,1256,83,1344
test4sub59of100,test4pub10of10,10,191,12,1131,70,1213
test4sub24of100,test4pub9of10,10,189,6,1179,64,1249
test4sub53of100,test4pub6of10,10,189,5,1285,58,1348
test4sub54of100,test4pub3of10,10,189,6,1385,52,1443
test4sub31of100,test4pub8of10,10,190,10,1215,51,1276
test4sub38of100,test4pub5of10,10,189,5,1329,50,1384
test4sub92of100,test4pub8of10,10,190,10,1236,32,1278
test4sub50of100,test4pub6of10,10,189,5,1313,32,1350
test4sub22of100,test4pub4of10,10,189,7,1366,26,1399
test4sub71of100,test4pub1of10,10,1468,12,1448,59,1519
test4sub11of100,test4pub8of10,10,190,10,1259,47,1316
test4sub97of100,test4pub1of10,10,1468,12,1462,85,1559
test4sub98of100,test4pub4of10,10,189,7,1386,83,1476
test4sub10of100,test4pub3of10,10,189,6,1435,83,1524
test4sub49of100,test4pub8of10,10,190,10,1288,106,1404
test4sub22of100,test4pub9of10,10,189,6,1262,109,1377
test4sub57of100,test4pub3of10,10,189,6,1450,116,1572
test4sub75of100,test4pub8of10,10,190,10,1271,126,1407
test4sub54of100,test4pub7of10,10,190,10,1301,129,1440
test4sub33of100,test4pub7of10,10,190,10,1324,106,1440
test4sub59of100,test4pub1of10,10,1468,12,1466,133,1611
test4sub80of100,test4pub3of10,10,189,6,1469,101,1576
test4sub99of100,test4pub1of10,10,1468,12,1512,127,1651
test4sub42of100,test4pub5of10,10,189,5,1432,117,1554
test4sub85of100,test4pub5of10,10,189,5,1441,109,1555
test4sub30of100,test4pub2of10,10,189,6,1518,108,1632
test4sub47of100,test4pub2of10,10,189,6,1521,106,1633
test4sub11of100,test4pub3of10,10,189,6,1507,105,1618
test4sub97of100,test4pub7of10,10,190,10,1381,94,1485
test4sub67of100,test4pub4of10,10,189,7,1473,91,1571
test4sub72of100,test4pub9of10,10,189,6,1328,90,1424
test4sub93of100,test4pub5of10,10,189,5,1468,86,1559
test4sub38of100,test4pub1of10,10,1468,12,1560,124,1696
test4sub29of100,test4pub8of10,10,190,10,1360,123,1493
test4sub82of100,test4pub9of10,10,189,6,1338,123,1467
test4sub77of100,test4pub6of10,10,189,5,1461,91,1557
test4sub22of100,test4pub7of10,10,190,10,1429,90,1529
test4sub61of100,test4pub3of10,10,189,6,1567,90,1663
test4sub36of100,test4pub5of10,10,189,5,1507,91,1603
test4sub75of100,test4pub6of10,10,189,5,1473,91,1569
test4sub33of100,test4pub3of10,10,189,6,1569,91,1666
test4sub39of100,test4pub3of10,10,189,6,1569,91,1666
test4sub59of100,test4pub7of10,10,190,10,1433,90,1533
test4sub71of100,test4pub2of10,10,189,6,1594,82,1682
test4sub95of100,test4pub1of10,10,1468,12,1608,123,1743
test4sub6of100,test4pub3of10,10,189,6,1579,123,1708
test4sub57of100,test4pub1of10,10,1468,12,1617,155,1784
test4sub43of100,test4pub4of10,10,189,7,1539,155,1701
test4sub66of100,test4pub2of10,10,189,6,1608,151,1765
test4sub15of100,test4pub10of10,10,191,12,1375,135,1522
test4sub42of100,test4pub4of10,10,189,7,1562,133,1702
test4sub97of100,test4pub8of10,10,190,10,1442,131,1583
test4sub100of100,test4pub2of10,10,189,6,1631,129,1766
test4sub45of100,test4pub2of10,10,189,6,1636,126,1768
test4sub69of100,test4pub10of10,10,191,12,1401,112,1525
test4sub55of100,test4pub4of10,10,189,7,1590,109,1706
test4sub49of100,test4pub3of10,10,189,6,1645,101,1752
test4sub79of100,test4pub1of10,10,1468,12,1679,136,1827
test4sub30of100,test4pub8of10,10,190,10,1479,135,1624
test4sub86of100,test4pub4of10,10,189,7,1606,132,1745
test4sub77of100,test4pub7of10,10,190,10,1519,131,1660
test4sub61of100,test4pub1of10,10,1468,12,1687,168,1867
test4sub36of100,test4pub1of10,10,1468,12,1688,208,1908
test4sub73of100,test4pub9of10,10,189,6,1465,207,1678
test4sub84of100,test4pub2of10,10,189,6,1680,202,1888
test4sub11of100,test4pub2of10,10,189,6,1696,187,1889
test4sub19of100,test4pub3of10,10,189,6,1693,173,1872
test4sub47of100,test4pub8of10,10,190,10,1537,158,1705
test4sub89of100,test4pub9of10,10,189,6,1519,155,1680
test4sub20of100,test4pub10of10,10,191,12,1495,140,1647
test4sub68of100,test4pub2of10,10,189,6,1746,138,1890
test4sub66of100,test4pub4of10,10,189,7,1695,126,1828
test4sub15of100,test4pub3of10,10,189,6,1743,127,1876
test4sub97of100,test4pub2of10,10,189,6,1761,127,1894
test4sub25of100,test4pub9of10,10,189,6,1568,109,1683
test4sub16of100,test4pub10of10,10,191,12,1534,105,1651
test4sub80of100,test4pub2of10,10,189,6,1788,100,1894
test4sub56of100,test4pub5of10,10,189,5,1717,96,1818
test4sub94of100,test4pub6of10,10,189,5,1685,93,1783
test4sub6of100,test4pub2of10,10,189,6,1797,93,1896
test4sub59of100,test4pub2of10,10,189,6,1809,82,1897
test4sub28of100,test4pub3of10,10,189,6,1816,59,1881
test4sub95of100,test4pub7of10,10,190,10,1680,59,1749
test4sub22of100,test4pub10of10,10,191,12,1589,54,1655
test4sub42of100,test4pub10of10,10,191,12,1596,47,1655
test4sub35of100,test4pub10of10,10,191,12,1597,47,1656
test4sub74of100,test4pub2of10,10,189,6,1852,41,1899
test4sub81of100,test4pub8of10,10,190,10,1684,23,1717
test4sub96of100,test4pub2of10,10,189,6,1873,22,1901
test4sub58of100,test4pub8of10,10,190,10,1687,20,1717
test4sub89of100,test4pub1of10,10,1468,12,1898,49,1959
test4sub68of100,test4pub1of10,10,1468,12,1899,88,1999
test4sub66of100,test4pub3of10,10,189,6,1870,87,1963
test4sub14of100,test4pub2of10,10,189,6,1889,84,1979
test4sub31of100,test4pub6of10,10,189,5,1780,83,1868
test4sub81of100,test4pub2of10,10,189,6,1895,81,1982
test4sub15of100,test4pub1of10,10,1468,12,1922,105,2039
test4sub9of100,test4pub3of10,10,189,6,1895,102,2003
test4sub63of100,test4pub9of10,10,189,6,1702,102,1810
test4sub2of100,test4pub3of10,10,189,6,1896,102,2004
test4sub25of100,test4pub1of10,10,1468,12,1928,139,2079
test4sub29of100,test4pub1of10,10,1468,12,1929,178,2119
test4sub27of100,test4pub1of10,1,317,11,480,9230,9721
test4sub64of100,test4pub2of10,1,188,5,190,9231,9426
test4sub32of100,test4pub2of10,10,189,6,1919,216,2141
test4sub55of100,test4pub2of10,10,189,6,1919,217,2142
test4sub69of100,test4pub5of10,10,189,5,1844,217,2066
test4sub21of100,test4pub6of10,10,189,5,1814,212,2031
test4sub8of100,test4pub9of10,10,189,6,1725,203,1934
test4sub20of100,test4pub2of10,10,189,6,1938,201,2145
test4sub97of100,test4pub4of10,10,189,7,1874,201,2082
test4sub100of100,test4pub4of10,10,189,7,1875,201,2083
test4sub53of100,test4pub3of10,10,189,6,1925,199,2130
test4sub83of100,test4pub7of10,10,190,10,1794,194,1998
test4sub52of100,test4pub1of10,1,317,11,505,9253,9769
test4sub91of100,test4pub1of10,1,317,11,511,9287,9809
test4sub24of100,test4pub5of10,10,189,5,1876,270,2151
test4sub39of100,test4pub9of10,10,189,6,1743,269,2018
test4sub73of100,test4pub4of10,10,189,7,1892,267,2166
test4sub23of100,test4pub2of10,10,189,6,1959,265,2230
test4sub90of100,test4pub1of10,1,317,11,522,9317,9850
test4sub43of100,test4pub1of10,10,1468,12,1979,336,2327
test4sub79of100,test4pub7of10,10,190,10,1819,329,2158
test4sub66of100,test4pub6of10,10,189,5,1863,328,2196
test4sub82of100,test4pub10of10,10,191,12,1727,327,2066
test4sub94of100,test4pub5of10,10,189,5,1903,324,2232
test4sub49of100,test4pub9of10,10,189,6,1770,324,2100
test4sub62of100,test4pub1of10,1,317,11,545,9377,9933
test4sub5of100,test4pub2of10,1,188,5,256,9377,9638
test4sub48of100,test4pub2of10,1,188,5,254,9379,9638
test4sub87of100,test4pub2of10,1,188,5,254,9379,9638
test4sub41of100,test4pub2of10,1,188,5,256,9380,9641
test4sub44of100,test4pub2of10,10,189,6,1989,360,2355
test4sub35of100,test4pub3of10,10,189,6,1978,355,2339
test4sub99of100,test4pub2of10,10,189,6,1995,354,2355
test4sub1of100,test4pub2of10,1,188,5,268,9369,9642
test4sub13of100,test4pub2of10,1,188,5,271,9367,9643
test4sub7of100,test4pub2of10,1,188,5,275,9364,9644
test4sub17of100,test4pub2of10,1,188,5,269,9371,9645
test4sub96of100,test4pub10of10,10,191,12,1754,350,2116
test4sub93of100,test4pub1of10,10,1468,12,2026,381,2419
test4sub63of100,test4pub6of10,10,189,5,1904,379,2288
test4sub18of100,test4pub4of10,10,189,7,1956,375,2338
test4sub14of100,test4pub5of10,10,189,5,1945,375,2325
test4sub56of100,test4pub10of10,10,191,12,1776,371,2159
test4sub30of100,test4pub7of10,10,190,10,1873,372,2255
test4sub86of100,test4pub6of10,10,189,5,1922,365,2292
test4sub22of100,test4pub3of10,10,189,6,2019,364,2389
test4sub28of100,test4pub5of10,10,189,5,1962,361,2328
test4sub31of100,test4pub4of10,10,189,7,1978,359,2344
test4sub70of100,test4pub9of10,10,189,6,1836,355,2197
test4sub40of100,test4pub1of10,10,1468,12,2061,394,2467
test4sub72of100,test4pub2of10,10,189,6,2051,391,2448
test4sub42of100,test4pub1of10,10,1468,12,2081,415,2508
test4sub60of100,test4pub3of10,10,189,6,2056,410,2472
test4sub76of100,test4pub1of10,10,1468,12,2088,447,2547
test4sub84of100,test4pub10of10,10,191,12,1832,443,2287
test4sub9of100,test4pub4of10,10,189,7,2023,437,2467
test4sub29of100,test4pub10of10,10,191,12,1845,432,2289
test4sub54of100,test4pub2of10,10,189,6,2095,430,2531
test4sub26of100,test4pub1of10,10,1468,12,2112,468,2592
test4sub3of100,test4pub8of10,10,190,10,1913,466,2389
test4sub80of100,test4pub10of10,10,191,12,1860,457,2329
test4sub88of100,test4pub6of10,10,189,5,1999,458,2462
test4sub19of100,test4pub6of10,10,189,5,2010,448,2463
test4sub12of100,test4pub2of10,10,189,6,2130,438,2574
test4sub15of100,test4pub6of10,10,189,5,2022,438,2465
test4sub27of100,test4pub2of10,1,188,5,9421,437,9863
test4sub32of100,test4pub5of10,10,189,5,2060,436,2501
test4sub64of100,test4pub1of10,1,317,11,9713,478,10202
test4sub55of100,test4pub6of10,10,189,5,2026,477,2508
test4sub69of100,test4pub3of10,10,189,6,2121,478,2605
test4sub8of100,test4pub5of10,10,189,5,2063,476,2544
test4sub100of100,test4pub1of10,10,1468,12,2155,517,2684
test4sub83of100,test4pub2of10,10,189,6,2142,517,2665
test4sub34of100,test4pub3of10,10,189,6,2133,510,2649
test4sub67of100,test4pub6of10,10,189,5,2049,500,2554
test4sub95of100,test4pub8of10,10,190,10,1979,495,2484
test4sub51of100,test4pub9of10,10,189,6,1963,489,2458
test4sub6of100,test4pub4of10,10,189,7,2116,482,2605
test4sub52of100,test4pub2of10,1,188,5,9469,482,9956
test4sub33of100,test4pub10of10,10,191,12,1936,479,2427
test4sub77of100,test4pub5of10,10,189,5,2119,471,2595
test4sub92of100,test4pub5of10,10,189,5,2119,470,2594
test4sub2of100,test4pub1of10,10,1468,12,2215,504,2731
test4sub11of100,test4pub7of10,10,190,10,2050,502,2562
test4sub36of100,test4pub10of10,10,191,12,1959,500,2471
test4sub58of100,test4pub1of10,10,1468,12,2232,528,2772
test4sub25of100,test4pub8of10,10,190,10,2031,527,2568
test4sub37of100,test4pub8of10,10,190,10,2032,528,2570
test4sub91of100,test4pub3of10,1,188,6,9174,527,9707
test4sub39of100,test4pub7of10,10,190,10,2070,526,2606
test4sub46of100,test4pub9of10,10,189,6,2013,528,2547
test4sub20of100,test4pub9of10,10,189,6,2018,523,2547
test4sub4of100,test4pub8of10,10,190,10,2062,503,2575
test4sub65of100,test4pub1of10,10,1468,12,2271,537,2820
test4sub89of100,test4pub10of10,10,191,12,2017,527,2556
test4sub66of100,test4pub9of10,10,189,6,2093,491,2590
test4sub82of100,test4pub7of10,10,190,10,2150,492,2652
test4sub85of100,test4pub1of10,10,1468,12,2330,517,2859
test4sub81of100,test4pub6of10,10,189,5,2215,507,2727
test4sub47of100,test4pub1of10,10,1468,12,2340,547,2899
test4sub53of100,test4pub4of10,10,189,7,2277,532,2816
test4sub62of100,test4pub3of10,1,188,6,9298,530,9834
test4sub48of100,test4pub3of10,1,188,6,9299,528,9833
test4sub87of100,test4pub3of10,1,188,6,9300,530,9836
test4sub41of100,test4pub3of10,1,188,6,9301,528,9835
test4sub1of100,test4pub3of10,1,188,6,9303,527,9836
test4sub13of100,test4pub3of10,1,188,6,9303,528,9837
test4sub7of100,test4pub3of10,1,188,6,9305,528,9839
test4sub17of100,test4pub3of10,1,188,6,9305,529,9840
test4sub24of100,test4pub2of10,10,189,6,2355,528,2889
test4sub93of100,test4pub7of10,10,190,10,2241,488,2739
test4sub63of100,test4pub4of10,10,189,7,2330,490,2827
test4sub18of100,test4pub6of10,10,189,5,2285,489,2779
test4sub14of100,test4pub10of10,10,191,12,2147,489,2648
test4sub30of100,test4pub4of10,10,189,7,2334,488,2829
test4sub86of100,test4pub1of10,10,1468,12,2413,527,2952
test4sub28of100,test4pub6of10,10,189,5,2290,525,2820
test4sub70of100,test4pub7of10,10,190,10,2249,526,2785
test4sub97of100,test4pub9of10,10,189,6,2197,520,2723
test4sub74of100,test4pub4of10,10,189,7,2366,500,2873
test4sub56of100,test4pub4of10,10,189,7,2377,489,2873
test4sub72of100,test4pub1of10,10,1468,12,2457,526,2995
test4sub50of100,test4pub4of10,10,189,7,2388,518,2913
test4sub96of100,test4pub4of10,10,189,7,2392,514,2913
test4sub71of100,test4pub6of10,10,189,5,2146,713,2864
test4sub98of100,test4pub6of10,10,189,5,2147,714,2866
test4sub23of100,test4pub8of10,10,190,10,2283,503,2796
test4sub42of100,test4pub6of10,10,189,5,2371,492,2868
test4sub40of100,test4pub4of10,10,189,7,2442,468,2917
test4sub76of100,test4pub10of10,10,191,12,2273,453,2738
test4sub84of100,test4pub6of10,10,189,5,2413,452,2870
test4sub61of100,test4pub5of10,10,189,5,2463,439,2907
test4sub3of100,test4pub5of10,10,189,5,2490,411,2906
test4sub80of100,test4pub1of10,10,1468,12,2581,450,3043
test4sub88of100,test4pub1of10,10,1468,12,2583,489,3084
test4sub12of100,test4pub4of10,10,189,7,2506,488,3001
test4sub27of100,test4pub3of10,1,188,6,9524,487,10017
test4sub32of100,test4pub7of10,10,190,10,2419,487,2916
test4sub54of100,test4pub10of10,10,191,12,2324,487,2823
test4sub19of100,test4pub10of10,10,191,12,2331,481,2824
test4sub35of100,test4pub2of10,10,189,6,2590,472,3068
test4sub79of100,test4pub5of10,10,189,5,2516,471,2992
test4sub64of100,test4pub3of10,1,188,6,9567,449,10022
test4sub55of100,test4pub1of10,10,1468,12,2629,487,3128
test4sub69of100,test4pub1of10,10,1468,12,2630,525,3167
test4sub8of100,test4pub2of10,10,189,6,2617,525,3148
test4sub94of100,test4pub8of10,10,190,10,2470,486,2966
test4sub83of100,test4pub1of10,10,1468,12,2673,522,3207
test4sub67of100,test4pub9of10,10,189,6,2450,521,2977
test4sub95of100,test4pub3of10,10,189,6,2646,521,3173
test4sub6of100,test4pub5of10,10,189,5,2587,521,3113
test4sub34of100,test4pub6of10,10,189,5,2552,522,3079
test4sub52of100,test4pub4of10,1,188,7,9300,520,9827
test4sub77of100,test4pub9of10,10,189,6,2456,531,2993
test4sub33of100,test4pub6of10,10,189,5,2554,535,3094
test4sub92of100,test4pub1of10,10,1468,12,2680,559,3251
test4sub22of100,test4pub6of10,10,189,5,2570,545,3120
test4sub60of100,test4pub2of10,10,189,6,2482,744,3232
test4sub11of100,test4pub10of10,10,191,12,2457,521,2990
test4sub36of100,test4pub2of10,10,189,6,2708,519,3233
test4sub99of100,test4pub7of10,10,190,10,2356,720,3086
test4sub58of100,test4pub6of10,10,189,5,2635,483,3123
test4sub16of100,test4pub4of10,10,189,7,2683,483,3173
test4sub91of100,test4pub2of10,1,188,5,10036,482,10523
test4sub39of100,test4pub1of10,10,1468,12,2764,519,3295
test4sub46of100,test4pub3of10,10,189,6,2735,518,3259
test4sub20of100,test4pub3of10,10,189,6,2736,519,3261
test4sub4of100,test4pub6of10,10,189,5,2642,517,3164
test4sub65of100,test4pub8of10,10,190,10,2607,479,3096
test4sub89of100,test4pub3of10,10,189,6,2778,479,3263
test4sub82of100,test4pub5of10,10,189,5,2720,479,3204
test4sub38of100,test4pub4of10,10,189,7,2744,467,3218
test4sub81of100,test4pub4of10,10,189,7,2770,442,3219
test4sub47of100,test4pub6of10,10,189,5,2763,403,3171
test4sub53of100,test4pub10of10,10,191,12,2626,404,3042
test4sub62of100,test4pub2of10,1,188,5,10163,402,10570
test4sub48of100,test4pub4of10,1,188,7,9512,404,9923
test4sub87of100,test4pub4of10,1,188,7,9514,403,9924
test4sub41of100,test4pub4of10,1,188,7,9514,404,9925
test4sub1of100,test4pub5of10,1,188,5,9233,403,9641
test4sub13of100,test4pub4of10,1,188,7,9516,404,9927
test4sub7of100,test4pub4of10,1,188,7,9517,403,9927
test4sub17of100,test4pub5of10,1,188,5,9235,404,9644
test4sub24of100,test4pub8of10,10,190,10,2696,402,3108
test4sub93of100,test4pub9of10,10,189,6,2673,404,3083
test4sub63of100,test4pub2of10,10,189,6,2885,402,3293
test4sub18of100,test4pub5of10,10,189,5,2809,404,3218
test4sub14of100,test4pub9of10,10,189,6,2677,403,3086
test4sub30of100,test4pub10of10,10,191,12,2638,405,3055
test4sub85of100,test4pub7of10,10,190,10,2740,398,3148
test4sub73of100,test4pub8of10,10,190,10,2712,393,3115
test4sub28of100,test4pub2of10,10,189,6,2926,367,3299
test4sub70of100,test4pub6of10,10,189,5,2817,367,3189
test4sub97of100,test4pub6of10,10,189,5,2818,366,3189
test4sub56of100,test4pub1of10,10,1468,12,2944,407,3363
test4sub74of100,test4pub6of10,10,189,5,2819,409,3233
test4sub57of100,test4pub10of10,10,191,12,2692,401,3105
test4sub72of100,test4pub6of10,10,189,5,2859,374,3238
test4sub96of100,test4pub9of10,10,189,6,2762,374,3142
test4sub71of100,test4pub10of10,10,191,12,2723,376,3111
test4sub98of100,test4pub2of10,10,189,6,2973,376,3355
test4sub23of100,test4pub7of10,10,190,10,2821,378,3209
test4sub42of100,test4pub3of10,10,189,6,2959,378,3343
test4sub40of100,test4pub10of10,10,191,12,2726,380,3118
test4sub84of100,test4pub5of10,10,189,5,2901,381,3287
test4sub76of100,test4pub6of10,10,189,5,2866,383,3254
test4sub61of100,test4pub10of10,10,191,12,2729,383,3124
test4sub3of100,test4pub9of10,10,189,6,2769,386,3161
test4sub45of100,test4pub1of10,10,1468,12,2998,421,3431
test4sub80of100,test4pub6of10,10,189,5,2907,387,3299
test4sub88of100,test4pub9of10,10,189,6,2848,348,3202
test4sub12of100,test4pub10of10,10,191,12,2809,349,3170
test4sub27of100,test4pub4of10,1,188,7,9696,349,10052
test4sub54of100,test4pub1of10,10,1468,12,3075,388,3475
test4sub35of100,test4pub4of10,10,189,7,2999,387,3393
test4sub19of100,test4pub1of10,10,1468,12,3077,427,3516
test4sub64of100,test4pub4of10,1,188,7,9701,424,10132
test4sub32of100,test4pub3of10,10,189,6,3082,392,3480
test4sub55of100,test4pub8of10,10,190,10,2915,389,3314
test4sub86of100,test4pub3of10,10,189,6,2910,566,3482
test4sub69of100,test4pub2of10,10,189,6,3142,350,3498
test4sub94of100,test4pub7of10,10,190,10,2991,348,3349
test4sub51of100,test4pub10of10,10,191,12,2929,316,3257
test4sub83of100,test4pub9of10,10,189,6,2972,313,3291
test4sub95of100,test4pub10of10,10,191,12,2935,312,3259
test4sub6of100,test4pub6of10,10,189,5,3073,312,3390
test4sub34of100,test4pub7of10,10,190,10,3032,300,3342
test4sub52of100,test4pub3of10,1,188,6,10149,301,10456
test4sub77of100,test4pub1of10,10,1468,12,3213,338,3563
test4sub33of100,test4pub4of10,10,189,7,3136,337,3480
test4sub92of100,test4pub10of10,10,191,12,2977,312,3301
test4sub60of100,test4pub5of10,10,189,5,3151,312,3468
test4sub36of100,test4pub3of10,10,189,6,3213,312,3531
test4sub99of100,test4pub5of10,10,189,5,3153,311,3469
test4sub16of100,test4pub6of10,10,189,5,3120,312,3437
test4sub58of100,test4pub4of10,10,189,7,3167,312,3486
test4sub91of100,test4pub4of10,1,188,7,9868,312,10187
test4sub39of100,test4pub10of10,10,191,12,3021,275,3308
test4sub46of100,test4pub7of10,10,190,10,3117,275,3402
test4sub20of100,test4pub4of10,10,189,7,3207,275,3489
test4sub4of100,test4pub1of10,10,1468,12,3286,313,3611
test4sub26of100,test4pub8of10,10,190,10,3086,313,3409
test4sub65of100,test4pub7of10,10,190,10,3121,313,3444
test4sub89of100,test4pub7of10,10,190,10,3121,313,3444
test4sub38of100,test4pub3of10,10,189,6,3260,313,3579
test4sub82of100,test4pub1of10,10,1468,12,3290,352,3654
test4sub81of100,test4pub10of10,10,191,12,3029,352,3393
test4sub53of100,test4pub7of10,10,190,10,3126,351,3487
test4sub62of100,test4pub4of10,1,188,7,9916,352,10275
test4sub48of100,test4pub6of10,1,188,5,9354,351,9710
test4sub87of100,test4pub5of10,1,188,5,9635,352,9992
test4sub41of100,test4pub5of10,1,188,5,9636,352,9993
test4sub1of100,test4pub4of10,1,188,7,9919,352,10278
test4sub13of100,test4pub6of10,1,188,5,9357,353,9715
test4sub7of100,test4pub5of10,1,188,5,9638,353,9996
test4sub17of100,test4pub4of10,1,188,7,9922,353,10282
test4sub24of100,test4pub7of10,10,190,10,3134,352,3496
test4sub93of100,test4pub10of10,10,191,12,3039,353,3404
test4sub63of100,test4pub1of10,10,1468,12,3303,393,3708
test4sub18of100,test4pub3of10,10,189,6,3274,391,3671
test4sub14of100,test4pub4of10,10,189,7,3227,392,3626
test4sub30of100,test4pub1of10,10,1468,12,3306,428,3746
test4sub85of100,test4pub6of10,10,189,5,3181,429,3615
test4sub73of100,test4pub2of10,10,189,6,3294,429,3729
test4sub28of100,test4pub4of10,10,189,7,3230,431,3668
test4sub70of100,test4pub8of10,10,190,10,3108,429,3547
test4sub97of100,test4pub3of10,10,189,6,3280,430,3716
test4sub56of100,test4pub2of10,10,189,6,3338,388,3732
test4sub2of100,test4pub5of10,10,189,5,2630,1021,3656
test4sub74of100,test4pub3of10,10,189,6,3324,389,3719
test4sub57of100,test4pub5of10,10,189,5,3266,387,3658
test4sub72of100,test4pub5of10,10,189,5,3268,386,3659
test4sub96of100,test4pub1of10,10,1468,12,3360,423,3795
test4sub71of100,test4pub3of10,10,189,6,3333,421,3760
test4sub98of100,test4pub10of10,10,191,12,3102,420,3534
test4sub8of100,test4pub6of10,10,189,5,3031,629,3665
test4sub23of100,test4pub5of10,10,189,5,3277,419,3701
test4sub42of100,test4pub9of10,10,189,6,3145,419,3570
test4sub40of100,test4pub8of10,10,190,10,3170,417,3597
test4sub84of100,test4pub4of10,10,189,7,3295,417,3719
test4sub76of100,test4pub8of10,10,190,10,3174,415,3599
test4sub61of100,test4pub9of10,10,189,6,3153,414,3573
test4sub3of100,test4pub6of10,10,189,5,3254,412,3671
test4sub43of100,test4pub3of10,10,189,6,2722,1042,3770
test4sub45of100,test4pub9of10,10,189,6,3196,374,3576
test4sub80of100,test4pub9of10,10,189,6,3196,374,3576
test4sub88of100,test4pub10of10,10,191,12,3159,374,3545
test4sub27of100,test4pub7of10,1,188,6,9244,373,9623
test4sub35of100,test4pub8of10,10,190,10,3263,332,3605
test4sub54of100,test4pub9of10,10,189,6,3256,319,3581
test4sub19of100,test4pub2of10,10,189,6,3490,294,3790
test4sub64of100,test4pub5of10,1,188,5,9843,296,10144
test4sub32of100,test4pub8of10,10,190,10,3305,295,3610
test4sub69of100,test4pub8of10,10,190,10,3306,294,3610
test4sub94of100,test4pub10of10,10,191,12,3245,295,3552
test4sub51of100,test4pub4of10,10,189,7,3431,294,3732
test4sub83of100,test4pub8of10,10,190,10,3308,294,3612
test4sub95of100,test4pub9of10,10,189,6,3287,294,3587
test4sub6of100,test4pub8of10,10,190,10,3310,294,3614
test4sub34of100,test4pub2of10,10,189,6,3499,294,3799
test4sub52of100,test4pub5of10,1,188,5,9852,295,10152
test4sub77of100,test4pub8of10,10,190,10,3351,255,3616
test4sub33of100,test4pub8of10,10,190,10,3351,257,3618
test4sub92of100,test4pub6of10,10,189,5,3429,256,3690
test4sub60of100,test4pub10of10,10,191,12,3291,257,3560
test4sub36of100,test4pub9of10,10,189,6,3331,256,3593
test4sub99of100,test4pub3of10,10,189,6,3526,257,3789
test4sub16of100,test4pub5of10,10,189,5,3467,255,3727
test4sub58of100,test4pub3of10,10,189,6,3527,257,3790
test4sub91of100,test4pub5of10,1,188,5,9898,255,10158
test4sub39of100,test4pub2of10,10,189,6,3545,257,3808
test4sub46of100,test4pub5of10,10,189,5,3471,256,3732
test4sub20of100,test4pub7of10,10,190,10,3394,256,3660
test4sub86of100,test4pub8of10,10,190,10,3368,249,3627
test4sub22of100,test4pub1of10,10,1468,12,3595,268,3875
test4sub4of100,test4pub3of10,10,189,6,3570,263,3839
test4sub26of100,test4pub2of10,10,189,6,3587,264,3857
test4sub65of100,test4pub9of10,10,189,6,3378,263,3647
test4sub89of100,test4pub8of10,10,190,10,3402,263,3675
test4sub38of100,test4pub7of10,10,190,10,3437,262,3709
test4sub79of100,test4pub6of10,10,189,5,3284,457,3746
test4sub82of100,test4pub3of10,10,189,6,3614,222,3842
test4sub62of100,test4pub6of10,1,188,5,9705,220,9930
test4sub53of100,test4pub1of10,10,1468,12,3646,260,3918
test4sub48of100,test4pub5of10,1,188,5,9987,260,10252
test4sub87of100,test4pub6of10,1,188,5,9707,259,9971
test4sub41of100,test4pub6of10,1,188,5,9709,258,9972
test4sub1of100,test4pub6of10,1,188,5,9709,258,9972
test4sub13of100,test4pub7of10,1,188,6,9472,256,9734
test4sub7of100,test4pub6of10,1,188,5,9711,256,9972
test4sub17of100,test4pub6of10,1,188,5,9713,254,9972
test4sub24of100,test4pub4of10,10,189,7,3577,255,3839
test4sub93of100,test4pub8of10,10,190,10,3455,253,3718
test4sub11of100,test4pub9of10,10,189,6,3437,249,3692
test4sub63of100,test4pub7of10,10,190,10,3529,214,3753
test4sub30of100,test4pub5of10,10,189,5,3646,175,3826
test4sub73of100,test4pub1of10,10,1468,12,3737,213,3962
test4sub28of100,test4pub10of10,10,191,12,3476,212,3700
test4sub70of100,test4pub3of10,10,189,6,3709,212,3927
test4sub97of100,test4pub5of10,10,189,5,3651,210,3866
test4sub85of100,test4pub8of10,10,190,10,3541,210,3761
test4sub2of100,test4pub6of10,10,189,5,3617,210,3832
test4sub56of100,test4pub9of10,10,189,6,3517,210,3733
test4sub74of100,test4pub5of10,10,189,5,3654,209,3868
test4sub57of100,test4pub7of10,10,190,10,3577,209,3796
test4sub72of100,test4pub4of10,10,189,7,3668,208,3883
test4sub71of100,test4pub7of10,10,190,10,3617,170,3797
test4sub98of100,test4pub5of10,10,189,5,3695,170,3870
test4sub8of100,test4pub1of10,10,1468,12,3786,208,4006
test4sub23of100,test4pub1of10,10,1468,12,3787,249,4048
test4sub42of100,test4pub2of10,10,189,6,3774,247,4027
test4sub40of100,test4pub3of10,10,189,6,3759,248,4013
test4sub76of100,test4pub7of10,10,190,10,3624,247,3881
test4sub84of100,test4pub8of10,10,190,10,3589,247,3846
test4sub3of100,test4pub10of10,10,191,12,3529,247,3788
test4sub61of100,test4pub8of10,10,190,10,3591,247,3848
test4sub43of100,test4pub6of10,10,189,5,3669,246,3920
test4sub45of100,test4pub8of10,10,190,10,3593,247,3850
test4sub80of100,test4pub8of10,10,190,10,3595,246,3851
test4sub88of100,test4pub7of10,10,190,10,3629,248,3887
test4sub35of100,test4pub7of10,10,190,10,3631,246,3887
test4sub27of100,test4pub6of10,1,188,5,9857,247,10109
test4sub54of100,test4pub5of10,10,189,5,3709,246,3960
test4sub19of100,test4pub9of10,10,189,6,3576,247,3829
test4sub64of100,test4pub7of10,1,188,6,9621,245,9872
test4sub32of100,test4pub9of10,10,189,6,3577,246,3829
test4sub69of100,test4pub6of10,10,189,5,3678,246,3929
test4sub94of100,test4pub3of10,10,189,6,3773,246,4025
test4sub83of100,test4pub10of10,10,191,12,3542,246,3800
test4sub95of100,test4pub6of10,10,189,5,3680,245,3930
test4sub34of100,test4pub5of10,10,189,5,3717,245,3967
test4sub6of100,test4pub7of10,10,190,10,3640,245,3895
test4sub77of100,test4pub10of10,10,191,12,3546,244,3802
test4sub52of100,test4pub6of10,1,188,5,9867,245,10117
test4sub92of100,test4pub7of10,10,190,10,3643,243,3896
test4sub33of100,test4pub1of10,10,1468,12,3810,284,4106
test4sub60of100,test4pub8of10,10,190,10,3611,284,3905
test4sub36of100,test4pub6of10,10,189,5,3687,285,3977
test4sub99of100,test4pub10of10,10,191,12,3550,283,3845
test4sub16of100,test4pub9of10,10,189,6,3590,285,3881
test4sub91of100,test4pub7of10,1,188,6,9635,283,9924
test4sub58of100,test4pub10of10,10,191,12,3552,284,3848
test4sub46of100,test4pub8of10,10,190,10,3616,282,3908
test4sub20of100,test4pub8of10,10,190,10,3617,283,3910
test4sub86of100,test4pub9of10,10,189,6,3595,282,3883
test4sub81of100,test4pub1of10,10,1468,12,3644,494,4150
test4sub22of100,test4pub5of10,10,189,5,3774,275,4054
test4sub65of100,test4pub10of10,10,191,12,3698,179,3889
test4sub89of100,test4pub5of10,10,189,5,3871,180,4056
test4sub79of100,test4pub10of10,10,191,12,3699,180,3891
test4sub4of100,test4pub7of10,10,190,10,3793,181,3984
test4sub82of100,test4pub8of10,10,190,10,3761,181,3952
test4sub62of100,test4pub5of10,1,188,5,10302,181,10488
test4sub26of100,test4pub6of10,10,189,5,3835,182,4022
test4sub53of100,test4pub5of10,10,189,5,3873,182,4060
test4sub48of100,test4pub7of10,1,188,6,9784,182,9972
test4sub87of100,test4pub8of10,1,188,5,9524,183,9712
test4sub1of100,test4pub8of10,1,188,5,9525,183,9713
test4sub41of100,test4pub9of10,1,188,5,9253,183,9441
test4sub13of100,test4pub5of10,1,188,5,10304,184,10493
test4sub7of100,test4pub7of10,1,188,6,9786,184,9976
test4sub24of100,test4pub6of10,10,189,5,3841,185,4031
test4sub17of100,test4pub7of10,1,188,6,9786,185,9977
test4sub63of100,test4pub5of10,10,189,5,3877,185,4067
test4sub73of100,test4pub6of10,10,189,5,3843,186,4034
test4sub28of100,test4pub9of10,10,189,6,3744,186,3936
test4sub70of100,test4pub10of10,10,191,12,3705,186,3903
test4sub2of100,test4pub4of10,10,189,7,3891,187,4085
test4sub74of100,test4pub8of10,10,190,10,3769,187,3966
test4sub56of100,test4pub6of10,10,189,5,3844,189,4038
test4sub57of100,test4pub9of10,10,189,6,3746,188,3940
test4sub72of100,test4pub8of10,10,190,10,3770,189,3969
test4sub98of100,test4pub8of10,10,190,10,3770,188,3968
test4sub8of100,test4pub10of10,10,191,12,3733,165,3910
test4sub23of100,test4pub9of10,10,189,6,3812,125,3943
test4sub42of100,test4pub8of10,10,190,10,3835,125,3970
test4sub40of100,test4pub2of10,10,189,6,4024,126,4156
test4sub84of100,test4pub9of10,10,189,6,3815,125,3946
test4sub3of100,test4pub7of10,10,190,10,3873,124,4007
test4sub43of100,test4pub7of10,10,190,10,3874,124,4008
test4sub45of100,test4pub4of10,10,189,7,3964,123,4094
test4sub80of100,test4pub7of10,10,190,10,3876,124,4010
test4sub88of100,test4pub5of10,10,189,5,3954,122,4081
test4sub35of100,test4pub5of10,10,189,5,3954,123,4082
test4sub27of100,test4pub5of10,1,188,5,10385,122,10512
test4sub54of100,test4pub8of10,10,190,10,3845,122,3977
test4sub64of100,test4pub6of10,1,188,5,10107,122,10234
test4sub69of100,test4pub9of10,10,189,6,3825,120,3951
test4sub94of100,test4pub1of10,10,1468,12,4050,162,4224
test4sub34of100,test4pub9of10,10,189,6,3828,159,3993
test4sub77of100,test4pub2of10,10,189,6,4039,159,4204
test4sub52of100,test4pub7of10,1,188,6,9874,158,10038
test4sub92of100,test4pub9of10,10,189,6,3831,159,3996
test4sub12of100,test4pub1of10,10,1468,12,3422,829,4263
test4sub60of100,test4pub6of10,10,189,5,3971,156,4132
test4sub33of100,test4pub9of10,10,189,6,3872,157,4035
test4sub36of100,test4pub8of10,10,190,10,3896,156,4062
test4sub99of100,test4pub8of10,10,190,10,3897,156,4063
test4sub91of100,test4pub6of10,1,188,5,10158,154,10317
test4sub46of100,test4pub10of10,10,191,12,3838,155,4005
test4sub81of100,test4pub3of10,10,189,6,4110,116,4232
test4sub65of100,test4pub5of10,10,189,5,4051,117,4173
test4sub79of100,test4pub8of10,10,190,10,3942,115,4067
test4sub62of100,test4pub8of10,1,188,5,9704,113,9822
test4sub26of100,test4pub7of10,10,190,10,3978,115,4103
test4sub48of100,test4pub9of10,1,188,5,9436,113,9554
test4sub87of100,test4pub7of10,1,188,6,9967,114,10087
test4sub1of100,test4pub7of10,1,188,6,9968,113,10087
test4sub41of100,test4pub7of10,1,188,6,9969,113,10088
test4sub13of100,test4pub10of10,1,189,5,9167,113,9285
test4sub7of100,test4pub10of10,1,189,5,9168,113,9286
test4sub24of100,test4pub3of10,10,189,6,4122,112,4240
test4sub17of100,test4pub8of10,1,188,5,9712,113,9830
test4sub63of100,test4pub8of10,10,190,10,3953,113,4076
test4sub28of100,test4pub8of10,10,190,10,3954,112,4076
test4sub70of100,test4pub1of10,10,1468,12,4155,151,4318
test4sub2of100,test4pub8of10,10,190,10,3956,150,4116
test4sub74of100,test4pub7of10,10,190,10,3991,150,4151
test4sub56of100,test4pub8of10,10,190,10,3958,149,4117
test4sub72of100,test4pub7of10,10,190,10,3993,149,4152
test4sub8of100,test4pub7of10,10,190,10,3994,148,4152
test4sub42of100,test4pub7of10,10,190,10,3996,147,4153
test4sub40of100,test4pub9of10,10,189,6,3940,146,4092
test4sub43of100,test4pub9of10,10,189,6,3942,145,4093
test4sub88of100,test4pub4of10,10,189,7,4090,144,4241
test4sub27of100,test4pub9of10,1,188,5,9458,144,9607
test4sub64of100,test4pub8of10,1,188,5,9730,142,9877
test4sub34of100,test4pub4of10,10,189,7,4134,101,4242
test4sub52of100,test4pub9of10,1,188,5,9502,101,9608
test4sub12of100,test4pub7of10,10,190,10,4085,63,4158
test4sub60of100,test4pub9of10,10,189,6,4028,64,4098
test4sub91of100,test4pub8of10,1,188,5,9815,62,9882
test4sub99of100,test4pub6of10,10,189,5,4129,64,4198
test4sub81of100,test4pub9of10,10,189,6,4032,62,4100
test4sub46of100,test4pub1of10,10,1468,12,4256,103,4371
test4sub79of100,test4pub9of10,10,189,6,4034,101,4141
test4sub62of100,test4pub7of10,1,188,6,10079,101,10186
test4sub48of100,test4pub8of10,1,188,5,9821,100,9926
test4sub87of100,test4pub10of10,1,189,5,9278,101,9384
test4sub41of100,test4pub10of10,1,189,5,9280,99,9384
test4sub62of100,test4pub10of10,1,189,5,9378,16,9399
test4sub48of100,test4pub10of10,1,189,5,9378,16,9399
test4sub99of100,test4pub9of10,10,189,6,4095,58,4159
test4sub60of100,test4pub7of10,10,190,10,4150,60,4220
test4sub12of100,test4pub5of10,10,189,5,4226,62,4293
test4sub52of100,test4pub10of10,1,189,5,9332,63,9400
test4sub64of100,test4pub9of10,1,188,5,9602,66,9673
test4sub2of100,test4pub7of10,10,190,10,4141,71,4222
test4sub17of100,test4pub10of10,1,189,5,9283,113,9401
test4sub91of100,test4pub9of10,1,188,5,9607,60,9672
test4sub24of100,test4pub10of10,10,191,12,4003,115,4130
test4sub7of100,test4pub9of10,1,188,5,9553,116,9674
test4sub1of100,test4pub9of10,1,188,5,9551,119,9675
test4sub8of100,test4pub4of10,10,189,7,4232,69,4308
test4sub40of100,test4pub5of10,10,189,5,4221,68,4294
test4sub87of100,test4pub9of10,1,188,5,9651,21,9677
test4sub27of100,test4pub8of10,1,188,5,9873,67,9945
test4sub13of100,test4pub9of10,1,188,5,9553,117,9675
test4sub62of100,test4pub9of10,1,188,5,9666,9,9680
test4sub48of100,test4pub2of10,10,189,6,4363,9,4378
test4sub12of100,test4pub9of10,10,189,6,4154,10,4170
test4sub52of100,test4pub8of10,1,188,5,9939,9,9953
test4sub64of100,test4pub10of10,1,189,5,9397,9,9411
test4sub1of100,test4pub10of10,1,189,5,9399,9,9413
test4sub41of100,test4pub8of10,1,188,5,9923,9,9937
test4sub17of100,test4pub9of10,1,188,5,9670,11,9686
test4sub7of100,test4pub8of10,1,188,5,9942,11,9958
test4sub2of100,test4pub10of10,10,191,12,4117,12,4141
test4sub40of100,test4pub6of10,10,189,5,4259,12,4276
test4sub87of100,test4pub1of10,10,1468,12,4384,51,4447
test4sub27of100,test4pub10of10,1,189,5,9402,51,9458
test4sub13of100,test4pub8of10,1,188,5,9945,50,10000
test4sub91of100,test4pub10of10,1,189,5,9398,52,9455
test4sub62of100,test4pub10of10,10,191,12,4124,51,4187
test4sub48of100,test4pub1of10,10,1468,12,4388,92,4492
test4sub52of100,test4pub4of10,10,189,7,4311,90,4408
test4sub64of100,test4pub7of10,10,190,10,4223,92,4325
test4sub41of100,test4pub2of10,10,189,6,4378,90,4474
test4sub17of100,test4pub5of10,10,189,5,4302,91,4398
test4sub1of100,test4pub1of10,10,1468,12,4392,131,4535
test4sub7of100,test4pub1of10,10,1468,12,4394,169,4575
test4sub2of100,test4pub9of10,10,189,6,4172,168,4346
test4sub27of100,test4pub3of10,10,189,6,4406,128,4540
test4sub13of100,test4pub1of10,10,1468,12,4437,167,4616
test4sub87of100,test4pub2of10,10,189,6,4422,166,4594
test4sub62of100,test4pub3of10,10,189,6,4409,166,4581
test4sub91of100,test4pub3of10,10,189,6,4408,167,4581
test4sub48of100,test4pub3of10,10,189,6,4450,126,4582
test4sub52of100,test4pub10of10,10,191,12,4217,126,4355
test4sub64of100,test4pub10of10,10,191,12,4219,125,4356
test4sub41of100,test4pub1of10,10,1468,12,4482,164,4658
test4sub17of100,test4pub3of10,10,189,6,4454,163,4623
test4sub1of100,test4pub6of10,10,189,5,4399,125,4529
test4sub7of100,test4pub5of10,10,189,5,4474,86,4565
test4sub27of100,test4pub9of10,10,189,6,4341,86,4433
test4sub13of100,test4pub7of10,10,190,10,4437,47,4494
test4sub87of100,test4pub3of10,10,189,6,4574,48,4628
test4sub62of100,test4pub6of10,10,189,5,4481,47,4533
test4sub91of100,test4pub5of10,10,189,5,4516,49,4570
test4sub52of100,test4pub2of10,10,189,6,4594,47,4647
test4sub64of100,test4pub8of10,10,190,10,4407,48,4465
test4sub48of100,test4pub9of10,10,189,6,4384,48,4438
test4sub41of100,test4pub9of10,10,189,6,4424,9,4439
test4sub17of100,test4pub10of10,10,191,12,4385,10,4407
test4sub1of100,test4pub5of10,10,189,5,4560,10,4575
test4sub7of100,test4pub2of10,10,189,6,4636,11,4653
test4sub27of100,test4pub7of10,10,190,10,4484,10,4504
test4sub13of100,test4pub10of10,10,191,12,4389,11,4412
test4sub87of100,test4pub6of10,10,189,5,4528,10,4543
test4sub62of100,test4pub8of10,10,190,10,4453,11,4474
test4sub91of100,test4pub8of10,10,190,10,4454,10,4474
test4sub52of100,test4pub9of10,10,189,6,4432,10,4448
test4sub64of100,test4pub2of10,10,189,6,4643,10,4659
test4sub48of100,test4pub10of10,10,191,12,4394,11,4417
test4sub41of100,test4pub3of10,10,189,6,4629,11,4646
test4sub17of100,test4pub1of10,10,1468,12,4659,48,4719
test4sub7of100,test4pub4of10,10,189,7,4583,46,4636
test4sub1of100,test4pub3of10,10,189,6,4631,47,4684
test4sub27of100,test4pub2of10,10,189,6,4649,47,4702
test4sub13of100,test4pub6of10,10,189,5,4538,46,4589
test4sub87of100,test4pub10of10,10,191,12,4402,47,4461
test4sub62of100,test4pub4of10,10,189,7,4587,47,4641
test4sub91of100,test4pub7of10,10,190,10,4499,47,4556
test4sub52of100,test4pub5of10,10,189,5,4577,46,4628
test4sub64of100,test4pub5of10,10,189,5,4579,47,4631
test4sub48of100,test4pub7of10,10,190,10,4502,47,4559
test4sub41of100,test4pub10of10,10,191,12,4407,46,4465
test4sub17of100,test4pub6of10,10,189,5,4583,9,4597
test4sub7of100,test4pub3of10,10,189,6,4678,10,4694
test4sub1of100,test4pub8of10,10,190,10,4508,9,4527
test4sub27of100,test4pub6of10,10,189,5,4586,10,4601
test4sub13of100,test4pub2of10,10,189,6,4697,10,4713
test4sub87of100,test4pub5of10,10,189,5,4622,10,4637
test4sub62of100,test4pub7of10,10,190,10,4546,10,4566
test4sub91of100,test4pub4of10,10,189,7,4636,9,4652
test4sub52of100,test4pub3of10,10,189,6,4685,10,4701
test4sub64of100,test4pub9of10,10,189,6,4492,10,4508
test4sub48of100,test4pub4of10,10,189,7,4638,10,4655
test4sub17of100,test4pub8of10,10,190,10,4517,10,4537
test4sub41of100,test4pub5of10,10,189,5,4627,10,4642
test4sub7of100,test4pub6of10,10,189,5,4594,10,4609
test4sub1of100,test4pub2of10,10,189,6,4706,10,4722
test4sub27of100,test4pub8of10,10,190,10,4520,9,4539
test4sub13of100,test4pub3of10,10,189,6,4692,10,4708
test4sub87of100,test4pub8of10,10,190,10,4522,9,4541
test4sub62of100,test4pub9of10,10,189,6,4499,10,4515
test4sub91of100,test4pub6of10,10,189,5,4600,10,4615
test4sub52of100,test4pub7of10,10,190,10,4558,11,4579
test4sub64of100,test4pub6of10,10,189,5,4602,10,4617
test4sub48of100,test4pub6of10,10,189,5,4602,12,4619
test4sub17of100,test4pub2of10,10,189,6,4714,10,4730
test4sub41of100,test4pub4of10,10,189,7,4651,12,4670
test4sub1of100,test4pub9of10,10,189,6,4506,10,4522
test4sub7of100,test4pub7of10,10,190,10,4563,11,4584
test4sub27of100,test4pub4of10,10,189,7,4654,11,4672
test4sub13of100,test4pub4of10,10,189,7,4654,11,4672
test4sub87of100,test4pub4of10,10,189,7,4656,10,4673
test4sub62of100,test4pub2of10,10,189,6,4720,11,4737
test4sub52of100,test4pub1of10,10,1468,12,4736,47,4795
test4sub91of100,test4pub10of10,10,191,12,4473,47,4532
test4sub64of100,test4pub4of10,10,189,7,4660,47,4714
test4sub48of100,test4pub8of10,10,190,10,4538,47,4595
test4sub17of100,test4pub7of10,10,190,10,4572,47,4629
test4sub41of100,test4pub6of10,10,189,5,4616,47,4668
test4sub1of100,test4pub10of10,10,191,12,4478,46,4536
test4sub7of100,test4pub10of10,10,191,12,4480,47,4539
test4sub27of100,test4pub10of10,10,191,12,4480,47,4539
test4sub13of100,test4pub5of10,10,189,5,4654,47,4706
test4sub87of100,test4pub7of10,10,190,10,4578,47,4635
test4sub62of100,test4pub5of10,10,189,5,4656,48,4709
test4sub52of100,test4pub6of10,10,189,5,4659,10,4674
test4sub91of100,test4pub2of10,10,189,6,4770,11,4787
test4sub64of100,test4pub3of10,10,189,6,4755,10,4771
test4sub48of100,test4pub5of10,10,189,5,4697,11,4713
test4sub17of100,test4pub9of10,10,189,6,4563,11,4580
test4sub41of100,test4pub8of10,10,190,10,4587,10,4607
test4sub1of100,test4pub4of10,10,189,7,4711,11,4729
test4sub7of100,test4pub8of10,10,190,10,4589,10,4609
test4sub27of100,test4pub1of10,10,1468,12,4791,48,4851
test4sub13of100,test4pub8of10,10,190,10,4591,47,4648
test4sub87of100,test4pub9of10,10,189,6,4569,48,4623
test4sub62of100,test4pub1of10,10,1468,12,4794,84,4890
test4sub52of100,test4pub8of10,10,190,10,4593,85,4688
test4sub91of100,test4pub1of10,10,1468,12,4796,123,4931
test4sub17of100,test4pub4of10,10,189,7,4720,161,4888
test4sub64of100,test4pub1of10,10,1468,12,4796,163,4971
test4sub41of100,test4pub7of10,10,190,10,4632,160,4802
test4sub1of100,test4pub7of10,10,190,10,4633,160,4803
test4sub7of100,test4pub9of10,10,189,6,4577,159,4742
test4sub27of100,test4pub5of10,10,189,5,4750,121,4876
test4sub13of100,test4pub9of10,10,189,6,4616,121,4743
test4sub91of100,test4pub9of10,10,189,6,4696,41,4743
test4sub10of100,test4pub6of10,10,189,5,2150,3008,5163
test4sub90of100,test4pub2of10,1,188,5,9549,3009,12563
test4sub10of100,test4pub2of10,10,189,6,5270,1,5277
test4sub90of100,test4pub3of10,1,188,6,12223,1,12230
test4sub10of100,test4pub10of10,10,191,12,5023,1,5036
test4sub90of100,test4pub4of10,1,188,7,11909,1,11917
test4sub10of100,test4pub1of10,10,1468,12,5287,40,5339
test4sub68of100,test4pub9of10,10,189,6,2064,3040,5110
test4sub90of100,test4pub6of10,1,188,5,11348,39,11392
test4sub78of100,test4pub10of10,10,191,12,2036,3031,5079
test4sub68of100,test4pub7of10,10,190,10,5161,2,5173
test4sub90of100,test4pub7of10,1,188,6,11149,2,11157
test4sub10of100,test4pub9of10,10,189,6,5104,2,5112
test4sub78of100,test4pub3of10,10,189,6,5300,3,5309
test4sub68of100,test4pub10of10,10,191,12,5068,1,5081
test4sub90of100,test4pub5of10,1,188,5,11671,3,11679
test4sub78of100,test4pub4of10,10,189,7,5255,1,5263
test4sub68of100,test4pub6of10,10,189,5,5209,3,5217
test4sub78of100,test4pub7of10,10,190,10,5168,1,5179
test4sub90of100,test4pub8of10,1,188,5,10895,2,10902
test4sub78of100,test4pub6of10,10,189,5,5212,1,5218
test4sub68of100,test4pub5of10,10,189,5,5247,1,5253
test4sub90of100,test4pub9of10,1,188,5,10628,1,10634
test4sub68of100,test4pub8of10,10,190,10,5139,1,5150
test4sub90of100,test4pub10of10,1,189,5,10358,1,10364
test4sub90of100,test4pub4of10,10,189,7,5265,1,5273
test4sub90of100,test4pub3of10,10,189,6,5314,1,5321
test4sub90of100,test4pub7of10,10,190,10,5179,1,5190
test4sub90of100,test4pub6of10,10,189,5,5222,0,5227
test4sub90of100,test4pub2of10,10,189,6,5335,1,5342
test4sub90of100,test4pub8of10,10,190,10,5149,0,5159
test4sub90of100,test4pub10of10,10,191,12,5089,1,5102
test4sub90of100,test4pub9of10,10,189,6,5129,0,5135
test4sub90of100,test4pub5of10,10,189,5,5265,1,5271
test4sub90of100,test4pub1of10,10,1468,12,5356,39,5407
test4sub21of100,test4pub8of10,10,190,10,2156,3039,5205
test4sub5of100,test4pub3of10,1,188,6,9298,3036,12340
test4sub21of100,test4pub7of10,10,190,10,5229,1,5240
test4sub5of100,test4pub4of10,1,188,7,12019,1,12027
test4sub5of100,test4pub5of10,1,188,5,11737,1,11743
test4sub21of100,test4pub5of10,10,189,5,5308,1,5314
test4sub5of100,test4pub6of10,1,188,5,11459,1,11465
test4sub94of100,test4pub2of10,100,190,7,71,1,79
test4sub21of100,test4pub1of10,10,1468,12,5400,42,5454
test4sub5of100,test4pub7of10,1,188,6,11223,41,11270
test4sub88of100,test4pub2of10,100,190,7,98,16,121
test4sub87of100,test4pub2of10,100,190,7,101,14,122
test4sub48of100,test4pub2of10,100,190,7,102,13,122
test4sub41of100,test4pub2of10,100,190,7,102,13,122
test4sub5of100,test4pub8of10,1,188,5,11005,2,11012
test4sub5of100,test4pub9of10,1,188,5,10736,0,10741
test4sub93of100,test4pub2of10,100,190,7,118,1,126
test4sub5of100,test4pub10of10,1,189,5,10466,0,10471
test4sub68of100,test4pub3of10,100,190,5,78,1,84
test4sub5of100,test4pub2of10,10,189,6,5437,0,5443
test4sub5of100,test4pub1of10,10,1468,12,5453,39,5504
test4sub96of100,test4pub3of10,100,190,5,88,33,126
test4sub70of100,test4pub2of10,100,190,7,133,30,170
test4sub51of100,test4pub2of10,100,190,7,134,29,170
test4sub3of100,test4pub2of10,100,190,7,138,26,171
test4sub73of100,test4pub3of10,100,190,5,96,25,126
test4sub61of100,test4pub2of10,100,190,7,156,7,170
test4sub21of100,test4pub2of10,100,190,7,156,8,171
test4sub46of100,test4pub2of10,100,190,7,157,8,172
test4sub5of100,test4pub6of10,10,189,5,5367,3,5375
test4sub5of100,test4pub4of10,10,189,7,5418,1,5426
test4sub5of100,test4pub5of10,10,189,5,5407,0,5412
test4sub5of100,test4pub10of10,10,191,12,5236,1,5249
test4sub5of100,test4pub3of10,10,189,6,5470,0,5476
test4sub5of100,test4pub8of10,10,190,10,5300,1,5311
test4sub5of100,test4pub9of10,10,189,6,5279,1,5286
test4sub5of100,test4pub7of10,10,190,10,5337,0,5347
test4sub86of100,test4pub2of10,100,190,7,177,1,185
test4sub8of100,test4pub3of10,100,190,5,135,1,141
test4sub5of100,test4pub2of10,100,190,7,183,1,191
test4sub49of100,test4pub1of10,10,1468,12,2536,3043,5591
test4sub75of100,test4pub10of10,10,191,12,2274,3042,5328
test4sub9of100,test4pub6of10,10,189,5,2414,3043,5462
test4sub92of100,test4pub4of10,100,190,8,110,26,144
test4sub47of100,test4pub3of10,100,190,5,186,25,216
test4sub95of100,test4pub5of10,100,190,5,92,13,110
test4sub82of100,test4pub2of10,100,190,7,240,13,260
test4sub23of100,test4pub4of10,100,190,8,127,12,147
test4sub13of100,test4pub1of10,100,12976,14,273,51,338
test4sub49of100,test4pub4of10,10,189,7,5502,44,5553
test4sub75of100,test4pub2of10,10,189,6,5566,45,5617
test4sub9of100,test4pub5of10,10,189,5,5492,44,5541
test4sub16of100,test4pub3of10,100,190,5,238,18,261
test4sub69of100,test4pub4of10,100,190,8,171,11,190
test4sub49of100,test4pub2of10,10,189,6,5612,3,5621
test4sub75of100,test4pub7of10,10,190,10,5459,2,5471
test4sub9of100,test4pub7of10,10,190,10,5461,3,5474
test4sub49of100,test4pub6of10,10,189,5,5504,1,5510
test4sub75of100,test4pub9of10,10,189,6,5406,2,5414
test4sub9of100,test4pub10of10,10,191,12,5368,2,5382
test4sub49of100,test4pub7of10,10,190,10,5464,2,5476
test4sub9of100,test4pub9of10,10,189,6,5409,2,5417
test4sub75of100,test4pub1of10,100,12976,14,334,42,390
test4sub9of100,test4pub1of10,10,1468,12,5635,80,5727
test4sub84of100,test4pub3of10,100,190,5,268,77,350
test4sub1of100,test4pub1of10,100,12976,14,356,104,474
test4sub100of100,test4pub9of10,10,189,6,2448,3091,5545
test4sub86of100,test4pub5of10,100,190,5,230,55,290
test4sub76of100,test4pub2of10,100,190,7,381,53,441
test4sub85of100,test4pub2of10,100,190,7,383,51,441
test4sub94of100,test4pub4of10,100,190,8,268,51,327
test4sub51of100,test4pub5of10,100,190,5,236,52,293
test4sub83of100,test4pub3of10,100,190,5,342,51,398
test4sub9of100,test4pub2of10,100,190,7,386,49,442
test4sub91of100,test4pub3of10,100,190,5,344,50,399
test4sub21of100,test4pub3of10,100,190,5,345,50,400
test4sub19of100,test4pub5of10,100,190,5,240,49,294
test4sub55of100,test4pub5of10,100,190,5,250,40,295
test4sub78of100,test4pub5of10,100,190,5,250,39,294
test4sub92of100,test4pub2of10,100,190,7,405,33,445
test4sub45of100,test4pub3of10,100,190,5,371,25,401
test4sub36of100,test4pub4of10,100,190,8,300,24,332
test4sub68of100,test4pub4of10,100,190,8,304,20,332
test4sub49of100,test4pub5of10,100,190,5,276,16,297
test4sub29of100,test4pub3of10,10,189,6,2722,3017,5745
test4sub35of100,test4pub6of10,100,190,5,197,8,210
test4sub57of100,test4pub2of10,100,190,7,431,8,446
test4sub25of100,test4pub5of10,10,189,5,2670,3011,5686
test4sub37of100,test4pub2of10,10,189,6,2748,3009,5763
test4sub100of100,test4pub8of10,10,190,10,5563,9,5582
test4sub29of100,test4pub6of10,10,189,5,5645,3,5653
test4sub25of100,test4pub4of10,10,189,7,5694,2,5703
test4sub29of100,test4pub9of10,10,189,6,5550,11,5567
test4sub100of100,test4pub3of10,10,189,6,5744,12,5762
test4sub37of100,test4pub9of10,10,189,6,5548,3,5557
test4sub25of100,test4pub3of10,10,189,6,5746,13,5765
test4sub48of100,test4pub1of10,100,12976,14,484,48,546
test4sub29of100,test4pub5of10,100,190,5,308,47,360
test4sub100of100,test4pub6of10,10,189,5,5661,49,5715
test4sub37of100,test4pub10of10,10,191,12,5524,48,5584
test4sub25of100,test4pub6of10,10,189,5,5665,49,5719
test4sub87of100,test4pub1of10,100,12976,14,489,94,597
test4sub12of100,test4pub6of10,100,190,5,262,59,326
test4sub1of100,test4pub6of10,100,190,5,262,59,326
test4sub14of100,test4pub1of10,100,12976,14,530,97,641
test4sub30of100,test4pub3of10,100,190,5,458,97,560
test4sub41of100,test4pub3of10,100,190,5,462,94,561
test4sub80of100,test4pub5of10,100,190,5,357,95,457
test4sub58of100,test4pub5of10,100,190,5,357,94,456
test4sub37of100,test4pub5of10,10,189,5,5747,93,5845
test4sub96of100,test4pub5of10,100,190,5,359,93,457
test4sub51of100,test4pub6of10,100,190,5,273,94,372
test4sub91of100,test4pub5of10,100,190,5,360,93,458
test4sub25of100,test4pub2of10,100,190,7,509,93,609
test4sub48of100,test4pub3of10,100,190,5,462,93,560
test4sub7of100,test4pub1of10,100,12976,14,541,135,690
test4sub17of100,test4pub5of10,100,190,5,368,131,504
test4sub83of100,test4pub5of10,100,190,5,369,131,505
test4sub64of100,test4pub2of10,100,190,7,525,124,656
test4sub90of100,test4pub3of10,100,190,5,488,118,611
test4sub60of100,test4pub4of10,100,190,8,417,117,542
test4sub4of100,test4pub4of10,100,190,8,438,97,543
test4sub70of100,test4pub5of10,100,190,5,406,96,507
test4sub1of100,test4pub5of10,100,190,5,408,94,507
test4sub39of100,test4pub5of10,100,190,5,412,90,507
test4sub27of100,test4pub3of10,100,190,5,524,84,613
test4sub89of100,test4pub6of10,100,190,5,333,85,423
test4sub33of100,test4pub5of10,100,190,5,426,77,508
test4sub71of100,test4pub5of10,100,190,5,427,77,509
test4sub23of100,test4pub3of10,100,190,5,541,69,615
test4sub88of100,test4pub3of10,100,190,5,552,58,615
test4sub77of100,test4pub4of10,100,190,8,481,56,545
test4sub14of100,test4pub3of10,100,190,5,556,54,615
test4sub37of100,test4pub7of10,10,190,10,5764,53,5827
test4sub51of100,test4pub3of10,100,190,5,560,51,616
test4sub26of100,test4pub5of10,100,190,5,457,49,511
test4sub11of100,test4pub6of10,100,190,5,377,44,426
test4sub65of100,test4pub4of10,100,190,8,497,43,548
test4sub81of100,test4pub7of10,100,190,5,99,34,138
test4sub44of100,test4pub8of10,10,190,10,2756,3029,5795
test4sub7of100,test4pub5of10,100,190,5,499,9,513
test4sub17of100,test4pub3of10,100,190,5,605,10,620
test4sub37of100,test4pub3of10,100,190,5,612,3,620
test4sub65of100,test4pub6of10,100,190,5,422,3,430
test4sub50of100,test4pub2of10,10,189,6,2970,3005,5981
test4sub44of100,test4pub9of10,10,189,6,5763,2,5771
test4sub37of100,test4pub4of10,100,190,8,544,3,555
test4sub65of100,test4pub3of10,100,190,5,617,3,625
test4sub50of100,test4pub10of10,10,191,12,5727,1,5740
test4sub44of100,test4pub6of10,10,189,5,5866,2,5873
test4sub50of100,test4pub7of10,10,190,10,5826,1,5837
test4sub44of100,test4pub3of10,100,190,5,621,1,627
test4sub44of100,test4pub5of10,100,190,5,516,1,522
test4sub50of100,test4pub8of10,10,190,10,5793,1,5804
test4sub50of100,test4pub3of10,100,190,5,624,0,629
test4sub50of100,test4pub5of10,100,190,5,520,1,526
test4sub15of100,test4pub8of10,10,190,10,2805,3005,5820
test4sub63of100,test4pub3of10,100,190,5,639,2,646
test4sub13of100,test4pub6of10,100,190,5,447,2,454
test4sub15of100,test4pub7of10,10,190,10,5845,1,5856
test4sub61of100,test4pub4of10,100,190,8,569,1,578
test4sub15of100,test4pub2of10,100,190,7,684,2,693
test4sub40of100,test4pub7of10,100,190,5,162,1,168
test4sub64of100,test4pub5of10,100,190,5,541,1,547
test4sub82of100,test4pub4of10,100,190,8,575,1,584
test4sub14of100,test4pub6of10,100,190,5,458,0,463
test4sub95of100,test4pub4of10,100,190,8,579,1,588
test4sub31of100,test4pub10of10,10,191,12,2760,3005,5777
test4sub31of100,test4pub3of10,10,189,6,5998,1,6005
test4sub47of100,test4pub4of10,100,190,8,583,1,592
test4sub31of100,test4pub5of10,10,189,5,5939,1,5945
test4sub31of100,test4pub9of10,10,189,6,5807,0,5813
test4sub17of100,test4pub6of10,100,190,5,469,1,475
test4sub10of100,test4pub4of10,100,190,8,601,0,609
test4sub79of100,test4pub4of10,100,190,8,603,1,612
test4sub90of100,test4pub4of10,100,190,8,606,1,615
test4sub44of100,test4pub7of10,100,190,5,217,4,226
test4sub28of100,test4pub1of10,100,12976,14,771,45,830
test4sub4of100,test4pub2of10,100,190,7,741,46,794
test4sub100of100,test4pub5of10,100,190,5,594,46,645
test4sub58of100,test4pub7of10,100,190,5,219,45,269
test4sub98of100,test4pub1of10,100,12976,14,789,71,874
test4sub39of100,test4pub4of10,100,190,8,658,57,723
test4sub59of100,test4pub5of10,10,189,5,3061,3010,6076
test4sub39of100,test4pub6of10,100,190,5,597,1,603
test4sub59of100,test4pub9of10,10,189,6,5938,1,5945
test4sub59of100,test4pub3of10,100,190,5,792,1,798
test4sub59of100,test4pub4of10,100,190,8,720,0,728
test4sub20of100,test4pub1of10,100,12976,14,877,43,934
test4sub31of100,test4pub7of10,100,190,5,328,39,372
test4sub21of100,test4pub4of10,100,190,8,745,31,784
test4sub67of100,test4pub1of10,10,1468,12,3196,3063,6271
test4sub20of100,test4pub6of10,100,190,5,657,42,704
test4sub3of100,test4pub4of10,100,190,8,798,21,827
test4sub23of100,test4pub6of10,100,190,5,685,15,705
test4sub43of100,test4pub5of10,100,190,5,775,13,793
test4sub72of100,test4pub3of10,100,190,5,884,9,898
test4sub67of100,test4pub2of10,10,189,6,6246,7,6259
test4sub83of100,test4pub6of10,100,190,5,696,6,707
test4sub73of100,test4pub5of10,100,190,5,783,7,795
test4sub85of100,test4pub3of10,100,190,5,889,7,901
test4sub59of100,test4pub6of10,100,190,5,698,7,710
test4sub15of100,test4pub5of10,100,190,5,785,6,796
test4sub29of100,test4pub2of10,100,190,7,933,7,947
test4sub77of100,test4pub3of10,100,190,5,890,6,901
test4sub20of100,test4pub5of10,100,190,5,786,5,796
test4sub67of100,test4pub5of10,10,189,5,6177,3,6185
test4sub67of100,test4pub7of10,10,190,10,6104,0,6114
test4sub56of100,test4pub3of10,100,190,5,900,1,906
test4sub67of100,test4pub8of10,10,190,10,6072,1,6083
test4sub45of100,test4pub6of10,100,190,5,712,1,718
test4sub67of100,test4pub3of10,100,190,5,903,2,910
test4sub45of100,test4pub5of10,100,190,5,799,3,807
test4sub91of100,test4pub4of10,100,190,8,833,2,843
test4sub22of100,test4pub2of10,100,190,7,949,2,958
test4sub45of100,test4pub7of10,100,190,5,427,1,433
test4sub7of100,test4pub2of10,100,190,7,951,1,959
test4sub30of100,test4pub6of10,100,190,5,718,1,724
test4sub27of100,test4pub2of10,100,190,7,976,1,984
test4sub89of100,test4pub2of10,100,190,7,980,1,988
test4sub89of100,test4pub4of10,100,190,8,866,0,874
test4sub33of100,test4pub2of10,100,190,7,991,1,999
test4sub26of100,test4pub3of10,100,190,5,950,1,956
test4sub1of100,test4pub3of10,100,190,5,951,0,956
test4sub11of100,test4pub4of10,100,190,8,892,0,900
test4sub11of100,test4pub5of10,100,190,5,861,1,867
test4sub46of100,test4pub4of10,100,190,8,900,1,909
test4sub81of100,test4pub5of10,100,190,5,867,1,873
test4sub9of100,test4pub8of10,100,190,6,403,1,410
test4sub93of100,test4pub3of10,100,190,5,976,0,981
test4sub38of100,test4pub2of10,100,190,7,1020,1,1028
test4sub61of100,test4pub7of10,100,190,5,499,1,505
test4sub92of100,test4pub3of10,100,190,5,981,2,988
test4sub44of100,test4pub4of10,100,190,8,909,4,921
test4sub62of100,test4pub3of10,100,190,5,983,3,991
test4sub61of100,test4pub6of10,100,190,5,791,2,798
test4sub98of100,test4pub3of10,100,190,5,984,2,991
test4sub57of100,test4pub6of10,100,190,5,797,1,803
test4sub54of100,test4pub6of10,100,190,5,800,1,806
test4sub31of100,test4pub2of10,100,190,7,1038,1,1046
test4sub2of100,test4pub2of10,100,190,7,1049,1,1057
test4sub43of100,test4pub2of10,100,190,7,1052,2,1061
test4sub52of100,test4pub4of10,100,190,8,938,1,947
test4sub36of100,test4pub5of10,100,190,5,912,1,918
test4sub39of100,test4pub3of10,100,190,5,1021,1,1027
test4sub70of100,test4pub4of10,100,190,8,949,1,958
test4sub25of100,test4pub7of10,100,190,5,543,1,549
test4sub7of100,test4pub3of10,100,190,5,1023,1,1029
test4sub1of100,test4pub2of10,100,190,7,1069,1,1077
test4sub26of100,test4pub4of10,100,190,8,954,2,964
test4sub33of100,test4pub3of10,100,190,5,1027,2,1034
test4sub50of100,test4pub6of10,100,190,5,836,2,843
test4sub11of100,test4pub3of10,100,190,5,1052,1,1058
test4sub46of100,test4pub6of10,100,190,5,862,1,868
test4sub38of100,test4pub6of10,100,190,5,864,2,871
test4sub74of100,test4pub1of10,100,12976,14,1129,43,1186
test4sub38of100,test4pub5of10,100,190,5,952,45,1002
test4sub61of100,test4pub3of10,100,190,5,1060,44,1109
test4sub62of100,test4pub6of10,100,190,5,874,40,919
test4sub78of100,test4pub2of10,100,190,7,1109,40,1156
test4sub57of100,test4pub3of10,100,190,5,1076,32,1113
test4sub12of100,test4pub3of10,100,190,5,1077,32,1114
test4sub54of100,test4pub3of10,100,190,5,1088,22,1115
test4sub86of100,test4pub7of10,100,190,5,608,23,636
test4sub32of100,test4pub1of10,100,12976,14,1176,52,1242
test4sub62of100,test4pub4of10,100,190,8,1033,50,1091
test4sub57of100,test4pub4of10,100,190,8,1036,50,1094
test4sub54of100,test4pub4of10,100,190,8,1038,47,1093
test4sub65of100,test4pub2of10,100,190,7,1155,50,1212
test4sub29of100,test4pub4of10,100,190,8,1041,50,1099
test4sub83of100,test4pub4of10,100,190,8,1042,51,1101
test4sub91of100,test4pub8of10,100,190,6,567,26,599
test4sub28of100,test4pub7of10,100,190,5,659,27,691
test4sub71of100,test4pub8of10,100,190,6,568,27,601
test4sub14of100,test4pub8of10,100,190,6,574,22,602
test4sub8of100,test4pub8of10,100,190,6,583,13,602
test4sub32of100,test4pub4of10,100,190,8,1084,13,1105
test4sub62of100,test4pub8of10,100,190,6,585,15,606
test4sub34of100,test4pub1of10,100,12976,14,1233,54,1301
test4sub80of100,test4pub3of10,100,190,5,1163,53,1221
test4sub12of100,test4pub8of10,100,190,6,590,54,650
test4sub29of100,test4pub7of10,100,190,5,684,52,741
test4sub87of100,test4pub3of10,100,190,5,1165,53,1223
test4sub32of100,test4pub6of10,100,190,5,979,47,1031
test4sub60of100,test4pub1of10,100,12976,14,1241,99,1354
test4sub37of100,test4pub1of10,100,12976,14,1244,136,1394
test4sub99of100,test4pub4of10,100,190,8,1111,125,1244
test4sub42of100,test4pub5of10,100,190,5,1087,116,1208
test4sub50of100,test4pub1of10,100,12976,14,1266,160,1440
test4sub47of100,test4pub5of10,100,190,5,1092,158,1255
test4sub71of100,test4pub4of10,100,190,8,1127,155,1290
test4sub24of100,test4pub1of10,100,12976,14,1282,192,1488
test4sub96of100,test4pub6of10,100,190,5,1022,188,1215
test4sub80of100,test4pub4of10,100,190,8,1144,186,1338
test4sub87of100,test4pub6of10,100,190,5,1027,184,1216
test4sub17of100,test4pub1of10,100,12976,14,1301,214,1529
test4sub11of100,test4pub1of10,100,12976,14,1303,255,1572
test4sub78of100,test4pub1of10,100,12976,14,1307,292,1613
test4sub6of100,test4pub1of10,100,12976,14,1310,330,1654
test4sub15of100,test4pub4of10,100,190,8,1166,329,1503
test4sub84of100,test4pub1of10,100,12976,14,1320,363,1697
test4sub56of100,test4pub7of10,100,190,5,772,359,1136
test4sub75of100,test4pub4of10,100,190,8,1194,345,1547
test4sub66of100,test4pub5of10,10,189,5,3560,3336,6901
test4sub53of100,test4pub2of10,100,190,7,1326,331,1664
test4sub5of100,test4pub1of10,100,12976,14,1369,360,1743
test4sub37of100,test4pub6of10,100,190,5,1117,348,1470
test4sub18of100,test4pub7of10,10,190,10,3529,3334,6873
test4sub69of100,test4pub7of10,100,190,5,854,323,1182
test4sub41of100,test4pub1of10,100,12976,14,1425,347,1786
test4sub47of100,test4pub7of10,100,190,5,875,345,1225
test4sub3of100,test4pub1of10,100,12976,14,1437,378,1829
test4sub10of100,test4pub5of10,100,190,5,1270,369,1644
test4sub93of100,test4pub6of10,100,190,5,1200,354,1559
test4sub79of100,test4pub2of10,100,190,7,1437,353,1797
test4sub31of100,test4pub1of10,100,12976,14,1472,388,1874
test4sub96of100,test4pub7of10,100,190,5,923,386,1314
test4sub58of100,test4pub2of10,100,190,7,1456,376,1839
test4sub64of100,test4pub7of10,100,190,5,937,372,1314
test4sub4of100,test4pub5of10,100,190,5,1312,374,1691
test4sub51of100,test4pub1of10,100,12976,14,1496,412,1922
test4sub17of100,test4pub2of10,100,190,7,1487,393,1887
test4sub85of100,test4pub4of10,100,190,8,1375,391,1774
test4sub35of100,test4pub1of10,100,12976,14,1522,428,1964
test4sub82of100,test4pub6of10,100,190,5,1303,385,1693
test4sub95of100,test4pub2of10,100,190,7,1538,385,1930
test4sub78of100,test4pub8of10,100,190,6,956,353,1315
test4sub13of100,test4pub7of10,100,190,5,1071,330,1406
test4sub6of100,test4pub3of10,100,190,5,1569,312,1886
test4sub44of100,test4pub1of10,100,12976,14,1650,346,2010
test4sub56of100,test4pub5of10,100,190,5,1507,311,1823
test4sub75of100,test4pub3of10,100,190,5,1614,312,1931
test4sub73of100,test4pub7of10,100,190,5,1133,311,1449
test4sub53of100,test4pub6of10,100,190,5,1424,310,1739
test4sub98of100,test4pub4of10,100,190,8,1544,310,1862
test4sub30of100,test4pub2of10,100,190,7,1665,305,1977
test4sub49of100,test4pub3of10,100,190,5,1631,297,1933
test4sub71of100,test4pub2of10,100,190,7,1689,282,1978
test4sub62of100,test4pub10of10,100,191,5,34,273,312
test4sub18of100,test4pub9of10,10,189,6,6807,270,7083
test4sub26of100,test4pub10of10,100,191,5,38,269,312
test4sub1of100,test4pub8of10,100,190,6,1090,268,1364
test4sub34of100,test4pub8of10,100,190,6,1100,257,1363
test4sub7of100,test4pub4of10,100,190,8,1608,251,1867
test4sub15of100,test4pub3of10,100,190,5,1687,244,1936
test4sub39of100,test4pub8of10,100,190,6,1126,233,1365
test4sub41of100,test4pub5of10,100,190,5,1596,232,1833
test4sub47of100,test4pub2of10,100,190,7,1744,232,1983
test4sub100of100,test4pub2of10,100,190,7,1749,228,1984
test4sub45of100,test4pub2of10,100,190,7,1749,228,1984
test4sub66of100,test4pub1of10,100,12976,14,1778,269,2061
test4sub57of100,test4pub8of10,100,190,6,1135,269,1410
test4sub22of100,test4pub4of10,100,190,8,1641,263,1912
test4sub69of100,test4pub5of10,100,190,5,1626,246,1877
test4sub97of100,test4pub2of10,100,190,7,1785,236,2028
test4sub3of100,test4pub3of10,100,190,5,1744,235,1984
test4sub10of100,test4pub3of10,100,190,5,1746,234,1985
test4sub93of100,test4pub4of10,100,190,8,1673,236,1917
test4sub77of100,test4pub6of10,100,190,5,1555,236,1796
test4sub79of100,test4pub3of10,100,190,5,1748,235,1988
test4sub84of100,test4pub2of10,100,190,7,1812,214,2033
test4sub16of100,test4pub2of10,100,190,7,1823,205,2035
test4sub76of100,test4pub5of10,100,190,5,1680,201,1886
test4sub24of100,test4pub5of10,100,190,5,1682,199,1886
test4sub58of100,test4pub9of10,100,190,5,538,197,740
test4sub64of100,test4pub8of10,100,190,6,1218,197,1421
test4sub59of100,test4pub8of10,100,190,6,1219,197,1422
test4sub11of100,test4pub2of10,100,190,7,1836,196,2039
test4sub55of100,test4pub3of10,100,190,5,1795,195,1995
test4sub28of100,test4pub3of10,100,190,5,1797,194,1996
test4sub38of100,test4pub8of10,100,190,6,1264,155,1425
test4sub27of100,test4pub7of10,100,190,5,1357,155,1517
test4sub17of100,test4pub8of10,100,190,6,1266,154,1426
test4sub85of100,test4pub5of10,100,190,5,1733,154,1892
test4sub91of100,test4pub7of10,100,190,5,1370,144,1519
test4sub68of100,test4pub2of10,100,190,7,1894,143,2044
test4sub2of100,test4pub3of10,100,190,5,1868,128,2001
test4sub9of100,test4pub3of10,100,190,5,1871,125,2001
test4sub94of100,test4pub5of10,100,190,5,1765,124,1894
test4sub67of100,test4pub4of10,100,190,8,1802,121,1931
test4sub13of100,test4pub2of10,100,190,7,1924,114,2045
test4sub6of100,test4pub10of10,100,191,5,261,114,380
test4sub4of100,test4pub10of10,100,191,5,263,113,381
test4sub8of100,test4pub5of10,100,190,5,1790,102,1897
test4sub43of100,test4pub4of10,100,190,8,1827,98,1933
test4sub42of100,test4pub4of10,100,190,8,1828,98,1934
test4sub51of100,test4pub8of10,100,190,6,1329,97,1432
test4sub19of100,test4pub4of10,100,190,8,1834,93,1935
test4sub5of100,test4pub5of10,100,190,5,1801,92,1898
test4sub14of100,test4pub5of10,100,190,5,1804,90,1899
test4sub32of100,test4pub5of10,100,190,5,1810,87,1902
test4sub87of100,test4pub5of10,100,190,5,1810,88,1903
test4sub86of100,test4pub4of10,100,190,8,1844,87,1939
test4sub90of100,test4pub2of10,100,190,7,1966,81,2054
test4sub75of100,test4pub5of10,100,190,5,1820,78,1903
test4sub98of100,test4pub7of10,100,190,5,1447,78,1530
test4sub18of100,test4pub8of10,10,190,10,7101,75,7186
test4sub34of100,test4pub10of10,100,191,5,310,75,390
test4sub53of100,test4pub3of10,100,190,5,1933,74,2012
test4sub80of100,test4pub2of10,100,190,7,1975,75,2057
test4sub100of100,test4pub10of10,100,191,5,314,73,392
test4sub88of100,test4pub8of10,100,190,6,1366,70,1442
test4sub35of100,test4pub9of10,100,190,5,705,53,763
test4sub66of100,test4pub8of10,100,190,6,1404,32,1442
test4sub22of100,test4pub8of10,100,190,6,1406,31,1443
test4sub97of100,test4pub1of10,100,12976,14,2053,71,2138
test4sub10of100,test4pub8of10,100,190,6,1408,72,1486
test4sub93of100,test4pub5of10,100,190,5,1878,71,1954
test4sub96of100,test4pub8of10,100,190,6,1412,69,1487
test4sub84of100,test4pub7of10,100,190,5,1504,70,1579
test4sub74of100,test4pub2of10,100,190,7,2028,70,2105
test4sub76of100,test4pub4of10,100,190,8,1915,69,1992
test4sub64of100,test4pub6of10,100,190,5,1797,70,1872
test4sub55of100,test4pub7of10,100,190,5,1510,68,1583
test4sub28of100,test4pub5of10,100,190,5,1885,69,1959
test4sub41of100,test4pub9of10,100,190,5,740,69,814
test4sub17of100,test4pub10of10,100,191,5,372,68,445
test4sub13of100,test4pub3of10,100,190,5,1997,66,2068
test4sub19of100,test4pub8of10,100,190,6,1427,63,1496
test4sub6of100,test4pub2of10,100,190,7,2043,62,2112
test4sub7of100,test4pub6of10,100,190,5,1810,62,1877
test4sub9of100,test4pub5of10,100,190,5,1898,61,1964
test4sub75of100,test4pub6of10,100,190,5,1814,59,1878
test4sub18of100,test4pub10of10,10,191,12,7116,59,7187
test4sub66of100,test4pub7of10,100,190,5,1529,56,1590
test4sub81of100,test4pub2of10,100,190,7,2076,33,2116
test4sub51of100,test4pub7of10,100,190,5,1562,25,1592
test4sub5of100,test4pub6of10,100,190,5,1853,23,1881
test4sub22of100,test4pub3of10,100,190,5,2046,23,2074
test4sub14of100,test4pub7of10,100,190,5,1565,23,1593
test4sub69of100,test4pub3of10,100,190,5,2047,24,2076
test4sub32of100,test4pub10of10,100,191,5,425,23,453
test4sub86of100,test4pub10of10,100,191,5,426,23,454
test4sub90of100,test4pub6of10,100,190,5,1862,18,1885
test4sub60of100,test4pub3of10,100,190,5,2056,16,2077
test4sub77of100,test4pub5of10,100,190,5,1951,15,1971
test4sub76of100,test4pub3of10,100,190,5,2058,15,2078
test4sub11of100,test4pub8of10,100,190,6,1485,15,1506
test4sub53of100,test4pub8of10,100,190,6,1486,15,1507
test4sub55of100,test4pub10of10,100,191,5,439,14,458
test4sub92of100,test4pub5of10,100,190,5,1956,13,1974
test4sub19of100,test4pub7of10,100,190,5,1583,11,1599
test4sub18of100,test4pub2of10,100,190,7,2109,10,2126
test4sub66of100,test4pub3of10,100,190,5,2067,14,2086
test4sub5of100,test4pub4of10,100,190,8,1996,11,2015
test4sub76of100,test4pub9of10,100,190,5,821,8,834
test4sub53of100,test4pub9of10,100,190,5,822,8,835
test4sub55of100,test4pub4of10,100,190,8,2003,8,2019
test4sub19of100,test4pub3of10,100,190,5,2077,7,2089
test4sub64of100,test4pub10of10,100,191,5,482,29,516
test4sub94of100,test4pub6of10,100,190,5,1914,26,1945
test4sub30of100,test4pub9of10,100,190,5,838,42,885
test4sub25of100,test4pub10of10,100,191,5,467,44,516
test4sub66of100,test4pub2of10,100,190,7,2123,52,2182
test4sub18of100,test4pub1of10,100,12976,14,2150,45,2209
test4sub96of100,test4pub2of10,100,190,7,2125,50,2182
test4sub59of100,test4pub1of10,100,12976,14,2180,71,2265
test4sub91of100,test4pub6of10,100,190,5,1918,70,1993
test4sub55of100,test4pub2of10,100,190,7,2153,71,2231
test4sub23of100,test4pub10of10,100,191,5,490,71,566
test4sub20of100,test4pub2of10,100,190,7,2158,67,2232
test4sub31of100,test4pub8of10,100,190,6,1543,68,1617
test4sub14of100,test4pub2of10,100,190,7,2159,68,2234
test4sub32of100,test4pub2of10,100,190,7,2160,66,2233
test4sub34of100,test4pub3of10,100,190,5,2134,51,2190
test4sub66of100,test4pub4of10,100,190,8,2061,51,2120
test4sub21of100,test4pub9of10,100,190,5,883,51,939
test4sub26of100,test4pub9of10,100,190,5,884,51,940
test4sub90of100,test4pub7of10,100,190,5,1656,51,1712
test4sub10of100,test4pub7of10,100,190,5,1655,50,1710
test4sub92of100,test4pub8of10,100,190,6,1565,50,1621
test4sub71of100,test4pub1of10,100,12976,14,2212,91,2317
test4sub99of100,test4pub1of10,100,12976,14,2216,131,2361
test4sub75of100,test4pub8of10,100,190,6,1582,121,1709
test4sub49of100,test4pub8of10,100,190,6,1584,120,1710
test4sub61of100,test4pub1of10,100,12976,14,2239,153,2406
test4sub100of100,test4pub7of10,100,190,5,1698,142,1845
test4sub59of100,test4pub2of10,100,190,7,2223,140,2370
test4sub23of100,test4pub2of10,100,190,7,2225,139,2371
test4sub31of100,test4pub6of10,100,190,5,1992,139,2136
test4sub21of100,test4pub6of10,100,190,5,1995,136,2136
test4sub78of100,test4pub9of10,100,190,5,941,130,1076
test4sub57of100,test4pub1of10,100,12976,14,2266,174,2454
test4sub44of100,test4pub2of10,100,190,7,2243,169,2419
test4sub97of100,test4pub4of10,100,190,8,2128,171,2307
test4sub79of100,test4pub1of10,100,12976,14,2280,204,2498
test4sub20of100,test4pub3of10,100,190,5,2213,200,2418
test4sub95of100,test4pub1of10,100,12976,14,2289,239,2542
test4sub71of100,test4pub9of10,100,190,5,981,223,1209
test4sub82of100,test4pub5of10,100,190,5,2128,223,2356
test4sub52of100,test4pub2of10,100,190,7,2284,217,2508
test4sub89of100,test4pub3of10,100,190,5,2245,216,2466
test4sub2of100,test4pub5of10,100,190,5,2145,209,2359
test4sub13of100,test4pub10of10,100,191,5,632,207,844
test4sub73of100,test4pub4of10,100,190,8,2193,196,2397
test4sub63of100,test4pub6of10,100,190,5,2080,192,2277
test4sub99of100,test4pub2of10,100,190,7,2319,186,2512
test4sub47of100,test4pub9of10,100,190,5,1033,179,1217
test4sub6of100,test4pub5of10,100,190,5,2185,173,2363
test4sub38of100,test4pub1of10,100,12976,14,2363,217,2594
test4sub72of100,test4pub2of10,100,190,7,2335,215,2557
test4sub83of100,test4pub2of10,100,190,7,2339,213,2559
test4sub18of100,test4pub4of10,100,190,8,2227,211,2446
test4sub55of100,test4pub6of10,100,190,5,2109,211,2325
test4sub86of100,test4pub6of10,100,190,5,2116,204,2325
test4sub68of100,test4pub1of10,100,12976,14,2380,247,2641
test4sub29of100,test4pub8of10,100,190,6,1746,237,1989
test4sub100of100,test4pub4of10,100,190,8,2249,235,2492
test4sub21of100,test4pub10of10,100,191,5,702,234,941
test4sub60of100,test4pub2of10,100,190,7,2367,232,2606
test4sub50of100,test4pub9of10,100,190,5,1084,223,1312
test4sub94of100,test4pub9of10,100,190,5,1084,223,1312
test4sub35of100,test4pub3of10,100,190,5,2337,223,2565
test4sub4of100,test4pub9of10,100,190,5,1089,218,1312
test4sub41of100,test4pub4of10,100,190,8,2269,219,2496
test4sub28of100,test4pub6of10,100,190,5,2150,218,2373
test4sub88of100,test4pub6of10,100,190,5,2152,218,2375
test4sub70of100,test4pub6of10,100,190,5,2155,214,2374
test4sub84of100,test4pub6of10,100,190,5,2162,209,2376
test4sub31of100,test4pub4of10,100,190,8,2290,199,2497
test4sub74of100,test4pub10of10,100,191,5,742,199,946
test4sub85of100,test4pub9of10,100,190,5,1116,196,1317
test4sub9of100,test4pub6of10,100,190,5,2177,197,2379
test4sub19of100,test4pub6of10,100,190,5,2179,195,2379
test4sub44of100,test4pub10of10,100,191,5,749,196,950
test4sub97of100,test4pub8of10,100,190,6,1800,194,2000
test4sub67of100,test4pub6of10,100,190,5,2184,192,2381
test4sub42of100,test4pub3of10,100,190,5,2376,192,2573
test4sub54of100,test4pub7of10,100,190,5,1900,188,2093
test4sub30of100,test4pub8of10,100,190,6,1813,183,2002
test4sub43of100,test4pub10of10,100,191,5,792,156,953
test4sub10of100,test4pub6of10,100,190,5,2234,145,2384
test4sub5of100,test4pub3of10,100,190,5,2431,141,2577
test4sub27of100,test4pub6of10,100,190,5,2240,141,2386
test4sub61of100,test4pub5of10,100,190,5,2340,127,2472
test4sub64of100,test4pub4of10,100,190,8,2382,118,2508
test4sub95of100,test4pub3of10,100,190,5,2457,116,2578
test4sub71of100,test4pub6of10,100,190,5,2265,117,2387
test4sub16of100,test4pub1of10,100,12976,14,2533,155,2702
test4sub47of100,test4pub8of10,100,190,6,1892,152,2050
test4sub6of100,test4pub9of10,100,190,5,1213,152,1370
test4sub33of100,test4pub7of10,100,190,5,1986,151,2142
test4sub38of100,test4pub9of10,100,190,5,1257,109,1371
test4sub72of100,test4pub10of10,100,191,5,888,110,1003
test4sub18of100,test4pub6of10,100,190,5,2319,109,2433
test4sub55of100,test4pub9of10,100,190,5,1260,109,1374
test4sub25of100,test4pub1of10,100,12976,14,2595,141,2750
test4sub58of100,test4pub6of10,100,190,5,2337,138,2480
test4sub89of100,test4pub1of10,100,12976,14,2614,165,2793
test4sub60of100,test4pub5of10,100,190,5,2453,149,2607
test4sub41of100,test4pub6of10,100,190,5,2369,147,2521
test4sub81of100,test4pub6of10,100,190,5,2371,145,2521
test4sub74of100,test4pub9of10,100,190,5,1312,145,1462
test4sub9of100,test4pub4of10,100,190,8,2493,144,2645
test4sub97of100,test4pub7of10,100,190,5,2087,143,2235
test4sub54of100,test4pub2of10,100,190,7,2611,142,2760
test4sub43of100,test4pub8of10,100,190,6,1997,141,2144
test4sub42of100,test4pub6of10,100,190,5,2379,141,2525
test4sub64of100,test4pub9of10,100,190,5,1322,138,1465
test4sub27of100,test4pub9of10,100,190,5,1330,130,1465
test4sub73of100,test4pub10of10,100,191,5,961,129,1095
test4sub84of100,test4pub5of10,100,190,5,2479,128,2612
test4sub46of100,test4pub3of10,100,190,5,2591,122,2718
test4sub79of100,test4pub5of10,100,190,5,2487,122,2614
test4sub63of100,test4pub4of10,100,190,8,2525,117,2650
test4sub37of100,test4pub2of10,100,190,7,2650,106,2763
test4sub15of100,test4pub1of10,100,12976,14,2680,148,2842
test4sub70of100,test4pub3of10,100,190,5,2611,146,2762
test4sub78of100,test4pub3of10,100,190,5,2611,147,2763
test4sub16of100,test4pub8of10,100,190,6,2045,141,2192
test4sub33of100,test4pub6of10,100,190,5,2427,139,2571
test4sub29of100,test4pub1of10,100,12976,14,2697,175,2886
test4sub18of100,test4pub5of10,100,190,5,2520,175,2700
test4sub53of100,test4pub4of10,100,190,8,2555,173,2736
test4sub87of100,test4pub4of10,100,190,8,2560,168,2736
test4sub20of100,test4pub4of10,100,190,8,2563,166,2737
test4sub47of100,test4pub10of10,100,191,5,1022,158,1185
test4sub58of100,test4pub8of10,100,190,6,2096,133,2235
test4sub12of100,test4pub2of10,100,190,7,2730,117,2854
test4sub72of100,test4pub9of10,100,190,5,1438,115,1558
test4sub82of100,test4pub9of10,100,190,5,1438,115,1558
test4sub2of100,test4pub6of10,100,190,5,2507,106,2618
test4sub81of100,test4pub8of10,100,190,6,2136,96,2238
test4sub74of100,test4pub5of10,100,190,5,2604,97,2706
test4sub64of100,test4pub3of10,100,190,5,2713,94,2812
test4sub15of100,test4pub6of10,100,190,5,2565,51,2621
test4sub16of100,test4pub7of10,100,190,5,2278,50,2333
test4sub63of100,test4pub2of10,100,190,7,2846,6,2859
test4sub58of100,test4pub3of10,100,190,5,2804,6,2815
test4sub81of100,test4pub4of10,100,190,8,2734,4,2746
test4sub74of100,test4pub3of10,100,190,5,2808,4,2817
test4sub15of100,test4pub9of10,100,190,5,1557,2,1564
test4sub63of100,test4pub10of10,100,191,5,1188,2,1195
test4sub74of100,test4pub6of10,100,190,5,2620,2,2627
test4sub56of100,test4pub4of10,100,190,8,2741,1,2750
test4sub50of100,test4pub4of10,100,190,8,2743,0,2751
test4sub3of100,test4pub5of10,100,190,5,2712,1,2718
test4sub66of100,test4pub6of10,100,190,5,2625,2,2632
test4sub77of100,test4pub7of10,100,190,5,2341,1,2347
test4sub85of100,test4pub10of10,100,191,5,1201,1,1207
test4sub74of100,test4pub4of10,100,190,8,2755,0,2763
test4sub73of100,test4pub9of10,100,190,5,1580,0,1585
test4sub45of100,test4pub10of10,100,191,5,1210,1,1216
test4sub86of100,test4pub3of10,100,190,5,2834,0,2839
test4sub49of100,test4pub10of10,100,191,5,1247,1,1253
test4sub30of100,test4pub4of10,100,190,8,2797,1,2806
test4sub97of100,test4pub3of10,100,190,5,2872,2,2879
test4sub29of100,test4pub3of10,100,190,5,2872,3,2880
test4sub59of100,test4pub7of10,100,190,5,2392,3,2400
test4sub41of100,test4pub10of10,100,191,5,1251,3,1259
test4sub38of100,test4pub10of10,100,191,5,1252,2,1259
test4sub89of100,test4pub9of10,100,190,5,1623,3,1631
test4sub17of100,test4pub7of10,100,190,5,2395,4,2404
test4sub95of100,test4pub8of10,100,190,6,2305,3,2314
test4sub47of100,test4pub6of10,100,190,5,2687,2,2694
test4sub67of100,test4pub10of10,100,191,5,1259,0,1264
test4sub22of100,test4pub7of10,100,190,5,2399,2,2406
test4sub35of100,test4pub2of10,100,190,7,2926,1,2934
test4sub72of100,test4pub6of10,100,190,5,2694,1,2700
test4sub4of100,test4pub6of10,100,190,5,2694,2,2701
test4sub14of100,test4pub4of10,100,190,8,2814,2,2824
test4sub37of100,test4pub8of10,100,190,6,2315,1,2322
test4sub63of100,test4pub9of10,100,190,5,1669,1,1675
test4sub26of100,test4pub1of10,100,12976,14,3012,44,3070
test4sub50of100,test4pub2of10,100,190,7,2997,30,3034
test4sub66of100,test4pub10of10,100,191,5,1335,29,1369
test4sub3of100,test4pub8of10,100,190,6,2384,29,2419
test4sub39of100,test4pub9of10,100,190,5,1712,23,1740
test4sub95of100,test4pub7of10,100,190,5,2491,14,2510
test4sub97of100,test4pub6of10,100,190,5,2780,14,2799
test4sub8of100,test4pub2of10,100,190,7,3015,14,3036
test4sub25of100,test4pub5of10,100,190,5,2867,14,2886
test4sub36of100,test4pub1of10,100,12976,14,3038,59,3111
test4sub22of100,test4pub9of10,100,190,5,1725,58,1788
test4sub4of100,test4pub8of10,100,190,6,2407,56,2469
test4sub97of100,test4pub10of10,100,191,5,1366,50,1421
test4sub25of100,test4pub9of10,100,190,5,1737,49,1791
test4sub35of100,test4pub4of10,100,190,8,2927,38,2973
test4sub49of100,test4pub9of10,100,190,5,1748,39,1792
test4sub59of100,test4pub10of10,100,191,5,1379,38,1422
test4sub96of100,test4pub4of10,100,190,8,2928,38,2974
test4sub38of100,test4pub3of10,100,190,5,3002,37,3044
test4sub84of100,test4pub4of10,100,190,8,2929,38,2975
test4sub57of100,test4pub5of10,100,190,5,2897,37,2939
test4sub79of100,test4pub7of10,100,190,5,2523,37,2565
test4sub7of100,test4pub7of10,100,190,5,2529,31,2565
test4sub30of100,test4pub7of10,100,190,5,2541,20,2566
test4sub1of100,test4pub4of10,100,190,8,2959,9,2976
test4sub36of100,test4pub7of10,100,190,5,2555,49,2609
test4sub22of100,test4pub6of10,100,190,5,2844,51,2900
test4sub69of100,test4pub1of10,100,12976,14,3105,51,3170
test4sub25of100,test4pub8of10,100,190,6,2465,49,2520
test4sub37of100,test4pub5of10,100,190,5,2943,38,2986
test4sub99of100,test4pub5of10,100,190,5,2944,39,2988
test4sub23of100,test4pub5of10,100,190,5,2945,38,2988
test4sub16of100,test4pub4of10,100,190,8,2987,29,3024
test4sub8of100,test4pub6of10,100,190,5,2875,24,2904
test4sub98of100,test4pub9of10,100,190,5,1816,23,1844
test4sub82of100,test4pub7of10,100,190,5,2593,19,2617
test4sub21of100,test4pub8of10,100,190,6,2505,15,2526
test4sub97of100,test4pub5of10,100,190,5,2972,15,2992
test4sub56of100,test4pub2of10,100,190,7,3127,9,3143
test4sub36of100,test4pub2of10,100,190,7,3128,10,3145
test4sub80of100,test4pub6of10,100,190,5,2894,9,2908
test4sub25of100,test4pub3of10,100,190,5,3088,8,3101
test4sub69of100,test4pub2of10,100,190,7,3130,8,3145
test4sub8of100,test4pub9of10,100,190,5,1839,7,1851
test4sub98of100,test4pub6of10,100,190,5,2899,7,2911
test4sub10of100,test4pub2of10,100,190,7,3135,6,3148
test4sub52of100,test4pub3of10,100,190,5,3095,7,3107
test4sub36of100,test4pub3of10,100,190,5,3096,5,3106
test4sub91of100,test4pub2of10,100,190,7,3140,5,3152
test4sub98of100,test4pub5of10,100,190,5,2993,3,3001
test4sub67of100,test4pub2of10,100,190,7,3142,3,3152
test4sub38of100,test4pub4of10,100,190,8,3027,3,3038
test4sub71of100,test4pub3of10,100,190,5,3101,2,3108
test4sub11of100,test4pub7of10,100,190,5,2624,2,2631
test4sub66of100,test4pub9of10,100,190,5,1854,3,1862
test4sub3of100,test4pub6of10,100,190,5,2915,3,2923
test4sub68of100,test4pub6of10,100,190,5,2915,4,2924
test4sub51of100,test4pub9of10,100,190,5,1856,2,1863
test4sub5of100,test4pub8of10,100,190,6,2536,3,2545
test4sub62of100,test4pub2of10,100,190,7,3152,2,3161
test4sub33of100,test4pub4of10,100,190,8,3082,0,3090
test4sub48of100,test4pub9of10,100,190,5,1908,1,1914
test4sub48of100,test4pub4of10,100,190,8,3088,0,3096
test4sub48of100,test4pub6of10,100,190,5,2971,1,2977
test4sub27of100,test4pub4of10,100,190,8,3094,1,3103
test4sub23of100,test4pub8of10,100,190,6,2596,1,2603
test4sub34of100,test4pub6of10,100,190,5,2978,2,2985
test4sub83of100,test4pub1of10,100,12976,14,3240,42,3296
test4sub16of100,test4pub6of10,100,190,5,3001,21,3027
test4sub98of100,test4pub2of10,100,190,7,3238,18,3263
test4sub76of100,test4pub1of10,100,12976,14,3269,61,3344
test4sub52of100,test4pub5of10,100,190,5,3094,58,3157
test4sub6of100,test4pub4of10,100,190,8,3129,57,3194
test4sub15of100,test4pub10of10,100,191,5,1581,57,1643
test4sub13of100,test4pub4of10,100,190,8,3130,57,3195
test4sub46of100,test4pub9of10,100,190,5,1954,56,2015
test4sub20of100,test4pub9of10,100,190,5,1955,54,2014
test4sub69of100,test4pub10of10,100,191,5,1586,55,1646
test4sub83of100,test4pub7of10,100,190,5,2733,49,2787
test4sub59of100,test4pub5of10,100,190,5,3126,30,3161
test4sub94of100,test4pub3of10,100,190,5,3239,24,3268
test4sub85of100,test4pub1of10,100,12976,14,3317,59,3390
test4sub31of100,test4pub3of10,100,190,5,3249,55,3309
test4sub12of100,test4pub4of10,100,190,8,3176,56,3240
test4sub76of100,test4pub6of10,100,190,5,3067,47,3119
test4sub32of100,test4pub3of10,100,190,5,3261,46,3312
test4sub4of100,test4pub3of10,100,190,5,3272,36,3313
test4sub95of100,test4pub6of10,100,190,5,3080,36,3121
test4sub49of100,test4pub1of10,100,12976,14,3361,59,3434
test4sub1of100,test4pub9of10,100,190,5,2048,48,2101
test4sub25of100,test4pub4of10,100,190,8,3227,49,3284
test4sub17of100,test4pub4of10,100,190,8,3228,49,3285
test4sub85of100,test4pub6of10,100,190,5,3113,45,3163
test4sub18of100,test4pub3of10,100,190,5,3319,33,3357
test4sub99of100,test4pub3of10,100,190,5,3320,31,3356
test4sub73of100,test4pub2of10,100,190,7,3386,7,3400
test4sub49of100,test4pub2of10,100,190,7,3391,2,3400
test4sub49of100,test4pub4of10,100,190,8,3280,1,3289
test4sub49of100,test4pub6of10,100,190,5,3162,0,3167
test4sub83of100,test4pub8of10,100,190,6,2812,1,2819
test4sub27of100,test4pub8of10,100,190,6,2817,0,2823
test4sub75of100,test4pub2of10,100,190,7,3445,1,3453
test4sub41of100,test4pub8of10,100,190,6,2834,1,2841
test4sub16of100,test4pub5of10,100,190,5,3302,3,3310
test4sub72of100,test4pub1of10,100,12976,14,3478,48,3540
test4sub47of100,test4pub1of10,100,12976,14,3483,86,3583
test4sub16of100,test4pub10of10,100,191,5,1790,86,1881
test4sub6of100,test4pub6of10,100,190,5,3223,83,3311
test4sub13of100,test4pub5of10,100,190,5,3311,83,3399
test4sub46of100,test4pub5of10,100,190,5,3313,80,3398
test4sub20of100,test4pub10of10,100,191,5,1798,79,1882
test4sub94of100,test4pub8of10,100,190,6,2853,74,2933
test4sub28of100,test4pub2of10,100,190,7,3472,71,3550
test4sub22of100,test4pub10of10,100,191,5,1820,58,1883
test4sub72of100,test4pub5of10,100,190,5,3351,44,3400
test4sub37of100,test4pub9of10,100,190,5,2236,14,2255
test4sub24of100,test4pub9of10,100,190,5,2261,1,2267
test4sub42of100,test4pub1of10,100,12976,14,3588,42,3644
test4sub35of100,test4pub10of10,100,191,5,1921,18,1944
test4sub88of100,test4pub1of10,100,12976,14,3616,60,3690
test4sub32of100,test4pub7of10,100,190,5,3070,54,3129
test4sub44of100,test4pub6of10,100,190,5,3386,27,3418
test4sub82of100,test4pub3of10,100,190,5,3590,15,3610
test4sub60of100,test4pub6of10,100,190,5,3402,11,3418
test4sub69of100,test4pub6of10,100,190,5,3448,0,3453
test4sub76of100,test4pub8of10,100,190,6,3068,1,3075
test4sub14of100,test4pub9of10,100,190,5,2410,1,2416
test4sub23of100,test4pub7of10,100,190,5,3183,1,3189
test4sub36of100,test4pub6of10,100,190,5,3473,1,3479
test4sub90of100,test4pub5of10,100,190,5,3594,1,3600
test4sub15of100,test4pub8of10,100,190,6,3128,0,3134
test4sub85of100,test4pub7of10,100,190,5,3226,1,3232
test4sub29of100,test4pub10of10,100,191,5,2086,1,2092
test4sub99of100,test4pub7of10,100,190,5,3228,0,3233
test4sub7of100,test4pub10of10,100,191,5,2093,1,2099
test4sub34of100,test4pub5of10,100,190,5,3613,1,3619
test4sub93of100,test4pub1of10,100,12976,14,3792,44,3850
test4sub61of100,test4pub9of10,100,190,5,2598,1,2604
test4sub17of100,test4pub9of10,100,190,5,2602,1,2608
test4sub98of100,test4pub8of10,100,190,6,3355,1,3362
test4sub73of100,test4pub8of10,100,190,6,3362,1,3369
test4sub2of100,test4pub1of10,100,12976,14,4030,42,4086
test4sub20of100,test4pub8of10,100,190,6,3388,41,3435
test4sub94of100,test4pub7of10,100,190,5,3481,40,3526
test4sub72of100,test4pub4of10,100,190,8,3889,40,3937
test4sub35of100,test4pub8of10,100,190,6,3390,39,3435
test4sub88of100,test4pub5of10,100,190,5,3858,40,3903
test4sub60of100,test4pub8of10,100,190,6,3391,40,3437
test4sub76of100,test4pub10of10,100,191,5,2343,40,2388
test4sub32of100,test4pub8of10,100,190,6,3391,41,3438
test4sub14of100,test4pub10of10,100,191,5,2343,41,2389
test4sub36of100,test4pub10of10,100,191,5,2344,41,2390
test4sub29of100,test4pub6of10,100,190,5,3775,40,3820
test4sub34of100,test4pub2of10,100,190,7,4010,39,4056
test4sub93of100,test4pub7of10,100,190,5,3487,40,3532
test4sub8of100,test4pub1of10,100,12976,14,4064,61,4139
test4sub18of100,test4pub7of10,100,190,5,3512,61,3578
test4sub25of100,test4pub6of10,100,190,5,3802,60,3867
test4sub91of100,test4pub10of10,100,191,5,2375,59,2439
test4sub2of100,test4pub4of10,100,190,8,3928,54,3990
test4sub35of100,test4pub5of10,100,190,5,3898,53,3956
test4sub88of100,test4pub4of10,100,190,8,3931,54,3993
test4sub11of100,test4pub10of10,100,191,5,2384,52,2441
test4sub66of100,test4pub5of10,100,190,5,3901,53,3959
test4sub34of100,test4pub7of10,100,190,5,3528,52,3585
test4sub93of100,test4pub9of10,100,190,5,2757,54,2816
test4sub79of100,test4pub6of10,100,190,5,3827,43,3875
test4sub89of100,test4pub8of10,100,190,6,3450,41,3497
test4sub69of100,test4pub8of10,100,190,6,3459,32,3497
test4sub95of100,test4pub9of10,100,190,5,2783,29,2817
test4sub15of100,test4pub7of10,100,190,5,3556,28,3589
test4sub52of100,test4pub10of10,100,191,5,2416,26,2447
test4sub84of100,test4pub10of10,100,191,5,2425,18,2448
test4sub74of100,test4pub8of10,100,190,6,3474,18,3498
test4sub71of100,test4pub10of10,100,191,5,2426,18,2449
test4sub75of100,test4pub10of10,100,191,5,2426,18,2449
test4sub41of100,test4pub7of10,100,190,5,3568,18,3591
test4sub56of100,test4pub1of10,100,12976,14,4113,58,4185
test4sub60of100,test4pub7of10,100,190,5,3572,55,3632
test4sub8of100,test4pub4of10,100,190,8,3982,56,4046
test4sub2of100,test4pub8of10,100,190,6,3483,54,3543
test4sub35of100,test4pub7of10,100,190,5,3576,55,3636
test4sub88of100,test4pub7of10,100,190,5,3577,54,3636
test4sub67of100,test4pub1of10,100,12976,14,4132,92,4238
test4sub34of100,test4pub4of10,100,190,8,3988,91,4087
test4sub93of100,test4pub8of10,100,190,6,3490,90,3586
test4sub6of100,test4pub8of10,100,190,6,3496,86,3588
test4sub55of100,test4pub1of10,100,12976,14,4164,108,4286
test4sub50of100,test4pub7of10,100,190,5,3618,104,3727
test4sub85of100,test4pub8of10,100,190,6,3529,100,3635
test4sub57of100,test4pub10of10,100,191,5,2482,99,2586
test4sub56of100,test4pub6of10,100,190,5,3917,94,4016
test4sub60of100,test4pub9of10,100,190,5,2858,96,2959
test4sub8of100,test4pub7of10,100,190,5,3630,95,3730
test4sub88of100,test4pub9of10,100,190,5,2861,95,2961
test4sub27of100,test4pub5of10,100,190,5,4015,87,4107
test4sub67of100,test4pub9of10,100,190,5,2901,55,2961
test4sub6of100,test4pub7of10,100,190,5,3674,54,3733
test4sub49of100,test4pub7of10,100,190,5,3677,53,3735
test4sub61of100,test4pub8of10,100,190,6,3602,37,3645
test4sub55of100,test4pub8of10,100,190,6,3629,11,3646
test4sub56of100,test4pub10of10,100,191,5,2582,9,2596
test4sub60of100,test4pub10of10,100,191,5,2584,8,2597
test4sub67of100,test4pub5of10,100,190,5,4103,5,4113
test4sub61of100,test4pub10of10,100,191,5,2590,4,2599
test4sub67of100,test4pub8of10,100,190,6,3642,1,3649
test4sub67of100,test4pub7of10,100,190,5,3736,1,3742
test4sub18of100,test4pub8of10,100,190,6,3649,1,3656
test4sub18of100,test4pub9of10,100,190,5,2972,1,2978
test4sub90of100,test4pub8of10,100,190,6,3651,0,3657
test4sub90of100,test4pub9of10,100,190,5,2974,1,2980
test4sub16of100,test4pub9of10,100,190,5,2986,1,2992
test4sub92of100,test4pub1of10,100,12976,14,4313,43,4370
test4sub76of100,test4pub7of10,100,190,5,3775,28,3808
test4sub92of100,test4pub6of10,100,190,5,4094,1,4100
test4sub92of100,test4pub10of10,100,191,5,2665,1,2671
test4sub92of100,test4pub7of10,100,190,5,3808,1,3814
test4sub92of100,test4pub9of10,100,190,5,3038,0,3043
test4sub77of100,test4pub1of10,100,12976,14,4381,42,4437
test4sub46of100,test4pub7of10,100,190,5,3847,26,3878
test4sub98of100,test4pub10of10,100,191,5,2711,22,2738
test4sub32of100,test4pub9of10,100,190,5,3082,22,3109
test4sub36of100,test4pub9of10,100,190,5,3083,22,3110
test4sub29of100,test4pub9of10,100,190,5,3088,16,3109
test4sub2of100,test4pub7of10,100,190,5,3863,13,3881
test4sub1of100,test4pub7of10,100,190,5,3866,12,3883
test4sub99of100,test4pub6of10,100,190,5,4156,11,4172
test4sub38of100,test4pub7of10,100,190,5,3872,7,3884
test4sub77of100,test4pub2of10,100,190,7,4395,6,4408
test4sub46of100,test4pub8of10,100,190,6,3782,5,3793
test4sub36of100,test4pub8of10,100,190,6,3784,3,3793
test4sub2of100,test4pub10of10,100,191,5,2736,4,2745
test4sub99of100,test4pub8of10,100,190,6,3786,2,3794
test4sub77of100,test4pub9of10,100,190,5,3109,2,3116
test4sub99of100,test4pub10of10,100,191,5,2741,1,2747
test4sub77of100,test4pub8of10,100,190,6,3790,1,3797
test4sub77of100,test4pub10of10,100,191,5,2743,1,2749
test4sub34of100,test4pub9of10,100,190,5,3119,0,3124
test4sub83of100,test4pub9of10,100,190,5,3149,0,3154
test4sub11of100,test4pub9of10,100,190,5,3150,1,3156
test4sub83of100,test4pub10of10,100,191,5,2781,1,2787
test4sub62of100,test4pub5of10,100,190,5,4320,1,4326
test4sub62of100,test4pub7of10,100,190,5,3947,1,3953
test4sub62of100,test4pub9of10,100,190,5,3177,0,3182
test4sub79of100,test4pub8of10,100,190,6,3856,1,3863
test4sub79of100,test4pub10of10,100,191,5,2809,1,2815
test4sub37of100,test4pub7of10,100,190,5,3952,1,3958
test4sub79of100,test4pub9of10,100,190,5,3181,0,3186
test4sub37of100,test4pub10of10,100,191,5,2812,1,2818
test4sub5of100,test4pub10of10,100,191,5,2817,1,2823
test4sub5of100,test4pub7of10,100,190,5,3959,0,3964
test4sub5of100,test4pub9of10,100,190,5,3189,1,3195
test4sub72of100,test4pub8of10,100,190,6,3873,0,3879
test4sub95of100,test4pub10of10,100,191,5,2826,1,2832
test4sub69of100,test4pub9of10,100,190,5,3195,2,3202
test4sub72of100,test4pub7of10,100,190,5,3967,2,3974
test4sub52of100,test4pub6of10,100,190,5,4257,1,4263
test4sub52of100,test4pub9of10,100,190,5,3199,0,3204
test4sub52of100,test4pub7of10,100,190,5,3972,1,3978
test4sub56of100,test4pub8of10,100,190,6,3882,1,3889
test4sub71of100,test4pub7of10,100,190,5,3975,1,3981
test4sub56of100,test4pub9of10,100,190,5,3205,2,3212
test4sub51of100,test4pub4of10,100,190,8,4385,1,4394
test4sub51of100,test4pub10of10,100,191,5,2837,0,2842
test4sub68of100,test4pub7of10,100,190,5,3984,1,3990
test4sub68of100,test4pub9of10,100,190,5,3214,0,3219
test4sub68of100,test4pub5of10,100,190,5,4361,1,4367
test4sub75of100,test4pub7of10,100,190,5,3987,2,3994
test4sub59of100,test4pub9of10,100,190,5,3217,3,3225
test4sub68of100,test4pub8of10,100,190,6,3896,3,3905
test4sub84of100,test4pub8of10,100,190,6,3897,2,3905
test4sub75of100,test4pub9of10,100,190,5,3219,3,3227
test4sub74of100,test4pub7of10,100,190,5,3991,4,4000
test4sub84of100,test4pub9of10,100,190,5,3222,2,3229
test4sub13of100,test4pub8of10,100,190,6,3901,1,3908
test4sub68of100,test4pub10of10,100,191,5,2851,2,2858
test4sub13of100,test4pub9of10,100,190,5,3225,1,3231
test4sub87of100,test4pub8of10,100,190,6,3905,1,3912
test4sub87of100,test4pub10of10,100,191,5,2857,0,2862
test4sub22of100,test4pub5of10,100,190,5,4385,1,4391
test4sub7of100,test4pub8of10,100,190,6,3920,1,3927
test4sub88of100,test4pub10of10,100,191,5,2873,1,2879
test4sub3of100,test4pub9of10,100,190,5,3287,0,3292
test4sub3of100,test4pub7of10,100,190,5,4060,1,4066
test4sub3of100,test4pub10of10,100,191,5,2920,0,2925
test4sub93of100,test4pub10of10,100,191,5,2933,0,2938
test4sub31of100,test4pub5of10,100,190,5,4451,0,4456
test4sub31of100,test4pub10of10,100,191,5,2937,1,2943
test4sub31of100,test4pub9of10,100,190,5,3308,0,3313
test4sub10of100,test4pub1of10,100,12976,14,4639,43,4696
test4sub4of100,test4pub1of10,100,12976,14,4657,69,4740
test4sub86of100,test4pub1of10,100,12976,14,4660,107,4781
test4sub54of100,test4pub1of10,100,12976,14,4664,144,4822
test4sub10of100,test4pub9of10,100,190,5,3361,124,3490
test4sub94of100,test4pub1of10,100,12976,14,4721,130,4865
test4sub4of100,test4pub7of10,100,190,5,4176,124,4305
test4sub86of100,test4pub8of10,100,190,6,4124,83,4213
test4sub2of100,test4pub9of10,100,190,5,3478,53,3536
test4sub1of100,test4pub10of10,100,191,5,3109,52,3166
test4sub99of100,test4pub9of10,100,190,5,3479,52,3536
test4sub54of100,test4pub5of10,100,190,5,4631,46,4682
test4sub10of100,test4pub10of10,100,191,5,3116,46,3167
test4sub94of100,test4pub10of10,100,191,5,3159,3,3167
test4sub86of100,test4pub9of10,100,190,5,3530,3,3538
test4sub54of100,test4pub10of10,100,191,5,3162,1,3168
test4sub54of100,test4pub8of10,100,190,6,4213,1,4220
test4sub54of100,test4pub9of10,100,190,5,3535,0,3540
test4sub97of100,test4pub9of10,100,190,5,3561,1,3567
test4sub89of100,test4pub7of10,100,190,5,4355,1,4361
test4sub89of100,test4pub10of10,100,191,5,3216,3,3224
test4sub80of100,test4pub1of10,100,12976,14,4912,44,4970
test4sub89of100,test4pub5of10,100,190,5,4737,42,4784
test4sub80of100,test4pub8of10,100,190,6,4312,1,4319
test4sub80of100,test4pub10of10,100,191,5,3265,0,3270
test4sub80of100,test4pub9of10,100,190,5,3636,1,3642
test4sub80of100,test4pub7of10,100,190,5,4409,0,4414
test4sub50of100,test4pub8of10,100,190,6,4319,0,4325
test4sub50of100,test4pub10of10,100,191,5,3272,1,3278
test4sub58of100,test4pub4of10,100,190,8,4840,0,4848
test4sub70of100,test4pub8of10,100,190,6,4438,0,4444
test4sub70of100,test4pub9of10,100,190,5,3761,1,3767
test4sub78of100,test4pub4of10,100,190,8,4941,1,4950
test4sub70of100,test4pub7of10,100,190,5,4533,1,4539
test4sub78of100,test4pub6of10,100,190,5,4824,1,4830
test4sub7of100,test4pub9of10,100,190,5,3766,1,3772
test4sub100of100,test4pub1of10,100,12976,14,5098,42,5154
test4sub28of100,test4pub4of10,100,190,8,4954,43,5005
test4sub53of100,test4pub1of10,100,12976,14,5107,71,5192
test4sub100of100,test4pub3of10,100,190,5,5070,43,5118
test4sub28of100,test4pub8of10,100,190,6,4499,85,4590
test4sub39of100,test4pub1of10,100,12976,14,5141,86,5241
test4sub20of100,test4pub7of10,100,190,5,4598,80,4683
test4sub53of100,test4pub7of10,100,190,5,4632,46,4683
test4sub100of100,test4pub8of10,100,190,6,4540,48,4594
test4sub43of100,test4pub1of10,100,12976,14,5214,61,5289
test4sub28of100,test4pub9of10,100,190,5,3906,46,3957
test4sub39of100,test4pub7of10,100,190,5,4677,48,4730
test4sub64of100,test4pub1of10,100,12976,14,5232,87,5333
test4sub53of100,test4pub5of10,100,190,5,5055,87,5147
test4sub100of100,test4pub9of10,100,190,5,3911,88,4004
test4sub90of100,test4pub1of10,100,12976,14,5236,128,5378
test4sub43of100,test4pub3of10,100,190,5,5205,89,5299
test4sub28of100,test4pub10of10,100,191,5,3584,91,3680
test4sub39of100,test4pub2of10,100,190,7,5249,90,5346
test4sub52of100,test4pub1of10,100,12976,14,5282,128,5424
test4sub58of100,test4pub1of10,100,12976,14,5303,148,5465
test4sub53of100,test4pub10of10,100,191,5,3628,131,3764
test4sub82of100,test4pub1of10,100,12976,14,5321,173,5508
test4sub100of100,test4pub6of10,100,190,5,5060,173,5238
test4sub90of100,test4pub10of10,100,191,5,3671,131,3807
test4sub43of100,test4pub6of10,100,190,5,5103,130,5238
test4sub73of100,test4pub1of10,100,12976,14,5365,173,5552
test4sub96of100,test4pub1of10,100,12976,14,5369,211,5594
test4sub39of100,test4pub10of10,100,191,5,3676,210,3891
test4sub70of100,test4pub1of10,100,12976,14,5388,236,5638
test4sub22of100,test4pub1of10,100,12976,14,5389,277,5680
test4sub8of100,test4pub10of10,100,191,5,3711,264,3980
test4sub52of100,test4pub8of10,100,190,6,4768,256,5030
test4sub91of100,test4pub1of10,100,12976,14,5422,289,5725
test4sub48of100,test4pub7of10,100,190,5,4871,289,5165
test4sub58of100,test4pub10of10,100,191,5,3759,260,4024
test4sub18of100,test4pub10of10,100,191,5,3785,234,4024
test4sub82of100,test4pub10of10,100,191,5,3803,218,4026
test4sub43of100,test4pub7of10,100,190,5,4945,216,5166
test4sub73of100,test4pub6of10,100,190,5,5277,176,5458
test4sub96of100,test4pub10of10,100,191,5,3887,135,4027
test4sub33of100,test4pub1of10,100,12976,14,5592,167,5773
test4sub70of100,test4pub10of10,100,191,5,3931,135,4071
test4sub91of100,test4pub9of10,100,190,5,4389,48,4442
test4sub48of100,test4pub10of10,100,191,5,4019,49,4073
test4sub82of100,test4pub8of10,100,190,6,5070,46,5122
test4sub43of100,test4pub9of10,100,190,5,4392,47,4444
test4sub96of100,test4pub9of10,100,190,5,4393,46,4444
test4sub33of100,test4pub8of10,100,190,6,5116,3,5125
test4sub48of100,test4pub8of10,100,190,6,5117,1,5124
test4sub33of100,test4pub10of10,100,191,5,4070,1,4076
test4sub48of100,test4pub5of10,100,190,5,5587,1,5593
test4sub33of100,test4pub9of10,100,190,5,4442,0,4447
test4sub21of100,test4pub7of10,100,190,5,5313,0,5318
test4sub21of100,test4pub5of10,100,190,5,5690,1,5696
test4sub78of100,test4pub10of10,100,191,5,4205,0,4210
test4sub78of100,test4pub7of10,100,190,5,5348,1,5354
test4sub26of100,test4pub2of10,100,190,7,5872,0,5879
test4sub26of100,test4pub6of10,100,190,5,5640,1,5646
test4sub26of100,test4pub8of10,100,190,6,5263,1,5270
test4sub26of100,test4pub7of10,100,190,5,5357,1,5363
test4sub81of100,test4pub3of10,100,190,5,5885,1,5891
test4sub87of100,test4pub7of10,100,190,5,5448,1,5454
test4sub87of100,test4pub9of10,100,190,5,4678,1,4684
test4sub63of100,test4pub1of10,100,12976,14,6004,55,6073
test4sub12of100,test4pub1of10,100,12976,14,6010,89,6113
test4sub57of100,test4pub7of10,100,190,5,5475,73,5553
test4sub63of100,test4pub5of10,100,190,5,5883,41,5929
test4sub19of100,test4pub1of10,100,12976,14,6079,64,6157
test4sub12of100,test4pub5of10,100,190,5,5923,43,5971
test4sub57of100,test4pub9of10,100,190,5,4777,44,4826
test4sub63of100,test4pub7of10,100,190,5,5550,44,5599
test4sub30of100,test4pub1of10,100,12976,14,6138,50,6202
test4sub19of100,test4pub2of10,100,190,7,6115,43,6165
test4sub12of100,test4pub7of10,100,190,5,5592,45,5642
test4sub63of100,test4pub8of10,100,190,6,5502,43,5551
test4sub46of100,test4pub1of10,100,12976,14,6169,61,6244
test4sub44of100,test4pub8of10,100,190,6,5542,46,5594
test4sub30of100,test4pub5of10,100,190,5,6011,44,6060
test4sub19of100,test4pub10of10,100,191,5,4496,44,4545
test4sub12of100,test4pub10of10,100,191,5,4497,45,4547
test4sub46of100,test4pub10of10,100,191,5,4539,4,4548
test4sub44of100,test4pub9of10,100,190,5,4909,5,4919
test4sub30of100,test4pub10of10,100,191,5,4540,3,4548
test4sub19of100,test4pub9of10,100,190,5,4911,3,4919
test4sub12of100,test4pub9of10,100,190,5,4913,1,4919
test4sub81of100,test4pub1of10,100,12976,14,6254,41,6309
test4sub21of100,test4pub1of10,100,12976,14,6262,73,6349
test4sub65of100,test4pub1of10,100,12976,14,6266,112,6392
test4sub81of100,test4pub10of10,100,191,5,4603,83,4691
test4sub9of100,test4pub1of10,100,12976,14,6358,65,6437
test4sub65of100,test4pub8of10,100,190,6,5736,48,5790
test4sub81of100,test4pub9of10,100,190,5,5057,49,5111
test4sub65of100,test4pub7of10,100,190,5,5877,5,5887
test4sub9of100,test4pub7of10,100,190,5,5877,7,5889
test4sub62of100,test4pub1of10,100,12976,14,6433,46,6493
test4sub27of100,test4pub1of10,100,12976,14,6434,84,6532
test4sub65of100,test4pub9of10,100,190,5,5112,84,5201
test4sub9of100,test4pub9of10,100,190,5,5114,84,5203
test4sub45of100,test4pub1of10,100,12976,14,6442,122,6578
test4sub23of100,test4pub1of10,100,12976,14,6445,159,6618
test4sub40of100,test4pub1of10,100,12976,14,6459,188,6661
test4sub27of100,test4pub10of10,100,191,5,4827,127,4959
test4sub65of100,test4pub5of10,100,190,5,6343,127,6475
test4sub9of100,test4pub10of10,100,191,5,4829,128,4962
test4sub45of100,test4pub4of10,100,190,8,6420,85,6513
test4sub23of100,test4pub9of10,100,190,5,5281,46,5332
test4sub40of100,test4pub4of10,100,190,8,6504,2,6514
test4sub65of100,test4pub10of10,100,191,5,4956,3,4964
test4sub45of100,test4pub8of10,100,190,6,6007,2,6015
test4sub40of100,test4pub3of10,100,190,5,6581,1,6587
test4sub45of100,test4pub9of10,100,190,5,5330,1,5336
test4sub40of100,test4pub2of10,100,190,7,6624,1,6632
test4sub40of100,test4pub5of10,100,190,5,6478,1,6484
test4sub40of100,test4pub8of10,100,190,6,6012,0,6018
test4sub40of100,test4pub6of10,100,190,5,6395,1,6401
test4sub40of100,test4pub9of10,100,190,5,5336,0,5341
test4sub40of100,test4pub10of10,100,191,5,4967,0,4972
test4sub75of100,test4pub1of100,1,318,12,126,38,176
test4sub13of100,test4pub1of100,1,318,12,140,64,216
test4sub1of100,test4pub1of100,1,318,12,184,59,255
test4sub48of100,test4pub1of100,1,318,12,366,37,415
test4sub14of100,test4pub1of100,1,318,12,373,70,455
test4sub7of100,test4pub1of100,1,318,12,374,110,496
test4sub28of100,test4pub1of100,1,318,12,374,149,535
test4sub20of100,test4pub1of100,1,318,12,378,186,576
test4sub5of100,test4pub1of100,1,318,12,385,219,616
test4sub98of100,test4pub1of100,1,318,12,484,160,656
test4sub66of100,test4pub1of100,1,318,12,487,198,697
test4sub74of100,test4pub1of100,1,318,12,490,233,735
test4sub41of100,test4pub1of100,1,318,12,498,266,776
test4sub78of100,test4pub1of100,1,318,12,516,287,815
test4sub17of100,test4pub1of100,1,318,12,523,321,856
test4sub16of100,test4pub1of100,1,318,12,530,353,895
test4sub34of100,test4pub1of100,1,318,12,531,392,935
test4sub60of100,test4pub1of100,1,318,12,536,428,976
test4sub37of100,test4pub1of100,1,318,12,539,465,1016
test4sub32of100,test4pub1of100,1,318,12,549,495,1056
test4sub3of100,test4pub1of100,1,318,12,553,530,1095
test4sub18of100,test4pub1of100,1,318,12,553,570,1135
test4sub42of100,test4pub2of10,100,190,7,7235,570,7812
test4sub94of100,test4pub2of100,1,189,5,367,568,940
test4sub51of100,test4pub1of100,1,318,12,562,601,1175
test4sub88of100,test4pub2of100,1,189,5,374,601,980
test4sub31of100,test4pub1of100,1,318,12,571,632,1215
test4sub25of100,test4pub2of100,1,189,5,383,632,1020
test4sub93of100,test4pub2of100,1,189,5,394,621,1020
test4sub44of100,test4pub1of100,1,318,12,589,654,1255
test4sub35of100,test4pub1of100,1,318,12,592,691,1295
test4sub6of100,test4pub1of100,1,318,12,593,730,1335
test4sub9of100,test4pub2of100,1,189,5,404,731,1140
test4sub70of100,test4pub2of100,1,189,5,404,731,1140
test4sub84of100,test4pub1of100,1,318,12,598,765,1375
test4sub11of100,test4pub1of100,1,318,12,604,800,1416
test4sub61of100,test4pub2of100,1,189,5,414,800,1219
test4sub21of100,test4pub2of100,1,189,5,416,800,1221
test4sub50of100,test4pub1of100,1,318,12,606,837,1455
test4sub46of100,test4pub2of100,1,189,5,417,838,1260
test4sub86of100,test4pub2of100,1,189,5,418,837,1260
test4sub82of100,test4pub2of100,1,189,5,419,837,1261
test4sub15of100,test4pub2of100,1,189,5,419,837,1261
test4sub59of100,test4pub1of100,1,318,12,610,874,1496
test4sub71of100,test4pub1of100,1,318,12,616,907,1535
test4sub76of100,test4pub2of100,1,189,5,427,907,1339
test4sub97of100,test4pub1of100,1,318,12,618,946,1576
test4sub85of100,test4pub2of100,1,189,5,443,931,1379
test4sub99of100,test4pub1of100,1,318,12,634,969,1615
test4sub38of100,test4pub1of100,1,318,12,635,1009,1656
test4sub95of100,test4pub1of100,1,318,12,637,1046,1695
test4sub57of100,test4pub1of100,1,318,12,644,1079,1735
test4sub36of100,test4pub1of100,1,318,12,655,1108,1775
test4sub92of100,test4pub2of100,1,189,5,466,1108,1579
test4sub79of100,test4pub1of100,1,318,12,656,1147,1815
test4sub89of100,test4pub2of100,1,189,5,469,1145,1619
test4sub68of100,test4pub1of100,1,318,12,660,1183,1855
test4sub29of100,test4pub1of100,1,318,12,661,1227,1900
test4sub43of100,test4pub1of100,1,318,12,661,1266,1939
test4sub40of100,test4pub1of100,1,318,12,663,1304,1979
test4sub69of100,test4pub1of100,1,318,12,666,1341,2019
test4sub100of100,test4pub1of100,1,318,12,671,1376,2059
test4sub26of100,test4pub1of100,1,318,12,672,1416,2100
test4sub83of100,test4pub1of100,1,318,12,672,1455,2139
test4sub64of100,test4pub2of100,1,189,5,483,1456,1944
test4sub2of100,test4pub1of100,1,318,12,673,1494,2179
test4sub65of100,test4pub2of100,1,189,5,484,1495,1984
test4sub58of100,test4pub1of100,1,318,12,675,1533,2220
test4sub47of100,test4pub1of100,1,318,12,675,1572,2259
test4sub33of100,test4pub2of100,1,189,5,486,1573,2064
test4sub27of100,test4pub2of100,1,189,5,487,1573,2065
test4sub4of100,test4pub2of100,1,189,5,488,1573,2066
test4sub55of100,test4pub1of100,1,318,12,678,1609,2299
test4sub80of100,test4pub1of100,1,318,12,679,1648,2339
test4sub72of100,test4pub1of100,1,318,12,679,1688,2379
test4sub53of100,test4pub2of100,1,189,5,490,1688,2183
test4sub49of100,test4pub1of100,1,318,12,683,1724,2419
test4sub39of100,test4pub1of100,1,318,12,684,1763,2459
test4sub22of100,test4pub2of100,1,189,5,496,1763,2264
test4sub8of100,test4pub1of100,1,318,12,687,1801,2500
test4sub56of100,test4pub1of100,1,318,12,692,1836,2540
test4sub67of100,test4pub1of100,1,318,12,697,1870,2579
test4sub96of100,test4pub1of100,1,318,12,698,1910,2620
test4sub77of100,test4pub1of100,1,318,12,700,1948,2660
test4sub12of100,test4pub1of100,1,318,12,701,1986,2699
test4sub54of100,test4pub1of100,1,318,12,702,2027,2741
test4sub30of100,test4pub1of100,1,318,12,704,2064,2780
test4sub75of100,test4pub2of100,1,189,5,624,1955,2584
test4sub81of100,test4pub1of100,1,318,12,911,1896,2819
test4sub52of100,test4pub1of100,1,318,12,705,2143,2860
test4sub91of100,test4pub1of100,1,318,12,707,2180,2899
test4sub34of100,test4pub2of100,1,189,5,735,1964,2704
test4sub24of100,test4pub2of10,100,190,7,7686,1885,9578
test4sub19of100,test4pub1of100,1,318,12,1045,1882,2939
test4sub42of100,test4pub9of10,100,190,5,6512,1804,8321
test4sub51of100,test4pub2of100,1,189,5,975,1765,2745
test4sub88of100,test4pub1of100,1,318,12,1165,1803,2980
test4sub25of100,test4pub1of100,1,318,12,1205,1803,3020
test4sub31of100,test4pub2of100,1,189,5,1015,1804,2824
test4sub93of100,test4pub1of100,1,318,12,1206,1841,3059
test4sub44of100,test4pub2of100,1,189,5,1055,1804,2864
test4sub18of100,test4pub2of100,1,189,5,1085,1774,2864
test4sub35of100,test4pub2of100,1,189,5,1095,1765,2865
test4sub73of100,test4pub1of100,1,318,12,1294,1793,3099
test4sub6of100,test4pub2of100,1,189,5,1135,1764,2904
test4sub9of100,test4pub1of100,1,318,12,1325,1803,3140
test4sub70of100,test4pub1of100,1,318,12,1326,1841,3179
test4sub84of100,test4pub2of100,1,189,5,1175,1804,2984
test4sub11of100,test4pub2of100,1,189,5,1215,1765,2985
test4sub61of100,test4pub1of100,1,318,12,1405,1803,3220
test4sub21of100,test4pub1of100,1,318,12,1406,1841,3259
test4sub78of100,test4pub2of100,1,189,5,1238,1820,3063
test4sub50of100,test4pub2of100,1,189,5,1255,1805,3065
test4sub86of100,test4pub1of100,1,318,12,1446,1842,3300
test4sub82of100,test4pub1of100,1,318,12,1446,1881,3339
test4sub15of100,test4pub1of100,1,318,12,1448,1920,3380
test4sub59of100,test4pub2of100,1,189,5,1295,1884,3184
test4sub71of100,test4pub2of100,1,189,5,1335,1845,3185
test4sub76of100,test4pub1of100,1,318,12,1525,1882,3419
test4sub7of100,test4pub2of100,1,189,5,1343,1876,3224
test4sub16of100,test4pub2of100,1,189,5,1354,1866,3225
test4sub97of100,test4pub2of100,1,189,5,1375,1846,3226
test4sub85of100,test4pub1of100,1,318,12,1565,1883,3460
test4sub99of100,test4pub2of100,1,189,5,1415,1844,3264
test4sub41of100,test4pub2of100,1,189,5,1439,1820,3264
test4sub38of100,test4pub2of100,1,189,5,1455,1805,3265
test4sub95of100,test4pub2of100,1,189,5,1495,1766,3266
test4sub57of100,test4pub2of100,1,189,5,1535,1727,3267
test4sub36of100,test4pub2of100,1,189,5,1575,1687,3267
test4sub90of100,test4pub2of100,1,189,5,1592,1672,3269
test4sub79of100,test4pub2of100,1,189,5,1615,1649,3269
test4sub68of100,test4pub2of100,1,189,5,1655,1611,3271
test4sub1of100,test4pub2of100,1,189,5,1474,1792,3271
test4sub29of100,test4pub2of100,1,189,5,1698,1568,3271
test4sub43of100,test4pub2of100,1,189,5,1739,1529,3273
test4sub40of100,test4pub2of100,1,189,5,1779,1490,3274
test4sub69of100,test4pub2of100,1,189,5,1819,1450,3274
test4sub100of100,test4pub2of100,1,189,5,1859,1412,3276
test4sub26of100,test4pub2of100,1,189,5,1899,1372,3276
test4sub83of100,test4pub2of100,1,189,5,1939,1334,3278
test4sub64of100,test4pub1of100,1,318,12,2129,1372,3513
test4sub2of100,test4pub2of100,1,189,5,1979,1332,3316
test4sub58of100,test4pub2of100,1,189,5,2019,1293,3317
test4sub33of100,test4pub1of100,1,318,12,2249,1290,3551
test4sub47of100,test4pub2of100,1,189,5,2059,1291,3355
test4sub27of100,test4pub1of100,1,318,12,2251,1329,3592
test4sub4of100,test4pub1of100,1,318,12,2251,1369,3632
test4sub55of100,test4pub2of100,1,189,5,2099,1332,3436
test4sub14of100,test4pub2of100,1,189,5,1491,1941,3437
test4sub80of100,test4pub2of100,1,189,5,2139,1293,3437
test4sub72of100,test4pub2of100,1,189,5,2179,1255,3439
test4sub65of100,test4pub1of100,1,318,12,2169,1491,3672
test4sub49of100,test4pub2of100,1,189,5,2218,1252,3475
test4sub39of100,test4pub2of100,1,189,5,2259,1213,3477
test4sub8of100,test4pub2of100,1,189,5,2299,1174,3478
test4sub32of100,test4pub2of100,1,189,5,1689,1785,3479
test4sub56of100,test4pub2of100,1,189,5,2339,1135,3479
test4sub67of100,test4pub2of100,1,189,5,2379,1097,3481
test4sub96of100,test4pub2of100,1,189,5,2419,1057,3481
test4sub77of100,test4pub2of100,1,189,5,2459,1018,3482
test4sub12of100,test4pub2of100,1,189,5,2499,979,3483
test4sub54of100,test4pub2of100,1,189,5,2539,939,3483
test4sub30of100,test4pub2of100,1,189,5,2579,900,3484
test4sub87of100,test4pub1of100,1,318,12,2569,1138,3719
test4sub81of100,test4pub2of100,1,189,5,2618,900,3523
test4sub52of100,test4pub2of100,1,189,5,2659,861,3525
test4sub91of100,test4pub2of100,1,189,5,2699,821,3525
test4sub34of100,test4pub3of100,1,189,8,2326,823,3157
test4sub24of100,test4pub6of10,100,190,5,9337,821,10163
test4sub19of100,test4pub2of100,1,189,5,2739,784,3528
test4sub51of100,test4pub3of100,1,189,8,2367,782,3157
test4sub88of100,test4pub3of100,1,189,8,2406,746,3160
test4sub25of100,test4pub7of100,1,189,5,1910,706,2621
test4sub31of100,test4pub7of100,1,189,5,1910,706,2621
test4sub93of100,test4pub3of100,1,189,8,2486,668,3162
test4sub44of100,test4pub3of100,1,189,8,2486,669,3163
test4sub18of100,test4pub3of100,1,189,8,2487,667,3162
test4sub35of100,test4pub3of100,1,189,8,2488,669,3165
test4sub22of100,test4pub1of100,1,318,12,2449,1307,3768
test4sub6of100,test4pub3of100,1,189,8,2526,669,3203
test4sub73of100,test4pub3of100,1,189,8,2526,670,3204
test4sub9of100,test4pub3of100,1,189,8,2566,631,3205
test4sub70of100,test4pub3of100,1,189,8,2606,591,3205
test4sub84of100,test4pub3of100,1,189,8,2606,592,3206
test4sub11of100,test4pub3of100,1,189,8,2608,593,3209
test4sub61of100,test4pub3of100,1,189,8,2646,557,3211
test4sub21of100,test4pub3of100,1,189,8,2686,518,3212
test4sub50of100,test4pub3of100,1,189,8,2687,518,3213
test4sub86of100,test4pub5of100,1,189,5,2254,481,2740
test4sub42of100,test4pub10of10,100,191,5,7946,842,8793
test4sub82of100,test4pub4of100,1,189,5,2420,444,2869
test4sub15of100,test4pub3of100,1,189,8,2806,406,3220
test4sub59of100,test4pub3of100,1,189,8,2806,408,3222
test4sub71of100,test4pub5of100,1,189,5,2335,408,2748
test4sub76of100,test4pub3of100,1,189,8,2846,370,3224
test4sub16of100,test4pub3of100,1,189,8,2847,372,3227
test4sub7of100,test4pub3of100,1,189,8,2847,373,3228
test4sub97of100,test4pub3of100,1,189,8,2849,372,3229
test4sub85of100,test4pub3of100,1,189,8,2886,336,3230
test4sub38of100,test4pub9of100,1,189,6,2274,335,2615
test4sub95of100,test4pub5of100,1,189,5,2416,335,2756
test4sub57of100,test4pub3of100,1,189,8,2889,335,3232
test4sub36of100,test4pub4of100,1,189,5,2544,336,2885
test4sub79of100,test4pub3of100,1,189,8,2891,334,3233
test4sub90of100,test4pub1of100,1,318,12,3454,373,3839
test4sub68of100,test4pub3of100,1,189,8,2893,372,3273
test4sub1of100,test4pub3of100,1,189,8,2893,373,3274
test4sub29of100,test4pub5of100,1,189,5,2423,372,2800
test4sub43of100,test4pub10of100,1,191,10,2258,374,2642
test4sub78of100,test4pub8of100,1,189,5,2102,583,2690
test4sub40of100,test4pub7of100,1,189,5,2361,374,2740
test4sub69of100,test4pub3of100,1,189,8,2897,374,3279
test4sub100of100,test4pub10of100,1,191,10,2261,373,2644
test4sub26of100,test4pub3of100,1,189,8,2899,374,3281
test4sub83of100,test4pub3of100,1,189,8,2900,374,3282
test4sub48of100,test4pub2of100,1,189,5,3289,357,3651
test4sub64of100,test4pub3of100,1,189,8,2938,338,3284
test4sub58of100,test4pub7of100,1,189,5,2404,336,2745
test4sub41of100,test4pub3of100,1,189,8,2969,308,3285
test4sub33of100,test4pub3of100,1,189,8,2978,300,3286
test4sub47of100,test4pub3of100,1,189,8,2978,301,3287
test4sub27of100,test4pub3of100,1,189,8,3018,261,3287
test4sub4of100,test4pub10of100,1,191,10,2421,223,2654
test4sub14of100,test4pub3of100,1,189,8,3059,221,3288
test4sub80of100,test4pub3of100,1,189,8,3060,223,3291
test4sub72of100,test4pub3of100,1,189,8,3061,222,3291
test4sub99of100,test4pub4of100,1,189,5,2540,398,2943
test4sub65of100,test4pub3of100,1,189,8,3098,187,3293
test4sub39of100,test4pub3of100,1,189,8,3099,186,3293
test4sub8of100,test4pub3of100,1,189,8,3100,186,3294
test4sub32of100,test4pub10of100,1,191,10,2464,186,2660
test4sub56of100,test4pub3of100,1,189,8,3102,186,3296
test4sub96of100,test4pub3of100,1,189,8,3103,185,3296
test4sub67of100,test4pub3of100,1,189,8,3103,186,3297
test4sub12of100,test4pub3of100,1,189,8,3105,186,3299
test4sub77of100,test4pub3of100,1,189,8,3105,186,3299
test4sub30of100,test4pub3of100,1,189,8,3107,186,3301
test4sub54of100,test4pub3of100,1,189,8,3106,186,3300
test4sub87of100,test4pub2of100,1,189,5,3519,148,3672
test4sub81of100,test4pub7of100,1,189,5,2610,148,2763
test4sub52of100,test4pub3of100,1,189,8,3147,148,3303
test4sub91of100,test4pub3of100,1,189,8,3148,148,3304
test4sub62of100,test4pub1of100,1,318,12,708,3191,3911
test4sub20of100,test4pub2of100,1,189,5,520,3191,3716
test4sub5of100,test4pub2of100,1,189,5,521,3191,3717
test4sub51of100,test4pub6of100,1,189,5,2655,188,2848
test4sub88of100,test4pub8of100,1,189,5,2568,187,2760
test4sub25of100,test4pub10of100,1,191,10,2515,188,2713
test4sub31of100,test4pub3of100,1,189,8,3154,188,3350
test4sub93of100,test4pub6of100,1,189,5,2658,189,2852
test4sub44of100,test4pub5of100,1,189,5,2683,187,2875
test4sub18of100,test4pub6of100,1,189,5,2660,189,2854
test4sub28of100,test4pub2of100,1,189,5,524,3193,3722
test4sub35of100,test4pub6of100,1,189,5,2661,189,2855
test4sub22of100,test4pub3of100,1,189,8,3194,153,3355
test4sub6of100,test4pub10of100,1,191,10,2558,152,2720
test4sub73of100,test4pub2of100,1,189,5,3569,151,3725
test4sub70of100,test4pub5of100,1,189,5,2726,151,2882
test4sub84of100,test4pub7of100,1,189,5,2664,152,2821
test4sub11of100,test4pub6of100,1,189,5,2705,150,2860
test4sub61of100,test4pub7of100,1,189,5,2667,150,2822
test4sub21of100,test4pub9of100,1,189,6,2590,149,2745
test4sub50of100,test4pub5of100,1,189,5,2734,148,2887
test4sub86of100,test4pub3of100,1,189,8,3207,148,3363
test4sub42of100,test4pub8of10,100,190,6,9838,148,9992
test4sub82of100,test4pub6of100,1,189,5,2714,147,2866
test4sub15of100,test4pub5of100,1,189,5,2740,146,2891
test4sub59of100,test4pub4of100,1,189,5,2868,145,3018
test4sub71of100,test4pub8of100,1,189,5,2632,145,2782
test4sub76of100,test4pub5of100,1,189,5,2746,143,2894
test4sub16of100,test4pub8of100,1,189,5,2636,143,2784
test4sub7of100,test4pub5of100,1,189,5,2749,141,2895
test4sub97of100,test4pub7of100,1,189,5,2685,142,2832
test4sub85of100,test4pub9of100,1,189,6,2609,142,2757
test4sub1of100,test4pub6of100,1,189,5,2772,110,2887
test4sub90of100,test4pub3of100,1,189,8,3266,113,3387
test4sub68of100,test4pub4of100,1,189,5,2920,113,3038
test4sub79of100,test4pub4of100,1,189,5,2881,153,3039
test4sub36of100,test4pub3of100,1,189,8,3226,154,3388
test4sub29of100,test4pub7of100,1,189,5,2732,113,2850
test4sub95of100,test4pub3of100,1,189,8,3225,157,3390
test4sub57of100,test4pub6of100,1,189,5,2729,157,2891
test4sub38of100,test4pub3of100,1,189,8,3223,159,3390
test4sub43of100,test4pub3of100,1,189,8,3269,115,3392
test4sub78of100,test4pub3of100,1,189,8,3270,116,3394
test4sub69of100,test4pub4of100,1,189,5,2925,115,3045
test4sub40of100,test4pub3of100,1,189,8,3271,116,3395
test4sub100of100,test4pub3of100,1,189,8,3273,116,3397
test4sub26of100,test4pub10of100,1,191,10,2636,116,2762
test4sub48of100,test4pub3of100,1,189,8,3275,116,3399
test4sub83of100,test4pub5of100,1,189,5,2802,116,2923
test4sub58of100,test4pub9of100,1,189,6,2662,116,2784
test4sub64of100,test4pub7of100,1,189,5,2740,116,2861
test4sub33of100,test4pub5of100,1,189,5,2806,115,2926
test4sub41of100,test4pub9of100,1,189,6,2664,116,2786
test4sub47of100,test4pub4of100,1,189,5,2934,115,3054
test4sub27of100,test4pub9of100,1,189,6,2666,116,2788
test4sub14of100,test4pub6of100,1,189,5,2786,115,2906
test4sub4of100,test4pub4of100,1,189,5,2935,116,3056
test4sub80of100,test4pub5of100,1,189,5,2811,115,2931
test4sub72of100,test4pub10of100,1,191,10,2646,115,2771
test4sub65of100,test4pub6of100,1,189,5,2789,114,2908
test4sub99of100,test4pub3of100,1,189,8,3285,115,3408
test4sub39of100,test4pub5of100,1,189,5,2814,114,2933
test4sub8of100,test4pub8of100,1,189,5,2703,115,2823
test4sub32of100,test4pub4of100,1,189,5,2942,113,3060
test4sub56of100,test4pub7of100,1,189,5,2752,114,2871
test4sub67of100,test4pub10of100,1,191,10,2653,114,2777
test4sub96of100,test4pub7of100,1,189,5,2754,115,2874
test4sub12of100,test4pub6of100,1,189,5,2795,113,2913
test4sub77of100,test4pub4of100,1,189,5,2946,115,3066
test4sub54of100,test4pub6of100,1,189,5,2797,113,2915
test4sub30of100,test4pub9of100,1,189,6,2679,114,2799
test4sub87of100,test4pub3of100,1,189,8,3294,114,3416
test4sub81of100,test4pub5of100,1,189,5,2823,115,2943
test4sub52of100,test4pub4of100,1,189,5,2950,113,3068
test4sub91of100,test4pub5of100,1,189,5,2825,115,2945
test4sub20of100,test4pub3of100,1,189,8,3338,74,3420
test4sub62of100,test4pub2of100,1,189,5,3711,75,3791
test4sub51of100,test4pub5of100,1,189,5,2868,74,2947
test4sub88of100,test4pub6of100,1,189,5,2844,74,2923
test4sub25of100,test4pub3of100,1,189,8,3342,74,3424
test4sub31of100,test4pub8of100,1,189,5,2758,75,2838
test4sub93of100,test4pub4of100,1,189,5,2997,74,3076
test4sub44of100,test4pub7of100,1,189,5,2808,74,2887
test4sub28of100,test4pub3of100,1,189,8,3345,74,3427
test4sub18of100,test4pub4of100,1,189,5,2999,74,3078
test4sub22of100,test4pub8of100,1,189,5,2763,75,2843
test4sub35of100,test4pub9of100,1,189,6,2733,75,2814
test4sub6of100,test4pub9of100,1,189,6,2734,74,2814
test4sub73of100,test4pub7of100,1,189,5,2813,75,2893
test4sub3of100,test4pub2of100,1,189,5,3723,75,3803
test4sub70of100,test4pub4of100,1,189,5,3005,74,3084
test4sub84of100,test4pub6of100,1,189,5,2856,74,2935
test4sub11of100,test4pub4of100,1,189,5,3006,74,3085
test4sub61of100,test4pub4of100,1,189,5,3008,74,3087
test4sub21of100,test4pub10of100,1,191,10,2717,74,2801
test4sub50of100,test4pub9of100,1,189,6,2741,74,2821
test4sub86of100,test4pub10of100,1,191,10,2719,74,2803
test4sub42of100,test4pub7of10,100,190,5,10079,73,10157
test4sub82of100,test4pub3of100,1,189,8,3358,74,3440
test4sub15of100,test4pub9of100,1,189,6,2746,73,2825
test4sub59of100,test4pub6of100,1,189,5,2864,73,2942
test4sub76of100,test4pub9of100,1,189,6,2748,73,2827
test4sub71of100,test4pub9of100,1,189,6,2747,73,2826
test4sub16of100,test4pub7of100,1,189,5,2827,72,2904
test4sub7of100,test4pub4of100,1,189,5,3017,72,3094
test4sub97of100,test4pub10of100,1,191,10,2728,72,2810
test4sub85of100,test4pub10of100,1,191,10,2728,73,2811
test4sub1of100,test4pub5of100,1,189,5,2906,60,2971
test4sub90of100,test4pub4of100,1,189,5,3033,59,3097
test4sub68of100,test4pub9of100,1,189,6,2765,61,2832
test4sub79of100,test4pub7of100,1,189,5,2844,61,2910
test4sub36of100,test4pub7of100,1,189,5,2845,61,2911
test4sub29of100,test4pub3of100,1,189,8,3381,61,3450
test4sub95of100,test4pub4of100,1,189,5,3036,61,3102
test4sub57of100,test4pub8of100,1,189,5,2799,61,2865
test4sub38of100,test4pub6of100,1,189,5,2888,61,2954
test4sub43of100,test4pub5of100,1,189,5,2914,60,2979
test4sub78of100,test4pub5of100,1,189,5,2914,59,2978
test4sub69of100,test4pub7of100,1,189,5,2852,61,2918
test4sub40of100,test4pub4of100,1,189,5,3042,62,3109
test4sub100of100,test4pub5of100,1,189,5,2917,60,2982
test4sub26of100,test4pub9of100,1,189,6,2776,61,2843
test4sub48of100,test4pub9of100,1,189,6,2777,60,2843
test4sub83of100,test4pub6of100,1,189,5,2896,60,2961
test4sub58of100,test4pub3of100,1,189,8,3393,60,3461
test4sub64of100,test4pub8of100,1,189,5,2809,60,2874
test4sub33of100,test4pub7of100,1,189,5,2859,61,2925
test4sub47of100,test4pub7of100,1,189,5,2860,60,2925
test4sub27of100,test4pub7of100,1,189,5,2860,60,2925
test4sub4of100,test4pub9of100,1,189,6,2784,60,2850
test4sub72of100,test4pub9of100,1,189,6,2785,58,2849
test4sub65of100,test4pub4of100,1,189,5,3053,60,3118
test4sub99of100,test4pub7of100,1,189,5,2865,59,2929
test4sub39of100,test4pub6of100,1,189,5,2905,60,2970
test4sub8of100,test4pub9of100,1,189,6,2788,59,2853
test4sub56of100,test4pub5of100,1,189,5,2931,59,2995
test4sub67of100,test4pub4of100,1,189,5,3058,59,3122
test4sub96of100,test4pub6of100,1,189,5,2909,59,2973
test4sub12of100,test4pub8of100,1,189,5,2822,59,2886
test4sub77of100,test4pub6of100,1,189,5,2911,59,2975
test4sub54of100,test4pub7of100,1,189,5,2871,59,2935
test4sub30of100,test4pub6of100,1,189,5,2913,59,2977
test4sub87of100,test4pub6of100,1,189,5,2913,59,2977
test4sub81of100,test4pub3of100,1,189,8,3410,59,3477
test4sub52of100,test4pub10of100,1,191,10,2774,59,2843
test4sub20of100,test4pub6of100,1,189,5,2916,59,2980
test4sub62of100,test4pub3of100,1,189,8,3413,58,3479
test4sub51of100,test4pub7of100,1,189,5,2879,59,2943
test4sub88of100,test4pub9of100,1,189,6,2801,58,2865
test4sub25of100,test4pub9of100,1,189,6,2803,59,2868
test4sub31of100,test4pub6of100,1,189,5,2921,59,2985
test4sub93of100,test4pub5of100,1,189,5,2946,59,3010
test4sub44of100,test4pub10of100,1,191,10,2782,59,2851
test4sub28of100,test4pub7of100,1,189,5,2884,58,2947
test4sub18of100,test4pub5of100,1,189,5,2949,59,3013
test4sub22of100,test4pub9of100,1,189,6,2808,58,2872
test4sub35of100,test4pub10of100,1,191,10,2785,59,2854
test4sub6of100,test4pub5of100,1,189,5,2952,58,3015
test4sub73of100,test4pub10of100,1,191,10,2787,60,2857
test4sub3of100,test4pub3of100,1,189,8,3425,58,3491
test4sub70of100,test4pub9of100,1,189,6,2811,60,2877
test4sub84of100,test4pub10of100,1,191,10,2790,59,2859
test4sub11of100,test4pub5of100,1,189,5,2955,59,3019
test4sub61of100,test4pub6of100,1,189,5,2932,59,2996
test4sub21of100,test4pub4of100,1,189,5,3083,59,3147
test4sub50of100,test4pub6of100,1,189,5,2934,58,2997
test4sub86of100,test4pub7of100,1,189,5,2894,59,2958
test4sub42of100,test4pub1of100,1,318,12,3995,97,4104
test4sub82of100,test4pub9of100,1,189,6,2818,98,2922
test4sub15of100,test4pub4of100,1,189,5,3087,97,3189
test4sub59of100,test4pub8of100,1,189,5,2850,97,2952
test4sub16of100,test4pub10of100,1,191,10,2799,96,2905
test4sub7of100,test4pub6of100,1,189,5,2940,96,3041
test4sub97of100,test4pub8of100,1,189,5,2854,96,2955
test4sub85of100,test4pub4of100,1,189,5,3092,97,3194
test4sub1of100,test4pub8of100,1,189,5,2855,96,2956
test4sub90of100,test4pub7of100,1,189,5,2904,96,3005
test4sub68of100,test4pub7of100,1,189,5,2905,96,3006
test4sub79of100,test4pub5of100,1,189,5,2970,96,3071
test4sub29of100,test4pub4of100,1,189,5,3098,96,3199
test4sub57of100,test4pub4of100,1,189,5,3099,95,3199
test4sub38of100,test4pub8of100,1,189,5,2861,95,2961
test4sub43of100,test4pub8of100,1,189,5,2862,95,2962
test4sub78of100,test4pub9of100,1,189,6,2833,95,2934
test4sub36of100,test4pub5of100,1,189,5,2976,95,3076
test4sub40of100,test4pub8of100,1,189,5,2866,96,2967
test4sub100of100,test4pub7of100,1,189,5,2914,95,3014
test4sub26of100,test4pub5of100,1,189,5,2980,95,3080
test4sub83of100,test4pub4of100,1,189,5,3107,95,3207
test4sub58of100,test4pub5of100,1,189,5,2982,94,3081
test4sub64of100,test4pub10of100,1,191,10,2818,94,2922
test4sub33of100,test4pub6of100,1,189,5,2960,94,3059
test4sub47of100,test4pub9of100,1,189,6,2842,94,2942
test4sub27of100,test4pub6of100,1,189,5,2962,94,3061
test4sub72of100,test4pub6of100,1,189,5,2963,94,3062
test4sub65of100,test4pub8of100,1,189,5,2876,93,2974
test4sub99of100,test4pub5of100,1,189,5,2988,94,3087
test4sub39of100,test4pub4of100,1,189,5,3116,94,3215
test4sub8of100,test4pub5of100,1,189,5,2990,94,3089
test4sub56of100,test4pub10of100,1,191,10,2826,93,2929
test4sub67of100,test4pub6of100,1,189,5,2968,95,3068
test4sub96of100,test4pub5of100,1,189,5,2993,93,3091
test4sub12of100,test4pub4of100,1,189,5,3119,94,3218
test4sub77of100,test4pub7of100,1,189,5,2931,94,3030
test4sub30of100,test4pub8of100,1,189,5,2884,93,2982
test4sub87of100,test4pub5of100,1,189,5,2997,93,3095
test4sub81of100,test4pub8of100,1,189,5,2886,93,2984
test4sub52of100,test4pub9of100,1,189,6,2857,93,2956
test4sub20of100,test4pub5of100,1,189,5,3000,92,3097
test4sub62of100,test4pub10of100,1,191,10,2836,93,2939
test4sub51of100,test4pub8of100,1,189,5,2890,92,2987
test4sub88of100,test4pub7of100,1,189,5,2939,92,3036
test4sub25of100,test4pub8of100,1,189,5,2892,92,2989
test4sub31of100,test4pub4of100,1,189,5,3130,92,3227
test4sub93of100,test4pub7of100,1,189,5,2942,91,3038
test4sub28of100,test4pub5of100,1,189,5,3007,91,3103
test4sub4of100,test4pub3of100,1,189,8,3479,92,3579
test4sub18of100,test4pub7of100,1,189,5,2945,91,3041
test4sub22of100,test4pub4of100,1,189,5,3135,93,3233
test4sub35of100,test4pub8of100,1,189,5,2898,91,2994
test4sub6of100,test4pub4of100,1,189,5,3137,95,3237
test4sub73of100,test4pub5of100,1,189,5,3012,93,3110
test4sub3of100,test4pub4of100,1,189,5,3139,95,3239
test4sub70of100,test4pub8of100,1,189,5,2902,93,3000
test4sub84of100,test4pub5of100,1,189,5,3014,94,3113
test4sub61of100,test4pub5of100,1,189,5,3016,94,3115
test4sub21of100,test4pub6of100,1,189,5,2992,94,3091
test4sub50of100,test4pub4of100,1,189,5,3144,94,3243
test4sub86of100,test4pub4of100,1,189,5,3144,95,3244
test4sub32of100,test4pub6of100,1,189,5,3000,88,3093
test4sub19of100,test4pub3of100,1,189,8,3150,436,3594
test4sub42of100,test4pub2of100,1,189,5,3903,57,3965
test4sub82of100,test4pub7of100,1,189,5,2994,58,3057
test4sub15of100,test4pub10of100,1,191,10,2894,57,2961
test4sub59of100,test4pub7of100,1,189,5,2996,58,3059
test4sub16of100,test4pub6of100,1,189,5,3037,57,3099
test4sub7of100,test4pub7of100,1,189,5,2997,57,3059
test4sub97of100,test4pub4of100,1,189,5,3189,57,3251
test4sub1of100,test4pub9of100,1,189,6,2922,55,2983
test4sub90of100,test4pub6of100,1,189,5,3041,57,3103
test4sub68of100,test4pub6of100,1,189,5,3042,55,3102
test4sub93of100,test4pub9of100,1,189,6,2957,39,3002
test4sub31of100,test4pub10of100,1,191,10,2932,41,2983
test4sub25of100,test4pub5of100,1,189,5,3097,42,3144
test4sub51of100,test4pub9of100,1,189,6,2953,44,3003
test4sub88of100,test4pub10of100,1,191,10,2930,44,2984
test4sub62of100,test4pub6of100,1,189,5,3070,47,3122
test4sub20of100,test4pub10of100,1,191,10,2929,48,2987
test4sub81of100,test4pub6of100,1,189,5,3068,50,3123
test4sub87of100,test4pub8of100,1,189,5,2979,52,3036
test4sub12of100,test4pub10of100,1,191,10,2924,54,2988
test4sub96of100,test4pub8of100,1,189,5,2975,56,3036
test4sub52of100,test4pub5of100,1,189,5,3092,49,3146
test4sub67of100,test4pub9of100,1,189,6,2945,56,3007
test4sub56of100,test4pub4of100,1,189,5,3212,59,3276
test4sub99of100,test4pub8of100,1,189,5,2972,61,3038
test4sub65of100,test4pub7of100,1,189,5,3018,63,3086
test4sub77of100,test4pub5of100,1,189,5,3089,54,3148
test4sub72of100,test4pub5of100,1,189,5,3081,66,3152
test4sub30of100,test4pub7of100,1,189,5,3026,52,3083
test4sub27of100,test4pub8of100,1,189,5,2969,67,3041
test4sub33of100,test4pub10of100,1,191,10,2914,69,2993
test4sub64of100,test4pub9of100,1,189,6,2936,71,3013
test4sub47of100,test4pub5of100,1,189,5,3079,69,3153
test4sub83of100,test4pub7of100,1,189,5,3012,74,3091
test4sub26of100,test4pub4of100,1,189,5,3202,74,3281
test4sub100of100,test4pub4of100,1,189,5,3200,76,3281
test4sub14of100,test4pub8of100,1,189,5,2970,64,3039
test4sub40of100,test4pub10of100,1,191,10,2909,77,2996
test4sub39of100,test4pub8of100,1,189,5,2972,61,3038
test4sub78of100,test4pub10of100,1,191,10,2907,80,2997
test4sub8of100,test4pub6of100,1,189,5,3061,59,3125
test4sub43of100,test4pub4of100,1,189,5,3196,82,3283
test4sub36of100,test4pub10of100,1,191,10,2907,79,2996
test4sub57of100,test4pub5of100,1,189,5,3068,85,3158
test4sub58of100,test4pub8of100,1,189,5,2965,72,3042
test4sub29of100,test4pub8of100,1,189,5,2956,87,3048
test4sub79of100,test4pub6of100,1,189,5,3042,89,3136
test4sub38of100,test4pub5of100,1,189,5,3070,84,3159
test4sub28of100,test4pub6of100,1,189,5,3075,43,3123
test4sub4of100,test4pub5of100,1,189,5,3100,60,3165
test4sub18of100,test4pub8of100,1,189,5,2989,60,3054
test4sub22of100,test4pub7of100,1,189,5,3038,60,3103
test4sub35of100,test4pub7of100,1,189,5,3039,60,3104
test4sub73of100,test4pub9of100,1,189,6,2964,57,3027
test4sub6of100,test4pub6of100,1,189,5,3082,58,3145
test4sub3of100,test4pub8of100,1,189,5,2996,57,3058
test4sub70of100,test4pub6of100,1,189,5,3084,57,3146
test4sub61of100,test4pub9of100,1,189,6,2968,57,3031
test4sub84of100,test4pub4of100,1,189,5,3236,57,3298
test4sub21of100,test4pub8of100,1,189,5,3000,57,3062
test4sub50of100,test4pub7of100,1,189,5,3048,58,3111
test4sub2of100,test4pub3of100,1,189,8,2938,703,3649
test4sub86of100,test4pub6of100,1,189,5,3089,58,3152
test4sub32of100,test4pub3of100,1,189,8,3586,58,3652
test4sub19of100,test4pub5of100,1,189,5,3115,57,3177
test4sub42of100,test4pub3of100,1,189,8,3587,58,3653
test4sub82of100,test4pub10of100,1,191,10,2952,58,3020
test4sub15of100,test4pub6of100,1,189,5,3093,57,3155
test4sub16of100,test4pub4of100,1,189,5,3245,58,3308
test4sub7of100,test4pub10of100,1,191,10,2954,58,3022
test4sub97of100,test4pub9of100,1,189,6,2978,57,3041
test4sub1of100,test4pub10of100,1,191,10,2956,58,3024
test4sub68of100,test4pub10of100,1,191,10,2973,41,3024
test4sub93of100,test4pub8of100,1,189,5,3027,41,3073
test4sub31of100,test4pub5of100,1,189,5,3139,43,3187
test4sub25of100,test4pub4of100,1,189,5,3266,42,3313
test4sub88of100,test4pub5of100,1,189,5,3141,42,3188
test4sub51of100,test4pub4of100,1,189,5,3267,42,3314
test4sub62of100,test4pub8of100,1,189,5,3030,45,3080
test4sub81of100,test4pub4of100,1,189,5,3269,44,3318
test4sub87of100,test4pub10of100,1,191,10,2979,44,3033
test4sub96of100,test4pub10of100,1,191,10,2979,45,3034
test4sub52of100,test4pub7of100,1,189,5,3080,45,3130
test4sub67of100,test4pub7of100,1,189,5,3081,45,3131
test4sub99of100,test4pub6of100,1,189,5,3122,46,3173
test4sub56of100,test4pub6of100,1,189,5,3122,46,3173
test4sub12of100,test4pub7of100,1,189,5,3080,45,3130
test4sub27of100,test4pub4of100,1,189,5,3274,45,3324
test4sub20of100,test4pub9of100,1,189,6,3001,46,3053
test4sub33of100,test4pub8of100,1,189,5,3037,45,3087
test4sub47of100,test4pub10of100,1,191,10,2985,46,3041
test4sub26of100,test4pub8of100,1,189,5,3038,46,3089
test4sub72of100,test4pub8of100,1,189,5,3035,48,3088
test4sub40of100,test4pub6of100,1,189,5,3128,47,3180
test4sub39of100,test4pub9of100,1,189,6,3010,47,3063
test4sub78of100,test4pub7of100,1,189,5,3089,48,3142
test4sub43of100,test4pub6of100,1,189,5,3129,48,3182
test4sub100of100,test4pub9of100,1,189,6,3009,49,3064
test4sub83of100,test4pub9of100,1,189,6,3008,48,3062
test4sub57of100,test4pub10of100,1,191,10,2989,50,3049
test4sub58of100,test4pub6of100,1,189,5,3131,51,3187
test4sub29of100,test4pub10of100,1,191,10,2990,50,3050
test4sub64of100,test4pub5of100,1,189,5,3150,52,3207
test4sub90of100,test4pub8of100,1,189,5,3010,52,3067
test4sub79of100,test4pub8of100,1,189,5,3044,52,3101
test4sub38of100,test4pub10of100,1,191,10,2992,53,3055
test4sub30of100,test4pub4of100,1,189,5,3274,54,3333
test4sub77of100,test4pub9of100,1,189,6,3005,53,3064
test4sub36of100,test4pub9of100,1,189,6,3011,55,3072
test4sub65of100,test4pub9of100,1,189,6,3005,55,3066
test4sub14of100,test4pub7of100,1,189,5,3088,55,3148
test4sub8of100,test4pub7of100,1,189,5,3089,57,3151
test4sub28of100,test4pub4of100,1,189,5,3286,55,3346
test4sub4of100,test4pub8of100,1,189,5,3049,54,3108
test4sub18of100,test4pub9of100,1,189,6,3020,56,3082
test4sub22of100,test4pub10of100,1,191,10,2998,57,3065
test4sub35of100,test4pub4of100,1,189,5,3289,57,3351
test4sub73of100,test4pub4of100,1,189,5,3291,58,3354
test4sub6of100,test4pub8of100,1,189,5,3053,58,3116
test4sub3of100,test4pub5of100,1,189,5,3166,57,3228
test4sub70of100,test4pub7of100,1,189,5,3103,59,3167
test4sub61of100,test4pub10of100,1,191,10,3003,58,3071
test4sub84of100,test4pub8of100,1,189,5,3056,59,3120
test4sub21of100,test4pub7of100,1,189,5,3106,58,3169
test4sub2of100,test4pub5of100,1,189,5,3171,58,3234
test4sub86of100,test4pub8of100,1,189,5,3060,57,3122
test4sub32of100,test4pub5of100,1,189,5,3172,58,3235
test4sub19of100,test4pub8of100,1,189,5,3062,57,3124
test4sub42of100,test4pub5of100,1,189,5,3174,58,3237
test4sub82of100,test4pub5of100,1,189,5,3175,57,3237
test4sub15of100,test4pub8of100,1,189,5,3064,58,3127
test4sub16of100,test4pub5of100,1,189,5,3177,57,3239
test4sub7of100,test4pub8of100,1,189,5,3065,58,3128
test4sub97of100,test4pub6of100,1,189,5,3155,57,3217
test4sub1of100,test4pub4of100,1,189,5,3305,59,3369
test4sub68of100,test4pub5of100,1,189,5,3180,57,3242
test4sub93of100,test4pub10of100,1,191,10,3016,58,3084
test4sub31of100,test4pub9of100,1,189,6,3040,57,3103
test4sub25of100,test4pub6of100,1,189,5,3158,58,3221
test4sub88of100,test4pub4of100,1,189,5,3309,57,3371
test4sub51of100,test4pub10of100,1,191,10,3019,58,3087
test4sub62of100,test4pub4of100,1,189,5,3313,55,3373
test4sub81of100,test4pub10of100,1,191,10,3022,56,3088
test4sub87of100,test4pub4of100,1,189,5,3315,55,3375
test4sub96of100,test4pub9of100,1,189,6,3047,56,3109
test4sub52of100,test4pub6of100,1,189,5,3167,55,3227
test4sub67of100,test4pub8of100,1,189,5,3079,56,3140
test4sub99of100,test4pub10of100,1,191,10,3027,54,3091
test4sub56of100,test4pub8of100,1,189,5,3080,56,3141
test4sub27of100,test4pub10of100,1,191,10,3029,55,3094
test4sub12of100,test4pub5of100,1,189,5,3194,57,3256
test4sub20of100,test4pub7of100,1,189,5,3131,55,3191
test4sub33of100,test4pub4of100,1,189,5,3322,56,3383
test4sub26of100,test4pub6of100,1,189,5,3173,54,3232
test4sub47of100,test4pub8of100,1,189,5,3085,56,3146
test4sub72of100,test4pub4of100,1,189,5,3325,54,3384
test4sub40of100,test4pub9of100,1,189,6,3057,55,3118
test4sub39of100,test4pub7of100,1,189,5,3137,54,3196
test4sub78of100,test4pub4of100,1,189,5,3327,55,3387
test4sub100of100,test4pub8of100,1,189,5,3091,53,3149
test4sub83of100,test4pub8of100,1,189,5,3091,55,3151
test4sub54of100,test4pub4of100,1,189,5,3330,54,3389
test4sub57of100,test4pub7of100,1,189,5,3141,55,3201
test4sub58of100,test4pub4of100,1,189,5,3332,53,3390
test4sub29of100,test4pub6of100,1,189,5,3183,55,3243
test4sub64of100,test4pub6of100,1,189,5,3184,53,3242
test4sub90of100,test4pub9of100,1,189,6,3066,54,3126
test4sub79of100,test4pub10of100,1,191,10,3045,53,3108
test4sub38of100,test4pub4of100,1,189,5,3336,55,3396
test4sub30of100,test4pub10of100,1,191,10,3046,53,3109
test4sub77of100,test4pub8of100,1,189,5,3100,55,3160
test4sub65of100,test4pub10of100,1,191,10,3048,53,3111
test4sub14of100,test4pub5of100,1,189,5,3214,54,3273
test4sub28of100,test4pub10of100,1,191,10,3050,52,3112
test4sub43of100,test4pub7of100,1,189,5,3152,54,3211
test4sub8of100,test4pub10of100,1,191,10,3050,53,3113
test4sub4of100,test4pub6of100,1,189,5,3193,55,3253
test4sub18of100,test4pub10of100,1,191,10,3053,53,3116
test4sub11of100,test4pub8of100,1,189,5,3106,53,3164
test4sub36of100,test4pub6of100,1,189,5,3196,53,3254
test4sub22of100,test4pub6of100,1,189,5,3197,52,3254
test4sub35of100,test4pub5of100,1,189,5,3222,54,3281
test4sub73of100,test4pub8of100,1,189,5,3111,53,3169
test4sub6of100,test4pub7of100,1,189,5,3159,53,3217
test4sub85of100,test4pub5of100,1,189,5,3225,53,3283
test4sub3of100,test4pub9of100,1,189,6,3082,53,3141
test4sub70of100,test4pub10of100,1,191,10,3061,52,3123
test4sub61of100,test4pub8of100,1,189,5,3115,53,3173
test4sub84of100,test4pub9of100,1,189,6,3086,53,3145
test4sub21of100,test4pub5of100,1,189,5,3228,52,3285
test4sub2of100,test4pub6of100,1,189,5,3206,53,3264
test4sub86of100,test4pub9of100,1,189,6,3088,53,3147
test4sub32of100,test4pub7of100,1,189,5,3167,52,3224
test4sub19of100,test4pub7of100,1,189,5,3167,52,3224
test4sub42of100,test4pub4of100,1,189,5,3359,51,3415
test4sub82of100,test4pub8of100,1,189,5,3121,52,3178
test4sub15of100,test4pub7of100,1,189,5,3171,51,3227
test4sub16of100,test4pub9of100,1,189,6,3093,52,3151
test4sub7of100,test4pub9of100,1,189,6,3094,51,3151
test4sub97of100,test4pub5of100,1,189,5,3236,51,3292
test4sub1of100,test4pub7of100,1,189,5,3174,51,3230
test4sub68of100,test4pub8of100,1,189,5,3126,52,3183
test4sub93of100,test4pub11of100,1,190,5,546,50,601
test4sub31of100,test4pub11of100,1,190,5,547,51,603
test4sub25of100,test4pub11of100,1,190,5,548,49,602
test4sub88of100,test4pub11of100,1,190,5,548,50,603
test4sub51of100,test4pub11of100,1,190,5,550,49,604
test4sub62of100,test4pub7of100,1,189,5,3179,49,3233
test4sub81of100,test4pub9of100,1,189,6,3102,47,3155
test4sub87of100,test4pub7of100,1,189,5,3181,49,3235
test4sub96of100,test4pub4of100,1,189,5,3372,48,3425
test4sub52of100,test4pub8of100,1,189,5,3134,48,3187
test4sub67of100,test4pub5of100,1,189,5,3247,48,3300
test4sub99of100,test4pub9of100,1,189,6,3106,49,3161
test4sub56of100,test4pub9of100,1,189,6,3107,48,3161
test4sub27of100,test4pub5of100,1,189,5,3250,48,3303
test4sub12of100,test4pub9of100,1,189,6,3109,49,3164
test4sub20of100,test4pub8of100,1,189,5,3139,48,3192
test4sub33of100,test4pub9of100,1,189,6,3110,48,3164
test4sub26of100,test4pub7of100,1,189,5,3189,50,3244
test4sub47of100,test4pub6of100,1,189,5,3230,48,3283
test4sub72of100,test4pub7of100,1,189,5,3190,49,3244
test4sub40of100,test4pub5of100,1,189,5,3256,48,3309
test4sub39of100,test4pub10of100,1,191,10,3091,50,3151
test4sub78of100,test4pub6of100,1,189,5,3233,49,3287
test4sub100of100,test4pub6of100,1,189,5,3234,50,3289
test4sub83of100,test4pub10of100,1,191,10,3094,49,3153
test4sub54of100,test4pub10of100,1,191,10,3094,49,3153
test4sub57of100,test4pub9of100,1,189,6,3119,49,3174
test4sub58of100,test4pub10of100,1,191,10,3096,50,3156
test4sub29of100,test4pub9of100,1,189,6,3120,48,3174
test4sub90of100,test4pub10of100,1,191,10,3098,48,3156
test4sub79of100,test4pub9of100,1,189,6,3122,50,3178
test4sub38of100,test4pub7of100,1,189,5,3201,48,3254
test4sub30of100,test4pub5of100,1,189,5,3266,49,3320
test4sub77of100,test4pub10of100,1,191,10,3102,47,3159
test4sub65of100,test4pub5of100,1,189,5,3267,49,3321
test4sub14of100,test4pub10of100,1,191,10,3104,48,3162
test4sub28of100,test4pub9of100,1,189,6,3127,49,3182
test4sub43of100,test4pub9of100,1,189,6,3128,49,3183
test4sub8of100,test4pub4of100,1,189,5,3397,49,3451
test4sub18of100,test4pub11of100,1,190,5,579,48,632
test4sub11of100,test4pub7of100,1,189,5,3209,48,3262
test4sub36of100,test4pub8of100,1,189,5,3162,47,3214
test4sub22of100,test4pub5of100,1,189,5,3275,48,3328
test4sub35of100,test4pub11of100,1,190,5,583,47,635
test4sub73of100,test4pub6of100,1,189,5,3252,47,3304
test4sub66of100,test4pub2of100,1,189,5,521,3647,4173
test4sub85of100,test4pub7of100,1,189,5,3214,48,3267
test4sub3of100,test4pub6of100,1,189,5,3254,47,3306
test4sub61of100,test4pub11of100,1,190,5,587,56,648
test4sub70of100,test4pub11of100,1,190,5,587,57,649
test4sub21of100,test4pub11of100,1,190,5,589,55,649
test4sub84of100,test4pub11of100,1,190,5,588,56,649
test4sub2of100,test4pub8of100,1,189,5,3171,54,3230
test4sub19of100,test4pub4of100,1,189,5,3410,53,3468
test4sub42of100,test4pub10of100,1,191,10,3120,55,3185
test4sub82of100,test4pub11of100,1,190,5,593,53,651
test4sub15of100,test4pub11of100,1,190,5,593,54,652
test4sub16of100,test4pub11of100,1,190,5,595,53,653
test4sub97of100,test4pub11of100,1,190,5,596,53,654
test4sub68of100,test4pub11of100,1,190,5,597,51,653
test4sub62of100,test4pub9of100,1,189,6,3150,49,3205
test4sub81of100,test4pub11of100,1,190,5,600,49,654
test4sub87of100,test4pub9of100,1,189,6,3152,48,3206
test4sub96of100,test4pub11of100,1,190,5,601,49,655
test4sub52of100,test4pub11of100,1,190,5,603,49,657
test4sub67of100,test4pub11of100,1,190,5,603,49,657
test4sub56of100,test4pub11of100,1,190,5,605,47,657
test4sub27of100,test4pub11of100,1,190,5,605,47,657
test4sub12of100,test4pub11of100,1,190,5,607,45,657
test4sub20of100,test4pub4of100,1,189,5,3426,45,3476
test4sub33of100,test4pub11of100,1,190,5,609,45,659
test4sub72of100,test4pub11of100,1,190,5,611,42,658
test4sub40of100,test4pub11of100,1,190,5,612,41,658
test4sub39of100,test4pub11of100,1,190,5,614,40,659
test4sub78of100,test4pub11of100,1,190,5,614,41,660
test4sub100of100,test4pub11of100,1,190,5,616,39,660
test4sub54of100,test4pub9of100,1,189,6,3168,38,3212
test4sub58of100,test4pub11of100,1,190,5,618,37,660
test4sub4of100,test4pub7of100,1,189,5,3248,36,3289
test4sub90of100,test4pub5of100,1,189,5,3312,36,3353
test4sub30of100,test4pub11of100,1,190,5,622,34,661
test4sub77of100,test4pub11of100,1,190,5,622,35,662
test4sub65of100,test4pub11of100,1,190,5,624,33,662
test4sub32of100,test4pub8of100,1,189,5,3206,32,3243
test4sub28of100,test4pub8of100,1,189,5,3207,32,3244
test4sub8of100,test4pub11of100,1,190,5,627,32,664
test4sub11of100,test4pub10of100,1,191,10,3156,31,3197
test4sub36of100,test4pub11of100,1,190,5,629,32,666
test4sub22of100,test4pub11of100,1,190,5,630,30,665
test4sub73of100,test4pub11of100,1,190,5,631,30,666
test4sub66of100,test4pub3of100,1,189,8,3797,30,3835
test4sub85of100,test4pub6of100,1,189,5,3302,30,3337
test4sub3of100,test4pub7of100,1,189,5,3263,30,3298
test4sub2of100,test4pub7of100,1,189,5,3274,20,3299
test4sub19of100,test4pub6of100,1,189,5,3315,20,3340
test4sub42of100,test4pub9of100,1,189,6,3198,19,3223
test4sub62of100,test4pub5of100,1,189,5,3342,17,3364
test4sub87of100,test4pub11of100,1,190,5,650,18,673
test4sub4of100,test4pub11of100,1,190,5,656,12,673
test4sub32of100,test4pub9of100,1,189,6,3209,11,3226
test4sub28of100,test4pub11of100,1,190,5,659,11,675
test4sub11of100,test4pub9of100,1,189,6,3212,9,3227
test4sub83of100,test4pub11of100,1,190,5,663,9,677
test4sub66of100,test4pub8of100,1,189,5,3244,9,3258
test4sub85of100,test4pub8of100,1,189,5,3245,8,3258
test4sub3of100,test4pub10of100,1,191,10,3193,9,3212
test4sub2of100,test4pub4of100,1,189,5,3485,8,3498
test4sub19of100,test4pub10of100,1,191,10,3194,11,3215
test4sub42of100,test4pub6of100,1,189,5,3336,9,3350
test4sub62of100,test4pub11of100,1,190,5,668,11,684
test4sub32of100,test4pub11of100,1,190,5,670,9,684
test4sub11of100,test4pub11of100,1,190,5,671,8,684
test4sub66of100,test4pub7of100,1,189,5,3302,7,3314
test4sub85of100,test4pub11of100,1,190,5,673,7,685
test4sub3of100,test4pub11of100,1,190,5,674,5,684
test4sub2of100,test4pub10of100,1,191,10,3203,6,3219
test4sub64of100,test4pub4of100,1,189,5,3495,5,3505
test4sub19of100,test4pub9of100,1,189,6,3228,5,3239
test4sub42of100,test4pub8of100,1,189,5,3259,5,3269
test4sub66of100,test4pub10of100,1,191,10,3208,3,3221
test4sub2of100,test4pub9of100,1,189,6,3232,3,3241
test4sub64of100,test4pub11of100,1,190,5,682,4,691
test4sub19of100,test4pub11of100,1,190,5,683,2,690
test4sub42of100,test4pub7of100,1,189,5,3312,3,3320
test4sub2of100,test4pub11of100,1,190,5,685,2,692
test4sub66of100,test4pub6of100,1,189,5,3354,3,3362
test4sub42of100,test4pub11of100,1,190,5,687,0,692
test4sub66of100,test4pub4of100,1,189,5,3507,0,3512
test4sub66of100,test4pub9of100,1,189,6,3241,1,3248
test4sub66of100,test4pub5of100,1,189,5,3384,1,3390
test4sub66of100,test4pub11of100,1,190,5,692,0,697
test4sub96of100,test4pub12of100,1,190,5,96,1,102
test4sub21of100,test4pub12of100,1,190,5,108,1,114
test4sub69of100,test4pub5of100,1,189,5,3421,1,3427
test4sub69of100,test4pub10of100,1,191,10,3258,1,3269
test4sub69of100,test4pub8of100,1,189,5,3314,1,3320
test4sub14of100,test4pub9of100,1,189,6,3286,1,3293
test4sub69of100,test4pub6of100,1,189,5,3403,1,3409
test4sub69of100,test4pub9of100,1,189,6,3287,1,3294
test4sub14of100,test4pub4of100,1,189,5,3555,1,3561
test4sub14of100,test4pub11of100,1,190,5,738,0,743
test4sub61of100,test4pub12of100,1,190,5,141,1,147
test4sub67of100,test4pub12of100,1,190,5,142,1,148
test4sub72of100,test4pub12of100,1,190,5,157,0,162
test4sub27of100,test4pub12of100,1,190,5,203,1,209
test4sub51of100,test4pub12of100,1,190,5,223,1,229
test4sub33of100,test4pub12of100,1,190,5,232,1,238
test4sub19of100,test4pub12of100,1,190,5,239,1,245
test4sub97of100,test4pub12of100,1,190,5,240,0,245
test4sub73of100,test4pub12of100,1,190,5,275,1,281
test4sub56of100,test4pub12of100,1,190,5,297,1,303
test4sub47of100,test4pub11of100,1,190,5,919,1,925
test4sub43of100,test4pub11of100,1,190,5,921,1,927
test4sub43of100,test4pub12of100,1,190,5,317,0,322
test4sub11of100,test4pub12of100,1,190,5,326,0,331
test4sub36of100,test4pub12of100,1,190,5,333,1,339
test4sub31of100,test4pub12of100,1,190,5,334,1,340
test4sub28of100,test4pub12of100,1,190,5,335,0,340
test4sub57of100,test4pub11of100,1,190,5,943,0,948
test4sub76of100,test4pub4of100,1,189,5,3763,1,3769
test4sub57of100,test4pub12of100,1,190,5,340,1,346
test4sub76of100,test4pub10of100,1,191,10,3474,0,3484
test4sub76of100,test4pub6of100,1,189,5,3617,0,3622
test4sub18of100,test4pub12of100,1,190,5,344,2,351
test4sub30of100,test4pub12of100,1,190,5,345,1,351
test4sub76of100,test4pub8of100,1,189,5,3531,1,3537
test4sub76of100,test4pub7of100,1,189,5,3582,1,3588
test4sub35of100,test4pub12of100,1,190,5,360,1,366
test4sub17of100,test4pub2of100,1,189,5,1522,3008,4535
test4sub17of100,test4pub3of100,1,189,8,4158,1,4167
test4sub17of100,test4pub5of100,1,189,5,3687,0,3692
test4sub17of100,test4pub10of100,1,191,10,3524,1,3535
test4sub17of100,test4pub6of100,1,189,5,3666,1,3672
test4sub17of100,test4pub8of100,1,189,5,3579,0,3584
test4sub17of100,test4pub7of100,1,189,5,3629,1,3635
test4sub17of100,test4pub9of100,1,189,6,3552,1,3559
test4sub17of100,test4pub4of100,1,189,5,3821,0,3826
test4sub17of100,test4pub11of100,1,190,5,1004,1,1010
test4sub17of100,test4pub12of100,1,190,5,400,0,405
test4sub68of100,test4pub12of100,1,190,5,400,1,406
test4sub39of100,test4pub12of100,1,190,5,404,0,409
test4sub60of100,test4pub2of100,1,189,5,1566,3003,4574
test4sub60of100,test4pub3of100,1,189,8,4198,1,4207
test4sub60of100,test4pub4of100,1,189,5,3853,0,3858
test4sub60of100,test4pub5of100,1,189,5,3729,1,3735
test4sub60of100,test4pub8of100,1,189,5,3618,0,3623
test4sub60of100,test4pub10of100,1,191,10,3567,1,3578
test4sub92of100,test4pub1of100,1,318,12,1765,3043,4820
test4sub60of100,test4pub6of100,1,189,5,3709,41,3755
test4sub95of100,test4pub8of100,1,189,5,3627,36,3668
test4sub3of100,test4pub12of100,1,190,5,457,20,482
test4sub32of100,test4pub12of100,1,190,5,462,16,483
test4sub89of100,test4pub1of100,1,318,12,1805,3043,4860
test4sub92of100,test4pub3of100,1,189,8,4246,40,4294
test4sub60of100,test4pub7of100,1,189,5,3710,41,3756
test4sub95of100,test4pub7of100,1,189,5,3711,41,3757
test4sub78of100,test4pub12of100,1,190,5,480,39,524
test4sub64of100,test4pub12of100,1,190,5,481,38,524
test4sub49of100,test4pub3of100,1,189,8,3098,1193,4299
test4sub69of100,test4pub11of100,1,190,5,1104,22,1131
test4sub8of100,test4pub12of100,1,190,5,501,21,527
test4sub25of100,test4pub12of100,1,190,5,501,21,527
test4sub5of100,test4pub3of100,1,189,8,4276,17,4301
test4sub42of100,test4pub12of100,1,190,5,508,17,530
test4sub82of100,test4pub12of100,1,190,5,509,15,529
test4sub6of100,test4pub11of100,1,190,5,1117,13,1135
test4sub7of100,test4pub11of100,1,190,5,1118,12,1135
test4sub89of100,test4pub6of100,1,189,5,3790,10,3805
test4sub92of100,test4pub4of100,1,189,5,3940,11,3956
test4sub22of100,test4pub12of100,1,190,5,517,10,532
test4sub60of100,test4pub9of100,1,189,6,3674,10,3690
test4sub95of100,test4pub10of100,1,191,10,3652,11,3673
test4sub49of100,test4pub5of100,1,189,5,3819,11,3835
test4sub69of100,test4pub12of100,1,190,5,521,11,537
test4sub14of100,test4pub12of100,1,190,5,523,10,538
test4sub5of100,test4pub6of100,1,189,5,3798,11,3814
test4sub6of100,test4pub12of100,1,190,5,526,9,540
test4sub89of100,test4pub3of100,1,189,8,4297,9,4314
test4sub92of100,test4pub8of100,1,189,5,3714,9,3728
test4sub77of100,test4pub12of100,1,190,5,529,9,543
test4sub83of100,test4pub12of100,1,190,5,530,9,544
test4sub95of100,test4pub6of100,1,189,5,3804,9,3818
test4sub65of100,test4pub12of100,1,190,5,531,9,545
test4sub87of100,test4pub12of100,1,190,5,532,8,545
test4sub80of100,test4pub4of100,1,189,5,3956,8,3969
test4sub60of100,test4pub11of100,1,190,5,1134,10,1149
test4sub49of100,test4pub10of100,1,191,10,3666,9,3685
test4sub5of100,test4pub5of100,1,189,5,3833,7,3845
test4sub15of100,test4pub12of100,1,190,5,536,10,551
test4sub89of100,test4pub4of100,1,189,5,3960,11,3976
test4sub70of100,test4pub12of100,1,190,5,537,10,552
test4sub92of100,test4pub5of100,1,189,5,3836,11,3852
test4sub95of100,test4pub9of100,1,189,6,3696,10,3712
test4sub80of100,test4pub10of100,1,191,10,3675,9,3694
test4sub60of100,test4pub12of100,1,190,5,542,9,556
test4sub5of100,test4pub4of100,1,189,5,3968,8,3981
test4sub16of100,test4pub12of100,1,190,5,544,7,556
test4sub88of100,test4pub12of100,1,190,5,545,8,558
test4sub58of100,test4pub12of100,1,190,5,545,7,557
test4sub47of100,test4pub12of100,1,190,5,546,8,559
test4sub49of100,test4pub8of100,1,189,5,3730,7,3742
test4sub66of100,test4pub12of100,1,190,5,547,8,560
test4sub89of100,test4pub9of100,1,189,6,3705,7,3718
test4sub92of100,test4pub6of100,1,189,5,3823,6,3834
test4sub80of100,test4pub6of100,1,189,5,3825,6,3836
test4sub5of100,test4pub10of100,1,191,10,3685,5,3700
test4sub90of100,test4pub11of100,1,190,5,1159,4,1168
test4sub49of100,test4pub9of100,1,189,6,3711,5,3722
test4sub89of100,test4pub10of100,1,191,10,3689,4,3703
test4sub92of100,test4pub10of100,1,191,10,3690,6,3706
test4sub80of100,test4pub9of100,1,189,6,3714,4,3724
test4sub40of100,test4pub12of100,1,190,5,559,6,570
test4sub90of100,test4pub12of100,1,190,5,560,5,570
test4sub49of100,test4pub6of100,1,189,5,3834,4,3843
test4sub95of100,test4pub11of100,1,190,5,1166,4,1175
test4sub89of100,test4pub8of100,1,189,5,3748,5,3758
test4sub63of100,test4pub1of100,1,318,12,1892,3047,4951
test4sub92of100,test4pub7of100,1,189,5,3797,44,3846
test4sub80of100,test4pub8of100,1,189,5,3750,45,3800
test4sub95of100,test4pub12of100,1,190,5,566,43,614
test4sub49of100,test4pub4of100,1,189,5,3990,44,4039
test4sub89of100,test4pub7of100,1,189,5,3801,43,3849
test4sub63of100,test4pub2of100,1,189,5,4751,4,4760
test4sub92of100,test4pub9of100,1,189,6,3764,5,3775
test4sub49of100,test4pub7of100,1,189,5,3844,3,3852
test4sub80of100,test4pub7of100,1,189,5,3843,3,3851
test4sub89of100,test4pub5of100,1,189,5,3910,3,3918
test4sub63of100,test4pub3of100,1,189,8,4382,4,4394
test4sub92of100,test4pub11of100,1,190,5,1218,3,1226
test4sub49of100,test4pub11of100,1,190,5,1219,3,1227
test4sub89of100,test4pub11of100,1,190,5,1221,2,1228
test4sub63of100,test4pub10of100,1,191,10,3749,2,3761
test4sub92of100,test4pub12of100,1,190,5,618,3,626
test4sub49of100,test4pub12of100,1,190,5,618,2,625
test4sub63of100,test4pub9of100,1,189,6,3776,2,3784
test4sub89of100,test4pub12of100,1,190,5,619,2,626
test4sub63of100,test4pub6of100,1,189,5,3896,0,3901
test4sub63of100,test4pub4of100,1,189,5,4048,1,4054
test4sub29of100,test4pub11of100,1,190,5,1229,1,1235
test4sub63of100,test4pub7of100,1,189,5,3859,1,3865
test4sub29of100,test4pub12of100,1,190,5,626,1,632
test4sub37of100,test4pub2of100,1,189,5,1764,3006,4775
test4sub63of100,test4pub8of100,1,189,5,3813,1,3819
test4sub37of100,test4pub3of100,1,189,8,4399,1,4408
test4sub63of100,test4pub5of100,1,189,5,3927,1,3933
test4sub37of100,test4pub4of100,1,189,5,4054,1,4060
test4sub63of100,test4pub11of100,1,190,5,1235,1,1241
test4sub63of100,test4pub12of100,1,190,5,632,0,637
test4sub37of100,test4pub6of100,1,189,5,3906,1,3912
test4sub37of100,test4pub8of100,1,189,5,3820,0,3825
test4sub10of100,test4pub1of100,1,318,12,1961,3047,5020
test4sub37of100,test4pub9of100,1,189,6,3792,40,3838
test4sub84of100,test4pub12of100,1,190,5,643,34,682
test4sub5of100,test4pub8of100,1,189,5,3846,17,3868
test4sub7of100,test4pub12of100,1,190,5,665,12,682
test4sub10of100,test4pub2of100,1,189,5,4819,2,4826
test4sub37of100,test4pub5of100,1,189,5,3974,2,3981
test4sub5of100,test4pub7of100,1,189,5,3912,2,3919
test4sub10of100,test4pub3of100,1,189,8,4449,0,4457
test4sub37of100,test4pub10of100,1,191,10,3812,2,3824
test4sub5of100,test4pub9of100,1,189,6,3836,1,3843
test4sub10of100,test4pub4of100,1,189,5,4105,3,4113
test4sub37of100,test4pub7of100,1,189,5,3916,1,3922
test4sub23of100,test4pub2of100,1,189,5,1823,3004,4832
test4sub5of100,test4pub11of100,1,190,5,1287,2,1294
test4sub10of100,test4pub8of100,1,189,5,3870,2,3877
test4sub37of100,test4pub11of100,1,190,5,1289,2,1296
test4sub23of100,test4pub1of100,1,318,12,5018,41,5071
test4sub5of100,test4pub12of100,1,190,5,686,43,734
test4sub37of100,test4pub12of100,1,190,5,687,34,726
test4sub20of100,test4pub11of100,1,190,5,1293,35,1333
test4sub10of100,test4pub7of100,1,189,5,3921,35,3961
test4sub13of100,test4pub2of100,1,189,5,1853,3021,4879
test4sub99of100,test4pub11of100,1,190,5,1320,16,1341
test4sub80of100,test4pub11of100,1,190,5,1332,6,1343
test4sub23of100,test4pub3of100,1,189,8,4498,5,4511
test4sub20of100,test4pub12of100,1,190,5,730,5,740
test4sub10of100,test4pub5of100,1,189,5,4028,4,4037
test4sub13of100,test4pub3of100,1,189,8,4502,4,4514
test4sub99of100,test4pub12of100,1,190,5,732,5,742
test4sub80of100,test4pub12of100,1,190,5,733,3,741
test4sub23of100,test4pub4of100,1,189,5,4158,4,4167
test4sub10of100,test4pub6of100,1,189,5,4009,2,4016
test4sub13of100,test4pub7of100,1,189,5,3971,2,3978
test4sub23of100,test4pub10of100,1,191,10,3871,1,3882
test4sub10of100,test4pub10of100,1,191,10,3872,2,3884
test4sub13of100,test4pub6of100,1,189,5,4014,2,4021
test4sub23of100,test4pub6of100,1,189,5,4014,2,4021
test4sub10of100,test4pub9of100,1,189,6,3897,1,3904
test4sub13of100,test4pub10of100,1,191,10,3875,2,3887
test4sub23of100,test4pub8of100,1,189,5,3929,1,3935
test4sub13of100,test4pub4of100,1,189,5,4168,1,4174
test4sub23of100,test4pub7of100,1,189,5,3979,1,3985
test4sub10of100,test4pub11of100,1,190,5,1349,2,1356
test4sub13of100,test4pub5of100,1,189,5,4045,1,4051
test4sub23of100,test4pub5of100,1,189,5,4045,1,4051
test4sub13of100,test4pub8of100,1,189,5,3934,0,3939
test4sub23of100,test4pub9of100,1,189,6,3905,0,3911
test4sub13of100,test4pub9of100,1,189,6,3906,1,3913
test4sub23of100,test4pub11of100,1,190,5,1356,1,1362
test4sub13of100,test4pub11of100,1,190,5,1356,1,1362
test4sub23of100,test4pub12of100,1,190,5,752,0,757
test4sub98of100,test4pub2of100,1,189,5,1890,3008,4903
test4sub98of100,test4pub3of100,1,189,8,4526,1,4535
test4sub98of100,test4pub7of100,1,189,5,3991,0,3996
test4sub17of100,test4pub13of100,1,190,5,20,0,25
test4sub94of100,test4pub1of100,1,318,12,2108,3044,5164
test4sub26of100,test4pub11of100,1,190,5,1389,36,1430
test4sub73of100,test4pub13of100,1,190,5,45,26,76
test4sub74of100,test4pub2of100,1,189,5,1946,3018,4969
test4sub94of100,test4pub4of100,1,189,5,4244,2,4251
test4sub26of100,test4pub12of100,1,190,5,820,3,828
test4sub74of100,test4pub3of100,1,189,8,4592,1,4601
test4sub94of100,test4pub9of100,1,189,6,3978,1,3985
test4sub74of100,test4pub10of100,1,191,10,3957,1,3968
test4sub94of100,test4pub3of100,1,189,8,4594,1,4603
test4sub94of100,test4pub6of100,1,189,5,4100,1,4106
test4sub74of100,test4pub9of100,1,189,6,3981,1,3988
test4sub74of100,test4pub6of100,1,189,5,4101,1,4107
test4sub94of100,test4pub5of100,1,189,5,4125,2,4132
test4sub79of100,test4pub11of100,1,190,5,1433,2,1440
test4sub94of100,test4pub8of100,1,189,5,4016,1,4022
test4sub74of100,test4pub5of100,1,189,5,4128,3,4136
test4sub79of100,test4pub12of100,1,190,5,831,1,837
test4sub94of100,test4pub7of100,1,189,5,4066,2,4073
test4sub74of100,test4pub4of100,1,189,5,4257,0,4262
test4sub46of100,test4pub1of100,1,318,12,2160,3047,5219
test4sub74of100,test4pub8of100,1,189,5,4021,41,4067
test4sub41of100,test4pub10of100,1,191,10,3970,39,4019
test4sub30of100,test4pub13of100,1,190,5,88,39,132
test4sub46of100,test4pub3of100,1,189,8,4646,2,4656
test4sub74of100,test4pub7of100,1,189,5,4110,2,4117
test4sub41of100,test4pub5of100,1,189,5,4175,2,4182
test4sub46of100,test4pub4of100,1,189,5,4302,1,4308
test4sub74of100,test4pub11of100,1,190,5,1485,2,1492
test4sub46of100,test4pub6of100,1,189,5,4154,1,4160
test4sub74of100,test4pub12of100,1,190,5,882,0,887
test4sub46of100,test4pub9of100,1,189,6,4038,1,4045
test4sub23of100,test4pub13of100,1,190,5,135,1,141
test4sub46of100,test4pub7of100,1,189,5,4118,1,4124
test4sub46of100,test4pub8of100,1,189,5,4072,1,4078
test4sub46of100,test4pub5of100,1,189,5,4185,0,4190
test4sub46of100,test4pub10of100,1,191,10,4022,1,4033
test4sub46of100,test4pub11of100,1,190,5,1495,1,1501
test4sub46of100,test4pub12of100,1,190,5,891,0,896
test4sub93of100,test4pub12of100,1,190,5,892,0,897
test4sub70of100,test4pub13of100,1,190,5,155,1,161
test4sub51of100,test4pub13of100,1,190,5,156,0,161
test4sub49of100,test4pub13of100,1,190,5,180,1,186
test4sub63of100,test4pub13of100,1,190,5,182,1,188
test4sub69of100,test4pub13of100,1,190,5,218,1,224
test4sub66of100,test4pub13of100,1,190,5,233,4,242
test4sub32of100,test4pub13of100,1,190,5,234,4,243
test4sub53of100,test4pub1of100,1,318,12,2369,3046,5427
test4sub64of100,test4pub13of100,1,190,5,293,41,339
test4sub92of100,test4pub13of100,1,190,5,294,41,340
test4sub60of100,test4pub13of100,1,190,5,295,42,342
test4sub84of100,test4pub13of100,1,190,5,297,40,342
test4sub19of100,test4pub13of100,1,190,5,324,13,342
test4sub3of100,test4pub13of100,1,190,5,333,5,343
test4sub53of100,test4pub3of100,1,189,8,4854,3,4865
test4sub21of100,test4pub13of100,1,190,5,336,3,344
test4sub7of100,test4pub13of100,1,190,5,336,3,344
test4sub53of100,test4pub9of100,1,189,6,4244,1,4251
test4sub53of100,test4pub8of100,1,189,5,4275,0,4280
test4sub53of100,test4pub6of100,1,189,5,4365,1,4371
test4sub53of100,test4pub4of100,1,189,5,4516,0,4521
test4sub53of100,test4pub7of100,1,189,5,4327,0,4332
test4sub42of100,test4pub13of100,1,190,5,380,1,386
test4sub99of100,test4pub13of100,1,190,5,397,0,402
test4sub86of100,test4pub11of100,1,190,5,1755,0,1760
test4sub86of100,test4pub12of100,1,190,5,1151,0,1156
test4sub25of100,test4pub13of100,1,190,5,408,2,415
test4sub80of100,test4pub13of100,1,190,5,408,3,416
test4sub26of100,test4pub13of100,1,190,5,409,2,416
test4sub52of100,test4pub12of100,1,190,5,1159,2,1166
test4sub37of100,test4pub13of100,1,190,5,411,2,418
test4sub52of100,test4pub13of100,1,190,5,413,1,419
test4sub95of100,test4pub13of100,1,190,5,415,1,421
test4sub2of100,test4pub12of100,1,190,5,1169,1,1175
test4sub68of100,test4pub13of100,1,190,5,420,0,425
test4sub41of100,test4pub4of100,1,189,5,4606,0,4611
test4sub41of100,test4pub6of100,1,189,5,4458,1,4464
test4sub41of100,test4pub8of100,1,189,5,4371,0,4376
test4sub41of100,test4pub7of100,1,189,5,4421,1,4427
test4sub41of100,test4pub11of100,1,190,5,1793,0,1798
test4sub41of100,test4pub12of100,1,190,5,1189,0,1194
test4sub65of100,test4pub13of100,1,190,5,464,0,469
test4sub87of100,test4pub13of100,1,190,5,466,1,472
test4sub61of100,test4pub13of100,1,190,5,466,1,472
test4sub79of100,test4pub14of100,1,190,5,17,1,23
test4sub89of100,test4pub13of100,1,190,5,487,1,493
test4sub35of100,test4pub13of100,1,190,5,512,1,518
test4sub13of100,test4pub12of100,1,190,5,1329,1,1335
test4sub13of100,test4pub13of100,1,190,5,582,1,588
test4sub18of100,test4pub13of100,1,190,5,583,0,588
test4sub82of100,test4pub13of100,1,190,5,604,1,610
test4sub49of100,test4pub14of100,1,190,5,143,0,148
test4sub93of100,test4pub13of100,1,190,5,618,1,624
test4sub77of100,test4pub13of100,1,190,5,627,1,633
test4sub29of100,test4pub13of100,1,190,5,630,1,636
test4sub27of100,test4pub13of100,1,190,5,631,1,637
test4sub72of100,test4pub13of100,1,190,5,643,0,648
test4sub75of100,test4pub3of100,1,189,8,2206,3007,5221
test4sub75of100,test4pub4of100,1,189,5,4868,1,4874
test4sub75of100,test4pub5of100,1,189,5,4743,0,4748
test4sub75of100,test4pub6of100,1,189,5,4721,1,4727
test4sub75of100,test4pub8of100,1,189,5,4634,1,4640
test4sub75of100,test4pub10of100,1,191,10,4582,0,4592
test4sub75of100,test4pub7of100,1,189,5,4685,1,4691
test4sub75of100,test4pub9of100,1,189,6,4608,0,4614
test4sub94of100,test4pub10of100,1,191,10,4587,2,4599
test4sub75of100,test4pub11of100,1,190,5,2058,2,2065
test4sub97of100,test4pub13of100,1,190,5,706,3,714
test4sub63of100,test4pub14of100,1,190,5,242,1,248
test4sub94of100,test4pub11of100,1,190,5,2061,2,2068
test4sub6of100,test4pub13of100,1,190,5,710,2,717
test4sub75of100,test4pub12of100,1,190,5,1458,2,1465
test4sub94of100,test4pub12of100,1,190,5,1460,2,1467
test4sub33of100,test4pub13of100,1,190,5,712,2,719
test4sub15of100,test4pub14of100,1,190,5,248,1,254
test4sub14of100,test4pub13of100,1,190,5,715,0,720
test4sub8of100,test4pub14of100,1,190,5,255,1,261
test4sub75of100,test4pub13of100,1,190,5,722,1,728
test4sub46of100,test4pub13of100,1,190,5,725,0,730
test4sub16of100,test4pub13of100,1,190,5,726,1,732
test4sub78of100,test4pub14of100,1,190,5,286,1,292
test4sub96of100,test4pub13of100,1,190,5,756,0,761
test4sub74of100,test4pub13of100,1,190,5,810,1,816
test4sub100of100,test4pub12of100,1,190,5,1647,1,1653
test4sub57of100,test4pub13of100,1,190,5,898,0,903
test4sub100of100,test4pub13of100,1,190,5,899,0,904
test4sub39of100,test4pub13of100,1,190,5,913,1,919
test4sub39of100,test4pub14of100,1,190,5,449,1,455
test4sub64of100,test4pub14of100,1,190,5,450,2,457
test4sub83of100,test4pub13of100,1,190,5,916,1,922
test4sub67of100,test4pub13of100,1,190,5,919,1,925
test4sub20of100,test4pub13of100,1,190,5,922,1,928
test4sub60of100,test4pub14of100,1,190,5,470,1,476
test4sub51of100,test4pub14of100,1,190,5,490,1,496
test4sub66of100,test4pub14of100,1,190,5,504,1,510
test4sub19of100,test4pub14of100,1,190,5,509,1,515
test4sub92of100,test4pub14of100,1,190,5,509,1,515
test4sub7of100,test4pub14of100,1,190,5,510,0,515
test4sub48of100,test4pub10of100,1,191,10,4859,1,4870
test4sub31of100,test4pub13of100,1,190,5,978,2,985
test4sub48of100,test4pub7of100,1,189,5,4961,2,4968
test4sub12of100,test4pub12of100,1,190,5,1729,1,1735
test4sub31of100,test4pub14of100,1,190,5,515,3,523
test4sub48of100,test4pub6of100,1,189,5,5004,1,5010
test4sub12of100,test4pub13of100,1,190,5,982,1,988
test4sub48of100,test4pub4of100,1,189,5,5156,0,5161
test4sub48of100,test4pub8of100,1,189,5,4920,1,4926
test4sub12of100,test4pub14of100,1,190,5,520,1,526
test4sub48of100,test4pub5of100,1,189,5,5033,1,5039
test4sub48of100,test4pub11of100,1,190,5,2342,1,2348
test4sub48of100,test4pub12of100,1,190,5,1738,1,1744
test4sub99of100,test4pub14of100,1,190,5,526,1,532
test4sub86of100,test4pub13of100,1,190,5,992,1,998
test4sub25of100,test4pub14of100,1,190,5,528,2,535
test4sub86of100,test4pub14of100,1,190,5,528,2,535
test4sub80of100,test4pub14of100,1,190,5,529,2,536
test4sub32of100,test4pub14of100,1,190,5,530,4,539
test4sub26of100,test4pub14of100,1,190,5,532,4,541
test4sub37of100,test4pub14of100,1,190,5,532,5,542
test4sub95of100,test4pub14of100,1,190,5,533,5,543
test4sub2of100,test4pub13of100,1,190,5,999,4,1008
test4sub68of100,test4pub14of100,1,190,5,535,3,543
test4sub69of100,test4pub14of100,1,190,5,536,4,545
test4sub40of100,test4pub14of100,1,190,5,537,3,545
test4sub2of100,test4pub14of100,1,190,5,539,3,547
test4sub41of100,test4pub13of100,1,190,5,1005,4,1014
test4sub22of100,test4pub13of100,1,190,5,1006,2,1013
test4sub40of100,test4pub13of100,1,190,5,1007,3,1015
test4sub42of100,test4pub14of100,1,190,5,543,2,550
test4sub41of100,test4pub14of100,1,190,5,544,1,550
test4sub17of100,test4pub14of100,1,190,5,556,1,562
test4sub84of100,test4pub14of100,1,190,5,601,1,607
test4sub65of100,test4pub14of100,1,190,5,610,0,615
test4sub79of100,test4pub13of100,1,190,5,1076,1,1082
test4sub89of100,test4pub14of100,1,190,5,612,2,619
test4sub35of100,test4pub14of100,1,190,5,613,2,620
test4sub81of100,test4pub12of100,1,190,5,1828,1,1834
test4sub76of100,test4pub11of100,1,190,5,2434,1,2440
test4sub81of100,test4pub13of100,1,190,5,1081,1,1087
test4sub76of100,test4pub12of100,1,190,5,1832,1,1838
test4sub76of100,test4pub13of100,1,190,5,1084,0,1089
test4sub52of100,test4pub14of100,1,190,5,620,1,626
test4sub76of100,test4pub14of100,1,190,5,621,2,628
test4sub18of100,test4pub14of100,1,190,5,621,1,627
test4sub13of100,test4pub14of100,1,190,5,621,1,627
test4sub82of100,test4pub14of100,1,190,5,629,0,634
test4sub93of100,test4pub14of100,1,190,5,647,0,652
test4sub91of100,test4pub7of100,1,189,5,5097,0,5102
test4sub91of100,test4pub8of100,1,189,5,5050,0,5055
test4sub91of100,test4pub4of100,1,189,5,5291,1,5297
test4sub91of100,test4pub6of100,1,189,5,5142,0,5147
test4sub77of100,test4pub14of100,1,190,5,655,1,661
test4sub91of100,test4pub10of100,1,191,10,5003,1,5014
test4sub29of100,test4pub14of100,1,190,5,659,1,665
test4sub27of100,test4pub14of100,1,190,5,660,1,666
test4sub72of100,test4pub14of100,1,190,5,661,1,667
test4sub94of100,test4pub13of100,1,190,5,1126,3,1134
test4sub73of100,test4pub14of100,1,190,5,662,3,670
test4sub97of100,test4pub14of100,1,190,5,663,4,672
test4sub6of100,test4pub14of100,1,190,5,663,3,671
test4sub33of100,test4pub14of100,1,190,5,664,3,672
test4sub15of100,test4pub13of100,1,190,5,1130,3,1138
test4sub14of100,test4pub14of100,1,190,5,665,2,672
test4sub88of100,test4pub13of100,1,190,5,1133,1,1139
test4sub8of100,test4pub13of100,1,190,5,1134,3,1142
test4sub75of100,test4pub14of100,1,190,5,669,2,676
test4sub46of100,test4pub14of100,1,190,5,670,1,676
test4sub88of100,test4pub14of100,1,190,5,671,2,678
test4sub16of100,test4pub14of100,1,190,5,676,0,681
test4sub28of100,test4pub13of100,1,190,5,1142,1,1148
test4sub4of100,test4pub12of100,1,190,5,1892,1,1898
test4sub28of100,test4pub14of100,1,190,5,679,1,685
test4sub4of100,test4pub13of100,1,190,5,1145,1,1151
test4sub4of100,test4pub14of100,1,190,5,681,0,686
test4sub78of100,test4pub13of100,1,190,5,1148,1,1154
test4sub56of100,test4pub13of100,1,190,5,1150,1,1156
test4sub90of100,test4pub13of100,1,190,5,1151,0,1156
test4sub90of100,test4pub14of100,1,190,5,688,1,694
test4sub74of100,test4pub14of100,1,190,5,688,1,694
test4sub100of100,test4pub14of100,1,190,5,695,1,701
test4sub57of100,test4pub14of100,1,190,5,697,1,703
test4sub70of100,test4pub14of100,1,190,5,698,0,703
test4sub96of100,test4pub14of100,1,190,5,834,1,840
test4sub21of100,test4pub14of100,1,190,5,835,0,840
test4sub3of100,test4pub14of100,1,190,5,837,1,843
test4sub30of100,test4pub14of100,1,190,5,838,2,845
test4sub83of100,test4pub14of100,1,190,5,839,1,845
test4sub67of100,test4pub14of100,1,190,5,844,1,850
test4sub20of100,test4pub14of100,1,190,5,848,0,853
test4sub53of100,test4pub10of100,1,191,10,5197,1,5208
test4sub53of100,test4pub5of100,1,189,5,5364,1,5370
test4sub53of100,test4pub11of100,1,190,5,2672,0,2677
test4sub53of100,test4pub12of100,1,190,5,2075,0,2080
test4sub53of100,test4pub13of100,1,190,5,1328,1,1334
test4sub53of100,test4pub14of100,1,190,5,864,0,869
test4sub45of100,test4pub1of100,1,318,12,6416,39,6467
test4sub59of100,test4pub10of100,1,191,10,5220,36,5266
test4sub47of100,test4pub13of100,1,190,5,1342,32,1379
test4sub48of100,test4pub13of100,1,190,5,1344,32,1381
test4sub45of100,test4pub2of100,1,189,5,6267,2,6274
test4sub47of100,test4pub14of100,1,190,5,911,1,917
test4sub48of100,test4pub14of100,1,190,5,911,2,918
test4sub45of100,test4pub3of100,1,189,8,5896,1,5905
test4sub45of100,test4pub6of100,1,189,5,5402,1,5408
test4sub45of100,test4pub7of100,1,189,5,5363,0,5368
test4sub45of100,test4pub5of100,1,189,5,5428,0,5433
test4sub71of100,test4pub3of100,1,189,8,5907,1,5916
test4sub71of100,test4pub4of100,1,189,5,5563,1,5569
test4sub71of100,test4pub6of100,1,189,5,5414,0,5419
test4sub71of100,test4pub10of100,1,191,10,5274,0,5284
test4sub1of100,test4pub11of100,1,190,5,2766,1,2772
test4sub1of100,test4pub12of100,1,190,5,2162,1,2168
test4sub22of100,test4pub14of100,1,190,5,949,1,955
test4sub1of100,test4pub13of100,1,190,5,1415,1,1421
test4sub44of100,test4pub4of100,1,189,5,5596,0,5601
test4sub44of100,test4pub8of100,1,189,5,5360,1,5366
test4sub44of100,test4pub6of100,1,189,5,5449,1,5455
test4sub81of100,test4pub14of100,1,190,5,964,1,970
test4sub91of100,test4pub9of100,1,189,6,5343,1,5350
test4sub91of100,test4pub11of100,1,190,5,2793,0,2798
test4sub91of100,test4pub12of100,1,190,5,2189,0,2194
test4sub91of100,test4pub13of100,1,190,5,1446,1,1452
test4sub91of100,test4pub14of100,1,190,5,982,0,987
test4sub94of100,test4pub14of100,1,190,5,986,0,991
test4sub56of100,test4pub14of100,1,190,5,987,1,993
test4sub5of100,test4pub13of100,1,190,5,1453,0,1458
test4sub5of100,test4pub14of100,1,190,5,990,1,996
test4sub55of100,test4pub3of100,1,189,8,3058,3003,6069
test4sub55of100,test4pub5of100,1,189,5,5590,1,5596
test4sub55of100,test4pub10of100,1,191,10,5426,0,5436
test4sub55of100,test4pub7of100,1,189,5,5528,1,5534
test4sub55of100,test4pub9of100,1,189,6,5452,1,5459
test4sub55of100,test4pub4of100,1,189,5,5721,0,5726
test4sub55of100,test4pub6of100,1,189,5,5572,1,5578
test4sub55of100,test4pub8of100,1,189,5,5486,1,5492
test4sub55of100,test4pub11of100,1,190,5,2906,0,2911
test4sub55of100,test4pub12of100,1,190,5,2303,1,2309
test4sub55of100,test4pub13of100,1,190,5,1555,1,1561
test4sub41of100,test4pub15of100,1,190,5,58,1,64
test4sub55of100,test4pub14of100,1,190,5,1091,0,1096
test4sub2of100,test4pub15of100,1,190,5,118,1,124
test4sub24of100,test4pub4of10,100,190,8,10278,3007,13293
test4sub34of100,test4pub10of100,1,191,10,2512,3008,5530
test4sub24of100,test4pub8of10,100,190,6,12787,1,12794
test4sub34of100,test4pub8of100,1,189,5,5574,1,5580
test4sub24of100,test4pub3of10,100,190,5,13361,1,13367
test4sub34of100,test4pub6of100,1,189,5,5664,1,5670
test4sub24of100,test4pub7of10,100,190,5,12882,0,12887
test4sub34of100,test4pub7of100,1,189,5,5625,1,5631
test4sub24of100,test4pub10of10,100,191,5,11743,1,11749
test4sub34of100,test4pub5of100,1,189,5,5691,1,5697
test4sub24of100,test4pub1of100,1,318,12,6727,40,6779
test4sub34of100,test4pub9of100,1,189,6,5551,41,5598
test4sub68of100,test4pub15of100,1,190,5,149,40,194
test4sub95of100,test4pub15of100,1,190,5,158,32,195
test4sub89of100,test4pub15of100,1,190,5,161,28,194
test4sub51of100,test4pub15of100,1,190,5,164,25,194
test4sub82of100,test4pub15of100,1,190,5,170,21,196
test4sub28of100,test4pub15of100,1,190,5,174,16,195
test4sub24of100,test4pub2of100,1,189,5,6579,3,6587
test4sub34of100,test4pub4of100,1,189,5,5860,3,5868
test4sub34of100,test4pub11of100,1,190,5,3045,1,3051
test4sub24of100,test4pub9of100,1,189,6,5596,1,5603
test4sub34of100,test4pub12of100,1,190,5,2442,1,2448
test4sub24of100,test4pub3of100,1,189,8,6212,1,6221
test4sub24of100,test4pub5of100,1,189,5,5741,1,5747
test4sub24of100,test4pub7of100,1,189,5,5679,1,5685
test4sub24of100,test4pub8of100,1,189,5,5632,0,5637
test4sub24of100,test4pub6of100,1,189,5,5722,1,5728
test4sub24of100,test4pub4of100,1,189,5,5873,0,5878
test4sub24of100,test4pub10of100,1,191,10,5583,1,5594
test4sub24of100,test4pub11of100,1,190,5,3057,1,3063
test4sub24of100,test4pub12of100,1,190,5,2453,0,2458
test4sub24of100,test4pub13of100,1,190,5,1706,1,1712
test4sub55of100,test4pub15of100,1,190,5,208,1,214
test4sub24of100,test4pub14of100,1,190,5,1242,0,1247
test4sub24of100,test4pub15of100,1,190,5,210,1,216
test4sub18of100,test4pub15of100,1,190,5,216,0,221
test4sub97of100,test4pub15of100,1,190,5,219,1,225
test4sub65of100,test4pub15of100,1,190,5,254,2,261
test4sub30of100,test4pub15of100,1,190,5,255,2,262
test4sub78of100,test4pub15of100,1,190,5,305,1,311
test4sub86of100,test4pub15of100,1,190,5,306,268,579
test4sub32of100,test4pub15of100,1,190,5,309,266,580
test4sub49of100,test4pub15of100,1,190,5,311,265,581
test4sub33of100,test4pub15of100,1,190,5,358,219,582
test4sub74of100,test4pub15of100,1,190,5,370,207,582
test4sub50of100,test4pub10of100,1,191,10,5831,127,5968
test4sub12of100,test4pub15of100,1,190,5,483,94,582
test4sub45of100,test4pub10of100,1,191,10,5877,82,5969
test4sub8of100,test4pub15of100,1,190,5,519,58,582
test4sub88of100,test4pub15of100,1,190,5,546,32,583
test4sub59of100,test4pub5of100,1,189,5,6105,19,6129
test4sub71of100,test4pub7of100,1,189,5,6080,1,6086
test4sub1of100,test4pub14of100,1,190,5,1638,2,1645
test4sub22of100,test4pub15of100,1,190,5,605,2,612
test4sub44of100,test4pub9of100,1,189,6,6010,0,6016
test4sub37of100,test4pub15of100,1,190,5,628,0,633
test4sub91of100,test4pub15of100,1,190,5,630,1,636
test4sub100of100,test4pub15of100,1,190,5,632,1,638
test4sub80of100,test4pub15of100,1,190,5,633,2,640
test4sub83of100,test4pub15of100,1,190,5,634,3,642
test4sub57of100,test4pub15of100,1,190,5,634,2,641
test4sub31of100,test4pub15of100,1,190,5,635,2,642
test4sub52of100,test4pub15of100,1,190,5,637,3,645
test4sub69of100,test4pub15of100,1,190,5,638,3,646
test4sub84of100,test4pub15of100,1,190,5,638,3,646
test4sub70of100,test4pub15of100,1,190,5,639,3,647
test4sub53of100,test4pub15of100,1,190,5,640,1,646
test4sub13of100,test4pub15of100,1,190,5,642,0,647
test4sub42of100,test4pub15of100,1,190,5,646,1,652
test4sub92of100,test4pub15of100,1,190,5,647,1,653
test4sub19of100,test4pub15of100,1,190,5,649,1,655
test4sub75of100,test4pub15of100,1,190,5,649,2,656
test4sub90of100,test4pub15of100,1,190,5,650,3,658
test4sub39of100,test4pub15of100,1,190,5,651,2,658
test4sub48of100,test4pub15of100,1,190,5,652,1,658
test4sub5of100,test4pub15of100,1,190,5,652,2,659
test4sub35of100,test4pub15of100,1,190,5,657,1,663
test4sub76of100,test4pub15of100,1,190,5,671,1,677
test4sub81of100,test4pub15of100,1,190,5,672,0,677
test4sub79of100,test4pub15of100,1,190,5,674,1,680
test4sub46of100,test4pub15of100,1,190,5,675,0,680
test4sub14of100,test4pub15of100,1,190,5,676,1,682
test4sub21of100,test4pub15of100,1,190,5,679,0,684
test4sub3of100,test4pub15of100,1,190,5,682,1,688
test4sub29of100,test4pub15of100,1,190,5,683,0,688
test4sub96of100,test4pub15of100,1,190,5,684,0,689
test4sub50of100,test4pub8of100,1,189,5,6231,3,6239
test4sub47of100,test4pub15of100,1,190,5,695,0,700
test4sub61of100,test4pub14of100,1,190,5,1730,1,1736
test4sub63of100,test4pub15of100,1,190,5,697,0,702
test4sub27of100,test4pub15of100,1,190,5,698,1,704
test4sub67of100,test4pub15of100,1,190,5,699,1,705
test4sub72of100,test4pub15of100,1,190,5,701,1,707
test4sub17of100,test4pub15of100,1,190,5,708,0,713
test4sub40of100,test4pub15of100,1,190,5,724,0,729
test4sub73of100,test4pub15of100,1,190,5,724,1,730
test4sub93of100,test4pub15of100,1,190,5,781,1,787
test4sub59of100,test4pub9of100,1,189,6,6201,5,6212
test4sub45of100,test4pub8of100,1,189,5,6231,4,6240
test4sub71of100,test4pub11of100,1,190,5,3651,5,3661
test4sub44of100,test4pub11of100,1,190,5,3651,6,3662
test4sub50of100,test4pub11of100,1,190,5,3654,4,3663
test4sub59of100,test4pub11of100,1,190,5,3656,2,3663
test4sub45of100,test4pub9of100,1,189,6,6207,4,6217
test4sub71of100,test4pub12of100,1,190,5,3053,4,3062
test4sub44of100,test4pub12of100,1,190,5,3053,6,3064
test4sub59of100,test4pub12of100,1,190,5,3055,6,3066
test4sub50of100,test4pub12of100,1,190,5,3054,6,3065
test4sub45of100,test4pub4of100,1,189,5,6480,6,6491
test4sub99of100,test4pub15of100,1,190,5,809,6,820
test4sub71of100,test4pub13of100,1,190,5,2308,7,2320
test4sub94of100,test4pub15of100,1,190,5,811,6,822
test4sub44of100,test4pub13of100,1,190,5,2310,5,2320
test4sub4of100,test4pub15of100,1,190,5,812,6,823
test4sub60of100,test4pub15of100,1,190,5,812,7,824
test4sub59of100,test4pub13of100,1,190,5,2312,5,2322
test4sub50of100,test4pub13of100,1,190,5,2313,5,2323
test4sub45of100,test4pub11of100,1,190,5,3668,4,3677
test4sub71of100,test4pub14of100,1,190,5,1850,4,1859
test4sub44of100,test4pub14of100,1,190,5,1852,4,1861
test4sub50of100,test4pub14of100,1,190,5,1854,2,1861
test4sub45of100,test4pub12of100,1,190,5,3068,3,3076
test4sub71of100,test4pub15of100,1,190,5,822,2,829
test4sub50of100,test4pub15of100,1,190,5,822,2,829
test4sub45of100,test4pub13of100,1,190,5,2323,0,2328
test4sub45of100,test4pub14of100,1,190,5,1859,1,1865
test4sub45of100,test4pub15of100,1,190,5,827,1,833
test4sub66of100,test4pub15of100,1,190,5,840,0,845
test4sub6of100,test4pub15of100,1,190,5,846,1,852
test4sub59of100,test4pub14of100,1,190,5,1881,1,1887
test4sub77of100,test4pub15of100,1,190,5,848,1,854
test4sub56of100,test4pub15of100,1,190,5,849,1,855
test4sub15of100,test4pub15of100,1,190,5,850,1,856
test4sub59of100,test4pub15of100,1,190,5,849,2,856
test4sub16of100,test4pub15of100,1,190,5,853,2,860
test4sub87of100,test4pub14of100,1,190,5,1887,1,1893
test4sub11of100,test4pub13of100,1,190,5,2360,1,2366
test4sub20of100,test4pub15of100,1,190,5,861,2,868
test4sub11of100,test4pub14of100,1,190,5,1896,1,1902
test4sub25of100,test4pub15of100,1,190,5,862,1,868
test4sub85of100,test4pub12of100,1,190,5,3117,0,3122
test4sub85of100,test4pub14of100,1,190,5,1905,1,1911
test4sub85of100,test4pub13of100,1,190,5,2371,0,2376
test4sub1of100,test4pub15of100,1,190,5,895,1,901
test4sub44of100,test4pub15of100,1,190,5,896,1,902
test4sub7of100,test4pub15of100,1,190,5,899,0,904
test4sub61of100,test4pub15of100,1,190,5,901,1,907
test4sub87of100,test4pub15of100,1,190,5,1153,0,1158
test4sub12of100,test4pub16of100,1,191,13,97,1,111
test4sub40of100,test4pub16of100,1,191,13,146,0,159
test4sub35of100,test4pub16of100,1,191,13,147,1,161
test4sub53of100,test4pub16of100,1,191,13,148,1,162
test4sub93of100,test4pub16of100,1,191,13,269,1,283
test4sub2of100,test4pub16of100,1,191,13,285,1,299
test4sub60of100,test4pub16of100,1,191,13,287,1,301
test4sub55of100,test4pub16of100,1,191,13,288,1,302
test4sub92of100,test4pub16of100,1,191,13,290,1,304
test4sub88of100,test4pub16of100,1,191,13,291,0,304
test4sub6of100,test4pub16of100,1,191,13,292,0,305
test4sub41of100,test4pub16of100,1,191,13,294,2,309
test4sub51of100,test4pub16of100,1,191,13,295,1,309
test4sub20of100,test4pub16of100,1,191,13,295,1,309
test4sub70of100,test4pub16of100,1,191,13,297,1,311
test4sub81of100,test4pub16of100,1,191,13,306,1,320
test4sub67of100,test4pub16of100,1,191,13,307,1,321
test4sub31of100,test4pub16of100,1,191,13,308,1,322
test4sub79of100,test4pub16of100,1,191,13,309,0,322
test4sub97of100,test4pub16of100,1,191,13,314,0,327
test4sub57of100,test4pub16of100,1,191,13,318,2,333
test4sub13of100,test4pub16of100,1,191,13,319,3,335
test4sub42of100,test4pub16of100,1,191,13,320,4,337
test4sub1of100,test4pub16of100,1,191,13,320,4,337
test4sub32of100,test4pub16of100,1,191,13,321,3,337
test4sub24of100,test4pub16of100,1,191,13,322,3,338
test4sub86of100,test4pub16of100,1,191,13,322,3,338
test4sub28of100,test4pub16of100,1,191,13,321,3,337
test4sub17of100,test4pub16of100,1,191,13,323,4,340
test4sub48of100,test4pub16of100,1,191,13,326,2,341
test4sub25of100,test4pub16of100,1,191,13,327,1,341
test4sub78of100,test4pub16of100,1,191,13,327,1,341
test4sub68of100,test4pub16of100,1,191,13,334,1,348
test4sub33of100,test4pub16of100,1,191,13,359,1,373
test4sub89of100,test4pub16of100,1,191,13,359,0,372
test4sub99of100,test4pub16of100,1,191,13,402,1,416
test4sub91of100,test4pub16of100,1,191,13,409,1,423
test4sub30of100,test4pub16of100,1,191,13,413,1,427
test4sub18of100,test4pub16of100,1,191,13,413,1,427
test4sub27of100,test4pub16of100,1,191,13,414,1,428
test4sub72of100,test4pub16of100,1,191,13,414,1,428
test4sub82of100,test4pub16of100,1,191,13,422,1,436
test4sub22of100,test4pub16of100,1,191,13,427,1,441
test4sub19of100,test4pub16of100,1,191,13,427,1,441
test4sub44of100,test4pub16of100,1,191,13,430,1,444
test4sub7of100,test4pub16of100,1,191,13,430,1,444
test4sub98of100,test4pub9of100,1,189,6,7041,1,7048
test4sub98of100,test4pub4of100,1,189,5,7311,0,7316
test4sub98of100,test4pub6of100,1,189,5,7163,1,7169
test4sub54of100,test4pub8of100,1,189,5,7076,1,7082
test4sub98of100,test4pub5of100,1,189,5,7188,1,7194
test4sub54of100,test4pub5of100,1,189,5,7190,3,7198
test4sub98of100,test4pub8of100,1,189,5,7079,2,7086
test4sub87of100,test4pub16of100,1,191,13,440,3,456
test4sub54of100,test4pub11of100,1,190,5,4500,1,4506
test4sub98of100,test4pub10of100,1,191,10,7029,2,7041
test4sub58of100,test4pub13of100,1,190,5,3147,2,3154
test4sub54of100,test4pub12of100,1,190,5,3898,1,3904
test4sub98of100,test4pub11of100,1,190,5,4503,4,4512
test4sub58of100,test4pub14of100,1,190,5,2685,4,2694
test4sub23of100,test4pub14of100,1,190,5,2686,4,2695
test4sub84of100,test4pub16of100,1,191,13,446,5,464
test4sub49of100,test4pub16of100,1,191,13,447,5,465
test4sub65of100,test4pub16of100,1,191,13,452,12,477
test4sub23of100,test4pub15of100,1,190,5,1657,13,1675
test4sub83of100,test4pub16of100,1,191,13,462,3,478
test4sub58of100,test4pub15of100,1,190,5,1656,15,1676
test4sub80of100,test4pub16of100,1,191,13,462,3,478
test4sub5of100,test4pub16of100,1,191,13,463,3,479
test4sub62of100,test4pub12of100,1,190,5,3902,18,3925
test4sub10of100,test4pub12of100,1,190,5,3918,5,3928
test4sub54of100,test4pub13of100,1,190,5,3152,21,3178
test4sub98of100,test4pub12of100,1,190,5,3903,23,3931
test4sub26of100,test4pub15of100,1,190,5,1667,10,1682
test4sub8of100,test4pub16of100,1,191,13,464,7,484
test4sub61of100,test4pub16of100,1,191,13,465,7,485
test4sub100of100,test4pub16of100,1,191,13,467,7,487
test4sub62of100,test4pub13of100,1,190,5,3173,7,3185
test4sub37of100,test4pub16of100,1,191,13,468,6,487
test4sub10of100,test4pub13of100,1,190,5,3174,7,3186
test4sub75of100,test4pub16of100,1,191,13,470,6,489
test4sub74of100,test4pub16of100,1,191,13,470,7,490
test4sub15of100,test4pub16of100,1,191,13,471,7,491
test4sub58of100,test4pub16of100,1,191,13,466,11,490
test4sub54of100,test4pub14of100,1,190,5,2711,7,2723
test4sub26of100,test4pub16of100,1,191,13,472,6,491
test4sub98of100,test4pub13of100,1,190,5,3177,5,3187
test4sub94of100,test4pub16of100,1,191,13,473,5,491
test4sub62of100,test4pub14of100,1,190,5,2715,4,2724
test4sub10of100,test4pub14of100,1,190,5,2716,4,2725
test4sub98of100,test4pub14of100,1,190,5,2719,2,2726
test4sub62of100,test4pub15of100,1,190,5,1686,1,1692
test4sub10of100,test4pub15of100,1,190,5,1687,2,1694
test4sub16of100,test4pub16of100,1,191,13,483,0,496
test4sub62of100,test4pub16of100,1,191,13,482,2,497
test4sub69of100,test4pub16of100,1,191,13,510,1,524
test4sub39of100,test4pub16of100,1,191,13,513,1,527
test4sub46of100,test4pub16of100,1,191,13,526,1,540
test4sub73of100,test4pub16of100,1,191,13,565,1,579
test4sub96of100,test4pub16of100,1,191,13,570,0,583
test4sub77of100,test4pub16of100,1,191,13,578,1,592
test4sub21of100,test4pub16of100,1,191,13,578,2,593
test4sub76of100,test4pub16of100,1,191,13,579,2,594
test4sub66of100,test4pub16of100,1,191,13,580,1,594
test4sub56of100,test4pub16of100,1,191,13,581,2,596
test4sub52of100,test4pub16of100,1,191,13,585,1,599
test4sub95of100,test4pub16of100,1,191,13,589,0,602
test4sub63of100,test4pub16of100,1,191,13,589,1,603
test4sub71of100,test4pub16of100,1,191,13,590,0,603
test4sub3of100,test4pub16of100,1,191,13,669,0,682
test4sub98of100,test4pub15of100,1,190,5,1877,0,1882
test4sub98of100,test4pub16of100,1,191,13,672,1,686
test4sub54of100,test4pub15of100,1,190,5,1982,0,1987
test4sub54of100,test4pub16of100,1,191,13,777,0,790
test4sub23of100,test4pub16of100,1,191,13,783,1,797
test4sub47of100,test4pub16of100,1,191,13,799,1,813
test4sub10of100,test4pub16of100,1,191,13,806,1,820
test4sub14of100,test4pub16of100,1,191,13,884,0,897
test4sub43of100,test4pub13of100,1,190,5,3596,1,3602
test4sub43of100,test4pub14of100,1,190,5,3132,0,3137
test4sub43of100,test4pub15of100,1,190,5,2107,0,2112
test4sub43of100,test4pub16of100,1,191,13,902,1,916
test4sub36of100,test4pub13of100,1,190,5,3624,1,3630
test4sub36of100,test4pub14of100,1,190,5,3160,0,3165
test4sub36of100,test4pub15of100,1,190,5,2128,1,2134
test4sub36of100,test4pub16of100,1,191,13,924,1,938
test4sub4of100,test4pub16of100,1,191,13,925,0,938
test4sub59of100,test4pub16of100,1,191,13,928,0,941
test4sub29of100,test4pub16of100,1,191,13,988,1,1002
test4sub90of100,test4pub16of100,1,191,13,1099,0,1112
test4sub45of100,test4pub16of100,1,191,13,1189,1,1203
test4sub55of100,test4pub17of100,1,190,5,87,1,93
test4sub21of100,test4pub17of100,1,190,5,96,1,102
test4sub61of100,test4pub17of100,1,190,5,117,1,123
test4sub24of100,test4pub17of100,1,190,5,129,1,135
test4sub4of100,test4pub17of100,1,190,5,129,0,134
test4sub74of100,test4pub17of100,1,190,5,158,1,164
test4sub87of100,test4pub17of100,1,190,5,227,1,233
test4sub26of100,test4pub17of100,1,190,5,243,1,249
test4sub31of100,test4pub17of100,1,190,5,249,0,254
test4sub65of100,test4pub17of100,1,190,5,273,0,278
test4sub47of100,test4pub17of100,1,190,5,295,1,301
test4sub20of100,test4pub17of100,1,190,5,313,1,319
test4sub80of100,test4pub17of100,1,190,5,319,0,324
test4sub67of100,test4pub17of100,1,190,5,326,0,331
test4sub78of100,test4pub17of100,1,190,5,331,1,337
test4sub3of100,test4pub17of100,1,190,5,338,0,343
test4sub98of100,test4pub17of100,1,190,5,342,1,348
test4sub63of100,test4pub17of100,1,190,5,342,1,348
test4sub6of100,test4pub17of100,1,190,5,343,1,349
test4sub48of100,test4pub17of100,1,190,5,345,1,351
test4sub42of100,test4pub17of100,1,190,5,348,1,354
test4sub60of100,test4pub17of100,1,190,5,349,1,355
test4sub7of100,test4pub17of100,1,190,5,351,1,357
test4sub73of100,test4pub17of100,1,190,5,363,0,368
test4sub57of100,test4pub17of100,1,190,5,367,1,373
test4sub58of100,test4pub17of100,1,190,5,369,1,375
test4sub97of100,test4pub17of100,1,190,5,372,1,378
test4sub39of100,test4pub17of100,1,190,5,374,1,380
test4sub5of100,test4pub17of100,1,190,5,375,2,382
test4sub53of100,test4pub17of100,1,190,5,375,1,381
test4sub13of100,test4pub17of100,1,190,5,376,1,382
test4sub1of100,test4pub17of100,1,190,5,384,1,390
test4sub79of100,test4pub17of100,1,190,5,386,1,392
test4sub89of100,test4pub17of100,1,190,5,388,1,394
test4sub91of100,test4pub17of100,1,190,5,392,0,397
test4sub54of100,test4pub17of100,1,190,5,394,1,400
test4sub36of100,test4pub17of100,1,190,5,394,1,400
test4sub45of100,test4pub17of100,1,190,5,395,1,401
test4sub71of100,test4pub17of100,1,190,5,397,0,402
test4sub10of100,test4pub17of100,1,190,5,398,1,404
test4sub90of100,test4pub17of100,1,190,5,398,2,405
test4sub52of100,test4pub17of100,1,190,5,400,2,407
test4sub8of100,test4pub17of100,1,190,5,400,1,406
test4sub17of100,test4pub17of100,1,190,5,403,0,408
test4sub75of100,test4pub17of100,1,190,5,403,1,409
test4sub12of100,test4pub17of100,1,190,5,405,1,411
test4sub35of100,test4pub17of100,1,190,5,410,1,416
test4sub51of100,test4pub17of100,1,190,5,437,1,443
test4sub66of100,test4pub17of100,1,190,5,456,1,462
test4sub95of100,test4pub17of100,1,190,5,501,1,507
test4sub86of100,test4pub17of100,1,190,5,508,0,513
test4sub23of100,test4pub17of100,1,190,5,514,0,519
test4sub29of100,test4pub17of100,1,190,5,521,0,526
test4sub2of100,test4pub17of100,1,190,5,527,0,532
test4sub49of100,test4pub17of100,1,190,5,539,1,545
test4sub84of100,test4pub17of100,1,190,5,544,0,549
test4sub43of100,test4pub17of100,1,190,5,550,1,556
test4sub25of100,test4pub17of100,1,190,5,556,1,562
test4sub33of100,test4pub17of100,1,190,5,561,0,566
test4sub93of100,test4pub17of100,1,190,5,569,0,574
test4sub92of100,test4pub17of100,1,190,5,575,1,581
test4sub19of100,test4pub17of100,1,190,5,587,1,593
test4sub72of100,test4pub17of100,1,190,5,592,0,597
test4sub68of100,test4pub17of100,1,190,5,598,1,604
test4sub46of100,test4pub17of100,1,190,5,610,1,616
test4sub32of100,test4pub17of100,1,190,5,622,0,627
test4sub18of100,test4pub17of100,1,190,5,628,0,633
test4sub77of100,test4pub17of100,1,190,5,634,1,640
test4sub70of100,test4pub17of100,1,190,5,639,0,644
test4sub59of100,test4pub17of100,1,190,5,646,1,652
test4sub37of100,test4pub17of100,1,190,5,652,0,657
test4sub15of100,test4pub17of100,1,190,5,658,0,663
test4sub41of100,test4pub17of100,1,190,5,659,1,665
test4sub82of100,test4pub17of100,1,190,5,660,0,665
test4sub76of100,test4pub17of100,1,190,5,663,1,669
test4sub30of100,test4pub17of100,1,190,5,664,1,670
test4sub69of100,test4pub17of100,1,190,5,666,3,674
test4sub100of100,test4pub17of100,1,190,5,666,2,673
test4sub56of100,test4pub17of100,1,190,5,667,2,674
test4sub40of100,test4pub17of100,1,190,5,668,1,674
test4sub62of100,test4pub17of100,1,190,5,690,1,696
test4sub14of100,test4pub17of100,1,190,5,690,1,696
test4sub16of100,test4pub17of100,1,190,5,691,1,697
test4sub27of100,test4pub17of100,1,190,5,693,1,699
test4sub99of100,test4pub17of100,1,190,5,695,1,701
test4sub88of100,test4pub17of100,1,190,5,696,1,702
test4sub83of100,test4pub17of100,1,190,5,697,1,703
test4sub81of100,test4pub17of100,1,190,5,698,2,705
test4sub28of100,test4pub17of100,1,190,5,698,1,704
test4sub96of100,test4pub17of100,1,190,5,700,1,706
test4sub22of100,test4pub17of100,1,190,5,711,1,717
test4sub94of100,test4pub17of100,1,190,5,745,1,751
test4sub64of100,test4pub15of100,1,190,5,3222,1,3228
test4sub64of100,test4pub16of100,1,191,13,2017,0,2030
test4sub64of100,test4pub17of100,1,190,5,750,1,756
test4sub44of100,test4pub17of100,1,190,5,752,0,757
test4sub81of100,test4pub18of100,1,190,5,87,1,93
test4sub65of100,test4pub18of100,1,190,5,92,0,97
test4sub92of100,test4pub18of100,1,190,5,110,3,118
test4sub32of100,test4pub18of100,1,190,5,110,3,118
test4sub29of100,test4pub18of100,1,190,5,111,2,118
test4sub52of100,test4pub18of100,1,190,5,111,3,119
test4sub69of100,test4pub18of100,1,190,5,112,3,120
test4sub50of100,test4pub16of100,1,191,13,2644,3,2660
test4sub4of100,test4pub18of100,1,190,5,115,1,121
test4sub50of100,test4pub17of100,1,190,5,1379,1,1385
test4sub62of100,test4pub18of100,1,190,5,183,0,188
test4sub89of100,test4pub18of100,1,190,5,194,1,200
test4sub27of100,test4pub18of100,1,190,5,200,0,205
test4sub18of100,test4pub18of100,1,190,5,205,1,211
test4sub24of100,test4pub18of100,1,190,5,207,0,212
test4sub100of100,test4pub18of100,1,190,5,208,0,213
test4sub8of100,test4pub18of100,1,190,5,223,1,229
test4sub42of100,test4pub18of100,1,190,5,223,1,229
test4sub28of100,test4pub18of100,1,190,5,224,0,229
test4sub33of100,test4pub18of100,1,190,5,230,1,236
test4sub53of100,test4pub18of100,1,190,5,232,1,238
test4sub40of100,test4pub18of100,1,190,5,238,1,244
test4sub1of100,test4pub18of100,1,190,5,239,0,244
test4sub30of100,test4pub18of100,1,190,5,244,1,250
test4sub13of100,test4pub18of100,1,190,5,245,1,251
test4sub50of100,test4pub18of100,1,190,5,248,1,254
test4sub88of100,test4pub18of100,1,190,5,261,1,267
test4sub55of100,test4pub18of100,1,190,5,278,0,283
test4sub10of100,test4pub18of100,1,190,5,282,0,287
test4sub77of100,test4pub18of100,1,190,5,288,1,294
test4sub7of100,test4pub18of100,1,190,5,291,1,297
test4sub57of100,test4pub18of100,1,190,5,298,0,303
test4sub54of100,test4pub18of100,1,190,5,304,1,310
test4sub15of100,test4pub18of100,1,190,5,308,1,314
test4sub75of100,test4pub18of100,1,190,5,311,1,317
test4sub64of100,test4pub18of100,1,190,5,314,0,319
test4sub43of100,test4pub18of100,1,190,5,391,0,396
test4sub90of100,test4pub18of100,1,190,5,393,1,399
test4sub58of100,test4pub18of100,1,190,5,394,0,399
test4sub45of100,test4pub18of100,1,190,5,428,1,434
test4sub3of100,test4pub18of100,1,190,5,429,0,434
test4sub49of100,test4pub18of100,1,190,5,458,0,463
test4sub39of100,test4pub18of100,1,190,5,488,0,493
test4sub51of100,test4pub18of100,1,190,5,490,1,496
test4sub71of100,test4pub18of100,1,190,5,491,1,497
test4sub93of100,test4pub18of100,1,190,5,519,0,524
test4sub91of100,test4pub18of100,1,190,5,533,1,539
test4sub19of100,test4pub18of100,1,190,5,535,1,541
test4sub26of100,test4pub18of100,1,190,5,537,1,543
test4sub76of100,test4pub18of100,1,190,5,539,0,544
test4sub6of100,test4pub18of100,1,190,5,540,1,546
test4sub95of100,test4pub18of100,1,190,5,658,0,663
test4sub41of100,test4pub18of100,1,190,5,701,1,707
test4sub70of100,test4pub18of100,1,190,5,708,1,714
test4sub68of100,test4pub18of100,1,190,5,723,1,729
test4sub94of100,test4pub18of100,1,190,5,736,0,741
test4sub21of100,test4pub18of100,1,190,5,739,0,744
test4sub98of100,test4pub18of100,1,190,5,742,0,747
test4sub25of100,test4pub18of100,1,190,5,748,1,754
test4sub80of100,test4pub18of100,1,190,5,757,1,763
test4sub83of100,test4pub18of100,1,190,5,768,0,773
test4sub2of100,test4pub18of100,1,190,5,771,0,776
test4sub84of100,test4pub18of100,1,190,5,774,0,779
test4sub48of100,test4pub18of100,1,190,5,778,0,783
test4sub56of100,test4pub18of100,1,190,5,782,1,788
test4sub44of100,test4pub18of100,1,190,5,784,1,790
test4sub96of100,test4pub18of100,1,190,5,792,0,797
test4sub74of100,test4pub18of100,1,190,5,795,1,801
test4sub12of100,test4pub18of100,1,190,5,798,1,804
test4sub79of100,test4pub18of100,1,190,5,813,0,818
test4sub66of100,test4pub18of100,1,190,5,825,0,830
test4sub82of100,test4pub18of100,1,190,5,829,1,835
test4sub16of100,test4pub18of100,1,190,5,832,1,838
test4sub86of100,test4pub18of100,1,190,5,837,1,843
test4sub72of100,test4pub18of100,1,190,5,840,0,845
test4sub67of100,test4pub18of100,1,190,5,846,1,852
test4sub31of100,test4pub18of100,1,190,5,849,0,854
test4sub46of100,test4pub18of100,1,190,5,852,1,858
test4sub47of100,test4pub18of100,1,190,5,855,1,861
test4sub37of100,test4pub18of100,1,190,5,858,1,864
test4sub36of100,test4pub18of100,1,190,5,860,1,866
test4sub60of100,test4pub18of100,1,190,5,864,0,869
test4sub63of100,test4pub18of100,1,190,5,867,1,873
test4sub35of100,test4pub18of100,1,190,5,870,1,876
test4sub61of100,test4pub18of100,1,190,5,876,1,882
test4sub73of100,test4pub18of100,1,190,5,881,1,887
test4sub78of100,test4pub18of100,1,190,5,887,0,892
test4sub22of100,test4pub18of100,1,190,5,891,1,897
test4sub99of100,test4pub18of100,1,190,5,897,0,902
test4sub20of100,test4pub18of100,1,190,5,904,1,910
test4sub59of100,test4pub18of100,1,190,5,909,1,915
test4sub23of100,test4pub18of100,1,190,5,925,1,931
test4sub97of100,test4pub18of100,1,190,5,926,1,932
test4sub5of100,test4pub18of100,1,190,5,1016,0,1021
test4sub38of100,test4pub11of100,1,190,5,8264,1,8270
test4sub38of100,test4pub12of100,1,190,5,7661,0,7666
test4sub38of100,test4pub13of100,1,190,5,6913,1,6919
test4sub38of100,test4pub14of100,1,190,5,6450,1,6456
test4sub14of100,test4pub18of100,1,190,5,1680,0,1685
test4sub38of100,test4pub15of100,1,190,5,5418,1,5424
test4sub87of100,test4pub18of100,1,190,5,1700,1,1706
test4sub38of100,test4pub16of100,1,191,13,4274,1,4288
test4sub38of100,test4pub17of100,1,190,5,3006,0,3011
test4sub38of100,test4pub18of100,1,190,5,1746,1,1752
test4sub17of100,test4pub18of100,1,190,5,1884,1,1890
test4sub62of100,test4pub19of100,1,190,5,140,0,145
test4sub28of100,test4pub19of100,1,190,5,283,1,289
test4sub91of100,test4pub19of100,1,190,5,296,0,301
test4sub6of100,test4pub19of100,1,190,5,302,1,308
test4sub93of100,test4pub19of100,1,190,5,308,1,314
test4sub64of100,test4pub19of100,1,190,5,314,0,319
test4sub33of100,test4pub19of100,1,190,5,320,1,326
test4sub76of100,test4pub19of100,1,190,5,325,0,330
test4sub90of100,test4pub19of100,1,190,5,331,0,336
test4sub65of100,test4pub19of100,1,190,5,360,1,366
test4sub96of100,test4pub19of100,1,190,5,362,1,368
test4sub79of100,test4pub19of100,1,190,5,388,1,394
test4sub13of100,test4pub19of100,1,190,5,392,2,399
test4sub1of100,test4pub19of100,1,190,5,394,1,400
test4sub81of100,test4pub19of100,1,190,5,394,1,400
test4sub10of100,test4pub19of100,1,190,5,397,1,403
test4sub66of100,test4pub19of100,1,190,5,402,1,408
test4sub60of100,test4pub19of100,1,190,5,403,1,409
test4sub53of100,test4pub19of100,1,190,5,403,2,410
test4sub36of100,test4pub19of100,1,190,5,405,2,412
test4sub22of100,test4pub19of100,1,190,5,406,1,412
test4sub12of100,test4pub19of100,1,190,5,407,1,413
test4sub38of100,test4pub19of100,1,190,5,408,1,414
test4sub40of100,test4pub19of100,1,190,5,410,1,416
test4sub16of100,test4pub19of100,1,190,5,411,1,417
test4sub50of100,test4pub19of100,1,190,5,412,1,418
test4sub58of100,test4pub19of100,1,190,5,413,1,419
test4sub83of100,test4pub19of100,1,190,5,415,1,421
test4sub29of100,test4pub19of100,1,190,5,415,2,422
test4sub82of100,test4pub19of100,1,190,5,416,2,423
test4sub87of100,test4pub19of100,1,190,5,417,4,426
test4sub73of100,test4pub19of100,1,190,5,418,4,427
test4sub55of100,test4pub19of100,1,190,5,419,3,427
test4sub17of100,test4pub19of100,1,190,5,420,4,429
test4sub2of100,test4pub19of100,1,190,5,421,4,430
test4sub25of100,test4pub19of100,1,190,5,421,3,429
test4sub63of100,test4pub19of100,1,190,5,422,3,430
test4sub99of100,test4pub19of100,1,190,5,424,2,431
test4sub67of100,test4pub19of100,1,190,5,433,2,440
test4sub56of100,test4pub19of100,1,190,5,433,2,440
test4sub54of100,test4pub19of100,1,190,5,434,3,442
test4sub69of100,test4pub19of100,1,190,5,435,3,443
test4sub49of100,test4pub19of100,1,190,5,437,2,444
test4sub48of100,test4pub19of100,1,190,5,438,2,445
test4sub14of100,test4pub19of100,1,190,5,447,1,453
test4sub19of100,test4pub19of100,1,190,5,447,2,454
test4sub15of100,test4pub19of100,1,190,5,448,2,455
test4sub75of100,test4pub19of100,1,190,5,449,2,456
test4sub8of100,test4pub19of100,1,190,5,459,1,465
test4sub51of100,test4pub19of100,1,190,5,462,1,468
test4sub39of100,test4pub19of100,1,190,5,468,1,474
test4sub95of100,test4pub19of100,1,190,5,474,0,479
test4sub71of100,test4pub19of100,1,190,5,476,1,482
test4sub27of100,test4pub19of100,1,190,5,477,2,484
test4sub23of100,test4pub19of100,1,190,5,478,1,484
test4sub46of100,test4pub19of100,1,190,5,481,0,486
test4sub78of100,test4pub19of100,1,190,5,484,0,489
test4sub43of100,test4pub19of100,1,190,5,485,1,491
test4sub34of100,test4pub13of100,1,190,5,7538,0,7543
test4sub34of100,test4pub14of100,1,190,5,7075,1,7081
test4sub34of100,test4pub15of100,1,190,5,6042,0,6047
test4sub34of100,test4pub16of100,1,191,13,4838,1,4852
test4sub42of100,test4pub19of100,1,190,5,496,0,501
test4sub34of100,test4pub17of100,1,190,5,3571,1,3577
test4sub57of100,test4pub19of100,1,190,5,502,0,507
test4sub88of100,test4pub19of100,1,190,5,507,0,512
test4sub4of100,test4pub19of100,1,190,5,514,1,520
test4sub100of100,test4pub19of100,1,190,5,516,1,522
test4sub31of100,test4pub19of100,1,190,5,516,1,522
test4sub7of100,test4pub19of100,1,190,5,519,1,525
test4sub70of100,test4pub19of100,1,190,5,526,0,531
test4sub20of100,test4pub19of100,1,190,5,537,1,543
test4sub32of100,test4pub19of100,1,190,5,553,0,558
test4sub34of100,test4pub18of100,1,190,5,2370,1,2376
test4sub92of100,test4pub19of100,1,190,5,559,1,565
test4sub34of100,test4pub19of100,1,190,5,560,1,566
test4sub85of100,test4pub15of100,1,190,5,6113,1,6119
test4sub85of100,test4pub16of100,1,191,13,4908,1,4922
test4sub21of100,test4pub19of100,1,190,5,566,0,571
test4sub85of100,test4pub17of100,1,190,5,3641,1,3647
test4sub85of100,test4pub18of100,1,190,5,2381,0,2386
test4sub11of100,test4pub15of100,1,190,5,6118,1,6124
test4sub11of100,test4pub16of100,1,191,13,4914,0,4927
test4sub11of100,test4pub17of100,1,190,5,3646,0,3651
test4sub11of100,test4pub18of100,1,190,5,2386,1,2392
test4sub11of100,test4pub19of100,1,190,5,575,1,581
test4sub47of100,test4pub19of100,1,190,5,578,1,584
test4sub80of100,test4pub19of100,1,190,5,605,1,611
test4sub44of100,test4pub19of100,1,190,5,607,1,613
test4sub94of100,test4pub19of100,1,190,5,608,0,613
test4sub3of100,test4pub19of100,1,190,5,625,1,631
test4sub61of100,test4pub19of100,1,190,5,627,0,632
test4sub30of100,test4pub19of100,1,190,5,634,0,639
test4sub84of100,test4pub19of100,1,190,5,638,1,644
test4sub26of100,test4pub19of100,1,190,5,642,1,648
test4sub89of100,test4pub19of100,1,190,5,643,0,648
test4sub45of100,test4pub19of100,1,190,5,650,1,656
test4sub98of100,test4pub19of100,1,190,5,652,0,657
test4sub74of100,test4pub19of100,1,190,5,653,1,659
test4sub77of100,test4pub19of100,1,190,5,660,1,666
test4sub86of100,test4pub19of100,1,190,5,660,0,665
test4sub41of100,test4pub19of100,1,190,5,661,1,667
test4sub72of100,test4pub19of100,1,190,5,662,0,667
test4sub18of100,test4pub19of100,1,190,5,664,0,669
test4sub68of100,test4pub19of100,1,190,5,666,1,672
test4sub5of100,test4pub19of100,1,190,5,667,1,673
test4sub37of100,test4pub19of100,1,190,5,668,1,674
test4sub97of100,test4pub19of100,1,190,5,670,0,675
test4sub85of100,test4pub19of100,1,190,5,694,1,700
test4sub59of100,test4pub19of100,1,190,5,833,0,838
test4sub24of100,test4pub19of100,1,190,5,1279,1,1285
test4sub52of100,test4pub19of100,1,190,5,1286,1,1292
test4sub35of100,test4pub19of100,1,190,5,1318,0,1323
test4sub28of100,test4pub20of100,1,190,5,105,0,110
test4sub87of100,test4pub20of100,1,190,5,110,0,115
test4sub41of100,test4pub20of100,1,190,5,114,0,119
test4sub98of100,test4pub20of100,1,190,5,117,1,123
test4sub12of100,test4pub20of100,1,190,5,120,1,126
test4sub8of100,test4pub20of100,1,190,5,165,1,171
test4sub72of100,test4pub20of100,1,190,5,181,1,187
test4sub15of100,test4pub20of100,1,190,5,187,0,192
test4sub7of100,test4pub20of100,1,190,5,190,0,195
test4sub85of100,test4pub20of100,1,190,5,193,1,199
test4sub25of100,test4pub20of100,1,190,5,200,0,205
test4sub95of100,test4pub20of100,1,190,5,211,1,217
test4sub50of100,test4pub20of100,1,190,5,214,1,220
test4sub13of100,test4pub20of100,1,190,5,330,0,335
test4sub45of100,test4pub20of100,1,190,5,333,0,338
test4sub19of100,test4pub20of100,1,190,5,336,0,341
test4sub76of100,test4pub20of100,1,190,5,339,0,344
test4sub83of100,test4pub20of100,1,190,5,342,0,347
test4sub63of100,test4pub20of100,1,190,5,345,1,351
test4sub6of100,test4pub20of100,1,190,5,355,1,361
test4sub52of100,test4pub20of100,1,190,5,364,1,370
test4sub86of100,test4pub20of100,1,190,5,384,1,390
test4sub27of100,test4pub20of100,1,190,5,385,1,391
test4sub94of100,test4pub20of100,1,190,5,388,1,394
test4sub33of100,test4pub20of100,1,190,5,400,1,406
test4sub36of100,test4pub20of100,1,190,5,400,1,406
test4sub2of100,test4pub20of100,1,190,5,403,1,409
test4sub99of100,test4pub20of100,1,190,5,403,1,409
test4sub66of100,test4pub20of100,1,190,5,407,1,413
test4sub70of100,test4pub20of100,1,190,5,410,0,415
test4sub55of100,test4pub20of100,1,190,5,413,1,419
test4sub16of100,test4pub20of100,1,190,5,416,0,421
test4sub4of100,test4pub20of100,1,190,5,422,1,428
test4sub67of100,test4pub20of100,1,190,5,428,1,434
test4sub68of100,test4pub20of100,1,190,5,429,2,436
test4sub69of100,test4pub20of100,1,190,5,429,1,435
test4sub43of100,test4pub20of100,1,190,5,439,1,445
test4sub75of100,test4pub20of100,1,190,5,442,0,447
test4sub38of100,test4pub20of100,1,190,5,443,1,449
test4sub81of100,test4pub20of100,1,190,5,445,1,451
test4sub96of100,test4pub20of100,1,190,5,464,1,470
test4sub51of100,test4pub20of100,1,190,5,465,1,471
test4sub11of100,test4pub20of100,1,190,5,472,1,478
test4sub35of100,test4pub20of100,1,190,5,487,2,494
test4sub56of100,test4pub20of100,1,190,5,488,3,496
test4sub47of100,test4pub20of100,1,190,5,488,2,495
test4sub48of100,test4pub20of100,1,190,5,489,2,496
test4sub88of100,test4pub20of100,1,190,5,491,1,497
test4sub24of100,test4pub20of100,1,190,5,493,1,499
test4sub44of100,test4pub20of100,1,190,5,494,0,499
test4sub79of100,test4pub20of100,1,190,5,496,2,503
test4sub20of100,test4pub20of100,1,190,5,497,2,504
test4sub49of100,test4pub20of100,1,190,5,498,1,504
test4sub60of100,test4pub20of100,1,190,5,500,2,507
test4sub80of100,test4pub20of100,1,190,5,501,2,508
test4sub42of100,test4pub20of100,1,190,5,501,3,509
test4sub30of100,test4pub20of100,1,190,5,500,6,511
test4sub22of100,test4pub20of100,1,190,5,502,4,511
test4sub58of100,test4pub20of100,1,190,5,503,3,511
test4sub78of100,test4pub20of100,1,190,5,504,3,512
test4sub10of100,test4pub20of100,1,190,5,505,2,512
test4sub77of100,test4pub20of100,1,190,5,524,1,530
test4sub89of100,test4pub20of100,1,190,5,525,1,531
test4sub32of100,test4pub20of100,1,190,5,533,1,539
test4sub23of100,test4pub20of100,1,190,5,539,0,544
test4sub84of100,test4pub20of100,1,190,5,543,1,549
test4sub91of100,test4pub20of100,1,190,5,543,1,549
test4sub57of100,test4pub20of100,1,190,5,544,2,551
test4sub9of100,test4pub8of100,1,189,5,12811,1,12817
test4sub9of100,test4pub5of100,1,189,5,12924,0,12929
test4sub9of100,test4pub6of100,1,189,5,12902,1,12908
test4sub9of100,test4pub4of100,1,189,5,13053,1,13059
test4sub14of100,test4pub20of100,1,190,5,551,2,558
test4sub9of100,test4pub7of100,1,189,5,12866,1,12872
test4sub34of100,test4pub20of100,1,190,5,554,1,560
test4sub9of100,test4pub9of100,1,189,6,12789,0,12795
test4sub9of100,test4pub10of100,1,191,10,12768,1,12779
test4sub9of100,test4pub11of100,1,190,5,10241,0,10246
test4sub9of100,test4pub12of100,1,190,5,9637,1,9643
test4sub54of100,test4pub20of100,1,190,5,559,0,564
test4sub9of100,test4pub13of100,1,190,5,8890,1,8896
test4sub39of100,test4pub20of100,1,190,5,561,1,567
test4sub90of100,test4pub20of100,1,190,5,562,1,568
test4sub17of100,test4pub20of100,1,190,5,563,1,569
test4sub71of100,test4pub20of100,1,190,5,564,1,570
test4sub9of100,test4pub14of100,1,190,5,8428,1,8434
test4sub9of100,test4pub15of100,1,190,5,7398,1,7404
test4sub97of100,test4pub20of100,1,190,5,568,0,573
test4sub9of100,test4pub16of100,1,191,13,6193,1,6207
test4sub74of100,test4pub20of100,1,190,5,570,1,576
test4sub1of100,test4pub20of100,1,190,5,574,1,580
test4sub29of100,test4pub20of100,1,190,5,574,1,580
test4sub5of100,test4pub20of100,1,190,5,581,0,586
test4sub9of100,test4pub17of100,1,190,5,4938,0,4943
test4sub9of100,test4pub18of100,1,190,5,3678,1,3684
test4sub9of100,test4pub19of100,1,190,5,1867,0,1872
test4sub9of100,test4pub20of100,1,190,5,587,1,593
test4sub3of100,test4pub20of100,1,190,5,596,1,602
test4sub59of100,test4pub20of100,1,190,5,597,1,603
test4sub18of100,test4pub20of100,1,190,5,599,1,605
test4sub64of100,test4pub20of100,1,190,5,602,0,607
test4sub40of100,test4pub20of100,1,190,5,605,1,611
test4sub21of100,test4pub20of100,1,190,5,615,1,621
test4sub31of100,test4pub20of100,1,190,5,616,0,621
test4sub93of100,test4pub20of100,1,190,5,621,1,627
test4sub46of100,test4pub20of100,1,190,5,631,1,637
test4sub53of100,test4pub20of100,1,190,5,635,1,641
test4sub73of100,test4pub20of100,1,190,5,635,0,640
test4sub61of100,test4pub20of100,1,190,5,638,1,644
test4sub65of100,test4pub20of100,1,190,5,641,1,647
test4sub37of100,test4pub20of100,1,190,5,641,1,647
test4sub100of100,test4pub20of100,1,190,5,645,1,651
test4sub26of100,test4pub20of100,1,190,5,667,1,673
test4sub92of100,test4pub20of100,1,190,5,672,0,677
test4sub62of100,test4pub20of100,1,190,5,673,1,679
test4sub82of100,test4pub20of100,1,190,5,674,1,680
test4sub8of100,test4pub21of100,1,190,5,73,0,78
test4sub13of100,test4pub21of100,1,190,5,85,1,91
test4sub25of100,test4pub21of100,1,190,5,90,1,96
test4sub83of100,test4pub21of100,1,190,5,93,0,98
test4sub93of100,test4pub21of100,1,190,5,97,1,103
test4sub43of100,test4pub21of100,1,190,5,105,1,111
test4sub94of100,test4pub21of100,1,190,5,149,0,154
test4sub2of100,test4pub21of100,1,190,5,153,1,159
test4sub62of100,test4pub21of100,1,190,5,158,1,164
test4sub3of100,test4pub21of100,1,190,5,165,1,171
test4sub81of100,test4pub21of100,1,190,5,167,1,173
test4sub73of100,test4pub21of100,1,190,5,175,0,180
test4sub60of100,test4pub21of100,1,190,5,185,0,190
test4sub80of100,test4pub21of100,1,190,5,228,0,233
test4sub44of100,test4pub21of100,1,190,5,232,0,237
test4sub17of100,test4pub21of100,1,190,5,239,1,245
test4sub75of100,test4pub21of100,1,190,5,243,1,249
test4sub10of100,test4pub21of100,1,190,5,247,0,252
test4sub90of100,test4pub21of100,1,190,5,248,1,254
test4sub50of100,test4pub21of100,1,190,5,251,1,257
test4sub11of100,test4pub21of100,1,190,5,254,1,260
test4sub63of100,test4pub21of100,1,190,5,254,1,260
test4sub34of100,test4pub21of100,1,190,5,264,1,270
test4sub36of100,test4pub21of100,1,190,5,266,1,272
test4sub6of100,test4pub21of100,1,190,5,358,0,363
test4sub58of100,test4pub21of100,1,190,5,359,0,364
test4sub38of100,test4pub21of100,1,190,5,361,1,367
test4sub7of100,test4pub21of100,1,190,5,362,0,367
test4sub30of100,test4pub21of100,1,190,5,365,0,370
test4sub16of100,test4pub21of100,1,190,5,366,1,372
test4sub46of100,test4pub21of100,1,190,5,369,0,374
test4sub32of100,test4pub21of100,1,190,5,370,0,375
test4sub96of100,test4pub21of100,1,190,5,380,1,386
test4sub99of100,test4pub21of100,1,190,5,381,1,387
test4sub52of100,test4pub21of100,1,190,5,435,0,440
test4sub1of100,test4pub21of100,1,190,5,445,1,451
test4sub12of100,test4pub21of100,1,190,5,447,1,453
test4sub98of100,test4pub21of100,1,190,5,449,1,455
test4sub41of100,test4pub21of100,1,190,5,451,1,457
test4sub5of100,test4pub21of100,1,190,5,455,1,461
test4sub92of100,test4pub21of100,1,190,5,456,1,462
test4sub23of100,test4pub21of100,1,190,5,459,1,465
test4sub97of100,test4pub21of100,1,190,5,460,1,466
test4sub31of100,test4pub21of100,1,190,5,462,1,468
test4sub100of100,test4pub21of100,1,190,5,464,1,470
test4sub61of100,test4pub21of100,1,190,5,465,1,471
test4sub54of100,test4pub21of100,1,190,5,467,2,474
test4sub71of100,test4pub21of100,1,190,5,468,2,475
test4sub47of100,test4pub21of100,1,190,5,469,1,475
test4sub66of100,test4pub21of100,1,190,5,490,1,496
test4sub4of100,test4pub21of100,1,190,5,547,1,553
test4sub55of100,test4pub21of100,1,190,5,554,1,560
test4sub78of100,test4pub21of100,1,190,5,561,0,566
test4sub24of100,test4pub21of100,1,190,5,562,1,568
test4sub37of100,test4pub21of100,1,190,5,563,0,568
test4sub84of100,test4pub21of100,1,190,5,567,0,572
test4sub21of100,test4pub21of100,1,190,5,571,1,577
test4sub65of100,test4pub21of100,1,190,5,572,1,578
test4sub42of100,test4pub21of100,1,190,5,587,0,592
test4sub35of100,test4pub21of100,1,190,5,587,1,593
test4sub28of100,test4pub21of100,1,190,5,590,1,596
test4sub82of100,test4pub21of100,1,190,5,589,2,596
test4sub22of100,test4pub21of100,1,190,5,590,1,596
test4sub86of100,test4pub21of100,1,190,5,591,1,597
test4sub74of100,test4pub21of100,1,190,5,596,0,601
test4sub77of100,test4pub21of100,1,190,5,597,1,603
test4sub91of100,test4pub21of100,1,190,5,605,0,610
test4sub59of100,test4pub21of100,1,190,5,609,0,614
test4sub67of100,test4pub21of100,1,190,5,619,0,624
test4sub20of100,test4pub21of100,1,190,5,620,2,627
test4sub70of100,test4pub21of100,1,190,5,621,2,628
test4sub15of100,test4pub21of100,1,190,5,622,1,628
test4sub56of100,test4pub21of100,1,190,5,623,1,629
test4sub68of100,test4pub21of100,1,190,5,636,1,642
test4sub14of100,test4pub21of100,1,190,5,639,1,645
test4sub85of100,test4pub21of100,1,190,5,642,1,648
test4sub39of100,test4pub21of100,1,190,5,645,1,651
test4sub51of100,test4pub21of100,1,190,5,648,1,654
test4sub49of100,test4pub21of100,1,190,5,649,0,654
test4sub45of100,test4pub21of100,1,190,5,651,1,657
test4sub79of100,test4pub21of100,1,190,5,652,1,658
test4sub69of100,test4pub21of100,1,190,5,658,1,664
test4sub64of100,test4pub21of100,1,190,5,659,1,665
test4sub57of100,test4pub21of100,1,190,5,662,0,667
test4sub72of100,test4pub21of100,1,190,5,669,0,674
test4sub40of100,test4pub21of100,1,190,5,670,1,676
test4sub33of100,test4pub21of100,1,190,5,672,1,678
test4sub26of100,test4pub21of100,1,190,5,672,1,678
test4sub76of100,test4pub21of100,1,190,5,675,1,681
test4sub29of100,test4pub21of100,1,190,5,675,2,682
test4sub18of100,test4pub21of100,1,190,5,676,1,682
test4sub48of100,test4pub21of100,1,190,5,678,1,684
test4sub87of100,test4pub21of100,1,190,5,679,1,685
test4sub53of100,test4pub21of100,1,190,5,704,1,710
test4sub19of100,test4pub21of100,1,190,5,756,1,762
test4sub95of100,test4pub21of100,1,190,5,759,1,765
test4sub27of100,test4pub21of100,1,190,5,764,1,770
test4sub9of100,test4pub21of100,1,190,5,765,1,771
test4sub88of100,test4pub21of100,1,190,5,947,1,953
test4sub11of100,test4pub22of100,1,190,5,15,1,21
test4sub72of100,test4pub22of100,1,190,5,21,1,27
test4sub34of100,test4pub22of100,1,190,5,31,1,37
test4sub89of100,test4pub21of100,1,190,5,1193,0,1198
test4sub73of100,test4pub22of100,1,190,5,40,1,46
test4sub80of100,test4pub22of100,1,190,5,47,1,53
test4sub29of100,test4pub22of100,1,190,5,70,1,76
test4sub50of100,test4pub22of100,1,190,5,72,1,78
test4sub90of100,test4pub22of100,1,190,5,92,0,97
test4sub60of100,test4pub22of100,1,190,5,105,1,111
test4sub78of100,test4pub22of100,1,190,5,107,1,113
test4sub100of100,test4pub22of100,1,190,5,110,2,117
test4sub24of100,test4pub22of100,1,190,5,111,1,117
test4sub41of100,test4pub22of100,1,190,5,120,0,125
test4sub18of100,test4pub22of100,1,190,5,122,1,128
test4sub8of100,test4pub22of100,1,190,5,124,0,129
test4sub9of100,test4pub22of100,1,190,5,126,1,132
test4sub85of100,test4pub22of100,1,190,5,127,1,133
test4sub68of100,test4pub22of100,1,190,5,128,4,137
test4sub19of100,test4pub22of100,1,190,5,129,3,137
test4sub37of100,test4pub22of100,1,190,5,130,3,138
test4sub82of100,test4pub22of100,1,190,5,130,2,137
test4sub53of100,test4pub22of100,1,190,5,130,2,137
test4sub3of100,test4pub22of100,1,190,5,137,0,142
test4sub40of100,test4pub22of100,1,190,5,143,1,149
test4sub30of100,test4pub22of100,1,190,5,149,1,155
test4sub35of100,test4pub22of100,1,190,5,151,1,157
test4sub89of100,test4pub22of100,1,190,5,155,0,160
test4sub94of100,test4pub22of100,1,190,5,158,1,164
test4sub31of100,test4pub22of100,1,190,5,171,0,176
test4sub95of100,test4pub22of100,1,190,5,176,1,182
test4sub79of100,test4pub22of100,1,190,5,205,1,211
test4sub58of100,test4pub22of100,1,190,5,230,0,235
test4sub63of100,test4pub22of100,1,190,5,254,1,260
test4sub17of100,test4pub22of100,1,190,5,275,1,281
test4sub26of100,test4pub22of100,1,190,5,280,1,286
test4sub57of100,test4pub22of100,1,190,5,293,1,299
test4sub49of100,test4pub23of100,1,190,5,36,0,41
test4sub32of100,test4pub23of100,1,190,5,39,1,45
test4sub95of100,test4pub23of100,1,190,5,43,1,49
test4sub32of100,test4pub22of100,1,190,5,315,1,321
test4sub84of100,test4pub22of100,1,190,5,326,1,332
test4sub62of100,test4pub23of100,1,190,5,62,0,67
test4sub42of100,test4pub22of100,1,190,5,335,0,340
test4sub38of100,test4pub22of100,1,190,5,344,0,349
test4sub59of100,test4pub23of100,1,190,5,73,2,80
test4sub74of100,test4pub22of100,1,190,5,345,1,351
test4sub62of100,test4pub22of100,1,190,5,346,1,352
test4sub69of100,test4pub22of100,1,190,5,352,1,358
test4sub86of100,test4pub23of100,1,190,5,82,0,87
test4sub87of100,test4pub23of100,1,190,5,89,1,95
test4sub90of100,test4pub23of100,1,190,5,98,2,105
test4sub43of100,test4pub22of100,1,190,5,370,1,376
test4sub71of100,test4pub22of100,1,190,5,387,1,393
test4sub5of100,test4pub22of100,1,190,5,390,1,396
test4sub81of100,test4pub23of100,1,190,5,129,0,134
test4sub35of100,test4pub23of100,1,190,5,133,1,139
test4sub1of100,test4pub23of100,1,190,5,136,0,141
test4sub97of100,test4pub23of100,1,190,5,136,1,142
test4sub7of100,test4pub22of100,1,190,5,409,2,416
test4sub45of100,test4pub22of100,1,190,5,410,3,418
test4sub59of100,test4pub22of100,1,190,5,411,2,418
test4sub9of100,test4pub23of100,1,190,5,141,1,147
test4sub48of100,test4pub22of100,1,190,5,432,2,439
test4sub82of100,test4pub23of100,1,190,5,162,2,169
test4sub2of100,test4pub22of100,1,190,5,434,2,441
test4sub99of100,test4pub22of100,1,190,5,440,3,448
test4sub6of100,test4pub23of100,1,190,5,170,3,178
test4sub28of100,test4pub22of100,1,190,5,441,3,449
test4sub36of100,test4pub22of100,1,190,5,441,3,449
test4sub4of100,test4pub23of100,1,190,5,171,2,178
test4sub74of100,test4pub23of100,1,190,5,171,3,179
test4sub66of100,test4pub23of100,1,190,5,175,0,180
test4sub24of100,test4pub23of100,1,190,5,182,1,188
test4sub15of100,test4pub22of100,1,190,5,461,1,467
test4sub57of100,test4pub23of100,1,190,5,190,1,196
test4sub92of100,test4pub23of100,1,190,5,192,1,198
test4sub91of100,test4pub22of100,1,190,5,464,2,471
test4sub75of100,test4pub22of100,1,190,5,465,1,471
test4sub22of100,test4pub23of100,1,190,5,198,1,204
test4sub47of100,test4pub23of100,1,190,5,204,2,211
test4sub14of100,test4pub23of100,1,190,5,204,2,211
test4sub61of100,test4pub22of100,1,190,5,476,2,483
test4sub29of100,test4pub23of100,1,190,5,205,3,213
test4sub56of100,test4pub23of100,1,190,5,206,2,213
test4sub67of100,test4pub23of100,1,190,5,208,1,214
test4sub69of100,test4pub23of100,1,190,5,211,1,217
test4sub12of100,test4pub22of100,1,190,5,485,1,491
test4sub50of100,test4pub23of100,1,190,5,215,1,221
test4sub33of100,test4pub23of100,1,190,5,219,2,226
test4sub68of100,test4pub23of100,1,190,5,219,2,226
test4sub80of100,test4pub23of100,1,190,5,220,1,226
test4sub86of100,test4pub22of100,1,190,5,491,2,498
test4sub94of100,test4pub23of100,1,190,5,223,0,228
test4sub60of100,test4pub23of100,1,190,5,225,1,231
test4sub65of100,test4pub23of100,1,190,5,226,1,232
test4sub81of100,test4pub22of100,1,190,5,502,1,508
test4sub16of100,test4pub22of100,1,190,5,503,1,509
test4sub34of100,test4pub23of100,1,190,5,235,1,241
test4sub70of100,test4pub22of100,1,190,5,510,0,515
test4sub54of100,test4pub22of100,1,190,5,512,1,518
test4sub43of100,test4pub23of100,1,190,5,242,1,248
test4sub7of100,test4pub23of100,1,190,5,256,1,262
test4sub45of100,test4pub23of100,1,190,5,258,1,264
test4sub51of100,test4pub22of100,1,190,5,531,0,536
test4sub93of100,test4pub22of100,1,190,5,532,2,539
test4sub83of100,test4pub22of100,1,190,5,533,2,540
test4sub44of100,test4pub22of100,1,190,5,534,2,541
test4sub23of100,test4pub23of100,1,190,5,263,2,270
test4sub6of100,test4pub22of100,1,190,5,537,1,543
test4sub28of100,test4pub23of100,1,190,5,266,2,273
test4sub87of100,test4pub22of100,1,190,5,538,2,545
test4sub4of100,test4pub22of100,1,190,5,539,3,547
test4sub46of100,test4pub22of100,1,190,5,541,2,548
test4sub20of100,test4pub22of100,1,190,5,541,2,548
test4sub76of100,test4pub23of100,1,190,5,271,2,278
test4sub66of100,test4pub22of100,1,190,5,542,2,549
test4sub39of100,test4pub22of100,1,190,5,548,1,554
test4sub27of100,test4pub22of100,1,190,5,551,1,557
test4sub25of100,test4pub23of100,1,190,5,280,1,286
test4sub92of100,test4pub22of100,1,190,5,556,1,562
test4sub75of100,test4pub23of100,1,190,5,292,1,298
test4sub19of100,test4pub23of100,1,190,5,292,0,297
test4sub64of100,test4pub22of100,1,190,5,565,1,571
test4sub88of100,test4pub22of100,1,190,5,570,1,576
test4sub47of100,test4pub22of100,1,190,5,573,1,579
test4sub14of100,test4pub22of100,1,190,5,574,1,580
test4sub99of100,test4pub23of100,1,190,5,304,1,310
test4sub1of100,test4pub22of100,1,190,5,581,1,587
test4sub61of100,test4pub23of100,1,190,5,311,1,317
test4sub77of100,test4pub22of100,1,190,5,583,1,589
test4sub56of100,test4pub22of100,1,190,5,589,1,595
test4sub67of100,test4pub22of100,1,190,5,596,0,601
test4sub12of100,test4pub23of100,1,190,5,328,1,334
test4sub30of100,test4pub23of100,1,190,5,333,0,338
test4sub98of100,test4pub22of100,1,190,5,605,1,611
test4sub18of100,test4pub23of100,1,190,5,336,1,342
test4sub33of100,test4pub22of100,1,190,5,609,1,615
test4sub38of100,test4pub23of100,1,190,5,339,1,345
test4sub21of100,test4pub22of100,1,190,5,612,1,618
test4sub16of100,test4pub23of100,1,190,5,352,0,357
test4sub51of100,test4pub23of100,1,190,5,376,1,382
test4sub65of100,test4pub22of100,1,190,5,654,2,661
test4sub44of100,test4pub23of100,1,190,5,384,2,391
test4sub23of100,test4pub22of100,1,190,5,656,1,662
test4sub52of100,test4pub22of100,1,190,5,664,3,672
test4sub76of100,test4pub22of100,1,190,5,664,3,672
test4sub49of100,test4pub22of100,1,190,5,665,5,675
test4sub53of100,test4pub23of100,1,190,5,394,4,403
test4sub97of100,test4pub22of100,1,190,5,666,4,675
test4sub96of100,test4pub22of100,1,190,5,666,4,675
test4sub25of100,test4pub22of100,1,190,5,668,4,677
test4sub22of100,test4pub22of100,1,190,5,668,3,676
test4sub13of100,test4pub23of100,1,190,5,398,3,406
test4sub55of100,test4pub22of100,1,190,5,670,2,677
test4sub54of100,test4pub23of100,1,190,5,405,1,411
test4sub64of100,test4pub23of100,1,190,5,406,2,413
test4sub10of100,test4pub22of100,1,190,5,678,2,685
test4sub26of100,test4pub23of100,1,190,5,407,2,414
test4sub93of100,test4pub23of100,1,190,5,408,2,415
test4sub89of100,test4pub23of100,1,190,5,409,2,416
test4sub100of100,test4pub23of100,1,190,5,410,2,417
test4sub40of100,test4pub23of100,1,190,5,411,3,419
test4sub77of100,test4pub23of100,1,190,5,413,2,420
test4sub2of100,test4pub23of100,1,190,5,412,3,420
test4sub91of100,test4pub23of100,1,190,5,414,2,421
test4sub20of100,test4pub23of100,1,190,5,415,2,422
test4sub88of100,test4pub23of100,1,190,5,416,2,423
test4sub36of100,test4pub23of100,1,190,5,424,1,430
test4sub21of100,test4pub23of100,1,190,5,445,0,450
test4sub85of100,test4pub23of100,1,190,5,446,1,452
test4sub79of100,test4pub23of100,1,190,5,451,0,456
test4sub96of100,test4pub23of100,1,190,5,495,0,500
test4sub13of100,test4pub22of100,1,190,5,766,1,772
test4sub70of100,test4pub23of100,1,190,5,498,0,503
test4sub63of100,test4pub23of100,1,190,5,501,0,506
test4sub84of100,test4pub23of100,1,190,5,501,1,507
test4sub72of100,test4pub23of100,1,190,5,508,2,515
test4sub15of100,test4pub23of100,1,190,5,509,0,514
test4sub39of100,test4pub23of100,1,190,5,516,1,522
test4sub46of100,test4pub23of100,1,190,5,517,1,523
test4sub3of100,test4pub23of100,1,190,5,518,1,524
test4sub58of100,test4pub23of100,1,190,5,520,1,526
test4sub83of100,test4pub23of100,1,190,5,522,2,529
test4sub37of100,test4pub23of100,1,190,5,523,1,529
test4sub25of100,test4pub24of100,1,190,6,28,0,34
test4sub85of100,test4pub24of100,1,190,6,33,1,40
test4sub5of100,test4pub23of100,1,190,5,553,1,559
test4sub95of100,test4pub24of100,1,190,6,35,1,42
test4sub55of100,test4pub23of100,1,190,5,568,1,574
test4sub17of100,test4pub23of100,1,190,5,571,0,576
test4sub20of100,test4pub24of100,1,190,6,58,0,64
test4sub11of100,test4pub23of100,1,190,5,585,1,591
test4sub31of100,test4pub23of100,1,190,5,589,0,594
test4sub17of100,test4pub24of100,1,190,6,88,1,95
test4sub8of100,test4pub23of100,1,190,5,609,0,614
test4sub76of100,test4pub24of100,1,190,6,92,1,99
test4sub51of100,test4pub24of100,1,190,6,94,1,101
test4sub11of100,test4pub24of100,1,190,6,95,1,102
test4sub48of100,test4pub23of100,1,190,5,616,1,622
test4sub49of100,test4pub24of100,1,190,6,101,1,108
test4sub30of100,test4pub24of100,1,190,6,103,1,110
test4sub71of100,test4pub23of100,1,190,5,624,0,629
test4sub52of100,test4pub23of100,1,190,5,629,1,635
test4sub14of100,test4pub24of100,1,190,6,110,1,117
test4sub42of100,test4pub23of100,1,190,5,634,1,640
test4sub48of100,test4pub24of100,1,190,6,115,0,121
test4sub68of100,test4pub24of100,1,190,6,124,1,131
test4sub78of100,test4pub24of100,1,190,6,125,1,132
test4sub39of100,test4pub24of100,1,190,6,131,0,137
test4sub75of100,test4pub24of100,1,190,6,137,1,144
test4sub98of100,test4pub23of100,1,190,5,676,1,682
test4sub60of100,test4pub24of100,1,190,6,158,1,165
test4sub96of100,test4pub24of100,1,190,6,159,0,165
test4sub78of100,test4pub23of100,1,190,5,683,1,689
test4sub99of100,test4pub24of100,1,190,6,176,1,183
test4sub2of100,test4pub24of100,1,190,6,177,1,184
test4sub59of100,test4pub24of100,1,190,6,178,1,185
test4sub50of100,test4pub24of100,1,190,6,179,2,187
test4sub41of100,test4pub23of100,1,190,5,699,1,705
test4sub27of100,test4pub23of100,1,190,5,700,2,707
test4sub37of100,test4pub24of100,1,190,6,182,1,189
test4sub40of100,test4pub24of100,1,190,6,186,1,193
test4sub58of100,test4pub24of100,1,190,6,199,1,206
test4sub73of100,test4pub23of100,1,190,5,721,0,726
test4sub1of100,test4pub24of100,1,190,6,204,1,211
test4sub10of100,test4pub23of100,1,190,5,724,1,730
test4sub9of100,test4pub24of100,1,190,6,213,0,219
test4sub35of100,test4pub24of100,1,190,6,224,1,231
test4sub77of100,test4pub24of100,1,190,6,228,1,235
test4sub87of100,test4pub24of100,1,190,6,230,1,237
test4sub31of100,test4pub24of100,1,190,6,230,2,238
test4sub34of100,test4pub24of100,1,190,6,231,2,239
test4sub22of100,test4pub24of100,1,190,6,232,1,239
test4sub100of100,test4pub24of100,1,190,6,233,2,241
test4sub66of100,test4pub24of100,1,190,6,237,0,243
test4sub29of100,test4pub24of100,1,190,6,237,1,244
test4sub16of100,test4pub24of100,1,190,6,243,1,250
test4sub91of100,test4pub24of100,1,190,6,246,0,252
test4sub93of100,test4pub24of100,1,190,6,246,1,253
test4sub47of100,test4pub24of100,1,190,6,249,0,255
test4sub26of100,test4pub24of100,1,190,6,251,1,258
test4sub7of100,test4pub24of100,1,190,6,255,1,262
test4sub42of100,test4pub24of100,1,190,6,255,1,262
test4sub90of100,test4pub24of100,1,190,6,263,1,270
test4sub89of100,test4pub24of100,1,190,6,286,2,294
test4sub74of100,test4pub24of100,1,190,6,286,3,295
test4sub65of100,test4pub24of100,1,190,6,287,2,295
test4sub70of100,test4pub24of100,1,190,6,288,1,295
test4sub28of100,test4pub24of100,1,190,6,300,1,307
test4sub64of100,test4pub24of100,1,190,6,311,1,318
test4sub71of100,test4pub24of100,1,190,6,328,1,335
test4sub46of100,test4pub24of100,1,190,6,331,1,338
test4sub97of100,test4pub24of100,1,190,6,334,1,341
test4sub10of100,test4pub24of100,1,190,6,341,0,347
test4sub3of100,test4pub24of100,1,190,6,349,0,355
test4sub69of100,test4pub24of100,1,190,6,380,1,387
test4sub54of100,test4pub24of100,1,190,6,380,1,387
test4sub18of100,test4pub24of100,1,190,6,390,1,397
test4sub12of100,test4pub25of100,1,190,5,14,1,20
test4sub53of100,test4pub25of100,1,190,5,45,0,50
test4sub67of100,test4pub24of100,1,190,6,431,1,438
test4sub25of100,test4pub25of100,1,190,5,63,1,69
test4sub63of100,test4pub24of100,1,190,6,445,1,452
test4sub98of100,test4pub25of100,1,190,5,75,1,81
test4sub4of100,test4pub24of100,1,190,6,457,1,464
test4sub23of100,test4pub24of100,1,190,6,463,1,470
test4sub10of100,test4pub25of100,1,190,5,86,1,92
test4sub33of100,test4pub25of100,1,190,5,93,1,99
test4sub81of100,test4pub24of100,1,190,6,474,1,481
test4sub21of100,test4pub24of100,1,190,6,480,1,487
test4sub12of100,test4pub24of100,1,190,6,483,0,489
test4sub66of100,test4pub25of100,1,190,5,104,1,110
test4sub43of100,test4pub24of100,1,190,6,485,1,492
test4sub67of100,test4pub25of100,1,190,5,115,1,121
test4sub15of100,test4pub24of100,1,190,6,513,1,520
test4sub93of100,test4pub25of100,1,190,5,135,0,140
test4sub53of100,test4pub24of100,1,190,6,521,1,528
test4sub31of100,test4pub25of100,1,190,5,145,1,151
test4sub36of100,test4pub24of100,1,190,6,534,1,541
test4sub24of100,test4pub24of100,1,190,6,535,0,541
test4sub36of100,test4pub25of100,1,190,5,157,1,163
test4sub33of100,test4pub24of100,1,190,6,540,1,547
test4sub32of100,test4pub24of100,1,190,6,543,1,550
test4sub84of100,test4pub24of100,1,190,6,543,1,550
test4sub11of100,test4pub25of100,1,190,5,165,1,171
test4sub83of100,test4pub25of100,1,190,5,166,1,172
test4sub19of100,test4pub25of100,1,190,5,173,1,179
test4sub8of100,test4pub25of100,1,190,5,174,1,180
test4sub62of100,test4pub25of100,1,190,5,180,1,186
test4sub42of100,test4pub25of100,1,190,5,182,1,188
test4sub23of100,test4pub25of100,1,190,5,186,1,192
test4sub56of100,test4pub24of100,1,190,6,568,1,575
test4sub57of100,test4pub25of100,1,190,5,191,0,196
test4sub92of100,test4pub24of100,1,190,6,572,0,578
test4sub80of100,test4pub25of100,1,190,5,199,1,205
test4sub98of100,test4pub24of100,1,190,6,591,0,597
test4sub85of100,test4pub25of100,1,190,5,214,1,220
test4sub44of100,test4pub25of100,1,190,5,234,1,240
test4sub97of100,test4pub25of100,1,190,5,235,1,241
test4sub20of100,test4pub25of100,1,190,5,238,0,243
test4sub88of100,test4pub24of100,1,190,6,619,0,625
test4sub68of100,test4pub25of100,1,190,5,245,1,251
test4sub18of100,test4pub25of100,1,190,5,247,0,252
test4sub62of100,test4pub24of100,1,190,6,627,1,634
test4sub80of100,test4pub24of100,1,190,6,628,1,635
test4sub52of100,test4pub24of100,1,190,6,635,1,642
test4sub82of100,test4pub25of100,1,190,5,260,2,267
test4sub38of100,test4pub24of100,1,190,6,641,1,648
test4sub8of100,test4pub24of100,1,190,6,641,2,649
test4sub28of100,test4pub25of100,1,190,5,262,2,269
test4sub69of100,test4pub25of100,1,190,5,266,1,272
test4sub6of100,test4pub25of100,1,190,5,267,1,273
test4sub41of100,test4pub25of100,1,190,5,272,1,278
test4sub91of100,test4pub25of100,1,190,5,273,1,279
test4sub82of100,test4pub24of100,1,190,6,657,1,664
test4sub4of100,test4pub25of100,1,190,5,280,0,285
test4sub54of100,test4pub25of100,1,190,5,293,1,299
test4sub50of100,test4pub25of100,1,190,5,295,1,301
test4sub41of100,test4pub24of100,1,190,6,680,1,687
test4sub34of100,test4pub25of100,1,190,5,303,2,310
test4sub44of100,test4pub24of100,1,190,6,690,2,698
test4sub24of100,test4pub25of100,1,190,5,311,2,318
test4sub14of100,test4pub25of100,1,190,5,315,1,321
test4sub22of100,test4pub26of100,1,190,6,23,2,31
test4sub61of100,test4pub24of100,1,190,6,695,2,703
test4sub58of100,test4pub25of100,1,190,5,317,0,322
test4sub49of100,test4pub26of100,1,190,6,29,0,35
test4sub32of100,test4pub25of100,1,190,5,344,0,349
test4sub83of100,test4pub24of100,1,190,6,726,0,732
test4sub17of100,test4pub25of100,1,190,5,351,1,357
test4sub64of100,test4pub26of100,1,190,6,69,1,76
test4sub59of100,test4pub26of100,1,190,6,70,1,77
test4sub87of100,test4pub25of100,1,190,5,362,1,368
test4sub6of100,test4pub24of100,1,190,6,745,0,751
test4sub13of100,test4pub24of100,1,190,6,747,2,755
test4sub73of100,test4pub24of100,1,190,6,746,1,753
test4sub95of100,test4pub26of100,1,190,6,77,2,85
test4sub63of100,test4pub25of100,1,190,5,368,1,374
test4sub29of100,test4pub26of100,1,190,6,92,1,99
test4sub19of100,test4pub24of100,1,190,6,769,1,776
test4sub20of100,test4pub26of100,1,190,6,99,1,106
test4sub65of100,test4pub26of100,1,190,6,100,1,107
test4sub92of100,test4pub25of100,1,190,5,399,1,405
test4sub9of100,test4pub25of100,1,190,5,400,1,406
test4sub16of100,test4pub25of100,1,190,5,402,0,407
test4sub12of100,test4pub26of100,1,190,6,126,1,133
test4sub6of100,test4pub26of100,1,190,6,130,1,137
test4sub97of100,test4pub26of100,1,190,6,138,1,145
test4sub86of100,test4pub24of100,1,190,6,809,0,815
test4sub5of100,test4pub24of100,1,190,6,817,1,824
test4sub57of100,test4pub26of100,1,190,6,153,0,159
test4sub27of100,test4pub26of100,1,190,6,155,1,162
test4sub79of100,test4pub24of100,1,190,6,826,1,833
test4sub76of100,test4pub25of100,1,190,5,448,1,454
test4sub85of100,test4pub26of100,1,190,6,158,0,164
test4sub99of100,test4pub25of100,1,190,5,453,1,459
test4sub90of100,test4pub26of100,1,190,6,163,1,170
test4sub65of100,test4pub25of100,1,190,5,548,3,556
test4sub94of100,test4pub25of100,1,190,5,457,1,463
test4sub19of100,test4pub26of100,1,190,6,257,5,268
test4sub45of100,test4pub24of100,1,190,6,838,0,844
test4sub81of100,test4pub25of100,1,190,5,460,1,466
test4sub43of100,test4pub26of100,1,190,6,171,2,179
test4sub66of100,test4pub26of100,1,190,6,172,1,179
test4sub55of100,test4pub24of100,1,190,6,843,1,850
test4sub1of100,test4pub25of100,1,190,5,466,0,471
test4sub75of100,test4pub25of100,1,190,5,469,1,475
test4sub72of100,test4pub24of100,1,190,6,852,1,859
test4sub38of100,test4pub25of100,1,190,5,502,1,508
test4sub80of100,test4pub26of100,1,190,6,216,1,223
test4sub18of100,test4pub26of100,1,190,6,216,2,224
test4sub15of100,test4pub26of100,1,190,6,218,1,225
test4sub56of100,test4pub26of100,1,190,6,217,3,226
test4sub50of100,test4pub26of100,1,190,6,219,1,226
test4sub46of100,test4pub25of100,1,190,5,513,0,518
test4sub78of100,test4pub25of100,1,190,5,517,0,522
test4sub68of100,test4pub26of100,1,190,6,229,1,236
test4sub74of100,test4pub25of100,1,190,5,520,2,527
test4sub60of100,test4pub25of100,1,190,5,521,1,527
test4sub17of100,test4pub26of100,1,190,6,231,2,239
test4sub95of100,test4pub25of100,1,190,5,523,4,532
test4sub100of100,test4pub26of100,1,190,6,232,3,241
test4sub37of100,test4pub25of100,1,190,5,524,3,532
test4sub44of100,test4pub26of100,1,190,6,234,3,243
test4sub7of100,test4pub25of100,1,190,5,525,2,532
test4sub71of100,test4pub25of100,1,190,5,526,1,532
test4sub21of100,test4pub26of100,1,190,6,239,1,246
test4sub83of100,test4pub26of100,1,190,6,240,2,248
test4sub62of100,test4pub26of100,1,190,6,241,0,247
test4sub48of100,test4pub26of100,1,190,6,243,1,250
test4sub70of100,test4pub26of100,1,190,6,244,1,251
test4sub89of100,test4pub25of100,1,190,5,540,0,545
test4sub96of100,test4pub25of100,1,190,5,542,0,547
test4sub27of100,test4pub24of100,1,190,6,929,7,942
test4sub57of100,test4pub24of100,1,190,6,929,8,943
test4sub79of100,test4pub26of100,1,190,6,259,7,272
test4sub99of100,test4pub26of100,1,190,6,260,6,272
test4sub90of100,test4pub25of100,1,190,5,551,7,563
test4sub30of100,test4pub25of100,1,190,5,552,7,564
test4sub94of100,test4pub24of100,1,190,6,933,7,946
test4sub45of100,test4pub25of100,1,190,5,553,6,564
test4sub56of100,test4pub25of100,1,190,5,556,3,564
test4sub49of100,test4pub25of100,1,190,5,566,1,572
test4sub55of100,test4pub25of100,1,190,5,575,1,581
test4sub86of100,test4pub25of100,1,190,5,576,1,582
test4sub52of100,test4pub25of100,1,190,5,594,1,600
test4sub84of100,test4pub25of100,1,190,5,610,1,616
test4sub35of100,test4pub25of100,1,190,5,612,0,617
test4sub79of100,test4pub25of100,1,190,5,640,1,646
test4sub77of100,test4pub26of100,1,190,6,351,1,358
test4sub88of100,test4pub26of100,1,190,6,356,1,363
test4sub29of100,test4pub25of100,1,190,5,651,1,657
test4sub22of100,test4pub25of100,1,190,5,652,1,658
test4sub43of100,test4pub25of100,1,190,5,653,1,659
test4sub74of100,test4pub26of100,1,190,6,363,1,370
test4sub7of100,test4pub26of100,1,190,6,366,1,373
test4sub8of100,test4pub26of100,1,190,6,367,0,373
test4sub33of100,test4pub26of100,1,190,6,368,1,375
test4sub46of100,test4pub26of100,1,190,6,369,1,376
test4sub25of100,test4pub26of100,1,190,6,372,1,379
test4sub59of100,test4pub25of100,1,190,5,664,1,670
test4sub71of100,test4pub26of100,1,190,6,372,3,381
test4sub100of100,test4pub25of100,1,190,5,665,1,671
test4sub2of100,test4pub26of100,1,190,6,382,2,390
test4sub70of100,test4pub25of100,1,190,5,674,2,681
test4sub40of100,test4pub26of100,1,190,6,383,2,391
test4sub5of100,test4pub25of100,1,190,5,675,2,682
test4sub89of100,test4pub26of100,1,190,6,386,1,393
test4sub30of100,test4pub26of100,1,190,6,387,3,396
test4sub94of100,test4pub26of100,1,190,6,388,1,395
test4sub39of100,test4pub25of100,1,190,5,680,2,687
test4sub54of100,test4pub26of100,1,190,6,392,1,399
test4sub45of100,test4pub26of100,1,190,6,395,1,402
test4sub87of100,test4pub26of100,1,190,6,399,0,405
test4sub86of100,test4pub26of100,1,190,6,447,0,453
test4sub51of100,test4pub25of100,1,190,5,740,1,746
test4sub15of100,test4pub25of100,1,190,5,744,1,750
test4sub21of100,test4pub25of100,1,190,5,746,1,752
test4sub31of100,test4pub26of100,1,190,6,464,0,470
test4sub76of100,test4pub26of100,1,190,6,466,1,473
test4sub61of100,test4pub25of100,1,190,5,758,1,764
test4sub73of100,test4pub25of100,1,190,5,759,1,765
test4sub53of100,test4pub26of100,1,190,6,477,1,484
test4sub4of100,test4pub26of100,1,190,6,482,4,492
test4sub35of100,test4pub26of100,1,190,6,483,3,492
test4sub64of100,test4pub25of100,1,190,5,775,3,783
test4sub16of100,test4pub26of100,1,190,6,485,12,503
test4sub72of100,test4pub25of100,1,190,5,779,10,794
test4sub47of100,test4pub26of100,1,190,6,489,10,505
test4sub3of100,test4pub25of100,1,190,5,780,10,795
test4sub26of100,test4pub25of100,1,190,5,781,11,797
test4sub93of100,test4pub26of100,1,190,6,490,12,508
test4sub42of100,test4pub26of100,1,190,6,491,11,508
test4sub27of100,test4pub25of100,1,190,5,783,11,799
test4sub48of100,test4pub25of100,1,190,5,784,12,801
test4sub13of100,test4pub25of100,1,190,5,785,13,803
test4sub52of100,test4pub26of100,1,190,6,495,11,512
test4sub77of100,test4pub25of100,1,190,5,787,11,803
test4sub88of100,test4pub25of100,1,190,5,792,9,806
test4sub91of100,test4pub26of100,1,190,6,505,7,518
test4sub60of100,test4pub26of100,1,190,6,509,3,518
test4sub63of100,test4pub26of100,1,190,6,509,4,519
test4sub38of100,test4pub26of100,1,190,6,510,3,519
test4sub37of100,test4pub26of100,1,190,6,511,4,521
test4sub9of100,test4pub26of100,1,190,6,541,1,548
test4sub81of100,test4pub26of100,1,190,6,541,2,549
test4sub14of100,test4pub26of100,1,190,6,542,1,549
test4sub24of100,test4pub26of100,1,190,6,551,1,558
test4sub82of100,test4pub26of100,1,190,6,551,0,557
test4sub32of100,test4pub26of100,1,190,6,553,1,560
test4sub2of100,test4pub25of100,1,190,5,859,0,864
test4sub5of100,test4pub26of100,1,190,6,568,1,575
test4sub39of100,test4pub26of100,1,190,6,588,1,595
test4sub36of100,test4pub26of100,1,190,6,592,0,598
test4sub78of100,test4pub26of100,1,190,6,601,1,608
test4sub98of100,test4pub26of100,1,190,6,602,1,609
test4sub11of100,test4pub26of100,1,190,6,603,0,609
test4sub69of100,test4pub26of100,1,190,6,604,1,611
test4sub58of100,test4pub26of100,1,190,6,608,0,614
test4sub41of100,test4pub26of100,1,190,6,611,1,618
test4sub47of100,test4pub25of100,1,190,5,905,1,911
test4sub55of100,test4pub26of100,1,190,6,614,1,621
test4sub3of100,test4pub26of100,1,190,6,620,0,626
test4sub34of100,test4pub26of100,1,190,6,620,1,627
test4sub26of100,test4pub26of100,1,190,6,622,1,629
test4sub72of100,test4pub26of100,1,190,6,621,2,629
test4sub23of100,test4pub26of100,1,190,6,624,1,631
test4sub10of100,test4pub26of100,1,190,6,626,1,633
test4sub75of100,test4pub26of100,1,190,6,629,0,635
test4sub13of100,test4pub26of100,1,190,6,634,0,640
test4sub28of100,test4pub26of100,1,190,6,639,1,646
test4sub84of100,test4pub26of100,1,190,6,652,0,658
test4sub17of100,test4pub27of100,1,190,5,24,0,29
test4sub18of100,test4pub27of100,1,190,5,30,0,35
test4sub4of100,test4pub27of100,1,190,5,42,1,48
test4sub44of100,test4pub27of100,1,190,5,52,1,58
test4sub42of100,test4pub27of100,1,190,5,58,1,64
test4sub94of100,test4pub27of100,1,190,5,68,1,74
test4sub50of100,test4pub27of100,1,190,5,73,1,79
test4sub24of100,test4pub27of100,1,190,5,73,0,78
test4sub51of100,test4pub26of100,1,190,6,841,0,847
test4sub45of100,test4pub27of100,1,190,5,115,1,121
test4sub19of100,test4pub27of100,1,190,5,120,1,126
test4sub77of100,test4pub27of100,1,190,5,122,1,128
test4sub49of100,test4pub27of100,1,190,5,124,1,130
test4sub79of100,test4pub27of100,1,190,5,125,1,131
test4sub55of100,test4pub27of100,1,190,5,126,1,132
test4sub26of100,test4pub27of100,1,190,5,129,1,135
test4sub90of100,test4pub27of100,1,190,5,130,2,137
test4sub86of100,test4pub27of100,1,190,5,131,1,137
test4sub48of100,test4pub27of100,1,190,5,131,2,138
test4sub34of100,test4pub27of100,1,190,5,141,1,147
test4sub72of100,test4pub27of100,1,190,5,143,1,149
test4sub62of100,test4pub27of100,1,190,5,143,1,149
test4sub40of100,test4pub25of100,1,190,5,1204,0,1209
test4sub74of100,test4pub27of100,1,190,5,156,0,161
test4sub39of100,test4pub27of100,1,190,5,163,0,168
test4sub65of100,test4pub27of100,1,190,5,163,1,169
test4sub14of100,test4pub27of100,1,190,5,165,0,170
test4sub97of100,test4pub27of100,1,190,5,173,1,179
test4sub73of100,test4pub26of100,1,190,6,937,1,944
test4sub33of100,test4pub27of100,1,190,5,203,1,209
test4sub68of100,test4pub27of100,1,190,5,204,0,209
test4sub93of100,test4pub27of100,1,190,5,228,1,234
test4sub16of100,test4pub27of100,1,190,5,232,1,238
test4sub8of100,test4pub27of100,1,190,5,240,1,246
test4sub96of100,test4pub26of100,1,190,6,1005,0,1011
test4sub41of100,test4pub27of100,1,190,5,266,1,272
test4sub67of100,test4pub26of100,1,190,6,1033,1,1040
test4sub32of100,test4pub27of100,1,190,5,275,1,281
test4sub96of100,test4pub27of100,1,190,5,276,1,282
test4sub47of100,test4pub27of100,1,190,5,286,1,292
test4sub67of100,test4pub27of100,1,190,5,295,1,301
test4sub71of100,test4pub27of100,1,190,5,301,1,307
test4sub13of100,test4pub27of100,1,190,5,301,1,307
test4sub85of100,test4pub27of100,1,190,5,311,1,317
test4sub63of100,test4pub27of100,1,190,5,317,1,323
test4sub100of100,test4pub27of100,1,190,5,319,0,324
test4sub80of100,test4pub27of100,1,190,5,326,0,331
test4sub98of100,test4pub28of100,1,190,5,27,1,33
test4sub96of100,test4pub28of100,1,190,5,27,1,33
test4sub23of100,test4pub28of100,1,190,5,29,0,34
test4sub85of100,test4pub28of100,1,190,5,30,1,36
test4sub16of100,test4pub28of100,1,190,5,31,0,36
test4sub92of100,test4pub26of100,1,190,6,1100,1,1107
test4sub23of100,test4pub27of100,1,190,5,350,0,355
test4sub52of100,test4pub27of100,1,190,5,357,1,363
test4sub12of100,test4pub27of100,1,190,5,359,0,364
test4sub25of100,test4pub27of100,1,190,5,361,1,367
test4sub32of100,test4pub28of100,1,190,5,58,2,65
test4sub92of100,test4pub27of100,1,190,5,362,1,368
test4sub60of100,test4pub27of100,1,190,5,363,2,370
test4sub93of100,test4pub28of100,1,190,5,68,1,74
test4sub6of100,test4pub28of100,1,190,5,73,0,78
test4sub87of100,test4pub27of100,1,190,5,380,1,386
test4sub74of100,test4pub28of100,1,190,5,79,1,85
test4sub52of100,test4pub28of100,1,190,5,86,1,92
test4sub99of100,test4pub27of100,1,190,5,389,0,394
test4sub50of100,test4pub28of100,1,190,5,89,1,95
test4sub20of100,test4pub27of100,1,190,5,411,0,416
test4sub80of100,test4pub28of100,1,190,5,117,1,123
test4sub24of100,test4pub28of100,1,190,5,122,1,128
test4sub26of100,test4pub28of100,1,190,5,123,0,128
test4sub31of100,test4pub27of100,1,190,5,435,1,441
test4sub37of100,test4pub27of100,1,190,5,436,1,442
test4sub42of100,test4pub28of100,1,190,5,139,0,144
test4sub61of100,test4pub26of100,1,190,6,1208,1,1215
test4sub54of100,test4pub28of100,1,190,5,155,0,160
test4sub70of100,test4pub27of100,1,190,5,465,2,472
test4sub76of100,test4pub27of100,1,190,5,465,2,472
test4sub49of100,test4pub28of100,1,190,5,163,2,170
test4sub13of100,test4pub28of100,1,190,5,163,2,170
test4sub43of100,test4pub28of100,1,190,5,164,2,171
test4sub83of100,test4pub27of100,1,190,5,469,3,477
test4sub95of100,test4pub28of100,1,190,5,167,2,174
test4sub48of100,test4pub28of100,1,190,5,168,3,176
test4sub19of100,test4pub28of100,1,190,5,168,3,176
test4sub29of100,test4pub27of100,1,190,5,472,3,480
test4sub62of100,test4pub28of100,1,190,5,171,2,178
test4sub56of100,test4pub28of100,1,190,5,172,1,178
test4sub5of100,test4pub28of100,1,190,5,175,1,181
test4sub36of100,test4pub27of100,1,190,5,479,3,487
test4sub31of100,test4pub28of100,1,190,5,177,2,184
test4sub71of100,test4pub28of100,1,190,5,177,2,184
test4sub37of100,test4pub28of100,1,190,5,178,2,185
test4sub46of100,test4pub28of100,1,190,5,181,1,187
test4sub65of100,test4pub28of100,1,190,5,185,0,190
test4sub38of100,test4pub27of100,1,190,5,488,1,494
test4sub64of100,test4pub27of100,1,190,5,492,0,497
test4sub78of100,test4pub28of100,1,190,5,194,0,199
test4sub35of100,test4pub27of100,1,190,5,504,1,510
test4sub40of100,test4pub27of100,1,190,5,508,0,513
test4sub87of100,test4pub28of100,1,190,5,209,1,215
test4sub84of100,test4pub28of100,1,190,5,225,1,231
test4sub58of100,test4pub27of100,1,190,5,534,0,539
test4sub11of100,test4pub27of100,1,190,5,537,0,542
test4sub69of100,test4pub27of100,1,190,5,539,2,546
test4sub99of100,test4pub28of100,1,190,5,237,1,243
test4sub55of100,test4pub28of100,1,190,5,237,2,244
test4sub20of100,test4pub28of100,1,190,5,238,1,244
test4sub9of100,test4pub28of100,1,190,5,245,1,251
test4sub27of100,test4pub27of100,1,190,5,557,0,562
test4sub21of100,test4pub27of100,1,190,5,565,1,571
test4sub22of100,test4pub27of100,1,190,5,566,0,571
test4sub6of100,test4pub27of100,1,190,5,571,1,577
test4sub47of100,test4pub28of100,1,190,5,278,0,283
test4sub2of100,test4pub27of100,1,190,5,582,0,587
test4sub75of100,test4pub27of100,1,190,5,587,1,593
test4sub98of100,test4pub27of100,1,190,5,588,0,593
test4sub81of100,test4pub27of100,1,190,5,590,0,595
test4sub53of100,test4pub27of100,1,190,5,592,1,598
test4sub61of100,test4pub27of100,1,190,5,593,1,599
test4sub28of100,test4pub28of100,1,190,5,291,1,297
test4sub88of100,test4pub27of100,1,190,5,595,1,601
test4sub79of100,test4pub28of100,1,190,5,293,0,298
test4sub57of100,test4pub27of100,1,190,5,600,1,606
test4sub44of100,test4pub28of100,1,190,5,306,1,312
test4sub82of100,test4pub27of100,1,190,5,638,0,643
test4sub59of100,test4pub27of100,1,190,5,695,1,701
test4sub56of100,test4pub27of100,1,190,5,696,0,701
test4sub95of100,test4pub27of100,1,190,5,699,1,705
test4sub51of100,test4pub28of100,1,190,5,409,1,415
test4sub5of100,test4pub27of100,1,190,5,712,1,718
test4sub39of100,test4pub28of100,1,190,5,414,1,420
test4sub66of100,test4pub27of100,1,190,5,717,2,724
test4sub94of100,test4pub28of100,1,190,5,415,1,421
test4sub7of100,test4pub28of100,1,190,5,418,1,424
test4sub43of100,test4pub27of100,1,190,5,722,1,728
test4sub10of100,test4pub28of100,1,190,5,419,1,425
test4sub3of100,test4pub27of100,1,190,5,725,1,731
test4sub17of100,test4pub28of100,1,190,5,423,1,429
test4sub1of100,test4pub26of100,1,190,6,1486,1,1493
test4sub30of100,test4pub28of100,1,190,5,426,1,432
test4sub73of100,test4pub27of100,1,190,5,732,1,738
test4sub18of100,test4pub28of100,1,190,5,434,0,439
test4sub54of100,test4pub27of100,1,190,5,739,0,744
test4sub15of100,test4pub27of100,1,190,5,740,1,746
test4sub86of100,test4pub28of100,1,190,5,445,1,451
test4sub89of100,test4pub28of100,1,190,5,447,0,452
test4sub25of100,test4pub28of100,1,190,5,447,4,456
test4sub68of100,test4pub28of100,1,190,5,448,3,456
test4sub67of100,test4pub28of100,1,190,5,449,4,458
test4sub36of100,test4pub28of100,1,190,5,449,4,458
test4sub60of100,test4pub28of100,1,190,5,450,3,458
test4sub97of100,test4pub28of100,1,190,5,451,4,460
test4sub33of100,test4pub28of100,1,190,5,452,4,461
test4sub12of100,test4pub28of100,1,190,5,454,2,461
test4sub63of100,test4pub28of100,1,190,5,453,3,461
test4sub46of100,test4pub27of100,1,190,5,758,2,765
test4sub90of100,test4pub28of100,1,190,5,460,0,465
test4sub77of100,test4pub28of100,1,190,5,462,2,469
test4sub92of100,test4pub28of100,1,190,5,463,1,469
test4sub83of100,test4pub28of100,1,190,5,479,1,485
test4sub38of100,test4pub28of100,1,190,5,489,1,495
test4sub78of100,test4pub27of100,1,190,5,793,1,799
test4sub64of100,test4pub28of100,1,190,5,490,2,497
test4sub45of100,test4pub28of100,1,190,5,491,1,497
test4sub8of100,test4pub28of100,1,190,5,492,1,498
test4sub35of100,test4pub28of100,1,190,5,493,1,499
test4sub76of100,test4pub28of100,1,190,5,494,1,500
test4sub70of100,test4pub28of100,1,190,5,496,1,502
test4sub84of100,test4pub27of100,1,190,5,800,0,805
test4sub11of100,test4pub28of100,1,190,5,502,1,508
test4sub69of100,test4pub28of100,1,190,5,508,1,514
test4sub9of100,test4pub27of100,1,190,5,812,1,818
test4sub27of100,test4pub28of100,1,190,5,513,1,519
test4sub21of100,test4pub28of100,1,190,5,513,2,520
test4sub22of100,test4pub28of100,1,190,5,514,3,522
test4sub58of100,test4pub28of100,1,190,5,515,3,523
test4sub14of100,test4pub28of100,1,190,5,516,4,525
test4sub2of100,test4pub28of100,1,190,5,515,4,524
test4sub75of100,test4pub28of100,1,190,5,517,5,527
test4sub81of100,test4pub28of100,1,190,5,518,4,527
test4sub61of100,test4pub28of100,1,190,5,519,5,529
test4sub53of100,test4pub28of100,1,190,5,519,6,530
test4sub28of100,test4pub27of100,1,190,5,823,5,833
test4sub88of100,test4pub28of100,1,190,5,522,5,532
test4sub100of100,test4pub28of100,1,190,5,521,4,530
test4sub57of100,test4pub28of100,1,190,5,523,3,531
test4sub34of100,test4pub28of100,1,190,5,524,3,532
test4sub72of100,test4pub28of100,1,190,5,525,3,533
test4sub4of100,test4pub28of100,1,190,5,533,1,539
test4sub66of100,test4pub28of100,1,190,5,533,0,538
test4sub7of100,test4pub27of100,1,190,5,843,0,848
test4sub40of100,test4pub28of100,1,190,5,555,1,561
test4sub29of100,test4pub28of100,1,190,5,568,1,574
test4sub10of100,test4pub27of100,1,190,5,874,1,880
test4sub3of100,test4pub28of100,1,190,5,572,0,577
test4sub1of100,test4pub27of100,1,190,5,882,1,888
test4sub30of100,test4pub27of100,1,190,5,883,2,890
test4sub1of100,test4pub28of100,1,190,5,580,1,586
test4sub73of100,test4pub28of100,1,190,5,582,2,589
test4sub41of100,test4pub28of100,1,190,5,583,2,590
test4sub15of100,test4pub28of100,1,190,5,583,1,589
test4sub51of100,test4pub27of100,1,190,5,889,1,895
test4sub89of100,test4pub27of100,1,190,5,890,0,895
test4sub91of100,test4pub28of100,1,190,5,680,0,685
test4sub76of100,test4pub29of100,1,190,5,21,1,27
test4sub91of100,test4pub27of100,1,190,5,985,0,990
test4sub55of100,test4pub29of100,1,190,5,25,1,31
test4sub11of100,test4pub29of100,1,190,5,75,1,81
test4sub96of100,test4pub29of100,1,190,5,77,1,83
test4sub85of100,test4pub29of100,1,190,5,76,1,82
test4sub57of100,test4pub29of100,1,190,5,79,0,84
test4sub72of100,test4pub29of100,1,190,5,82,1,88
test4sub4of100,test4pub29of100,1,190,5,85,1,91
test4sub77of100,test4pub29of100,1,190,5,86,1,92
test4sub74of100,test4pub29of100,1,190,5,89,0,94
test4sub9of100,test4pub29of100,1,190,5,91,0,96
test4sub90of100,test4pub29of100,1,190,5,93,0,98
test4sub48of100,test4pub29of100,1,190,5,100,1,106
test4sub93of100,test4pub29of100,1,190,5,135,0,140
test4sub87of100,test4pub29of100,1,190,5,137,1,143
test4sub91of100,test4pub29of100,1,190,5,139,0,144
test4sub2of100,test4pub29of100,1,190,5,149,0,154
test4sub32of100,test4pub29of100,1,190,5,165,1,171
test4sub92of100,test4pub29of100,1,190,5,166,1,172
test4sub6of100,test4pub29of100,1,190,5,169,1,175
test4sub100of100,test4pub29of100,1,190,5,169,1,175
test4sub50of100,test4pub29of100,1,190,5,172,1,178
test4sub78of100,test4pub29of100,1,190,5,174,0,179
test4sub95of100,test4pub29of100,1,190,5,175,3,183
test4sub41of100,test4pub29of100,1,190,5,176,2,183
test4sub60of100,test4pub29of100,1,190,5,176,1,182
test4sub27of100,test4pub29of100,1,190,5,182,1,188
test4sub63of100,test4pub29of100,1,190,5,182,2,189
test4sub29of100,test4pub29of100,1,190,5,183,0,188
test4sub73of100,test4pub29of100,1,190,5,186,0,191
test4sub1of100,test4pub29of100,1,190,5,194,1,200
test4sub37of100,test4pub29of100,1,190,5,195,2,202
test4sub3of100,test4pub29of100,1,190,5,196,1,202
test4sub14of100,test4pub29of100,1,190,5,197,1,203
test4sub58of100,test4pub29of100,1,190,5,202,1,208
test4sub83of100,test4pub29of100,1,190,5,203,1,209
test4sub65of100,test4pub29of100,1,190,5,211,1,217
test4sub30of100,test4pub29of100,1,190,5,226,0,231
test4sub68of100,test4pub29of100,1,190,5,230,0,235
test4sub67of100,test4pub29of100,1,190,5,232,1,238
test4sub62of100,test4pub29of100,1,190,5,233,0,238
test4sub86of100,test4pub29of100,1,190,5,241,1,247
test4sub71of100,test4pub29of100,1,190,5,242,0,247
test4sub13of100,test4pub29of100,1,190,5,250,1,256
test4sub26of100,test4pub29of100,1,190,5,251,1,257
test4sub16of100,test4pub29of100,1,190,5,253,1,259
test4sub53of100,test4pub29of100,1,190,5,254,2,261
test4sub7of100,test4pub29of100,1,190,5,255,2,262
test4sub24of100,test4pub29of100,1,190,5,255,2,262
test4sub98of100,test4pub29of100,1,190,5,256,1,262
test4sub36of100,test4pub29of100,1,190,5,258,1,264
test4sub64of100,test4pub29of100,1,190,5,258,1,264
test4sub66of100,test4pub29of100,1,190,5,261,0,266
test4sub81of100,test4pub29of100,1,190,5,295,1,301
test4sub97of100,test4pub29of100,1,190,5,305,1,311
test4sub8of100,test4pub29of100,1,190,5,310,1,316
test4sub17of100,test4pub29of100,1,190,5,320,1,326
test4sub38of100,test4pub29of100,1,190,5,331,1,337
test4sub61of100,test4pub29of100,1,190,5,336,1,342
test4sub49of100,test4pub29of100,1,190,5,346,1,352
test4sub23of100,test4pub29of100,1,190,5,348,1,354
test4sub15of100,test4pub29of100,1,190,5,359,1,365
test4sub31of100,test4pub29of100,1,190,5,361,0,366
test4sub82of100,test4pub28of100,1,190,5,1026,1,1032
test4sub34of100,test4pub29of100,1,190,5,384,1,390
test4sub42of100,test4pub29of100,1,190,5,386,1,392
test4sub47of100,test4pub29of100,1,190,5,392,1,398
test4sub51of100,test4pub29of100,1,190,5,393,1,399
test4sub46of100,test4pub29of100,1,190,5,394,1,400
test4sub20of100,test4pub29of100,1,190,5,401,1,407
test4sub33of100,test4pub29of100,1,190,5,419,1,425
test4sub89of100,test4pub29of100,1,190,5,422,1,428
test4sub80of100,test4pub29of100,1,190,5,427,0,432
test4sub22of100,test4pub29of100,1,190,5,446,1,452
test4sub21of100,test4pub29of100,1,190,5,463,0,468
test4sub84of100,test4pub29of100,1,190,5,481,1,487
test4sub10of100,test4pub29of100,1,190,5,485,0,490
test4sub88of100,test4pub29of100,1,190,5,489,0,494
test4sub70of100,test4pub29of100,1,190,5,494,0,499
test4sub56of100,test4pub29of100,1,190,5,511,1,517
test4sub1of100,test4pub30of100,1,190,5,33,0,38
test4sub31of100,test4pub30of100,1,190,5,35,0,40
test4sub39of100,test4pub29of100,1,190,5,529,1,535
test4sub35of100,test4pub29of100,1,190,5,530,0,535
test4sub78of100,test4pub30of100,1,190,5,49,1,55
test4sub73of100,test4pub30of100,1,190,5,68,1,74
test4sub23of100,test4pub30of100,1,190,5,69,1,75
test4sub61of100,test4pub30of100,1,190,5,76,1,82
test4sub6of100,test4pub30of100,1,190,5,87,1,93
test4sub44of100,test4pub29of100,1,190,5,575,2,582
test4sub12of100,test4pub29of100,1,190,5,576,1,582
test4sub72of100,test4pub30of100,1,190,5,94,1,100
test4sub5of100,test4pub29of100,1,190,5,579,1,585
test4sub79of100,test4pub29of100,1,190,5,583,0,588
test4sub56of100,test4pub30of100,1,190,5,104,1,110
test4sub13of100,test4pub30of100,1,190,5,107,1,113
test4sub94of100,test4pub29of100,1,190,5,593,1,599
test4sub32of100,test4pub30of100,1,190,5,123,0,128
test4sub98of100,test4pub30of100,1,190,5,132,0,137
test4sub7of100,test4pub30of100,1,190,5,147,1,153
test4sub27of100,test4pub30of100,1,190,5,148,1,154
test4sub79of100,test4pub30of100,1,190,5,148,2,155
test4sub19of100,test4pub29of100,1,190,5,634,1,640
test4sub45of100,test4pub29of100,1,190,5,636,1,642
test4sub54of100,test4pub29of100,1,190,5,635,2,642
test4sub43of100,test4pub29of100,1,190,5,641,1,647
test4sub99of100,test4pub29of100,1,190,5,642,1,648
test4sub52of100,test4pub29of100,1,190,5,643,1,649
test4sub25of100,test4pub29of100,1,190,5,644,1,650
test4sub82of100,test4pub29of100,1,190,5,672,1,678
test4sub36of100,test4pub30of100,1,190,5,197,1,203
test4sub28of100,test4pub29of100,1,190,5,681,1,687
test4sub69of100,test4pub29of100,1,190,5,683,0,688
test4sub18of100,test4pub29of100,1,190,5,684,1,690
test4sub75of100,test4pub29of100,1,190,5,687,1,693
test4sub63of100,test4pub30of100,1,190,5,213,1,219
test4sub53of100,test4pub30of100,1,190,5,216,1,222
test4sub62of100,test4pub30of100,1,190,5,217,0,222
test4sub65of100,test4pub30of100,1,190,5,219,1,225
test4sub85of100,test4pub30of100,1,190,5,225,1,231
test4sub76of100,test4pub30of100,1,190,5,226,1,232
test4sub49of100,test4pub30of100,1,190,5,227,1,233
test4sub24of100,test4pub30of100,1,190,5,229,1,235
test4sub91of100,test4pub30of100,1,190,5,228,1,234
test4sub92of100,test4pub30of100,1,190,5,230,1,236
test4sub94of100,test4pub30of100,1,190,5,232,0,237
test4sub48of100,test4pub30of100,1,190,5,240,0,245
test4sub28of100,test4pub30of100,1,190,5,253,1,259
test4sub16of100,test4pub30of100,1,190,5,256,0,261
test4sub71of100,test4pub30of100,1,190,5,258,1,264
test4sub34of100,test4pub30of100,1,190,5,259,2,266
test4sub86of100,test4pub30of100,1,190,5,259,1,265
test4sub20of100,test4pub30of100,1,190,5,264,1,270
test4sub57of100,test4pub30of100,1,190,5,268,0,273
test4sub19of100,test4pub30of100,1,190,5,280,1,286
test4sub97of100,test4pub30of100,1,190,5,297,0,302
test4sub10of100,test4pub30of100,1,190,5,307,0,312
test4sub41of100,test4pub30of100,1,190,5,309,0,314
test4sub3of100,test4pub30of100,1,190,5,324,1,330
test4sub59of100,test4pub28of100,1,190,5,1474,1,1480
test4sub15of100,test4pub30of100,1,190,5,333,1,339
test4sub59of100,test4pub29of100,1,190,5,816,1,822
test4sub42of100,test4pub30of100,1,190,5,341,1,347
test4sub60of100,test4pub30of100,1,190,5,355,1,361
test4sub22of100,test4pub30of100,1,190,5,356,1,362
test4sub47of100,test4pub30of100,1,190,5,367,1,373
test4sub70of100,test4pub30of100,1,190,5,370,1,376
test4sub1of100,test4pub31of100,1,190,5,23,0,28
test4sub68of100,test4pub30of100,1,190,5,380,1,386
test4sub69of100,test4pub30of100,1,190,5,397,0,402
test4sub87of100,test4pub30of100,1,190,5,398,0,403
test4sub62of100,test4pub31of100,1,190,5,48,1,54
test4sub27of100,test4pub31of100,1,190,5,49,0,54
test4sub37of100,test4pub30of100,1,190,5,407,1,413
test4sub2of100,test4pub30of100,1,190,5,408,0,413
test4sub35of100,test4pub30of100,1,190,5,412,0,417
test4sub55of100,test4pub30of100,1,190,5,414,1,420
test4sub40of100,test4pub29of100,1,190,5,898,1,904
test4sub93of100,test4pub30of100,1,190,5,417,1,423
test4sub96of100,test4pub30of100,1,190,5,417,1,423
test4sub12of100,test4pub30of100,1,190,5,430,0,435
test4sub86of100,test4pub31of100,1,190,5,83,1,89
test4sub14of100,test4pub30of100,1,190,5,439,1,445
test4sub39of100,test4pub31of100,1,190,5,90,0,95
test4sub72of100,test4pub31of100,1,190,5,92,1,98
test4sub51of100,test4pub30of100,1,190,5,451,0,456
test4sub88of100,test4pub30of100,1,190,5,453,1,459
test4sub68of100,test4pub31of100,1,190,5,99,2,106
test4sub48of100,test4pub31of100,1,190,5,100,1,106
test4sub5of100,test4pub31of100,1,190,5,101,0,106
test4sub80of100,test4pub30of100,1,190,5,457,1,463
test4sub46of100,test4pub30of100,1,190,5,460,1,466
test4sub74of100,test4pub30of100,1,190,5,461,0,466
test4sub90of100,test4pub30of100,1,190,5,468,1,474
test4sub59of100,test4pub31of100,1,190,5,114,6,125
test4sub20of100,test4pub31of100,1,190,5,113,9,127
test4sub30of100,test4pub31of100,1,190,5,121,1,127
test4sub47of100,test4pub31of100,1,190,5,121,2,128
test4sub15of100,test4pub31of100,1,190,5,128,1,134
test4sub50of100,test4pub30of100,1,190,5,483,1,489
test4sub22of100,test4pub31of100,1,190,5,129,1,135
test4sub89of100,test4pub31of100,1,190,5,135,1,141
test4sub56of100,test4pub31of100,1,190,5,137,1,143
test4sub4of100,test4pub31of100,1,190,5,137,1,143
test4sub38of100,test4pub30of100,1,190,5,493,1,499
test4sub18of100,test4pub30of100,1,190,5,495,1,501
test4sub66of100,test4pub30of100,1,190,5,496,0,501
test4sub44of100,test4pub31of100,1,190,5,144,1,150
test4sub93of100,test4pub31of100,1,190,5,156,1,162
test4sub13of100,test4pub31of100,1,190,5,159,0,164
test4sub77of100,test4pub30of100,1,190,5,520,1,526
test4sub85of100,test4pub31of100,1,190,5,170,0,175
test4sub33of100,test4pub30of100,1,190,5,536,1,542
test4sub100of100,test4pub30of100,1,190,5,560,1,566
test4sub8of100,test4pub30of100,1,190,5,560,2,567
test4sub84of100,test4pub30of100,1,190,5,561,1,567
test4sub43of100,test4pub30of100,1,190,5,562,0,567
test4sub21of100,test4pub30of100,1,190,5,568,0,573
test4sub12of100,test4pub31of100,1,190,5,215,0,220
test4sub95of100,test4pub30of100,1,190,5,572,1,578
test4sub81of100,test4pub30of100,1,190,5,575,1,581
test4sub54of100,test4pub30of100,1,190,5,574,2,581
test4sub9of100,test4pub30of100,1,190,5,576,1,582
test4sub37of100,test4pub31of100,1,190,5,222,3,230
test4sub99of100,test4pub30of100,1,190,5,577,2,584
test4sub39of100,test4pub30of100,1,190,5,578,2,585
test4sub51of100,test4pub31of100,1,190,5,224,4,233
test4sub55of100,test4pub31of100,1,190,5,225,2,232
test4sub64of100,test4pub30of100,1,190,5,582,2,589
test4sub26of100,test4pub30of100,1,190,5,582,2,589
test4sub75of100,test4pub31of100,1,190,5,231,1,237
test4sub52of100,test4pub30of100,1,190,5,586,1,592
test4sub11of100,test4pub30of100,1,190,5,588,0,593
test4sub45of100,test4pub30of100,1,190,5,587,2,594
test4sub25of100,test4pub31of100,1,190,5,237,1,243
test4sub32of100,test4pub31of100,1,190,5,237,1,243
test4sub92of100,test4pub31of100,1,190,5,240,1,246
test4sub60of100,test4pub31of100,1,190,5,241,0,246
test4sub40of100,test4pub30of100,1,190,5,597,0,602
test4sub28of100,test4pub31of100,1,190,5,247,1,253
test4sub17of100,test4pub30of100,1,190,5,603,1,609
test4sub97of100,test4pub31of100,1,190,5,249,0,254
test4sub46of100,test4pub31of100,1,190,5,250,1,256
test4sub74of100,test4pub31of100,1,190,5,251,1,257
test4sub82of100,test4pub30of100,1,190,5,612,1,618
test4sub36of100,test4pub31of100,1,190,5,259,0,264
test4sub30of100,test4pub30of100,1,190,5,640,0,645
test4sub59of100,test4pub30of100,1,190,5,642,0,647
test4sub50of100,test4pub31of100,1,190,5,302,0,307
test4sub24of100,test4pub31of100,1,190,5,316,0,321
test4sub89of100,test4pub30of100,1,190,5,676,0,681
test4sub29of100,test4pub30of100,1,190,5,680,0,685
test4sub2of100,test4pub31of100,1,190,5,330,1,336
test4sub67of100,test4pub31of100,1,190,5,331,1,337
test4sub83of100,test4pub30of100,1,190,5,688,0,693
test4sub71of100,test4pub31of100,1,190,5,335,1,341
test4sub69of100,test4pub31of100,1,190,5,336,1,342
test4sub58of100,test4pub30of100,1,190,5,693,1,699
test4sub10of100,test4pub31of100,1,190,5,339,1,345
test4sub5of100,test4pub30of100,1,190,5,695,1,701
test4sub34of100,test4pub31of100,1,190,5,342,0,347
test4sub14of100,test4pub31of100,1,190,5,348,1,354
test4sub4of100,test4pub30of100,1,190,5,704,1,710
test4sub38of100,test4pub31of100,1,190,5,350,0,355
test4sub18of100,test4pub31of100,1,190,5,351,1,357
test4sub66of100,test4pub31of100,1,190,5,352,1,358
test4sub53of100,test4pub31of100,1,190,5,354,1,360
test4sub96of100,test4pub31of100,1,190,5,356,1,362
test4sub42of100,test4pub31of100,1,190,5,357,1,363
test4sub44of100,test4pub30of100,1,190,5,719,1,725
test4sub80of100,test4pub31of100,1,190,5,373,1,379
test4sub33of100,test4pub31of100,1,190,5,413,0,418
test4sub8of100,test4pub31of100,1,190,5,419,1,425
test4sub95of100,test4pub31of100,1,190,5,420,0,425
test4sub77of100,test4pub31of100,1,190,5,422,1,428
test4sub45of100,test4pub31of100,1,190,5,423,2,430
test4sub11of100,test4pub31of100,1,190,5,423,1,429
test4sub25of100,test4pub30of100,1,190,5,784,0,789
test4sub16of100,test4pub31of100,1,190,5,436,1,442
test4sub17of100,test4pub31of100,1,190,5,441,0,446
test4sub82of100,test4pub31of100,1,190,5,444,1,450
test4sub52of100,test4pub31of100,1,190,5,448,1,454
test4sub29of100,test4pub31of100,1,190,5,461,1,467
test4sub65of100,test4pub31of100,1,190,5,462,1,468
test4sub67of100,test4pub30of100,1,190,5,818,0,823
test4sub83of100,test4pub31of100,1,190,5,466,1,472
test4sub98of100,test4pub31of100,1,190,5,473,1,479
test4sub87of100,test4pub31of100,1,190,5,483,1,489
test4sub90of100,test4pub31of100,1,190,5,491,0,496
test4sub57of100,test4pub31of100,1,190,5,493,1,499
test4sub70of100,test4pub31of100,1,190,5,494,0,499
test4sub31of100,test4pub31of100,1,190,5,496,0,501
test4sub94of100,test4pub31of100,1,190,5,497,0,502
test4sub91of100,test4pub31of100,1,190,5,500,0,505
test4sub63of100,test4pub31of100,1,190,5,502,1,508
test4sub73of100,test4pub31of100,1,190,5,504,1,510
test4sub19of100,test4pub31of100,1,190,5,506,0,511
test4sub78of100,test4pub31of100,1,190,5,507,2,514
test4sub100of100,test4pub31of100,1,190,5,508,2,515
test4sub76of100,test4pub31of100,1,190,5,508,1,514
test4sub79of100,test4pub31of100,1,190,5,510,1,516
test4sub84of100,test4pub31of100,1,190,5,523,0,528
test4sub23of100,test4pub31of100,1,190,5,524,1,530
test4sub7of100,test4pub31of100,1,190,5,526,0,531
test4sub49of100,test4pub31of100,1,190,5,527,0,532
test4sub35of100,test4pub31of100,1,190,5,530,2,537
test4sub61of100,test4pub31of100,1,190,5,531,2,538
test4sub6of100,test4pub31of100,1,190,5,532,1,538
test4sub43of100,test4pub31of100,1,190,5,629,1,635
test4sub5of100,test4pub32of100,1,190,5,19,1,25
test4sub62of100,test4pub32of100,1,190,5,26,0,31
test4sub100of100,test4pub32of100,1,190,5,33,0,38
test4sub76of100,test4pub32of100,1,190,5,40,1,46
test4sub4of100,test4pub32of100,1,190,5,71,1,77
test4sub68of100,test4pub32of100,1,190,5,78,1,84
test4sub83of100,test4pub32of100,1,190,5,79,0,84
test4sub86of100,test4pub32of100,1,190,5,92,1,98
test4sub72of100,test4pub32of100,1,190,5,95,1,101
test4sub75of100,test4pub30of100,1,190,5,1114,0,1119
test4sub24of100,test4pub32of100,1,190,5,101,1,107
test4sub10of100,test4pub32of100,1,190,5,102,1,108
test4sub42of100,test4pub32of100,1,190,5,107,1,113
test4sub65of100,test4pub32of100,1,190,5,120,0,125
test4sub52of100,test4pub32of100,1,190,5,131,0,136
test4sub64of100,test4pub31of100,1,190,5,798,1,804
test4sub38of100,test4pub32of100,1,190,5,140,1,146
test4sub40of100,test4pub31of100,1,190,5,806,1,812
test4sub82of100,test4pub32of100,1,190,5,145,1,151
test4sub40of100,test4pub32of100,1,190,5,147,1,153
test4sub96of100,test4pub32of100,1,190,5,149,0,154
test4sub43of100,test4pub32of100,1,190,5,150,1,156
test4sub21of100,test4pub31of100,1,190,5,833,1,839
test4sub9of100,test4pub31of100,1,190,5,833,0,838
test4sub64of100,test4pub32of100,1,190,5,175,0,180
test4sub78of100,test4pub32of100,1,190,5,186,1,192
test4sub44of100,test4pub32of100,1,190,5,189,1,195
test4sub15of100,test4pub32of100,1,190,5,196,2,203
test4sub31of100,test4pub32of100,1,190,5,198,1,204
test4sub77of100,test4pub32of100,1,190,5,198,2,205
test4sub13of100,test4pub32of100,1,190,5,199,2,206
test4sub12of100,test4pub32of100,1,190,5,200,1,206
test4sub87of100,test4pub32of100,1,190,5,202,1,208
test4sub3of100,test4pub31of100,1,190,5,866,1,872
test4sub99of100,test4pub31of100,1,190,5,891,1,897
test4sub61of100,test4pub32of100,1,190,5,229,0,234
test4sub55of100,test4pub32of100,1,190,5,231,1,237
test4sub19of100,test4pub32of100,1,190,5,232,1,238
test4sub27of100,test4pub32of100,1,190,5,233,1,239
test4sub23of100,test4pub32of100,1,190,5,234,1,240
test4sub59of100,test4pub32of100,1,190,5,235,0,240
test4sub33of100,test4pub32of100,1,190,5,238,1,244
test4sub94of100,test4pub32of100,1,190,5,241,1,247
test4sub32of100,test4pub32of100,1,190,5,242,1,248
test4sub80of100,test4pub32of100,1,190,5,248,1,254
test4sub79of100,test4pub32of100,1,190,5,253,1,259
test4sub88of100,test4pub31of100,1,190,5,918,1,924
test4sub14of100,test4pub32of100,1,190,5,265,1,271
test4sub67of100,test4pub32of100,1,190,5,273,1,279
test4sub81of100,test4pub31of100,1,190,5,935,0,940
test4sub63of100,test4pub32of100,1,190,5,276,1,282
test4sub46of100,test4pub32of100,1,190,5,277,1,283
test4sub48of100,test4pub32of100,1,190,5,280,0,285
test4sub71of100,test4pub32of100,1,190,5,296,1,302
test4sub75of100,test4pub32of100,1,190,5,298,0,303
test4sub69of100,test4pub32of100,1,190,5,300,2,307
test4sub47of100,test4pub32of100,1,190,5,301,2,308
test4sub30of100,test4pub32of100,1,190,5,302,2,309
test4sub1of100,test4pub32of100,1,190,5,303,1,309
test4sub41of100,test4pub31of100,1,190,5,972,1,978
test4sub74of100,test4pub32of100,1,190,5,311,1,317
test4sub51of100,test4pub32of100,1,190,5,319,0,324
test4sub37of100,test4pub32of100,1,190,5,331,0,336
test4sub95of100,test4pub32of100,1,190,5,341,1,347
test4sub49of100,test4pub32of100,1,190,5,343,1,349
test4sub28of100,test4pub32of100,1,190,5,346,1,352
test4sub22of100,test4pub32of100,1,190,5,357,0,362
test4sub29of100,test4pub32of100,1,190,5,361,1,367
test4sub85of100,test4pub32of100,1,190,5,367,1,373
test4sub50of100,test4pub32of100,1,190,5,371,2,378
test4sub25of100,test4pub32of100,1,190,5,372,1,378
test4sub3of100,test4pub32of100,1,190,5,383,0,388
test4sub97of100,test4pub32of100,1,190,5,388,0,393
test4sub60of100,test4pub32of100,1,190,5,395,0,400
test4sub26of100,test4pub31of100,1,190,5,1072,1,1078
test4sub26of100,test4pub32of100,1,190,5,412,1,418
test4sub21of100,test4pub32of100,1,190,5,413,0,418
test4sub88of100,test4pub32of100,1,190,5,416,1,422
test4sub39of100,test4pub32of100,1,190,5,418,1,424
test4sub73of100,test4pub32of100,1,190,5,420,1,426
test4sub98of100,test4pub32of100,1,190,5,421,0,426
test4sub7of100,test4pub32of100,1,190,5,425,1,431
test4sub34of100,test4pub32of100,1,190,5,429,1,435
test4sub81of100,test4pub32of100,1,190,5,431,0,436
test4sub18of100,test4pub32of100,1,190,5,433,1,439
test4sub8of100,test4pub32of100,1,190,5,434,1,440
test4sub41of100,test4pub32of100,1,190,5,438,1,444
test4sub17of100,test4pub32of100,1,190,5,443,1,449
test4sub16of100,test4pub32of100,1,190,5,470,1,476
test4sub56of100,test4pub32of100,1,190,5,473,1,479
test4sub35of100,test4pub32of100,1,190,5,478,1,484
test4sub99of100,test4pub32of100,1,190,5,484,0,489
test4sub89of100,test4pub32of100,1,190,5,492,0,497
test4sub70of100,test4pub32of100,1,190,5,501,0,506
test4sub91of100,test4pub32of100,1,190,5,505,1,511
test4sub6of100,test4pub32of100,1,190,5,508,1,514
test4sub84of100,test4pub32of100,1,190,5,510,0,515
test4sub66of100,test4pub32of100,1,190,5,511,1,517
test4sub36of100,test4pub32of100,1,190,5,512,0,517
test4sub2of100,test4pub32of100,1,190,5,530,1,536
test4sub92of100,test4pub32of100,1,190,5,533,0,538
test4sub53of100,test4pub32of100,1,190,5,535,1,541
test4sub57of100,test4pub32of100,1,190,5,537,0,542
test4sub18of100,test4pub33of100,1,190,5,13,1,19
test4sub52of100,test4pub33of100,1,190,5,22,1,28
test4sub17of100,test4pub33of100,1,190,5,32,0,37
test4sub10of100,test4pub33of100,1,190,5,36,1,42
test4sub81of100,test4pub33of100,1,190,5,38,1,44
test4sub54of100,test4pub31of100,1,190,5,1294,1,1300
test4sub54of100,test4pub32of100,1,190,5,634,3,642
test4sub50of100,test4pub33of100,1,190,5,47,2,54
test4sub54of100,test4pub33of100,1,190,5,49,1,55
test4sub84of100,test4pub33of100,1,190,5,56,0,61
test4sub64of100,test4pub33of100,1,190,5,59,1,65
test4sub67of100,test4pub33of100,1,190,5,62,1,68
test4sub62of100,test4pub33of100,1,190,5,70,0,75
test4sub51of100,test4pub33of100,1,190,5,80,1,86
test4sub46of100,test4pub33of100,1,190,5,90,0,95
test4sub41of100,test4pub33of100,1,190,5,102,1,108
test4sub3of100,test4pub33of100,1,190,5,104,1,110
test4sub91of100,test4pub33of100,1,190,5,109,1,115
test4sub5of100,test4pub33of100,1,190,5,110,1,116
test4sub77of100,test4pub33of100,1,190,5,114,1,120
test4sub61of100,test4pub33of100,1,190,5,120,1,126
test4sub93of100,test4pub32of100,1,190,5,709,1,715
test4sub23of100,test4pub33of100,1,190,5,125,1,131
test4sub56of100,test4pub33of100,1,190,5,127,0,132
test4sub34of100,test4pub33of100,1,190,5,128,1,134
test4sub98of100,test4pub33of100,1,190,5,129,2,136
test4sub76of100,test4pub33of100,1,190,5,129,1,135
test4sub21of100,test4pub33of100,1,190,5,131,1,137
test4sub29of100,test4pub33of100,1,190,5,132,1,138
test4sub48of100,test4pub33of100,1,190,5,136,1,142
test4sub39of100,test4pub33of100,1,190,5,143,1,149
test4sub6of100,test4pub33of100,1,190,5,146,1,152
test4sub75of100,test4pub33of100,1,190,5,149,0,154
test4sub68of100,test4pub33of100,1,190,5,153,1,159
test4sub87of100,test4pub33of100,1,190,5,153,1,159
test4sub73of100,test4pub33of100,1,190,5,160,1,166
test4sub35of100,test4pub33of100,1,190,5,162,0,167
test4sub28of100,test4pub33of100,1,190,5,165,0,170
test4sub31of100,test4pub33of100,1,190,5,170,1,176
test4sub2of100,test4pub33of100,1,190,5,175,1,181
test4sub24of100,test4pub33of100,1,190,5,176,1,182
test4sub15of100,test4pub33of100,1,190,5,181,0,186
test4sub88of100,test4pub33of100,1,190,5,182,1,188
test4sub36of100,test4pub33of100,1,190,5,193,1,199
test4sub90of100,test4pub32of100,1,190,5,776,2,783
test4sub99of100,test4pub33of100,1,190,5,196,1,202
test4sub95of100,test4pub33of100,1,190,5,210,0,215
test4sub71of100,test4pub33of100,1,190,5,214,1,220
test4sub43of100,test4pub33of100,1,190,5,216,1,222
test4sub92of100,test4pub33of100,1,190,5,219,1,225
test4sub25of100,test4pub33of100,1,190,5,224,1,230
test4sub69of100,test4pub33of100,1,190,5,225,1,231
test4sub89of100,test4pub33of100,1,190,5,226,0,231
test4sub20of100,test4pub32of100,1,190,5,831,0,836
test4sub20of100,test4pub33of100,1,190,5,244,0,249
test4sub22of100,test4pub33of100,1,190,5,254,1,260
test4sub80of100,test4pub33of100,1,190,5,262,0,267
test4sub74of100,test4pub33of100,1,190,5,265,1,271
test4sub65of100,test4pub33of100,1,190,5,273,1,279
test4sub9of100,test4pub32of100,1,190,5,864,1,870
test4sub40of100,test4pub33of100,1,190,5,280,0,285
test4sub33of100,test4pub33of100,1,190,5,291,0,296
test4sub93of100,test4pub33of100,1,190,5,295,1,301
test4sub94of100,test4pub33of100,1,190,5,296,1,302
test4sub7of100,test4pub33of100,1,190,5,311,1,317
test4sub83of100,test4pub33of100,1,190,5,314,0,319
test4sub49of100,test4pub33of100,1,190,5,338,0,343
test4sub30of100,test4pub33of100,1,190,5,347,1,353
test4sub46of100,test4pub34of100,1,190,5,46,0,51
test4sub59of100,test4pub34of100,1,190,5,49,0,54
test4sub65of100,test4pub34of100,1,190,5,54,0,59
test4sub86of100,test4pub33of100,1,190,5,371,1,377
test4sub57of100,test4pub34of100,1,190,5,71,1,77
test4sub9of100,test4pub33of100,1,190,5,388,1,394
test4sub72of100,test4pub33of100,1,190,5,399,1,405
test4sub14of100,test4pub34of100,1,190,5,99,0,104
test4sub27of100,test4pub33of100,1,190,5,421,1,427
test4sub63of100,test4pub33of100,1,190,5,423,1,429
test4sub96of100,test4pub34of100,1,190,5,117,0,122
test4sub79of100,test4pub34of100,1,190,5,117,1,123
test4sub60of100,test4pub34of100,1,190,5,119,1,125
test4sub1of100,test4pub33of100,1,190,5,431,1,437
test4sub26of100,test4pub33of100,1,190,5,435,1,441
test4sub16of100,test4pub34of100,1,190,5,126,1,132
test4sub90of100,test4pub33of100,1,190,5,440,0,445
test4sub44of100,test4pub34of100,1,190,5,133,1,139
test4sub27of100,test4pub34of100,1,190,5,137,1,143
test4sub70of100,test4pub33of100,1,190,5,452,0,457
test4sub13of100,test4pub33of100,1,190,5,453,1,459
test4sub57of100,test4pub33of100,1,190,5,467,1,473
test4sub37of100,test4pub33of100,1,190,5,478,0,483
test4sub53of100,test4pub33of100,1,190,5,490,0,495
test4sub26of100,test4pub34of100,1,190,5,182,1,188
test4sub8of100,test4pub33of100,1,190,5,492,0,497
test4sub80of100,test4pub34of100,1,190,5,184,1,190
test4sub48of100,test4pub34of100,1,190,5,186,0,191
test4sub18of100,test4pub34of100,1,190,5,187,1,193
test4sub60of100,test4pub33of100,1,190,5,503,0,508
test4sub44of100,test4pub33of100,1,190,5,505,1,511
test4sub42of100,test4pub33of100,1,190,5,505,2,512
test4sub52of100,test4pub34of100,1,190,5,197,0,202
test4sub10of100,test4pub34of100,1,190,5,199,1,205
test4sub82of100,test4pub33of100,1,190,5,510,0,515
test4sub79of100,test4pub33of100,1,190,5,510,1,516
test4sub71of100,test4pub34of100,1,190,5,204,0,209
test4sub98of100,test4pub34of100,1,190,5,213,1,219
test4sub97of100,test4pub33of100,1,190,5,523,1,529
test4sub78of100,test4pub34of100,1,190,5,215,1,221
test4sub49of100,test4pub34of100,1,190,5,223,0,228
test4sub85of100,test4pub33of100,1,190,5,533,3,541
test4sub96of100,test4pub33of100,1,190,5,534,2,541
test4sub23of100,test4pub34of100,1,190,5,226,2,233
test4sub56of100,test4pub34of100,1,190,5,226,1,232
test4sub70of100,test4pub34of100,1,190,5,229,0,234
test4sub38of100,test4pub33of100,1,190,5,540,1,546
test4sub93of100,test4pub34of100,1,190,5,231,4,240
test4sub25of100,test4pub34of100,1,190,5,233,4,242
test4sub29of100,test4pub34of100,1,190,5,234,4,243
test4sub14of100,test4pub33of100,1,190,5,541,6,552
test4sub12of100,test4pub33of100,1,190,5,542,5,552
test4sub22of100,test4pub34of100,1,190,5,234,4,243
test4sub32of100,test4pub34of100,1,190,5,235,4,244
test4sub66of100,test4pub33of100,1,190,5,544,4,553
test4sub6of100,test4pub34of100,1,190,5,236,3,244
test4sub19of100,test4pub33of100,1,190,5,556,1,562
test4sub45of100,test4pub32of100,1,190,5,1146,0,1151
test4sub95of100,test4pub34of100,1,190,5,262,1,268
test4sub100of100,test4pub33of100,1,190,5,570,1,576
test4sub78of100,test4pub33of100,1,190,5,591,1,597
test4sub85of100,test4pub34of100,1,190,5,283,1,289
test4sub45of100,test4pub33of100,1,190,5,599,1,605
test4sub61of100,test4pub34of100,1,190,5,290,1,296
test4sub55of100,test4pub33of100,1,190,5,605,0,610
test4sub100of100,test4pub34of100,1,190,5,304,1,310
test4sub16of100,test4pub33of100,1,190,5,613,3,621
test4sub20of100,test4pub34of100,1,190,5,305,3,313
test4sub17of100,test4pub34of100,1,190,5,306,1,312
test4sub81of100,test4pub34of100,1,190,5,306,1,312
test4sub59of100,test4pub33of100,1,190,5,617,1,623
test4sub91of100,test4pub34of100,1,190,5,317,1,323
test4sub68of100,test4pub34of100,1,190,5,318,0,323
test4sub47of100,test4pub33of100,1,190,5,631,1,637
test4sub32of100,test4pub33of100,1,190,5,632,1,638
test4sub4of100,test4pub33of100,1,190,5,636,1,642
test4sub15of100,test4pub34of100,1,190,5,342,1,348
test4sub2of100,test4pub34of100,1,190,5,343,2,350
test4sub82of100,test4pub34of100,1,190,5,343,1,349
test4sub64of100,test4pub34of100,1,190,5,345,0,350
test4sub66of100,test4pub34of100,1,190,5,351,1,357
test4sub83of100,test4pub34of100,1,190,5,352,1,358
test4sub28of100,test4pub34of100,1,190,5,353,1,359
test4sub86of100,test4pub34of100,1,190,5,355,1,361
test4sub87of100,test4pub34of100,1,190,5,360,1,366
test4sub84of100,test4pub34of100,1,190,5,360,0,365
test4sub73of100,test4pub34of100,1,190,5,362,0,367
test4sub45of100,test4pub34of100,1,190,5,378,1,384
test4sub63of100,test4pub34of100,1,190,5,381,1,387
test4sub38of100,test4pub34of100,1,190,5,384,1,390
test4sub67of100,test4pub34of100,1,190,5,387,1,393
test4sub50of100,test4pub34of100,1,190,5,402,1,408
test4sub9of100,test4pub34of100,1,190,5,402,1,408
test4sub36of100,test4pub34of100,1,190,5,405,1,411
test4sub30of100,test4pub34of100,1,190,5,406,0,411
test4sub39of100,test4pub34of100,1,190,5,408,1,414
test4sub24of100,test4pub34of100,1,190,5,409,0,414
test4sub65of100,test4pub35of100,1,190,5,12,1,18
test4sub94of100,test4pub34of100,1,190,5,417,2,424
test4sub92of100,test4pub34of100,1,190,5,418,1,424
test4sub66of100,test4pub35of100,1,190,5,25,1,31
test4sub74of100,test4pub35of100,1,190,5,27,0,32
test4sub40of100,test4pub34of100,1,190,5,431,1,437
test4sub11of100,test4pub32of100,1,190,5,1339,0,1344
test4sub11of100,test4pub33of100,1,190,5,751,0,756
test4sub95of100,test4pub35of100,1,190,5,41,1,47
test4sub12of100,test4pub34of100,1,190,5,446,1,452
test4sub25of100,test4pub35of100,1,190,5,55,0,60
test4sub33of100,test4pub34of100,1,190,5,465,1,471
test4sub8of100,test4pub34of100,1,190,5,467,1,473
test4sub4of100,test4pub35of100,1,190,5,63,2,70
test4sub7of100,test4pub35of100,1,190,5,62,3,70
test4sub27of100,test4pub35of100,1,190,5,61,1,67
test4sub76of100,test4pub34of100,1,190,5,479,1,485
test4sub75of100,test4pub34of100,1,190,5,478,2,485
test4sub44of100,test4pub35of100,1,190,5,79,1,85
test4sub43of100,test4pub34of100,1,190,5,490,1,496
test4sub23of100,test4pub35of100,1,190,5,86,2,93
test4sub81of100,test4pub35of100,1,190,5,86,3,94
test4sub31of100,test4pub34of100,1,190,5,491,2,498
test4sub99of100,test4pub34of100,1,190,5,492,3,500
test4sub42of100,test4pub34of100,1,190,5,493,1,499
test4sub78of100,test4pub35of100,1,190,5,92,2,99
test4sub48of100,test4pub35of100,1,190,5,92,2,99
test4sub53of100,test4pub34of100,1,190,5,497,3,505
test4sub69of100,test4pub35of100,1,190,5,94,3,102
test4sub72of100,test4pub34of100,1,190,5,499,2,506
test4sub1of100,test4pub34of100,1,190,5,500,2,507
test4sub61of100,test4pub35of100,1,190,5,97,1,103
test4sub35of100,test4pub35of100,1,190,5,103,1,109
test4sub47of100,test4pub34of100,1,190,5,507,0,512
test4sub41of100,test4pub35of100,1,190,5,116,0,121
test4sub40of100,test4pub35of100,1,190,5,131,0,136
test4sub11of100,test4pub34of100,1,190,5,536,1,542
test4sub70of100,test4pub35of100,1,190,5,145,0,150
test4sub33of100,test4pub35of100,1,190,5,156,1,162
test4sub37of100,test4pub34of100,1,190,5,560,1,566
test4sub10of100,test4pub35of100,1,190,5,163,1,169
test4sub43of100,test4pub35of100,1,190,5,184,1,190
test4sub84of100,test4pub35of100,1,190,5,185,2,192
test4sub58of100,test4pub31of100,1,190,5,2149,1,2155
test4sub5of100,test4pub34of100,1,190,5,594,1,600
test4sub90of100,test4pub34of100,1,190,5,595,2,602
test4sub7of100,test4pub34of100,1,190,5,596,3,604
test4sub99of100,test4pub35of100,1,190,5,192,4,201
test4sub53of100,test4pub35of100,1,190,5,193,5,203
test4sub4of100,test4pub34of100,1,190,5,598,5,608
test4sub62of100,test4pub34of100,1,190,5,598,5,608
test4sub89of100,test4pub34of100,1,190,5,599,4,608
test4sub21of100,test4pub34of100,1,190,5,600,4,609
test4sub88of100,test4pub34of100,1,190,5,601,4,610
test4sub49of100,test4pub35of100,1,190,5,197,3,205
test4sub47of100,test4pub35of100,1,190,5,199,1,205
test4sub55of100,test4pub34of100,1,190,5,606,1,612
test4sub45of100,test4pub35of100,1,190,5,205,1,211
test4sub86of100,test4pub35of100,1,190,5,206,2,213
test4sub94of100,test4pub35of100,1,190,5,207,4,216
test4sub79of100,test4pub35of100,1,190,5,208,4,217
test4sub77of100,test4pub34of100,1,190,5,613,3,621
test4sub41of100,test4pub34of100,1,190,5,614,3,622
test4sub96of100,test4pub35of100,1,190,5,210,2,217
test4sub13of100,test4pub34of100,1,190,5,615,7,627
test4sub1of100,test4pub35of100,1,190,5,211,6,222
test4sub16of100,test4pub35of100,1,190,5,214,5,224
test4sub97of100,test4pub35of100,1,190,5,214,4,223
test4sub14of100,test4pub35of100,1,190,5,215,4,224
test4sub74of100,test4pub34of100,1,190,5,619,4,628
test4sub34of100,test4pub34of100,1,190,5,620,4,629
test4sub30of100,test4pub35of100,1,190,5,217,3,225
test4sub3of100,test4pub34of100,1,190,5,628,0,633
test4sub54of100,test4pub34of100,1,190,5,638,1,644
test4sub69of100,test4pub34of100,1,190,5,644,2,651
test4sub36of100,test4pub35of100,1,190,5,240,2,247
test4sub51of100,test4pub34of100,1,190,5,645,2,652
test4sub31of100,test4pub35of100,1,190,5,242,4,251
test4sub20of100,test4pub35of100,1,190,5,243,4,252
test4sub35of100,test4pub34of100,1,190,5,648,4,657
test4sub19of100,test4pub34of100,1,190,5,649,3,657
test4sub11of100,test4pub35of100,1,190,5,245,3,253
test4sub100of100,test4pub35of100,1,190,5,247,3,255
test4sub22of100,test4pub35of100,1,190,5,248,2,255
test4sub71of100,test4pub35of100,1,190,5,250,1,256
test4sub68of100,test4pub35of100,1,190,5,249,2,256
test4sub37of100,test4pub35of100,1,190,5,270,1,276
test4sub83of100,test4pub35of100,1,190,5,277,0,282
test4sub17of100,test4pub35of100,1,190,5,286,0,291
test4sub58of100,test4pub32of100,1,190,5,1591,1,1597
test4sub58of100,test4pub33of100,1,190,5,1004,0,1009
test4sub58of100,test4pub34of100,1,190,5,696,1,702
test4sub85of100,test4pub35of100,1,190,5,294,1,300
test4sub2of100,test4pub35of100,1,190,5,295,2,302
test4sub76of100,test4pub35of100,1,190,5,296,1,302
test4sub52of100,test4pub35of100,1,190,5,298,1,304
test4sub42of100,test4pub35of100,1,190,5,299,2,306
test4sub21of100,test4pub35of100,1,190,5,300,2,307
test4sub62of100,test4pub35of100,1,190,5,300,2,307
test4sub92of100,test4pub35of100,1,190,5,301,1,307
test4sub97of100,test4pub34of100,1,190,5,724,1,730
test4sub5of100,test4pub35of100,1,190,5,339,1,345
test4sub98of100,test4pub35of100,1,190,5,341,1,347
test4sub24of100,test4pub35of100,1,190,5,340,2,347
test4sub32of100,test4pub35of100,1,190,5,343,1,349
test4sub90of100,test4pub35of100,1,190,5,349,1,355
test4sub6of100,test4pub35of100,1,190,5,350,1,356
test4sub80of100,test4pub35of100,1,190,5,352,1,358
test4sub64of100,test4pub35of100,1,190,5,354,1,360
test4sub51of100,test4pub35of100,1,190,5,355,1,361
test4sub77of100,test4pub35of100,1,190,5,357,1,363
test4sub72of100,test4pub35of100,1,190,5,358,1,364
test4sub82of100,test4pub35of100,1,190,5,360,2,367
test4sub19of100,test4pub35of100,1,190,5,360,2,367
test4sub54of100,test4pub35of100,1,190,5,361,2,368
test4sub89of100,test4pub35of100,1,190,5,362,1,368
test4sub3of100,test4pub35of100,1,190,5,365,0,370
test4sub29of100,test4pub35of100,1,190,5,368,1,374
test4sub28of100,test4pub35of100,1,190,5,372,1,378
test4sub73of100,test4pub35of100,1,190,5,379,1,385
test4sub75of100,test4pub35of100,1,190,5,387,0,392
test4sub93of100,test4pub35of100,1,190,5,397,0,402
test4sub67of100,test4pub35of100,1,190,5,403,1,409
test4sub63of100,test4pub35of100,1,190,5,403,1,409
test4sub87of100,test4pub35of100,1,190,5,405,1,411
test4sub56of100,test4pub35of100,1,190,5,406,2,413
test4sub58of100,test4pub35of100,1,190,5,408,1,414
test4sub9of100,test4pub35of100,1,190,5,408,1,414
test4sub18of100,test4pub35of100,1,190,5,417,2,424
test4sub34of100,test4pub35of100,1,190,5,417,1,423
test4sub91of100,test4pub35of100,1,190,5,417,2,424
test4sub55of100,test4pub35of100,1,190,5,415,5,425
test4sub59of100,test4pub35of100,1,190,5,415,5,425
test4sub26of100,test4pub35of100,1,190,5,419,4,428
test4sub12of100,test4pub35of100,1,190,5,420,4,429
test4sub39of100,test4pub35of100,1,190,5,421,3,429
test4sub57of100,test4pub35of100,1,190,5,421,4,430
test4sub46of100,test4pub35of100,1,190,5,422,3,430
test4sub38of100,test4pub35of100,1,190,5,423,2,430
test4sub15of100,test4pub35of100,1,190,5,424,2,431
test4sub13of100,test4pub35of100,1,190,5,429,1,435
test4sub8of100,test4pub35of100,1,190,5,430,1,436
test4sub60of100,test4pub35of100,1,190,5,431,1,437
test4sub88of100,test4pub35of100,1,190,5,431,1,437
test4sub50of100,test4pub35of100,1,190,5,434,0,439
test4sub91of100,test4pub36of100,1,190,5,14,1,20
test4sub73of100,test4pub36of100,1,190,5,30,0,35
test4sub8of100,test4pub36of100,1,190,5,31,1,37
test4sub88of100,test4pub36of100,1,190,5,38,0,43
test4sub63of100,test4pub36of100,1,190,5,38,1,44
test4sub14of100,test4pub36of100,1,190,5,43,1,49
test4sub46of100,test4pub36of100,1,190,5,43,1,49
test4sub70of100,test4pub36of100,1,190,5,49,1,55
test4sub81of100,test4pub36of100,1,190,5,59,1,65
test4sub80of100,test4pub36of100,1,190,5,67,1,73
test4sub75of100,test4pub36of100,1,190,5,73,0,78
test4sub13of100,test4pub36of100,1,190,5,90,1,96
test4sub66of100,test4pub36of100,1,190,5,97,1,103
test4sub61of100,test4pub36of100,1,190,5,102,1,108
test4sub20of100,test4pub36of100,1,190,5,110,0,115
test4sub4of100,test4pub36of100,1,190,5,125,1,131
test4sub100of100,test4pub36of100,1,190,5,151,1,157
test4sub28of100,test4pub36of100,1,190,5,157,1,163
test4sub7of100,test4pub36of100,1,190,5,168,0,173
test4sub65of100,test4pub36of100,1,190,5,169,1,175
test4sub35of100,test4pub36of100,1,190,5,170,2,177
test4sub83of100,test4pub36of100,1,190,5,171,2,178
test4sub77of100,test4pub36of100,1,190,5,172,2,179
test4sub67of100,test4pub36of100,1,190,5,173,1,179
test4sub9of100,test4pub36of100,1,190,5,175,2,182
test4sub1of100,test4pub36of100,1,190,5,176,1,182
test4sub71of100,test4pub36of100,1,190,5,178,1,184
test4sub53of100,test4pub36of100,1,190,5,190,1,196
test4sub18of100,test4pub36of100,1,190,5,196,1,202
test4sub31of100,test4pub36of100,1,190,5,201,1,207
test4sub54of100,test4pub36of100,1,190,5,208,1,214
test4sub19of100,test4pub36of100,1,190,5,213,1,219
test4sub92of100,test4pub36of100,1,190,5,224,1,230
test4sub43of100,test4pub36of100,1,190,5,233,1,239
test4sub93of100,test4pub36of100,1,190,5,234,1,240
test4sub33of100,test4pub36of100,1,190,5,235,1,241
test4sub6of100,test4pub36of100,1,190,5,237,0,242
test4sub98of100,test4pub36of100,1,190,5,237,1,243
test4sub48of100,test4pub36of100,1,190,5,247,1,253
test4sub11of100,test4pub36of100,1,190,5,250,1,256
test4sub40of100,test4pub36of100,1,190,5,258,1,264
test4sub85of100,test4pub36of100,1,190,5,265,1,271
test4sub74of100,test4pub36of100,1,190,5,269,1,275
test4sub58of100,test4pub36of100,1,190,5,281,1,287
test4sub27of100,test4pub36of100,1,190,5,318,1,324
test4sub22of100,test4pub36of100,1,190,5,323,0,328
test4sub56of100,test4pub36of100,1,190,5,337,0,342
test4sub47of100,test4pub36of100,1,190,5,358,1,364
test4sub44of100,test4pub36of100,1,190,5,361,1,367
test4sub97of100,test4pub36of100,1,190,5,372,1,378
test4sub14of100,test4pub37of100,1,190,6,17,1,24
test4sub49of100,test4pub36of100,1,190,5,391,0,396
test4sub95of100,test4pub36of100,1,190,5,395,1,401
test4sub89of100,test4pub37of100,1,190,6,38,1,45
test4sub47of100,test4pub37of100,1,190,6,41,1,48
test4sub5of100,test4pub36of100,1,190,5,414,1,420
test4sub24of100,test4pub36of100,1,190,5,428,0,433
test4sub90of100,test4pub37of100,1,190,6,76,1,83
test4sub87of100,test4pub36of100,1,190,5,458,0,463
test4sub3of100,test4pub36of100,1,190,5,465,1,471
test4sub55of100,test4pub37of100,1,190,6,108,1,115
test4sub45of100,test4pub36of100,1,190,5,470,1,476
test4sub49of100,test4pub37of100,1,190,6,109,1,116
test4sub55of100,test4pub36of100,1,190,5,481,0,486
test4sub43of100,test4pub37of100,1,190,6,130,1,137
test4sub12of100,test4pub36of100,1,190,5,493,1,499
test4sub29of100,test4pub37of100,1,190,6,134,1,141
test4sub94of100,test4pub36of100,1,190,5,495,1,501
test4sub20of100,test4pub37of100,1,190,6,137,0,143
test4sub72of100,test4pub37of100,1,190,6,136,1,143
test4sub16of100,test4pub37of100,1,190,6,138,0,144
test4sub44of100,test4pub37of100,1,190,6,142,1,149
test4sub70of100,test4pub37of100,1,190,6,142,0,148
test4sub7of100,test4pub37of100,1,190,6,148,1,155
test4sub28of100,test4pub37of100,1,190,6,150,1,157
test4sub42of100,test4pub36of100,1,190,5,519,1,525
test4sub57of100,test4pub36of100,1,190,5,520,1,526
test4sub62of100,test4pub36of100,1,190,5,521,2,528
test4sub82of100,test4pub36of100,1,190,5,522,2,529
test4sub96of100,test4pub36of100,1,190,5,523,1,529
test4sub68of100,test4pub37of100,1,190,6,172,1,179
test4sub21of100,test4pub37of100,1,190,6,174,1,181
test4sub86of100,test4pub37of100,1,190,6,173,4,183
test4sub56of100,test4pub37of100,1,190,6,175,3,184
test4sub38of100,test4pub37of100,1,190,6,176,2,184
test4sub24of100,test4pub37of100,1,190,6,176,1,183
test4sub19of100,test4pub37of100,1,190,6,178,1,185
test4sub39of100,test4pub36of100,1,190,5,544,1,550
test4sub85of100,test4pub37of100,1,190,6,186,1,193
test4sub54of100,test4pub37of100,1,190,6,192,1,199
test4sub41of100,test4pub37of100,1,190,6,195,1,202
test4sub76of100,test4pub37of100,1,190,6,200,1,207
test4sub66of100,test4pub37of100,1,190,6,202,1,209
test4sub64of100,test4pub36of100,1,190,5,564,1,570
test4sub34of100,test4pub36of100,1,190,5,567,1,573
test4sub42of100,test4pub37of100,1,190,6,209,1,216
test4sub25of100,test4pub37of100,1,190,6,210,0,216
test4sub69of100,test4pub36of100,1,190,5,574,1,580
test4sub11of100,test4pub37of100,1,190,6,218,1,225
test4sub89of100,test4pub36of100,1,190,5,578,1,584
test4sub72of100,test4pub36of100,1,190,5,581,1,587
test4sub17of100,test4pub36of100,1,190,5,582,1,588
test4sub50of100,test4pub36of100,1,190,5,583,1,589
test4sub60of100,test4pub36of100,1,190,5,584,1,590
test4sub99of100,test4pub36of100,1,190,5,585,1,591
test4sub15of100,test4pub36of100,1,190,5,589,1,595
test4sub51of100,test4pub36of100,1,190,5,591,0,596
test4sub37of100,test4pub36of100,1,190,5,599,1,605
test4sub30of100,test4pub36of100,1,190,5,600,1,606
test4sub84of100,test4pub37of100,1,190,6,243,1,250
test4sub90of100,test4pub36of100,1,190,5,606,1,612
test4sub59of100,test4pub36of100,1,190,5,612,0,617
test4sub33of100,test4pub37of100,1,190,6,261,1,268
test4sub36of100,test4pub36of100,1,190,5,621,1,627
test4sub31of100,test4pub37of100,1,190,6,265,1,272
test4sub52of100,test4pub36of100,1,190,5,628,1,634
test4sub2of100,test4pub37of100,1,190,6,269,0,275
test4sub32of100,test4pub36of100,1,190,5,631,0,636
test4sub16of100,test4pub36of100,1,190,5,633,0,638
test4sub38of100,test4pub36of100,1,190,5,635,1,641
test4sub78of100,test4pub36of100,1,190,5,640,0,645
test4sub53of100,test4pub37of100,1,190,6,281,1,288
test4sub77of100,test4pub37of100,1,190,6,284,0,290
test4sub3of100,test4pub37of100,1,190,6,289,1,296
test4sub86of100,test4pub36of100,1,190,5,651,1,657
test4sub68of100,test4pub36of100,1,190,5,653,0,658
test4sub41of100,test4pub36of100,1,190,5,654,1,660
test4sub29of100,test4pub36of100,1,190,5,656,1,662
test4sub26of100,test4pub36of100,1,190,5,663,1,669
test4sub76of100,test4pub36of100,1,190,5,664,1,670
test4sub21of100,test4pub36of100,1,190,5,666,1,672
test4sub10of100,test4pub36of100,1,190,5,669,1,675
test4sub4of100,test4pub37of100,1,190,6,315,1,322
test4sub63of100,test4pub37of100,1,190,6,315,0,321
test4sub1of100,test4pub37of100,1,190,6,318,1,325
test4sub79of100,test4pub36of100,1,190,5,680,0,685
test4sub88of100,test4pub37of100,1,190,6,330,1,337
test4sub23of100,test4pub36of100,1,190,5,695,0,700
test4sub96of100,test4pub37of100,1,190,6,340,1,347
test4sub55of100,test4pub38of100,1,190,5,15,1,21
test4sub85of100,test4pub38of100,1,190,5,21,1,27
test4sub56of100,test4pub38of100,1,190,5,26,1,32
test4sub9of100,test4pub37of100,1,190,6,354,1,361
test4sub25of100,test4pub36of100,1,190,5,715,0,720
test4sub69of100,test4pub37of100,1,190,6,361,0,367
test4sub81of100,test4pub37of100,1,190,6,367,1,374
test4sub17of100,test4pub37of100,1,190,6,370,0,376
test4sub50of100,test4pub37of100,1,190,6,372,1,379
test4sub84of100,test4pub36of100,1,190,5,746,1,752
test4sub82of100,test4pub37of100,1,190,6,391,1,398
test4sub39of100,test4pub37of100,1,190,6,406,0,412
test4sub99of100,test4pub37of100,1,190,6,411,1,418
test4sub15of100,test4pub37of100,1,190,6,415,0,421
test4sub2of100,test4pub36of100,1,190,5,786,0,791
test4sub60of100,test4pub37of100,1,190,6,430,1,437
test4sub32of100,test4pub37of100,1,190,6,431,1,438
test4sub36of100,test4pub38of100,1,190,5,112,1,118
test4sub38of100,test4pub38of100,1,190,5,113,4,122
test4sub83of100,test4pub37of100,1,190,6,439,3,448
test4sub30of100,test4pub38of100,1,190,5,114,3,122
test4sub67of100,test4pub38of100,1,190,5,115,3,123
test4sub52of100,test4pub38of100,1,190,5,116,2,123
test4sub54of100,test4pub38of100,1,190,5,124,1,130
test4sub40of100,test4pub37of100,1,190,6,450,1,457
test4sub34of100,test4pub37of100,1,190,6,451,2,459
test4sub61of100,test4pub38of100,1,190,5,126,1,132
test4sub66of100,test4pub38of100,1,190,5,133,1,139
test4sub18of100,test4pub37of100,1,190,6,467,1,474
test4sub74of100,test4pub37of100,1,190,6,468,1,475
test4sub76of100,test4pub38of100,1,190,5,143,1,149
test4sub42of100,test4pub38of100,1,190,5,143,3,151
test4sub93of100,test4pub37of100,1,190,6,470,1,477
test4sub43of100,test4pub38of100,1,190,5,147,0,152
test4sub27of100,test4pub37of100,1,190,6,475,1,482
test4sub37of100,test4pub38of100,1,190,5,148,2,155
test4sub78of100,test4pub37of100,1,190,6,476,1,483
test4sub64of100,test4pub37of100,1,190,6,478,1,485
test4sub13of100,test4pub37of100,1,190,6,479,1,486
test4sub79of100,test4pub37of100,1,190,6,500,1,507
test4sub79of100,test4pub38of100,1,190,5,175,0,180
test4sub98of100,test4pub37of100,1,190,6,505,0,511
test4sub88of100,test4pub38of100,1,190,5,180,2,187
test4sub11of100,test4pub38of100,1,190,5,181,1,187
test4sub23of100,test4pub38of100,1,190,5,182,1,188
test4sub96of100,test4pub38of100,1,190,5,188,1,194
test4sub73of100,test4pub38of100,1,190,5,192,0,197
test4sub87of100,test4pub37of100,1,190,6,524,1,531
test4sub46of100,test4pub37of100,1,190,6,525,0,531
test4sub45of100,test4pub37of100,1,190,6,526,1,533
test4sub5of100,test4pub38of100,1,190,5,201,0,206
test4sub95of100,test4pub37of100,1,190,6,533,1,540
test4sub22of100,test4pub37of100,1,190,6,534,0,540
test4sub68of100,test4pub38of100,1,190,5,227,1,233
test4sub48of100,test4pub38of100,1,190,5,229,1,235
test4sub58of100,test4pub37of100,1,190,6,554,4,564
test4sub81of100,test4pub38of100,1,190,5,229,3,237
test4sub97of100,test4pub37of100,1,190,6,556,2,564
test4sub84of100,test4pub38of100,1,190,5,231,2,238
test4sub62of100,test4pub37of100,1,190,6,565,1,572
test4sub57of100,test4pub37of100,1,190,6,566,1,573
test4sub60of100,test4pub38of100,1,190,5,242,1,248
test4sub89of100,test4pub38of100,1,190,5,242,3,250
test4sub83of100,test4pub38of100,1,190,5,243,5,253
test4sub52of100,test4pub37of100,1,190,6,570,5,581
test4sub67of100,test4pub37of100,1,190,6,570,6,582
test4sub40of100,test4pub38of100,1,190,5,245,5,255
test4sub72of100,test4pub38of100,1,190,5,246,4,255
test4sub91of100,test4pub37of100,1,190,6,572,4,582
test4sub23of100,test4pub37of100,1,190,6,573,4,583
test4sub73of100,test4pub37of100,1,190,6,574,4,584
test4sub92of100,test4pub38of100,1,190,5,248,5,258
test4sub95of100,test4pub38of100,1,190,5,251,2,258
test4sub10of100,test4pub38of100,1,190,5,252,1,258
test4sub6of100,test4pub38of100,1,190,5,257,1,263
test4sub12of100,test4pub37of100,1,190,6,589,1,596
test4sub59of100,test4pub37of100,1,190,6,590,1,597
test4sub24of100,test4pub38of100,1,190,5,265,1,271
test4sub65of100,test4pub38of100,1,190,5,273,0,278
test4sub5of100,test4pub37of100,1,190,6,601,1,608
test4sub1of100,test4pub38of100,1,190,5,279,0,284
test4sub94of100,test4pub37of100,1,190,6,607,6,619
test4sub30of100,test4pub37of100,1,190,6,606,7,619
test4sub48of100,test4pub37of100,1,190,6,608,1,615
test4sub98of100,test4pub38of100,1,190,5,295,1,301
test4sub32of100,test4pub38of100,1,190,5,303,1,309
test4sub8of100,test4pub37of100,1,190,6,645,0,651
test4sub35of100,test4pub37of100,1,190,6,647,2,655
test4sub49of100,test4pub38of100,1,190,5,322,1,328
test4sub21of100,test4pub38of100,1,190,5,325,1,331
test4sub41of100,test4pub38of100,1,190,5,326,1,332
test4sub62of100,test4pub38of100,1,190,5,329,1,335
test4sub82of100,test4pub38of100,1,190,5,329,1,335
test4sub47of100,test4pub38of100,1,190,5,335,0,340
test4sub19of100,test4pub38of100,1,190,5,345,0,350
test4sub17of100,test4pub38of100,1,190,5,352,1,358
test4sub91of100,test4pub38of100,1,190,5,372,1,378
test4sub33of100,test4pub38of100,1,190,5,375,1,381
test4sub45of100,test4pub38of100,1,190,5,384,1,390
test4sub39of100,test4pub38of100,1,190,5,387,0,392
test4sub92of100,test4pub37of100,1,190,6,718,1,725
test4sub4of100,test4pub38of100,1,190,5,393,1,399
test4sub10of100,test4pub37of100,1,190,6,721,0,727
test4sub77of100,test4pub38of100,1,190,5,409,1,415
test4sub34of100,test4pub38of100,1,190,5,410,0,415
test4sub97of100,test4pub38of100,1,190,5,411,1,417
test4sub6of100,test4pub37of100,1,190,6,739,1,746
test4sub50of100,test4pub38of100,1,190,5,414,1,420
test4sub58of100,test4pub38of100,1,190,5,416,0,421
test4sub9of100,test4pub38of100,1,190,5,417,2,424
test4sub65of100,test4pub37of100,1,190,6,744,3,753
test4sub86of100,test4pub38of100,1,190,5,418,2,425
test4sub28of100,test4pub38of100,1,190,5,419,2,426
test4sub63of100,test4pub38of100,1,190,5,425,0,430
test4sub15of100,test4pub38of100,1,190,5,430,2,437
test4sub3of100,test4pub38of100,1,190,5,430,2,437
test4sub70of100,test4pub38of100,1,190,5,431,1,437
test4sub25of100,test4pub38of100,1,190,5,431,1,437
test4sub87of100,test4pub38of100,1,190,5,434,1,440
test4sub14of100,test4pub38of100,1,190,5,434,2,441
test4sub35of100,test4pub38of100,1,190,5,436,1,442
test4sub99of100,test4pub38of100,1,190,5,442,1,448
test4sub12of100,test4pub38of100,1,190,5,454,1,460
test4sub94of100,test4pub38of100,1,190,5,455,0,460
test4sub100of100,test4pub38of100,1,190,5,467,1,473
test4sub90of100,test4pub38of100,1,190,5,489,0,494
test4sub75of100,test4pub37of100,1,190,6,816,0,822
test4sub46of100,test4pub38of100,1,190,5,497,0,502
test4sub44of100,test4pub38of100,1,190,5,499,1,505
test4sub8of100,test4pub38of100,1,190,5,501,1,507
test4sub93of100,test4pub38of100,1,190,5,502,0,507
test4sub26of100,test4pub38of100,1,190,5,501,2,508
test4sub29of100,test4pub38of100,1,190,5,504,1,510
test4sub2of100,test4pub38of100,1,190,5,510,1,516
test4sub51of100,test4pub38of100,1,190,5,519,0,524
test4sub20of100,test4pub38of100,1,190,5,563,0,568
test4sub7of100,test4pub38of100,1,190,5,570,0,575
test4sub16of100,test4pub38of100,1,190,5,572,1,578
test4sub31of100,test4pub38of100,1,190,5,586,2,593
test4sub69of100,test4pub38of100,1,190,5,586,1,592
test4sub71of100,test4pub37of100,1,190,6,913,1,920
test4sub59of100,test4pub38of100,1,190,5,594,1,600
test4sub57of100,test4pub38of100,1,190,5,595,1,601
test4sub36of100,test4pub37of100,1,190,6,922,1,929
test4sub22of100,test4pub38of100,1,190,5,597,1,603
test4sub27of100,test4pub38of100,1,190,5,598,0,603
test4sub18of100,test4pub38of100,1,190,5,600,0,605
test4sub74of100,test4pub38of100,1,190,5,601,0,606
test4sub53of100,test4pub38of100,1,190,5,603,1,609
test4sub13of100,test4pub38of100,1,190,5,620,1,626
test4sub100of100,test4pub37of100,1,190,6,956,1,963
test4sub78of100,test4pub38of100,1,190,5,633,1,639
test4sub75of100,test4pub38of100,1,190,5,633,1,639
test4sub64of100,test4pub38of100,1,190,5,644,1,650
test4sub80of100,test4pub37of100,1,190,6,972,0,978
test4sub26of100,test4pub37of100,1,190,6,973,1,980
test4sub61of100,test4pub37of100,1,190,6,978,1,985
test4sub51of100,test4pub37of100,1,190,6,978,0,984
test4sub71of100,test4pub38of100,1,190,5,656,0,661
test4sub80of100,test4pub38of100,1,190,5,667,0,672
test4sub52of100,test4pub39of100,1,190,5,13,0,18
test4sub100of100,test4pub39of100,1,190,5,15,0,20
test4sub64of100,test4pub39of100,1,190,5,28,1,34
test4sub37of100,test4pub37of100,1,190,6,1074,1,1081
test4sub99of100,test4pub39of100,1,190,5,50,1,56
test4sub76of100,test4pub39of100,1,190,5,68,1,74
test4sub1of100,test4pub39of100,1,190,5,84,0,89
test4sub35of100,test4pub39of100,1,190,5,89,1,95
test4sub65of100,test4pub39of100,1,190,5,100,1,106
test4sub9of100,test4pub39of100,1,190,5,102,0,107
test4sub57of100,test4pub39of100,1,190,5,103,1,109
test4sub95of100,test4pub39of100,1,190,5,107,0,112
test4sub77of100,test4pub39of100,1,190,5,109,2,116
test4sub16of100,test4pub39of100,1,190,5,110,1,116
test4sub55of100,test4pub39of100,1,190,5,111,2,118
test4sub70of100,test4pub39of100,1,190,5,112,2,119
test4sub92of100,test4pub39of100,1,190,5,113,2,120
test4sub22of100,test4pub39of100,1,190,5,114,2,121
test4sub50of100,test4pub39of100,1,190,5,115,2,122
test4sub96of100,test4pub39of100,1,190,5,116,2,123
test4sub14of100,test4pub39of100,1,190,5,117,2,124
test4sub78of100,test4pub39of100,1,190,5,120,1,126
test4sub42of100,test4pub39of100,1,190,5,120,1,126
test4sub94of100,test4pub39of100,1,190,5,123,1,129
test4sub40of100,test4pub39of100,1,190,5,123,1,129
test4sub74of100,test4pub39of100,1,190,5,124,1,130
test4sub29of100,test4pub39of100,1,190,5,126,1,132
test4sub26of100,test4pub39of100,1,190,5,131,1,137
test4sub61of100,test4pub39of100,1,190,5,131,1,137
test4sub58of100,test4pub39of100,1,190,5,140,1,146
test4sub56of100,test4pub39of100,1,190,5,171,1,177
test4sub3of100,test4pub39of100,1,190,5,172,1,178
test4sub4of100,test4pub39of100,1,190,5,173,1,179
test4sub72of100,test4pub39of100,1,190,5,175,1,181
test4sub11of100,test4pub39of100,1,190,5,176,1,182
test4sub17of100,test4pub39of100,1,190,5,186,0,191
test4sub27of100,test4pub39of100,1,190,5,187,1,193
test4sub7of100,test4pub39of100,1,190,5,192,1,198
test4sub89of100,test4pub39of100,1,190,5,195,1,201
test4sub13of100,test4pub39of100,1,190,5,206,1,212
test4sub21of100,test4pub39of100,1,190,5,207,0,212
test4sub6of100,test4pub39of100,1,190,5,209,0,214
test4sub84of100,test4pub39of100,1,190,5,208,2,215
test4sub33of100,test4pub39of100,1,190,5,210,1,216
test4sub37of100,test4pub39of100,1,190,5,213,1,219
test4sub63of100,test4pub39of100,1,190,5,223,1,229
test4sub20of100,test4pub39of100,1,190,5,231,1,237
test4sub45of100,test4pub39of100,1,190,5,232,2,239
test4sub83of100,test4pub39of100,1,190,5,233,1,239
test4sub46of100,test4pub39of100,1,190,5,236,0,241
test4sub60of100,test4pub39of100,1,190,5,255,1,261
test4sub85of100,test4pub39of100,1,190,5,263,3,271
test4sub5of100,test4pub39of100,1,190,5,264,3,272
test4sub47of100,test4pub39of100,1,190,5,265,3,273
test4sub87of100,test4pub39of100,1,190,5,275,1,281
test4sub28of100,test4pub39of100,1,190,5,279,0,284
test4sub98of100,test4pub39of100,1,190,5,289,0,294
test4sub31of100,test4pub39of100,1,190,5,295,1,301
test4sub82of100,test4pub39of100,1,190,5,296,0,301
test4sub67of100,test4pub39of100,1,190,5,297,0,302
test4sub39of100,test4pub39of100,1,190,5,301,1,307
test4sub66of100,test4pub39of100,1,190,5,307,1,313
test4sub2of100,test4pub39of100,1,190,5,315,1,321
test4sub10of100,test4pub39of100,1,190,5,323,1,329
test4sub97of100,test4pub39of100,1,190,5,327,1,333
test4sub32of100,test4pub39of100,1,190,5,327,1,333
test4sub90of100,test4pub39of100,1,190,5,330,1,336
test4sub88of100,test4pub39of100,1,190,5,334,1,340
test4sub25of100,test4pub39of100,1,190,5,334,1,340
test4sub48of100,test4pub39of100,1,190,5,339,0,344
test4sub23of100,test4pub40of100,1,190,7,19,2,28
test4sub22of100,test4pub40of100,1,190,7,20,1,28
test4sub76of100,test4pub40of100,1,190,7,24,1,32
test4sub6of100,test4pub40of100,1,190,7,25,1,33
test4sub44of100,test4pub39of100,1,190,5,356,1,362
test4sub73of100,test4pub39of100,1,190,5,364,1,370
test4sub35of100,test4pub40of100,1,190,7,43,1,51
test4sub81of100,test4pub39of100,1,190,5,371,0,376
test4sub53of100,test4pub39of100,1,190,5,373,1,379
test4sub27of100,test4pub40of100,1,190,7,49,1,57
test4sub41of100,test4pub39of100,1,190,5,389,0,394
test4sub75of100,test4pub40of100,1,190,7,65,1,73
test4sub93of100,test4pub39of100,1,190,5,396,1,402
test4sub30of100,test4pub39of100,1,190,5,397,1,403
test4sub15of100,test4pub39of100,1,190,5,403,1,409
test4sub4of100,test4pub40of100,1,190,7,80,1,88
test4sub43of100,test4pub39of100,1,190,5,409,1,415
test4sub51of100,test4pub39of100,1,190,5,413,1,419
test4sub51of100,test4pub40of100,1,190,7,94,1,102
test4sub79of100,test4pub39of100,1,190,5,424,1,430
test4sub12of100,test4pub39of100,1,190,5,426,0,431
test4sub94of100,test4pub40of100,1,190,7,103,0,110
test4sub78of100,test4pub40of100,1,190,7,103,1,111
test4sub79of100,test4pub40of100,1,190,7,106,1,114
test4sub54of100,test4pub39of100,1,190,5,435,0,440
test4sub34of100,test4pub40of100,1,190,7,108,1,116
test4sub34of100,test4pub39of100,1,190,5,447,1,453
test4sub60of100,test4pub40of100,1,190,7,120,1,128
test4sub92of100,test4pub40of100,1,190,7,126,1,134
test4sub72of100,test4pub40of100,1,190,7,127,1,135
test4sub48of100,test4pub40of100,1,190,7,135,1,143
test4sub42of100,test4pub40of100,1,190,7,136,0,143
test4sub56of100,test4pub40of100,1,190,7,138,1,146
test4sub74of100,test4pub40of100,1,190,7,145,1,153
test4sub69of100,test4pub39of100,1,190,5,473,1,479
test4sub57of100,test4pub40of100,1,190,7,147,1,155
test4sub8of100,test4pub39of100,1,190,5,477,1,483
test4sub87of100,test4pub40of100,1,190,7,151,2,160
test4sub59of100,test4pub39of100,1,190,5,479,2,486
test4sub85of100,test4pub40of100,1,190,7,152,1,160
test4sub23of100,test4pub39of100,1,190,5,482,0,487
test4sub91of100,test4pub39of100,1,190,5,484,0,489
test4sub19of100,test4pub39of100,1,190,5,488,0,493
test4sub18of100,test4pub39of100,1,190,5,491,1,497
test4sub71of100,test4pub39of100,1,190,5,492,1,498
test4sub49of100,test4pub39of100,1,190,5,495,1,501
test4sub90of100,test4pub40of100,1,190,7,172,0,179
test4sub50of100,test4pub40of100,1,190,7,176,2,185
test4sub88of100,test4pub40of100,1,190,7,177,1,185
test4sub100of100,test4pub40of100,1,190,7,180,1,188
test4sub36of100,test4pub39of100,1,190,5,509,1,515
test4sub54of100,test4pub40of100,1,190,7,183,1,191
test4sub86of100,test4pub39of100,1,190,5,512,1,518
test4sub73of100,test4pub40of100,1,190,7,187,1,195
test4sub20of100,test4pub40of100,1,190,7,187,2,196
test4sub62of100,test4pub40of100,1,190,7,188,1,196
test4sub80of100,test4pub39of100,1,190,5,517,2,524
test4sub17of100,test4pub40of100,1,190,7,191,1,199
test4sub75of100,test4pub39of100,1,190,5,522,0,527
test4sub24of100,test4pub39of100,1,190,5,529,1,535
test4sub3of100,test4pub40of100,1,190,7,202,1,210
test4sub38of100,test4pub39of100,1,190,5,534,1,540
test4sub62of100,test4pub39of100,1,190,5,534,0,539
test4sub68of100,test4pub39of100,1,190,5,536,1,542
test4sub13of100,test4pub40of100,1,190,7,213,1,221
test4sub41of100,test4pub40of100,1,190,7,217,1,225
test4sub26of100,test4pub40of100,1,190,7,218,0,225
test4sub47of100,test4pub40of100,1,190,7,220,1,228
test4sub68of100,test4pub40of100,1,190,7,220,1,228
test4sub63of100,test4pub40of100,1,190,7,222,0,229
test4sub82of100,test4pub40of100,1,190,7,221,2,230
test4sub28of100,test4pub40of100,1,190,7,228,1,236
test4sub81of100,test4pub40of100,1,190,7,229,1,237
test4sub21of100,test4pub40of100,1,190,7,231,1,239
test4sub71of100,test4pub40of100,1,190,7,241,0,248
test4sub59of100,test4pub40of100,1,190,7,244,1,252
test4sub7of100,test4pub40of100,1,190,7,258,1,266
test4sub11of100,test4pub40of100,1,190,7,264,1,272
test4sub86of100,test4pub40of100,1,190,7,271,1,279
test4sub98of100,test4pub40of100,1,190,7,282,1,290
test4sub83of100,test4pub40of100,1,190,7,286,1,294
test4sub25of100,test4pub40of100,1,190,7,302,0,309
test4sub44of100,test4pub40of100,1,190,7,310,1,318
test4sub36of100,test4pub40of100,1,190,7,318,2,327
test4sub67of100,test4pub40of100,1,190,7,319,2,328
test4sub77of100,test4pub40of100,1,190,7,319,1,327
test4sub5of100,test4pub40of100,1,190,7,319,1,327
test4sub14of100,test4pub40of100,1,190,7,326,1,334
test4sub80of100,test4pub40of100,1,190,7,329,1,337
test4sub33of100,test4pub40of100,1,190,7,332,1,340
test4sub17of100,test4pub41of100,1,190,5,26,0,31
test4sub66of100,test4pub41of100,1,190,5,28,1,34
test4sub10of100,test4pub40of100,1,190,7,342,1,350
test4sub21of100,test4pub41of100,1,190,5,32,0,37
test4sub9of100,test4pub40of100,1,190,7,346,1,354
test4sub34of100,test4pub41of100,1,190,5,34,1,40
test4sub53of100,test4pub41of100,1,190,5,40,1,46
test4sub69of100,test4pub40of100,1,190,7,353,1,361
test4sub85of100,test4pub41of100,1,190,5,44,0,49
test4sub12of100,test4pub41of100,1,190,5,49,3,57
test4sub65of100,test4pub40of100,1,190,7,363,3,373
test4sub46of100,test4pub40of100,1,190,7,363,2,372
test4sub33of100,test4pub41of100,1,190,5,51,2,58
test4sub97of100,test4pub40of100,1,190,7,369,2,378
test4sub84of100,test4pub40of100,1,190,7,371,1,379
test4sub64of100,test4pub41of100,1,190,5,62,1,68
test4sub63of100,test4pub41of100,1,190,5,78,1,84
test4sub61of100,test4pub41of100,1,190,5,84,1,90
test4sub65of100,test4pub41of100,1,190,5,84,1,90
test4sub19of100,test4pub41of100,1,190,5,86,0,91
test4sub69of100,test4pub41of100,1,190,5,91,1,97
test4sub93of100,test4pub40of100,1,190,7,405,2,414
test4sub58of100,test4pub40of100,1,190,7,406,1,414
test4sub48of100,test4pub41of100,1,190,5,93,2,100
test4sub53of100,test4pub40of100,1,190,7,407,1,415
test4sub10of100,test4pub41of100,1,190,5,98,1,104
test4sub30of100,test4pub40of100,1,190,7,413,1,421
test4sub43of100,test4pub40of100,1,190,7,423,1,431
test4sub8of100,test4pub40of100,1,190,7,424,1,432
test4sub2of100,test4pub40of100,1,190,7,432,1,440
test4sub1of100,test4pub40of100,1,190,7,434,1,442
test4sub61of100,test4pub40of100,1,190,7,441,1,449
test4sub70of100,test4pub40of100,1,190,7,453,0,460
test4sub30of100,test4pub41of100,1,190,5,141,1,147
test4sub20of100,test4pub41of100,1,190,5,143,1,149
test4sub95of100,test4pub40of100,1,190,7,455,1,463
test4sub15of100,test4pub40of100,1,190,7,465,1,473
test4sub2of100,test4pub41of100,1,190,5,152,2,159
test4sub40of100,test4pub40of100,1,190,7,466,3,476
test4sub37of100,test4pub40of100,1,190,7,466,3,476
test4sub12of100,test4pub40of100,1,190,7,467,2,476
test4sub60of100,test4pub41of100,1,190,5,155,2,162
test4sub82of100,test4pub41of100,1,190,5,162,1,168
test4sub49of100,test4pub41of100,1,190,5,162,1,168
test4sub55of100,test4pub40of100,1,190,7,482,0,489
test4sub77of100,test4pub41of100,1,190,5,171,2,178
test4sub91of100,test4pub41of100,1,190,5,172,1,178
test4sub47of100,test4pub41of100,1,190,5,175,1,181
test4sub31of100,test4pub40of100,1,190,7,493,1,501
test4sub99of100,test4pub41of100,1,190,5,199,1,205
test4sub49of100,test4pub40of100,1,190,7,512,1,520
test4sub37of100,test4pub41of100,1,190,5,200,2,207
test4sub38of100,test4pub41of100,1,190,5,202,1,208
test4sub66of100,test4pub40of100,1,190,7,515,2,524
test4sub18of100,test4pub40of100,1,190,7,517,4,528
test4sub80of100,test4pub41of100,1,190,5,204,3,212
test4sub16of100,test4pub40of100,1,190,7,518,2,527
test4sub14of100,test4pub41of100,1,190,5,205,3,213
test4sub8of100,test4pub41of100,1,190,5,206,2,213
test4sub28of100,test4pub41of100,1,190,5,206,2,213
test4sub39of100,test4pub41of100,1,190,5,212,2,219
test4sub97of100,test4pub41of100,1,190,5,212,1,218
test4sub11of100,test4pub41of100,1,190,5,213,1,219
test4sub22of100,test4pub41of100,1,190,5,215,1,221
test4sub64of100,test4pub40of100,1,190,7,528,2,537
test4sub52of100,test4pub40of100,1,190,7,530,1,538
test4sub9of100,test4pub41of100,1,190,5,218,1,224
test4sub29of100,test4pub40of100,1,190,7,533,1,541
test4sub95of100,test4pub41of100,1,190,5,226,1,232
test4sub99of100,test4pub40of100,1,190,7,539,1,547
test4sub24of100,test4pub40of100,1,190,7,546,0,553
test4sub5of100,test4pub41of100,1,190,5,235,0,240
test4sub38of100,test4pub40of100,1,190,7,549,1,557
test4sub91of100,test4pub40of100,1,190,7,552,1,560
test4sub54of100,test4pub41of100,1,190,5,260,1,266
test4sub39of100,test4pub40of100,1,190,7,578,1,586
test4sub35of100,test4pub41of100,1,190,5,266,1,272
test4sub68of100,test4pub41of100,1,190,5,267,1,273
test4sub52of100,test4pub41of100,1,190,5,275,2,282
test4sub76of100,test4pub41of100,1,190,5,275,2,282
test4sub32of100,test4pub40of100,1,190,7,589,1,597
test4sub19of100,test4pub40of100,1,190,7,591,1,599
test4sub94of100,test4pub41of100,1,190,5,279,1,285
test4sub100of100,test4pub41of100,1,190,5,280,0,285
test4sub15of100,test4pub41of100,1,190,5,281,1,287
test4sub7of100,test4pub41of100,1,190,5,282,2,289
test4sub4of100,test4pub41of100,1,190,5,283,1,289
test4sub45of100,test4pub40of100,1,190,7,599,1,607
test4sub96of100,test4pub40of100,1,190,7,600,1,608
test4sub3of100,test4pub41of100,1,190,5,287,3,295
test4sub89of100,test4pub40of100,1,190,7,601,3,611
test4sub67of100,test4pub41of100,1,190,5,289,1,295
test4sub24of100,test4pub41of100,1,190,5,290,1,296
test4sub13of100,test4pub41of100,1,190,5,292,0,297
test4sub50of100,test4pub41of100,1,190,5,294,0,299
test4sub70of100,test4pub41of100,1,190,5,299,0,304
test4sub58of100,test4pub41of100,1,190,5,305,1,311
test4sub42of100,test4pub41of100,1,190,5,316,1,322
test4sub51of100,test4pub41of100,1,190,5,320,1,326
test4sub18of100,test4pub41of100,1,190,5,324,0,329
test4sub74of100,test4pub41of100,1,190,5,330,1,336
test4sub92of100,test4pub41of100,1,190,5,333,1,339
test4sub25of100,test4pub41of100,1,190,5,347,1,353
test4sub84of100,test4pub41of100,1,190,5,353,1,359
test4sub32of100,test4pub41of100,1,190,5,357,1,363
test4sub55of100,test4pub41of100,1,190,5,365,1,371
test4sub16of100,test4pub41of100,1,190,5,365,0,370
test4sub96of100,test4pub41of100,1,190,5,368,1,374
test4sub86of100,test4pub41of100,1,190,5,369,1,375
test4sub41of100,test4pub41of100,1,190,5,392,0,397
test4sub87of100,test4pub41of100,1,190,5,414,0,419
test4sub89of100,test4pub41of100,1,190,5,419,0,424
test4sub78of100,test4pub41of100,1,190,5,422,0,427
test4sub24of100,test4pub42of100,1,190,5,13,1,19
test4sub32of100,test4pub42of100,1,190,5,20,1,26
test4sub40of100,test4pub41of100,1,190,5,437,1,443
test4sub99of100,test4pub42of100,1,190,5,23,1,29
test4sub3of100,test4pub42of100,1,190,5,30,1,36
test4sub74of100,test4pub42of100,1,190,5,47,0,52
test4sub6of100,test4pub41of100,1,190,5,468,1,474
test4sub71of100,test4pub41of100,1,190,5,476,1,482
test4sub56of100,test4pub41of100,1,190,5,477,2,484
test4sub1of100,test4pub41of100,1,190,5,477,1,483
test4sub43of100,test4pub42of100,1,190,5,64,0,69
test4sub90of100,test4pub41of100,1,190,5,482,0,487
test4sub83of100,test4pub41of100,1,190,5,492,2,499
test4sub59of100,test4pub41of100,1,190,5,493,1,499
test4sub40of100,test4pub42of100,1,190,5,78,3,86
test4sub72of100,test4pub41of100,1,190,5,495,1,501
test4sub46of100,test4pub41of100,1,190,5,496,1,502
test4sub62of100,test4pub42of100,1,190,5,86,1,92
test4sub2of100,test4pub42of100,1,190,5,86,2,93
test4sub95of100,test4pub42of100,1,190,5,89,1,95
test4sub44of100,test4pub41of100,1,190,5,507,1,513
test4sub71of100,test4pub42of100,1,190,5,91,2,98
test4sub68of100,test4pub42of100,1,190,5,92,1,98
test4sub92of100,test4pub42of100,1,190,5,93,1,99
test4sub14of100,test4pub42of100,1,190,5,96,1,102
test4sub10of100,test4pub42of100,1,190,5,101,1,107
test4sub16of100,test4pub42of100,1,190,5,102,1,108
test4sub53of100,test4pub42of100,1,190,5,103,0,108
test4sub36of100,test4pub41of100,1,190,5,519,2,526
test4sub75of100,test4pub41of100,1,190,5,520,2,527
test4sub54of100,test4pub42of100,1,190,5,107,1,113
test4sub94of100,test4pub42of100,1,190,5,108,1,114
test4sub46of100,test4pub42of100,1,190,5,126,1,132
test4sub90of100,test4pub42of100,1,190,5,129,0,134
test4sub18of100,test4pub42of100,1,190,5,133,1,139
test4sub42of100,test4pub42of100,1,190,5,141,1,147
test4sub26of100,test4pub41of100,1,190,5,563,1,569
test4sub23of100,test4pub41of100,1,190,5,567,1,573
test4sub81of100,test4pub41of100,1,190,5,568,2,575
test4sub73of100,test4pub41of100,1,190,5,570,3,578
test4sub27of100,test4pub41of100,1,190,5,570,3,578
test4sub29of100,test4pub41of100,1,190,5,571,3,579
test4sub45of100,test4pub41of100,1,190,5,572,2,579
test4sub31of100,test4pub41of100,1,190,5,572,3,580
test4sub62of100,test4pub41of100,1,190,5,574,1,580
test4sub57of100,test4pub41of100,1,190,5,575,2,582
test4sub43of100,test4pub41of100,1,190,5,578,1,584
test4sub77of100,test4pub42of100,1,190,5,163,2,170
test4sub98of100,test4pub41of100,1,190,5,580,3,588
test4sub75of100,test4pub42of100,1,190,5,164,3,172
test4sub88of100,test4pub41of100,1,190,5,581,3,589
test4sub35of100,test4pub42of100,1,190,5,165,3,173
test4sub17of100,test4pub42of100,1,190,5,167,2,174
test4sub78of100,test4pub42of100,1,190,5,170,1,176
test4sub5of100,test4pub42of100,1,190,5,176,1,182
test4sub79of100,test4pub41of100,1,190,5,595,1,601
test4sub12of100,test4pub42of100,1,190,5,180,1,186
test4sub93of100,test4pub41of100,1,190,5,601,1,607
test4sub31of100,test4pub42of100,1,190,5,187,0,192
test4sub63of100,test4pub42of100,1,190,5,194,1,200
test4sub22of100,test4pub42of100,1,190,5,218,1,224
test4sub67of100,test4pub42of100,1,190,5,219,1,225
test4sub70of100,test4pub42of100,1,190,5,221,1,227
test4sub49of100,test4pub42of100,1,190,5,221,0,226
test4sub27of100,test4pub42of100,1,190,5,225,1,231
test4sub91of100,test4pub42of100,1,190,5,225,3,233
test4sub98of100,test4pub42of100,1,190,5,226,3,234
test4sub55of100,test4pub42of100,1,190,5,227,3,235
test4sub7of100,test4pub42of100,1,190,5,228,3,236
test4sub20of100,test4pub42of100,1,190,5,228,4,237
test4sub82of100,test4pub42of100,1,190,5,229,3,237
test4sub38of100,test4pub42of100,1,190,5,230,2,237
test4sub29of100,test4pub42of100,1,190,5,231,2,238
test4sub11of100,test4pub42of100,1,190,5,239,1,245
test4sub52of100,test4pub42of100,1,190,5,247,1,253
test4sub86of100,test4pub42of100,1,190,5,247,1,253
test4sub96of100,test4pub42of100,1,190,5,252,1,258
test4sub84of100,test4pub42of100,1,190,5,255,0,260
test4sub80of100,test4pub42of100,1,190,5,263,1,269
test4sub6of100,test4pub42of100,1,190,5,280,0,285
test4sub87of100,test4pub42of100,1,190,5,291,1,297
test4sub26of100,test4pub42of100,1,190,5,291,0,296
test4sub73of100,test4pub42of100,1,190,5,301,1,307
test4sub4of100,test4pub42of100,1,190,5,308,0,313
test4sub69of100,test4pub42of100,1,190,5,311,1,317
test4sub88of100,test4pub42of100,1,190,5,316,0,321
test4sub28of100,test4pub42of100,1,190,5,320,1,326
test4sub30of100,test4pub42of100,1,190,5,321,1,327
test4sub21of100,test4pub42of100,1,190,5,327,1,333
test4sub65of100,test4pub42of100,1,190,5,328,1,334
test4sub36of100,test4pub42of100,1,190,5,332,0,337
test4sub1of100,test4pub42of100,1,190,5,333,0,338
test4sub39of100,test4pub42of100,1,190,5,334,1,340
test4sub57of100,test4pub42of100,1,190,5,339,1,345
test4sub59of100,test4pub42of100,1,190,5,339,1,345
test4sub44of100,test4pub43of100,1,190,5,17,1,23
test4sub67of100,test4pub43of100,1,190,5,21,1,27
test4sub61of100,test4pub42of100,1,190,5,350,1,356
test4sub76of100,test4pub42of100,1,190,5,353,1,359
test4sub20of100,test4pub43of100,1,190,5,29,0,34
test4sub34of100,test4pub43of100,1,190,5,30,9,44
test4sub8of100,test4pub42of100,1,190,5,366,2,373
test4sub77of100,test4pub43of100,1,190,5,38,2,45
test4sub50of100,test4pub42of100,1,190,5,367,1,373
test4sub87of100,test4pub43of100,1,190,5,44,1,50
test4sub17of100,test4pub43of100,1,190,5,44,1,50
test4sub25of100,test4pub42of100,1,190,5,379,0,384
test4sub66of100,test4pub42of100,1,190,5,381,1,387
test4sub90of100,test4pub43of100,1,190,5,52,1,58
test4sub61of100,test4pub43of100,1,190,5,53,1,59
test4sub97of100,test4pub42of100,1,190,5,388,1,394
test4sub100of100,test4pub42of100,1,190,5,389,2,396
test4sub72of100,test4pub42of100,1,190,5,390,1,396
test4sub15of100,test4pub42of100,1,190,5,401,1,407
test4sub85of100,test4pub43of100,1,190,5,77,0,82
test4sub85of100,test4pub42of100,1,190,5,410,0,415
test4sub41of100,test4pub42of100,1,190,5,412,1,418
test4sub43of100,test4pub43of100,1,190,5,85,1,91
test4sub3of100,test4pub43of100,1,190,5,91,1,97
test4sub47of100,test4pub43of100,1,190,5,121,1,127
test4sub9of100,test4pub42of100,1,190,5,451,1,457
test4sub15of100,test4pub43of100,1,190,5,131,1,137
test4sub98of100,test4pub43of100,1,190,5,137,2,144
test4sub64of100,test4pub42of100,1,190,5,466,2,473
test4sub56of100,test4pub43of100,1,190,5,138,1,144
test4sub44of100,test4pub42of100,1,190,5,469,1,475
test4sub58of100,test4pub43of100,1,190,5,140,0,145
test4sub56of100,test4pub42of100,1,190,5,478,1,484
test4sub23of100,test4pub43of100,1,190,5,151,1,157
test4sub58of100,test4pub42of100,1,190,5,481,1,487
test4sub48of100,test4pub42of100,1,190,5,483,1,489
test4sub45of100,test4pub42of100,1,190,5,486,2,493
test4sub37of100,test4pub42of100,1,190,5,487,1,493
test4sub7of100,test4pub43of100,1,190,5,165,0,170
test4sub51of100,test4pub42of100,1,190,5,495,4,504
test4sub79of100,test4pub42of100,1,190,5,496,4,505
test4sub65of100,test4pub43of100,1,190,5,167,4,176
test4sub40of100,test4pub43of100,1,190,5,168,4,177
test4sub71of100,test4pub43of100,1,190,5,168,3,176
test4sub97of100,test4pub43of100,1,190,5,169,3,177
test4sub34of100,test4pub42of100,1,190,5,499,2,506
test4sub76of100,test4pub43of100,1,190,5,179,1,185
test4sub28of100,test4pub43of100,1,190,5,180,1,186
test4sub23of100,test4pub42of100,1,190,5,511,0,516
test4sub93of100,test4pub42of100,1,190,5,513,1,519
test4sub19of100,test4pub42of100,1,190,5,512,2,519
test4sub81of100,test4pub42of100,1,190,5,516,0,521
test4sub60of100,test4pub42of100,1,190,5,526,1,532
test4sub33of100,test4pub43of100,1,190,5,198,1,204
test4sub83of100,test4pub43of100,1,190,5,204,1,210
test4sub33of100,test4pub42of100,1,190,5,533,1,539
test4sub6of100,test4pub43of100,1,190,5,213,1,219
test4sub83of100,test4pub42of100,1,190,5,547,1,553
test4sub18of100,test4pub43of100,1,190,5,220,1,226
test4sub24of100,test4pub43of100,1,190,5,226,1,232
test4sub13of100,test4pub42of100,1,190,5,557,1,563
test4sub94of100,test4pub43of100,1,190,5,232,1,238
test4sub30of100,test4pub43of100,1,190,5,236,1,242
test4sub47of100,test4pub42of100,1,190,5,573,1,579
test4sub11of100,test4pub43of100,1,190,5,245,1,251
test4sub79of100,test4pub43of100,1,190,5,255,0,260
test4sub89of100,test4pub42of100,1,190,5,590,2,597
test4sub49of100,test4pub43of100,1,190,5,261,3,269
test4sub74of100,test4pub43of100,1,190,5,262,3,270
test4sub46of100,test4pub43of100,1,190,5,263,2,270
test4sub41of100,test4pub43of100,1,190,5,263,1,269
test4sub93of100,test4pub43of100,1,190,5,268,1,274
test4sub9of100,test4pub43of100,1,190,5,274,1,280
test4sub89of100,test4pub43of100,1,190,5,275,0,280
test4sub32of100,test4pub43of100,1,190,5,282,1,288
test4sub60of100,test4pub43of100,1,190,5,283,1,289
test4sub26of100,test4pub43of100,1,190,5,284,0,289
test4sub35of100,test4pub43of100,1,190,5,286,1,292
test4sub10of100,test4pub43of100,1,190,5,287,1,293
test4sub13of100,test4pub43of100,1,190,5,288,0,293
test4sub88of100,test4pub43of100,1,190,5,293,0,298
test4sub62of100,test4pub43of100,1,190,5,295,0,300
test4sub66of100,test4pub43of100,1,190,5,295,1,301
test4sub52of100,test4pub44of100,1,190,6,21,2,29
test4sub21of100,test4pub44of100,1,190,6,22,1,29
test4sub50of100,test4pub43of100,1,190,5,307,2,314
test4sub49of100,test4pub44of100,1,190,6,32,1,39
test4sub32of100,test4pub44of100,1,190,6,32,1,39
test4sub19of100,test4pub43of100,1,190,5,317,1,323
test4sub63of100,test4pub44of100,1,190,6,39,1,46
test4sub68of100,test4pub44of100,1,190,6,41,0,47
test4sub79of100,test4pub44of100,1,190,6,44,1,51
test4sub65of100,test4pub44of100,1,190,6,51,0,57
test4sub53of100,test4pub43of100,1,190,5,339,1,345
test4sub2of100,test4pub44of100,1,190,6,59,1,66
test4sub99of100,test4pub43of100,1,190,5,348,0,353
test4sub73of100,test4pub44of100,1,190,6,65,2,73
test4sub38of100,test4pub43of100,1,190,5,350,2,357
test4sub41of100,test4pub44of100,1,190,6,66,3,75
test4sub6of100,test4pub44of100,1,190,6,66,2,74
test4sub30of100,test4pub44of100,1,190,6,68,1,75
test4sub93of100,test4pub44of100,1,190,6,74,1,81
test4sub45of100,test4pub43of100,1,190,5,358,2,365
test4sub55of100,test4pub44of100,1,190,6,75,1,82
test4sub82of100,test4pub43of100,1,190,5,361,1,367
test4sub73of100,test4pub43of100,1,190,5,365,1,371
test4sub48of100,test4pub44of100,1,190,6,81,0,87
test4sub16of100,test4pub43of100,1,190,5,380,0,385
test4sub26of100,test4pub44of100,1,190,6,102,0,108
test4sub22of100,test4pub44of100,1,190,6,106,1,113
test4sub34of100,test4pub44of100,1,190,6,111,1,118
test4sub72of100,test4pub43of100,1,190,5,403,1,409
test4sub1of100,test4pub44of100,1,190,6,123,1,130
test4sub91of100,test4pub43of100,1,190,5,409,4,418
test4sub48of100,test4pub43of100,1,190,5,409,7,421
test4sub5of100,test4pub44of100,1,190,6,127,7,140
test4sub37of100,test4pub43of100,1,190,5,411,7,423
test4sub17of100,test4pub44of100,1,190,6,130,6,142
test4sub12of100,test4pub43of100,1,190,5,415,5,425
test4sub78of100,test4pub43of100,1,190,5,416,5,426
test4sub51of100,test4pub43of100,1,190,5,416,6,427
test4sub92of100,test4pub44of100,1,190,6,134,3,143
test4sub2of100,test4pub43of100,1,190,5,424,5,434
test4sub25of100,test4pub44of100,1,190,6,141,3,150
test4sub56of100,test4pub44of100,1,190,6,142,4,152
test4sub57of100,test4pub43of100,1,190,5,427,3,435
test4sub4of100,test4pub44of100,1,190,6,144,2,152
test4sub40of100,test4pub44of100,1,190,6,149,0,155
test4sub27of100,test4pub43of100,1,190,5,436,3,444
test4sub31of100,test4pub44of100,1,190,6,152,3,161
test4sub86of100,test4pub43of100,1,190,5,437,2,444
test4sub35of100,test4pub44of100,1,190,6,155,2,163
test4sub16of100,test4pub44of100,1,190,6,155,2,163
test4sub36of100,test4pub43of100,1,190,5,447,1,453
test4sub80of100,test4pub43of100,1,190,5,459,1,465
test4sub51of100,test4pub44of100,1,190,6,182,1,189
test4sub38of100,test4pub44of100,1,190,6,191,1,198
test4sub68of100,test4pub43of100,1,190,5,477,1,483
test4sub64of100,test4pub44of100,1,190,6,199,1,206
test4sub10of100,test4pub44of100,1,190,6,208,2,216
test4sub100of100,test4pub43of100,1,190,5,493,2,500
test4sub55of100,test4pub43of100,1,190,5,493,2,500
test4sub69of100,test4pub44of100,1,190,6,210,3,219
test4sub59of100,test4pub43of100,1,190,5,495,2,502
test4sub31of100,test4pub43of100,1,190,5,496,2,503
test4sub61of100,test4pub44of100,1,190,6,215,1,222
test4sub29of100,test4pub44of100,1,190,6,217,1,224
test4sub23of100,test4pub44of100,1,190,6,218,1,225
test4sub54of100,test4pub44of100,1,190,6,220,1,227
test4sub25of100,test4pub43of100,1,190,5,506,0,511
test4sub5of100,test4pub43of100,1,190,5,512,0,517
test4sub90of100,test4pub44of100,1,190,6,239,1,246
test4sub52of100,test4pub43of100,1,190,5,524,2,531
test4sub98of100,test4pub44of100,1,190,6,241,2,249
test4sub3of100,test4pub44of100,1,190,6,241,2,249
test4sub45of100,test4pub44of100,1,190,6,242,3,251
test4sub69of100,test4pub43of100,1,190,5,526,2,533
test4sub92of100,test4pub43of100,1,190,5,530,1,536
test4sub42of100,test4pub44of100,1,190,6,258,1,265
test4sub29of100,test4pub43of100,1,190,5,543,1,549
test4sub21of100,test4pub43of100,1,190,5,545,0,550
test4sub24of100,test4pub44of100,1,190,6,262,2,270
test4sub62of100,test4pub44of100,1,190,6,261,3,270
test4sub84of100,test4pub43of100,1,190,5,547,3,555
test4sub39of100,test4pub43of100,1,190,5,548,2,555
test4sub14of100,test4pub43of100,1,190,5,547,2,554
test4sub8of100,test4pub43of100,1,190,5,551,1,557
test4sub63of100,test4pub43of100,1,190,5,552,1,558
test4sub70of100,test4pub44of100,1,190,6,273,0,279
test4sub81of100,test4pub43of100,1,190,5,562,1,568
test4sub19of100,test4pub44of100,1,190,6,285,0,291
test4sub75of100,test4pub43of100,1,190,5,579,1,585
test4sub36of100,test4pub44of100,1,190,6,308,0,314
test4sub8of100,test4pub44of100,1,190,6,308,1,315
test4sub64of100,test4pub43of100,1,190,5,598,1,604
test4sub18of100,test4pub44of100,1,190,6,315,0,321
test4sub70of100,test4pub43of100,1,190,5,601,1,607
test4sub74of100,test4pub44of100,1,190,6,318,1,325
test4sub87of100,test4pub44of100,1,190,6,322,1,329
test4sub4of100,test4pub43of100,1,190,5,610,0,615
test4sub1of100,test4pub43of100,1,190,5,615,1,621
test4sub42of100,test4pub43of100,1,190,5,621,1,627
test4sub54of100,test4pub43of100,1,190,5,629,1,635
test4sub88of100,test4pub44of100,1,190,6,349,0,355
test4sub95of100,test4pub43of100,1,190,5,634,3,642
test4sub83of100,test4pub44of100,1,190,6,351,2,359
test4sub22of100,test4pub43of100,1,190,5,635,3,643
test4sub47of100,test4pub44of100,1,190,6,352,2,360
test4sub96of100,test4pub43of100,1,190,5,637,1,643
test4sub82of100,test4pub44of100,1,190,6,357,1,364
test4sub39of100,test4pub44of100,1,190,6,358,1,365
test4sub86of100,test4pub44of100,1,190,6,358,1,365
test4sub67of100,test4pub44of100,1,190,6,366,1,373
test4sub96of100,test4pub44of100,1,190,6,377,1,384
test4sub89of100,test4pub44of100,1,190,6,382,1,389
test4sub78of100,test4pub44of100,1,190,6,391,0,397
test4sub7of100,test4pub44of100,1,190,6,391,1,398
test4sub100of100,test4pub44of100,1,190,6,393,0,399
test4sub95of100,test4pub44of100,1,190,6,398,1,405
test4sub27of100,test4pub44of100,1,190,6,398,2,406
test4sub66of100,test4pub44of100,1,190,6,399,1,406
test4sub77of100,test4pub44of100,1,190,6,404,1,411
test4sub13of100,test4pub44of100,1,190,6,405,1,412
test4sub71of100,test4pub44of100,1,190,6,409,1,416
test4sub80of100,test4pub44of100,1,190,6,418,1,425
test4sub58of100,test4pub44of100,1,190,6,419,1,426
test4sub9of100,test4pub44of100,1,190,6,420,0,426
test4sub46of100,test4pub44of100,1,190,6,432,1,439
test4sub14of100,test4pub44of100,1,190,6,435,1,442
test4sub59of100,test4pub44of100,1,190,6,436,0,442
test4sub75of100,test4pub44of100,1,190,6,438,1,445
test4sub84of100,test4pub44of100,1,190,6,438,0,444
test4sub57of100,test4pub44of100,1,190,6,440,1,447
test4sub44of100,test4pub44of100,1,190,6,449,1,456
test4sub72of100,test4pub44of100,1,190,6,458,1,465
test4sub11of100,test4pub44of100,1,190,6,459,0,465
test4sub37of100,test4pub44of100,1,190,6,473,6,485
test4sub81of100,test4pub44of100,1,190,6,482,1,489
test4sub28of100,test4pub44of100,1,190,6,485,1,492
test4sub20of100,test4pub44of100,1,190,6,486,2,494
test4sub50of100,test4pub44of100,1,190,6,487,1,494
test4sub98of100,test4pub45of100,1,190,5,12,1,18
test4sub85of100,test4pub44of100,1,190,6,499,1,506
test4sub33of100,test4pub44of100,1,190,6,505,0,511
test4sub44of100,test4pub45of100,1,190,5,27,1,33
test4sub53of100,test4pub44of100,1,190,6,506,2,514
test4sub12of100,test4pub44of100,1,190,6,509,1,516
test4sub23of100,test4pub45of100,1,190,5,38,0,43
test4sub99of100,test4pub45of100,1,190,5,39,1,45
test4sub31of100,test4pub45of100,1,190,5,57,1,63
test4sub94of100,test4pub44of100,1,190,6,542,0,548
test4sub91of100,test4pub44of100,1,190,6,547,1,554
test4sub62of100,test4pub45of100,1,190,5,69,1,75
test4sub68of100,test4pub45of100,1,190,5,71,1,77
test4sub99of100,test4pub44of100,1,190,6,552,1,559
test4sub43of100,test4pub44of100,1,190,6,565,2,573
test4sub15of100,test4pub44of100,1,190,6,565,3,574
test4sub69of100,test4pub45of100,1,190,5,86,3,94
test4sub7of100,test4pub45of100,1,190,5,86,4,95
test4sub75of100,test4pub45of100,1,190,5,87,3,95
test4sub97of100,test4pub44of100,1,190,6,568,2,576
test4sub60of100,test4pub44of100,1,190,6,568,3,577
test4sub76of100,test4pub44of100,1,190,6,571,0,577
test4sub100of100,test4pub45of100,1,190,5,93,1,99
test4sub33of100,test4pub45of100,1,190,5,94,1,100
test4sub95of100,test4pub45of100,1,190,5,95,1,101
test4sub18of100,test4pub45of100,1,190,5,101,0,106
test4sub64of100,test4pub45of100,1,190,5,111,1,117
test4sub79of100,test4pub45of100,1,190,5,116,1,122
test4sub12of100,test4pub45of100,1,190,5,122,1,128
test4sub17of100,test4pub45of100,1,190,5,122,0,127
test4sub43of100,test4pub45of100,1,190,5,129,0,134
test4sub35of100,test4pub45of100,1,190,5,135,1,141
test4sub50of100,test4pub45of100,1,190,5,139,1,145
test4sub20of100,test4pub45of100,1,190,5,139,2,146
test4sub56of100,test4pub45of100,1,190,5,140,2,147
test4sub61of100,test4pub45of100,1,190,5,141,2,148
test4sub27of100,test4pub45of100,1,190,5,149,1,155
test4sub9of100,test4pub45of100,1,190,5,149,2,156
test4sub3of100,test4pub45of100,1,190,5,151,1,157
test4sub77of100,test4pub45of100,1,190,5,153,1,159
test4sub1of100,test4pub45of100,1,190,5,158,1,164
test4sub83of100,test4pub45of100,1,190,5,162,1,168
test4sub34of100,test4pub45of100,1,190,5,167,1,173
test4sub84of100,test4pub45of100,1,190,5,168,1,174
test4sub51of100,test4pub45of100,1,190,5,169,0,174
test4sub63of100,test4pub45of100,1,190,5,170,1,176
test4sub4of100,test4pub45of100,1,190,5,174,1,180
test4sub86of100,test4pub45of100,1,190,5,176,1,182
test4sub66of100,test4pub45of100,1,190,5,178,1,184
test4sub6of100,test4pub45of100,1,190,5,181,0,186
test4sub15of100,test4pub45of100,1,190,5,191,0,196
test4sub13of100,test4pub45of100,1,190,5,192,1,198
test4sub91of100,test4pub45of100,1,190,5,194,1,200
test4sub58of100,test4pub45of100,1,190,5,195,0,200
test4sub71of100,test4pub45of100,1,190,5,202,1,208
test4sub74of100,test4pub45of100,1,190,5,203,1,209
test4sub59of100,test4pub45of100,1,190,5,211,0,216
test4sub72of100,test4pub45of100,1,190,5,217,0,222
test4sub37of100,test4pub45of100,1,190,5,225,0,230
test4sub73of100,test4pub45of100,1,190,5,234,0,239
test4sub25of100,test4pub45of100,1,190,5,235,1,241
test4sub5of100,test4pub45of100,1,190,5,239,0,244
test4sub57of100,test4pub45of100,1,190,5,242,1,248
test4sub87of100,test4pub45of100,1,190,5,243,0,248
test4sub28of100,test4pub45of100,1,190,5,245,0,250
test4sub30of100,test4pub45of100,1,190,5,248,1,254
test4sub60of100,test4pub45of100,1,190,5,253,0,258
test4sub67of100,test4pub45of100,1,190,5,259,1,265
test4sub88of100,test4pub45of100,1,190,5,261,2,268
test4sub82of100,test4pub45of100,1,190,5,262,2,269
test4sub94of100,test4pub45of100,1,190,5,262,2,269
test4sub36of100,test4pub45of100,1,190,5,263,2,270
test4sub32of100,test4pub45of100,1,190,5,264,1,270
test4sub93of100,test4pub45of100,1,190,5,266,0,271
test4sub53of100,test4pub45of100,1,190,5,275,1,281
test4sub81of100,test4pub45of100,1,190,5,275,0,280
test4sub92of100,test4pub45of100,1,190,5,281,1,287
test4sub16of100,test4pub45of100,1,190,5,285,0,290
test4sub22of100,test4pub45of100,1,190,5,291,1,297
test4sub80of100,test4pub45of100,1,190,5,299,1,305
test4sub39of100,test4pub45of100,1,190,5,306,1,312
test4sub54of100,test4pub45of100,1,190,5,321,0,326
test4sub14of100,test4pub45of100,1,190,5,330,1,336
test4sub46of100,test4pub45of100,1,190,5,331,1,337
test4sub78of100,test4pub45of100,1,190,5,333,0,338
test4sub52of100,test4pub45of100,1,190,5,334,1,340
test4sub89of100,test4pub45of100,1,190,5,339,1,345
test4sub96of100,test4pub45of100,1,190,5,341,0,346
test4sub45of100,test4pub45of100,1,190,5,348,0,353
test4sub2of100,test4pub45of100,1,190,5,348,1,354
test4sub48of100,test4pub45of100,1,190,5,351,0,356
test4sub42of100,test4pub45of100,1,190,5,352,1,358
test4sub40of100,test4pub45of100,1,190,5,364,1,370
test4sub65of100,test4pub45of100,1,190,5,364,1,370
test4sub49of100,test4pub45of100,1,190,5,365,1,371
test4sub97of100,test4pub45of100,1,190,5,367,1,373
test4sub29of100,test4pub45of100,1,190,5,375,1,381
test4sub90of100,test4pub45of100,1,190,5,376,0,381
test4sub85of100,test4pub45of100,1,190,5,376,1,382
test4sub10of100,test4pub45of100,1,190,5,378,1,384
test4sub47of100,test4pub45of100,1,190,5,379,2,386
test4sub55of100,test4pub45of100,1,190,5,380,1,386
test4sub8of100,test4pub45of100,1,190,5,381,1,387
test4sub19of100,test4pub45of100,1,190,5,386,0,391
test4sub1of100,test4pub46of100,1,190,5,28,0,33
test4sub26of100,test4pub45of100,1,190,5,403,0,408
test4sub10of100,test4pub46of100,1,190,5,42,1,48
test4sub24of100,test4pub45of100,1,190,5,406,1,412
test4sub38of100,test4pub45of100,1,190,5,418,1,424
test4sub81of100,test4pub46of100,1,190,5,63,0,68
test4sub23of100,test4pub46of100,1,190,5,66,1,72
test4sub70of100,test4pub45of100,1,190,5,430,1,436
test4sub59of100,test4pub46of100,1,190,5,69,1,75
test4sub96of100,test4pub46of100,1,190,5,70,1,76
test4sub2of100,test4pub46of100,1,190,5,71,2,78
test4sub21of100,test4pub45of100,1,190,5,435,1,441
test4sub41of100,test4pub45of100,1,190,5,438,1,444
test4sub87of100,test4pub46of100,1,190,5,78,1,84
test4sub76of100,test4pub45of100,1,190,5,441,1,447
test4sub11of100,test4pub45of100,1,190,5,442,1,448
test4sub16of100,test4pub46of100,1,190,5,87,2,94
test4sub69of100,test4pub46of100,1,190,5,88,1,94
test4sub45of100,test4pub46of100,1,190,5,106,0,111
test4sub67of100,test4pub46of100,1,190,5,109,0,114
test4sub28of100,test4pub46of100,1,190,5,116,1,122
test4sub41of100,test4pub46of100,1,190,5,117,1,123
test4sub63of100,test4pub46of100,1,190,5,118,1,124
test4sub33of100,test4pub46of100,1,190,5,128,1,134
test4sub78of100,test4pub46of100,1,190,5,130,0,135
test4sub92of100,test4pub46of100,1,190,5,132,2,139
test4sub3of100,test4pub46of100,1,190,5,132,1,138
test4sub58of100,test4pub46of100,1,190,5,133,1,139
test4sub9of100,test4pub46of100,1,190,5,134,1,140
test4sub54of100,test4pub46of100,1,190,5,140,1,146
test4sub72of100,test4pub46of100,1,190,5,146,1,152
test4sub20of100,test4pub46of100,1,190,5,147,1,153
test4sub94of100,test4pub46of100,1,190,5,149,1,155
test4sub57of100,test4pub46of100,1,190,5,149,1,155
test4sub19of100,test4pub46of100,1,190,5,157,1,163
test4sub31of100,test4pub46of100,1,190,5,157,2,164
test4sub12of100,test4pub46of100,1,190,5,158,2,165
test4sub74of100,test4pub46of100,1,190,5,159,3,167
test4sub91of100,test4pub46of100,1,190,5,160,4,169
test4sub86of100,test4pub46of100,1,190,5,161,3,169
test4sub37of100,test4pub46of100,1,190,5,162,2,169
test4sub49of100,test4pub46of100,1,190,5,163,2,170
test4sub60of100,test4pub46of100,1,190,5,163,2,170
test4sub39of100,test4pub46of100,1,190,5,167,1,173
test4sub32of100,test4pub46of100,1,190,5,207,1,213
test4sub80of100,test4pub46of100,1,190,5,212,1,218
test4sub56of100,test4pub46of100,1,190,5,216,1,222
test4sub18of100,test4pub46of100,1,190,5,217,1,223
test4sub7of100,test4pub46of100,1,190,5,225,1,231
test4sub21of100,test4pub46of100,1,190,5,226,1,232
test4sub93of100,test4pub46of100,1,190,5,227,2,234
test4sub27of100,test4pub46of100,1,190,5,228,2,235
test4sub29of100,test4pub46of100,1,190,5,229,2,236
test4sub51of100,test4pub46of100,1,190,5,230,1,236
test4sub11of100,test4pub46of100,1,190,5,234,0,239
test4sub100of100,test4pub46of100,1,190,5,236,1,242
test4sub83of100,test4pub46of100,1,190,5,238,1,244
test4sub76of100,test4pub46of100,1,190,5,239,1,245
test4sub17of100,test4pub46of100,1,190,5,244,1,250
test4sub26of100,test4pub46of100,1,190,5,247,0,252
test4sub68of100,test4pub46of100,1,190,5,252,0,257
test4sub35of100,test4pub46of100,1,190,5,263,0,268
test4sub48of100,test4pub46of100,1,190,5,268,0,273
test4sub82of100,test4pub46of100,1,190,5,269,1,275
test4sub4of100,test4pub46of100,1,190,5,277,1,283
test4sub24of100,test4pub46of100,1,190,5,279,1,285
test4sub70of100,test4pub46of100,1,190,5,280,1,286
test4sub73of100,test4pub46of100,1,190,5,282,1,288
test4sub42of100,test4pub46of100,1,190,5,289,1,295
test4sub99of100,test4pub46of100,1,190,5,293,1,299
test4sub52of100,test4pub46of100,1,190,5,293,0,298
test4sub64of100,test4pub46of100,1,190,5,295,1,301
test4sub5of100,test4pub46of100,1,190,5,309,1,315
test4sub6of100,test4pub46of100,1,190,5,314,1,320
test4sub98of100,test4pub46of100,1,190,5,322,1,328
test4sub50of100,test4pub46of100,1,190,5,323,2,330
test4sub46of100,test4pub46of100,1,190,5,324,1,330
test4sub13of100,test4pub46of100,1,190,5,326,1,332
test4sub75of100,test4pub46of100,1,190,5,337,1,343
test4sub97of100,test4pub46of100,1,190,5,349,1,355
test4sub77of100,test4pub46of100,1,190,5,352,1,358
test4sub90of100,test4pub46of100,1,190,5,359,1,365
test4sub71of100,test4pub46of100,1,190,5,366,1,372
test4sub34of100,test4pub46of100,1,190,5,367,1,373
test4sub14of100,test4pub46of100,1,190,5,371,1,377
test4sub53of100,test4pub46of100,1,190,5,376,1,382
test4sub66of100,test4pub46of100,1,190,5,382,0,387
test4sub62of100,test4pub46of100,1,190,5,407,1,413
test4sub84of100,test4pub46of100,1,190,5,437,1,443
test4sub15of100,test4pub46of100,1,190,5,441,1,447
test4sub36of100,test4pub46of100,1,190,5,442,1,448
test4sub42of100,test4pub47of100,1,190,5,16,1,22
test4sub50of100,test4pub47of100,1,190,5,21,0,26
test4sub22of100,test4pub46of100,1,190,5,459,1,465
test4sub32of100,test4pub47of100,1,190,5,28,0,33
test4sub6of100,test4pub47of100,1,190,5,40,1,46
test4sub38of100,test4pub46of100,1,190,5,474,0,479
test4sub46of100,test4pub47of100,1,190,5,42,1,48
test4sub30of100,test4pub46of100,1,190,5,490,1,496
test4sub72of100,test4pub47of100,1,190,5,59,1,65
test4sub65of100,test4pub46of100,1,190,5,495,1,501
test4sub89of100,test4pub46of100,1,190,5,495,0,500
test4sub64of100,test4pub47of100,1,190,5,65,1,71
test4sub96of100,test4pub47of100,1,190,5,66,1,72
test4sub88of100,test4pub46of100,1,190,5,500,1,506
test4sub95of100,test4pub46of100,1,190,5,503,1,509
test4sub20of100,test4pub47of100,1,190,5,77,1,83
test4sub18of100,test4pub47of100,1,190,5,87,1,93
test4sub3of100,test4pub47of100,1,190,5,88,1,94
test4sub15of100,test4pub47of100,1,190,5,93,1,99
test4sub47of100,test4pub46of100,1,190,5,532,1,538
test4sub43of100,test4pub46of100,1,190,5,564,1,570
test4sub51of100,test4pub47of100,1,190,5,135,1,141
test4sub25of100,test4pub46of100,1,190,5,570,0,575
test4sub55of100,test4pub46of100,1,190,5,574,0,579
test4sub79of100,test4pub46of100,1,190,5,579,1,585
test4sub89of100,test4pub47of100,1,190,5,147,1,153
test4sub66of100,test4pub47of100,1,190,5,147,2,154
test4sub12of100,test4pub47of100,1,190,5,149,0,154
test4sub10of100,test4pub47of100,1,190,5,151,1,157
test4sub44of100,test4pub46of100,1,190,5,585,2,592
test4sub62of100,test4pub47of100,1,190,5,153,1,159
test4sub40of100,test4pub46of100,1,190,5,590,0,595
test4sub85of100,test4pub46of100,1,190,5,592,1,598
test4sub8of100,test4pub46of100,1,190,5,595,0,600
test4sub61of100,test4pub46of100,1,190,5,609,1,615
test4sub4of100,test4pub47of100,1,190,5,178,1,184
test4sub60of100,test4pub47of100,1,190,5,182,0,187
test4sub99of100,test4pub47of100,1,190,5,187,0,192
test4sub67of100,test4pub47of100,1,190,5,188,1,194
test4sub70of100,test4pub47of100,1,190,5,195,1,201
test4sub68of100,test4pub47of100,1,190,5,204,0,209
test4sub52of100,test4pub47of100,1,190,5,209,0,214
test4sub31of100,test4pub47of100,1,190,5,213,1,219
test4sub53of100,test4pub47of100,1,190,5,214,1,220
test4sub97of100,test4pub47of100,1,190,5,216,1,222
test4sub83of100,test4pub47of100,1,190,5,217,1,223
test4sub37of100,test4pub47of100,1,190,5,225,1,231
test4sub98of100,test4pub47of100,1,190,5,231,1,237
test4sub81of100,test4pub47of100,1,190,5,233,0,238
test4sub79of100,test4pub47of100,1,190,5,252,1,258
test4sub48of100,test4pub47of100,1,190,5,256,1,262
test4sub93of100,test4pub47of100,1,190,5,264,0,269
test4sub22of100,test4pub47of100,1,190,5,271,1,277
test4sub35of100,test4pub47of100,1,190,5,272,1,278
test4sub38of100,test4pub47of100,1,190,5,280,0,285
test4sub58of100,test4pub47of100,1,190,5,286,1,292
test4sub25of100,test4pub47of100,1,190,5,291,0,296
test4sub26of100,test4pub47of100,1,190,5,309,1,315
test4sub59of100,test4pub47of100,1,190,5,345,1,351
test4sub41of100,test4pub48of100,1,190,9,11,1,21
test4sub4of100,test4pub48of100,1,190,9,13,1,23
test4sub11of100,test4pub47of100,1,190,5,383,0,388
test4sub55of100,test4pub48of100,1,190,9,36,1,46
test4sub83of100,test4pub48of100,1,190,9,38,1,48
test4sub56of100,test4pub47of100,1,190,5,394,1,400
test4sub43of100,test4pub48of100,1,190,9,45,1,55
test4sub24of100,test4pub48of100,1,190,9,48,1,58
test4sub20of100,test4pub48of100,1,190,9,53,107,169
test4sub27of100,test4pub48of100,1,190,9,67,95,171
test4sub43of100,test4pub47of100,1,190,5,424,91,520
test4sub5of100,test4pub47of100,1,190,5,426,88,519
test4sub19of100,test4pub47of100,1,190,5,431,84,520
test4sub74of100,test4pub48of100,1,190,9,85,79,173
test4sub38of100,test4pub48of100,1,190,9,89,75,173
test4sub7of100,test4pub47of100,1,190,5,446,71,522
test4sub34of100,test4pub48of100,1,190,9,98,67,174
test4sub30of100,test4pub47of100,1,190,5,466,54,525
test4sub28of100,test4pub47of100,1,190,5,477,44,526
test4sub40of100,test4pub48of100,1,190,9,137,33,179
test4sub86of100,test4pub47of100,1,190,5,490,31,526
test4sub54of100,test4pub47of100,1,190,5,495,26,526
test4sub63of100,test4pub47of100,1,190,5,498,25,528
test4sub94of100,test4pub47of100,1,190,5,498,24,527
test4sub97of100,test4pub48of100,1,190,9,147,24,180
test4sub72of100,test4pub48of100,1,190,9,158,13,180
test4sub100of100,test4pub47of100,1,190,5,510,14,529
test4sub87of100,test4pub47of100,1,190,5,511,14,530
test4sub69of100,test4pub48of100,1,190,9,160,14,183
test4sub99of100,test4pub48of100,1,190,9,160,14,183
test4sub91of100,test4pub47of100,1,190,5,513,13,531
test4sub5of100,test4pub48of100,1,190,9,163,12,184
test4sub53of100,test4pub48of100,1,190,9,166,9,184
test4sub90of100,test4pub47of100,1,190,5,518,9,532
test4sub16of100,test4pub47of100,1,190,5,519,9,533
test4sub2of100,test4pub47of100,1,190,5,519,10,534
test4sub36of100,test4pub48of100,1,190,9,169,10,188
test4sub78of100,test4pub48of100,1,190,9,172,7,188
test4sub37of100,test4pub48of100,1,190,9,172,7,188
test4sub34of100,test4pub47of100,1,190,5,526,6,537
test4sub89of100,test4pub48of100,1,190,9,177,2,188
test4sub74of100,test4pub47of100,1,190,5,530,2,537
test4sub47of100,test4pub47of100,1,190,5,550,1,556
test4sub58of100,test4pub48of100,1,190,9,208,1,218
test4sub88of100,test4pub47of100,1,190,5,565,1,571
test4sub77of100,test4pub47of100,1,190,5,567,1,573
test4sub95of100,test4pub47of100,1,190,5,568,2,575
test4sub65of100,test4pub47of100,1,190,5,569,1,575
test4sub60of100,test4pub48of100,1,190,9,219,0,228
test4sub36of100,test4pub47of100,1,190,5,573,0,578
test4sub55of100,test4pub47of100,1,190,5,586,1,592
test4sub80of100,test4pub47of100,1,190,5,588,1,594
test4sub46of100,test4pub48of100,1,190,9,238,0,247
test4sub78of100,test4pub47of100,1,190,5,596,3,604
test4sub70of100,test4pub48of100,1,190,9,244,3,256
test4sub45of100,test4pub47of100,1,190,5,597,2,604
test4sub57of100,test4pub47of100,1,190,5,598,2,605
test4sub24of100,test4pub47of100,1,190,5,598,2,605
test4sub94of100,test4pub48of100,1,190,9,248,2,259
test4sub82of100,test4pub47of100,1,190,5,602,1,608
test4sub100of100,test4pub48of100,1,190,9,251,2,262
test4sub22of100,test4pub48of100,1,190,9,252,2,263
test4sub29of100,test4pub47of100,1,190,5,604,3,612
test4sub41of100,test4pub47of100,1,190,5,605,3,613
test4sub93of100,test4pub48of100,1,190,9,254,2,265
test4sub17of100,test4pub47of100,1,190,5,607,1,613
test4sub85of100,test4pub47of100,1,190,5,615,0,620
test4sub73of100,test4pub47of100,1,190,5,615,2,622
test4sub13of100,test4pub48of100,1,190,9,264,2,275
test4sub95of100,test4pub48of100,1,190,9,265,1,275
test4sub44of100,test4pub48of100,1,190,9,265,1,275
test4sub54of100,test4pub48of100,1,190,9,288,1,298
test4sub71of100,test4pub47of100,1,190,5,650,1,656
test4sub88of100,test4pub48of100,1,190,9,315,1,325
test4sub23of100,test4pub48of100,1,190,9,319,1,329
test4sub64of100,test4pub48of100,1,190,9,323,0,332
test4sub76of100,test4pub47of100,1,190,5,677,1,683
test4sub28of100,test4pub48of100,1,190,9,326,1,336
test4sub40of100,test4pub47of100,1,190,5,682,1,688
test4sub33of100,test4pub47of100,1,190,5,684,1,690
test4sub9of100,test4pub48of100,1,190,9,334,2,345
test4sub25of100,test4pub48of100,1,190,9,334,2,345
test4sub66of100,test4pub48of100,1,190,9,335,2,346
test4sub18of100,test4pub48of100,1,190,9,336,1,346
test4sub8of100,test4pub47of100,1,190,5,692,1,698
test4sub35of100,test4pub48of100,1,190,9,341,0,350
test4sub2of100,test4pub48of100,1,190,9,345,1,355
test4sub21of100,test4pub47of100,1,190,5,698,1,704
test4sub69of100,test4pub47of100,1,190,5,705,0,710
test4sub30of100,test4pub48of100,1,190,9,355,0,364
test4sub31of100,test4pub48of100,1,190,9,355,1,365
test4sub49of100,test4pub47of100,1,190,5,714,1,720
test4sub61of100,test4pub47of100,1,190,5,714,1,720
test4sub13of100,test4pub47of100,1,190,5,719,1,725
test4sub82of100,test4pub48of100,1,190,9,370,1,380
test4sub84of100,test4pub47of100,1,190,5,722,2,729
test4sub27of100,test4pub47of100,1,190,5,723,1,729
test4sub14of100,test4pub47of100,1,190,5,724,2,731
test4sub1of100,test4pub47of100,1,190,5,727,1,733
test4sub75of100,test4pub47of100,1,190,5,728,2,735
test4sub9of100,test4pub47of100,1,190,5,729,1,735
test4sub77of100,test4pub48of100,1,190,9,381,1,391
test4sub21of100,test4pub48of100,1,190,9,385,1,395
test4sub80of100,test4pub48of100,1,190,9,404,0,413
test4sub92of100,test4pub47of100,1,190,5,758,1,764
test4sub91of100,test4pub48of100,1,190,9,410,1,420
test4sub23of100,test4pub47of100,1,190,5,768,1,774
test4sub26of100,test4pub48of100,1,190,9,417,1,427
test4sub44of100,test4pub47of100,1,190,5,770,1,776
test4sub39of100,test4pub47of100,1,190,5,772,2,779
test4sub32of100,test4pub48of100,1,190,9,421,1,431
test4sub57of100,test4pub48of100,1,190,9,423,1,433
test4sub87of100,test4pub48of100,1,190,9,429,1,439
test4sub29of100,test4pub48of100,1,190,9,430,0,439
test4sub84of100,test4pub48of100,1,190,9,432,1,442
test4sub52of100,test4pub48of100,1,190,9,433,1,443
test4sub3of100,test4pub48of100,1,190,9,436,1,446
test4sub86of100,test4pub48of100,1,190,9,435,1,445
test4sub76of100,test4pub48of100,1,190,9,440,1,450
test4sub85of100,test4pub48of100,1,190,9,441,2,452
test4sub6of100,test4pub48of100,1,190,9,443,1,453
test4sub61of100,test4pub48of100,1,190,9,444,1,454
test4sub1of100,test4pub48of100,1,190,9,445,2,456
test4sub75of100,test4pub48of100,1,190,9,446,1,456
test4sub62of100,test4pub48of100,1,190,9,447,1,457
test4sub10of100,test4pub48of100,1,190,9,455,1,465
test4sub98of100,test4pub48of100,1,190,9,457,2,468
test4sub59of100,test4pub48of100,1,190,9,458,1,468
test4sub73of100,test4pub48of100,1,190,9,459,0,468
test4sub56of100,test4pub48of100,1,190,9,461,0,470
test4sub14of100,test4pub48of100,1,190,9,461,0,470
test4sub79of100,test4pub48of100,1,190,9,469,1,479
test4sub8of100,test4pub48of100,1,190,9,470,1,480
test4sub45of100,test4pub48of100,1,190,9,479,1,489
test4sub81of100,test4pub48of100,1,190,9,480,1,490
test4sub7of100,test4pub48of100,1,190,9,488,0,497
test4sub96of100,test4pub48of100,1,190,9,499,1,509
test4sub15of100,test4pub48of100,1,190,9,501,0,510
test4sub51of100,test4pub48of100,1,190,9,520,1,530
test4sub67of100,test4pub48of100,1,190,9,524,1,534
test4sub63of100,test4pub48of100,1,190,9,525,10,544
test4sub71of100,test4pub48of100,1,190,9,533,2,544
test4sub16of100,test4pub48of100,1,190,9,534,2,545
test4sub48of100,test4pub48of100,1,190,9,534,3,546
test4sub42of100,test4pub48of100,1,190,9,533,2,544
test4sub17of100,test4pub48of100,1,190,9,533,2,544
test4sub50of100,test4pub48of100,1,190,9,539,1,549
test4sub39of100,test4pub48of100,1,190,9,547,0,556
test4sub33of100,test4pub48of100,1,190,9,557,1,567
test4sub68of100,test4pub48of100,1,190,9,558,1,568
test4sub34of100,test4pub49of100,1,190,6,34,0,40
test4sub80of100,test4pub49of100,1,190,6,37,1,44
test4sub93of100,test4pub49of100,1,190,6,38,1,45
test4sub19of100,test4pub48of100,1,190,9,570,0,579
test4sub60of100,test4pub49of100,1,190,6,43,2,51
test4sub12of100,test4pub48of100,1,190,9,572,2,583
test4sub71of100,test4pub49of100,1,190,6,46,1,53
test4sub37of100,test4pub49of100,1,190,6,52,1,59
test4sub81of100,test4pub49of100,1,190,6,60,1,67
test4sub79of100,test4pub49of100,1,190,6,60,0,66
test4sub19of100,test4pub49of100,1,190,6,72,1,79
test4sub65of100,test4pub48of100,1,190,9,601,1,611
test4sub49of100,test4pub48of100,1,190,9,602,0,611
test4sub67of100,test4pub49of100,1,190,6,77,1,84
test4sub30of100,test4pub49of100,1,190,6,78,1,85
test4sub3of100,test4pub49of100,1,190,6,79,0,85
test4sub90of100,test4pub48of100,1,190,9,609,1,619
test4sub51of100,test4pub49of100,1,190,6,86,0,92
test4sub92of100,test4pub48of100,1,190,9,626,0,635
test4sub47of100,test4pub48of100,1,190,9,630,1,640
test4sub12of100,test4pub49of100,1,190,6,109,1,116
test4sub11of100,test4pub48of100,1,190,9,635,1,645
test4sub98of100,test4pub49of100,1,190,6,120,0,126
test4sub87of100,test4pub49of100,1,190,6,120,1,127
test4sub85of100,test4pub49of100,1,190,6,131,1,138
test4sub75of100,test4pub49of100,1,190,6,139,1,146
test4sub11of100,test4pub49of100,1,190,6,146,0,152
test4sub91of100,test4pub49of100,1,190,6,153,0,159
test4sub15of100,test4pub49of100,1,190,6,174,0,180
test4sub4of100,test4pub49of100,1,190,6,177,1,184
test4sub86of100,test4pub49of100,1,190,6,177,1,184
test4sub52of100,test4pub49of100,1,190,6,180,2,188
test4sub76of100,test4pub49of100,1,190,6,180,3,189
test4sub92of100,test4pub49of100,1,190,6,181,1,188
test4sub73of100,test4pub49of100,1,190,6,181,3,190
test4sub90of100,test4pub49of100,1,190,6,183,3,192
test4sub84of100,test4pub49of100,1,190,6,184,2,192
test4sub47of100,test4pub49of100,1,190,6,184,3,193
test4sub56of100,test4pub49of100,1,190,6,185,2,193
test4sub54of100,test4pub49of100,1,190,6,186,2,194
test4sub23of100,test4pub49of100,1,190,6,188,0,194
test4sub16of100,test4pub49of100,1,190,6,199,1,206
test4sub100of100,test4pub49of100,1,190,6,202,0,208
test4sub31of100,test4pub49of100,1,190,6,203,3,212
test4sub28of100,test4pub49of100,1,190,6,204,1,211
test4sub72of100,test4pub49of100,1,190,6,204,2,212
test4sub63of100,test4pub49of100,1,190,6,205,2,213
test4sub82of100,test4pub49of100,1,190,6,212,1,219
test4sub68of100,test4pub49of100,1,190,6,215,1,222
test4sub36of100,test4pub49of100,1,190,6,215,1,222
test4sub77of100,test4pub49of100,1,190,6,224,1,231
test4sub83of100,test4pub49of100,1,190,6,226,1,233
test4sub94of100,test4pub49of100,1,190,6,227,1,234
test4sub33of100,test4pub49of100,1,190,6,232,0,238
test4sub59of100,test4pub49of100,1,190,6,243,1,250
test4sub39of100,test4pub49of100,1,190,6,244,2,252
test4sub95of100,test4pub49of100,1,190,6,245,1,252
test4sub62of100,test4pub49of100,1,190,6,246,1,253
test4sub38of100,test4pub49of100,1,190,6,249,0,255
test4sub21of100,test4pub49of100,1,190,6,250,0,256
test4sub46of100,test4pub49of100,1,190,6,255,0,261
test4sub49of100,test4pub49of100,1,190,6,258,1,265
test4sub78of100,test4pub49of100,1,190,6,258,2,266
test4sub7of100,test4pub49of100,1,190,6,260,3,269
test4sub41of100,test4pub49of100,1,190,6,259,3,268
test4sub5of100,test4pub49of100,1,190,6,260,2,268
test4sub96of100,test4pub49of100,1,190,6,261,2,269
test4sub69of100,test4pub49of100,1,190,6,261,2,269
test4sub17of100,test4pub49of100,1,190,6,264,0,270
test4sub42of100,test4pub49of100,1,190,6,268,0,274
test4sub18of100,test4pub49of100,1,190,6,284,1,291
test4sub70of100,test4pub49of100,1,190,6,288,1,295
test4sub2of100,test4pub49of100,1,190,6,296,1,303
test4sub74of100,test4pub49of100,1,190,6,299,1,306
test4sub99of100,test4pub49of100,1,190,6,331,1,338
test4sub22of100,test4pub49of100,1,190,6,335,0,341
test4sub43of100,test4pub49of100,1,190,6,344,1,351
test4sub35of100,test4pub49of100,1,190,6,350,0,356
test4sub57of100,test4pub49of100,1,190,6,355,1,362
test4sub44of100,test4pub49of100,1,190,6,362,0,368
test4sub89of100,test4pub49of100,1,190,6,364,1,371
test4sub25of100,test4pub49of100,1,190,6,365,1,372
test4sub40of100,test4pub49of100,1,190,6,365,1,372
test4sub97of100,test4pub49of100,1,190,6,366,1,373
test4sub14of100,test4pub49of100,1,190,6,373,0,379
test4sub50of100,test4pub49of100,1,190,6,377,1,384
test4sub10of100,test4pub49of100,1,190,6,377,2,385
test4sub65of100,test4pub49of100,1,190,6,378,1,385
test4sub24of100,test4pub49of100,1,190,6,381,1,388
test4sub88of100,test4pub49of100,1,190,6,382,1,389
test4sub66of100,test4pub49of100,1,190,6,382,2,390
test4sub48of100,test4pub49of100,1,190,6,390,1,397
test4sub27of100,test4pub49of100,1,190,6,389,1,396
test4sub13of100,test4pub49of100,1,190,6,395,0,401
test4sub45of100,test4pub49of100,1,190,6,412,1,419
test4sub61of100,test4pub49of100,1,190,6,412,2,420
test4sub6of100,test4pub49of100,1,190,6,413,1,420
test4sub55of100,test4pub49of100,1,190,6,415,1,422
test4sub64of100,test4pub49of100,1,190,6,419,0,425
test4sub29of100,test4pub49of100,1,190,6,423,0,429
test4sub32of100,test4pub49of100,1,190,6,426,1,433
test4sub8of100,test4pub49of100,1,190,6,441,1,448
test4sub58of100,test4pub49of100,1,190,6,441,1,448
test4sub1of100,test4pub49of100,1,190,6,444,1,451
test4sub20of100,test4pub49of100,1,190,6,449,2,457
test4sub53of100,test4pub49of100,1,190,6,449,3,458
test4sub9of100,test4pub49of100,1,190,6,450,1,457
test4sub26of100,test4pub49of100,1,190,6,451,1,458
test4sub24of100,test4pub50of100,1,190,5,29,1,35
test4sub86of100,test4pub50of100,1,190,5,39,0,44
test4sub25of100,test4pub50of100,1,190,5,49,0,54
test4sub18of100,test4pub50of100,1,190,5,56,1,62
test4sub47of100,test4pub50of100,1,190,5,61,1,67
test4sub6of100,test4pub50of100,1,190,5,72,0,77
test4sub4of100,test4pub50of100,1,190,5,72,1,78
test4sub63of100,test4pub50of100,1,190,5,74,1,80
test4sub51of100,test4pub50of100,1,190,5,82,0,87
test4sub62of100,test4pub50of100,1,190,5,96,0,101
test4sub10of100,test4pub50of100,1,190,5,114,1,120
test4sub96of100,test4pub50of100,1,190,5,117,0,122
test4sub46of100,test4pub50of100,1,190,5,120,0,125
test4sub76of100,test4pub50of100,1,190,5,120,1,126
test4sub22of100,test4pub50of100,1,190,5,123,1,129
test4sub40of100,test4pub50of100,1,190,5,123,1,129
test4sub78of100,test4pub50of100,1,190,5,138,1,144
test4sub95of100,test4pub50of100,1,190,5,143,1,149
test4sub68of100,test4pub50of100,1,190,5,143,1,149
test4sub31of100,test4pub50of100,1,190,5,144,1,150
test4sub57of100,test4pub50of100,1,190,5,147,1,153
test4sub93of100,test4pub50of100,1,190,5,151,1,157
test4sub34of100,test4pub50of100,1,190,5,153,1,159
test4sub84of100,test4pub50of100,1,190,5,153,2,160
test4sub3of100,test4pub50of100,1,190,5,154,1,160
test4sub16of100,test4pub50of100,1,190,5,155,1,161
test4sub42of100,test4pub50of100,1,190,5,156,1,162
test4sub50of100,test4pub50of100,1,190,5,166,1,172
test4sub15of100,test4pub50of100,1,190,5,177,1,183
test4sub43of100,test4pub50of100,1,190,5,178,0,183
test4sub7of100,test4pub50of100,1,190,5,185,0,190
test4sub80of100,test4pub50of100,1,190,5,191,0,196
test4sub89of100,test4pub50of100,1,190,5,196,1,202
test4sub49of100,test4pub50of100,1,190,5,197,0,202
test4sub97of100,test4pub50of100,1,190,5,206,1,212
test4sub58of100,test4pub50of100,1,190,5,208,1,214
test4sub53of100,test4pub50of100,1,190,5,211,0,216
test4sub36of100,test4pub50of100,1,190,5,234,1,240
test4sub91of100,test4pub50of100,1,190,5,244,0,249
test4sub61of100,test4pub50of100,1,190,5,247,1,253
test4sub44of100,test4pub50of100,1,190,5,253,1,259
test4sub2of100,test4pub50of100,1,190,5,255,1,261
test4sub87of100,test4pub50of100,1,190,5,262,1,268
test4sub74of100,test4pub50of100,1,190,5,278,0,283
test4sub32of100,test4pub50of100,1,190,5,283,1,289
test4sub88of100,test4pub50of100,1,190,5,284,1,290
test4sub55of100,test4pub50of100,1,190,5,298,0,303
test4sub66of100,test4pub50of100,1,190,5,309,0,314
test4sub92of100,test4pub50of100,1,190,5,320,1,326
test4sub44of100,test4pub51of100,1,190,5,23,1,29
test4sub38of100,test4pub51of100,1,190,5,32,1,38
test4sub32of100,test4pub51of100,1,190,5,55,1,61
test4sub70of100,test4pub50of100,1,190,5,363,0,368
test4sub84of100,test4pub51of100,1,190,5,64,1,70
test4sub36of100,test4pub51of100,1,190,5,68,0,73
test4sub82of100,test4pub50of100,1,190,5,382,1,388
test4sub69of100,test4pub51of100,1,190,5,83,1,89
test4sub93of100,test4pub51of100,1,190,5,114,1,120
test4sub71of100,test4pub51of100,1,190,5,136,1,142
test4sub81of100,test4pub50of100,1,190,5,444,1,450
test4sub46of100,test4pub51of100,1,190,5,148,1,154
test4sub48of100,test4pub50of100,1,190,5,455,2,462
test4sub67of100,test4pub50of100,1,190,5,455,1,461
test4sub80of100,test4pub51of100,1,190,5,150,1,156
test4sub8of100,test4pub50of100,1,190,5,459,1,465
test4sub14of100,test4pub50of100,1,190,5,461,1,467
test4sub98of100,test4pub50of100,1,190,5,462,1,468
test4sub41of100,test4pub50of100,1,190,5,463,1,469
test4sub5of100,test4pub50of100,1,190,5,462,2,469
test4sub33of100,test4pub50of100,1,190,5,467,1,473
test4sub63of100,test4pub51of100,1,190,5,168,1,174
test4sub20of100,test4pub50of100,1,190,5,476,2,483
test4sub21of100,test4pub50of100,1,190,5,476,2,483
test4sub60of100,test4pub50of100,1,190,5,477,5,487
test4sub79of100,test4pub51of100,1,190,5,171,6,182
test4sub59of100,test4pub50of100,1,190,5,477,5,487
test4sub48of100,test4pub51of100,1,190,5,169,9,183
test4sub90of100,test4pub51of100,1,190,5,172,6,183
test4sub83of100,test4pub51of100,1,190,5,173,4,182
test4sub26of100,test4pub50of100,1,190,5,479,4,488
test4sub73of100,test4pub51of100,1,190,5,174,4,183
test4sub67of100,test4pub51of100,1,190,5,174,4,183
test4sub27of100,test4pub50of100,1,190,5,482,3,490
test4sub12of100,test4pub50of100,1,190,5,491,1,497
test4sub15of100,test4pub51of100,1,190,5,185,2,192
test4sub28of100,test4pub50of100,1,190,5,492,1,498
test4sub81of100,test4pub51of100,1,190,5,187,2,194
test4sub30of100,test4pub50of100,1,190,5,494,1,500
test4sub71of100,test4pub50of100,1,190,5,499,0,504
test4sub39of100,test4pub51of100,1,190,5,205,1,211
test4sub70of100,test4pub51of100,1,190,5,205,0,210
test4sub52of100,test4pub50of100,1,190,5,519,1,525
test4sub9of100,test4pub50of100,1,190,5,519,0,524
test4sub7of100,test4pub51of100,1,190,5,215,2,222
test4sub99of100,test4pub51of100,1,190,5,215,3,223
test4sub86of100,test4pub51of100,1,190,5,216,2,223
test4sub13of100,test4pub50of100,1,190,5,522,2,529
test4sub77of100,test4pub50of100,1,190,5,522,2,529
test4sub11of100,test4pub51of100,1,190,5,220,0,225
test4sub40of100,test4pub51of100,1,190,5,223,0,228
test4sub56of100,test4pub51of100,1,190,5,223,1,229
test4sub1of100,test4pub51of100,1,190,5,225,0,230
test4sub35of100,test4pub50of100,1,190,5,534,1,540
test4sub29of100,test4pub51of100,1,190,5,231,0,236
test4sub76of100,test4pub51of100,1,190,5,250,0,255
test4sub64of100,test4pub50of100,1,190,5,557,1,563
test4sub21of100,test4pub51of100,1,190,5,252,2,259
test4sub20of100,test4pub51of100,1,190,5,252,3,260
test4sub90of100,test4pub50of100,1,190,5,559,2,566
test4sub73of100,test4pub50of100,1,190,5,560,1,566
test4sub30of100,test4pub51of100,1,190,5,262,0,267
test4sub39of100,test4pub50of100,1,190,5,581,1,587
test4sub91of100,test4pub51of100,1,190,5,275,2,282
test4sub45of100,test4pub50of100,1,190,5,582,0,587
test4sub54of100,test4pub50of100,1,190,5,584,1,590
test4sub24of100,test4pub51of100,1,190,5,279,1,285
test4sub49of100,test4pub51of100,1,190,5,280,1,286
test4sub99of100,test4pub50of100,1,190,5,588,0,593
test4sub19of100,test4pub51of100,1,190,5,292,0,297
test4sub13of100,test4pub51of100,1,190,5,294,1,300
test4sub75of100,test4pub50of100,1,190,5,601,1,607
test4sub42of100,test4pub51of100,1,190,5,296,2,303
test4sub65of100,test4pub50of100,1,190,5,603,1,609
test4sub12of100,test4pub51of100,1,190,5,323,1,329
test4sub100of100,test4pub50of100,1,190,5,634,1,640
test4sub47of100,test4pub51of100,1,190,5,337,1,343
test4sub27of100,test4pub51of100,1,190,5,340,1,346
test4sub2of100,test4pub51of100,1,190,5,341,3,349
test4sub1of100,test4pub50of100,1,190,5,647,3,655
test4sub5of100,test4pub51of100,1,190,5,342,5,352
test4sub94of100,test4pub50of100,1,190,5,649,6,660
test4sub8of100,test4pub51of100,1,190,5,344,5,354
test4sub78of100,test4pub51of100,1,190,5,344,5,354
test4sub38of100,test4pub50of100,1,190,5,651,5,661
test4sub56of100,test4pub50of100,1,190,5,652,5,662
test4sub83of100,test4pub50of100,1,190,5,653,4,662
test4sub72of100,test4pub50of100,1,190,5,654,4,663
test4sub9of100,test4pub51of100,1,190,5,356,0,361
test4sub41of100,test4pub51of100,1,190,5,357,1,363
test4sub25of100,test4pub51of100,1,190,5,365,2,372
test4sub77of100,test4pub51of100,1,190,5,366,4,375
test4sub23of100,test4pub50of100,1,190,5,672,5,682
test4sub85of100,test4pub50of100,1,190,5,673,4,682
test4sub17of100,test4pub50of100,1,190,5,674,4,683
test4sub11of100,test4pub50of100,1,190,5,675,4,684
test4sub37of100,test4pub50of100,1,190,5,675,5,685
test4sub43of100,test4pub51of100,1,190,5,369,4,378
test4sub79of100,test4pub50of100,1,190,5,676,5,686
test4sub69of100,test4pub50of100,1,190,5,677,6,688
test4sub58of100,test4pub51of100,1,190,5,373,3,381
test4sub22of100,test4pub51of100,1,190,5,375,3,383
test4sub68of100,test4pub51of100,1,190,5,375,2,382
test4sub51of100,test4pub51of100,1,190,5,376,2,383
test4sub35of100,test4pub51of100,1,190,5,386,0,391
test4sub95of100,test4pub51of100,1,190,5,388,0,393
test4sub82of100,test4pub51of100,1,190,5,392,1,398
test4sub55of100,test4pub51of100,1,190,5,392,1,398
test4sub87of100,test4pub51of100,1,190,5,401,1,407
test4sub33of100,test4pub51of100,1,190,5,409,1,415
test4sub29of100,test4pub50of100,1,190,5,717,1,723
test4sub57of100,test4pub51of100,1,190,5,418,1,424
test4sub64of100,test4pub51of100,1,190,5,421,1,427
test4sub89of100,test4pub51of100,1,190,5,422,0,427
test4sub4of100,test4pub51of100,1,190,5,429,1,435
test4sub10of100,test4pub51of100,1,190,5,434,0,439
test4sub88of100,test4pub51of100,1,190,5,437,2,444
test4sub98of100,test4pub51of100,1,190,5,438,2,445
test4sub14of100,test4pub51of100,1,190,5,439,2,446
test4sub59of100,test4pub51of100,1,190,5,440,1,446
test4sub100of100,test4pub51of100,1,190,5,450,0,455
test4sub6of100,test4pub51of100,1,190,5,458,1,464
test4sub97of100,test4pub51of100,1,190,5,469,0,474
test4sub72of100,test4pub51of100,1,190,5,470,1,476
test4sub23of100,test4pub51of100,1,190,5,473,1,479
test4sub85of100,test4pub51of100,1,190,5,477,1,483
test4sub17of100,test4pub51of100,1,190,5,480,1,486
test4sub94of100,test4pub51of100,1,190,5,481,2,488
test4sub66of100,test4pub51of100,1,190,5,482,1,488
test4sub62of100,test4pub51of100,1,190,5,485,1,491
test4sub53of100,test4pub51of100,1,190,5,491,1,497
test4sub96of100,test4pub51of100,1,190,5,502,0,507
test4sub31of100,test4pub51of100,1,190,5,512,1,518
test4sub34of100,test4pub51of100,1,190,5,517,1,523
test4sub45of100,test4pub51of100,1,190,5,529,1,535
test4sub75of100,test4pub51of100,1,190,5,529,0,534
test4sub16of100,test4pub51of100,1,190,5,540,1,546
test4sub54of100,test4pub51of100,1,190,5,553,1,559
test4sub74of100,test4pub51of100,1,190,5,556,0,561
test4sub3of100,test4pub51of100,1,190,5,559,0,564
test4sub52of100,test4pub51of100,1,190,5,568,0,573
test4sub26of100,test4pub51of100,1,190,5,569,0,574
test4sub50of100,test4pub51of100,1,190,5,571,1,577
test4sub60of100,test4pub51of100,1,190,5,571,1,577
test4sub18of100,test4pub51of100,1,190,5,572,1,578
test4sub37of100,test4pub51of100,1,190,5,614,1,620
test4sub92of100,test4pub51of100,1,190,5,639,1,645
test4sub61of100,test4pub51of100,1,190,5,671,0,676
test4sub19of100,test4pub50of100,1,190,5,982,1,988
test4sub28of100,test4pub51of100,1,190,5,677,1,683
test4sub65of100,test4pub51of100,1,190,5,679,0,684
test4sub29of100,test4pub52of100,1,190,5,18,0,23
test4sub91of100,test4pub52of100,1,190,5,65,0,70
test4sub59of100,test4pub52of100,1,190,5,79,1,85
test4sub58of100,test4pub52of100,1,190,5,91,0,96
test4sub8of100,test4pub52of100,1,190,5,102,0,107
test4sub98of100,test4pub52of100,1,190,5,109,1,115
test4sub34of100,test4pub52of100,1,190,5,121,1,127
test4sub23of100,test4pub52of100,1,190,5,130,3,138
test4sub27of100,test4pub52of100,1,190,5,130,2,137
test4sub79of100,test4pub52of100,1,190,5,131,3,139
test4sub21of100,test4pub52of100,1,190,5,131,2,138
test4sub22of100,test4pub52of100,1,190,5,132,2,139
test4sub87of100,test4pub52of100,1,190,5,135,1,141
test4sub2of100,test4pub52of100,1,190,5,137,0,142
test4sub76of100,test4pub52of100,1,190,5,137,2,144
test4sub25of100,test4pub52of100,1,190,5,139,0,144
test4sub97of100,test4pub52of100,1,190,5,150,1,156
test4sub69of100,test4pub52of100,1,190,5,152,0,157
test4sub75of100,test4pub52of100,1,190,5,153,1,159
test4sub3of100,test4pub52of100,1,190,5,169,1,175
test4sub10of100,test4pub52of100,1,190,5,171,1,177
test4sub28of100,test4pub52of100,1,190,5,174,1,180
test4sub38of100,test4pub52of100,1,190,5,180,1,186
test4sub82of100,test4pub52of100,1,190,5,184,1,190
test4sub41of100,test4pub52of100,1,190,5,194,1,200
test4sub11of100,test4pub52of100,1,190,5,203,1,209
test4sub63of100,test4pub52of100,1,190,5,206,0,211
test4sub39of100,test4pub52of100,1,190,5,213,1,219
test4sub16of100,test4pub52of100,1,190,5,217,2,224
test4sub84of100,test4pub52of100,1,190,5,218,1,224
test4sub73of100,test4pub52of100,1,190,5,232,1,238
test4sub67of100,test4pub52of100,1,190,5,243,1,249
test4sub71of100,test4pub52of100,1,190,5,247,1,253
test4sub40of100,test4pub52of100,1,190,5,255,1,261
test4sub86of100,test4pub52of100,1,190,5,255,1,261
test4sub19of100,test4pub52of100,1,190,5,260,1,266
test4sub14of100,test4pub52of100,1,190,5,268,1,274
test4sub45of100,test4pub52of100,1,190,5,272,1,278
test4sub5of100,test4pub52of100,1,190,5,289,0,294
test4sub88of100,test4pub52of100,1,190,5,293,0,298
test4sub15of100,test4pub52of100,1,190,5,308,1,314
test4sub48of100,test4pub52of100,1,190,5,308,1,314
test4sub77of100,test4pub52of100,1,190,5,333,1,339
test4sub54of100,test4pub52of100,1,190,5,335,0,340
test4sub24of100,test4pub52of100,1,190,5,343,1,349
test4sub64of100,test4pub52of100,1,190,5,353,0,358
test4sub70of100,test4pub52of100,1,190,5,373,1,379
test4sub57of100,test4pub53of100,1,190,5,31,0,36
test4sub19of100,test4pub53of100,1,190,5,34,0,39
test4sub23of100,test4pub53of100,1,190,5,34,1,40
test4sub66of100,test4pub52of100,1,190,5,383,1,389
test4sub9of100,test4pub52of100,1,190,5,397,1,403
test4sub32of100,test4pub52of100,1,190,5,404,0,409
test4sub37of100,test4pub53of100,1,190,5,64,1,70
test4sub27of100,test4pub53of100,1,190,5,64,1,70
test4sub59of100,test4pub53of100,1,190,5,71,0,76
test4sub78of100,test4pub52of100,1,190,5,419,1,425
test4sub82of100,test4pub53of100,1,190,5,73,0,78
test4sub66of100,test4pub53of100,1,190,5,75,1,81
test4sub33of100,test4pub52of100,1,190,5,423,1,429
test4sub55of100,test4pub52of100,1,190,5,424,0,429
test4sub18of100,test4pub52of100,1,190,5,425,1,431
test4sub56of100,test4pub52of100,1,190,5,455,0,460
test4sub13of100,test4pub52of100,1,190,5,457,0,462
test4sub41of100,test4pub53of100,1,190,5,113,1,119
test4sub11of100,test4pub53of100,1,190,5,118,0,123
test4sub39of100,test4pub53of100,1,190,5,120,0,125
test4sub89of100,test4pub52of100,1,190,5,467,1,473
test4sub20of100,test4pub52of100,1,190,5,469,1,475
test4sub62of100,test4pub52of100,1,190,5,469,0,474
test4sub98of100,test4pub53of100,1,190,5,126,0,131
test4sub46of100,test4pub53of100,1,190,5,125,2,132
test4sub28of100,test4pub53of100,1,190,5,136,1,142
test4sub81of100,test4pub53of100,1,190,5,139,0,144
test4sub91of100,test4pub53of100,1,190,5,145,1,151
test4sub99of100,test4pub53of100,1,190,5,155,0,160
test4sub42of100,test4pub52of100,1,190,5,501,1,507
test4sub77of100,test4pub53of100,1,190,5,158,1,164
test4sub68of100,test4pub52of100,1,190,5,505,2,512
test4sub85of100,test4pub53of100,1,190,5,160,1,166
test4sub1of100,test4pub52of100,1,190,5,507,1,513
test4sub96of100,test4pub53of100,1,190,5,163,1,169
test4sub49of100,test4pub52of100,1,190,5,511,1,517
test4sub4of100,test4pub52of100,1,190,5,520,1,526
test4sub65of100,test4pub52of100,1,190,5,521,3,529
test4sub55of100,test4pub53of100,1,190,5,176,2,183
test4sub40of100,test4pub53of100,1,190,5,176,3,184
test4sub33of100,test4pub53of100,1,190,5,175,4,184
test4sub69of100,test4pub53of100,1,190,5,178,3,186
test4sub31of100,test4pub52of100,1,190,5,524,3,532
test4sub57of100,test4pub52of100,1,190,5,525,3,533
test4sub36of100,test4pub52of100,1,190,5,527,1,533
test4sub63of100,test4pub53of100,1,190,5,182,1,188
test4sub17of100,test4pub53of100,1,190,5,185,1,191
test4sub30of100,test4pub53of100,1,190,5,192,1,198
test4sub7of100,test4pub53of100,1,190,5,199,1,205
test4sub52of100,test4pub52of100,1,190,5,546,2,553
test4sub74of100,test4pub52of100,1,190,5,547,1,553
test4sub60of100,test4pub53of100,1,190,5,202,1,208
test4sub53of100,test4pub52of100,1,190,5,550,0,555
test4sub84of100,test4pub53of100,1,190,5,206,2,213
test4sub12of100,test4pub52of100,1,190,5,553,3,561
test4sub47of100,test4pub52of100,1,190,5,554,3,562
test4sub44of100,test4pub53of100,1,190,5,208,3,216
test4sub32of100,test4pub53of100,1,190,5,209,1,215
test4sub100of100,test4pub52of100,1,190,5,559,1,565
test4sub51of100,test4pub52of100,1,190,5,559,2,566
test4sub62of100,test4pub53of100,1,190,5,215,1,221
test4sub70of100,test4pub53of100,1,190,5,214,3,222
test4sub64of100,test4pub53of100,1,190,5,215,1,221
test4sub46of100,test4pub52of100,1,190,5,565,1,571
test4sub78of100,test4pub53of100,1,190,5,221,1,227
test4sub26of100,test4pub52of100,1,190,5,568,2,575
test4sub92of100,test4pub53of100,1,190,5,220,5,230
test4sub45of100,test4pub53of100,1,190,5,221,4,230
test4sub80of100,test4pub52of100,1,190,5,568,2,575
test4sub61of100,test4pub52of100,1,190,5,569,2,576
test4sub95of100,test4pub52of100,1,190,5,581,0,586
test4sub85of100,test4pub52of100,1,190,5,584,1,590
test4sub90of100,test4pub52of100,1,190,5,588,1,594
test4sub96of100,test4pub52of100,1,190,5,588,1,594
test4sub6of100,test4pub52of100,1,190,5,590,0,595
test4sub94of100,test4pub53of100,1,190,5,246,1,252
test4sub25of100,test4pub53of100,1,190,5,249,1,255
test4sub81of100,test4pub52of100,1,190,5,603,0,608
test4sub73of100,test4pub53of100,1,190,5,259,1,265
test4sub99of100,test4pub52of100,1,190,5,606,1,612
test4sub37of100,test4pub52of100,1,190,5,607,1,613
test4sub35of100,test4pub52of100,1,190,5,608,1,614
test4sub36of100,test4pub53of100,1,190,5,282,1,288
test4sub93of100,test4pub52of100,1,190,5,633,1,639
test4sub75of100,test4pub53of100,1,190,5,291,0,296
test4sub17of100,test4pub52of100,1,190,5,642,1,648
test4sub7of100,test4pub52of100,1,190,5,650,1,656
test4sub52of100,test4pub53of100,1,190,5,307,1,313
test4sub60of100,test4pub52of100,1,190,5,654,0,659
test4sub83of100,test4pub52of100,1,190,5,658,1,664
test4sub53of100,test4pub53of100,1,190,5,335,1,341
test4sub13of100,test4pub53of100,1,190,5,336,3,344
test4sub89of100,test4pub53of100,1,190,5,337,3,345
test4sub72of100,test4pub52of100,1,190,5,684,3,692
test4sub87of100,test4pub53of100,1,190,5,338,3,346
test4sub43of100,test4pub52of100,1,190,5,684,3,692
test4sub50of100,test4pub52of100,1,190,5,685,4,694
test4sub12of100,test4pub53of100,1,190,5,340,3,348
test4sub16of100,test4pub53of100,1,190,5,341,4,350
test4sub30of100,test4pub52of100,1,190,5,689,2,696
test4sub54of100,test4pub53of100,1,190,5,349,1,355
test4sub44of100,test4pub52of100,1,190,5,696,1,702
test4sub10of100,test4pub53of100,1,190,5,351,2,358
test4sub1of100,test4pub53of100,1,190,5,352,2,359
test4sub76of100,test4pub53of100,1,190,5,354,4,363
test4sub92of100,test4pub52of100,1,190,5,702,3,710
test4sub3of100,test4pub53of100,1,190,5,354,5,364
test4sub88of100,test4pub53of100,1,190,5,356,5,366
test4sub24of100,test4pub53of100,1,190,5,357,4,366
test4sub71of100,test4pub53of100,1,190,5,356,4,365
test4sub67of100,test4pub53of100,1,190,5,358,3,366
test4sub31of100,test4pub53of100,1,190,5,359,2,366
test4sub74of100,test4pub53of100,1,190,5,367,1,373
test4sub4of100,test4pub53of100,1,190,5,368,3,376
test4sub6of100,test4pub53of100,1,190,5,368,2,375
test4sub65of100,test4pub53of100,1,190,5,370,2,377
test4sub20of100,test4pub53of100,1,190,5,369,2,376
test4sub83of100,test4pub53of100,1,190,5,391,1,397
test4sub50of100,test4pub53of100,1,190,5,401,0,406
test4sub51of100,test4pub53of100,1,190,5,406,1,412
test4sub15of100,test4pub53of100,1,190,5,412,0,417
test4sub68of100,test4pub53of100,1,190,5,416,1,422
test4sub58of100,test4pub53of100,1,190,5,428,1,434
test4sub93of100,test4pub53of100,1,190,5,437,1,443
test4sub72of100,test4pub53of100,1,190,5,437,1,443
test4sub2of100,test4pub53of100,1,190,5,442,0,447
test4sub22of100,test4pub53of100,1,190,5,449,0,454
test4sub61of100,test4pub53of100,1,190,5,451,0,456
test4sub21of100,test4pub53of100,1,190,5,457,0,462
test4sub18of100,test4pub53of100,1,190,5,467,1,473
test4sub29of100,test4pub53of100,1,190,5,475,1,481
test4sub86of100,test4pub53of100,1,190,5,481,1,487
test4sub49of100,test4pub53of100,1,190,5,485,1,491
test4sub34of100,test4pub53of100,1,190,5,487,0,492
test4sub90of100,test4pub53of100,1,190,5,489,0,494
test4sub14of100,test4pub53of100,1,190,5,490,1,496
test4sub47of100,test4pub53of100,1,190,5,499,1,505
test4sub97of100,test4pub53of100,1,190,5,511,1,517
test4sub95of100,test4pub53of100,1,190,5,514,1,520
test4sub56of100,test4pub53of100,1,190,5,515,0,520
test4sub80of100,test4pub53of100,1,190,5,522,0,527
test4sub38of100,test4pub53of100,1,190,5,560,1,566
test4sub35of100,test4pub53of100,1,190,5,570,1,576
test4sub48of100,test4pub53of100,1,190,5,574,1,580
test4sub43of100,test4pub53of100,1,190,5,576,1,582
test4sub79of100,test4pub53of100,1,190,5,577,1,583
test4sub100of100,test4pub53of100,1,190,5,586,1,592
test4sub26of100,test4pub53of100,1,190,5,589,0,594
test4sub8of100,test4pub53of100,1,190,5,591,1,597
test4sub32of100,test4pub54of100,1,190,5,24,1,30
test4sub5of100,test4pub53of100,1,190,5,597,1,603
test4sub94of100,test4pub52of100,1,190,5,954,1,960
test4sub42of100,test4pub53of100,1,190,5,612,1,618
test4sub98of100,test4pub54of100,1,190,5,43,0,48
test4sub67of100,test4pub54of100,1,190,5,63,0,68
test4sub61of100,test4pub54of100,1,190,5,67,0,72
test4sub9of100,test4pub54of100,1,190,5,82,1,88
test4sub46of100,test4pub54of100,1,190,5,86,0,91
test4sub9of100,test4pub53of100,1,190,5,663,0,668
test4sub72of100,test4pub54of100,1,190,5,109,0,114
test4sub4of100,test4pub54of100,1,190,5,112,0,117
test4sub54of100,test4pub54of100,1,190,5,117,1,123
test4sub26of100,test4pub54of100,1,190,5,121,1,127
test4sub68of100,test4pub54of100,1,190,5,121,1,127
test4sub8of100,test4pub54of100,1,190,5,125,1,131
test4sub10of100,test4pub54of100,1,190,5,128,0,133
test4sub28of100,test4pub54of100,1,190,5,133,1,139
test4sub57of100,test4pub54of100,1,190,5,135,0,140
test4sub95of100,test4pub54of100,1,190,5,138,1,144
test4sub89of100,test4pub54of100,1,190,5,139,0,144
test4sub15of100,test4pub54of100,1,190,5,138,2,145
test4sub71of100,test4pub54of100,1,190,5,152,1,158
test4sub75of100,test4pub54of100,1,190,5,153,2,160
test4sub59of100,test4pub54of100,1,190,5,154,2,161
test4sub100of100,test4pub54of100,1,190,5,154,2,161
test4sub69of100,test4pub54of100,1,190,5,155,1,161
test4sub70of100,test4pub54of100,1,190,5,160,1,166
test4sub50of100,test4pub54of100,1,190,5,160,1,166
test4sub82of100,test4pub54of100,1,190,5,168,0,173
test4sub44of100,test4pub54of100,1,190,5,170,1,176
test4sub29of100,test4pub54of100,1,190,5,182,1,188
test4sub48of100,test4pub54of100,1,190,5,192,0,197
test4sub53of100,test4pub54of100,1,190,5,195,1,201
test4sub2of100,test4pub54of100,1,190,5,196,2,203
test4sub91of100,test4pub54of100,1,190,5,201,1,207
test4sub34of100,test4pub54of100,1,190,5,201,2,208
test4sub16of100,test4pub54of100,1,190,5,202,1,208
test4sub33of100,test4pub54of100,1,190,5,204,1,210
test4sub92of100,test4pub54of100,1,190,5,205,2,212
test4sub3of100,test4pub54of100,1,190,5,206,2,213
test4sub25of100,test4pub54of100,1,190,5,226,1,232
test4sub39of100,test4pub54of100,1,190,5,226,1,232
test4sub81of100,test4pub54of100,1,190,5,229,0,234
test4sub31of100,test4pub54of100,1,190,5,235,2,242
test4sub55of100,test4pub54of100,1,190,5,236,1,242
test4sub6of100,test4pub54of100,1,190,5,243,1,249
test4sub52of100,test4pub54of100,1,190,5,250,1,256
test4sub78of100,test4pub54of100,1,190,5,252,1,258
test4sub64of100,test4pub54of100,1,190,5,252,0,257
test4sub86of100,test4pub54of100,1,190,5,255,1,261
test4sub65of100,test4pub54of100,1,190,5,255,0,260
test4sub7of100,test4pub54of100,1,190,5,269,1,275
test4sub47of100,test4pub54of100,1,190,5,271,0,276
test4sub18of100,test4pub54of100,1,190,5,277,1,283
test4sub20of100,test4pub54of100,1,190,5,279,0,284
test4sub17of100,test4pub54of100,1,190,5,284,1,290
test4sub56of100,test4pub54of100,1,190,5,294,1,300
test4sub42of100,test4pub54of100,1,190,5,309,1,315
test4sub35of100,test4pub54of100,1,190,5,323,1,329
test4sub62of100,test4pub54of100,1,190,5,327,1,333
test4sub96of100,test4pub54of100,1,190,5,330,0,335
test4sub66of100,test4pub54of100,1,190,5,347,0,352
test4sub88of100,test4pub54of100,1,190,5,350,1,356
test4sub79of100,test4pub54of100,1,190,5,358,1,364
test4sub30of100,test4pub54of100,1,190,5,368,1,374
test4sub90of100,test4pub54of100,1,190,5,375,1,381
test4sub12of100,test4pub54of100,1,190,5,376,1,382
test4sub24of100,test4pub54of100,1,190,5,393,0,398
test4sub29of100,test4pub55of100,1,190,5,13,1,19
test4sub67of100,test4pub55of100,1,190,5,21,1,27
test4sub23of100,test4pub54of100,1,190,5,432,1,438
test4sub18of100,test4pub55of100,1,190,5,36,1,42
test4sub97of100,test4pub54of100,1,190,5,450,1,456
test4sub50of100,test4pub55of100,1,190,5,43,0,48
test4sub58of100,test4pub54of100,1,190,5,460,0,465
test4sub51of100,test4pub55of100,1,190,5,59,1,65
test4sub71of100,test4pub55of100,1,190,5,60,1,66
test4sub38of100,test4pub55of100,1,190,5,61,1,67
test4sub84of100,test4pub54of100,1,190,5,473,1,479
test4sub95of100,test4pub55of100,1,190,5,82,0,87
test4sub9of100,test4pub55of100,1,190,5,90,0,95
test4sub21of100,test4pub54of100,1,190,5,509,1,515
test4sub93of100,test4pub54of100,1,190,5,511,1,517
test4sub73of100,test4pub55of100,1,190,5,102,0,107
test4sub61of100,test4pub55of100,1,190,5,122,1,128
test4sub94of100,test4pub54of100,1,190,5,535,1,541
test4sub47of100,test4pub55of100,1,190,5,126,1,132
test4sub19of100,test4pub55of100,1,190,5,128,2,135
test4sub12of100,test4pub55of100,1,190,5,129,3,137
test4sub46of100,test4pub55of100,1,190,5,129,4,138
test4sub13of100,test4pub54of100,1,190,5,539,4,548
test4sub40of100,test4pub54of100,1,190,5,540,4,549
test4sub4of100,test4pub55of100,1,190,5,131,4,140
test4sub27of100,test4pub54of100,1,190,5,541,4,550
test4sub60of100,test4pub55of100,1,190,5,134,7,146
test4sub22of100,test4pub55of100,1,190,5,135,5,145
test4sub70of100,test4pub55of100,1,190,5,136,6,147
test4sub98of100,test4pub55of100,1,190,5,137,6,148
test4sub68of100,test4pub55of100,1,190,5,138,8,151
test4sub2of100,test4pub55of100,1,190,5,139,8,152
test4sub96of100,test4pub55of100,1,190,5,139,9,153
test4sub6of100,test4pub55of100,1,190,5,140,8,153
test4sub36of100,test4pub55of100,1,190,5,141,6,152
test4sub30of100,test4pub55of100,1,190,5,142,6,153
test4sub14of100,test4pub54of100,1,190,5,553,5,563
test4sub74of100,test4pub54of100,1,190,5,554,5,564
test4sub93of100,test4pub55of100,1,190,5,145,4,154
test4sub49of100,test4pub54of100,1,190,5,555,4,564
test4sub87of100,test4pub54of100,1,190,5,554,4,563
test4sub99of100,test4pub54of100,1,190,5,558,2,565
test4sub32of100,test4pub55of100,1,190,5,151,1,157
test4sub37of100,test4pub54of100,1,190,5,563,1,569
test4sub41of100,test4pub54of100,1,190,5,570,1,576
test4sub80of100,test4pub54of100,1,190,5,573,1,579
test4sub51of100,test4pub54of100,1,190,5,576,1,582
test4sub94of100,test4pub55of100,1,190,5,172,1,178
test4sub82of100,test4pub55of100,1,190,5,175,0,180
test4sub76of100,test4pub54of100,1,190,5,589,1,595
test4sub83of100,test4pub55of100,1,190,5,192,0,197
test4sub55of100,test4pub55of100,1,190,5,230,1,236
test4sub60of100,test4pub54of100,1,190,5,639,1,645
test4sub90of100,test4pub55of100,1,190,5,239,1,245
test4sub5of100,test4pub54of100,1,190,5,648,1,654
test4sub58of100,test4pub55of100,1,190,5,241,0,246
test4sub73of100,test4pub54of100,1,190,5,651,1,657
test4sub36of100,test4pub54of100,1,190,5,652,2,659
test4sub63of100,test4pub54of100,1,190,5,653,2,660
test4sub19of100,test4pub54of100,1,190,5,653,3,661
test4sub69of100,test4pub55of100,1,190,5,245,2,252
test4sub65of100,test4pub55of100,1,190,5,247,1,253
test4sub64of100,test4pub55of100,1,190,5,247,1,253
test4sub22of100,test4pub54of100,1,190,5,662,1,668
test4sub87of100,test4pub55of100,1,190,5,257,0,262
test4sub24of100,test4pub55of100,1,190,5,258,1,264
test4sub1of100,test4pub55of100,1,190,5,257,3,265
test4sub91of100,test4pub55of100,1,190,5,259,3,267
test4sub23of100,test4pub55of100,1,190,5,259,2,266
test4sub38of100,test4pub54of100,1,190,5,669,2,676
test4sub31of100,test4pub55of100,1,190,5,262,1,268
test4sub72of100,test4pub55of100,1,190,5,263,2,270
test4sub97of100,test4pub55of100,1,190,5,264,1,270
test4sub44of100,test4pub55of100,1,190,5,286,1,292
test4sub11of100,test4pub54of100,1,190,5,697,1,703
test4sub79of100,test4pub55of100,1,190,5,289,3,297
test4sub45of100,test4pub54of100,1,190,5,699,2,706
test4sub43of100,test4pub54of100,1,190,5,699,1,705
test4sub77of100,test4pub54of100,1,190,5,702,1,708
test4sub83of100,test4pub54of100,1,190,5,702,1,708
test4sub57of100,test4pub55of100,1,190,5,296,0,301
test4sub85of100,test4pub54of100,1,190,5,706,1,712
test4sub14of100,test4pub55of100,1,190,5,306,1,312
test4sub33of100,test4pub55of100,1,190,5,312,0,317
test4sub63of100,test4pub55of100,1,190,5,320,0,325
test4sub17of100,test4pub55of100,1,190,5,324,1,330
test4sub1of100,test4pub54of100,1,190,5,733,1,739
test4sub11of100,test4pub55of100,1,190,5,326,0,331
test4sub75of100,test4pub55of100,1,190,5,327,0,332
test4sub45of100,test4pub55of100,1,190,5,329,0,334
test4sub86of100,test4pub55of100,1,190,5,337,1,343
test4sub37of100,test4pub55of100,1,190,5,338,0,343
test4sub92of100,test4pub55of100,1,190,5,341,1,347
test4sub78of100,test4pub55of100,1,190,5,342,0,347
test4sub35of100,test4pub55of100,1,190,5,533,0,538
test4sub39of100,test4pub55of100,1,190,5,535,0,540
test4sub59of100,test4pub55of100,1,190,5,536,0,541
test4sub80of100,test4pub55of100,1,190,5,539,1,545
test4sub49of100,test4pub55of100,1,190,5,542,1,548
test4sub26of100,test4pub55of100,1,190,5,543,1,549
test4sub34of100,test4pub55of100,1,190,5,542,4,551
test4sub62of100,test4pub55of100,1,190,5,544,3,552
test4sub66of100,test4pub55of100,1,190,5,545,4,554
test4sub40of100,test4pub55of100,1,190,5,546,3,554
test4sub77of100,test4pub55of100,1,190,5,547,3,555
test4sub20of100,test4pub55of100,1,190,5,547,3,555
test4sub28of100,test4pub55of100,1,190,5,549,2,556
test4sub25of100,test4pub55of100,1,190,5,553,1,559
test4sub74of100,test4pub55of100,1,190,5,555,1,561
test4sub5of100,test4pub55of100,1,190,5,559,1,565
test4sub52of100,test4pub55of100,1,190,5,561,1,567
test4sub27of100,test4pub55of100,1,190,5,562,1,568
test4sub76of100,test4pub55of100,1,190,5,563,0,568
test4sub13of100,test4pub55of100,1,190,5,564,0,569
test4sub7of100,test4pub55of100,1,190,5,569,1,575
test4sub43of100,test4pub55of100,1,190,5,569,1,575
test4sub56of100,test4pub55of100,1,190,5,570,1,576
test4sub15of100,test4pub55of100,1,190,5,574,1,580
test4sub99of100,test4pub55of100,1,190,5,575,1,581
test4sub81of100,test4pub55of100,1,190,5,575,1,581
test4sub48of100,test4pub55of100,1,190,5,577,0,582
test4sub16of100,test4pub55of100,1,190,5,582,1,588
test4sub89of100,test4pub55of100,1,190,5,596,0,601
test4sub85of100,test4pub55of100,1,190,5,600,2,607
test4sub84of100,test4pub55of100,1,190,5,601,1,607
test4sub41of100,test4pub55of100,1,190,5,606,8,619
test4sub53of100,test4pub55of100,1,190,5,613,2,620
test4sub10of100,test4pub55of100,1,190,5,613,3,621
test4sub3of100,test4pub55of100,1,190,5,615,1,621
test4sub21of100,test4pub55of100,1,190,5,616,0,621
test4sub42of100,test4pub55of100,1,190,5,619,0,624
test4sub8of100,test4pub55of100,1,190,5,623,1,629
test4sub54of100,test4pub55of100,1,190,5,632,0,637
test4sub100of100,test4pub55of100,1,190,5,641,1,647
test4sub88of100,test4pub55of100,1,190,5,643,1,649
test4sub51of100,test4pub56of100,1,190,5,28,0,33
test4sub53of100,test4pub56of100,1,190,5,32,0,37
test4sub45of100,test4pub56of100,1,190,5,43,1,49
test4sub41of100,test4pub56of100,1,190,5,48,0,53
test4sub58of100,test4pub56of100,1,190,5,53,0,58
test4sub21of100,test4pub56of100,1,190,5,57,1,63
test4sub80of100,test4pub56of100,1,190,5,63,0,68
test4sub13of100,test4pub56of100,1,190,5,67,1,73
test4sub54of100,test4pub56of100,1,190,5,105,1,111
test4sub91of100,test4pub56of100,1,190,5,122,1,128
test4sub99of100,test4pub56of100,1,190,5,126,1,132
test4sub37of100,test4pub56of100,1,190,5,127,1,133
test4sub2of100,test4pub56of100,1,190,5,131,1,137
test4sub81of100,test4pub56of100,1,190,5,131,2,138
test4sub65of100,test4pub56of100,1,190,5,132,2,139
test4sub19of100,test4pub56of100,1,190,5,133,1,139
test4sub95of100,test4pub56of100,1,190,5,134,1,140
test4sub61of100,test4pub56of100,1,190,5,135,1,141
test4sub62of100,test4pub56of100,1,190,5,139,1,145
test4sub63of100,test4pub56of100,1,190,5,140,1,146
test4sub93of100,test4pub56of100,1,190,5,143,1,149
test4sub64of100,test4pub56of100,1,190,5,147,1,153
test4sub16of100,test4pub56of100,1,190,5,150,1,156
test4sub39of100,test4pub56of100,1,190,5,154,0,159
test4sub60of100,test4pub56of100,1,190,5,155,0,160
test4sub86of100,test4pub56of100,1,190,5,160,1,166
test4sub43of100,test4pub56of100,1,190,5,164,1,170
test4sub17of100,test4pub56of100,1,190,5,165,0,170
test4sub28of100,test4pub56of100,1,190,5,170,1,176
test4sub22of100,test4pub56of100,1,190,5,171,1,177
test4sub89of100,test4pub56of100,1,190,5,176,1,182
test4sub79of100,test4pub56of100,1,190,5,179,1,185
test4sub12of100,test4pub56of100,1,190,5,179,1,185
test4sub77of100,test4pub56of100,1,190,5,183,1,189
test4sub70of100,test4pub56of100,1,190,5,208,1,214
test4sub44of100,test4pub56of100,1,190,5,244,1,250
test4sub57of100,test4pub56of100,1,190,5,248,0,253
test4sub85of100,test4pub56of100,1,190,5,299,1,305
test4sub24of100,test4pub56of100,1,190,5,315,0,320
test4sub51of100,test4pub57of100,1,190,5,34,0,39
test4sub16of100,test4pub57of100,1,190,5,43,1,49
test4sub36of100,test4pub56of100,1,190,5,333,0,338
test4sub70of100,test4pub57of100,1,190,5,52,1,58
test4sub83of100,test4pub57of100,1,190,5,73,1,79
test4sub57of100,test4pub57of100,1,190,5,74,0,79
test4sub93of100,test4pub57of100,1,190,5,76,0,81
test4sub35of100,test4pub57of100,1,190,5,79,1,85
test4sub59of100,test4pub57of100,1,190,5,80,1,86
test4sub65of100,test4pub57of100,1,190,5,87,1,93
test4sub49of100,test4pub56of100,1,190,5,375,2,382
test4sub10of100,test4pub57of100,1,190,5,88,1,94
test4sub78of100,test4pub56of100,1,190,5,379,1,385
test4sub9of100,test4pub56of100,1,190,5,382,0,387
test4sub60of100,test4pub57of100,1,190,5,100,0,105
test4sub63of100,test4pub57of100,1,190,5,102,0,107
test4sub55of100,test4pub57of100,1,190,5,117,1,123
test4sub9of100,test4pub57of100,1,190,5,121,1,127
test4sub67of100,test4pub56of100,1,190,5,413,0,418
test4sub97of100,test4pub56of100,1,190,5,416,1,422
test4sub96of100,test4pub57of100,1,190,5,136,1,142
test4sub52of100,test4pub57of100,1,190,5,136,2,143
test4sub75of100,test4pub56of100,1,190,5,424,1,430
test4sub46of100,test4pub56of100,1,190,5,429,1,435
test4sub32of100,test4pub56of100,1,190,5,429,1,435
test4sub8of100,test4pub57of100,1,190,5,147,2,154
test4sub84of100,test4pub56of100,1,190,5,434,2,441
test4sub50of100,test4pub56of100,1,190,5,435,2,442
test4sub54of100,test4pub57of100,1,190,5,150,3,158
test4sub5of100,test4pub56of100,1,190,5,438,3,446
test4sub100of100,test4pub56of100,1,190,5,438,2,445
test4sub59of100,test4pub56of100,1,190,5,439,1,445
test4sub10of100,test4pub56of100,1,190,5,443,1,449
test4sub27of100,test4pub57of100,1,190,5,161,1,167
test4sub71of100,test4pub57of100,1,190,5,170,2,177
test4sub32of100,test4pub57of100,1,190,5,171,1,177
test4sub85of100,test4pub57of100,1,190,5,176,1,182
test4sub24of100,test4pub57of100,1,190,5,178,1,184
test4sub38of100,test4pub57of100,1,190,5,179,0,184
test4sub40of100,test4pub56of100,1,190,5,469,0,474
test4sub100of100,test4pub57of100,1,190,5,184,0,189
test4sub42of100,test4pub56of100,1,190,5,473,2,480
test4sub6of100,test4pub57of100,1,190,5,188,2,195
test4sub15of100,test4pub57of100,1,190,5,188,1,194
test4sub11of100,test4pub57of100,1,190,5,190,2,197
test4sub94of100,test4pub56of100,1,190,5,479,1,485
test4sub31of100,test4pub56of100,1,190,5,483,1,489
test4sub66of100,test4pub56of100,1,190,5,485,1,491
test4sub76of100,test4pub56of100,1,190,5,489,1,495
test4sub38of100,test4pub56of100,1,190,5,495,0,500
test4sub6of100,test4pub56of100,1,190,5,500,2,507
test4sub86of100,test4pub57of100,1,190,5,214,1,220
test4sub95of100,test4pub57of100,1,190,5,215,1,221
test4sub89of100,test4pub57of100,1,190,5,217,1,223
test4sub3of100,test4pub56of100,1,190,5,506,1,512
test4sub26of100,test4pub56of100,1,190,5,512,1,518
test4sub50of100,test4pub57of100,1,190,5,228,1,234
test4sub90of100,test4pub56of100,1,190,5,515,1,521
test4sub14of100,test4pub56of100,1,190,5,519,1,525
test4sub7of100,test4pub56of100,1,190,5,528,1,534
test4sub76of100,test4pub57of100,1,190,5,243,1,249
test4sub52of100,test4pub56of100,1,190,5,534,1,540
test4sub27of100,test4pub56of100,1,190,5,537,1,543
test4sub17of100,test4pub57of100,1,190,5,253,1,259
test4sub18of100,test4pub56of100,1,190,5,541,2,548
test4sub74of100,test4pub56of100,1,190,5,542,2,549
test4sub96of100,test4pub56of100,1,190,5,543,2,550
test4sub87of100,test4pub57of100,1,190,5,263,1,269
test4sub23of100,test4pub56of100,1,190,5,550,1,556
test4sub34of100,test4pub57of100,1,190,5,264,2,271
test4sub56of100,test4pub56of100,1,190,5,552,1,558
test4sub4of100,test4pub56of100,1,190,5,566,2,573
test4sub25of100,test4pub56of100,1,190,5,567,1,573
test4sub72of100,test4pub56of100,1,190,5,572,0,577
test4sub74of100,test4pub57of100,1,190,5,286,1,292
test4sub92of100,test4pub56of100,1,190,5,576,1,582
test4sub20of100,test4pub56of100,1,190,5,577,1,583
test4sub82of100,test4pub56of100,1,190,5,578,1,584
test4sub2of100,test4pub57of100,1,190,5,294,1,300
test4sub73of100,test4pub56of100,1,190,5,584,1,590
test4sub30of100,test4pub57of100,1,190,5,300,1,306
test4sub69of100,test4pub57of100,1,190,5,302,0,307
test4sub53of100,test4pub57of100,1,190,5,304,0,309
test4sub33of100,test4pub56of100,1,190,5,594,1,600
test4sub41of100,test4pub57of100,1,190,5,310,1,316
test4sub29of100,test4pub56of100,1,190,5,598,1,604
test4sub83of100,test4pub56of100,1,190,5,599,1,605
test4sub71of100,test4pub56of100,1,190,5,601,1,607
test4sub87of100,test4pub56of100,1,190,5,604,0,609
test4sub22of100,test4pub57of100,1,190,5,318,0,323
test4sub48of100,test4pub56of100,1,190,5,608,1,614
test4sub68of100,test4pub56of100,1,190,5,612,1,618
test4sub15of100,test4pub56of100,1,190,5,615,1,621
test4sub55of100,test4pub56of100,1,190,5,619,1,625
test4sub39of100,test4pub57of100,1,190,5,333,0,338
test4sub34of100,test4pub56of100,1,190,5,624,1,630
test4sub75of100,test4pub57of100,1,190,5,336,2,343
test4sub3of100,test4pub57of100,1,190,5,343,1,349
test4sub40of100,test4pub57of100,1,190,5,345,1,351
test4sub30of100,test4pub56of100,1,190,5,633,2,640
test4sub69of100,test4pub56of100,1,190,5,636,0,641
test4sub88of100,test4pub56of100,1,190,5,639,1,645
test4sub1of100,test4pub56of100,1,190,5,640,3,648
test4sub35of100,test4pub56of100,1,190,5,641,3,649
test4sub62of100,test4pub57of100,1,190,5,355,4,364
test4sub11of100,test4pub56of100,1,190,5,642,3,650
test4sub19of100,test4pub57of100,1,190,5,356,4,365
test4sub8of100,test4pub56of100,1,190,5,647,2,654
test4sub98of100,test4pub56of100,1,190,5,650,9,664
test4sub43of100,test4pub57of100,1,190,5,362,9,376
test4sub73of100,test4pub57of100,1,190,5,361,11,377
test4sub47of100,test4pub56of100,1,190,5,647,12,664
test4sub91of100,test4pub57of100,1,190,5,359,5,369
test4sub21of100,test4pub57of100,1,190,5,365,9,379
test4sub90of100,test4pub57of100,1,190,5,375,1,381
test4sub78of100,test4pub57of100,1,190,5,372,4,381
test4sub68of100,test4pub57of100,1,190,5,374,4,383
test4sub49of100,test4pub57of100,1,190,5,376,1,382
test4sub79of100,test4pub57of100,1,190,5,379,1,385
test4sub92of100,test4pub57of100,1,190,5,390,1,396
test4sub36of100,test4pub57of100,1,190,5,395,1,401
test4sub7of100,test4pub57of100,1,190,5,396,2,403
test4sub82of100,test4pub57of100,1,190,5,399,1,405
test4sub58of100,test4pub57of100,1,190,5,398,2,405
test4sub81of100,test4pub57of100,1,190,5,397,4,406
test4sub18of100,test4pub57of100,1,190,5,400,1,406
test4sub98of100,test4pub57of100,1,190,5,417,0,422
test4sub46of100,test4pub57of100,1,190,5,418,2,425
test4sub48of100,test4pub57of100,1,190,5,419,1,425
test4sub99of100,test4pub57of100,1,190,5,431,1,437
test4sub61of100,test4pub57of100,1,190,5,438,1,444
test4sub26of100,test4pub57of100,1,190,5,443,1,449
test4sub5of100,test4pub57of100,1,190,5,469,1,475
test4sub23of100,test4pub57of100,1,190,5,479,1,485
test4sub56of100,test4pub57of100,1,190,5,480,1,486
test4sub31of100,test4pub57of100,1,190,5,481,1,487
test4sub72of100,test4pub57of100,1,190,5,482,1,488
test4sub20of100,test4pub57of100,1,190,5,486,0,491
test4sub25of100,test4pub57of100,1,190,5,489,0,494
test4sub64of100,test4pub57of100,1,190,5,491,1,497
test4sub84of100,test4pub57of100,1,190,5,492,1,498
test4sub97of100,test4pub57of100,1,190,5,494,0,499
test4sub88of100,test4pub57of100,1,190,5,493,2,500
test4sub8of100,test4pub58of100,1,190,5,44,1,50
test4sub29of100,test4pub57of100,1,190,5,521,1,527
test4sub67of100,test4pub58of100,1,190,5,46,1,52
test4sub77of100,test4pub58of100,1,190,5,46,1,52
test4sub60of100,test4pub58of100,1,190,5,49,1,55
test4sub66of100,test4pub57of100,1,190,5,525,2,532
test4sub56of100,test4pub58of100,1,190,5,50,2,57
test4sub6of100,test4pub58of100,1,190,5,51,1,57
test4sub98of100,test4pub58of100,1,190,5,51,1,57
test4sub80of100,test4pub57of100,1,190,5,535,1,541
test4sub94of100,test4pub57of100,1,190,5,542,1,548
test4sub28of100,test4pub57of100,1,190,5,547,0,552
test4sub13of100,test4pub57of100,1,190,5,556,1,562
test4sub74of100,test4pub58of100,1,190,5,82,0,87
test4sub14of100,test4pub57of100,1,190,5,559,1,565
test4sub45of100,test4pub57of100,1,190,5,560,1,566
test4sub97of100,test4pub58of100,1,190,5,85,0,90
test4sub58of100,test4pub58of100,1,190,5,86,1,92
test4sub35of100,test4pub58of100,1,190,5,88,1,94
test4sub44of100,test4pub57of100,1,190,5,565,0,570
test4sub33of100,test4pub57of100,1,190,5,571,1,577
test4sub37of100,test4pub57of100,1,190,5,574,1,580
test4sub65of100,test4pub58of100,1,190,5,110,1,116
test4sub49of100,test4pub58of100,1,190,5,113,0,118
test4sub57of100,test4pub58of100,1,190,5,113,1,119
test4sub42of100,test4pub57of100,1,190,5,591,0,596
test4sub2of100,test4pub58of100,1,190,5,117,2,124
test4sub63of100,test4pub58of100,1,190,5,118,1,124
test4sub47of100,test4pub57of100,1,190,5,594,2,601
test4sub77of100,test4pub57of100,1,190,5,597,1,603
test4sub95of100,test4pub58of100,1,190,5,122,0,127
test4sub82of100,test4pub58of100,1,190,5,131,0,136
test4sub67of100,test4pub57of100,1,190,5,608,1,614
test4sub12of100,test4pub57of100,1,190,5,611,2,618
test4sub1of100,test4pub57of100,1,190,5,611,2,618
test4sub4of100,test4pub57of100,1,190,5,612,2,619
test4sub100of100,test4pub58of100,1,190,5,136,1,142
test4sub24of100,test4pub58of100,1,190,5,139,1,145
test4sub3of100,test4pub58of100,1,190,5,141,1,147
test4sub5of100,test4pub58of100,1,190,5,145,1,151
test4sub54of100,test4pub58of100,1,190,5,153,1,159
test4sub76of100,test4pub58of100,1,190,5,162,0,167
test4sub23of100,test4pub58of100,1,190,5,176,1,182
test4sub69of100,test4pub58of100,1,190,5,178,2,185
test4sub91of100,test4pub58of100,1,190,5,178,3,186
test4sub40of100,test4pub58of100,1,190,5,179,3,187
test4sub15of100,test4pub58of100,1,190,5,180,2,187
test4sub94of100,test4pub58of100,1,190,5,181,2,188
test4sub41of100,test4pub58of100,1,190,5,191,0,196
test4sub42of100,test4pub58of100,1,190,5,192,0,197
test4sub80of100,test4pub58of100,1,190,5,203,1,209
test4sub48of100,test4pub58of100,1,190,5,204,0,209
test4sub18of100,test4pub58of100,1,190,5,206,0,211
test4sub38of100,test4pub58of100,1,190,5,216,5,226
test4sub59of100,test4pub58of100,1,190,5,217,5,227
test4sub64of100,test4pub58of100,1,190,5,218,5,228
test4sub10of100,test4pub58of100,1,190,5,222,1,228
test4sub37of100,test4pub58of100,1,190,5,228,1,234
test4sub83of100,test4pub58of100,1,190,5,229,0,234
test4sub9of100,test4pub58of100,1,190,5,235,1,241
test4sub62of100,test4pub58of100,1,190,5,236,1,242
test4sub86of100,test4pub58of100,1,190,5,247,1,253
test4sub43of100,test4pub58of100,1,190,5,253,1,259
test4sub26of100,test4pub58of100,1,190,5,275,1,281
test4sub96of100,test4pub58of100,1,190,5,279,1,285
test4sub32of100,test4pub58of100,1,190,5,289,1,295
test4sub78of100,test4pub58of100,1,190,5,290,0,295
test4sub92of100,test4pub58of100,1,190,5,294,1,300
test4sub71of100,test4pub58of100,1,190,5,297,2,304
test4sub93of100,test4pub58of100,1,190,5,298,1,304
test4sub19of100,test4pub58of100,1,190,5,299,1,305
test4sub7of100,test4pub58of100,1,190,5,302,0,307
test4sub47of100,test4pub58of100,1,190,5,304,0,309
test4sub53of100,test4pub58of100,1,190,5,307,1,313
test4sub81of100,test4pub58of100,1,190,5,309,0,314
test4sub75of100,test4pub58of100,1,190,5,309,1,315
test4sub30of100,test4pub58of100,1,190,5,315,0,320
test4sub50of100,test4pub58of100,1,190,5,318,1,324
test4sub11of100,test4pub58of100,1,190,5,327,1,333
test4sub44of100,test4pub58of100,1,190,5,335,1,341
test4sub13of100,test4pub58of100,1,190,5,343,1,349
test4sub39of100,test4pub58of100,1,190,5,343,1,349
test4sub21of100,test4pub58of100,1,190,5,348,1,354
test4sub29of100,test4pub58of100,1,190,5,351,1,357
test4sub55of100,test4pub58of100,1,190,5,355,0,360
test4sub72of100,test4pub58of100,1,190,5,372,0,377
test4sub16of100,test4pub58of100,1,190,5,373,0,378
test4sub46of100,test4pub58of100,1,190,5,383,1,389
test4sub45of100,test4pub58of100,1,190,5,392,1,398
test4sub33of100,test4pub58of100,1,190,5,394,0,399
test4sub84of100,test4pub58of100,1,190,5,425,1,431
test4sub14of100,test4pub58of100,1,190,5,426,2,433
test4sub99of100,test4pub58of100,1,190,5,426,1,432
test4sub1of100,test4pub58of100,1,190,5,427,2,434
test4sub79of100,test4pub58of100,1,190,5,428,1,434
test4sub27of100,test4pub58of100,1,190,5,447,1,453
test4sub34of100,test4pub58of100,1,190,5,457,1,463
test4sub4of100,test4pub58of100,1,190,5,466,1,472
test4sub73of100,test4pub58of100,1,190,5,470,1,476
test4sub25of100,test4pub58of100,1,190,5,482,0,487
test4sub90of100,test4pub58of100,1,190,5,484,0,489
test4sub66of100,test4pub58of100,1,190,5,489,0,494
test4sub89of100,test4pub58of100,1,190,5,492,1,498
test4sub18of100,test4pub59of100,1,190,5,15,1,21
test4sub22of100,test4pub59of100,1,190,5,19,0,24
test4sub20of100,test4pub58of100,1,190,5,515,1,521
test4sub79of100,test4pub59of100,1,190,5,32,1,38
test4sub87of100,test4pub58of100,1,190,5,520,1,526
test4sub68of100,test4pub58of100,1,190,5,522,1,528
test4sub61of100,test4pub58of100,1,190,5,525,1,531
test4sub26of100,test4pub59of100,1,190,5,52,1,58
test4sub70of100,test4pub58of100,1,190,5,536,1,542
test4sub41of100,test4pub59of100,1,190,5,63,0,68
test4sub36of100,test4pub58of100,1,190,5,550,1,556
test4sub12of100,test4pub58of100,1,190,5,562,1,568
test4sub9of100,test4pub59of100,1,190,5,79,1,85
test4sub53of100,test4pub59of100,1,190,5,86,0,91
test4sub22of100,test4pub58of100,1,190,5,576,1,582
test4sub69of100,test4pub59of100,1,190,5,107,0,112
test4sub85of100,test4pub59of100,1,190,5,112,0,117
test4sub63of100,test4pub59of100,1,190,5,119,1,125
test4sub85of100,test4pub58of100,1,190,5,609,1,615
test4sub87of100,test4pub59of100,1,190,5,128,1,134
test4sub31of100,test4pub58of100,1,190,5,615,0,620
test4sub11of100,test4pub59of100,1,190,5,139,2,146
test4sub57of100,test4pub59of100,1,190,5,139,2,146
test4sub17of100,test4pub58of100,1,190,5,624,1,630
test4sub95of100,test4pub59of100,1,190,5,143,0,148
test4sub93of100,test4pub59of100,1,190,5,154,1,160
test4sub51of100,test4pub58of100,1,190,5,638,1,644
test4sub88of100,test4pub58of100,1,190,5,640,2,647
test4sub38of100,test4pub59of100,1,190,5,156,2,163
test4sub52of100,test4pub58of100,1,190,5,641,1,647
test4sub28of100,test4pub58of100,1,190,5,641,1,647
test4sub61of100,test4pub59of100,1,190,5,163,1,169
test4sub24of100,test4pub59of100,1,190,5,168,0,173
test4sub25of100,test4pub59of100,1,190,5,173,0,178
test4sub70of100,test4pub59of100,1,190,5,174,1,180
test4sub88of100,test4pub59of100,1,190,5,175,0,180
test4sub46of100,test4pub59of100,1,190,5,180,2,187
test4sub37of100,test4pub59of100,1,190,5,181,2,188
test4sub86of100,test4pub59of100,1,190,5,182,1,188
test4sub14of100,test4pub59of100,1,190,5,182,2,189
test4sub94of100,test4pub59of100,1,190,5,191,1,197
test4sub89of100,test4pub59of100,1,190,5,191,2,198
test4sub96of100,test4pub59of100,1,190,5,192,1,198
test4sub64of100,test4pub59of100,1,190,5,193,1,199
test4sub55of100,test4pub59of100,1,190,5,196,0,201
test4sub66of100,test4pub59of100,1,190,5,205,0,210
test4sub7of100,test4pub59of100,1,190,5,235,1,241
test4sub92of100,test4pub59of100,1,190,5,242,1,248
test4sub59of100,test4pub59of100,1,190,5,243,1,249
test4sub73of100,test4pub59of100,1,190,5,245,0,250
test4sub5of100,test4pub59of100,1,190,5,245,1,251
test4sub30of100,test4pub59of100,1,190,5,249,1,255
test4sub17of100,test4pub59of100,1,190,5,255,0,260
test4sub99of100,test4pub59of100,1,190,5,267,1,273
test4sub77of100,test4pub59of100,1,190,5,268,0,273
test4sub43of100,test4pub59of100,1,190,5,278,0,283
test4sub60of100,test4pub59of100,1,190,5,282,0,287
test4sub28of100,test4pub59of100,1,190,5,292,0,297
test4sub4of100,test4pub59of100,1,190,5,297,1,303
test4sub13of100,test4pub59of100,1,190,5,306,1,312
test4sub80of100,test4pub59of100,1,190,5,313,1,319
test4sub97of100,test4pub59of100,1,190,5,316,1,322
test4sub2of100,test4pub59of100,1,190,5,349,1,355
test4sub15of100,test4pub59of100,1,190,5,350,0,355
test4sub84of100,test4pub59of100,1,190,5,360,1,366
test4sub36of100,test4pub59of100,1,190,5,360,0,365
test4sub29of100,test4pub59of100,1,190,5,365,1,371
test4sub37of100,test4pub60of100,1,190,5,29,2,36
test4sub4of100,test4pub60of100,1,190,5,29,1,35
test4sub90of100,test4pub59of100,1,190,5,393,2,400
test4sub42of100,test4pub60of100,1,190,5,34,1,40
test4sub76of100,test4pub59of100,1,190,5,405,1,411
test4sub26of100,test4pub60of100,1,190,5,46,1,52
test4sub71of100,test4pub59of100,1,190,5,423,1,429
test4sub10of100,test4pub59of100,1,190,5,427,1,433
test4sub72of100,test4pub59of100,1,190,5,429,1,435
test4sub20of100,test4pub59of100,1,190,5,429,0,434
test4sub33of100,test4pub60of100,1,190,5,72,1,78
test4sub30of100,test4pub60of100,1,190,5,83,1,89
test4sub65of100,test4pub60of100,1,190,5,88,1,94
test4sub66of100,test4pub60of100,1,190,5,97,1,103
test4sub52of100,test4pub60of100,1,190,5,103,0,108
test4sub54of100,test4pub60of100,1,190,5,107,1,113
test4sub32of100,test4pub60of100,1,190,5,111,1,117
test4sub74of100,test4pub59of100,1,190,5,479,1,485
test4sub48of100,test4pub59of100,1,190,5,483,0,488
test4sub67of100,test4pub59of100,1,190,5,490,1,496
test4sub64of100,test4pub60of100,1,190,5,127,1,133
test4sub28of100,test4pub60of100,1,190,5,128,1,134
test4sub45of100,test4pub59of100,1,190,5,493,0,498
test4sub52of100,test4pub59of100,1,190,5,493,1,499
test4sub31of100,test4pub59of100,1,190,5,498,2,505
test4sub13of100,test4pub60of100,1,190,5,136,1,142
test4sub49of100,test4pub59of100,1,190,5,500,1,506
test4sub33of100,test4pub59of100,1,190,5,503,1,509
test4sub65of100,test4pub59of100,1,190,5,507,0,512
test4sub36of100,test4pub60of100,1,190,5,144,3,152
test4sub21of100,test4pub59of100,1,190,5,508,2,515
test4sub39of100,test4pub59of100,1,190,5,509,1,515
test4sub98of100,test4pub60of100,1,190,5,147,2,154
test4sub19of100,test4pub59of100,1,190,5,511,1,517
test4sub27of100,test4pub59of100,1,190,5,515,2,522
test4sub1of100,test4pub59of100,1,190,5,515,1,521
test4sub92of100,test4pub60of100,1,190,5,153,2,160
test4sub3of100,test4pub59of100,1,190,5,521,1,527
test4sub44of100,test4pub59of100,1,190,5,521,2,528
test4sub73of100,test4pub60of100,1,190,5,158,1,164
test4sub83of100,test4pub60of100,1,190,5,162,0,167
test4sub68of100,test4pub60of100,1,190,5,179,1,185
test4sub57of100,test4pub60of100,1,190,5,184,0,189
test4sub31of100,test4pub60of100,1,190,5,186,0,191
test4sub34of100,test4pub59of100,1,190,5,557,1,563
test4sub19of100,test4pub60of100,1,190,5,195,1,201
test4sub86of100,test4pub60of100,1,190,5,197,1,203
test4sub49of100,test4pub60of100,1,190,5,200,1,206
test4sub87of100,test4pub60of100,1,190,5,203,1,209
test4sub3of100,test4pub60of100,1,190,5,204,2,211
test4sub82of100,test4pub59of100,1,190,5,567,1,573
test4sub59of100,test4pub60of100,1,190,5,210,1,216
test4sub100of100,test4pub60of100,1,190,5,216,1,222
test4sub1of100,test4pub60of100,1,190,5,222,1,228
test4sub54of100,test4pub59of100,1,190,5,585,0,590
test4sub14of100,test4pub60of100,1,190,5,225,1,231
test4sub53of100,test4pub60of100,1,190,5,226,1,232
test4sub2of100,test4pub60of100,1,190,5,230,1,236
test4sub56of100,test4pub59of100,1,190,5,594,0,599
test4sub6of100,test4pub59of100,1,190,5,602,1,608
test4sub99of100,test4pub60of100,1,190,5,241,0,246
test4sub56of100,test4pub60of100,1,190,5,240,2,247
test4sub40of100,test4pub59of100,1,190,5,609,1,615
test4sub16of100,test4pub59of100,1,190,5,610,1,616
test4sub88of100,test4pub60of100,1,190,5,253,1,259
test4sub81of100,test4pub59of100,1,190,5,618,0,623
test4sub42of100,test4pub59of100,1,190,5,622,1,628
test4sub50of100,test4pub59of100,1,190,5,627,1,633
test4sub100of100,test4pub59of100,1,190,5,630,1,636
test4sub91of100,test4pub59of100,1,190,5,634,1,640
test4sub7of100,test4pub60of100,1,190,5,271,2,278
test4sub40of100,test4pub60of100,1,190,5,273,1,279
test4sub83of100,test4pub59of100,1,190,5,640,0,645
test4sub50of100,test4pub60of100,1,190,5,281,1,287
test4sub23of100,test4pub59of100,1,190,5,648,1,654
test4sub25of100,test4pub60of100,1,190,5,289,1,295
test4sub51of100,test4pub59of100,1,190,5,655,1,661
test4sub90of100,test4pub60of100,1,190,5,292,1,298
test4sub47of100,test4pub59of100,1,190,5,663,1,669
test4sub8of100,test4pub59of100,1,190,5,665,0,670
test4sub82of100,test4pub60of100,1,190,5,305,1,311
test4sub77of100,test4pub60of100,1,190,5,309,0,314
test4sub45of100,test4pub60of100,1,190,5,313,1,319
test4sub78of100,test4pub60of100,1,190,5,313,1,319
test4sub96of100,test4pub60of100,1,190,5,314,1,320
test4sub75of100,test4pub59of100,1,190,5,681,1,687
test4sub58of100,test4pub59of100,1,190,5,684,1,690
test4sub85of100,test4pub60of100,1,190,5,323,0,328
test4sub81of100,test4pub60of100,1,190,5,327,0,332
test4sub35of100,test4pub60of100,1,190,5,330,0,335
test4sub15of100,test4pub60of100,1,190,5,331,2,338
test4sub11of100,test4pub60of100,1,190,5,332,2,339
test4sub47of100,test4pub60of100,1,190,5,333,0,338
test4sub68of100,test4pub59of100,1,190,5,705,1,711
test4sub35of100,test4pub59of100,1,190,5,708,1,714
test4sub78of100,test4pub59of100,1,190,5,709,1,715
test4sub32of100,test4pub59of100,1,190,5,718,1,724
test4sub74of100,test4pub60of100,1,190,5,357,0,362
test4sub62of100,test4pub59of100,1,190,5,720,1,726
test4sub98of100,test4pub59of100,1,190,5,724,1,730
test4sub39of100,test4pub60of100,1,190,5,367,1,373
test4sub98of100,test4pub61of100,1,190,6,18,1,25
test4sub20of100,test4pub61of100,1,190,6,18,0,24
test4sub12of100,test4pub59of100,1,190,5,745,1,751
test4sub24of100,test4pub60of100,1,190,5,382,2,389
test4sub97of100,test4pub61of100,1,190,6,32,2,40
test4sub26of100,test4pub61of100,1,190,6,33,2,41
test4sub8of100,test4pub60of100,1,190,5,392,1,398
test4sub55of100,test4pub61of100,1,190,6,42,1,49
test4sub97of100,test4pub60of100,1,190,5,395,1,401
test4sub21of100,test4pub60of100,1,190,5,397,1,403
test4sub58of100,test4pub60of100,1,190,5,399,1,405
test4sub81of100,test4pub61of100,1,190,6,51,1,58
test4sub11of100,test4pub61of100,1,190,6,61,1,68
test4sub92of100,test4pub61of100,1,190,6,62,1,69
test4sub54of100,test4pub61of100,1,190,6,64,1,71
test4sub24of100,test4pub61of100,1,190,6,68,0,74
test4sub84of100,test4pub60of100,1,190,5,425,1,431
test4sub33of100,test4pub61of100,1,190,6,75,1,82
test4sub60of100,test4pub60of100,1,190,5,427,0,432
test4sub9of100,test4pub61of100,1,190,6,81,1,88
test4sub66of100,test4pub61of100,1,190,6,83,1,90
test4sub16of100,test4pub60of100,1,190,5,435,0,440
test4sub18of100,test4pub60of100,1,190,5,441,1,447
test4sub29of100,test4pub60of100,1,190,5,445,1,451
test4sub41of100,test4pub60of100,1,190,5,449,2,456
test4sub73of100,test4pub61of100,1,190,6,99,1,106
test4sub100of100,test4pub61of100,1,190,6,99,2,107
test4sub62of100,test4pub60of100,1,190,5,453,1,459
test4sub55of100,test4pub60of100,1,190,5,458,0,463
test4sub80of100,test4pub60of100,1,190,5,459,2,466
test4sub75of100,test4pub60of100,1,190,5,460,2,467
test4sub69of100,test4pub60of100,1,190,5,460,1,466
test4sub18of100,test4pub61of100,1,190,6,117,1,124
test4sub79of100,test4pub60of100,1,190,5,470,1,476
test4sub38of100,test4pub60of100,1,190,5,471,1,477
test4sub34of100,test4pub60of100,1,190,5,480,1,486
test4sub2of100,test4pub61of100,1,190,6,129,1,136
test4sub63of100,test4pub60of100,1,190,5,483,1,489
test4sub95of100,test4pub60of100,1,190,5,490,1,496
test4sub71of100,test4pub60of100,1,190,5,497,1,503
test4sub89of100,test4pub60of100,1,190,5,504,1,510
test4sub95of100,test4pub61of100,1,190,6,155,0,161
test4sub39of100,test4pub61of100,1,190,6,158,0,164
test4sub12of100,test4pub60of100,1,190,5,513,2,520
test4sub94of100,test4pub61of100,1,190,6,163,2,171
test4sub74of100,test4pub61of100,1,190,6,164,2,172
test4sub70of100,test4pub60of100,1,190,5,517,1,523
test4sub82of100,test4pub61of100,1,190,6,165,3,174
test4sub51of100,test4pub61of100,1,190,6,167,1,174
test4sub5of100,test4pub60of100,1,190,5,521,1,527
test4sub49of100,test4pub61of100,1,190,6,170,1,177
test4sub48of100,test4pub61of100,1,190,6,172,0,178
test4sub89of100,test4pub61of100,1,190,6,175,1,182
test4sub3of100,test4pub61of100,1,190,6,176,1,183
test4sub8of100,test4pub61of100,1,190,6,179,1,186
test4sub96of100,test4pub61of100,1,190,6,181,0,187
test4sub85of100,test4pub61of100,1,190,6,186,1,193
test4sub35of100,test4pub61of100,1,190,6,189,0,195
test4sub17of100,test4pub61of100,1,190,6,199,0,205
test4sub5of100,test4pub61of100,1,190,6,209,1,216
test4sub43of100,test4pub60of100,1,190,5,564,0,569
test4sub10of100,test4pub60of100,1,190,5,565,2,572
test4sub94of100,test4pub60of100,1,190,5,566,1,572
test4sub9of100,test4pub60of100,1,190,5,576,1,582
test4sub6of100,test4pub60of100,1,190,5,580,3,588
test4sub51of100,test4pub60of100,1,190,5,580,3,588
test4sub62of100,test4pub61of100,1,190,6,231,3,240
test4sub99of100,test4pub61of100,1,190,6,231,3,240
test4sub87of100,test4pub61of100,1,190,6,232,2,240
test4sub61of100,test4pub60of100,1,190,5,583,3,591
test4sub72of100,test4pub60of100,1,190,5,593,5,603
test4sub46of100,test4pub60of100,1,190,5,598,1,604
test4sub22of100,test4pub61of100,1,190,6,246,2,254
test4sub48of100,test4pub60of100,1,190,5,604,0,609
test4sub20of100,test4pub60of100,1,190,5,605,1,611
test4sub41of100,test4pub61of100,1,190,6,255,1,262
test4sub44of100,test4pub60of100,1,190,5,607,2,614
test4sub91of100,test4pub60of100,1,190,5,615,0,620
test4sub76of100,test4pub60of100,1,190,5,623,0,628
test4sub17of100,test4pub60of100,1,190,5,636,0,641
test4sub90of100,test4pub61of100,1,190,6,294,1,301
test4sub22of100,test4pub60of100,1,190,5,645,2,652
test4sub15of100,test4pub61of100,1,190,6,295,1,302
test4sub27of100,test4pub60of100,1,190,5,650,0,655
test4sub77of100,test4pub61of100,1,190,6,301,1,308
test4sub93of100,test4pub60of100,1,190,5,657,1,663
test4sub64of100,test4pub61of100,1,190,6,307,1,314
test4sub67of100,test4pub60of100,1,190,5,658,3,666
test4sub23of100,test4pub60of100,1,190,5,659,2,666
test4sub75of100,test4pub61of100,1,190,6,309,2,317
test4sub46of100,test4pub61of100,1,190,6,310,2,318
test4sub47of100,test4pub61of100,1,190,6,311,3,320
test4sub44of100,test4pub61of100,1,190,6,312,2,320
test4sub36of100,test4pub61of100,1,190,6,313,3,322
test4sub12of100,test4pub61of100,1,190,6,314,2,322
test4sub10of100,test4pub61of100,1,190,6,346,0,352
test4sub68of100,test4pub61of100,1,190,6,346,1,353
test4sub30of100,test4pub61of100,1,190,6,353,1,360
test4sub42of100,test4pub61of100,1,190,6,365,0,371
test4sub79of100,test4pub61of100,1,190,6,385,1,392
test4sub59of100,test4pub61of100,1,190,6,394,0,400
test4sub27of100,test4pub61of100,1,190,6,408,1,415
test4sub88of100,test4pub61of100,1,190,6,408,1,415
test4sub60of100,test4pub61of100,1,190,6,414,1,421
test4sub61of100,test4pub61of100,1,190,6,426,1,433
test4sub13of100,test4pub61of100,1,190,6,430,1,437
test4sub15of100,test4pub62of100,1,190,5,25,1,31
test4sub92of100,test4pub62of100,1,190,5,39,1,45
test4sub21of100,test4pub61of100,1,190,6,470,0,476
test4sub19of100,test4pub61of100,1,190,6,473,1,480
test4sub60of100,test4pub62of100,1,190,5,52,0,57
test4sub57of100,test4pub61of100,1,190,6,484,1,491
test4sub67of100,test4pub61of100,1,190,6,486,0,492
test4sub38of100,test4pub61of100,1,190,6,490,1,497
test4sub33of100,test4pub62of100,1,190,5,77,0,82
test4sub62of100,test4pub62of100,1,190,5,91,1,97
test4sub58of100,test4pub61of100,1,190,6,522,0,528
test4sub4of100,test4pub61of100,1,190,6,531,1,538
test4sub6of100,test4pub61of100,1,190,6,531,1,538
test4sub28of100,test4pub61of100,1,190,6,533,1,540
test4sub84of100,test4pub62of100,1,190,5,116,0,121
test4sub45of100,test4pub61of100,1,190,6,545,1,552
test4sub29of100,test4pub61of100,1,190,6,550,2,558
test4sub49of100,test4pub62of100,1,190,5,122,2,129
test4sub13of100,test4pub62of100,1,190,5,123,2,130
test4sub80of100,test4pub61of100,1,190,6,552,1,559
test4sub90of100,test4pub62of100,1,190,5,126,1,132
test4sub71of100,test4pub61of100,1,190,6,561,2,569
test4sub65of100,test4pub62of100,1,190,5,132,2,139
test4sub59of100,test4pub62of100,1,190,5,133,3,141
test4sub53of100,test4pub61of100,1,190,6,562,4,572
test4sub50of100,test4pub62of100,1,190,5,135,2,142
test4sub69of100,test4pub61of100,1,190,6,564,3,573
test4sub89of100,test4pub62of100,1,190,5,136,2,143
test4sub46of100,test4pub62of100,1,190,5,154,0,159
test4sub29of100,test4pub62of100,1,190,5,165,1,171
test4sub95of100,test4pub62of100,1,190,5,166,2,173
test4sub37of100,test4pub61of100,1,190,6,597,1,604
test4sub34of100,test4pub62of100,1,190,5,167,2,174
test4sub78of100,test4pub62of100,1,190,5,168,1,174
test4sub94of100,test4pub62of100,1,190,5,171,1,177
test4sub71of100,test4pub62of100,1,190,5,172,2,179
test4sub53of100,test4pub62of100,1,190,5,173,1,179
test4sub86of100,test4pub61of100,1,190,6,604,1,611
test4sub63of100,test4pub62of100,1,190,5,176,2,183
test4sub81of100,test4pub62of100,1,190,5,176,7,188
test4sub56of100,test4pub61of100,1,190,6,612,1,619
test4sub83of100,test4pub62of100,1,190,5,185,1,191
test4sub9of100,test4pub62of100,1,190,5,187,1,193
test4sub20of100,test4pub62of100,1,190,5,188,1,194
test4sub43of100,test4pub62of100,1,190,5,191,0,196
test4sub76of100,test4pub61of100,1,190,6,621,0,627
test4sub40of100,test4pub61of100,1,190,6,625,1,632
test4sub32of100,test4pub61of100,1,190,6,627,1,634
test4sub65of100,test4pub61of100,1,190,6,633,1,640
test4sub6of100,test4pub62of100,1,190,5,208,1,214
test4sub88of100,test4pub62of100,1,190,5,208,2,215
test4sub21of100,test4pub62of100,1,190,5,209,1,215
test4sub70of100,test4pub61of100,1,190,6,641,0,647
test4sub23of100,test4pub61of100,1,190,6,644,1,651
test4sub78of100,test4pub61of100,1,190,6,646,0,652
test4sub1of100,test4pub61of100,1,190,6,648,0,654
test4sub12of100,test4pub62of100,1,190,5,219,1,225
test4sub31of100,test4pub62of100,1,190,5,224,1,230
test4sub73of100,test4pub62of100,1,190,5,225,1,231
test4sub14of100,test4pub61of100,1,190,6,657,0,663
test4sub84of100,test4pub61of100,1,190,6,657,2,665
test4sub25of100,test4pub61of100,1,190,6,658,1,665
test4sub34of100,test4pub61of100,1,190,6,659,2,667
test4sub72of100,test4pub61of100,1,190,6,664,1,671
test4sub80of100,test4pub62of100,1,190,5,236,1,242
test4sub7of100,test4pub61of100,1,190,6,670,1,677
test4sub57of100,test4pub62of100,1,190,5,243,0,248
test4sub8of100,test4pub62of100,1,190,5,244,0,249
test4sub100of100,test4pub62of100,1,190,5,243,1,249
test4sub16of100,test4pub61of100,1,190,6,671,3,680
test4sub52of100,test4pub61of100,1,190,6,685,1,692
test4sub91of100,test4pub61of100,1,190,6,684,2,692
test4sub44of100,test4pub62of100,1,190,5,257,2,264
test4sub63of100,test4pub61of100,1,190,6,686,1,693
test4sub24of100,test4pub62of100,1,190,5,262,1,268
test4sub93of100,test4pub61of100,1,190,6,702,1,709
test4sub83of100,test4pub61of100,1,190,6,702,1,709
test4sub50of100,test4pub61of100,1,190,6,703,0,709
test4sub26of100,test4pub62of100,1,190,5,277,0,282
test4sub38of100,test4pub62of100,1,190,5,280,1,286
test4sub3of100,test4pub62of100,1,190,5,281,0,286
test4sub96of100,test4pub62of100,1,190,5,299,0,304
test4sub28of100,test4pub62of100,1,190,5,302,1,308
test4sub39of100,test4pub62of100,1,190,5,305,1,311
test4sub43of100,test4pub61of100,1,190,6,735,0,741
test4sub76of100,test4pub62of100,1,190,5,326,1,332
test4sub4of100,test4pub62of100,1,190,5,327,0,332
test4sub19of100,test4pub63of100,1,190,5,41,1,47
test4sub55of100,test4pub63of100,1,190,5,49,1,55
test4sub40of100,test4pub62of100,1,190,5,362,1,368
test4sub31of100,test4pub61of100,1,190,6,793,0,799
test4sub84of100,test4pub63of100,1,190,5,71,0,76
test4sub14of100,test4pub62of100,1,190,5,372,0,377
test4sub25of100,test4pub63of100,1,190,5,74,1,80
test4sub75of100,test4pub63of100,1,190,5,74,3,82
test4sub72of100,test4pub62of100,1,190,5,376,3,384
test4sub66of100,test4pub62of100,1,190,5,377,2,384
test4sub30of100,test4pub62of100,1,190,5,377,3,385
test4sub5of100,test4pub63of100,1,190,5,78,4,87
test4sub79of100,test4pub63of100,1,190,5,80,2,87
test4sub1of100,test4pub62of100,1,190,5,380,3,388
test4sub32of100,test4pub63of100,1,190,5,82,1,88
test4sub17of100,test4pub63of100,1,190,5,83,2,90
test4sub65of100,test4pub63of100,1,190,5,86,1,92
test4sub18of100,test4pub63of100,1,190,5,88,1,94
test4sub11of100,test4pub63of100,1,190,5,88,1,94
test4sub6of100,test4pub63of100,1,190,5,93,1,99
test4sub54of100,test4pub62of100,1,190,5,398,1,404
test4sub90of100,test4pub63of100,1,190,5,103,0,108
test4sub94of100,test4pub63of100,1,190,5,123,1,129
test4sub56of100,test4pub62of100,1,190,5,424,1,430
test4sub10of100,test4pub62of100,1,190,5,430,1,436
test4sub76of100,test4pub63of100,1,190,5,130,1,136
test4sub4of100,test4pub63of100,1,190,5,132,1,138
test4sub86of100,test4pub62of100,1,190,5,432,2,439
test4sub19of100,test4pub62of100,1,190,5,433,1,439
test4sub12of100,test4pub63of100,1,190,5,136,1,142
test4sub93of100,test4pub63of100,1,190,5,136,3,144
test4sub36of100,test4pub62of100,1,190,5,437,3,445
test4sub64of100,test4pub62of100,1,190,5,437,3,445
test4sub99of100,test4pub62of100,1,190,5,438,3,446
test4sub25of100,test4pub62of100,1,190,5,439,3,447
test4sub2of100,test4pub62of100,1,190,5,440,1,446
test4sub91of100,test4pub62of100,1,190,5,445,1,451
test4sub70of100,test4pub63of100,1,190,5,145,1,151
test4sub67of100,test4pub62of100,1,190,5,447,2,454
test4sub1of100,test4pub63of100,1,190,5,147,2,154
test4sub37of100,test4pub62of100,1,190,5,448,2,455
test4sub23of100,test4pub62of100,1,190,5,449,3,457
test4sub46of100,test4pub63of100,1,190,5,149,2,156
test4sub43of100,test4pub63of100,1,190,5,150,1,156
test4sub48of100,test4pub62of100,1,190,5,453,1,459
test4sub57of100,test4pub63of100,1,190,5,154,1,160
test4sub83of100,test4pub63of100,1,190,5,156,1,162
test4sub7of100,test4pub62of100,1,190,5,458,1,464
test4sub56of100,test4pub63of100,1,190,5,159,2,166
test4sub27of100,test4pub62of100,1,190,5,459,1,465
test4sub87of100,test4pub62of100,1,190,5,462,1,468
test4sub58of100,test4pub63of100,1,190,5,172,1,178
test4sub52of100,test4pub62of100,1,190,5,473,0,478
test4sub16of100,test4pub63of100,1,190,5,186,0,191
test4sub42of100,test4pub62of100,1,190,5,507,1,513
test4sub91of100,test4pub63of100,1,190,5,212,1,218
test4sub75of100,test4pub62of100,1,190,5,513,1,519
test4sub28of100,test4pub63of100,1,190,5,217,1,223
test4sub70of100,test4pub62of100,1,190,5,517,2,524
test4sub5of100,test4pub62of100,1,190,5,518,2,525
test4sub74of100,test4pub63of100,1,190,5,219,3,227
test4sub62of100,test4pub63of100,1,190,5,219,2,226
test4sub34of100,test4pub63of100,1,190,5,220,2,227
test4sub82of100,test4pub62of100,1,190,5,530,0,535
test4sub16of100,test4pub62of100,1,190,5,532,1,538
test4sub51of100,test4pub62of100,1,190,5,535,1,541
test4sub73of100,test4pub63of100,1,190,5,240,1,246
test4sub100of100,test4pub63of100,1,190,5,246,0,251
test4sub47of100,test4pub62of100,1,190,5,548,1,554
test4sub97of100,test4pub62of100,1,190,5,549,1,555
test4sub3of100,test4pub63of100,1,190,5,248,1,254
test4sub32of100,test4pub62of100,1,190,5,551,1,557
test4sub87of100,test4pub63of100,1,190,5,251,1,257
test4sub35of100,test4pub62of100,1,190,5,575,1,581
test4sub55of100,test4pub62of100,1,190,5,579,1,585
test4sub72of100,test4pub63of100,1,190,5,283,1,289
test4sub18of100,test4pub62of100,1,190,5,584,0,589
test4sub35of100,test4pub63of100,1,190,5,286,2,293
test4sub14of100,test4pub63of100,1,190,5,287,0,292
test4sub7of100,test4pub63of100,1,190,5,289,1,295
test4sub2of100,test4pub63of100,1,190,5,296,0,301
test4sub45of100,test4pub62of100,1,190,5,604,1,610
test4sub80of100,test4pub63of100,1,190,5,305,1,311
test4sub85of100,test4pub63of100,1,190,5,312,1,318
test4sub98of100,test4pub62of100,1,190,5,615,1,621
test4sub93of100,test4pub62of100,1,190,5,616,0,621
test4sub49of100,test4pub63of100,1,190,5,317,1,323
test4sub64of100,test4pub63of100,1,190,5,322,0,327
test4sub42of100,test4pub63of100,1,190,5,329,1,335
test4sub61of100,test4pub62of100,1,190,5,632,0,637
test4sub41of100,test4pub62of100,1,190,5,632,1,638
test4sub68of100,test4pub62of100,1,190,5,640,3,648
test4sub58of100,test4pub62of100,1,190,5,640,4,649
test4sub63of100,test4pub63of100,1,190,5,341,3,349
test4sub69of100,test4pub62of100,1,190,5,642,3,650
test4sub74of100,test4pub62of100,1,190,5,641,4,650
test4sub38of100,test4pub63of100,1,190,5,342,4,351
test4sub22of100,test4pub62of100,1,190,5,643,4,652
test4sub36of100,test4pub63of100,1,190,5,344,2,351
test4sub30of100,test4pub63of100,1,190,5,349,1,355
test4sub77of100,test4pub62of100,1,190,5,648,1,654
test4sub81of100,test4pub63of100,1,190,5,351,0,356
test4sub11of100,test4pub62of100,1,190,5,651,1,657
test4sub96of100,test4pub63of100,1,190,5,362,0,367
test4sub45of100,test4pub63of100,1,190,5,378,1,384
test4sub85of100,test4pub62of100,1,190,5,686,0,691
test4sub24of100,test4pub63of100,1,190,5,389,1,395
test4sub79of100,test4pub62of100,1,190,5,691,0,696
test4sub51of100,test4pub63of100,1,190,5,396,1,402
test4sub67of100,test4pub63of100,1,190,5,397,1,403
test4sub17of100,test4pub62of100,1,190,5,699,1,705
test4sub88of100,test4pub63of100,1,190,5,399,1,405
test4sub39of100,test4pub63of100,1,190,5,405,1,411
test4sub9of100,test4pub63of100,1,190,5,405,2,412
test4sub77of100,test4pub63of100,1,190,5,406,1,412
test4sub31of100,test4pub63of100,1,190,5,409,1,415
test4sub22of100,test4pub63of100,1,190,5,411,1,417
test4sub52of100,test4pub63of100,1,190,5,412,0,417
test4sub21of100,test4pub63of100,1,190,5,413,2,420
test4sub26of100,test4pub63of100,1,190,5,414,2,421
test4sub97of100,test4pub63of100,1,190,5,415,2,422
test4sub15of100,test4pub63of100,1,190,5,415,1,421
test4sub48of100,test4pub63of100,1,190,5,442,0,447
test4sub86of100,test4pub63of100,1,190,5,456,1,462
test4sub69of100,test4pub63of100,1,190,5,458,1,464
test4sub53of100,test4pub63of100,1,190,5,461,1,467
test4sub61of100,test4pub63of100,1,190,5,462,1,468
test4sub95of100,test4pub63of100,1,190,5,463,1,469
test4sub37of100,test4pub63of100,1,190,5,467,1,473
test4sub44of100,test4pub63of100,1,190,5,468,1,474
test4sub98of100,test4pub63of100,1,190,5,470,1,476
test4sub23of100,test4pub63of100,1,190,5,472,1,478
test4sub99of100,test4pub63of100,1,190,5,482,1,488
test4sub59of100,test4pub63of100,1,190,5,483,1,489
test4sub54of100,test4pub63of100,1,190,5,511,1,517
test4sub92of100,test4pub63of100,1,190,5,514,1,520
test4sub47of100,test4pub63of100,1,190,5,515,1,521
test4sub78of100,test4pub63of100,1,190,5,515,1,521
test4sub66of100,test4pub63of100,1,190,5,524,1,530
test4sub50of100,test4pub63of100,1,190,5,533,1,539
test4sub41of100,test4pub63of100,1,190,5,537,1,543
test4sub60of100,test4pub63of100,1,190,5,543,1,549
test4sub71of100,test4pub63of100,1,190,5,551,1,557
test4sub82of100,test4pub63of100,1,190,5,562,0,567
test4sub27of100,test4pub63of100,1,190,5,574,1,580
test4sub89of100,test4pub63of100,1,190,5,589,1,595
test4sub13of100,test4pub63of100,1,190,5,591,1,597
test4sub10of100,test4pub63of100,1,190,5,598,0,603
test4sub80of100,test4pub64of100,1,190,5,18,0,23
test4sub36of100,test4pub64of100,1,190,5,24,1,30
test4sub8of100,test4pub63of100,1,190,5,618,1,624
test4sub16of100,test4pub64of100,1,190,5,28,0,33
test4sub76of100,test4pub64of100,1,190,5,29,1,35
test4sub40of100,test4pub63of100,1,190,5,638,1,644
test4sub68of100,test4pub63of100,1,190,5,647,1,653
test4sub20of100,test4pub63of100,1,190,5,648,0,653
test4sub29of100,test4pub63of100,1,190,5,656,1,662
test4sub33of100,test4pub63of100,1,190,5,657,1,663
test4sub64of100,test4pub64of100,1,190,5,66,0,71
test4sub25of100,test4pub64of100,1,190,5,69,0,74
test4sub8of100,test4pub64of100,1,190,5,72,0,77
test4sub73of100,test4pub64of100,1,190,5,78,1,84
test4sub82of100,test4pub64of100,1,190,5,79,1,85
test4sub85of100,test4pub64of100,1,190,5,82,1,88
test4sub18of100,test4pub64of100,1,190,5,85,0,90
test4sub67of100,test4pub64of100,1,190,5,86,1,92
test4sub2of100,test4pub64of100,1,190,5,90,1,96
test4sub72of100,test4pub64of100,1,190,5,93,1,99
test4sub97of100,test4pub64of100,1,190,5,94,2,101
test4sub83of100,test4pub64of100,1,190,5,95,1,101
test4sub6of100,test4pub64of100,1,190,5,111,0,116
test4sub38of100,test4pub64of100,1,190,5,118,1,124
test4sub14of100,test4pub64of100,1,190,5,122,0,127
test4sub46of100,test4pub64of100,1,190,5,132,1,138
test4sub41of100,test4pub64of100,1,190,5,138,1,144
test4sub27of100,test4pub64of100,1,190,5,141,1,147
test4sub35of100,test4pub64of100,1,190,5,143,1,149
test4sub37of100,test4pub64of100,1,190,5,149,0,154
test4sub51of100,test4pub64of100,1,190,5,153,1,159
test4sub92of100,test4pub64of100,1,190,5,154,1,160
test4sub34of100,test4pub64of100,1,190,5,155,1,161
test4sub19of100,test4pub64of100,1,190,5,160,1,166
test4sub90of100,test4pub64of100,1,190,5,161,1,167
test4sub33of100,test4pub64of100,1,190,5,163,1,169
test4sub53of100,test4pub64of100,1,190,5,164,1,170
test4sub68of100,test4pub64of100,1,190,5,167,1,173
test4sub63of100,test4pub64of100,1,190,5,167,1,173
test4sub81of100,test4pub64of100,1,190,5,176,1,182
test4sub26of100,test4pub64of100,1,190,5,191,1,197
test4sub21of100,test4pub64of100,1,190,5,192,1,198
test4sub22of100,test4pub64of100,1,190,5,195,1,201
test4sub55of100,test4pub64of100,1,190,5,196,1,202
test4sub42of100,test4pub64of100,1,190,5,198,1,204
test4sub32of100,test4pub64of100,1,190,5,199,0,204
test4sub29of100,test4pub64of100,1,190,5,201,1,207
test4sub45of100,test4pub64of100,1,190,5,203,0,208
test4sub9of100,test4pub64of100,1,190,5,205,1,211
test4sub57of100,test4pub64of100,1,190,5,206,1,212
test4sub24of100,test4pub64of100,1,190,5,210,1,216
test4sub100of100,test4pub64of100,1,190,5,210,1,216
test4sub11of100,test4pub64of100,1,190,5,211,1,217
test4sub44of100,test4pub64of100,1,190,5,213,1,219
test4sub95of100,test4pub64of100,1,190,5,216,1,222
test4sub89of100,test4pub64of100,1,190,5,219,1,225
test4sub59of100,test4pub64of100,1,190,5,266,1,272
test4sub75of100,test4pub64of100,1,190,5,270,1,276
test4sub91of100,test4pub64of100,1,190,5,274,1,280
test4sub87of100,test4pub64of100,1,190,5,283,0,288
test4sub4of100,test4pub64of100,1,190,5,283,1,289
test4sub20of100,test4pub64of100,1,190,5,328,1,334
test4sub3of100,test4pub64of100,1,190,5,342,0,347
test4sub96of100,test4pub64of100,1,190,5,351,0,356
test4sub39of100,test4pub65of100,1,190,5,18,1,24
test4sub5of100,test4pub65of100,1,190,5,19,1,25
test4sub12of100,test4pub65of100,1,190,5,23,1,29
test4sub83of100,test4pub65of100,1,190,5,35,1,41
test4sub79of100,test4pub64of100,1,190,5,381,1,387
test4sub73of100,test4pub65of100,1,190,5,43,1,49
test4sub52of100,test4pub64of100,1,190,5,387,0,392
test4sub43of100,test4pub65of100,1,190,5,47,0,52
test4sub98of100,test4pub64of100,1,190,5,397,0,402
test4sub62of100,test4pub64of100,1,190,5,412,1,418
test4sub69of100,test4pub65of100,1,190,5,80,0,85
test4sub55of100,test4pub65of100,1,190,5,113,1,119
test4sub28of100,test4pub64of100,1,190,5,470,13,488
test4sub56of100,test4pub64of100,1,190,5,479,5,489
test4sub34of100,test4pub65of100,1,190,5,136,5,146
test4sub66of100,test4pub65of100,1,190,5,136,5,146
test4sub15of100,test4pub64of100,1,190,5,481,7,493
test4sub10of100,test4pub64of100,1,190,5,479,10,494
test4sub64of100,test4pub65of100,1,190,5,136,10,151
test4sub70of100,test4pub65of100,1,190,5,138,9,152
test4sub16of100,test4pub65of100,1,190,5,138,8,151
test4sub87of100,test4pub65of100,1,190,5,139,9,153
test4sub49of100,test4pub65of100,1,190,5,141,8,154
test4sub61of100,test4pub64of100,1,190,5,486,9,500
test4sub40of100,test4pub64of100,1,190,5,487,10,502
test4sub50of100,test4pub64of100,1,190,5,488,10,503
test4sub32of100,test4pub65of100,1,190,5,148,6,159
test4sub23of100,test4pub64of100,1,190,5,493,6,504
test4sub66of100,test4pub64of100,1,190,5,494,5,504
test4sub30of100,test4pub64of100,1,190,5,496,4,505
test4sub15of100,test4pub65of100,1,190,5,152,5,162
test4sub93of100,test4pub64of100,1,190,5,500,2,507
test4sub39of100,test4pub64of100,1,190,5,506,1,512
test4sub85of100,test4pub65of100,1,190,5,161,1,167
test4sub86of100,test4pub64of100,1,190,5,507,1,513
test4sub99of100,test4pub64of100,1,190,5,517,3,525
test4sub71of100,test4pub64of100,1,190,5,519,3,527
test4sub12of100,test4pub64of100,1,190,5,519,2,526
test4sub29of100,test4pub65of100,1,190,5,176,2,183
test4sub44of100,test4pub65of100,1,190,5,181,1,187
test4sub69of100,test4pub64of100,1,190,5,535,0,540
test4sub58of100,test4pub64of100,1,190,5,534,2,541
test4sub41of100,test4pub65of100,1,190,5,197,1,203
test4sub43of100,test4pub64of100,1,190,5,551,1,557
test4sub95of100,test4pub65of100,1,190,5,211,1,217
test4sub49of100,test4pub64of100,1,190,5,556,0,561
test4sub84of100,test4pub65of100,1,190,5,215,1,221
test4sub27of100,test4pub65of100,1,190,5,227,0,232
test4sub94of100,test4pub64of100,1,190,5,581,1,587
test4sub30of100,test4pub65of100,1,190,5,237,1,243
test4sub47of100,test4pub64of100,1,190,5,583,1,589
test4sub50of100,test4pub65of100,1,190,5,240,1,246
test4sub7of100,test4pub64of100,1,190,5,586,0,591
test4sub17of100,test4pub64of100,1,190,5,594,1,600
test4sub23of100,test4pub65of100,1,190,5,253,1,259
test4sub31of100,test4pub64of100,1,190,5,597,1,603
test4sub5of100,test4pub64of100,1,190,5,606,1,612
test4sub72of100,test4pub65of100,1,190,5,263,1,269
test4sub99of100,test4pub65of100,1,190,5,265,1,271
test4sub9of100,test4pub65of100,1,190,5,280,1,286
test4sub13of100,test4pub64of100,1,190,5,625,2,632
test4sub80of100,test4pub65of100,1,190,5,282,2,289
test4sub91of100,test4pub65of100,1,190,5,283,4,292
test4sub1of100,test4pub64of100,1,190,5,628,3,636
test4sub65of100,test4pub65of100,1,190,5,284,3,292
test4sub60of100,test4pub64of100,1,190,5,629,3,637
test4sub54of100,test4pub64of100,1,190,5,630,3,638
test4sub93of100,test4pub65of100,1,190,5,288,2,295
test4sub45of100,test4pub65of100,1,190,5,288,1,294
test4sub90of100,test4pub65of100,1,190,5,300,0,305
test4sub57of100,test4pub65of100,1,190,5,301,2,308
test4sub70of100,test4pub64of100,1,190,5,646,3,654
test4sub11of100,test4pub65of100,1,190,5,303,2,310
test4sub77of100,test4pub64of100,1,190,5,647,1,653
test4sub78of100,test4pub64of100,1,190,5,651,1,657
test4sub61of100,test4pub65of100,1,190,5,309,1,315
test4sub88of100,test4pub64of100,1,190,5,653,1,659
test4sub82of100,test4pub65of100,1,190,5,311,0,316
test4sub48of100,test4pub64of100,1,190,5,656,1,662
test4sub7of100,test4pub65of100,1,190,5,314,0,319
test4sub36of100,test4pub65of100,1,190,5,321,1,327
test4sub84of100,test4pub64of100,1,190,5,671,1,677
test4sub38of100,test4pub65of100,1,190,5,336,1,342
test4sub74of100,test4pub64of100,1,190,5,687,1,693
test4sub25of100,test4pub65of100,1,190,5,359,1,365
test4sub58of100,test4pub65of100,1,190,5,368,1,374
test4sub59of100,test4pub65of100,1,190,5,369,2,376
test4sub33of100,test4pub65of100,1,190,5,369,1,375
test4sub6of100,test4pub65of100,1,190,5,371,2,378
test4sub14of100,test4pub65of100,1,190,5,372,3,380
test4sub98of100,test4pub65of100,1,190,5,373,2,380
test4sub18of100,test4pub65of100,1,190,5,375,1,381
test4sub52of100,test4pub65of100,1,190,5,377,1,383
test4sub20of100,test4pub65of100,1,190,5,378,1,384
test4sub76of100,test4pub65of100,1,190,5,379,1,385
test4sub79of100,test4pub65of100,1,190,5,382,1,388
test4sub21of100,test4pub65of100,1,190,5,383,1,389
test4sub3of100,test4pub65of100,1,190,5,384,0,389
test4sub65of100,test4pub64of100,1,190,5,728,2,735
test4sub67of100,test4pub65of100,1,190,5,385,1,391
test4sub51of100,test4pub65of100,1,190,5,388,1,394
test4sub54of100,test4pub65of100,1,190,5,395,1,401
test4sub89of100,test4pub65of100,1,190,5,397,0,402
test4sub8of100,test4pub65of100,1,190,5,403,0,408
test4sub28of100,test4pub65of100,1,190,5,404,1,410
test4sub48of100,test4pub65of100,1,190,5,407,1,413
test4sub100of100,test4pub65of100,1,190,5,408,1,414
test4sub74of100,test4pub65of100,1,190,5,415,1,421
test4sub71of100,test4pub65of100,1,190,5,416,1,422
test4sub81of100,test4pub65of100,1,190,5,420,1,426
test4sub13of100,test4pub65of100,1,190,5,422,1,428
test4sub97of100,test4pub65of100,1,190,5,425,1,431
test4sub92of100,test4pub65of100,1,190,5,426,1,432
test4sub22of100,test4pub65of100,1,190,5,427,0,432
test4sub1of100,test4pub65of100,1,190,5,430,1,436
test4sub62of100,test4pub65of100,1,190,5,435,0,440
test4sub96of100,test4pub65of100,1,190,5,438,0,443
test4sub24of100,test4pub65of100,1,190,5,438,1,444
test4sub37of100,test4pub65of100,1,190,5,464,0,469
test4sub46of100,test4pub65of100,1,190,5,467,1,473
test4sub31of100,test4pub65of100,1,190,5,489,1,495
test4sub60of100,test4pub65of100,1,190,5,495,1,501
test4sub10of100,test4pub65of100,1,190,5,496,1,502
test4sub77of100,test4pub65of100,1,190,5,500,1,506
test4sub19of100,test4pub65of100,1,190,5,524,1,530
test4sub47of100,test4pub65of100,1,190,5,527,1,533
test4sub2of100,test4pub65of100,1,190,5,543,1,549
test4sub86of100,test4pub65of100,1,190,5,565,0,570
test4sub42of100,test4pub65of100,1,190,5,567,0,572
test4sub75of100,test4pub65of100,1,190,5,572,1,578
test4sub68of100,test4pub65of100,1,190,5,572,1,578
test4sub57of100,test4pub66of100,1,190,8,42,1,51
test4sub37of100,test4pub66of100,1,190,8,43,0,51
test4sub100of100,test4pub66of100,1,190,8,49,0,57
test4sub40of100,test4pub65of100,1,190,5,581,1,587
test4sub26of100,test4pub65of100,1,190,5,585,2,592
test4sub78of100,test4pub65of100,1,190,5,587,1,593
test4sub94of100,test4pub65of100,1,190,5,590,0,595
test4sub56of100,test4pub65of100,1,190,5,592,1,598
test4sub17of100,test4pub66of100,1,190,8,67,1,76
test4sub28of100,test4pub66of100,1,190,8,68,6,82
test4sub35of100,test4pub65of100,1,190,5,605,1,611
test4sub88of100,test4pub65of100,1,190,5,606,1,612
test4sub4of100,test4pub65of100,1,190,5,607,1,613
test4sub14of100,test4pub66of100,1,190,8,89,1,98
test4sub33of100,test4pub66of100,1,190,8,101,1,110
test4sub53of100,test4pub65of100,1,190,5,633,2,640
test4sub63of100,test4pub65of100,1,190,5,633,1,639
test4sub27of100,test4pub66of100,1,190,8,104,1,113
test4sub1of100,test4pub66of100,1,190,8,107,1,116
test4sub20of100,test4pub66of100,1,190,8,108,0,116
test4sub17of100,test4pub65of100,1,190,5,638,2,645
test4sub25of100,test4pub66of100,1,190,8,112,1,121
test4sub23of100,test4pub66of100,1,190,8,112,2,122
test4sub59of100,test4pub66of100,1,190,8,113,1,122
test4sub19of100,test4pub66of100,1,190,8,121,1,130
test4sub51of100,test4pub66of100,1,190,8,123,1,132
test4sub79of100,test4pub66of100,1,190,8,125,1,134
test4sub95of100,test4pub66of100,1,190,8,126,1,135
test4sub92of100,test4pub66of100,1,190,8,133,1,142
test4sub75of100,test4pub66of100,1,190,8,136,0,144
test4sub5of100,test4pub66of100,1,190,8,137,1,146
test4sub39of100,test4pub66of100,1,190,8,140,1,149
test4sub4of100,test4pub66of100,1,190,8,148,1,157
test4sub24of100,test4pub66of100,1,190,8,149,0,157
test4sub80of100,test4pub66of100,1,190,8,161,1,170
test4sub22of100,test4pub66of100,1,190,8,165,0,173
test4sub26of100,test4pub66of100,1,190,8,168,1,177
test4sub38of100,test4pub66of100,1,190,8,177,0,185
test4sub6of100,test4pub66of100,1,190,8,179,1,188
test4sub93of100,test4pub66of100,1,190,8,181,0,189
test4sub53of100,test4pub66of100,1,190,8,183,1,192
test4sub35of100,test4pub66of100,1,190,8,186,2,196
test4sub15of100,test4pub66of100,1,190,8,187,2,197
test4sub85of100,test4pub66of100,1,190,8,188,2,198
test4sub63of100,test4pub66of100,1,190,8,189,2,199
test4sub89of100,test4pub66of100,1,190,8,189,4,201
test4sub67of100,test4pub66of100,1,190,8,190,4,202
test4sub13of100,test4pub66of100,1,190,8,191,3,202
test4sub30of100,test4pub66of100,1,190,8,191,4,203
test4sub54of100,test4pub66of100,1,190,8,193,2,203
test4sub29of100,test4pub66of100,1,190,8,202,1,211
test4sub77of100,test4pub66of100,1,190,8,207,1,216
test4sub97of100,test4pub66of100,1,190,8,207,1,216
test4sub45of100,test4pub66of100,1,190,8,210,1,219
test4sub34of100,test4pub66of100,1,190,8,210,1,219
test4sub98of100,test4pub66of100,1,190,8,213,1,222
test4sub52of100,test4pub66of100,1,190,8,214,0,222
test4sub7of100,test4pub66of100,1,190,8,217,0,225
test4sub66of100,test4pub66of100,1,190,8,225,1,234
test4sub61of100,test4pub66of100,1,190,8,228,1,237
test4sub84of100,test4pub66of100,1,190,8,250,0,258
test4sub60of100,test4pub66of100,1,190,8,255,0,263
test4sub94of100,test4pub66of100,1,190,8,278,1,287
test4sub96of100,test4pub66of100,1,190,8,281,1,290
test4sub43of100,test4pub66of100,1,190,8,285,0,293
test4sub41of100,test4pub66of100,1,190,8,288,1,297
test4sub90of100,test4pub66of100,1,190,8,291,1,300
test4sub3of100,test4pub66of100,1,190,8,302,1,311
test4sub9of100,test4pub66of100,1,190,8,311,0,319
test4sub74of100,test4pub66of100,1,190,8,318,1,327
test4sub44of100,test4pub66of100,1,190,8,320,1,329
test4sub12of100,test4pub66of100,1,190,8,321,2,331
test4sub50of100,test4pub66of100,1,190,8,321,2,331
test4sub48of100,test4pub66of100,1,190,8,322,2,332
test4sub2of100,test4pub66of100,1,190,8,323,2,333
test4sub69of100,test4pub66of100,1,190,8,325,1,334
test4sub91of100,test4pub66of100,1,190,8,327,0,335
test4sub71of100,test4pub66of100,1,190,8,337,0,345
test4sub70of100,test4pub66of100,1,190,8,341,1,350
test4sub65of100,test4pub66of100,1,190,8,342,2,352
test4sub10of100,test4pub66of100,1,190,8,343,2,353
test4sub16of100,test4pub66of100,1,190,8,343,2,353
test4sub31of100,test4pub66of100,1,190,8,344,1,353
test4sub82of100,test4pub66of100,1,190,8,346,2,356
test4sub32of100,test4pub66of100,1,190,8,347,2,357
test4sub8of100,test4pub66of100,1,190,8,348,2,358
test4sub64of100,test4pub66of100,1,190,8,349,1,358
test4sub76of100,test4pub66of100,1,190,8,358,1,367
test4sub46of100,test4pub66of100,1,190,8,365,1,374
test4sub11of100,test4pub66of100,1,190,8,376,0,384
test4sub83of100,test4pub66of100,1,190,8,388,1,397
test4sub81of100,test4pub66of100,1,190,8,403,1,412
test4sub21of100,test4pub66of100,1,190,8,407,1,416
test4sub78of100,test4pub66of100,1,190,8,427,0,435
test4sub87of100,test4pub66of100,1,190,8,436,1,445
test4sub73of100,test4pub66of100,1,190,8,446,1,455
test4sub18of100,test4pub66of100,1,190,8,450,1,459
test4sub99of100,test4pub66of100,1,190,8,456,0,464
test4sub58of100,test4pub66of100,1,190,8,473,0,481
test4sub76of100,test4pub67of100,1,190,5,28,0,33
test4sub52of100,test4pub67of100,1,190,5,35,1,41
test4sub86of100,test4pub66of100,1,190,8,490,0,498
test4sub26of100,test4pub67of100,1,190,5,44,1,50
test4sub55of100,test4pub66of100,1,190,8,496,0,504
test4sub68of100,test4pub66of100,1,190,8,499,1,508
test4sub69of100,test4pub67of100,1,190,5,54,0,59
test4sub18of100,test4pub67of100,1,190,5,57,1,63
test4sub88of100,test4pub67of100,1,190,5,70,1,76
test4sub56of100,test4pub67of100,1,190,5,78,1,84
test4sub88of100,test4pub66of100,1,190,8,529,1,538
test4sub40of100,test4pub67of100,1,190,5,83,1,89
test4sub42of100,test4pub66of100,1,190,8,545,0,553
test4sub95of100,test4pub67of100,1,190,5,114,0,119
test4sub7of100,test4pub67of100,1,190,5,127,1,133
test4sub55of100,test4pub67of100,1,190,5,129,1,135
test4sub25of100,test4pub67of100,1,190,5,129,1,135
test4sub47of100,test4pub66of100,1,190,8,580,1,589
test4sub39of100,test4pub67of100,1,190,5,131,1,137
test4sub81of100,test4pub67of100,1,190,5,138,1,144
test4sub72of100,test4pub66of100,1,190,8,588,1,597
test4sub56of100,test4pub66of100,1,190,8,590,1,599
test4sub71of100,test4pub67of100,1,190,5,142,1,148
test4sub86of100,test4pub67of100,1,190,5,142,1,148
test4sub58of100,test4pub67of100,1,190,5,144,1,150
test4sub49of100,test4pub66of100,1,190,8,594,2,604
test4sub35of100,test4pub67of100,1,190,5,146,3,154
test4sub63of100,test4pub67of100,1,190,5,146,4,155
test4sub40of100,test4pub66of100,1,190,8,596,3,607
test4sub33of100,test4pub67of100,1,190,5,148,4,157
test4sub68of100,test4pub67of100,1,190,5,148,4,157
test4sub10of100,test4pub67of100,1,190,5,149,4,158
test4sub32of100,test4pub67of100,1,190,5,151,2,158
test4sub62of100,test4pub66of100,1,190,8,601,1,610
test4sub14of100,test4pub67of100,1,190,5,153,2,160
test4sub28of100,test4pub67of100,1,190,5,171,1,177
test4sub36of100,test4pub66of100,1,190,8,620,1,629
test4sub89of100,test4pub67of100,1,190,5,174,1,180
test4sub78of100,test4pub67of100,1,190,5,187,1,193
test4sub87of100,test4pub67of100,1,190,5,199,0,204
test4sub12of100,test4pub67of100,1,190,5,204,1,210
test4sub43of100,test4pub67of100,1,190,5,209,0,214
test4sub21of100,test4pub67of100,1,190,5,233,1,239
test4sub62of100,test4pub67of100,1,190,5,235,1,241
test4sub46of100,test4pub67of100,1,190,5,245,0,250
test4sub65of100,test4pub67of100,1,190,5,295,0,300
test4sub79of100,test4pub67of100,1,190,5,306,1,312
test4sub59of100,test4pub67of100,1,190,5,306,0,311
test4sub100of100,test4pub67of100,1,190,5,310,1,316
test4sub84of100,test4pub68of100,1,190,5,33,1,39
test4sub54of100,test4pub67of100,1,190,5,341,1,347
test4sub9of100,test4pub67of100,1,190,5,361,1,367
test4sub59of100,test4pub68of100,1,190,5,58,1,64
test4sub27of100,test4pub68of100,1,190,5,59,1,65
test4sub5of100,test4pub67of100,1,190,5,369,1,375
test4sub20of100,test4pub67of100,1,190,5,373,1,379
test4sub23of100,test4pub67of100,1,190,5,384,0,389
test4sub42of100,test4pub68of100,1,190,5,89,1,95
test4sub70of100,test4pub67of100,1,190,5,405,1,411
test4sub88of100,test4pub68of100,1,190,5,108,1,114
test4sub84of100,test4pub67of100,1,190,5,417,0,422
test4sub40of100,test4pub68of100,1,190,5,115,1,121
test4sub16of100,test4pub67of100,1,190,5,428,2,435
test4sub47of100,test4pub67of100,1,190,5,429,0,434
test4sub13of100,test4pub67of100,1,190,5,432,0,437
test4sub37of100,test4pub68of100,1,190,5,127,1,133
test4sub97of100,test4pub67of100,1,190,5,435,1,441
test4sub82of100,test4pub67of100,1,190,5,443,1,449
test4sub77of100,test4pub68of100,1,190,5,137,1,143
test4sub63of100,test4pub68of100,1,190,5,138,1,144
test4sub38of100,test4pub68of100,1,190,5,141,0,146
test4sub83of100,test4pub68of100,1,190,5,143,1,149
test4sub3of100,test4pub67of100,1,190,5,452,3,460
test4sub41of100,test4pub67of100,1,190,5,453,2,460
test4sub72of100,test4pub68of100,1,190,5,144,5,154
test4sub67of100,test4pub67of100,1,190,5,452,4,461
test4sub36of100,test4pub67of100,1,190,5,453,3,461
test4sub89of100,test4pub68of100,1,190,5,145,3,153
test4sub5of100,test4pub68of100,1,190,5,148,3,156
test4sub32of100,test4pub68of100,1,190,5,154,1,160
test4sub50of100,test4pub67of100,1,190,5,461,1,467
test4sub35of100,test4pub68of100,1,190,5,160,0,165
test4sub10of100,test4pub68of100,1,190,5,164,0,169
test4sub49of100,test4pub68of100,1,190,5,166,2,173
test4sub45of100,test4pub67of100,1,190,5,474,2,481
test4sub4of100,test4pub67of100,1,190,5,476,1,482
test4sub44of100,test4pub67of100,1,190,5,475,1,481
test4sub60of100,test4pub68of100,1,190,5,176,1,182
test4sub80of100,test4pub67of100,1,190,5,484,1,490
test4sub98of100,test4pub67of100,1,190,5,487,1,493
test4sub24of100,test4pub68of100,1,190,5,186,0,191
test4sub96of100,test4pub68of100,1,190,5,189,0,194
test4sub22of100,test4pub67of100,1,190,5,500,1,506
test4sub85of100,test4pub67of100,1,190,5,503,1,509
test4sub68of100,test4pub68of100,1,190,5,197,2,204
test4sub44of100,test4pub68of100,1,190,5,198,1,204
test4sub94of100,test4pub67of100,1,190,5,505,1,511
test4sub71of100,test4pub68of100,1,190,5,209,1,215
test4sub38of100,test4pub67of100,1,190,5,520,1,526
test4sub13of100,test4pub68of100,1,190,5,214,2,221
test4sub31of100,test4pub68of100,1,190,5,215,1,221
test4sub15of100,test4pub68of100,1,190,5,215,1,221
test4sub15of100,test4pub67of100,1,190,5,530,1,536
test4sub37of100,test4pub67of100,1,190,5,535,1,541
test4sub99of100,test4pub67of100,1,190,5,535,1,541
test4sub3of100,test4pub68of100,1,190,5,230,1,236
test4sub96of100,test4pub67of100,1,190,5,541,1,547
test4sub66of100,test4pub67of100,1,190,5,542,1,548
test4sub2of100,test4pub67of100,1,190,5,552,1,558
test4sub55of100,test4pub68of100,1,190,5,251,1,257
test4sub74of100,test4pub67of100,1,190,5,563,0,568
test4sub57of100,test4pub67of100,1,190,5,566,0,571
test4sub25of100,test4pub68of100,1,190,5,263,1,269
test4sub75of100,test4pub67of100,1,190,5,570,0,575
test4sub18of100,test4pub68of100,1,190,5,266,1,272
test4sub12of100,test4pub68of100,1,190,5,268,0,273
test4sub19of100,test4pub67of100,1,190,5,580,0,585
test4sub60of100,test4pub67of100,1,190,5,592,1,598
test4sub48of100,test4pub67of100,1,190,5,593,1,599
test4sub8of100,test4pub67of100,1,190,5,595,1,601
test4sub56of100,test4pub68of100,1,190,5,288,2,295
test4sub83of100,test4pub67of100,1,190,5,597,1,603
test4sub85of100,test4pub68of100,1,190,5,290,1,296
test4sub24of100,test4pub67of100,1,190,5,603,2,610
test4sub29of100,test4pub67of100,1,190,5,604,2,611
test4sub53of100,test4pub68of100,1,190,5,298,1,304
test4sub34of100,test4pub68of100,1,190,5,310,0,315
test4sub61of100,test4pub68of100,1,190,5,316,1,322
test4sub39of100,test4pub68of100,1,190,5,317,2,324
test4sub81of100,test4pub68of100,1,190,5,318,1,324
test4sub51of100,test4pub67of100,1,190,5,629,0,634
test4sub36of100,test4pub69of100,1,190,5,34,1,40
test4sub6of100,test4pub68of100,1,190,5,323,1,329
test4sub73of100,test4pub67of100,1,190,5,634,1,640
test4sub92of100,test4pub69of100,1,190,5,40,1,46
test4sub17of100,test4pub68of100,1,190,5,330,1,336
test4sub16of100,test4pub69of100,1,190,5,46,1,52
test4sub65of100,test4pub68of100,1,190,5,336,1,342
test4sub26of100,test4pub68of100,1,190,5,337,1,343
test4sub52of100,test4pub68of100,1,190,5,342,1,348
test4sub22of100,test4pub68of100,1,190,5,343,0,348
test4sub6of100,test4pub69of100,1,190,5,58,0,63
test4sub70of100,test4pub68of100,1,190,5,349,0,354
test4sub49of100,test4pub67of100,1,190,5,660,1,666
test4sub20of100,test4pub68of100,1,190,5,355,1,361
test4sub33of100,test4pub68of100,1,190,5,365,0,370
test4sub61of100,test4pub67of100,1,190,5,676,1,682
test4sub90of100,test4pub69of100,1,190,5,83,1,89
test4sub11of100,test4pub68of100,1,190,5,371,1,377
test4sub64of100,test4pub67of100,1,190,5,679,2,686
test4sub46of100,test4pub68of100,1,190,5,379,0,384
test4sub58of100,test4pub68of100,1,190,5,382,0,387
test4sub93of100,test4pub68of100,1,190,5,382,2,389
test4sub96of100,test4pub69of100,1,190,5,97,2,104
test4sub78of100,test4pub68of100,1,190,5,387,7,399
test4sub53of100,test4pub67of100,1,190,5,695,2,702
test4sub57of100,test4pub69of100,1,190,5,107,1,113
test4sub86of100,test4pub68of100,1,190,5,395,1,401
test4sub16of100,test4pub68of100,1,190,5,399,0,404
test4sub47of100,test4pub69of100,1,190,5,113,0,118
test4sub74of100,test4pub69of100,1,190,5,115,1,121
test4sub61of100,test4pub69of100,1,190,5,125,1,131
test4sub90of100,test4pub67of100,1,190,5,721,1,727
test4sub72of100,test4pub67of100,1,190,5,723,3,731
test4sub42of100,test4pub67of100,1,190,5,724,3,732
test4sub64of100,test4pub69of100,1,190,5,129,3,137
test4sub27of100,test4pub67of100,1,190,5,725,3,733
test4sub14of100,test4pub69of100,1,190,5,140,1,146
test4sub45of100,test4pub68of100,1,190,5,430,1,436
test4sub66of100,test4pub68of100,1,190,5,433,1,439
test4sub1of100,test4pub67of100,1,190,5,742,1,748
test4sub97of100,test4pub68of100,1,190,5,438,1,444
test4sub43of100,test4pub68of100,1,190,5,450,1,456
test4sub77of100,test4pub67of100,1,190,5,762,1,768
test4sub93of100,test4pub67of100,1,190,5,763,1,769
test4sub48of100,test4pub68of100,1,190,5,464,1,470
test4sub4of100,test4pub69of100,1,190,5,177,1,183
test4sub10of100,test4pub69of100,1,190,5,177,2,184
test4sub2of100,test4pub68of100,1,190,5,466,1,472
test4sub31of100,test4pub67of100,1,190,5,776,0,781
test4sub54of100,test4pub68of100,1,190,5,469,1,475
test4sub30of100,test4pub67of100,1,190,5,778,1,784
test4sub55of100,test4pub69of100,1,190,5,184,1,190
test4sub51of100,test4pub68of100,1,190,5,478,1,484
test4sub17of100,test4pub67of100,1,190,5,787,1,793
test4sub15of100,test4pub69of100,1,190,5,191,4,200
test4sub79of100,test4pub68of100,1,190,5,480,3,488
test4sub13of100,test4pub69of100,1,190,5,194,3,202
test4sub75of100,test4pub68of100,1,190,5,482,3,490
test4sub42of100,test4pub69of100,1,190,5,194,2,201
test4sub90of100,test4pub68of100,1,190,5,483,3,491
test4sub1of100,test4pub68of100,1,190,5,491,0,496
test4sub92of100,test4pub67of100,1,190,5,800,1,806
test4sub77of100,test4pub69of100,1,190,5,206,1,212
test4sub34of100,test4pub67of100,1,190,5,803,0,808
test4sub94of100,test4pub68of100,1,190,5,501,1,507
test4sub87of100,test4pub68of100,1,190,5,530,2,537
test4sub91of100,test4pub67of100,1,190,5,837,2,844
test4sub99of100,test4pub68of100,1,190,5,531,3,539
test4sub6of100,test4pub67of100,1,190,5,839,1,845
test4sub85of100,test4pub69of100,1,190,5,248,0,253
test4sub28of100,test4pub68of100,1,190,5,543,1,549
test4sub11of100,test4pub67of100,1,190,5,852,1,858
test4sub91of100,test4pub68of100,1,190,5,545,1,551
test4sub99of100,test4pub69of100,1,190,5,303,2,310
test4sub82of100,test4pub69of100,1,190,5,303,3,311
test4sub8of100,test4pub68of100,1,190,5,592,4,601
test4sub74of100,test4pub68of100,1,190,5,592,4,601
test4sub19of100,test4pub68of100,1,190,5,593,4,602
test4sub78of100,test4pub69of100,1,190,5,306,4,315
test4sub92of100,test4pub68of100,1,190,5,594,4,603
test4sub4of100,test4pub68of100,1,190,5,595,3,603
test4sub67of100,test4pub69of100,1,190,5,309,3,317
test4sub26of100,test4pub69of100,1,190,5,311,2,318
test4sub60of100,test4pub69of100,1,190,5,312,2,319
test4sub41of100,test4pub68of100,1,190,5,601,3,609
test4sub7of100,test4pub68of100,1,190,5,602,2,609
test4sub23of100,test4pub68of100,1,190,5,603,3,611
test4sub29of100,test4pub68of100,1,190,5,605,4,614
test4sub95of100,test4pub68of100,1,190,5,606,2,613
test4sub36of100,test4pub68of100,1,190,5,607,2,614
test4sub73of100,test4pub68of100,1,190,5,607,3,615
test4sub76of100,test4pub68of100,1,190,5,606,5,616
test4sub25of100,test4pub69of100,1,190,5,320,3,328
test4sub69of100,test4pub69of100,1,190,5,317,6,328
test4sub14of100,test4pub68of100,1,190,5,609,4,618
test4sub27of100,test4pub69of100,1,190,5,322,3,330
test4sub81of100,test4pub69of100,1,190,5,329,1,335
test4sub8of100,test4pub69of100,1,190,5,339,0,344
test4sub67of100,test4pub68of100,1,190,5,635,1,641
test4sub21of100,test4pub68of100,1,190,5,636,2,643
test4sub57of100,test4pub68of100,1,190,5,637,1,643
test4sub98of100,test4pub68of100,1,190,5,637,1,643
test4sub39of100,test4pub69of100,1,190,5,353,1,359
test4sub64of100,test4pub68of100,1,190,5,641,1,647
test4sub46of100,test4pub69of100,1,190,5,352,2,359
test4sub2of100,test4pub69of100,1,190,5,356,1,362
test4sub80of100,test4pub68of100,1,190,5,644,2,651
test4sub100of100,test4pub68of100,1,190,5,646,2,653
test4sub7of100,test4pub69of100,1,190,5,357,3,365
test4sub31of100,test4pub69of100,1,190,5,359,1,365
test4sub9of100,test4pub69of100,1,190,5,366,1,372
test4sub48of100,test4pub69of100,1,190,5,373,1,379
test4sub62of100,test4pub68of100,1,190,5,674,1,680
test4sub83of100,test4pub69of100,1,190,5,386,2,393
test4sub30of100,test4pub68of100,1,190,5,675,1,681
test4sub47of100,test4pub68of100,1,190,5,675,1,681
test4sub82of100,test4pub68of100,1,190,5,678,0,683
test4sub50of100,test4pub68of100,1,190,5,684,1,690
test4sub19of100,test4pub69of100,1,190,5,397,1,403
test4sub65of100,test4pub69of100,1,190,5,399,2,406
test4sub69of100,test4pub68of100,1,190,5,688,1,694
test4sub32of100,test4pub69of100,1,190,5,406,1,412
test4sub3of100,test4pub69of100,1,190,5,413,0,418
test4sub52of100,test4pub69of100,1,190,5,418,1,424
test4sub88of100,test4pub69of100,1,190,5,419,2,426
test4sub75of100,test4pub69of100,1,190,5,420,1,426
test4sub37of100,test4pub69of100,1,190,5,424,0,429
test4sub98of100,test4pub69of100,1,190,5,428,0,433
test4sub59of100,test4pub69of100,1,190,5,429,0,434
test4sub89of100,test4pub69of100,1,190,5,437,0,442
test4sub80of100,test4pub69of100,1,190,5,448,1,454
test4sub28of100,test4pub69of100,1,190,5,464,1,470
test4sub9of100,test4pub68of100,1,190,5,754,0,759
test4sub29of100,test4pub69of100,1,190,5,467,1,473
test4sub38of100,test4pub69of100,1,190,5,471,1,477
test4sub41of100,test4pub69of100,1,190,5,478,0,483
test4sub63of100,test4pub69of100,1,190,5,484,1,490
test4sub11of100,test4pub69of100,1,190,5,488,1,494
test4sub68of100,test4pub69of100,1,190,5,494,1,500
test4sub5of100,test4pub69of100,1,190,5,496,0,501
test4sub20of100,test4pub69of100,1,190,5,514,1,520
test4sub17of100,test4pub69of100,1,190,5,509,2,516
test4sub58of100,test4pub69of100,1,190,5,516,0,521
test4sub45of100,test4pub69of100,1,190,5,526,1,532
test4sub22of100,test4pub69of100,1,190,5,530,1,536
test4sub84of100,test4pub69of100,1,190,5,535,0,540
test4sub71of100,test4pub69of100,1,190,5,537,0,542
test4sub34of100,test4pub69of100,1,190,5,539,1,545
test4sub70of100,test4pub69of100,1,190,5,553,1,559
test4sub79of100,test4pub69of100,1,190,5,555,1,561
test4sub23of100,test4pub69of100,1,190,5,556,2,563
test4sub24of100,test4pub69of100,1,190,5,557,2,564
test4sub43of100,test4pub69of100,1,190,5,558,2,565
test4sub35of100,test4pub69of100,1,190,5,566,1,572
test4sub18of100,test4pub69of100,1,190,5,569,1,575
test4sub51of100,test4pub69of100,1,190,5,572,1,578
test4sub44of100,test4pub69of100,1,190,5,572,2,579
test4sub53of100,test4pub69of100,1,190,5,574,1,580
test4sub54of100,test4pub69of100,1,190,5,587,0,592
test4sub72of100,test4pub70of100,1,190,5,39,1,45
test4sub23of100,test4pub70of100,1,190,5,42,2,49
test4sub27of100,test4pub70of100,1,190,5,43,1,49
test4sub66of100,test4pub69of100,1,190,5,599,0,604
test4sub15of100,test4pub70of100,1,190,5,57,1,63
test4sub94of100,test4pub69of100,1,190,5,615,0,620
test4sub62of100,test4pub69of100,1,190,5,623,1,629
test4sub30of100,test4pub69of100,1,190,5,626,1,632
test4sub97of100,test4pub69of100,1,190,5,631,1,637
test4sub37of100,test4pub70of100,1,190,5,77,2,84
test4sub72of100,test4pub69of100,1,190,5,632,1,638
test4sub87of100,test4pub69of100,1,190,5,640,1,646
test4sub91of100,test4pub69of100,1,190,5,647,0,652
test4sub40of100,test4pub69of100,1,190,5,658,0,663
test4sub33of100,test4pub69of100,1,190,5,661,0,666
test4sub10of100,test4pub70of100,1,190,5,113,1,119
test4sub24of100,test4pub70of100,1,190,5,117,0,122
test4sub26of100,test4pub70of100,1,190,5,119,0,124
test4sub51of100,test4pub70of100,1,190,5,133,1,139
test4sub56of100,test4pub69of100,1,190,5,688,2,695
test4sub38of100,test4pub70of100,1,190,5,134,1,140
test4sub46of100,test4pub70of100,1,190,5,137,1,143
test4sub42of100,test4pub70of100,1,190,5,136,3,144
test4sub3of100,test4pub70of100,1,190,5,138,1,144
test4sub86of100,test4pub70of100,1,190,5,141,0,146
test4sub18of100,test4pub70of100,1,190,5,162,0,167
test4sub76of100,test4pub69of100,1,190,5,723,1,729
test4sub8of100,test4pub70of100,1,190,5,171,0,176
test4sub62of100,test4pub70of100,1,190,5,179,0,184
test4sub12of100,test4pub69of100,1,190,5,737,1,743
test4sub81of100,test4pub70of100,1,190,5,186,2,193
test4sub57of100,test4pub70of100,1,190,5,187,2,194
test4sub49of100,test4pub69of100,1,190,5,742,2,749
test4sub99of100,test4pub70of100,1,190,5,188,2,195
test4sub93of100,test4pub69of100,1,190,5,744,1,750
test4sub73of100,test4pub69of100,1,190,5,748,1,754
test4sub91of100,test4pub70of100,1,190,5,193,1,199
test4sub45of100,test4pub70of100,1,190,5,196,0,201
test4sub95of100,test4pub69of100,1,190,5,758,1,764
test4sub52of100,test4pub70of100,1,190,5,204,1,210
test4sub86of100,test4pub69of100,1,190,5,761,0,766
test4sub100of100,test4pub69of100,1,190,5,765,0,770
test4sub50of100,test4pub69of100,1,190,5,767,1,773
test4sub21of100,test4pub69of100,1,190,5,771,1,777
test4sub1of100,test4pub69of100,1,190,5,774,1,780
test4sub17of100,test4pub70of100,1,190,5,225,1,231
test4sub49of100,test4pub70of100,1,190,5,228,2,235
test4sub54of100,test4pub70of100,1,190,5,230,1,236
test4sub63of100,test4pub70of100,1,190,5,232,1,238
test4sub96of100,test4pub70of100,1,190,5,233,1,239
test4sub95of100,test4pub70of100,1,190,5,235,2,242
test4sub61of100,test4pub70of100,1,190,5,236,1,242
test4sub9of100,test4pub70of100,1,190,5,236,1,242
test4sub48of100,test4pub70of100,1,190,5,241,1,247
test4sub29of100,test4pub70of100,1,190,5,242,1,248
test4sub65of100,test4pub70of100,1,190,5,243,3,251
test4sub73of100,test4pub70of100,1,190,5,243,3,251
test4sub68of100,test4pub70of100,1,190,5,244,2,251
test4sub44of100,test4pub70of100,1,190,5,245,2,252
test4sub13of100,test4pub70of100,1,190,5,246,2,253
test4sub69of100,test4pub70of100,1,190,5,248,0,253
test4sub6of100,test4pub70of100,1,190,5,256,0,261
test4sub78of100,test4pub70of100,1,190,5,259,1,265
test4sub39of100,test4pub70of100,1,190,5,259,1,265
test4sub75of100,test4pub70of100,1,190,5,261,1,267
test4sub74of100,test4pub70of100,1,190,5,264,1,270
test4sub31of100,test4pub70of100,1,190,5,272,0,277
test4sub20of100,test4pub70of100,1,190,5,277,0,282
test4sub21of100,test4pub70of100,1,190,5,277,1,283
test4sub11of100,test4pub70of100,1,190,5,279,0,284
test4sub97of100,test4pub70of100,1,190,5,281,1,287
test4sub53of100,test4pub70of100,1,190,5,282,1,288
test4sub4of100,test4pub70of100,1,190,5,283,1,289
test4sub94of100,test4pub70of100,1,190,5,290,1,296
test4sub60of100,test4pub70of100,1,190,5,301,1,307
test4sub88of100,test4pub70of100,1,190,5,303,0,308
test4sub14of100,test4pub70of100,1,190,5,316,1,322
test4sub33of100,test4pub70of100,1,190,5,316,1,322
test4sub66of100,test4pub70of100,1,190,5,320,1,326
test4sub41of100,test4pub70of100,1,190,5,327,0,332
test4sub30of100,test4pub70of100,1,190,5,328,1,334
test4sub59of100,test4pub70of100,1,190,5,332,0,337
test4sub67of100,test4pub70of100,1,190,5,341,1,347
test4sub77of100,test4pub70of100,1,190,5,343,2,350
test4sub2of100,test4pub70of100,1,190,5,344,2,351
test4sub100of100,test4pub70of100,1,190,5,345,1,351
test4sub22of100,test4pub70of100,1,190,5,349,0,354
test4sub47of100,test4pub70of100,1,190,5,364,0,369
test4sub28of100,test4pub70of100,1,190,5,367,1,373
test4sub16of100,test4pub70of100,1,190,5,367,1,373
test4sub93of100,test4pub70of100,1,190,5,373,1,379
test4sub25of100,test4pub70of100,1,190,5,374,1,380
test4sub56of100,test4pub70of100,1,190,5,392,0,397
test4sub5of100,test4pub70of100,1,190,5,408,2,415
test4sub32of100,test4pub70of100,1,190,5,414,1,420
test4sub79of100,test4pub70of100,1,190,5,414,2,421
test4sub70of100,test4pub70of100,1,190,5,415,2,422
test4sub76of100,test4pub70of100,1,190,5,435,1,441
test4sub90of100,test4pub70of100,1,190,5,441,0,446
test4sub26of100,test4pub71of100,1,190,6,16,0,22
test4sub87of100,test4pub71of100,1,190,6,22,1,29
test4sub33of100,test4pub71of100,1,190,6,24,1,31
test4sub22of100,test4pub71of100,1,190,6,28,1,35
test4sub85of100,test4pub71of100,1,190,6,35,1,42
test4sub98of100,test4pub70of100,1,190,5,480,1,486
test4sub1of100,test4pub70of100,1,190,5,504,0,509
test4sub71of100,test4pub70of100,1,190,5,506,1,512
test4sub7of100,test4pub70of100,1,190,5,509,0,514
test4sub87of100,test4pub70of100,1,190,5,514,1,520
test4sub80of100,test4pub70of100,1,190,5,517,0,522
test4sub89of100,test4pub71of100,1,190,6,85,1,92
test4sub15of100,test4pub71of100,1,190,6,87,1,94
test4sub50of100,test4pub70of100,1,190,5,526,1,532
test4sub92of100,test4pub70of100,1,190,5,533,0,538
test4sub9of100,test4pub71of100,1,190,6,107,1,114
test4sub65of100,test4pub71of100,1,190,6,141,1,148
test4sub60of100,test4pub71of100,1,190,6,152,1,159
test4sub41of100,test4pub71of100,1,190,6,153,1,160
test4sub82of100,test4pub70of100,1,190,5,591,3,599
test4sub55of100,test4pub70of100,1,190,5,592,2,599
test4sub48of100,test4pub71of100,1,190,6,155,2,163
test4sub71of100,test4pub71of100,1,190,6,156,1,163
test4sub99of100,test4pub71of100,1,190,6,156,2,164
test4sub92of100,test4pub71of100,1,190,6,161,1,168
test4sub39of100,test4pub71of100,1,190,6,164,1,171
test4sub89of100,test4pub70of100,1,190,5,601,3,609
test4sub12of100,test4pub70of100,1,190,5,602,2,609
test4sub64of100,test4pub70of100,1,190,5,603,2,610
test4sub10of100,test4pub71of100,1,190,6,168,0,174
test4sub91of100,test4pub71of100,1,190,6,168,1,175
test4sub19of100,test4pub70of100,1,190,5,609,1,615
test4sub72of100,test4pub71of100,1,190,6,177,1,184
test4sub40of100,test4pub70of100,1,190,5,616,0,621
test4sub42of100,test4pub71of100,1,190,6,182,1,189
test4sub36of100,test4pub70of100,1,190,5,619,0,624
test4sub35of100,test4pub70of100,1,190,5,625,0,630
test4sub4of100,test4pub71of100,1,190,6,190,1,197
test4sub43of100,test4pub70of100,1,190,5,631,1,637
test4sub85of100,test4pub70of100,1,190,5,632,1,638
test4sub52of100,test4pub71of100,1,190,6,197,1,204
test4sub83of100,test4pub70of100,1,190,5,637,1,643
test4sub84of100,test4pub70of100,1,190,5,642,1,648
test4sub75of100,test4pub71of100,1,190,6,210,1,217
test4sub6of100,test4pub71of100,1,190,6,210,1,217
test4sub82of100,test4pub71of100,1,190,6,212,0,218
test4sub34of100,test4pub71of100,1,190,6,215,1,222
test4sub58of100,test4pub70of100,1,190,5,652,2,659
test4sub66of100,test4pub71of100,1,190,6,216,1,223
test4sub70of100,test4pub71of100,1,190,6,244,1,251
test4sub7of100,test4pub71of100,1,190,6,249,1,256
test4sub20of100,test4pub71of100,1,190,6,251,1,258
test4sub19of100,test4pub71of100,1,190,6,252,1,259
test4sub57of100,test4pub71of100,1,190,6,253,1,260
test4sub34of100,test4pub70of100,1,190,5,691,1,697
test4sub81of100,test4pub71of100,1,190,6,257,1,264
test4sub38of100,test4pub71of100,1,190,6,259,1,266
test4sub45of100,test4pub71of100,1,190,6,263,1,270
test4sub16of100,test4pub71of100,1,190,6,265,0,271
test4sub94of100,test4pub71of100,1,190,6,265,1,272
test4sub68of100,test4pub71of100,1,190,6,272,0,278
test4sub25of100,test4pub71of100,1,190,6,285,1,292
test4sub83of100,test4pub71of100,1,190,6,289,1,296
test4sub84of100,test4pub71of100,1,190,6,293,1,300
test4sub76of100,test4pub71of100,1,190,6,294,1,301
test4sub12of100,test4pub71of100,1,190,6,296,0,302
test4sub78of100,test4pub71of100,1,190,6,304,1,311
test4sub80of100,test4pub71of100,1,190,6,311,1,318
test4sub74of100,test4pub71of100,1,190,6,313,1,320
test4sub77of100,test4pub71of100,1,190,6,316,0,322
test4sub64of100,test4pub71of100,1,190,6,325,1,332
test4sub97of100,test4pub71of100,1,190,6,330,0,336
test4sub90of100,test4pub71of100,1,190,6,332,1,339
test4sub3of100,test4pub71of100,1,190,6,341,0,347
test4sub63of100,test4pub71of100,1,190,6,345,0,351
test4sub21of100,test4pub71of100,1,190,6,354,0,360
test4sub93of100,test4pub71of100,1,190,6,356,1,363
test4sub1of100,test4pub71of100,1,190,6,357,0,363
test4sub2of100,test4pub71of100,1,190,6,358,1,365
test4sub73of100,test4pub71of100,1,190,6,360,0,366
test4sub51of100,test4pub71of100,1,190,6,370,0,376
test4sub34of100,test4pub72of100,1,190,5,14,2,21
test4sub36of100,test4pub72of100,1,190,5,15,2,22
test4sub43of100,test4pub71of100,1,190,6,372,1,379
test4sub46of100,test4pub72of100,1,190,5,18,0,23
test4sub55of100,test4pub71of100,1,190,6,376,0,382
test4sub87of100,test4pub72of100,1,190,5,24,1,30
test4sub68of100,test4pub72of100,1,190,5,32,1,38
test4sub69of100,test4pub72of100,1,190,5,32,0,37
test4sub93of100,test4pub72of100,1,190,5,42,2,49
test4sub28of100,test4pub71of100,1,190,6,399,2,407
test4sub54of100,test4pub71of100,1,190,6,399,1,406
test4sub4of100,test4pub72of100,1,190,5,57,1,63
test4sub31of100,test4pub71of100,1,190,6,414,1,421
test4sub36of100,test4pub71of100,1,190,6,417,0,423
test4sub100of100,test4pub71of100,1,190,6,421,1,428
test4sub14of100,test4pub72of100,1,190,5,65,1,71
test4sub18of100,test4pub71of100,1,190,6,425,1,432
test4sub48of100,test4pub72of100,1,190,5,70,1,76
test4sub49of100,test4pub72of100,1,190,5,75,1,81
test4sub57of100,test4pub72of100,1,190,5,75,2,82
test4sub29of100,test4pub71of100,1,190,6,432,0,438
test4sub23of100,test4pub71of100,1,190,6,442,3,451
test4sub24of100,test4pub71of100,1,190,6,442,3,451
test4sub80of100,test4pub72of100,1,190,5,88,3,96
test4sub69of100,test4pub71of100,1,190,6,443,3,452
test4sub46of100,test4pub71of100,1,190,6,436,3,445
test4sub53of100,test4pub71of100,1,190,6,444,3,453
test4sub8of100,test4pub71of100,1,190,6,437,3,446
test4sub58of100,test4pub71of100,1,190,6,452,0,458
test4sub30of100,test4pub71of100,1,190,6,458,1,465
test4sub92of100,test4pub72of100,1,190,5,102,0,107
test4sub63of100,test4pub72of100,1,190,5,110,1,116
test4sub56of100,test4pub71of100,1,190,6,472,1,479
test4sub31of100,test4pub72of100,1,190,5,120,1,126
test4sub44of100,test4pub71of100,1,190,6,476,1,483
test4sub32of100,test4pub71of100,1,190,6,481,0,487
test4sub100of100,test4pub72of100,1,190,5,132,1,138
test4sub20of100,test4pub72of100,1,190,5,159,2,166
test4sub67of100,test4pub71of100,1,190,6,516,2,524
test4sub61of100,test4pub71of100,1,190,6,517,1,524
test4sub79of100,test4pub71of100,1,190,6,519,1,526
test4sub59of100,test4pub72of100,1,190,5,164,1,170
test4sub26of100,test4pub72of100,1,190,5,163,1,169
test4sub88of100,test4pub71of100,1,190,6,523,1,530
test4sub55of100,test4pub72of100,1,190,5,168,0,173
test4sub11of100,test4pub71of100,1,190,6,526,1,533
test4sub35of100,test4pub71of100,1,190,6,527,2,535
test4sub25of100,test4pub72of100,1,190,5,172,3,180
test4sub13of100,test4pub71of100,1,190,6,528,2,536
test4sub41of100,test4pub72of100,1,190,5,173,3,181
test4sub32of100,test4pub72of100,1,190,5,174,2,181
test4sub71of100,test4pub72of100,1,190,5,175,1,181
test4sub64of100,test4pub72of100,1,190,5,180,0,185
test4sub40of100,test4pub71of100,1,190,6,536,1,543
test4sub50of100,test4pub71of100,1,190,6,539,2,547
test4sub17of100,test4pub71of100,1,190,6,539,2,547
test4sub52of100,test4pub72of100,1,190,5,184,2,191
test4sub12of100,test4pub72of100,1,190,5,184,2,191
test4sub86of100,test4pub71of100,1,190,6,541,2,549
test4sub90of100,test4pub72of100,1,190,5,188,1,194
test4sub47of100,test4pub71of100,1,190,6,543,1,550
test4sub96of100,test4pub71of100,1,190,6,548,0,554
test4sub14of100,test4pub71of100,1,190,6,549,1,556
test4sub49of100,test4pub71of100,1,190,6,550,1,557
test4sub62of100,test4pub71of100,1,190,6,551,0,557
test4sub5of100,test4pub71of100,1,190,6,555,1,562
test4sub51of100,test4pub72of100,1,190,5,202,1,208
test4sub59of100,test4pub71of100,1,190,6,567,0,573
test4sub27of100,test4pub71of100,1,190,6,570,0,576
test4sub88of100,test4pub72of100,1,190,5,217,1,223
test4sub37of100,test4pub71of100,1,190,6,576,1,583
test4sub85of100,test4pub72of100,1,190,5,236,0,241
test4sub16of100,test4pub72of100,1,190,5,237,1,243
test4sub24of100,test4pub72of100,1,190,5,243,0,248
test4sub9of100,test4pub72of100,1,190,5,248,1,254
test4sub40of100,test4pub72of100,1,190,5,250,1,256
test4sub95of100,test4pub71of100,1,190,6,612,0,618
test4sub91of100,test4pub72of100,1,190,5,258,0,263
test4sub98of100,test4pub71of100,1,190,6,625,1,632
test4sub81of100,test4pub72of100,1,190,5,270,1,276
test4sub30of100,test4pub72of100,1,190,5,274,0,279
test4sub67of100,test4pub72of100,1,190,5,274,1,280
test4sub94of100,test4pub72of100,1,190,5,282,1,288
test4sub18of100,test4pub72of100,1,190,5,282,1,288
test4sub97of100,test4pub72of100,1,190,5,291,1,297
test4sub6of100,test4pub72of100,1,190,5,296,1,302
test4sub54of100,test4pub72of100,1,190,5,298,1,304
test4sub43of100,test4pub72of100,1,190,5,299,2,306
test4sub72of100,test4pub72of100,1,190,5,300,1,306
test4sub50of100,test4pub72of100,1,190,5,306,0,311
test4sub35of100,test4pub72of100,1,190,5,321,1,327
test4sub53of100,test4pub72of100,1,190,5,323,1,329
test4sub19of100,test4pub72of100,1,190,5,341,1,347
test4sub79of100,test4pub72of100,1,190,5,346,2,353
test4sub22of100,test4pub72of100,1,190,5,346,2,353
test4sub58of100,test4pub72of100,1,190,5,345,3,353
test4sub45of100,test4pub72of100,1,190,5,347,1,353
test4sub75of100,test4pub72of100,1,190,5,353,0,358
test4sub83of100,test4pub72of100,1,190,5,357,0,362
test4sub7of100,test4pub72of100,1,190,5,360,1,366
test4sub62of100,test4pub72of100,1,190,5,361,0,366
test4sub47of100,test4pub72of100,1,190,5,366,1,372
test4sub21of100,test4pub72of100,1,190,5,369,2,376
test4sub8of100,test4pub72of100,1,190,5,370,3,378
test4sub82of100,test4pub72of100,1,190,5,372,2,379
test4sub96of100,test4pub72of100,1,190,5,376,2,383
test4sub10of100,test4pub72of100,1,190,5,377,1,383
test4sub11of100,test4pub72of100,1,190,5,378,2,385
test4sub5of100,test4pub72of100,1,190,5,379,2,386
test4sub95of100,test4pub72of100,1,190,5,380,1,386
test4sub2of100,test4pub72of100,1,190,5,384,1,390
test4sub56of100,test4pub72of100,1,190,5,384,1,390
test4sub27of100,test4pub72of100,1,190,5,386,0,391
test4sub70of100,test4pub72of100,1,190,5,402,1,408
test4sub44of100,test4pub72of100,1,190,5,410,0,415
test4sub66of100,test4pub72of100,1,190,5,416,1,422
test4sub99of100,test4pub72of100,1,190,5,416,1,422
test4sub78of100,test4pub72of100,1,190,5,420,1,426
test4sub65of100,test4pub72of100,1,190,5,420,1,426
test4sub73of100,test4pub72of100,1,190,5,421,1,427
test4sub39of100,test4pub72of100,1,190,5,422,1,428
test4sub37of100,test4pub72of100,1,190,5,425,1,431
test4sub38of100,test4pub72of100,1,190,5,425,1,431
test4sub61of100,test4pub72of100,1,190,5,426,2,433
test4sub1of100,test4pub72of100,1,190,5,428,1,434
test4sub23of100,test4pub72of100,1,190,5,431,8,444
test4sub3of100,test4pub72of100,1,190,5,431,1,437
test4sub13of100,test4pub72of100,1,190,5,438,2,445
test4sub15of100,test4pub72of100,1,190,5,432,9,446
test4sub28of100,test4pub72of100,1,190,5,439,3,447
test4sub17of100,test4pub72of100,1,190,5,440,3,448
test4sub42of100,test4pub72of100,1,190,5,440,3,448
test4sub77of100,test4pub72of100,1,190,5,444,0,449
test4sub98of100,test4pub72of100,1,190,5,446,1,452
test4sub60of100,test4pub72of100,1,190,5,460,1,466
test4sub86of100,test4pub72of100,1,190,5,462,0,467
test4sub84of100,test4pub72of100,1,190,5,468,1,474
test4sub33of100,test4pub72of100,1,190,5,482,1,488
test4sub29of100,test4pub72of100,1,190,5,486,1,492
test4sub76of100,test4pub72of100,1,190,5,491,1,497
test4sub74of100,test4pub72of100,1,190,5,492,1,498
test4sub89of100,test4pub72of100,1,190,5,494,0,499
test4sub26of100,test4pub73of100,1,190,5,19,0,24
test4sub99of100,test4pub73of100,1,190,5,27,0,32
test4sub29of100,test4pub73of100,1,190,5,28,1,34
test4sub49of100,test4pub73of100,1,190,5,42,0,47
test4sub92of100,test4pub73of100,1,190,5,49,1,55
test4sub53of100,test4pub73of100,1,190,5,59,1,65
test4sub59of100,test4pub73of100,1,190,5,91,1,97
test4sub35of100,test4pub73of100,1,190,5,96,1,102
test4sub69of100,test4pub73of100,1,190,5,98,1,104
test4sub41of100,test4pub73of100,1,190,5,100,0,105
test4sub1of100,test4pub73of100,1,190,5,105,0,110
test4sub37of100,test4pub73of100,1,190,5,106,1,112
test4sub57of100,test4pub73of100,1,190,5,109,1,115
test4sub19of100,test4pub73of100,1,190,5,113,1,119
test4sub66of100,test4pub73of100,1,190,5,114,0,119
test4sub10of100,test4pub73of100,1,190,5,119,1,125
test4sub72of100,test4pub73of100,1,190,5,120,1,126
test4sub42of100,test4pub73of100,1,190,5,120,1,126
test4sub83of100,test4pub73of100,1,190,5,122,0,127
test4sub51of100,test4pub73of100,1,190,5,128,0,133
test4sub5of100,test4pub73of100,1,190,5,132,0,137
test4sub40of100,test4pub73of100,1,190,5,136,1,142
test4sub30of100,test4pub73of100,1,190,5,138,1,144
test4sub12of100,test4pub73of100,1,190,5,159,1,165
test4sub88of100,test4pub73of100,1,190,5,170,0,175
test4sub71of100,test4pub73of100,1,190,5,172,1,178
test4sub77of100,test4pub73of100,1,190,5,173,0,178
test4sub39of100,test4pub73of100,1,190,5,185,0,190
test4sub54of100,test4pub73of100,1,190,5,193,1,199
test4sub82of100,test4pub73of100,1,190,5,203,1,209
test4sub73of100,test4pub73of100,1,190,5,205,1,211
test4sub8of100,test4pub73of100,1,190,5,213,1,219
test4sub84of100,test4pub73of100,1,190,5,213,0,218
test4sub89of100,test4pub73of100,1,190,5,224,0,229
test4sub86of100,test4pub73of100,1,190,5,231,0,236
test4sub17of100,test4pub73of100,1,190,5,236,0,241
test4sub9of100,test4pub73of100,1,190,5,237,1,243
test4sub75of100,test4pub73of100,1,190,5,242,0,247
test4sub70of100,test4pub73of100,1,190,5,246,0,251
test4sub33of100,test4pub73of100,1,190,5,254,1,260
test4sub3of100,test4pub73of100,1,190,5,257,1,263
test4sub23of100,test4pub73of100,1,190,5,269,1,275
test4sub90of100,test4pub73of100,1,190,5,272,0,277
test4sub89of100,test4pub74of100,1,190,5,12,1,18
test4sub58of100,test4pub73of100,1,190,5,311,1,317
test4sub45of100,test4pub74of100,1,190,5,27,1,33
test4sub32of100,test4pub73of100,1,190,5,324,3,332
test4sub24of100,test4pub74of100,1,190,5,28,2,35
test4sub31of100,test4pub73of100,1,190,5,325,1,331
test4sub27of100,test4pub73of100,1,190,5,333,1,339
test4sub93of100,test4pub73of100,1,190,5,334,1,340
test4sub95of100,test4pub73of100,1,190,5,341,1,347
test4sub66of100,test4pub74of100,1,190,5,53,1,59
test4sub37of100,test4pub74of100,1,190,5,53,0,58
test4sub25of100,test4pub73of100,1,190,5,357,0,362
test4sub47of100,test4pub73of100,1,190,5,359,1,365
test4sub39of100,test4pub74of100,1,190,5,63,3,71
test4sub8of100,test4pub74of100,1,190,5,65,1,71
test4sub76of100,test4pub73of100,1,190,5,358,5,368
test4sub65of100,test4pub73of100,1,190,5,360,2,367
test4sub24of100,test4pub73of100,1,190,5,361,2,368
test4sub64of100,test4pub73of100,1,190,5,364,1,370
test4sub3of100,test4pub74of100,1,190,5,72,1,78
test4sub97of100,test4pub74of100,1,190,5,79,1,85
test4sub63of100,test4pub73of100,1,190,5,377,0,382
test4sub36of100,test4pub73of100,1,190,5,387,0,392
test4sub22of100,test4pub73of100,1,190,5,392,1,398
test4sub55of100,test4pub74of100,1,190,5,98,1,104
test4sub61of100,test4pub73of100,1,190,5,395,1,401
test4sub28of100,test4pub73of100,1,190,5,401,0,406
test4sub46of100,test4pub73of100,1,190,5,409,1,415
test4sub69of100,test4pub74of100,1,190,5,115,1,121
test4sub18of100,test4pub73of100,1,190,5,412,1,418
test4sub40of100,test4pub74of100,1,190,5,156,1,162
test4sub67of100,test4pub73of100,1,190,5,459,1,465
test4sub14of100,test4pub73of100,1,190,5,461,1,467
test4sub91of100,test4pub73of100,1,190,5,462,0,467
test4sub9of100,test4pub74of100,1,190,5,168,1,174
test4sub19of100,test4pub74of100,1,190,5,169,3,177
test4sub2of100,test4pub74of100,1,190,5,170,4,179
test4sub25of100,test4pub74of100,1,190,5,170,3,178
test4sub4of100,test4pub73of100,1,190,5,466,4,475
test4sub71of100,test4pub74of100,1,190,5,171,4,180
test4sub87of100,test4pub74of100,1,190,5,171,4,180
test4sub47of100,test4pub74of100,1,190,5,172,4,181
test4sub62of100,test4pub73of100,1,190,5,469,4,478
test4sub70of100,test4pub74of100,1,190,5,175,2,182
test4sub34of100,test4pub73of100,1,190,5,495,0,500
test4sub56of100,test4pub73of100,1,190,5,495,1,501
test4sub81of100,test4pub74of100,1,190,5,204,1,210
test4sub51of100,test4pub74of100,1,190,5,205,1,211
test4sub33of100,test4pub74of100,1,190,5,205,1,211
test4sub96of100,test4pub73of100,1,190,5,504,1,510
test4sub48of100,test4pub73of100,1,190,5,505,2,512
test4sub78of100,test4pub73of100,1,190,5,505,1,511
test4sub29of100,test4pub74of100,1,190,5,210,2,217
test4sub85of100,test4pub73of100,1,190,5,510,1,516
test4sub98of100,test4pub73of100,1,190,5,511,1,517
test4sub87of100,test4pub73of100,1,190,5,512,1,518
test4sub97of100,test4pub73of100,1,190,5,513,1,519
test4sub62of100,test4pub74of100,1,190,5,219,1,225
test4sub79of100,test4pub73of100,1,190,5,515,2,522
test4sub20of100,test4pub73of100,1,190,5,522,1,528
test4sub86of100,test4pub74of100,1,190,5,226,1,232
test4sub14of100,test4pub74of100,1,190,5,227,1,233
test4sub11of100,test4pub73of100,1,190,5,529,1,535
test4sub60of100,test4pub73of100,1,190,5,529,6,540
test4sub76of100,test4pub74of100,1,190,5,262,1,268
test4sub68of100,test4pub73of100,1,190,5,561,0,566
test4sub52of100,test4pub73of100,1,190,5,561,1,567
test4sub99of100,test4pub74of100,1,190,5,267,1,273
test4sub13of100,test4pub74of100,1,190,5,268,1,274
test4sub98of100,test4pub74of100,1,190,5,269,2,276
test4sub17of100,test4pub74of100,1,190,5,270,2,277
test4sub15of100,test4pub73of100,1,190,5,567,3,575
test4sub5of100,test4pub74of100,1,190,5,272,1,278
test4sub80of100,test4pub73of100,1,190,5,569,1,575
test4sub94of100,test4pub73of100,1,190,5,571,1,577
test4sub38of100,test4pub73of100,1,190,5,572,2,579
test4sub48of100,test4pub74of100,1,190,5,277,2,284
test4sub57of100,test4pub74of100,1,190,5,278,1,284
test4sub45of100,test4pub73of100,1,190,5,578,0,583
test4sub27of100,test4pub74of100,1,190,5,286,1,292
test4sub81of100,test4pub73of100,1,190,5,583,1,589
test4sub6of100,test4pub73of100,1,190,5,589,1,595
test4sub74of100,test4pub74of100,1,190,5,294,2,301
test4sub7of100,test4pub73of100,1,190,5,590,2,597
test4sub38of100,test4pub74of100,1,190,5,296,0,301
test4sub75of100,test4pub74of100,1,190,5,323,0,328
test4sub18of100,test4pub74of100,1,190,5,323,1,329
test4sub2of100,test4pub73of100,1,190,5,622,1,628
test4sub80of100,test4pub74of100,1,190,5,333,1,339
test4sub46of100,test4pub74of100,1,190,5,334,3,342
test4sub43of100,test4pub73of100,1,190,5,630,5,640
test4sub53of100,test4pub74of100,1,190,5,336,5,346
test4sub77of100,test4pub74of100,1,190,5,336,4,345
test4sub50of100,test4pub73of100,1,190,5,633,4,642
test4sub44of100,test4pub73of100,1,190,5,634,4,643
test4sub67of100,test4pub74of100,1,190,5,338,4,347
test4sub28of100,test4pub74of100,1,190,5,339,4,348
test4sub16of100,test4pub73of100,1,190,5,635,5,645
test4sub55of100,test4pub73of100,1,190,5,638,4,647
test4sub100of100,test4pub73of100,1,190,5,639,3,647
test4sub74of100,test4pub73of100,1,190,5,639,4,648
test4sub21of100,test4pub73of100,1,190,5,640,4,649
test4sub13of100,test4pub73of100,1,190,5,642,4,651
test4sub41of100,test4pub74of100,1,190,5,347,3,355
test4sub90of100,test4pub74of100,1,190,5,347,4,356
test4sub85of100,test4pub74of100,1,190,5,348,3,356
test4sub82of100,test4pub74of100,1,190,5,349,1,355
test4sub56of100,test4pub74of100,1,190,5,354,1,360
test4sub54of100,test4pub74of100,1,190,5,354,1,360
test4sub32of100,test4pub74of100,1,190,5,357,1,363
test4sub10of100,test4pub74of100,1,190,5,357,2,364
test4sub49of100,test4pub74of100,1,190,5,358,1,364
test4sub1of100,test4pub74of100,1,190,5,366,1,372
test4sub44of100,test4pub74of100,1,190,5,367,1,373
test4sub21of100,test4pub74of100,1,190,5,368,1,374
test4sub72of100,test4pub74of100,1,190,5,370,1,376
test4sub84of100,test4pub74of100,1,190,5,433,0,438
test4sub26of100,test4pub74of100,1,190,5,446,1,452
test4sub68of100,test4pub74of100,1,190,5,450,1,456
test4sub4of100,test4pub74of100,1,190,5,450,1,456
test4sub95of100,test4pub74of100,1,190,5,452,1,458
test4sub58of100,test4pub74of100,1,190,5,452,1,458
test4sub96of100,test4pub74of100,1,190,5,455,4,464
test4sub30of100,test4pub74of100,1,190,5,455,6,466
test4sub91of100,test4pub74of100,1,190,5,456,8,469
test4sub78of100,test4pub74of100,1,190,5,457,9,471
test4sub31of100,test4pub74of100,1,190,5,457,9,471
test4sub73of100,test4pub74of100,1,190,5,458,8,471
test4sub15of100,test4pub74of100,1,190,5,459,8,472
test4sub60of100,test4pub74of100,1,190,5,459,7,471
test4sub100of100,test4pub74of100,1,190,5,458,8,471
test4sub12of100,test4pub74of100,1,190,5,460,7,472
test4sub83of100,test4pub74of100,1,190,5,461,6,472
test4sub65of100,test4pub74of100,1,190,5,461,6,472
test4sub23of100,test4pub74of100,1,190,5,462,6,473
test4sub35of100,test4pub74of100,1,190,5,463,6,474
test4sub63of100,test4pub74of100,1,190,5,463,5,473
test4sub34of100,test4pub74of100,1,190,5,463,6,474
test4sub92of100,test4pub74of100,1,190,5,464,5,474
test4sub7of100,test4pub74of100,1,190,5,607,1,613
test4sub88of100,test4pub74of100,1,190,5,692,0,697
test4sub59of100,test4pub74of100,1,190,5,694,1,700
test4sub64of100,test4pub74of100,1,190,5,695,1,701
test4sub42of100,test4pub74of100,1,190,5,696,1,702
test4sub22of100,test4pub74of100,1,190,5,701,1,707
test4sub20of100,test4pub74of100,1,190,5,703,1,709
test4sub36of100,test4pub74of100,1,190,5,703,1,709
test4sub43of100,test4pub74of100,1,190,5,701,4,710
test4sub6of100,test4pub74of100,1,190,5,702,2,709
test4sub11of100,test4pub74of100,1,190,5,707,0,712
test4sub50of100,test4pub74of100,1,190,5,706,2,713
test4sub79of100,test4pub74of100,1,190,5,713,1,719
test4sub94of100,test4pub74of100,1,190,5,714,2,721
test4sub61of100,test4pub74of100,1,190,5,715,1,721
test4sub93of100,test4pub74of100,1,190,5,715,2,722
test4sub52of100,test4pub74of100,1,190,5,722,1,728
test4sub16of100,test4pub74of100,1,190,5,757,1,763
test4sub86of100,test4pub75of100,1,190,5,25,0,30
test4sub95of100,test4pub75of100,1,190,5,39,0,44
test4sub39of100,test4pub75of100,1,190,5,41,1,47
test4sub97of100,test4pub75of100,1,190,5,47,0,52
test4sub10of100,test4pub75of100,1,190,5,61,0,66
test4sub43of100,test4pub75of100,1,190,5,69,1,75
test4sub48of100,test4pub75of100,1,190,5,70,0,75
test4sub40of100,test4pub75of100,1,190,5,76,1,82
test4sub21of100,test4pub75of100,1,190,5,86,0,91
test4sub35of100,test4pub75of100,1,190,5,119,1,125
test4sub29of100,test4pub75of100,1,190,5,132,1,138
test4sub94of100,test4pub75of100,1,190,5,135,3,143
test4sub60of100,test4pub75of100,1,190,5,136,3,144
test4sub38of100,test4pub75of100,1,190,5,136,7,148
test4sub82of100,test4pub75of100,1,190,5,136,8,149
test4sub78of100,test4pub75of100,1,190,5,139,6,150
test4sub90of100,test4pub75of100,1,190,5,140,5,150
test4sub28of100,test4pub75of100,1,190,5,141,5,151
test4sub63of100,test4pub75of100,1,190,5,141,7,153
test4sub55of100,test4pub75of100,1,190,5,142,8,155
test4sub13of100,test4pub75of100,1,190,5,143,8,156
test4sub15of100,test4pub75of100,1,190,5,148,3,156
test4sub87of100,test4pub75of100,1,190,5,149,4,158
test4sub44of100,test4pub75of100,1,190,5,150,3,158
test4sub89of100,test4pub75of100,1,190,5,159,2,166
test4sub61of100,test4pub75of100,1,190,5,166,1,172
test4sub100of100,test4pub75of100,1,190,5,169,1,175
test4sub83of100,test4pub75of100,1,190,5,186,0,191
test4sub96of100,test4pub75of100,1,190,5,200,1,206
test4sub76of100,test4pub75of100,1,190,5,200,0,205
test4sub77of100,test4pub75of100,1,190,5,203,0,208
test4sub33of100,test4pub75of100,1,190,5,205,0,210
test4sub22of100,test4pub75of100,1,190,5,212,1,218
test4sub27of100,test4pub75of100,1,190,5,212,1,218
test4sub34of100,test4pub75of100,1,190,5,214,1,220
test4sub54of100,test4pub75of100,1,190,5,214,2,221
test4sub16of100,test4pub75of100,1,190,5,215,1,221
test4sub79of100,test4pub75of100,1,190,5,231,1,237
test4sub98of100,test4pub75of100,1,190,5,238,1,244
test4sub84of100,test4pub75of100,1,190,5,243,1,249
test4sub20of100,test4pub75of100,1,190,5,246,1,252
test4sub30of100,test4pub75of100,1,190,5,267,1,273
test4sub25of100,test4pub75of100,1,190,5,272,1,278
test4sub70of100,test4pub75of100,1,190,5,274,1,280
test4sub50of100,test4pub75of100,1,190,5,277,0,282
test4sub57of100,test4pub75of100,1,190,5,283,1,289
test4sub91of100,test4pub75of100,1,190,5,283,1,289
test4sub49of100,test4pub75of100,1,190,5,290,1,296
test4sub72of100,test4pub75of100,1,190,5,290,1,296
test4sub67of100,test4pub75of100,1,190,5,292,1,298
test4sub32of100,test4pub75of100,1,190,5,312,1,318
test4sub69of100,test4pub75of100,1,190,5,329,0,334
test4sub26of100,test4pub75of100,1,190,5,329,1,335
test4sub31of100,test4pub75of100,1,190,5,334,1,340
test4sub47of100,test4pub75of100,1,190,5,347,1,353
test4sub56of100,test4pub75of100,1,190,5,350,1,356
test4sub24of100,test4pub75of100,1,190,5,366,0,371
test4sub6of100,test4pub75of100,1,190,5,393,1,399
test4sub5of100,test4pub75of100,1,190,5,407,1,413
test4sub1of100,test4pub75of100,1,190,5,415,1,421
test4sub4of100,test4pub75of100,1,190,5,425,0,430
test4sub62of100,test4pub75of100,1,190,5,437,0,442
test4sub18of100,test4pub75of100,1,190,5,440,1,446
test4sub45of100,test4pub75of100,1,190,5,440,1,446
test4sub58of100,test4pub75of100,1,190,5,442,0,447
test4sub36of100,test4pub75of100,1,190,5,449,0,454
test4sub64of100,test4pub75of100,1,190,5,450,0,455
test4sub52of100,test4pub76of100,1,190,5,29,0,34
test4sub80of100,test4pub75of100,1,190,5,460,0,465
test4sub35of100,test4pub76of100,1,190,5,33,1,39
test4sub51of100,test4pub76of100,1,190,5,44,1,50
test4sub3of100,test4pub75of100,1,190,5,473,1,479
test4sub66of100,test4pub75of100,1,190,5,482,0,487
test4sub28of100,test4pub76of100,1,190,5,87,1,93
test4sub52of100,test4pub75of100,1,190,5,526,1,532
test4sub38of100,test4pub76of100,1,190,5,99,1,105
test4sub30of100,test4pub76of100,1,190,5,100,1,106
test4sub19of100,test4pub75of100,1,190,5,527,0,532
test4sub95of100,test4pub76of100,1,190,5,109,1,115
test4sub99of100,test4pub76of100,1,190,5,110,1,116
test4sub73of100,test4pub75of100,1,190,5,540,1,546
test4sub75of100,test4pub75of100,1,190,5,556,1,562
test4sub7of100,test4pub76of100,1,190,5,149,0,154
test4sub39of100,test4pub76of100,1,190,5,149,1,155
test4sub51of100,test4pub75of100,1,190,5,580,0,585
test4sub49of100,test4pub76of100,1,190,5,153,1,159
test4sub16of100,test4pub76of100,1,190,5,156,1,162
test4sub75of100,test4pub76of100,1,190,5,159,1,165
test4sub69of100,test4pub76of100,1,190,5,161,0,166
test4sub7of100,test4pub75of100,1,190,5,589,1,595
test4sub60of100,test4pub76of100,1,190,5,163,0,168
test4sub26of100,test4pub76of100,1,190,5,165,1,171
test4sub80of100,test4pub76of100,1,190,5,166,1,172
test4sub88of100,test4pub75of100,1,190,5,596,0,601
test4sub74of100,test4pub75of100,1,190,5,598,1,604
test4sub64of100,test4pub76of100,1,190,5,175,1,181
test4sub33of100,test4pub76of100,1,190,5,189,0,194
test4sub81of100,test4pub75of100,1,190,5,619,1,625
test4sub17of100,test4pub75of100,1,190,5,622,1,628
test4sub93of100,test4pub75of100,1,190,5,624,1,630
test4sub89of100,test4pub76of100,1,190,5,199,1,205
test4sub5of100,test4pub76of100,1,190,5,201,1,207
test4sub53of100,test4pub76of100,1,190,5,202,1,208
test4sub79of100,test4pub76of100,1,190,5,203,1,209
test4sub57of100,test4pub76of100,1,190,5,203,1,209
test4sub41of100,test4pub75of100,1,190,5,636,0,641
test4sub21of100,test4pub76of100,1,190,5,215,1,221
test4sub2of100,test4pub75of100,1,190,5,642,1,648
test4sub56of100,test4pub76of100,1,190,5,217,1,223
test4sub92of100,test4pub76of100,1,190,5,217,1,223
test4sub85of100,test4pub75of100,1,190,5,645,2,652
test4sub32of100,test4pub76of100,1,190,5,219,1,225
test4sub46of100,test4pub75of100,1,190,5,687,0,692
test4sub14of100,test4pub75of100,1,190,5,689,1,695
test4sub8of100,test4pub75of100,1,190,5,689,1,695
test4sub63of100,test4pub76of100,1,190,5,263,1,269
test4sub13of100,test4pub76of100,1,190,5,265,1,271
test4sub97of100,test4pub76of100,1,190,5,266,1,272
test4sub70of100,test4pub76of100,1,190,5,277,1,283
test4sub53of100,test4pub75of100,1,190,5,706,1,712
test4sub71of100,test4pub75of100,1,190,5,707,1,713
test4sub12of100,test4pub75of100,1,190,5,706,3,714
test4sub85of100,test4pub76of100,1,190,5,284,1,290
test4sub2of100,test4pub76of100,1,190,5,283,2,290
test4sub61of100,test4pub76of100,1,190,5,287,1,293
test4sub29of100,test4pub76of100,1,190,5,291,1,297
test4sub65of100,test4pub75of100,1,190,5,719,2,726
test4sub27of100,test4pub76of100,1,190,5,291,1,297
test4sub92of100,test4pub75of100,1,190,5,720,1,726
test4sub100of100,test4pub76of100,1,190,5,299,0,304
test4sub96of100,test4pub76of100,1,190,5,304,1,310
test4sub93of100,test4pub76of100,1,190,5,310,0,315
test4sub37of100,test4pub75of100,1,190,5,740,0,745
test4sub90of100,test4pub76of100,1,190,5,336,0,341
test4sub23of100,test4pub76of100,1,190,5,340,0,345
test4sub50of100,test4pub76of100,1,190,5,349,0,354
test4sub99of100,test4pub75of100,1,190,5,778,0,783
test4sub9of100,test4pub75of100,1,190,5,786,1,792
test4sub59of100,test4pub75of100,1,190,5,795,1,801
test4sub24of100,test4pub76of100,1,190,5,376,1,382
test4sub11of100,test4pub75of100,1,190,5,805,1,811
test4sub1of100,test4pub76of100,1,190,5,379,1,385
test4sub42of100,test4pub75of100,1,190,5,803,5,813
test4sub36of100,test4pub76of100,1,190,5,377,4,386
test4sub41of100,test4pub76of100,1,190,5,378,4,387
test4sub55of100,test4pub76of100,1,190,5,380,2,387
test4sub68of100,test4pub75of100,1,190,5,806,4,815
test4sub15of100,test4pub76of100,1,190,5,384,2,391
test4sub67of100,test4pub76of100,1,190,5,386,1,392
test4sub44of100,test4pub76of100,1,190,5,383,5,393
test4sub86of100,test4pub76of100,1,190,5,384,4,393
test4sub98of100,test4pub76of100,1,190,5,385,4,394
test4sub54of100,test4pub76of100,1,190,5,386,3,394
test4sub19of100,test4pub76of100,1,190,5,386,2,393
test4sub47of100,test4pub76of100,1,190,5,391,1,397
test4sub18of100,test4pub76of100,1,190,5,393,1,399
test4sub71of100,test4pub76of100,1,190,5,394,1,400
test4sub6of100,test4pub76of100,1,190,5,397,2,404
test4sub91of100,test4pub76of100,1,190,5,396,3,404
test4sub66of100,test4pub76of100,1,190,5,398,3,406
test4sub23of100,test4pub75of100,1,190,5,825,2,832
test4sub22of100,test4pub76of100,1,190,5,399,1,405
test4sub87of100,test4pub76of100,1,190,5,400,1,406
test4sub9of100,test4pub76of100,1,190,5,404,1,410
test4sub73of100,test4pub76of100,1,190,5,414,1,420
test4sub14of100,test4pub76of100,1,190,5,415,2,422
test4sub59of100,test4pub76of100,1,190,5,415,1,421
test4sub82of100,test4pub76of100,1,190,5,429,1,435
test4sub37of100,test4pub76of100,1,190,5,446,1,452
test4sub40of100,test4pub76of100,1,190,5,446,1,452
test4sub11of100,test4pub76of100,1,190,5,482,1,488
test4sub34of100,test4pub76of100,1,190,5,492,0,497
test4sub20of100,test4pub76of100,1,190,5,493,0,498
test4sub45of100,test4pub76of100,1,190,5,510,0,515
test4sub68of100,test4pub76of100,1,190,5,534,0,539
test4sub10of100,test4pub77of100,1,190,5,15,0,20
test4sub40of100,test4pub77of100,1,190,5,21,1,27
test4sub74of100,test4pub76of100,1,190,5,551,1,557
test4sub64of100,test4pub77of100,1,190,5,28,1,34
test4sub78of100,test4pub76of100,1,190,5,559,1,565
test4sub58of100,test4pub77of100,1,190,5,40,0,45
test4sub11of100,test4pub77of100,1,190,5,45,1,51
test4sub62of100,test4pub76of100,1,190,5,574,0,579
test4sub8of100,test4pub77of100,1,190,5,50,1,56
test4sub84of100,test4pub76of100,1,190,5,603,1,609
test4sub99of100,test4pub77of100,1,190,5,107,1,113
test4sub60of100,test4pub77of100,1,190,5,116,1,122
test4sub88of100,test4pub76of100,1,190,5,644,1,650
test4sub8of100,test4pub76of100,1,190,5,647,0,652
test4sub25of100,test4pub77of100,1,190,5,125,1,131
test4sub48of100,test4pub76of100,1,190,5,655,1,661
test4sub76of100,test4pub76of100,1,190,5,655,0,660
test4sub3of100,test4pub76of100,1,190,5,669,1,675
test4sub12of100,test4pub76of100,1,190,5,674,1,680
test4sub47of100,test4pub77of100,1,190,5,147,1,153
test4sub72of100,test4pub76of100,1,190,5,676,3,684
test4sub83of100,test4pub77of100,1,190,5,149,4,158
test4sub88of100,test4pub77of100,1,190,5,150,3,158
test4sub10of100,test4pub76of100,1,190,5,677,3,685
test4sub31of100,test4pub76of100,1,190,5,678,3,686
test4sub4of100,test4pub76of100,1,190,5,679,2,686
test4sub94of100,test4pub76of100,1,190,5,683,1,689
test4sub43of100,test4pub76of100,1,190,5,683,2,690
test4sub81of100,test4pub76of100,1,190,5,684,1,690
test4sub77of100,test4pub76of100,1,190,5,685,1,691
test4sub65of100,test4pub76of100,1,190,5,689,1,695
test4sub25of100,test4pub76of100,1,190,5,702,1,708
test4sub42of100,test4pub76of100,1,190,5,719,1,725
test4sub83of100,test4pub76of100,1,190,5,723,0,728
test4sub19of100,test4pub77of100,1,190,5,198,0,203
test4sub49of100,test4pub77of100,1,190,5,200,0,205
test4sub1of100,test4pub77of100,1,190,5,209,1,215
test4sub58of100,test4pub76of100,1,190,5,738,1,744
test4sub46of100,test4pub76of100,1,190,5,743,1,749
test4sub34of100,test4pub77of100,1,190,5,218,1,224
test4sub32of100,test4pub77of100,1,190,5,219,1,225
test4sub9of100,test4pub77of100,1,190,5,225,1,231
test4sub17of100,test4pub76of100,1,190,5,752,1,758
test4sub100of100,test4pub77of100,1,190,5,228,1,234
test4sub96of100,test4pub77of100,1,190,5,231,1,237
test4sub12of100,test4pub77of100,1,190,5,239,1,245
test4sub13of100,test4pub77of100,1,190,5,242,0,247
test4sub75of100,test4pub77of100,1,190,5,250,1,256
test4sub94of100,test4pub77of100,1,190,5,256,0,261
test4sub89of100,test4pub77of100,1,190,5,257,2,264
test4sub18of100,test4pub77of100,1,190,5,258,1,264
test4sub27of100,test4pub77of100,1,190,5,260,1,266
test4sub23of100,test4pub77of100,1,190,5,266,0,271
test4sub35of100,test4pub77of100,1,190,5,268,1,274
test4sub73of100,test4pub77of100,1,190,5,269,2,276
test4sub37of100,test4pub77of100,1,190,5,270,1,276
test4sub77of100,test4pub77of100,1,190,5,277,1,283
test4sub20of100,test4pub77of100,1,190,5,278,1,284
test4sub43of100,test4pub77of100,1,190,5,287,0,292
test4sub80of100,test4pub77of100,1,190,5,289,0,294
test4sub22of100,test4pub77of100,1,190,5,295,1,301
test4sub93of100,test4pub77of100,1,190,5,296,1,302
test4sub15of100,test4pub77of100,1,190,5,301,1,307
test4sub65of100,test4pub77of100,1,190,5,306,0,311
test4sub70of100,test4pub77of100,1,190,5,312,1,318
test4sub45of100,test4pub77of100,1,190,5,320,1,326
test4sub46of100,test4pub77of100,1,190,5,323,0,328
test4sub63of100,test4pub77of100,1,190,5,327,1,333
test4sub41of100,test4pub77of100,1,190,5,328,1,334
test4sub98of100,test4pub77of100,1,190,5,358,1,364
test4sub78of100,test4pub78of100,1,190,5,43,1,49
test4sub54of100,test4pub77of100,1,190,5,369,1,375
test4sub69of100,test4pub78of100,1,190,5,49,1,55
test4sub59of100,test4pub78of100,1,190,5,59,1,65
test4sub51of100,test4pub78of100,1,190,5,54,1,60
test4sub11of100,test4pub78of100,1,190,5,62,1,68
test4sub73of100,test4pub78of100,1,190,5,74,1,80
test4sub95of100,test4pub77of100,1,190,5,404,0,409
test4sub59of100,test4pub77of100,1,190,5,406,1,412
test4sub98of100,test4pub78of100,1,190,5,87,1,93
test4sub69of100,test4pub77of100,1,190,5,415,1,421
test4sub60of100,test4pub78of100,1,190,5,92,2,99
test4sub84of100,test4pub77of100,1,190,5,422,1,428
test4sub6of100,test4pub78of100,1,190,5,128,0,133
test4sub26of100,test4pub77of100,1,190,5,455,0,460
test4sub19of100,test4pub78of100,1,190,5,142,1,148
test4sub79of100,test4pub77of100,1,190,5,472,1,478
test4sub83of100,test4pub78of100,1,190,5,149,0,154
test4sub80of100,test4pub78of100,1,190,5,151,1,157
test4sub68of100,test4pub77of100,1,190,5,475,1,481
test4sub71of100,test4pub78of100,1,190,5,163,1,169
test4sub55of100,test4pub77of100,1,190,5,486,0,491
test4sub95of100,test4pub78of100,1,190,5,165,1,171
test4sub16of100,test4pub77of100,1,190,5,489,1,495
test4sub13of100,test4pub78of100,1,190,5,169,0,174
test4sub90of100,test4pub77of100,1,190,5,492,1,498
test4sub79of100,test4pub78of100,1,190,5,173,0,178
test4sub17of100,test4pub77of100,1,190,5,499,0,504
test4sub44of100,test4pub78of100,1,190,5,178,1,184
test4sub78of100,test4pub77of100,1,190,5,513,1,519
test4sub53of100,test4pub77of100,1,190,5,513,1,519
test4sub37of100,test4pub78of100,1,190,5,215,1,221
test4sub87of100,test4pub78of100,1,190,5,215,2,222
test4sub20of100,test4pub78of100,1,190,5,216,2,223
test4sub55of100,test4pub78of100,1,190,5,217,1,223
test4sub31of100,test4pub77of100,1,190,5,547,1,553
test4sub100of100,test4pub78of100,1,190,5,229,0,234
test4sub24of100,test4pub77of100,1,190,5,553,2,560
test4sub85of100,test4pub78of100,1,190,5,231,2,238
test4sub63of100,test4pub78of100,1,190,5,231,2,238
test4sub36of100,test4pub77of100,1,190,5,555,1,561
test4sub49of100,test4pub78of100,1,190,5,234,4,243
test4sub61of100,test4pub77of100,1,190,5,558,4,567
test4sub75of100,test4pub78of100,1,190,5,235,6,246
test4sub39of100,test4pub78of100,1,190,5,236,5,246
test4sub44of100,test4pub77of100,1,190,5,560,5,570
test4sub38of100,test4pub77of100,1,190,5,560,4,569
test4sub33of100,test4pub78of100,1,190,5,238,4,247
test4sub29of100,test4pub77of100,1,190,5,562,4,571
test4sub72of100,test4pub77of100,1,190,5,563,3,571
test4sub26of100,test4pub78of100,1,190,5,248,1,254
test4sub85of100,test4pub77of100,1,190,5,576,1,582
test4sub61of100,test4pub78of100,1,190,5,259,1,265
test4sub33of100,test4pub77of100,1,190,5,585,0,590
test4sub14of100,test4pub77of100,1,190,5,589,1,595
test4sub42of100,test4pub77of100,1,190,5,589,0,594
test4sub29of100,test4pub78of100,1,190,5,269,1,275
test4sub9of100,test4pub78of100,1,190,5,269,1,275
test4sub21of100,test4pub77of100,1,190,5,595,1,601
test4sub56of100,test4pub77of100,1,190,5,603,1,609
test4sub10of100,test4pub78of100,1,190,5,285,0,290
test4sub28of100,test4pub77of100,1,190,5,609,0,614
test4sub97of100,test4pub77of100,1,190,5,612,1,618
test4sub3of100,test4pub77of100,1,190,5,612,1,618
test4sub84of100,test4pub78of100,1,190,5,291,2,298
test4sub82of100,test4pub77of100,1,190,5,614,2,621
test4sub66of100,test4pub77of100,1,190,5,615,2,622
test4sub91of100,test4pub77of100,1,190,5,615,1,621
test4sub16of100,test4pub78of100,1,190,5,295,1,301
test4sub48of100,test4pub77of100,1,190,5,621,1,627
test4sub86of100,test4pub77of100,1,190,5,622,2,629
test4sub74of100,test4pub77of100,1,190,5,623,2,630
test4sub35of100,test4pub78of100,1,190,5,300,4,309
test4sub71of100,test4pub77of100,1,190,5,625,3,633
test4sub4of100,test4pub77of100,1,190,5,626,3,634
test4sub67of100,test4pub77of100,1,190,5,627,2,634
test4sub87of100,test4pub77of100,1,190,5,627,2,634
test4sub57of100,test4pub78of100,1,190,5,308,1,314
test4sub43of100,test4pub78of100,1,190,5,310,0,315
test4sub21of100,test4pub78of100,1,190,5,315,1,321
test4sub89of100,test4pub78of100,1,190,5,331,1,337
test4sub6of100,test4pub77of100,1,190,5,660,0,665
test4sub30of100,test4pub78of100,1,190,5,343,1,349
test4sub38of100,test4pub78of100,1,190,5,344,0,349
test4sub62of100,test4pub77of100,1,190,5,668,1,674
test4sub52of100,test4pub77of100,1,190,5,671,1,677
test4sub22of100,test4pub78of100,1,190,5,349,1,355
test4sub51of100,test4pub77of100,1,190,5,677,1,683
test4sub56of100,test4pub78of100,1,190,5,360,1,366
test4sub7of100,test4pub77of100,1,190,5,685,1,691
test4sub47of100,test4pub78of100,1,190,5,422,1,428
test4sub48of100,test4pub78of100,1,190,5,431,0,436
test4sub5of100,test4pub77of100,1,190,5,758,0,763
test4sub8of100,test4pub78of100,1,190,5,445,1,451
test4sub39of100,test4pub77of100,1,190,5,769,2,776
test4sub57of100,test4pub77of100,1,190,5,770,4,779
test4sub81of100,test4pub77of100,1,190,5,771,4,780
test4sub25of100,test4pub78of100,1,190,5,448,4,457
test4sub92of100,test4pub77of100,1,190,5,773,3,781
test4sub40of100,test4pub78of100,1,190,5,450,4,459
test4sub50of100,test4pub77of100,1,190,5,777,1,783
test4sub76of100,test4pub77of100,1,190,5,778,1,784
test4sub94of100,test4pub78of100,1,190,5,460,2,467
test4sub2of100,test4pub77of100,1,190,5,783,3,791
test4sub4of100,test4pub78of100,1,190,5,461,2,468
test4sub64of100,test4pub78of100,1,190,5,462,3,470
test4sub28of100,test4pub78of100,1,190,5,463,1,469
test4sub34of100,test4pub78of100,1,190,5,471,0,476
test4sub30of100,test4pub77of100,1,190,5,797,11,813
test4sub62of100,test4pub78of100,1,190,5,475,4,484
test4sub68of100,test4pub78of100,1,190,5,481,4,490
test4sub46of100,test4pub78of100,1,190,5,482,3,490
test4sub97of100,test4pub78of100,1,190,5,482,3,490
test4sub96of100,test4pub78of100,1,190,5,483,4,492
test4sub72of100,test4pub78of100,1,190,5,483,4,492
test4sub70of100,test4pub78of100,1,190,5,475,12,492
test4sub27of100,test4pub78of100,1,190,5,484,4,493
test4sub65of100,test4pub78of100,1,190,5,484,4,493
test4sub7of100,test4pub78of100,1,190,5,501,1,507
test4sub5of100,test4pub78of100,1,190,5,516,1,522
test4sub12of100,test4pub78of100,1,190,5,525,1,531
test4sub81of100,test4pub78of100,1,190,5,526,1,532
test4sub82of100,test4pub78of100,1,190,5,527,1,533
test4sub50of100,test4pub78of100,1,190,5,530,0,535
test4sub92of100,test4pub78of100,1,190,5,536,1,542
test4sub3of100,test4pub78of100,1,190,5,536,0,541
test4sub42of100,test4pub78of100,1,190,5,538,0,543
test4sub88of100,test4pub78of100,1,190,5,543,1,549
test4sub45of100,test4pub78of100,1,190,5,553,0,558
test4sub52of100,test4pub78of100,1,190,5,555,1,561
test4sub41of100,test4pub78of100,1,190,5,562,1,568
test4sub14of100,test4pub78of100,1,190,5,568,1,574
test4sub24of100,test4pub78of100,1,190,5,569,0,574
test4sub1of100,test4pub78of100,1,190,5,572,1,578
test4sub23of100,test4pub78of100,1,190,5,573,0,578
test4sub32of100,test4pub78of100,1,190,5,575,1,581
test4sub93of100,test4pub78of100,1,190,5,583,0,588
test4sub67of100,test4pub78of100,1,190,5,593,1,599
test4sub36of100,test4pub78of100,1,190,5,593,1,599
test4sub99of100,test4pub78of100,1,190,5,608,1,614
test4sub86of100,test4pub78of100,1,190,5,609,1,615
test4sub91of100,test4pub78of100,1,190,5,609,3,617
test4sub77of100,test4pub78of100,1,190,5,611,2,618
test4sub66of100,test4pub78of100,1,190,5,612,1,618
test4sub18of100,test4pub78of100,1,190,5,612,2,619
test4sub58of100,test4pub78of100,1,190,5,614,1,620
test4sub85of100,test4pub79of100,1,190,6,18,0,24
test4sub24of100,test4pub79of100,1,190,6,24,0,30
test4sub3of100,test4pub79of100,1,190,6,24,1,31
test4sub90of100,test4pub78of100,1,190,5,637,0,642
test4sub49of100,test4pub79of100,1,190,6,33,0,39
test4sub76of100,test4pub79of100,1,190,6,35,1,42
test4sub89of100,test4pub79of100,1,190,6,46,1,53
test4sub31of100,test4pub78of100,1,190,5,656,1,662
test4sub37of100,test4pub79of100,1,190,6,59,1,66
test4sub71of100,test4pub79of100,1,190,6,61,1,68
test4sub17of100,test4pub78of100,1,190,5,678,1,684
test4sub53of100,test4pub78of100,1,190,5,683,1,689
test4sub54of100,test4pub78of100,1,190,5,688,1,694
test4sub15of100,test4pub78of100,1,190,5,693,1,699
test4sub33of100,test4pub79of100,1,190,6,90,1,97
test4sub79of100,test4pub79of100,1,190,6,99,1,106
test4sub12of100,test4pub79of100,1,190,6,100,0,106
test4sub76of100,test4pub78of100,1,190,5,733,1,739
test4sub2of100,test4pub78of100,1,190,5,734,1,740
test4sub74of100,test4pub78of100,1,190,5,735,1,741
test4sub32of100,test4pub79of100,1,190,6,129,1,136
test4sub48of100,test4pub79of100,1,190,6,130,2,138
test4sub88of100,test4pub79of100,1,190,6,131,1,138
test4sub22of100,test4pub79of100,1,190,6,136,1,143
test4sub65of100,test4pub79of100,1,190,6,164,1,171
test4sub39of100,test4pub79of100,1,190,6,169,1,176
test4sub21of100,test4pub79of100,1,190,6,175,1,182
test4sub23of100,test4pub79of100,1,190,6,181,0,187
test4sub63of100,test4pub79of100,1,190,6,184,1,191
test4sub70of100,test4pub79of100,1,190,6,184,2,192
test4sub8of100,test4pub79of100,1,190,6,186,1,193
test4sub95of100,test4pub79of100,1,190,6,185,2,193
test4sub68of100,test4pub79of100,1,190,6,187,0,193
test4sub7of100,test4pub79of100,1,190,6,193,1,200
test4sub26of100,test4pub79of100,1,190,6,195,0,201
test4sub47of100,test4pub79of100,1,190,6,197,0,203
test4sub4of100,test4pub79of100,1,190,6,201,1,208
test4sub35of100,test4pub79of100,1,190,6,201,1,208
test4sub90of100,test4pub79of100,1,190,6,203,0,209
test4sub60of100,test4pub79of100,1,190,6,205,1,212
test4sub93of100,test4pub79of100,1,190,6,205,2,213
test4sub52of100,test4pub79of100,1,190,6,206,1,213
test4sub96of100,test4pub79of100,1,190,6,209,1,216
test4sub50of100,test4pub79of100,1,190,6,209,1,216
test4sub55of100,test4pub79of100,1,190,6,212,1,219
test4sub41of100,test4pub79of100,1,190,6,217,0,223
test4sub5of100,test4pub79of100,1,190,6,221,1,228
test4sub51of100,test4pub79of100,1,190,6,223,0,229
test4sub57of100,test4pub79of100,1,190,6,223,1,230
test4sub6of100,test4pub79of100,1,190,6,228,0,234
test4sub97of100,test4pub79of100,1,190,6,238,1,245
test4sub18of100,test4pub79of100,1,190,6,242,1,249
test4sub20of100,test4pub79of100,1,190,6,250,1,257
test4sub1of100,test4pub79of100,1,190,6,253,1,260
test4sub54of100,test4pub79of100,1,190,6,269,0,275
test4sub64of100,test4pub79of100,1,190,6,270,1,277
test4sub99of100,test4pub79of100,1,190,6,281,1,288
test4sub34of100,test4pub79of100,1,190,6,285,1,292
test4sub53of100,test4pub79of100,1,190,6,329,0,335
test4sub75of100,test4pub79of100,1,190,6,332,0,338
test4sub82of100,test4pub79of100,1,190,6,333,1,340
test4sub46of100,test4pub79of100,1,190,6,334,1,341
test4sub86of100,test4pub79of100,1,190,6,342,1,349
test4sub16of100,test4pub79of100,1,190,6,345,1,352
test4sub73of100,test4pub79of100,1,190,6,345,1,352
test4sub83of100,test4pub79of100,1,190,6,347,0,353
test4sub61of100,test4pub79of100,1,190,6,350,2,358
test4sub9of100,test4pub79of100,1,190,6,350,2,358
test4sub2of100,test4pub79of100,1,190,6,356,1,363
test4sub72of100,test4pub79of100,1,190,6,367,0,373
test4sub81of100,test4pub79of100,1,190,6,373,0,379
test4sub44of100,test4pub79of100,1,190,6,420,1,427
test4sub43of100,test4pub79of100,1,190,6,421,1,428
test4sub98of100,test4pub79of100,1,190,6,421,1,428
test4sub67of100,test4pub79of100,1,190,6,422,2,430
test4sub100of100,test4pub79of100,1,190,6,424,2,432
test4sub36of100,test4pub79of100,1,190,6,424,2,432
test4sub80of100,test4pub79of100,1,190,6,424,2,432
test4sub28of100,test4pub79of100,1,190,6,426,1,433
test4sub29of100,test4pub79of100,1,190,6,431,1,438
test4sub31of100,test4pub79of100,1,190,6,432,1,439
test4sub25of100,test4pub79of100,1,190,6,436,1,443
test4sub66of100,test4pub79of100,1,190,6,437,0,443
test4sub14of100,test4pub79of100,1,190,6,442,1,449
test4sub56of100,test4pub79of100,1,190,6,445,0,451
test4sub27of100,test4pub79of100,1,190,6,446,1,453
test4sub45of100,test4pub79of100,1,190,6,447,0,453
test4sub15of100,test4pub79of100,1,190,6,449,3,458
test4sub19of100,test4pub79of100,1,190,6,449,4,459
test4sub40of100,test4pub79of100,1,190,6,450,3,459
test4sub87of100,test4pub79of100,1,190,6,450,5,461
test4sub59of100,test4pub79of100,1,190,6,450,5,461
test4sub74of100,test4pub79of100,1,190,6,451,6,463
test4sub42of100,test4pub79of100,1,190,6,452,4,462
test4sub99of100,test4pub80of100,1,190,5,21,3,29
test4sub10of100,test4pub79of100,1,190,6,455,3,464
test4sub73of100,test4pub80of100,1,190,5,22,3,30
test4sub69of100,test4pub79of100,1,190,6,470,0,476
test4sub61of100,test4pub80of100,1,190,5,42,1,48
test4sub50of100,test4pub80of100,1,190,5,43,1,49
test4sub7of100,test4pub80of100,1,190,5,46,0,51
test4sub67of100,test4pub80of100,1,190,5,48,0,53
test4sub77of100,test4pub79of100,1,190,6,483,1,490
test4sub90of100,test4pub80of100,1,190,5,53,1,59
test4sub79of100,test4pub80of100,1,190,5,66,1,72
test4sub38of100,test4pub79of100,1,190,6,499,1,506
test4sub88of100,test4pub80of100,1,190,5,68,0,73
test4sub91of100,test4pub79of100,1,190,6,510,1,517
test4sub78of100,test4pub79of100,1,190,6,512,1,519
test4sub30of100,test4pub79of100,1,190,6,512,1,519
test4sub8of100,test4pub80of100,1,190,5,82,1,88
test4sub3of100,test4pub80of100,1,190,5,88,0,93
test4sub92of100,test4pub79of100,1,190,6,524,1,531
test4sub62of100,test4pub80of100,1,190,5,93,2,100
test4sub84of100,test4pub79of100,1,190,6,525,2,533
test4sub13of100,test4pub79of100,1,190,6,526,2,534
test4sub89of100,test4pub80of100,1,190,5,95,1,101
test4sub94of100,test4pub79of100,1,190,6,533,1,540
test4sub52of100,test4pub80of100,1,190,5,102,1,108
test4sub58of100,test4pub79of100,1,190,6,536,1,543
test4sub80of100,test4pub80of100,1,190,5,105,1,111
test4sub17of100,test4pub79of100,1,190,6,538,0,544
test4sub43of100,test4pub80of100,1,190,5,114,0,119
test4sub33of100,test4pub80of100,1,190,5,119,1,125
test4sub31of100,test4pub80of100,1,190,5,125,1,131
test4sub26of100,test4pub80of100,1,190,5,129,1,135
test4sub27of100,test4pub80of100,1,190,5,134,2,141
test4sub45of100,test4pub80of100,1,190,5,134,3,142
test4sub28of100,test4pub80of100,1,190,5,135,2,142
test4sub19of100,test4pub80of100,1,190,5,135,3,143
test4sub59of100,test4pub80of100,1,190,5,136,1,142
test4sub11of100,test4pub79of100,1,190,6,577,1,584
test4sub70of100,test4pub80of100,1,190,5,150,0,155
test4sub20of100,test4pub80of100,1,190,5,151,1,157
test4sub74of100,test4pub80of100,1,190,5,152,0,157
test4sub47of100,test4pub80of100,1,190,5,163,0,168
test4sub16of100,test4pub80of100,1,190,5,175,1,181
test4sub63of100,test4pub80of100,1,190,5,177,1,183
test4sub18of100,test4pub80of100,1,190,5,179,1,185
test4sub93of100,test4pub80of100,1,190,5,182,0,187
test4sub25of100,test4pub80of100,1,190,5,185,1,191
test4sub91of100,test4pub80of100,1,190,5,216,0,221
test4sub78of100,test4pub80of100,1,190,5,221,1,227
test4sub30of100,test4pub80of100,1,190,5,222,1,228
test4sub15of100,test4pub80of100,1,190,5,223,1,229
test4sub69of100,test4pub80of100,1,190,5,226,1,232
test4sub34of100,test4pub80of100,1,190,5,227,1,233
test4sub94of100,test4pub80of100,1,190,5,234,0,239
test4sub81of100,test4pub80of100,1,190,5,239,0,244
test4sub21of100,test4pub80of100,1,190,5,242,1,248
test4sub100of100,test4pub80of100,1,190,5,243,1,249
test4sub17of100,test4pub80of100,1,190,5,245,1,251
test4sub58of100,test4pub80of100,1,190,5,248,1,254
test4sub42of100,test4pub80of100,1,190,5,251,1,257
test4sub96of100,test4pub80of100,1,190,5,255,1,261
test4sub10of100,test4pub80of100,1,190,5,282,0,287
test4sub35of100,test4pub80of100,1,190,5,283,1,289
test4sub86of100,test4pub80of100,1,190,5,293,1,299
test4sub23of100,test4pub80of100,1,190,5,298,0,303
test4sub13of100,test4pub80of100,1,190,5,311,0,316
test4sub92of100,test4pub80of100,1,190,5,341,1,347
test4sub2of100,test4pub80of100,1,190,5,344,1,350
test4sub72of100,test4pub80of100,1,190,5,347,1,353
test4sub97of100,test4pub80of100,1,190,5,350,1,356
test4sub64of100,test4pub80of100,1,190,5,378,1,384
test4sub36of100,test4pub80of100,1,190,5,386,1,392
test4sub44of100,test4pub81of100,1,190,5,11,1,17
test4sub59of100,test4pub81of100,1,190,5,33,1,39
test4sub49of100,test4pub80of100,1,190,5,416,1,422
test4sub83of100,test4pub80of100,1,190,5,426,1,432
test4sub76of100,test4pub80of100,1,190,5,431,1,437
test4sub7of100,test4pub81of100,1,190,5,61,1,67
test4sub67of100,test4pub81of100,1,190,5,70,1,76
test4sub93of100,test4pub81of100,1,190,5,76,1,82
test4sub84of100,test4pub80of100,1,190,5,466,1,472
test4sub62of100,test4pub79of100,1,190,6,907,0,913
test4sub51of100,test4pub80of100,1,190,5,482,0,487
test4sub29of100,test4pub81of100,1,190,5,105,1,111
test4sub31of100,test4pub81of100,1,190,5,107,0,112
test4sub46of100,test4pub80of100,1,190,5,508,1,514
test4sub77of100,test4pub80of100,1,190,5,509,2,516
test4sub8of100,test4pub81of100,1,190,5,129,1,135
test4sub41of100,test4pub80of100,1,190,5,511,1,517
test4sub68of100,test4pub80of100,1,190,5,513,1,519
test4sub9of100,test4pub80of100,1,190,5,514,1,520
test4sub34of100,test4pub81of100,1,190,5,135,0,140
test4sub85of100,test4pub80of100,1,190,5,518,1,524
test4sub98of100,test4pub80of100,1,190,5,519,0,524
test4sub71of100,test4pub80of100,1,190,5,522,1,528
test4sub12of100,test4pub80of100,1,190,5,528,0,533
test4sub54of100,test4pub80of100,1,190,5,531,1,537
test4sub75of100,test4pub80of100,1,190,5,531,2,538
test4sub53of100,test4pub80of100,1,190,5,533,0,538
test4sub37of100,test4pub80of100,1,190,5,532,2,539
test4sub82of100,test4pub81of100,1,190,5,155,1,161
test4sub11of100,test4pub80of100,1,190,5,536,2,543
test4sub40of100,test4pub81of100,1,190,5,156,1,162
test4sub64of100,test4pub81of100,1,190,5,157,2,164
test4sub21of100,test4pub81of100,1,190,5,169,2,176
test4sub48of100,test4pub81of100,1,190,5,170,3,178
test4sub26of100,test4pub81of100,1,190,5,171,4,180
test4sub1of100,test4pub80of100,1,190,5,552,4,561
test4sub44of100,test4pub80of100,1,190,5,553,3,561
test4sub16of100,test4pub81of100,1,190,5,173,4,182
test4sub73of100,test4pub81of100,1,190,5,174,4,183
test4sub65of100,test4pub80of100,1,190,5,555,3,563
test4sub83of100,test4pub81of100,1,190,5,176,3,184
test4sub60of100,test4pub80of100,1,190,5,558,0,563
test4sub24of100,test4pub80of100,1,190,5,562,1,568
test4sub39of100,test4pub80of100,1,190,5,563,1,569
test4sub5of100,test4pub80of100,1,190,5,568,0,573
test4sub87of100,test4pub80of100,1,190,5,571,1,577
test4sub56of100,test4pub80of100,1,190,5,575,0,580
test4sub22of100,test4pub81of100,1,190,5,197,1,203
test4sub25of100,test4pub81of100,1,190,5,199,1,205
test4sub71of100,test4pub81of100,1,190,5,200,2,207
test4sub1of100,test4pub81of100,1,190,5,201,1,207
test4sub49of100,test4pub81of100,1,190,5,208,1,214
test4sub6of100,test4pub80of100,1,190,5,589,1,595
test4sub95of100,test4pub80of100,1,190,5,592,0,597
test4sub5of100,test4pub81of100,1,190,5,214,1,220
test4sub32of100,test4pub80of100,1,190,5,601,1,607
test4sub82of100,test4pub80of100,1,190,5,608,1,614
test4sub55of100,test4pub81of100,1,190,5,233,1,239
test4sub53of100,test4pub81of100,1,190,5,238,0,243
test4sub51of100,test4pub81of100,1,190,5,238,1,244
test4sub47of100,test4pub81of100,1,190,5,239,1,245
test4sub85of100,test4pub81of100,1,190,5,241,1,247
test4sub88of100,test4pub81of100,1,190,5,243,1,249
test4sub86of100,test4pub81of100,1,190,5,244,2,251
test4sub66of100,test4pub80of100,1,190,5,625,1,631
test4sub43of100,test4pub81of100,1,190,5,246,2,253
test4sub89of100,test4pub81of100,1,190,5,247,0,252
test4sub99of100,test4pub81of100,1,190,5,256,1,262
test4sub38of100,test4pub80of100,1,190,5,643,0,648
test4sub22of100,test4pub80of100,1,190,5,643,1,649
test4sub57of100,test4pub80of100,1,190,5,646,2,653
test4sub14of100,test4pub80of100,1,190,5,647,2,654
test4sub55of100,test4pub80of100,1,190,5,647,3,655
test4sub4of100,test4pub80of100,1,190,5,648,2,655
test4sub29of100,test4pub80of100,1,190,5,649,1,655
test4sub30of100,test4pub81of100,1,190,5,273,0,278
test4sub36of100,test4pub81of100,1,190,5,277,1,283
test4sub61of100,test4pub81of100,1,190,5,277,1,283
test4sub41of100,test4pub81of100,1,190,5,292,1,298
test4sub75of100,test4pub81of100,1,190,5,292,1,298
test4sub40of100,test4pub80of100,1,190,5,677,1,683
test4sub48of100,test4pub80of100,1,190,5,677,1,683
test4sub63of100,test4pub81of100,1,190,5,306,1,312
test4sub37of100,test4pub81of100,1,190,5,312,1,318
test4sub66of100,test4pub81of100,1,190,5,315,1,321
test4sub87of100,test4pub81of100,1,190,5,324,1,330
test4sub3of100,test4pub81of100,1,190,5,339,1,345
test4sub9of100,test4pub81of100,1,190,5,366,1,372
test4sub94of100,test4pub81of100,1,190,5,377,1,383
test4sub58of100,test4pub81of100,1,190,5,378,1,384
test4sub69of100,test4pub81of100,1,190,5,380,1,386
test4sub46of100,test4pub81of100,1,190,5,380,1,386
test4sub33of100,test4pub81of100,1,190,5,381,3,389
test4sub80of100,test4pub81of100,1,190,5,383,3,391
test4sub60of100,test4pub81of100,1,190,5,383,2,390
test4sub23of100,test4pub81of100,1,190,5,382,4,391
test4sub57of100,test4pub81of100,1,190,5,383,4,392
test4sub14of100,test4pub81of100,1,190,5,384,3,392
test4sub15of100,test4pub81of100,1,190,5,384,2,391
test4sub70of100,test4pub81of100,1,190,5,389,1,395
test4sub42of100,test4pub81of100,1,190,5,393,1,399
test4sub56of100,test4pub81of100,1,190,5,393,1,399
test4sub68of100,test4pub81of100,1,190,5,398,7,410
test4sub11of100,test4pub81of100,1,190,5,405,1,411
test4sub90of100,test4pub81of100,1,190,5,404,1,410
test4sub78of100,test4pub81of100,1,190,5,414,1,420
test4sub24of100,test4pub81of100,1,190,5,420,0,425
test4sub18of100,test4pub81of100,1,190,5,424,1,430
test4sub17of100,test4pub81of100,1,190,5,431,1,437
test4sub35of100,test4pub81of100,1,190,5,453,0,458
test4sub36of100,test4pub82of100,1,190,5,14,1,20
test4sub84of100,test4pub81of100,1,190,5,478,1,484
test4sub70of100,test4pub82of100,1,190,5,31,0,36
test4sub19of100,test4pub81of100,1,190,5,492,1,498
test4sub79of100,test4pub81of100,1,190,5,498,1,504
test4sub12of100,test4pub81of100,1,190,5,504,0,509
test4sub6of100,test4pub82of100,1,190,5,47,1,53
test4sub88of100,test4pub82of100,1,190,5,55,0,60
test4sub87of100,test4pub82of100,1,190,5,59,1,65
test4sub81of100,test4pub81of100,1,190,5,521,1,527
test4sub48of100,test4pub82of100,1,190,5,71,0,76
test4sub16of100,test4pub82of100,1,190,5,79,1,85
test4sub50of100,test4pub81of100,1,190,5,548,1,554
test4sub38of100,test4pub81of100,1,190,5,551,0,556
test4sub99of100,test4pub82of100,1,190,5,94,1,100
test4sub39of100,test4pub81of100,1,190,5,555,1,561
test4sub95of100,test4pub82of100,1,190,5,103,1,109
test4sub92of100,test4pub81of100,1,190,5,581,0,586
test4sub62of100,test4pub81of100,1,190,5,594,0,599
test4sub100of100,test4pub81of100,1,190,5,597,1,603
test4sub4of100,test4pub82of100,1,190,5,136,1,142
test4sub23of100,test4pub82of100,1,190,5,144,2,151
test4sub9of100,test4pub82of100,1,190,5,144,2,151
test4sub28of100,test4pub81of100,1,190,5,606,2,613
test4sub17of100,test4pub82of100,1,190,5,147,1,153
test4sub13of100,test4pub81of100,1,190,5,609,1,615
test4sub72of100,test4pub82of100,1,190,5,156,1,162
test4sub27of100,test4pub81of100,1,190,5,619,1,625
test4sub2of100,test4pub81of100,1,190,5,621,1,627
test4sub4of100,test4pub81of100,1,190,5,622,0,627
test4sub10of100,test4pub81of100,1,190,5,640,1,646
test4sub98of100,test4pub81of100,1,190,5,642,1,648
test4sub78of100,test4pub82of100,1,190,5,185,1,191
test4sub65of100,test4pub82of100,1,190,5,185,3,193
test4sub31of100,test4pub82of100,1,190,5,186,3,194
test4sub45of100,test4pub81of100,1,190,5,648,2,655
test4sub12of100,test4pub82of100,1,190,5,187,3,195
test4sub14of100,test4pub82of100,1,190,5,188,2,195
test4sub91of100,test4pub81of100,1,190,5,654,1,660
test4sub90of100,test4pub82of100,1,190,5,200,1,206
test4sub57of100,test4pub82of100,1,190,5,201,1,207
test4sub32of100,test4pub81of100,1,190,5,664,2,671
test4sub29of100,test4pub82of100,1,190,5,203,1,209
test4sub65of100,test4pub81of100,1,190,5,665,1,671
test4sub24of100,test4pub82of100,1,190,5,206,0,211
test4sub54of100,test4pub81of100,1,190,5,669,2,676
test4sub20of100,test4pub81of100,1,190,5,670,2,677
test4sub26of100,test4pub82of100,1,190,5,210,1,216
test4sub91of100,test4pub82of100,1,190,5,218,1,224
test4sub19of100,test4pub82of100,1,190,5,225,1,231
test4sub37of100,test4pub82of100,1,190,5,226,1,232
test4sub96of100,test4pub81of100,1,190,5,688,2,695
test4sub97of100,test4pub81of100,1,190,5,689,1,695
test4sub77of100,test4pub81of100,1,190,5,689,2,696
test4sub43of100,test4pub82of100,1,190,5,229,2,236
test4sub85of100,test4pub82of100,1,190,5,230,1,236
test4sub52of100,test4pub81of100,1,190,5,693,1,699
test4sub66of100,test4pub82of100,1,190,5,237,0,242
test4sub72of100,test4pub81of100,1,190,5,702,0,707
test4sub94of100,test4pub82of100,1,190,5,248,0,253
test4sub33of100,test4pub82of100,1,190,5,250,1,256
test4sub83of100,test4pub82of100,1,190,5,252,1,258
test4sub74of100,test4pub81of100,1,190,5,717,1,723
test4sub76of100,test4pub81of100,1,190,5,718,1,724
test4sub95of100,test4pub81of100,1,190,5,721,0,726
test4sub100of100,test4pub82of100,1,190,5,268,1,274
test4sub6of100,test4pub81of100,1,190,5,733,1,739
test4sub28of100,test4pub82of100,1,190,5,274,1,280
test4sub53of100,test4pub82of100,1,190,5,273,2,280
test4sub54of100,test4pub82of100,1,190,5,274,1,280
test4sub5of100,test4pub82of100,1,190,5,279,1,285
test4sub38of100,test4pub82of100,1,190,5,282,1,288
test4sub1of100,test4pub82of100,1,190,5,286,0,291
test4sub3of100,test4pub82of100,1,190,5,287,1,293
test4sub2of100,test4pub82of100,1,190,5,289,0,294
test4sub50of100,test4pub82of100,1,190,5,293,1,299
test4sub86of100,test4pub82of100,1,190,5,294,1,300
test4sub58of100,test4pub82of100,1,190,5,299,0,304
test4sub41of100,test4pub82of100,1,190,5,303,1,309
test4sub80of100,test4pub82of100,1,190,5,308,7,320
test4sub21of100,test4pub82of100,1,190,5,309,7,321
test4sub71of100,test4pub82of100,1,190,5,315,1,321
test4sub84of100,test4pub82of100,1,190,5,315,2,322
test4sub15of100,test4pub82of100,1,190,5,332,1,338
test4sub74of100,test4pub82of100,1,190,5,332,1,338
test4sub34of100,test4pub82of100,1,190,5,337,1,343
test4sub32of100,test4pub82of100,1,190,5,338,1,344
test4sub62of100,test4pub82of100,1,190,5,353,1,359
test4sub46of100,test4pub82of100,1,190,5,358,1,364
test4sub59of100,test4pub82of100,1,190,5,364,1,370
test4sub97of100,test4pub82of100,1,190,5,366,1,372
test4sub20of100,test4pub82of100,1,190,5,371,1,377
test4sub10of100,test4pub82of100,1,190,5,371,1,377
test4sub44of100,test4pub82of100,1,190,5,376,1,382
test4sub81of100,test4pub82of100,1,190,5,376,1,382
test4sub44of100,test4pub83of100,1,190,5,18,0,23
test4sub76of100,test4pub83of100,1,190,5,20,2,27
test4sub19of100,test4pub83of100,1,190,5,21,2,28
test4sub35of100,test4pub82of100,1,190,5,387,1,393
test4sub92of100,test4pub83of100,1,190,5,26,0,31
test4sub7of100,test4pub82of100,1,190,5,397,0,402
test4sub49of100,test4pub83of100,1,190,5,37,1,43
test4sub82of100,test4pub82of100,1,190,5,406,1,412
test4sub60of100,test4pub82of100,1,190,5,407,0,412
test4sub52of100,test4pub82of100,1,190,5,414,1,420
test4sub79of100,test4pub82of100,1,190,5,416,0,421
test4sub75of100,test4pub82of100,1,190,5,421,1,427
test4sub63of100,test4pub82of100,1,190,5,422,0,427
test4sub55of100,test4pub82of100,1,190,5,429,1,435
test4sub89of100,test4pub83of100,1,190,5,64,1,70
test4sub10of100,test4pub83of100,1,190,5,65,1,71
test4sub56of100,test4pub83of100,1,190,5,70,0,75
test4sub75of100,test4pub83of100,1,190,5,72,1,78
test4sub32of100,test4pub83of100,1,190,5,72,1,78
test4sub45of100,test4pub82of100,1,190,5,438,1,444
test4sub30of100,test4pub82of100,1,190,5,441,1,447
test4sub29of100,test4pub83of100,1,190,5,81,1,87
test4sub98of100,test4pub82of100,1,190,5,448,1,454
test4sub21of100,test4pub83of100,1,190,5,84,1,90
test4sub61of100,test4pub82of100,1,190,5,450,1,456
test4sub9of100,test4pub83of100,1,190,5,87,1,93
test4sub68of100,test4pub82of100,1,190,5,454,0,459
test4sub92of100,test4pub82of100,1,190,5,456,1,462
test4sub77of100,test4pub82of100,1,190,5,457,0,462
test4sub11of100,test4pub83of100,1,190,5,97,1,103
test4sub100of100,test4pub83of100,1,190,5,100,1,106
test4sub39of100,test4pub82of100,1,190,5,467,1,473
test4sub63of100,test4pub83of100,1,190,5,110,1,116
test4sub14of100,test4pub83of100,1,190,5,115,1,121
test4sub13of100,test4pub82of100,1,190,5,482,1,488
test4sub34of100,test4pub83of100,1,190,5,122,1,128
test4sub93of100,test4pub82of100,1,190,5,502,0,507
test4sub71of100,test4pub83of100,1,190,5,139,0,144
test4sub67of100,test4pub82of100,1,190,5,506,0,511
test4sub40of100,test4pub82of100,1,190,5,510,1,516
test4sub16of100,test4pub83of100,1,190,5,146,1,152
test4sub73of100,test4pub82of100,1,190,5,512,2,519
test4sub49of100,test4pub82of100,1,190,5,513,1,519
test4sub18of100,test4pub82of100,1,190,5,523,1,529
test4sub51of100,test4pub83of100,1,190,5,161,1,167
test4sub47of100,test4pub83of100,1,190,5,167,1,173
test4sub42of100,test4pub83of100,1,190,5,172,1,178
test4sub85of100,test4pub83of100,1,190,5,172,2,179
test4sub76of100,test4pub82of100,1,190,5,538,1,544
test4sub13of100,test4pub83of100,1,190,5,173,2,180
test4sub24of100,test4pub83of100,1,190,5,175,2,182
test4sub81of100,test4pub83of100,1,190,5,177,3,185
test4sub89of100,test4pub82of100,1,190,5,542,3,550
test4sub82of100,test4pub83of100,1,190,5,178,2,185
test4sub46of100,test4pub83of100,1,190,5,179,2,186
test4sub26of100,test4pub83of100,1,190,5,179,1,185
test4sub43of100,test4pub83of100,1,190,5,183,2,190
test4sub5of100,test4pub83of100,1,190,5,184,1,190
test4sub47of100,test4pub82of100,1,190,5,571,1,577
test4sub83of100,test4pub83of100,1,190,5,217,0,222
test4sub7of100,test4pub83of100,1,190,5,219,2,226
test4sub48of100,test4pub83of100,1,190,5,221,2,228
test4sub64of100,test4pub82of100,1,190,5,587,2,594
test4sub80of100,test4pub83of100,1,190,5,221,4,230
test4sub38of100,test4pub83of100,1,190,5,221,3,229
test4sub42of100,test4pub82of100,1,190,5,588,3,596
test4sub25of100,test4pub82of100,1,190,5,588,2,595
test4sub56of100,test4pub82of100,1,190,5,594,1,600
test4sub69of100,test4pub82of100,1,190,5,594,2,601
test4sub27of100,test4pub82of100,1,190,5,595,1,601
test4sub36of100,test4pub83of100,1,190,5,231,2,238
test4sub59of100,test4pub83of100,1,190,5,231,2,238
test4sub51of100,test4pub82of100,1,190,5,600,0,605
test4sub88of100,test4pub83of100,1,190,5,239,1,245
test4sub22of100,test4pub82of100,1,190,5,605,0,610
test4sub3of100,test4pub83of100,1,190,5,246,0,251
test4sub11of100,test4pub82of100,1,190,5,615,1,621
test4sub91of100,test4pub83of100,1,190,5,250,1,256
test4sub66of100,test4pub83of100,1,190,5,272,1,278
test4sub23of100,test4pub83of100,1,190,5,278,1,284
test4sub37of100,test4pub83of100,1,190,5,279,1,285
test4sub25of100,test4pub83of100,1,190,5,282,1,288
test4sub67of100,test4pub83of100,1,190,5,282,0,287
test4sub8of100,test4pub82of100,1,190,5,649,2,656
test4sub27of100,test4pub83of100,1,190,5,285,2,292
test4sub57of100,test4pub83of100,1,190,5,285,1,291
test4sub73of100,test4pub83of100,1,190,5,286,2,293
test4sub96of100,test4pub82of100,1,190,5,653,1,659
test4sub62of100,test4pub83of100,1,190,5,288,1,294
test4sub35of100,test4pub83of100,1,190,5,289,1,295
test4sub98of100,test4pub83of100,1,190,5,295,0,300
test4sub58of100,test4pub83of100,1,190,5,295,1,301
test4sub1of100,test4pub83of100,1,190,5,296,1,302
test4sub86of100,test4pub83of100,1,190,5,306,0,311
test4sub31of100,test4pub83of100,1,190,5,313,1,319
test4sub84of100,test4pub83of100,1,190,5,313,1,319
test4sub90of100,test4pub83of100,1,190,5,316,0,321
test4sub15of100,test4pub83of100,1,190,5,323,1,329
test4sub97of100,test4pub83of100,1,190,5,324,0,329
test4sub60of100,test4pub83of100,1,190,5,326,1,332
test4sub28of100,test4pub83of100,1,190,5,327,1,333
test4sub30of100,test4pub83of100,1,190,5,329,1,335
test4sub65of100,test4pub83of100,1,190,5,330,1,336
test4sub99of100,test4pub83of100,1,190,5,333,0,338
test4sub72of100,test4pub83of100,1,190,5,345,1,351
test4sub68of100,test4pub83of100,1,190,5,346,1,352
test4sub12of100,test4pub83of100,1,190,5,351,1,357
test4sub64of100,test4pub83of100,1,190,5,360,0,365
test4sub96of100,test4pub83of100,1,190,5,364,1,370
test4sub22of100,test4pub83of100,1,190,5,405,1,411
test4sub50of100,test4pub83of100,1,190,5,416,1,422
test4sub8of100,test4pub83of100,1,190,5,455,1,461
test4sub4of100,test4pub83of100,1,190,5,455,1,461
test4sub2of100,test4pub83of100,1,190,5,457,1,463
test4sub53of100,test4pub83of100,1,190,5,477,0,482
test4sub52of100,test4pub83of100,1,190,5,482,1,488
test4sub69of100,test4pub83of100,1,190,5,482,1,488
test4sub17of100,test4pub83of100,1,190,5,489,1,495
test4sub6of100,test4pub83of100,1,190,5,489,1,495
test4sub20of100,test4pub83of100,1,190,5,492,1,498
test4sub77of100,test4pub83of100,1,190,5,520,0,525
test4sub61of100,test4pub83of100,1,190,5,532,1,538
test4sub79of100,test4pub83of100,1,190,5,555,1,561
test4sub87of100,test4pub83of100,1,190,5,561,1,567
test4sub54of100,test4pub83of100,1,190,5,564,1,570
test4sub33of100,test4pub83of100,1,190,5,565,1,571
test4sub40of100,test4pub83of100,1,190,5,568,1,574
test4sub45of100,test4pub83of100,1,190,5,571,1,577
test4sub95of100,test4pub83of100,1,190,5,578,1,584
test4sub55of100,test4pub83of100,1,190,5,584,1,590
test4sub70of100,test4pub83of100,1,190,5,588,1,594
test4sub74of100,test4pub83of100,1,190,5,591,0,596
test4sub41of100,test4pub83of100,1,190,5,594,0,599
test4sub94of100,test4pub83of100,1,190,5,599,1,605
test4sub18of100,test4pub83of100,1,190,5,604,1,610
test4sub39of100,test4pub83of100,1,190,5,635,1,641
test4sub78of100,test4pub83of100,1,190,5,648,0,653
test4sub93of100,test4pub83of100,1,190,5,650,1,656
test4sub77of100,test4pub84of100,1,190,5,13,0,18
test4sub31of100,test4pub84of100,1,190,5,25,1,31
test4sub94of100,test4pub84of100,1,190,5,52,1,58
test4sub56of100,test4pub84of100,1,190,5,55,0,60
test4sub71of100,test4pub84of100,1,190,5,64,1,70
test4sub86of100,test4pub84of100,1,190,5,84,0,89
test4sub68of100,test4pub84of100,1,190,5,90,1,96
test4sub44of100,test4pub84of100,1,190,5,90,1,96
test4sub66of100,test4pub84of100,1,190,5,99,0,104
test4sub58of100,test4pub84of100,1,190,5,105,0,110
test4sub85of100,test4pub84of100,1,190,5,110,1,116
test4sub53of100,test4pub84of100,1,190,5,111,1,117
test4sub95of100,test4pub84of100,1,190,5,113,1,119
test4sub99of100,test4pub84of100,1,190,5,120,1,126
test4sub84of100,test4pub84of100,1,190,5,121,2,128
test4sub9of100,test4pub84of100,1,190,5,122,2,129
test4sub91of100,test4pub84of100,1,190,5,123,3,131
test4sub1of100,test4pub84of100,1,190,5,124,1,130
test4sub39of100,test4pub84of100,1,190,5,138,1,144
test4sub89of100,test4pub84of100,1,190,5,146,1,152
test4sub57of100,test4pub84of100,1,190,5,154,1,160
test4sub75of100,test4pub84of100,1,190,5,169,1,175
test4sub3of100,test4pub84of100,1,190,5,170,1,176
test4sub11of100,test4pub84of100,1,190,5,174,1,180
test4sub96of100,test4pub84of100,1,190,5,185,0,190
test4sub69of100,test4pub84of100,1,190,5,186,1,192
test4sub82of100,test4pub84of100,1,190,5,187,1,193
test4sub38of100,test4pub84of100,1,190,5,188,1,194
test4sub78of100,test4pub84of100,1,190,5,197,1,203
test4sub13of100,test4pub84of100,1,190,5,199,0,204
test4sub98of100,test4pub84of100,1,190,5,209,1,215
test4sub22of100,test4pub84of100,1,190,5,220,1,226
test4sub2of100,test4pub84of100,1,190,5,222,1,228
test4sub37of100,test4pub84of100,1,190,5,244,1,250
test4sub26of100,test4pub84of100,1,190,5,252,1,258
test4sub18of100,test4pub84of100,1,190,5,254,1,260
test4sub74of100,test4pub84of100,1,190,5,258,1,264
test4sub24of100,test4pub84of100,1,190,5,261,1,267
test4sub33of100,test4pub84of100,1,190,5,291,0,296
test4sub63of100,test4pub84of100,1,190,5,296,1,302
test4sub21of100,test4pub84of100,1,190,5,319,1,325
test4sub50of100,test4pub84of100,1,190,5,321,0,326
test4sub17of100,test4pub84of100,1,190,5,321,1,327
test4sub7of100,test4pub84of100,1,190,5,328,0,333
test4sub61of100,test4pub84of100,1,190,5,328,1,334
test4sub14of100,test4pub84of100,1,190,5,333,1,339
test4sub70of100,test4pub85of100,1,190,5,22,1,28
test4sub88of100,test4pub85of100,1,190,5,23,1,29
test4sub73of100,test4pub85of100,1,190,5,25,0,30
test4sub35of100,test4pub85of100,1,190,5,26,1,32
test4sub25of100,test4pub85of100,1,190,5,36,0,41
test4sub77of100,test4pub85of100,1,190,5,58,1,64
test4sub51of100,test4pub85of100,1,190,5,60,1,66
test4sub32of100,test4pub84of100,1,190,5,395,0,400
test4sub5of100,test4pub84of100,1,190,5,402,1,408
test4sub90of100,test4pub85of100,1,190,5,98,0,103
test4sub87of100,test4pub85of100,1,190,5,110,1,116
test4sub41of100,test4pub85of100,1,190,5,125,1,131
test4sub96of100,test4pub85of100,1,190,5,140,1,146
test4sub4of100,test4pub84of100,1,190,5,459,1,465
test4sub62of100,test4pub84of100,1,190,5,464,1,470
test4sub30of100,test4pub84of100,1,190,5,468,1,474
test4sub29of100,test4pub84of100,1,190,5,469,1,475
test4sub8of100,test4pub85of100,1,190,5,157,1,163
test4sub82of100,test4pub85of100,1,190,5,162,1,168
test4sub72of100,test4pub84of100,1,190,5,481,1,487
test4sub92of100,test4pub84of100,1,190,5,482,2,489
test4sub88of100,test4pub84of100,1,190,5,482,1,488
test4sub45of100,test4pub85of100,1,190,5,165,2,172
test4sub70of100,test4pub84of100,1,190,5,486,1,492
test4sub6of100,test4pub84of100,1,190,5,486,1,492
test4sub27of100,test4pub85of100,1,190,5,169,1,175
test4sub59of100,test4pub84of100,1,190,5,488,0,493
test4sub95of100,test4pub85of100,1,190,5,172,3,180
test4sub79of100,test4pub85of100,1,190,5,172,3,180
test4sub86of100,test4pub85of100,1,190,5,173,6,184
test4sub64of100,test4pub84of100,1,190,5,492,5,502
test4sub87of100,test4pub84of100,1,190,5,492,6,503
test4sub50of100,test4pub85of100,1,190,5,175,5,185
test4sub10of100,test4pub84of100,1,190,5,495,8,508
test4sub1of100,test4pub85of100,1,190,5,177,9,191
test4sub7of100,test4pub85of100,1,190,5,176,11,192
test4sub62of100,test4pub85of100,1,190,5,176,12,193
test4sub93of100,test4pub84of100,1,190,5,497,11,513
test4sub23of100,test4pub85of100,1,190,5,186,3,194
test4sub90of100,test4pub84of100,1,190,5,505,4,514
test4sub15of100,test4pub85of100,1,190,5,188,2,195
test4sub53of100,test4pub85of100,1,190,5,189,3,197
test4sub2of100,test4pub85of100,1,190,5,190,1,196
test4sub42of100,test4pub84of100,1,190,5,513,1,519
test4sub25of100,test4pub84of100,1,190,5,527,1,533
test4sub72of100,test4pub85of100,1,190,5,217,1,223
test4sub97of100,test4pub84of100,1,190,5,537,1,543
test4sub52of100,test4pub84of100,1,190,5,580,0,585
test4sub20of100,test4pub84of100,1,190,5,584,1,590
test4sub61of100,test4pub85of100,1,190,5,267,1,273
test4sub47of100,test4pub84of100,1,190,5,588,1,594
test4sub16of100,test4pub84of100,1,190,5,591,1,597
test4sub54of100,test4pub85of100,1,190,5,276,0,281
test4sub98of100,test4pub85of100,1,190,5,278,2,285
test4sub8of100,test4pub84of100,1,190,5,596,3,604
test4sub67of100,test4pub84of100,1,190,5,597,5,607
test4sub45of100,test4pub84of100,1,190,5,597,5,607
test4sub55of100,test4pub84of100,1,190,5,598,5,608
test4sub43of100,test4pub85of100,1,190,5,281,5,291
test4sub74of100,test4pub85of100,1,190,5,282,5,292
test4sub80of100,test4pub84of100,1,190,5,600,6,611
test4sub76of100,test4pub84of100,1,190,5,601,8,614
test4sub46of100,test4pub84of100,1,190,5,601,10,616
test4sub30of100,test4pub85of100,1,190,5,284,8,297
test4sub4of100,test4pub85of100,1,190,5,286,9,300
test4sub89of100,test4pub85of100,1,190,5,288,8,301
test4sub48of100,test4pub84of100,1,190,5,607,7,619
test4sub29of100,test4pub85of100,1,190,5,289,7,301
test4sub19of100,test4pub84of100,1,190,5,608,8,621
test4sub73of100,test4pub84of100,1,190,5,608,8,621
test4sub27of100,test4pub84of100,1,190,5,609,8,622
test4sub79of100,test4pub84of100,1,190,5,610,9,624
test4sub83of100,test4pub84of100,1,190,5,611,7,623
test4sub49of100,test4pub84of100,1,190,5,612,7,624
test4sub68of100,test4pub85of100,1,190,5,294,8,307
test4sub18of100,test4pub85of100,1,190,5,297,7,309
test4sub34of100,test4pub84of100,1,190,5,619,4,628
test4sub91of100,test4pub85of100,1,190,5,299,7,311
test4sub6of100,test4pub85of100,1,190,5,300,8,313
test4sub28of100,test4pub84of100,1,190,5,620,7,632
test4sub92of100,test4pub85of100,1,190,5,303,6,314
test4sub99of100,test4pub85of100,1,190,5,304,7,316
test4sub66of100,test4pub85of100,1,190,5,304,7,316
test4sub40of100,test4pub84of100,1,190,5,623,7,635
test4sub36of100,test4pub84of100,1,190,5,625,6,636
test4sub12of100,test4pub84of100,1,190,5,626,5,636
test4sub78of100,test4pub85of100,1,190,5,310,5,320
test4sub100of100,test4pub84of100,1,190,5,629,4,638
test4sub60of100,test4pub84of100,1,190,5,643,1,649
test4sub35of100,test4pub84of100,1,190,5,644,1,650
test4sub84of100,test4pub85of100,1,190,5,327,1,333
test4sub81of100,test4pub84of100,1,190,5,661,0,666
test4sub59of100,test4pub85of100,1,190,5,345,0,350
test4sub23of100,test4pub84of100,1,190,5,665,1,671
test4sub24of100,test4pub85of100,1,190,5,347,2,354
test4sub15of100,test4pub84of100,1,190,5,667,1,673
test4sub65of100,test4pub84of100,1,190,5,668,1,674
test4sub5of100,test4pub85of100,1,190,5,352,1,358
test4sub47of100,test4pub85of100,1,190,5,353,3,361
test4sub14of100,test4pub85of100,1,190,5,354,3,362
test4sub54of100,test4pub84of100,1,190,5,672,3,680
test4sub67of100,test4pub85of100,1,190,5,354,3,362
test4sub43of100,test4pub84of100,1,190,5,673,3,681
test4sub80of100,test4pub85of100,1,190,5,356,2,363
test4sub46of100,test4pub85of100,1,190,5,357,2,364
test4sub94of100,test4pub85of100,1,190,5,363,1,369
test4sub41of100,test4pub84of100,1,190,5,682,0,687
test4sub51of100,test4pub84of100,1,190,5,688,1,694
test4sub17of100,test4pub85of100,1,190,5,376,1,382
test4sub16of100,test4pub85of100,1,190,5,388,0,393
test4sub44of100,test4pub85of100,1,190,5,388,1,394
test4sub38of100,test4pub85of100,1,190,5,392,1,398
test4sub52of100,test4pub85of100,1,190,5,399,0,404
test4sub19of100,test4pub85of100,1,190,5,404,0,409
test4sub34of100,test4pub85of100,1,190,5,418,0,423
test4sub28of100,test4pub85of100,1,190,5,422,1,428
test4sub40of100,test4pub85of100,1,190,5,423,0,428
test4sub60of100,test4pub85of100,1,190,5,434,1,440
test4sub12of100,test4pub85of100,1,190,5,446,0,451
test4sub48of100,test4pub85of100,1,190,5,451,1,457
test4sub13of100,test4pub85of100,1,190,5,456,1,462
test4sub65of100,test4pub85of100,1,190,5,458,1,464
test4sub64of100,test4pub85of100,1,190,5,459,0,464
test4sub97of100,test4pub85of100,1,190,5,466,1,472
test4sub76of100,test4pub85of100,1,190,5,473,1,479
test4sub21of100,test4pub85of100,1,190,5,477,1,483
test4sub36of100,test4pub85of100,1,190,5,478,1,484
test4sub20of100,test4pub85of100,1,190,5,479,1,485
test4sub33of100,test4pub85of100,1,190,5,484,1,490
test4sub69of100,test4pub85of100,1,190,5,485,2,492
test4sub9of100,test4pub85of100,1,190,5,486,1,492
test4sub22of100,test4pub85of100,1,190,5,489,1,495
test4sub10of100,test4pub85of100,1,190,5,496,1,502
test4sub37of100,test4pub85of100,1,190,5,497,1,503
test4sub42of100,test4pub85of100,1,190,5,498,2,505
test4sub3of100,test4pub85of100,1,190,5,499,1,505
test4sub57of100,test4pub85of100,1,190,5,507,1,513
test4sub39of100,test4pub85of100,1,190,5,509,1,515
test4sub71of100,test4pub85of100,1,190,5,512,0,517
test4sub56of100,test4pub85of100,1,190,5,514,1,520
test4sub55of100,test4pub85of100,1,190,5,521,0,526
test4sub63of100,test4pub85of100,1,190,5,525,1,531
test4sub93of100,test4pub85of100,1,190,5,525,0,530
test4sub100of100,test4pub85of100,1,190,5,527,0,532
test4sub32of100,test4pub85of100,1,190,5,530,1,536
test4sub49of100,test4pub85of100,1,190,5,532,1,538
test4sub58of100,test4pub85of100,1,190,5,542,1,548
test4sub31of100,test4pub85of100,1,190,5,556,1,562
test4sub81of100,test4pub85of100,1,190,5,556,1,562
test4sub75of100,test4pub85of100,1,190,5,558,0,563
test4sub26of100,test4pub85of100,1,190,5,560,1,566
test4sub85of100,test4pub85of100,1,190,5,565,1,571
test4sub83of100,test4pub85of100,1,190,5,565,1,571
test4sub63of100,test4pub86of100,1,190,5,24,1,30
test4sub87of100,test4pub86of100,1,190,5,27,1,33
test4sub11of100,test4pub85of100,1,190,5,583,1,589
test4sub90of100,test4pub86of100,1,190,5,31,0,36
test4sub95of100,test4pub86of100,1,190,5,31,2,38
test4sub77of100,test4pub86of100,1,190,5,39,1,45
test4sub34of100,test4pub86of100,1,190,5,46,0,51
test4sub20of100,test4pub86of100,1,190,5,51,1,57
test4sub4of100,test4pub86of100,1,190,5,56,1,62
test4sub46of100,test4pub86of100,1,190,5,61,1,67
test4sub57of100,test4pub86of100,1,190,5,68,0,73
test4sub66of100,test4pub86of100,1,190,5,70,0,75
test4sub45of100,test4pub86of100,1,190,5,71,1,77
test4sub2of100,test4pub86of100,1,190,5,74,1,80
test4sub44of100,test4pub86of100,1,190,5,81,1,87
test4sub33of100,test4pub86of100,1,190,5,82,1,88
test4sub19of100,test4pub86of100,1,190,5,81,2,88
test4sub27of100,test4pub86of100,1,190,5,83,1,89
test4sub71of100,test4pub86of100,1,190,5,89,1,95
test4sub76of100,test4pub86of100,1,190,5,91,1,97
test4sub42of100,test4pub86of100,1,190,5,90,2,97
test4sub80of100,test4pub86of100,1,190,5,98,1,104
test4sub60of100,test4pub86of100,1,190,5,115,1,121
test4sub58of100,test4pub86of100,1,190,5,124,1,130
test4sub62of100,test4pub86of100,1,190,5,128,1,134
test4sub78of100,test4pub86of100,1,190,5,131,0,136
test4sub98of100,test4pub86of100,1,190,5,136,1,142
test4sub88of100,test4pub86of100,1,190,5,141,1,147
test4sub51of100,test4pub86of100,1,190,5,142,2,149
test4sub53of100,test4pub86of100,1,190,5,143,1,149
test4sub15of100,test4pub86of100,1,190,5,143,2,150
test4sub83of100,test4pub86of100,1,190,5,145,1,151
test4sub3of100,test4pub86of100,1,190,5,146,1,152
test4sub7of100,test4pub86of100,1,190,5,147,1,153
test4sub59of100,test4pub86of100,1,190,5,155,1,161
test4sub26of100,test4pub86of100,1,190,5,164,1,170
test4sub69of100,test4pub86of100,1,190,5,169,0,174
test4sub32of100,test4pub86of100,1,190,5,169,1,175
test4sub84of100,test4pub86of100,1,190,5,178,1,184
test4sub39of100,test4pub86of100,1,190,5,187,0,192
test4sub93of100,test4pub86of100,1,190,5,189,1,195
test4sub5of100,test4pub86of100,1,190,5,190,0,195
test4sub24of100,test4pub86of100,1,190,5,194,1,200
test4sub28of100,test4pub86of100,1,190,5,212,1,218
test4sub35of100,test4pub86of100,1,190,5,217,1,223
test4sub47of100,test4pub86of100,1,190,5,220,1,226
test4sub1of100,test4pub86of100,1,190,5,225,0,230
test4sub48of100,test4pub86of100,1,190,5,231,0,236
test4sub68of100,test4pub86of100,1,190,5,234,0,239
test4sub99of100,test4pub86of100,1,190,5,236,0,241
test4sub49of100,test4pub86of100,1,190,5,243,1,249
test4sub11of100,test4pub86of100,1,190,5,243,2,250
test4sub55of100,test4pub86of100,1,190,5,244,1,250
test4sub97of100,test4pub86of100,1,190,5,249,1,255
test4sub75of100,test4pub86of100,1,190,5,250,1,256
test4sub18of100,test4pub86of100,1,190,5,251,2,258
test4sub100of100,test4pub86of100,1,190,5,251,1,257
test4sub43of100,test4pub86of100,1,190,5,253,1,259
test4sub54of100,test4pub86of100,1,190,5,259,1,265
test4sub81of100,test4pub86of100,1,190,5,269,2,276
test4sub14of100,test4pub86of100,1,190,5,270,2,277
test4sub10of100,test4pub86of100,1,190,5,271,0,276
test4sub29of100,test4pub86of100,1,190,5,276,1,282
test4sub91of100,test4pub86of100,1,190,5,279,0,284
test4sub16of100,test4pub86of100,1,190,5,282,1,288
test4sub61of100,test4pub87of100,1,190,6,16,0,22
test4sub8of100,test4pub87of100,1,190,6,21,1,28
test4sub70of100,test4pub87of100,1,190,6,27,1,34
test4sub6of100,test4pub86of100,1,190,5,302,1,308
test4sub74of100,test4pub87of100,1,190,6,37,1,44
test4sub50of100,test4pub86of100,1,190,5,309,1,315
test4sub94of100,test4pub87of100,1,190,6,47,1,54
test4sub38of100,test4pub86of100,1,190,5,319,0,324
test4sub37of100,test4pub86of100,1,190,5,322,0,327
test4sub2of100,test4pub87of100,1,190,6,64,1,71
test4sub10of100,test4pub87of100,1,190,6,65,1,72
test4sub3of100,test4pub87of100,1,190,6,65,2,73
test4sub13of100,test4pub86of100,1,190,5,338,5,348
test4sub25of100,test4pub86of100,1,190,5,337,5,347
test4sub89of100,test4pub87of100,1,190,6,69,3,78
test4sub21of100,test4pub87of100,1,190,6,68,4,78
test4sub83of100,test4pub87of100,1,190,6,69,3,78
test4sub64of100,test4pub86of100,1,190,5,341,4,350
test4sub72of100,test4pub86of100,1,190,5,341,4,350
test4sub17of100,test4pub86of100,1,190,5,342,5,352
test4sub40of100,test4pub87of100,1,190,6,74,2,82
test4sub56of100,test4pub87of100,1,190,6,74,2,82
test4sub86of100,test4pub86of100,1,190,5,346,1,352
test4sub19of100,test4pub87of100,1,190,6,89,1,96
test4sub65of100,test4pub86of100,1,190,5,367,1,373
test4sub85of100,test4pub86of100,1,190,5,368,1,374
test4sub13of100,test4pub87of100,1,190,6,98,1,105
test4sub21of100,test4pub86of100,1,190,5,370,0,375
test4sub56of100,test4pub86of100,1,190,5,381,1,387
test4sub57of100,test4pub87of100,1,190,6,111,0,117
test4sub25of100,test4pub87of100,1,190,6,125,1,132
test4sub75of100,test4pub87of100,1,190,6,139,1,146
test4sub94of100,test4pub86of100,1,190,5,411,1,417
test4sub12of100,test4pub86of100,1,190,5,412,2,419
test4sub22of100,test4pub86of100,1,190,5,413,2,420
test4sub79of100,test4pub86of100,1,190,5,414,2,421
test4sub31of100,test4pub86of100,1,190,5,414,2,421
test4sub40of100,test4pub86of100,1,190,5,414,2,421
test4sub72of100,test4pub87of100,1,190,6,147,2,155
test4sub82of100,test4pub86of100,1,190,5,419,2,426
test4sub62of100,test4pub87of100,1,190,6,148,1,155
test4sub74of100,test4pub86of100,1,190,5,420,1,426
test4sub38of100,test4pub87of100,1,190,6,154,0,160
test4sub23of100,test4pub86of100,1,190,5,428,1,434
test4sub41of100,test4pub86of100,1,190,5,429,0,434
test4sub4of100,test4pub87of100,1,190,6,162,1,169
test4sub63of100,test4pub87of100,1,190,6,174,1,181
test4sub8of100,test4pub86of100,1,190,5,450,0,455
test4sub9of100,test4pub86of100,1,190,5,452,0,457
test4sub73of100,test4pub86of100,1,190,5,455,0,460
test4sub70of100,test4pub86of100,1,190,5,457,1,463
test4sub67of100,test4pub86of100,1,190,5,470,1,476
test4sub96of100,test4pub86of100,1,190,5,474,1,480
test4sub66of100,test4pub87of100,1,190,6,204,2,212
test4sub30of100,test4pub86of100,1,190,5,476,1,482
test4sub69of100,test4pub87of100,1,190,6,205,1,212
test4sub52of100,test4pub86of100,1,190,5,481,0,486
test4sub45of100,test4pub87of100,1,190,6,210,6,222
test4sub33of100,test4pub87of100,1,190,6,211,2,219
test4sub36of100,test4pub87of100,1,190,6,217,3,226
test4sub61of100,test4pub86of100,1,190,5,488,2,495
test4sub20of100,test4pub87of100,1,190,6,219,1,226
test4sub89of100,test4pub86of100,1,190,5,490,2,497
test4sub46of100,test4pub87of100,1,190,6,226,1,233
test4sub1of100,test4pub87of100,1,190,6,226,2,234
test4sub31of100,test4pub87of100,1,190,6,227,0,233
test4sub55of100,test4pub87of100,1,190,6,231,0,237
test4sub92of100,test4pub86of100,1,190,5,503,0,508
test4sub47of100,test4pub87of100,1,190,6,237,0,243
test4sub37of100,test4pub87of100,1,190,6,244,0,250
test4sub44of100,test4pub87of100,1,190,6,246,0,252
test4sub6of100,test4pub87of100,1,190,6,250,1,257
test4sub51of100,test4pub87of100,1,190,6,257,1,264
test4sub16of100,test4pub87of100,1,190,6,258,1,265
test4sub80of100,test4pub87of100,1,190,6,259,1,266
test4sub9of100,test4pub87of100,1,190,6,261,0,267
test4sub60of100,test4pub87of100,1,190,6,265,0,271
test4sub79of100,test4pub87of100,1,190,6,268,1,275
test4sub29of100,test4pub87of100,1,190,6,278,1,285
test4sub73of100,test4pub87of100,1,190,6,279,1,286
test4sub30of100,test4pub87of100,1,190,6,317,1,324
test4sub36of100,test4pub86of100,1,190,5,591,0,596
test4sub27of100,test4pub87of100,1,190,6,331,0,337
test4sub26of100,test4pub87of100,1,190,6,340,0,346
test4sub86of100,test4pub87of100,1,190,6,342,1,349
test4sub28of100,test4pub87of100,1,190,6,346,1,353
test4sub90of100,test4pub87of100,1,190,6,346,1,353
test4sub48of100,test4pub87of100,1,190,6,349,1,356
test4sub53of100,test4pub87of100,1,190,6,351,2,359
test4sub91of100,test4pub87of100,1,190,6,351,3,360
test4sub41of100,test4pub87of100,1,190,6,352,2,360
test4sub100of100,test4pub87of100,1,190,6,353,3,362
test4sub32of100,test4pub87of100,1,190,6,352,3,361
test4sub97of100,test4pub87of100,1,190,6,354,3,363
test4sub15of100,test4pub87of100,1,190,6,352,2,360
test4sub85of100,test4pub87of100,1,190,6,362,0,368
test4sub14of100,test4pub87of100,1,190,6,381,1,388
test4sub39of100,test4pub87of100,1,190,6,382,0,388
test4sub34of100,test4pub87of100,1,190,6,383,2,391
test4sub18of100,test4pub87of100,1,190,6,384,2,392
test4sub71of100,test4pub87of100,1,190,6,384,2,392
test4sub43of100,test4pub87of100,1,190,6,385,1,392
test4sub76of100,test4pub88of100,1,191,28,57,1,86
test4sub50of100,test4pub88of100,1,191,28,58,4,90
test4sub34of100,test4pub88of100,1,191,28,59,4,91
test4sub23of100,test4pub88of100,1,191,28,59,4,91
test4sub32of100,test4pub88of100,1,191,28,60,3,91
test4sub92of100,test4pub87of100,1,190,6,418,2,426
test4sub39of100,test4pub88of100,1,191,28,61,2,91
test4sub74of100,test4pub88of100,1,191,28,64,1,93
test4sub78of100,test4pub87of100,1,190,6,422,2,430
test4sub33of100,test4pub88of100,1,191,28,66,1,95
test4sub88of100,test4pub87of100,1,190,6,424,1,431
test4sub18of100,test4pub88of100,1,191,28,73,1,102
test4sub11of100,test4pub87of100,1,190,6,432,1,439
test4sub49of100,test4pub88of100,1,191,28,78,0,106
test4sub98of100,test4pub87of100,1,190,6,438,0,444
test4sub81of100,test4pub87of100,1,190,6,439,0,445
test4sub65of100,test4pub87of100,1,190,6,441,0,447
test4sub58of100,test4pub88of100,1,191,28,95,1,124
test4sub25of100,test4pub88of100,1,191,28,96,0,124
test4sub84of100,test4pub87of100,1,190,6,455,1,462
test4sub46of100,test4pub88of100,1,191,28,103,0,131
test4sub57of100,test4pub88of100,1,191,28,103,1,132
test4sub53of100,test4pub88of100,1,191,28,108,0,136
test4sub90of100,test4pub88of100,1,191,28,109,1,138
test4sub7of100,test4pub87of100,1,190,6,468,1,475
test4sub43of100,test4pub88of100,1,191,28,113,1,142
test4sub49of100,test4pub87of100,1,190,6,473,1,480
test4sub17of100,test4pub87of100,1,190,6,474,1,481
test4sub100of100,test4pub88of100,1,191,28,118,0,146
test4sub23of100,test4pub87of100,1,190,6,478,1,485
test4sub63of100,test4pub88of100,1,191,28,122,0,150
test4sub50of100,test4pub87of100,1,190,6,480,1,487
test4sub21of100,test4pub88of100,1,191,28,127,0,155
test4sub40of100,test4pub88of100,1,191,28,130,1,159
test4sub76of100,test4pub87of100,1,190,6,490,1,497
test4sub11of100,test4pub88of100,1,191,28,137,0,165
test4sub28of100,test4pub88of100,1,191,28,139,1,168
test4sub96of100,test4pub87of100,1,190,6,495,1,502
test4sub78of100,test4pub88of100,1,191,28,143,1,172
test4sub8of100,test4pub88of100,1,191,28,144,2,174
test4sub64of100,test4pub87of100,1,190,6,502,2,510
test4sub2of100,test4pub88of100,1,191,28,146,2,176
test4sub91of100,test4pub88of100,1,191,28,156,0,184
test4sub22of100,test4pub87of100,1,190,6,515,0,521
test4sub35of100,test4pub87of100,1,190,6,520,0,526
test4sub13of100,test4pub88of100,1,191,28,167,1,196
test4sub58of100,test4pub87of100,1,190,6,525,2,533
test4sub42of100,test4pub88of100,1,191,28,169,1,198
test4sub87of100,test4pub87of100,1,190,6,528,0,534
test4sub99of100,test4pub87of100,1,190,6,532,3,541
test4sub82of100,test4pub87of100,1,190,6,533,2,541
test4sub54of100,test4pub87of100,1,190,6,533,3,542
test4sub67of100,test4pub87of100,1,190,6,534,2,542
test4sub60of100,test4pub88of100,1,191,28,177,4,209
test4sub51of100,test4pub88of100,1,191,28,178,3,209
test4sub14of100,test4pub88of100,1,191,28,180,2,210
test4sub52of100,test4pub87of100,1,190,6,542,1,549
test4sub77of100,test4pub87of100,1,190,6,543,1,550
test4sub95of100,test4pub87of100,1,190,6,545,0,551
test4sub3of100,test4pub88of100,1,191,28,194,1,223
test4sub12of100,test4pub87of100,1,190,6,555,1,562
test4sub17of100,test4pub88of100,1,191,28,199,1,228
test4sub59of100,test4pub87of100,1,190,6,558,1,565
test4sub24of100,test4pub87of100,1,190,6,559,1,566
test4sub5of100,test4pub87of100,1,190,6,562,1,569
test4sub35of100,test4pub88of100,1,191,28,207,0,235
test4sub42of100,test4pub87of100,1,190,6,567,1,574
test4sub45of100,test4pub88of100,1,191,28,211,0,239
test4sub93of100,test4pub87of100,1,190,6,571,0,577
test4sub68of100,test4pub87of100,1,190,6,572,8,586
test4sub30of100,test4pub88of100,1,191,28,221,1,250
test4sub81of100,test4pub88of100,1,191,28,222,1,251
test4sub52of100,test4pub88of100,1,191,28,230,1,259
test4sub12of100,test4pub88of100,1,191,28,233,1,262
test4sub44of100,test4pub88of100,1,191,28,233,1,262
test4sub29of100,test4pub88of100,1,191,28,237,1,266
test4sub97of100,test4pub88of100,1,191,28,238,1,267
test4sub7of100,test4pub88of100,1,191,28,239,1,268
test4sub87of100,test4pub88of100,1,191,28,241,0,269
test4sub85of100,test4pub88of100,1,191,28,247,1,276
test4sub69of100,test4pub88of100,1,191,28,249,0,277
test4sub72of100,test4pub88of100,1,191,28,254,1,283
test4sub86of100,test4pub88of100,1,191,28,256,1,285
test4sub70of100,test4pub88of100,1,191,28,258,0,286
test4sub89of100,test4pub88of100,1,191,28,261,1,290
test4sub65of100,test4pub88of100,1,191,28,265,1,294
test4sub98of100,test4pub88of100,1,191,28,276,1,305
test4sub82of100,test4pub88of100,1,191,28,278,1,307
test4sub26of100,test4pub88of100,1,191,28,285,1,314
test4sub62of100,test4pub88of100,1,191,28,302,0,330
test4sub59of100,test4pub88of100,1,191,28,302,1,331
test4sub55of100,test4pub88of100,1,191,28,304,1,333
test4sub71of100,test4pub88of100,1,191,28,305,1,334
test4sub77of100,test4pub88of100,1,191,28,310,1,339
test4sub4of100,test4pub88of100,1,191,28,313,1,342
test4sub48of100,test4pub88of100,1,191,28,318,1,347
test4sub24of100,test4pub88of100,1,191,28,319,0,347
test4sub80of100,test4pub88of100,1,191,28,321,0,349
test4sub31of100,test4pub88of100,1,191,28,328,1,357
test4sub47of100,test4pub88of100,1,191,28,328,1,357
test4sub1of100,test4pub88of100,1,191,28,330,0,358
test4sub9of100,test4pub88of100,1,191,28,335,1,364
test4sub79of100,test4pub88of100,1,191,28,335,1,364
test4sub56of100,test4pub88of100,1,191,28,336,1,365
test4sub16of100,test4pub88of100,1,191,28,338,0,366
test4sub94of100,test4pub88of100,1,191,28,340,0,368
test4sub93of100,test4pub88of100,1,191,28,342,1,371
test4sub88of100,test4pub88of100,1,191,28,348,0,376
test4sub20of100,test4pub88of100,1,191,28,364,0,392
test4sub64of100,test4pub88of100,1,191,28,384,1,413
test4sub10of100,test4pub88of100,1,191,28,391,0,419
test4sub83of100,test4pub88of100,1,191,28,407,1,436
test4sub99of100,test4pub88of100,1,191,28,417,1,446
test4sub36of100,test4pub88of100,1,191,28,444,1,473
test4sub15of100,test4pub88of100,1,191,28,444,1,473
test4sub41of100,test4pub88of100,1,191,28,454,1,483
test4sub100of100,test4pub89of100,1,190,5,12,1,18
test4sub21of100,test4pub89of100,1,190,5,16,1,22
test4sub39of100,test4pub89of100,1,190,5,19,0,24
test4sub6of100,test4pub88of100,1,191,28,479,1,508
test4sub87of100,test4pub89of100,1,190,5,45,1,51
test4sub64of100,test4pub89of100,1,190,5,45,1,51
test4sub72of100,test4pub89of100,1,190,5,53,1,59
test4sub27of100,test4pub88of100,1,191,28,501,1,530
test4sub5of100,test4pub88of100,1,191,28,509,2,539
test4sub41of100,test4pub89of100,1,190,5,64,1,70
test4sub75of100,test4pub88of100,1,191,28,510,2,540
test4sub19of100,test4pub88of100,1,191,28,516,1,545
test4sub91of100,test4pub89of100,1,190,5,71,1,77
test4sub96of100,test4pub88of100,1,191,28,518,1,547
test4sub62of100,test4pub89of100,1,190,5,81,0,86
test4sub43of100,test4pub89of100,1,190,5,87,1,93
test4sub22of100,test4pub89of100,1,190,5,88,0,93
test4sub63of100,test4pub89of100,1,190,5,98,1,104
test4sub79of100,test4pub89of100,1,190,5,124,1,130
test4sub9of100,test4pub89of100,1,190,5,126,1,132
test4sub73of100,test4pub88of100,1,191,28,577,1,606
test4sub16of100,test4pub89of100,1,190,5,136,1,142
test4sub84of100,test4pub88of100,1,191,28,582,1,611
test4sub48of100,test4pub89of100,1,190,5,138,3,146
test4sub82of100,test4pub89of100,1,190,5,137,5,147
test4sub56of100,test4pub89of100,1,190,5,138,4,147
test4sub78of100,test4pub89of100,1,190,5,139,3,147
test4sub68of100,test4pub88of100,1,191,28,585,3,616
test4sub19of100,test4pub89of100,1,190,5,140,3,148
test4sub93of100,test4pub89of100,1,190,5,141,3,149
test4sub24of100,test4pub89of100,1,190,5,141,4,150
test4sub54of100,test4pub88of100,1,191,28,593,0,621
test4sub66of100,test4pub88of100,1,191,28,593,1,622
test4sub67of100,test4pub88of100,1,191,28,594,1,623
test4sub45of100,test4pub89of100,1,190,5,151,1,157
test4sub74of100,test4pub89of100,1,190,5,153,0,158
test4sub94of100,test4pub89of100,1,190,5,156,1,162
test4sub1of100,test4pub89of100,1,190,5,163,1,169
test4sub57of100,test4pub89of100,1,190,5,164,1,170
test4sub38of100,test4pub88of100,1,191,28,617,0,645
test4sub61of100,test4pub88of100,1,191,28,632,0,660
test4sub22of100,test4pub88of100,1,191,28,633,0,661
test4sub95of100,test4pub88of100,1,191,28,635,1,664
test4sub25of100,test4pub89of100,1,190,5,195,1,201
test4sub20of100,test4pub89of100,1,190,5,200,0,205
test4sub37of100,test4pub88of100,1,191,28,654,0,682
test4sub49of100,test4pub89of100,1,190,5,212,1,218
test4sub70of100,test4pub89of100,1,190,5,212,1,218
test4sub3of100,test4pub89of100,1,190,5,216,1,222
test4sub92of100,test4pub88of100,1,191,28,664,1,693
test4sub11of100,test4pub89of100,1,190,5,243,1,249
test4sub10of100,test4pub89of100,1,190,5,243,2,250
test4sub23of100,test4pub89of100,1,190,5,248,1,254
test4sub92of100,test4pub89of100,1,190,5,256,1,262
test4sub55of100,test4pub89of100,1,190,5,274,0,279
test4sub53of100,test4pub89of100,1,190,5,280,1,286
test4sub38of100,test4pub89of100,1,190,5,293,0,298
test4sub76of100,test4pub89of100,1,190,5,298,1,304
test4sub13of100,test4pub89of100,1,190,5,300,1,306
test4sub72of100,test4pub90of100,1,190,5,17,1,23
test4sub7of100,test4pub90of100,1,190,5,25,0,30
test4sub62of100,test4pub90of100,1,190,5,51,0,56
test4sub50of100,test4pub89of100,1,190,5,349,1,355
test4sub98of100,test4pub89of100,1,190,5,359,1,365
test4sub30of100,test4pub89of100,1,190,5,376,1,382
test4sub84of100,test4pub90of100,1,190,5,114,0,119
test4sub48of100,test4pub90of100,1,190,5,122,1,128
test4sub88of100,test4pub89of100,1,190,5,421,1,427
test4sub8of100,test4pub89of100,1,190,5,424,1,430
test4sub29of100,test4pub89of100,1,190,5,424,0,429
test4sub2of100,test4pub89of100,1,190,5,434,1,440
test4sub27of100,test4pub90of100,1,190,5,140,1,146
test4sub37of100,test4pub90of100,1,190,5,144,1,150
test4sub32of100,test4pub90of100,1,190,5,145,1,151
test4sub89of100,test4pub89of100,1,190,5,441,1,447
test4sub35of100,test4pub90of100,1,190,5,147,0,152
test4sub14of100,test4pub89of100,1,190,5,454,1,460
test4sub61of100,test4pub90of100,1,190,5,160,0,165
test4sub52of100,test4pub90of100,1,190,5,167,0,172
test4sub16of100,test4pub90of100,1,190,5,167,1,173
test4sub55of100,test4pub90of100,1,190,5,168,1,174
test4sub86of100,test4pub89of100,1,190,5,464,1,470
test4sub26of100,test4pub90of100,1,190,5,172,0,177
test4sub85of100,test4pub89of100,1,190,5,471,0,476
test4sub83of100,test4pub89of100,1,190,5,475,1,481
test4sub75of100,test4pub89of100,1,190,5,476,7,488
test4sub28of100,test4pub89of100,1,190,5,477,2,484
test4sub37of100,test4pub89of100,1,190,5,483,4,492
test4sub89of100,test4pub90of100,1,190,5,189,3,197
test4sub53of100,test4pub90of100,1,190,5,189,3,197
test4sub54of100,test4pub89of100,1,190,5,485,2,492
test4sub74of100,test4pub90of100,1,190,5,191,1,197
test4sub95of100,test4pub89of100,1,190,5,489,0,494
test4sub71of100,test4pub90of100,1,190,5,201,1,207
test4sub70of100,test4pub90of100,1,190,5,201,1,207
test4sub67of100,test4pub89of100,1,190,5,499,0,504
test4sub36of100,test4pub89of100,1,190,5,500,1,506
test4sub13of100,test4pub90of100,1,190,5,206,0,211
test4sub5of100,test4pub89of100,1,190,5,504,1,510
test4sub41of100,test4pub90of100,1,190,5,214,1,220
test4sub88of100,test4pub90of100,1,190,5,238,1,244
test4sub6of100,test4pub90of100,1,190,5,240,0,245
test4sub95of100,test4pub90of100,1,190,5,244,1,250
test4sub80of100,test4pub89of100,1,190,5,541,0,546
test4sub71of100,test4pub89of100,1,190,5,543,2,550
test4sub77of100,test4pub89of100,1,190,5,543,2,550
test4sub26of100,test4pub89of100,1,190,5,544,1,550
test4sub85of100,test4pub90of100,1,190,5,252,2,259
test4sub3of100,test4pub90of100,1,190,5,253,2,260
test4sub98of100,test4pub90of100,1,190,5,251,3,259
test4sub33of100,test4pub89of100,1,190,5,548,3,556
test4sub59of100,test4pub89of100,1,190,5,549,2,556
test4sub94of100,test4pub90of100,1,190,5,255,1,261
test4sub99of100,test4pub89of100,1,190,5,550,2,557
test4sub12of100,test4pub89of100,1,190,5,556,1,562
test4sub5of100,test4pub90of100,1,190,5,264,1,270
test4sub15of100,test4pub89of100,1,190,5,562,1,568
test4sub58of100,test4pub89of100,1,190,5,563,1,569
test4sub31of100,test4pub89of100,1,190,5,568,1,574
test4sub96of100,test4pub89of100,1,190,5,568,1,574
test4sub66of100,test4pub89of100,1,190,5,571,1,577
test4sub67of100,test4pub90of100,1,190,5,277,1,283
test4sub46of100,test4pub89of100,1,190,5,573,0,578
test4sub27of100,test4pub89of100,1,190,5,576,1,582
test4sub81of100,test4pub89of100,1,190,5,576,1,582
test4sub40of100,test4pub89of100,1,190,5,608,0,613
test4sub90of100,test4pub89of100,1,190,5,614,1,620
test4sub73of100,test4pub90of100,1,190,5,320,1,326
test4sub84of100,test4pub89of100,1,190,5,616,1,622
test4sub17of100,test4pub89of100,1,190,5,616,4,625
test4sub44of100,test4pub89of100,1,190,5,617,3,625
test4sub87of100,test4pub90of100,1,190,5,323,3,331
test4sub97of100,test4pub89of100,1,190,5,618,3,626
test4sub47of100,test4pub89of100,1,190,5,619,5,629
test4sub60of100,test4pub89of100,1,190,5,621,3,629
test4sub18of100,test4pub89of100,1,190,5,623,3,631
test4sub6of100,test4pub89of100,1,190,5,623,2,630
test4sub96of100,test4pub90of100,1,190,5,329,2,336
test4sub69of100,test4pub89of100,1,190,5,627,0,632
test4sub35of100,test4pub89of100,1,190,5,630,2,637
test4sub4of100,test4pub89of100,1,190,5,631,1,637
test4sub32of100,test4pub89of100,1,190,5,631,2,638
test4sub34of100,test4pub89of100,1,190,5,632,2,639
test4sub79of100,test4pub90of100,1,190,5,352,0,357
test4sub52of100,test4pub89of100,1,190,5,656,0,661
test4sub61of100,test4pub89of100,1,190,5,666,0,671
test4sub73of100,test4pub89of100,1,190,5,677,0,682
test4sub12of100,test4pub90of100,1,190,5,386,1,392
test4sub15of100,test4pub90of100,1,190,5,386,1,392
test4sub58of100,test4pub90of100,1,190,5,389,1,395
test4sub43of100,test4pub90of100,1,190,5,390,1,396
test4sub81of100,test4pub90of100,1,190,5,392,1,398
test4sub19of100,test4pub90of100,1,190,5,397,1,403
test4sub7of100,test4pub89of100,1,190,5,694,1,700
test4sub65of100,test4pub89of100,1,190,5,695,0,700
test4sub68of100,test4pub89of100,1,190,5,707,0,712
test4sub42of100,test4pub90of100,1,190,5,414,1,420
test4sub31of100,test4pub90of100,1,190,5,415,1,421
test4sub59of100,test4pub90of100,1,190,5,417,1,423
test4sub51of100,test4pub89of100,1,190,5,721,1,727
test4sub22of100,test4pub90of100,1,190,5,425,1,431
test4sub10of100,test4pub90of100,1,190,5,430,0,435
test4sub21of100,test4pub90of100,1,190,5,433,1,439
test4sub1of100,test4pub90of100,1,190,5,435,0,440
test4sub56of100,test4pub90of100,1,190,5,439,1,445
test4sub80of100,test4pub90of100,1,190,5,439,2,446
test4sub46of100,test4pub90of100,1,190,5,439,2,446
test4sub45of100,test4pub90of100,1,190,5,441,1,447
test4sub38of100,test4pub90of100,1,190,5,441,2,448
test4sub83of100,test4pub90of100,1,190,5,444,1,450
test4sub95of100,test4pub91of100,1,190,5,19,1,25
test4sub63of100,test4pub90of100,1,190,5,447,0,452
test4sub19of100,test4pub91of100,1,190,5,24,0,29
test4sub66of100,test4pub90of100,1,190,5,453,1,459
test4sub86of100,test4pub90of100,1,190,5,465,1,471
test4sub54of100,test4pub90of100,1,190,5,479,2,486
test4sub50of100,test4pub91of100,1,190,5,53,2,60
test4sub42of100,test4pub89of100,1,190,5,776,2,783
test4sub29of100,test4pub91of100,1,190,5,55,2,62
test4sub59of100,test4pub91of100,1,190,5,56,1,62
test4sub9of100,test4pub91of100,1,190,5,58,0,63
test4sub31of100,test4pub91of100,1,190,5,61,1,67
test4sub4of100,test4pub91of100,1,190,5,63,0,68
test4sub8of100,test4pub90of100,1,190,5,492,1,498
test4sub49of100,test4pub90of100,1,190,5,493,1,499
test4sub2of100,test4pub91of100,1,190,5,69,0,74
test4sub17of100,test4pub90of100,1,190,5,498,1,504
test4sub39of100,test4pub90of100,1,190,5,501,1,507
test4sub93of100,test4pub91of100,1,190,5,75,1,81
test4sub34of100,test4pub90of100,1,190,5,503,1,509
test4sub56of100,test4pub91of100,1,190,5,76,1,82
test4sub18of100,test4pub90of100,1,190,5,505,1,511
test4sub82of100,test4pub90of100,1,190,5,506,0,511
test4sub76of100,test4pub90of100,1,190,5,512,1,518
test4sub26of100,test4pub91of100,1,190,5,89,1,95
test4sub68of100,test4pub91of100,1,190,5,90,0,95
test4sub47of100,test4pub90of100,1,190,5,560,1,566
test4sub61of100,test4pub91of100,1,190,5,137,1,143
test4sub29of100,test4pub90of100,1,190,5,571,1,577
test4sub28of100,test4pub90of100,1,190,5,579,1,585
test4sub74of100,test4pub91of100,1,190,5,152,2,159
test4sub44of100,test4pub90of100,1,190,5,581,3,589
test4sub100of100,test4pub90of100,1,190,5,581,4,590
test4sub64of100,test4pub90of100,1,190,5,582,4,591
test4sub40of100,test4pub90of100,1,190,5,583,3,591
test4sub78of100,test4pub90of100,1,190,5,582,4,591
test4sub4of100,test4pub90of100,1,190,5,582,5,592
test4sub50of100,test4pub90of100,1,190,5,583,5,593
test4sub10of100,test4pub91of100,1,190,5,153,9,167
test4sub93of100,test4pub90of100,1,190,5,584,6,595
test4sub66of100,test4pub91of100,1,190,5,159,5,169
test4sub30of100,test4pub90of100,1,190,5,588,3,596
test4sub92of100,test4pub90of100,1,190,5,587,3,595
test4sub33of100,test4pub90of100,1,190,5,590,7,602
test4sub60of100,test4pub90of100,1,190,5,599,1,605
test4sub43of100,test4pub91of100,1,190,5,172,1,178
test4sub77of100,test4pub90of100,1,190,5,604,1,610
test4sub99of100,test4pub90of100,1,190,5,604,1,610
test4sub25of100,test4pub90of100,1,190,5,604,1,610
test4sub97of100,test4pub91of100,1,190,5,180,0,185
test4sub65of100,test4pub91of100,1,190,5,185,1,191
test4sub42of100,test4pub91of100,1,190,5,192,1,198
test4sub24of100,test4pub90of100,1,190,5,622,1,628
test4sub51of100,test4pub90of100,1,190,5,644,2,651
test4sub36of100,test4pub90of100,1,190,5,644,2,651
test4sub23of100,test4pub91of100,1,190,5,218,2,225
test4sub57of100,test4pub90of100,1,190,5,647,0,652
test4sub83of100,test4pub91of100,1,190,5,220,1,226
test4sub9of100,test4pub90of100,1,190,5,651,1,657
test4sub75of100,test4pub90of100,1,190,5,655,1,661
test4sub86of100,test4pub91of100,1,190,5,234,1,240
test4sub87of100,test4pub91of100,1,190,5,238,1,244
test4sub38of100,test4pub91of100,1,190,5,240,1,246
test4sub20of100,test4pub90of100,1,190,5,668,2,675
test4sub15of100,test4pub91of100,1,190,5,242,4,251
test4sub97of100,test4pub90of100,1,190,5,669,5,679
test4sub48of100,test4pub91of100,1,190,5,243,4,252
test4sub3of100,test4pub91of100,1,190,5,244,4,253
test4sub90of100,test4pub90of100,1,190,5,671,4,680
test4sub14of100,test4pub90of100,1,190,5,672,4,681
test4sub45of100,test4pub91of100,1,190,5,245,4,254
test4sub6of100,test4pub91of100,1,190,5,246,4,255
test4sub69of100,test4pub90of100,1,190,5,674,4,683
test4sub91of100,test4pub90of100,1,190,5,676,2,683
test4sub76of100,test4pub91of100,1,190,5,253,2,260
test4sub40of100,test4pub91of100,1,190,5,253,2,260
test4sub68of100,test4pub90of100,1,190,5,681,2,688
test4sub98of100,test4pub91of100,1,190,5,254,3,262
test4sub44of100,test4pub91of100,1,190,5,256,1,262
test4sub53of100,test4pub91of100,1,190,5,257,1,263
test4sub2of100,test4pub90of100,1,190,5,684,1,690
test4sub11of100,test4pub90of100,1,190,5,686,1,692
test4sub23of100,test4pub90of100,1,190,5,687,2,694
test4sub80of100,test4pub91of100,1,190,5,261,2,268
test4sub17of100,test4pub91of100,1,190,5,263,1,269
test4sub22of100,test4pub91of100,1,190,5,261,4,270
test4sub88of100,test4pub91of100,1,190,5,262,3,270
test4sub35of100,test4pub91of100,1,190,5,263,2,270
test4sub16of100,test4pub91of100,1,190,5,264,2,271
test4sub71of100,test4pub91of100,1,190,5,269,1,275
test4sub24of100,test4pub91of100,1,190,5,272,0,277
test4sub1of100,test4pub91of100,1,190,5,281,1,287
test4sub81of100,test4pub91of100,1,190,5,289,0,294
test4sub28of100,test4pub91of100,1,190,5,293,1,299
test4sub37of100,test4pub91of100,1,190,5,294,1,300
test4sub18of100,test4pub91of100,1,190,5,304,1,310
test4sub72of100,test4pub91of100,1,190,5,305,1,311
test4sub75of100,test4pub91of100,1,190,5,308,1,314
test4sub85of100,test4pub91of100,1,190,5,310,0,315
test4sub27of100,test4pub91of100,1,190,5,314,0,319
test4sub5of100,test4pub91of100,1,190,5,319,1,325
test4sub32of100,test4pub91of100,1,190,5,339,1,345
test4sub13of100,test4pub91of100,1,190,5,344,0,349
test4sub49of100,test4pub91of100,1,190,5,347,1,353
test4sub12of100,test4pub91of100,1,190,5,349,1,355
test4sub94of100,test4pub91of100,1,190,5,350,1,356
test4sub63of100,test4pub91of100,1,190,5,355,0,360
test4sub14of100,test4pub91of100,1,190,5,359,1,365
test4sub73of100,test4pub91of100,1,190,5,362,1,368
test4sub70of100,test4pub91of100,1,190,5,365,1,371
test4sub39of100,test4pub91of100,1,190,5,368,0,373
test4sub62of100,test4pub91of100,1,190,5,369,0,374
test4sub79of100,test4pub91of100,1,190,5,385,0,390
test4sub51of100,test4pub91of100,1,190,5,390,1,396
test4sub21of100,test4pub91of100,1,190,5,398,0,403
test4sub36of100,test4pub91of100,1,190,5,405,1,411
test4sub92of100,test4pub91of100,1,190,5,414,1,420
test4sub30of100,test4pub91of100,1,190,5,434,0,439
test4sub34of100,test4pub91of100,1,190,5,438,1,444
test4sub96of100,test4pub91of100,1,190,5,441,0,446
test4sub55of100,test4pub91of100,1,190,5,444,0,449
test4sub99of100,test4pub91of100,1,190,5,445,1,451
test4sub65of100,test4pub90of100,1,190,5,875,1,881
test4sub8of100,test4pub91of100,1,190,5,450,1,456
test4sub23of100,test4pub92of100,1,190,5,21,0,26
test4sub47of100,test4pub91of100,1,190,5,458,0,463
test4sub11of100,test4pub92of100,1,190,5,25,0,30
test4sub89of100,test4pub91of100,1,190,5,497,1,503
test4sub41of100,test4pub91of100,1,190,5,503,1,509
test4sub86of100,test4pub92of100,1,190,5,69,1,75
test4sub62of100,test4pub92of100,1,190,5,72,0,77
test4sub44of100,test4pub92of100,1,190,5,78,0,83
test4sub90of100,test4pub92of100,1,190,5,85,1,91
test4sub18of100,test4pub92of100,1,190,5,85,2,92
test4sub58of100,test4pub91of100,1,190,5,522,1,528
test4sub7of100,test4pub91of100,1,190,5,523,1,529
test4sub8of100,test4pub92of100,1,190,5,88,1,94
test4sub63of100,test4pub92of100,1,190,5,94,1,100
test4sub57of100,test4pub91of100,1,190,5,531,1,537
test4sub6of100,test4pub92of100,1,190,5,97,1,103
test4sub33of100,test4pub91of100,1,190,5,535,1,541
test4sub82of100,test4pub91of100,1,190,5,536,1,542
test4sub67of100,test4pub91of100,1,190,5,534,4,543
test4sub73of100,test4pub92of100,1,190,5,99,2,106
test4sub43of100,test4pub92of100,1,190,5,99,3,107
test4sub69of100,test4pub91of100,1,190,5,545,0,550
test4sub20of100,test4pub91of100,1,190,5,547,1,553
test4sub78of100,test4pub91of100,1,190,5,553,0,558
test4sub64of100,test4pub91of100,1,190,5,558,1,564
test4sub96of100,test4pub92of100,1,190,5,127,1,133
test4sub100of100,test4pub91of100,1,190,5,590,0,595
test4sub3of100,test4pub92of100,1,190,5,155,1,161
test4sub90of100,test4pub91of100,1,190,5,592,2,599
test4sub91of100,test4pub91of100,1,190,5,592,1,598
test4sub55of100,test4pub92of100,1,190,5,160,1,166
test4sub77of100,test4pub91of100,1,190,5,596,1,602
test4sub60of100,test4pub91of100,1,190,5,597,1,603
test4sub54of100,test4pub91of100,1,190,5,601,1,607
test4sub84of100,test4pub91of100,1,190,5,601,3,609
test4sub52of100,test4pub91of100,1,190,5,602,2,609
test4sub25of100,test4pub91of100,1,190,5,603,1,609
test4sub88of100,test4pub92of100,1,190,5,168,2,175
test4sub47of100,test4pub92of100,1,190,5,170,2,177
test4sub50of100,test4pub92of100,1,190,5,170,2,177
test4sub11of100,test4pub91of100,1,190,5,607,1,613
test4sub46of100,test4pub91of100,1,190,5,607,2,614
test4sub61of100,test4pub92of100,1,190,5,175,1,181
test4sub22of100,test4pub92of100,1,190,5,176,1,182
test4sub40of100,test4pub92of100,1,190,5,181,2,188
test4sub19of100,test4pub92of100,1,190,5,182,0,187
test4sub34of100,test4pub92of100,1,190,5,190,1,196
test4sub4of100,test4pub92of100,1,190,5,193,1,199
test4sub58of100,test4pub92of100,1,190,5,194,1,200
test4sub17of100,test4pub92of100,1,190,5,199,0,204
test4sub13of100,test4pub92of100,1,190,5,200,1,206
test4sub42of100,test4pub92of100,1,190,5,203,0,208
test4sub94of100,test4pub92of100,1,190,5,204,1,210
test4sub1of100,test4pub92of100,1,190,5,207,1,213
test4sub89of100,test4pub92of100,1,190,5,211,1,217
test4sub78of100,test4pub92of100,1,190,5,226,1,232
test4sub14of100,test4pub92of100,1,190,5,241,0,246
test4sub75of100,test4pub92of100,1,190,5,251,0,256
test4sub10of100,test4pub92of100,1,190,5,256,1,262
test4sub5of100,test4pub92of100,1,190,5,259,1,265
test4sub48of100,test4pub92of100,1,190,5,273,1,279
test4sub97of100,test4pub92of100,1,190,5,276,1,282
test4sub82of100,test4pub92of100,1,190,5,290,1,296
test4sub79of100,test4pub92of100,1,190,5,311,1,317
test4sub21of100,test4pub92of100,1,190,5,352,0,357
test4sub65of100,test4pub92of100,1,190,5,353,1,359
test4sub24of100,test4pub92of100,1,190,5,371,1,377
test4sub72of100,test4pub92of100,1,190,5,375,9,389
test4sub87of100,test4pub92of100,1,190,5,381,2,388
test4sub38of100,test4pub92of100,1,190,5,381,3,389
test4sub77of100,test4pub92of100,1,190,5,382,3,390
test4sub52of100,test4pub92of100,1,190,5,383,3,391
test4sub56of100,test4pub92of100,1,190,5,425,1,431
test4sub67of100,test4pub92of100,1,190,5,426,2,433
test4sub51of100,test4pub92of100,1,190,5,427,2,434
test4sub66of100,test4pub92of100,1,190,5,428,1,434
test4sub20of100,test4pub92of100,1,190,5,427,3,435
test4sub28of100,test4pub92of100,1,190,5,427,3,435
test4sub84of100,test4pub92of100,1,190,5,430,1,436
test4sub54of100,test4pub92of100,1,190,5,431,2,438
test4sub98of100,test4pub92of100,1,190,5,432,3,440
test4sub70of100,test4pub92of100,1,190,5,433,2,440
test4sub41of100,test4pub92of100,1,190,5,433,2,440
test4sub69of100,test4pub92of100,1,190,5,434,1,440
test4sub32of100,test4pub92of100,1,190,5,436,1,442
test4sub31of100,test4pub92of100,1,190,5,439,0,444
test4sub91of100,test4pub92of100,1,190,5,442,1,448
test4sub26of100,test4pub92of100,1,190,5,445,0,450
test4sub74of100,test4pub92of100,1,190,5,468,0,473
test4sub83of100,test4pub92of100,1,190,5,472,1,478
test4sub16of100,test4pub92of100,1,190,5,472,0,477
test4sub76of100,test4pub93of100,1,190,5,20,0,25
test4sub68of100,test4pub93of100,1,190,5,35,0,40
test4sub45of100,test4pub93of100,1,190,5,41,1,47
test4sub92of100,test4pub93of100,1,190,5,49,1,55
test4sub37of100,test4pub92of100,1,190,5,520,0,525
test4sub66of100,test4pub93of100,1,190,5,89,1,95
test4sub94of100,test4pub93of100,1,190,5,95,1,101
test4sub93of100,test4pub92of100,1,190,5,577,1,583
test4sub91of100,test4pub93of100,1,190,5,135,1,141
test4sub95of100,test4pub92of100,1,190,5,630,3,638
test4sub85of100,test4pub92of100,1,190,5,633,0,638
test4sub59of100,test4pub92of100,1,190,5,636,1,642
test4sub17of100,test4pub93of100,1,190,5,179,1,185
test4sub29of100,test4pub92of100,1,190,5,645,2,652
test4sub27of100,test4pub92of100,1,190,5,647,2,654
test4sub90of100,test4pub93of100,1,190,5,185,0,190
test4sub92of100,test4pub92of100,1,190,5,651,2,658
test4sub18of100,test4pub93of100,1,190,5,187,2,194
test4sub2of100,test4pub92of100,1,190,5,652,3,660
test4sub76of100,test4pub92of100,1,190,5,653,2,660
test4sub46of100,test4pub92of100,1,190,5,654,1,660
test4sub64of100,test4pub92of100,1,190,5,660,1,666
test4sub100of100,test4pub92of100,1,190,5,660,1,666
test4sub59of100,test4pub93of100,1,190,5,198,1,204
test4sub14of100,test4pub93of100,1,190,5,199,1,205
test4sub39of100,test4pub92of100,1,190,5,667,3,675
test4sub57of100,test4pub92of100,1,190,5,668,2,675
test4sub83of100,test4pub93of100,1,190,5,203,1,209
test4sub71of100,test4pub92of100,1,190,5,669,2,676
test4sub12of100,test4pub92of100,1,190,5,676,1,682
test4sub60of100,test4pub92of100,1,190,5,677,0,682
test4sub5of100,test4pub93of100,1,190,5,227,0,232
test4sub36of100,test4pub92of100,1,190,5,701,1,707
test4sub29of100,test4pub93of100,1,190,5,335,2,342
test4sub72of100,test4pub93of100,1,190,5,245,0,250
test4sub45of100,test4pub92of100,1,190,5,713,1,719
test4sub33of100,test4pub92of100,1,190,5,714,1,720
test4sub25of100,test4pub92of100,1,190,5,715,2,722
test4sub99of100,test4pub92of100,1,190,5,716,2,723
test4sub15of100,test4pub92of100,1,190,5,716,2,723
test4sub68of100,test4pub92of100,1,190,5,717,2,724
test4sub88of100,test4pub93of100,1,190,5,256,1,262
test4sub75of100,test4pub93of100,1,190,5,257,0,262
test4sub74of100,test4pub93of100,1,190,5,260,0,265
test4sub49of100,test4pub92of100,1,190,5,725,1,731
test4sub81of100,test4pub92of100,1,190,5,727,1,733
test4sub35of100,test4pub92of100,1,190,5,729,1,735
test4sub7of100,test4pub92of100,1,190,5,731,1,737
test4sub16of100,test4pub93of100,1,190,5,270,0,275
test4sub53of100,test4pub92of100,1,190,5,739,1,745
test4sub10of100,test4pub93of100,1,190,5,280,0,285
test4sub9of100,test4pub92of100,1,190,5,751,0,756
test4sub80of100,test4pub92of100,1,190,5,756,1,762
test4sub38of100,test4pub93of100,1,190,5,336,5,346
test4sub30of100,test4pub92of100,1,190,5,759,0,764
test4sub78of100,test4pub93of100,1,190,5,303,1,309
test4sub13of100,test4pub93of100,1,190,5,304,0,309
test4sub34of100,test4pub93of100,1,190,5,307,1,313
test4sub100of100,test4pub93of100,1,190,5,336,6,347
test4sub77of100,test4pub93of100,1,190,5,309,0,314
test4sub11of100,test4pub93of100,1,190,5,314,1,320
test4sub69of100,test4pub93of100,1,190,5,315,1,321
test4sub85of100,test4pub93of100,1,190,5,322,0,327
test4sub61of100,test4pub93of100,1,190,5,322,1,328
test4sub87of100,test4pub93of100,1,190,5,323,0,328
test4sub31of100,test4pub93of100,1,190,5,323,2,330
test4sub73of100,test4pub93of100,1,190,5,327,0,332
test4sub97of100,test4pub93of100,1,190,5,331,1,337
test4sub33of100,test4pub93of100,1,190,5,339,6,350
test4sub93of100,test4pub93of100,1,190,5,339,5,349
test4sub6of100,test4pub93of100,1,190,5,339,6,350
test4sub3of100,test4pub93of100,1,190,5,340,6,351
test4sub70of100,test4pub93of100,1,190,5,337,9,351
test4sub80of100,test4pub93of100,1,190,5,341,5,351
test4sub19of100,test4pub93of100,1,190,5,343,3,351
test4sub63of100,test4pub93of100,1,190,5,344,3,352
test4sub8of100,test4pub93of100,1,190,5,349,1,355
test4sub86of100,test4pub93of100,1,190,5,348,1,354
test4sub81of100,test4pub93of100,1,190,5,349,2,356
test4sub79of100,test4pub93of100,1,190,5,353,2,360
test4sub28of100,test4pub93of100,1,190,5,355,1,361
test4sub27of100,test4pub93of100,1,190,5,357,1,363
test4sub7of100,test4pub93of100,1,190,5,362,0,367
test4sub48of100,test4pub93of100,1,190,5,366,1,372
test4sub37of100,test4pub93of100,1,190,5,366,1,372
test4sub39of100,test4pub93of100,1,190,5,372,1,378
test4sub32of100,test4pub93of100,1,190,5,372,0,377
test4sub64of100,test4pub93of100,1,190,5,376,1,382
test4sub44of100,test4pub93of100,1,190,5,377,1,383
test4sub82of100,test4pub93of100,1,190,5,380,1,386
test4sub35of100,test4pub93of100,1,190,5,382,1,388
test4sub1of100,test4pub93of100,1,190,5,382,0,387
test4sub57of100,test4pub93of100,1,190,5,392,0,397
test4sub24of100,test4pub93of100,1,190,5,397,0,402
test4sub9of100,test4pub93of100,1,190,5,401,1,407
test4sub56of100,test4pub93of100,1,190,5,401,1,407
test4sub40of100,test4pub93of100,1,190,5,403,1,409
test4sub20of100,test4pub93of100,1,190,5,409,1,415
test4sub71of100,test4pub93of100,1,190,5,409,2,416
test4sub12of100,test4pub93of100,1,190,5,412,1,418
test4sub95of100,test4pub93of100,1,190,5,417,0,422
test4sub62of100,test4pub93of100,1,190,5,420,1,426
test4sub26of100,test4pub93of100,1,190,5,425,1,431
test4sub36of100,test4pub93of100,1,190,5,429,1,435
test4sub2of100,test4pub93of100,1,190,5,429,1,435
test4sub58of100,test4pub93of100,1,190,5,433,1,439
test4sub51of100,test4pub93of100,1,190,5,433,1,439
test4sub96of100,test4pub93of100,1,190,5,441,1,447
test4sub55of100,test4pub93of100,1,190,5,446,1,452
test4sub89of100,test4pub93of100,1,190,5,448,1,454
test4sub42of100,test4pub93of100,1,190,5,449,1,455
test4sub99of100,test4pub93of100,1,190,5,465,1,471
test4sub49of100,test4pub93of100,1,190,5,468,0,473
test4sub67of100,test4pub93of100,1,190,5,482,1,488
test4sub43of100,test4pub93of100,1,190,5,484,0,489
test4sub27of100,test4pub94of100,1,190,9,11,1,21
test4sub47of100,test4pub94of100,1,190,9,13,1,23
test4sub65of100,test4pub93of100,1,190,5,496,1,502
test4sub21of100,test4pub93of100,1,190,5,500,1,506
test4sub35of100,test4pub94of100,1,190,9,22,1,32
test4sub63of100,test4pub94of100,1,190,9,42,1,52
test4sub4of100,test4pub93of100,1,190,5,531,0,536
test4sub30of100,test4pub93of100,1,190,5,535,1,541
test4sub52of100,test4pub93of100,1,190,5,540,1,546
test4sub50of100,test4pub93of100,1,190,5,541,1,547
test4sub47of100,test4pub93of100,1,190,5,543,0,548
test4sub79of100,test4pub94of100,1,190,9,67,1,77
test4sub71of100,test4pub94of100,1,190,9,67,1,77
test4sub67of100,test4pub94of100,1,190,9,68,1,78
test4sub60of100,test4pub93of100,1,190,5,552,1,558
test4sub8of100,test4pub94of100,1,190,9,74,0,83
test4sub14of100,test4pub94of100,1,190,9,77,1,87
test4sub59of100,test4pub94of100,1,190,9,78,1,88
test4sub32of100,test4pub94of100,1,190,9,81,0,90
test4sub70of100,test4pub94of100,1,190,9,96,0,105
test4sub78of100,test4pub94of100,1,190,9,112,1,122
test4sub94of100,test4pub94of100,1,190,9,114,0,123
test4sub22of100,test4pub93of100,1,190,5,597,1,603
test4sub98of100,test4pub94of100,1,190,9,122,1,132
test4sub84of100,test4pub93of100,1,190,5,607,0,612
test4sub53of100,test4pub93of100,1,190,5,608,1,614
test4sub15of100,test4pub93of100,1,190,5,609,0,614
test4sub75of100,test4pub94of100,1,190,9,132,0,141
test4sub41of100,test4pub93of100,1,190,5,615,0,620
test4sub23of100,test4pub93of100,1,190,5,614,3,622
test4sub89of100,test4pub94of100,1,190,9,134,2,145
test4sub9of100,test4pub94of100,1,190,9,135,2,146
test4sub38of100,test4pub94of100,1,190,9,136,2,147
test4sub80of100,test4pub94of100,1,190,9,145,1,155
test4sub10of100,test4pub94of100,1,190,9,146,0,155
test4sub46of100,test4pub93of100,1,190,5,631,2,638
test4sub98of100,test4pub93of100,1,190,5,632,1,638
test4sub25of100,test4pub93of100,1,190,5,637,2,644
test4sub54of100,test4pub93of100,1,190,5,637,2,644
test4sub60of100,test4pub94of100,1,190,9,157,2,168
test4sub88of100,test4pub94of100,1,190,9,164,1,174
test4sub4of100,test4pub94of100,1,190,9,168,0,177
test4sub76of100,test4pub94of100,1,190,9,170,1,180
test4sub52of100,test4pub94of100,1,190,9,177,1,187
test4sub19of100,test4pub94of100,1,190,9,179,0,188
test4sub21of100,test4pub94of100,1,190,9,187,1,197
test4sub36of100,test4pub94of100,1,190,9,200,1,210
test4sub13of100,test4pub94of100,1,190,9,202,1,212
test4sub69of100,test4pub94of100,1,190,9,203,2,214
test4sub87of100,test4pub94of100,1,190,9,204,1,214
test4sub65of100,test4pub94of100,1,190,9,207,1,217
test4sub34of100,test4pub94of100,1,190,9,212,0,221
test4sub54of100,test4pub94of100,1,190,9,215,0,224
test4sub28of100,test4pub94of100,1,190,9,226,0,235
test4sub86of100,test4pub94of100,1,190,9,237,0,246
test4sub49of100,test4pub94of100,1,190,9,244,0,253
test4sub3of100,test4pub94of100,1,190,9,252,1,262
test4sub77of100,test4pub94of100,1,190,9,264,1,274
test4sub15of100,test4pub94of100,1,190,9,270,1,280
test4sub25of100,test4pub94of100,1,190,9,281,0,290
test4sub42of100,test4pub94of100,1,190,9,297,1,307
test4sub97of100,test4pub94of100,1,190,9,299,1,309
test4sub29of100,test4pub94of100,1,190,9,300,1,310
test4sub95of100,test4pub94of100,1,190,9,315,1,325
test4sub96of100,test4pub95of100,1,190,6,14,1,21
test4sub90of100,test4pub94of100,1,190,9,319,1,329
test4sub35of100,test4pub95of100,1,190,6,25,1,32
test4sub60of100,test4pub95of100,1,190,6,33,0,39
test4sub98of100,test4pub95of100,1,190,6,39,1,46
test4sub2of100,test4pub95of100,1,190,6,39,1,46
test4sub92of100,test4pub94of100,1,190,9,351,1,361
test4sub11of100,test4pub94of100,1,190,9,359,1,369
test4sub66of100,test4pub95of100,1,190,6,60,1,67
test4sub87of100,test4pub95of100,1,190,6,81,1,88
test4sub7of100,test4pub95of100,1,190,6,91,1,98
test4sub65of100,test4pub95of100,1,190,6,100,0,106
test4sub37of100,test4pub95of100,1,190,6,102,1,109
test4sub33of100,test4pub95of100,1,190,6,112,1,119
test4sub74of100,test4pub94of100,1,190,9,417,1,427
test4sub72of100,test4pub94of100,1,190,9,418,2,429
test4sub22of100,test4pub94of100,1,190,9,418,2,429
test4sub70of100,test4pub95of100,1,190,6,119,1,126
test4sub96of100,test4pub94of100,1,190,9,420,1,430
test4sub16of100,test4pub94of100,1,190,9,422,0,431
test4sub67of100,test4pub95of100,1,190,6,127,1,134
test4sub58of100,test4pub94of100,1,190,9,429,1,439
test4sub57of100,test4pub94of100,1,190,9,430,1,440
test4sub41of100,test4pub94of100,1,190,9,431,2,442
test4sub4of100,test4pub95of100,1,190,6,132,4,142
test4sub83of100,test4pub94of100,1,190,9,434,3,446
test4sub17of100,test4pub95of100,1,190,6,133,3,142
test4sub52of100,test4pub95of100,1,190,6,134,2,142
test4sub66of100,test4pub94of100,1,190,9,432,6,447
test4sub74of100,test4pub95of100,1,190,6,133,3,142
test4sub55of100,test4pub94of100,1,190,9,435,3,447
test4sub73of100,test4pub94of100,1,190,9,443,1,453
test4sub81of100,test4pub95of100,1,190,6,144,0,150
test4sub24of100,test4pub94of100,1,190,9,451,1,461
test4sub43of100,test4pub94of100,1,190,9,456,1,466
test4sub12of100,test4pub95of100,1,190,6,155,1,162
test4sub16of100,test4pub95of100,1,190,6,163,1,170
test4sub30of100,test4pub95of100,1,190,6,164,1,171
test4sub56of100,test4pub95of100,1,190,6,175,0,181
test4sub6of100,test4pub94of100,1,190,9,480,1,490
test4sub18of100,test4pub94of100,1,190,9,481,1,491
test4sub7of100,test4pub94of100,1,190,9,485,1,495
test4sub81of100,test4pub94of100,1,190,9,485,2,496
test4sub24of100,test4pub95of100,1,190,6,185,2,193
test4sub93of100,test4pub94of100,1,190,9,487,2,498
test4sub13of100,test4pub95of100,1,190,6,187,2,195
test4sub84of100,test4pub94of100,1,190,9,496,1,506
test4sub99of100,test4pub94of100,1,190,9,498,1,508
test4sub1of100,test4pub94of100,1,190,9,499,1,509
test4sub92of100,test4pub95of100,1,190,6,199,1,206
test4sub88of100,test4pub95of100,1,190,6,202,1,209
test4sub2of100,test4pub94of100,1,190,9,506,0,515
test4sub82of100,test4pub94of100,1,190,9,514,1,524
test4sub34of100,test4pub95of100,1,190,6,223,2,231
test4sub39of100,test4pub95of100,1,190,6,224,3,233
test4sub50of100,test4pub94of100,1,190,9,526,2,537
test4sub30of100,test4pub94of100,1,190,9,526,2,537
test4sub93of100,test4pub95of100,1,190,6,225,3,234
test4sub17of100,test4pub94of100,1,190,9,529,3,541
test4sub62of100,test4pub95of100,1,190,6,228,2,236
test4sub5of100,test4pub95of100,1,190,6,230,2,238
test4sub89of100,test4pub95of100,1,190,6,232,1,239
test4sub36of100,test4pub95of100,1,190,6,236,1,243
test4sub31of100,test4pub94of100,1,190,9,538,1,548
test4sub32of100,test4pub95of100,1,190,6,244,0,250
test4sub85of100,test4pub95of100,1,190,6,255,0,261
test4sub23of100,test4pub94of100,1,190,9,559,0,568
test4sub39of100,test4pub94of100,1,190,9,561,1,571
test4sub64of100,test4pub94of100,1,190,9,562,1,572
test4sub57of100,test4pub95of100,1,190,6,260,2,268
test4sub44of100,test4pub94of100,1,190,9,572,0,581
test4sub85of100,test4pub94of100,1,190,9,573,0,582
test4sub91of100,test4pub94of100,1,190,9,577,0,586
test4sub83of100,test4pub95of100,1,190,6,278,1,285
test4sub53of100,test4pub95of100,1,190,6,283,1,290
test4sub51of100,test4pub94of100,1,190,9,585,0,594
test4sub78of100,test4pub95of100,1,190,6,286,0,292
test4sub49of100,test4pub95of100,1,190,6,288,6,300
test4sub97of100,test4pub95of100,1,190,6,289,1,296
test4sub77of100,test4pub95of100,1,190,6,299,2,307
test4sub61of100,test4pub94of100,1,190,9,600,3,612
test4sub63of100,test4pub95of100,1,190,6,300,1,307
test4sub62of100,test4pub94of100,1,190,9,601,1,611
test4sub8of100,test4pub95of100,1,190,6,306,1,313
test4sub33of100,test4pub94of100,1,190,9,610,1,620
test4sub54of100,test4pub95of100,1,190,6,310,1,317
test4sub11of100,test4pub95of100,1,190,6,312,1,319
test4sub99of100,test4pub95of100,1,190,6,316,1,323
test4sub86of100,test4pub95of100,1,190,6,317,1,324
test4sub53of100,test4pub94of100,1,190,9,623,1,633
test4sub37of100,test4pub94of100,1,190,9,625,1,635
test4sub45of100,test4pub94of100,1,190,9,627,1,637
test4sub20of100,test4pub94of100,1,190,9,631,1,641
test4sub48of100,test4pub94of100,1,190,9,634,1,644
test4sub94of100,test4pub95of100,1,190,6,333,1,340
test4sub46of100,test4pub94of100,1,190,9,638,1,648
test4sub59of100,test4pub95of100,1,190,6,339,0,345
test4sub68of100,test4pub94of100,1,190,9,641,1,651
test4sub19of100,test4pub95of100,1,190,6,343,1,350
test4sub68of100,test4pub95of100,1,190,6,349,0,355
test4sub51of100,test4pub95of100,1,190,6,360,1,367
test4sub26of100,test4pub94of100,1,190,9,665,1,675
test4sub40of100,test4pub94of100,1,190,9,670,1,680
test4sub72of100,test4pub95of100,1,190,6,373,0,379
test4sub61of100,test4pub95of100,1,190,6,376,0,382
test4sub76of100,test4pub95of100,1,190,6,378,1,385
test4sub12of100,test4pub94of100,1,190,9,681,1,691
test4sub55of100,test4pub95of100,1,190,6,385,1,392
test4sub5of100,test4pub94of100,1,190,9,687,1,697
test4sub100of100,test4pub94of100,1,190,9,688,1,698
test4sub56of100,test4pub94of100,1,190,9,692,1,702
test4sub22of100,test4pub95of100,1,190,6,392,0,398
test4sub90of100,test4pub95of100,1,190,6,396,1,403
test4sub32of100,test4pub96of100,1,190,5,25,1,31
test4sub20of100,test4pub95of100,1,190,6,405,1,412
test4sub41of100,test4pub95of100,1,190,6,412,0,418
test4sub37of100,test4pub96of100,1,190,5,34,1,40
test4sub7of100,test4pub96of100,1,190,5,41,1,47
test4sub82of100,test4pub95of100,1,190,6,423,1,430
test4sub30of100,test4pub96of100,1,190,5,49,1,55
test4sub27of100,test4pub95of100,1,190,6,428,0,434
test4sub79of100,test4pub96of100,1,190,5,56,1,62
test4sub43of100,test4pub95of100,1,190,6,439,1,446
test4sub71of100,test4pub95of100,1,190,6,445,1,452
test4sub81of100,test4pub96of100,1,190,5,66,1,72
test4sub47of100,test4pub95of100,1,190,6,446,2,454
test4sub54of100,test4pub96of100,1,190,5,69,1,75
test4sub31of100,test4pub95of100,1,190,6,448,1,455
test4sub23of100,test4pub95of100,1,190,6,451,1,458
test4sub41of100,test4pub96of100,1,190,5,76,1,82
test4sub25of100,test4pub95of100,1,190,6,459,1,466
test4sub60of100,test4pub96of100,1,190,5,81,0,86
test4sub24of100,test4pub96of100,1,190,5,83,1,89
test4sub78of100,test4pub96of100,1,190,5,86,1,92
test4sub44of100,test4pub96of100,1,190,5,93,1,99
test4sub58of100,test4pub96of100,1,190,5,97,1,103
test4sub45of100,test4pub95of100,1,190,6,481,1,488
test4sub64of100,test4pub95of100,1,190,6,483,1,490
test4sub28of100,test4pub95of100,1,190,6,486,1,493
test4sub50of100,test4pub95of100,1,190,6,494,0,500
test4sub46of100,test4pub96of100,1,190,5,124,1,130
test4sub12of100,test4pub96of100,1,190,5,134,0,139
test4sub69of100,test4pub95of100,1,190,6,518,0,524
test4sub3of100,test4pub95of100,1,190,6,520,1,527
test4sub11of100,test4pub96of100,1,190,5,141,1,147
test4sub86of100,test4pub96of100,1,190,5,145,0,150
test4sub1of100,test4pub95of100,1,190,6,528,0,534
test4sub75of100,test4pub95of100,1,190,6,530,1,537
test4sub17of100,test4pub96of100,1,190,5,153,1,159
test4sub80of100,test4pub95of100,1,190,6,536,0,542
test4sub83of100,test4pub96of100,1,190,5,157,1,163
test4sub44of100,test4pub95of100,1,190,6,541,1,548
test4sub42of100,test4pub96of100,1,190,5,165,0,170
test4sub95of100,test4pub95of100,1,190,6,544,1,551
test4sub58of100,test4pub95of100,1,190,6,548,1,555
test4sub100of100,test4pub95of100,1,190,6,554,0,560
test4sub79of100,test4pub95of100,1,190,6,556,0,562
test4sub15of100,test4pub96of100,1,190,5,178,2,185
test4sub1of100,test4pub96of100,1,190,5,179,2,186
test4sub84of100,test4pub95of100,1,190,6,558,2,566
test4sub70of100,test4pub96of100,1,190,5,181,1,187
test4sub34of100,test4pub96of100,1,190,5,182,1,188
test4sub10of100,test4pub95of100,1,190,6,565,1,572
test4sub29of100,test4pub95of100,1,190,6,567,1,574
test4sub40of100,test4pub96of100,1,190,5,190,1,196
test4sub42of100,test4pub95of100,1,190,6,570,1,577
test4sub73of100,test4pub95of100,1,190,6,576,1,583
test4sub15of100,test4pub95of100,1,190,6,581,0,587
test4sub100of100,test4pub96of100,1,190,5,203,1,209
test4sub3of100,test4pub96of100,1,190,5,204,0,209
test4sub33of100,test4pub96of100,1,190,5,208,1,214
test4sub6of100,test4pub95of100,1,190,6,591,1,598
test4sub62of100,test4pub96of100,1,190,5,212,0,217
test4sub71of100,test4pub96of100,1,190,5,214,0,219
test4sub55of100,test4pub96of100,1,190,5,215,3,223
test4sub14of100,test4pub95of100,1,190,6,595,1,602
test4sub29of100,test4pub96of100,1,190,5,217,1,223
test4sub98of100,test4pub96of100,1,190,5,219,1,225
test4sub26of100,test4pub96of100,1,190,5,222,1,228
test4sub40of100,test4pub95of100,1,190,6,612,1,619
test4sub75of100,test4pub96of100,1,190,5,251,1,257
test4sub4of100,test4pub96of100,1,190,5,252,2,259
test4sub46of100,test4pub95of100,1,190,6,632,1,639
test4sub25of100,test4pub96of100,1,190,5,253,1,259
test4sub84of100,test4pub96of100,1,190,5,259,1,265
test4sub26of100,test4pub95of100,1,190,6,638,2,646
test4sub48of100,test4pub95of100,1,190,6,639,0,645
test4sub91of100,test4pub95of100,1,190,6,652,1,659
test4sub38of100,test4pub95of100,1,190,6,652,1,659
test4sub56of100,test4pub96of100,1,190,5,274,1,280
test4sub87of100,test4pub96of100,1,190,5,280,1,286
test4sub21of100,test4pub95of100,1,190,6,659,1,666
test4sub18of100,test4pub95of100,1,190,6,662,1,669
test4sub9of100,test4pub95of100,1,190,6,663,1,670
test4sub85of100,test4pub96of100,1,190,5,285,0,290
test4sub59of100,test4pub96of100,1,190,5,286,1,292
test4sub36of100,test4pub96of100,1,190,5,294,2,301
test4sub48of100,test4pub96of100,1,190,5,295,2,302
test4sub77of100,test4pub96of100,1,190,5,295,1,301
test4sub52of100,test4pub96of100,1,190,5,303,1,309
test4sub53of100,test4pub96of100,1,190,5,304,1,310
test4sub47of100,test4pub96of100,1,190,5,307,1,313
test4sub91of100,test4pub96of100,1,190,5,312,0,317
test4sub57of100,test4pub96of100,1,190,5,314,1,320
test4sub61of100,test4pub96of100,1,190,5,315,2,322
test4sub21of100,test4pub96of100,1,190,5,315,1,321
test4sub8of100,test4pub96of100,1,190,5,321,1,327
test4sub23of100,test4pub96of100,1,190,5,323,1,329
test4sub73of100,test4pub96of100,1,190,5,324,1,330
test4sub90of100,test4pub96of100,1,190,5,330,0,335
test4sub97of100,test4pub96of100,1,190,5,331,2,338
test4sub45of100,test4pub96of100,1,190,5,337,3,345
test4sub89of100,test4pub96of100,1,190,5,338,2,345
test4sub16of100,test4pub96of100,1,190,5,339,2,346
test4sub94of100,test4pub96of100,1,190,5,345,1,351
test4sub96of100,test4pub96of100,1,190,5,347,0,352
test4sub9of100,test4pub96of100,1,190,5,354,1,360
test4sub2of100,test4pub96of100,1,190,5,355,0,360
test4sub31of100,test4pub96of100,1,190,5,360,0,365
test4sub28of100,test4pub96of100,1,190,5,363,1,369
test4sub13of100,test4pub96of100,1,190,5,364,1,370
test4sub50of100,test4pub96of100,1,190,5,366,1,372
test4sub82of100,test4pub96of100,1,190,5,368,1,374
test4sub19of100,test4pub96of100,1,190,5,369,0,374
test4sub68of100,test4pub96of100,1,190,5,375,0,380
test4sub69of100,test4pub96of100,1,190,5,398,1,404
test4sub99of100,test4pub96of100,1,190,5,398,1,404
test4sub65of100,test4pub96of100,1,190,5,409,0,414
test4sub10of100,test4pub96of100,1,190,5,417,0,422
test4sub22of100,test4pub96of100,1,190,5,417,1,423
test4sub14of100,test4pub96of100,1,190,5,419,1,425
test4sub72of100,test4pub96of100,1,190,5,420,1,426
test4sub66of100,test4pub97of100,1,190,5,11,1,17
test4sub27of100,test4pub96of100,1,190,5,440,1,446
test4sub51of100,test4pub96of100,1,190,5,446,1,452
test4sub33of100,test4pub97of100,1,190,5,29,1,35
test4sub95of100,test4pub96of100,1,190,5,450,0,455
test4sub76of100,test4pub96of100,1,190,5,453,1,459
test4sub12of100,test4pub97of100,1,190,5,34,2,41
test4sub39of100,test4pub96of100,1,190,5,454,1,460
test4sub63of100,test4pub96of100,1,190,5,455,2,462
test4sub16of100,test4pub97of100,1,190,5,42,1,48
test4sub94of100,test4pub97of100,1,190,5,44,1,50
test4sub38of100,test4pub96of100,1,190,5,465,1,471
test4sub23of100,test4pub97of100,1,190,5,47,0,52
test4sub88of100,test4pub96of100,1,190,5,471,1,477
test4sub43of100,test4pub96of100,1,190,5,472,0,477
test4sub49of100,test4pub96of100,1,190,5,475,1,481
test4sub80of100,test4pub96of100,1,190,5,480,1,486
test4sub70of100,test4pub97of100,1,190,5,63,0,68
test4sub5of100,test4pub96of100,1,190,5,487,1,493
test4sub92of100,test4pub96of100,1,190,5,489,2,496
test4sub74of100,test4pub96of100,1,190,5,490,2,497
test4sub20of100,test4pub96of100,1,190,5,490,1,496
test4sub35of100,test4pub96of100,1,190,5,497,1,503
test4sub18of100,test4pub96of100,1,190,5,496,1,502
test4sub25of100,test4pub97of100,1,190,5,82,0,87
test4sub3of100,test4pub97of100,1,190,5,90,0,95
test4sub64of100,test4pub97of100,1,190,5,93,1,99
test4sub67of100,test4pub96of100,1,190,5,512,1,518
test4sub100of100,test4pub97of100,1,190,5,98,1,104
test4sub29of100,test4pub97of100,1,190,5,103,1,109
test4sub65of100,test4pub97of100,1,190,5,105,2,112
test4sub6of100,test4pub96of100,1,190,5,525,3,533
test4sub53of100,test4pub97of100,1,190,5,108,3,116
test4sub93of100,test4pub96of100,1,190,5,529,3,537
test4sub64of100,test4pub96of100,1,190,5,529,4,538
test4sub44of100,test4pub97of100,1,190,5,112,4,121
test4sub43of100,test4pub97of100,1,190,5,113,5,123
test4sub97of100,test4pub97of100,1,190,5,116,4,125
test4sub37of100,test4pub97of100,1,190,5,118,3,126
test4sub32of100,test4pub97of100,1,190,5,125,1,131
test4sub66of100,test4pub96of100,1,190,5,550,1,556
test4sub26of100,test4pub97of100,1,190,5,132,1,138
test4sub30of100,test4pub97of100,1,190,5,135,1,141
test4sub42of100,test4pub97of100,1,190,5,139,1,145
test4sub96of100,test4pub97of100,1,190,5,141,1,147
test4sub10of100,test4pub97of100,1,190,5,143,1,149
test4sub41of100,test4pub97of100,1,190,5,145,1,151
test4sub71of100,test4pub97of100,1,190,5,148,1,154
test4sub91of100,test4pub97of100,1,190,5,161,0,166
test4sub7of100,test4pub97of100,1,190,5,176,1,182
test4sub27of100,test4pub97of100,1,190,5,183,1,189
test4sub48of100,test4pub97of100,1,190,5,188,1,194
test4sub18of100,test4pub97of100,1,190,5,189,2,196
test4sub62of100,test4pub97of100,1,190,5,191,1,197
test4sub4of100,test4pub97of100,1,190,5,190,2,197
test4sub46of100,test4pub97of100,1,190,5,195,1,201
test4sub88of100,test4pub97of100,1,190,5,195,1,201
test4sub15of100,test4pub97of100,1,190,5,199,1,205
test4sub21of100,test4pub97of100,1,190,5,200,1,206
test4sub61of100,test4pub97of100,1,190,5,202,1,208
test4sub22of100,test4pub97of100,1,190,5,202,1,208
test4sub31of100,test4pub97of100,1,190,5,208,1,214
test4sub77of100,test4pub97of100,1,190,5,209,1,215
test4sub28of100,test4pub97of100,1,190,5,215,1,221
test4sub99of100,test4pub97of100,1,190,5,216,0,221
test4sub52of100,test4pub97of100,1,190,5,222,1,228
test4sub60of100,test4pub97of100,1,190,5,227,1,233
test4sub81of100,test4pub97of100,1,190,5,233,1,239
test4sub50of100,test4pub97of100,1,190,5,236,1,242
test4sub87of100,test4pub97of100,1,190,5,244,1,250
test4sub17of100,test4pub97of100,1,190,5,251,1,257
test4sub14of100,test4pub97of100,1,190,5,251,1,257
test4sub76of100,test4pub97of100,1,190,5,263,1,269
test4sub20of100,test4pub97of100,1,190,5,268,1,274
test4sub47of100,test4pub97of100,1,190,5,272,1,278
test4sub85of100,test4pub97of100,1,190,5,275,1,281
test4sub75of100,test4pub97of100,1,190,5,277,1,283
test4sub24of100,test4pub97of100,1,190,5,279,1,285
test4sub40of100,test4pub97of100,1,190,5,283,1,289
test4sub82of100,test4pub97of100,1,190,5,286,0,291
test4sub72of100,test4pub97of100,1,190,5,292,0,297
test4sub8of100,test4pub97of100,1,190,5,296,1,302
test4sub13of100,test4pub97of100,1,190,5,302,1,308
test4sub1of100,test4pub97of100,1,190,5,319,1,325
test4sub98of100,test4pub97of100,1,190,5,321,1,327
test4sub39of100,test4pub97of100,1,190,5,325,2,332
test4sub9of100,test4pub97of100,1,190,5,325,1,331
test4sub74of100,test4pub97of100,1,190,5,326,1,332
test4sub35of100,test4pub97of100,1,190,5,345,1,351
test4sub16of100,test4pub98of100,1,190,5,33,0,38
test4sub34of100,test4pub97of100,1,190,5,356,1,362
test4sub77of100,test4pub98of100,1,190,5,39,1,45
test4sub3of100,test4pub98of100,1,190,5,41,1,47
test4sub34of100,test4pub98of100,1,190,5,42,1,48
test4sub6of100,test4pub97of100,1,190,5,361,1,367
test4sub37of100,test4pub98of100,1,190,5,47,0,52
test4sub43of100,test4pub98of100,1,190,5,51,1,57
test4sub50of100,test4pub98of100,1,190,5,52,1,58
test4sub61of100,test4pub98of100,1,190,5,53,2,60
test4sub58of100,test4pub97of100,1,190,5,373,1,379
test4sub18of100,test4pub98of100,1,190,5,59,1,65
test4sub39of100,test4pub98of100,1,190,5,62,0,67
test4sub73of100,test4pub97of100,1,190,5,385,1,391
test4sub84of100,test4pub97of100,1,190,5,387,1,393
test4sub99of100,test4pub98of100,1,190,5,68,1,74
test4sub38of100,test4pub97of100,1,190,5,392,0,397
test4sub74of100,test4pub98of100,1,190,5,87,4,96
test4sub86of100,test4pub97of100,1,190,5,406,5,416
test4sub45of100,test4pub97of100,1,190,5,407,4,416
test4sub20of100,test4pub98of100,1,190,5,88,4,97
test4sub49of100,test4pub98of100,1,190,5,89,4,98
test4sub2of100,test4pub97of100,1,190,5,408,3,416
test4sub95of100,test4pub98of100,1,190,5,89,4,98
test4sub68of100,test4pub97of100,1,190,5,409,4,418
test4sub89of100,test4pub97of100,1,190,5,410,4,419
test4sub2of100,test4pub98of100,1,190,5,94,1,100
test4sub4of100,test4pub98of100,1,190,5,97,0,102
test4sub93of100,test4pub97of100,1,190,5,419,0,424
test4sub57of100,test4pub97of100,1,190,5,422,1,428
test4sub83of100,test4pub97of100,1,190,5,428,1,434
test4sub51of100,test4pub97of100,1,190,5,430,1,436
test4sub79of100,test4pub97of100,1,190,5,431,0,436
test4sub67of100,test4pub97of100,1,190,5,433,0,438
test4sub54of100,test4pub97of100,1,190,5,438,0,443
test4sub63of100,test4pub97of100,1,190,5,440,1,446
test4sub11of100,test4pub97of100,1,190,5,443,1,449
test4sub90of100,test4pub97of100,1,190,5,446,0,451
test4sub95of100,test4pub97of100,1,190,5,447,0,452
test4sub49of100,test4pub97of100,1,190,5,446,2,453
test4sub72of100,test4pub98of100,1,190,5,129,1,135
test4sub88of100,test4pub98of100,1,190,5,130,1,136
test4sub78of100,test4pub98of100,1,190,5,138,1,144
test4sub32of100,test4pub98of100,1,190,5,143,1,149
test4sub70of100,test4pub98of100,1,190,5,144,1,150
test4sub92of100,test4pub97of100,1,190,5,466,0,471
test4sub80of100,test4pub97of100,1,190,5,468,0,473
test4sub21of100,test4pub98of100,1,190,5,154,1,160
test4sub59of100,test4pub97of100,1,190,5,474,1,480
test4sub19of100,test4pub97of100,1,190,5,476,1,482
test4sub69of100,test4pub97of100,1,190,5,476,1,482
test4sub55of100,test4pub97of100,1,190,5,480,1,486
test4sub8of100,test4pub98of100,1,190,5,161,1,167
test4sub56of100,test4pub98of100,1,190,5,165,0,170
test4sub36of100,test4pub97of100,1,190,5,488,1,494
test4sub86of100,test4pub98of100,1,190,5,169,1,175
test4sub64of100,test4pub98of100,1,190,5,174,1,180
test4sub57of100,test4pub98of100,1,190,5,179,1,185
test4sub46of100,test4pub98of100,1,190,5,180,1,186
test4sub35of100,test4pub98of100,1,190,5,181,2,188
test4sub78of100,test4pub97of100,1,190,5,507,1,513
test4sub5of100,test4pub97of100,1,190,5,506,2,513
test4sub80of100,test4pub98of100,1,190,5,189,0,194
test4sub28of100,test4pub98of100,1,190,5,193,1,199
test4sub56of100,test4pub97of100,1,190,5,513,1,519
test4sub11of100,test4pub98of100,1,190,5,196,0,201
test4sub1of100,test4pub98of100,1,190,5,201,1,207
test4sub91of100,test4pub98of100,1,190,5,208,2,215
test4sub100of100,test4pub98of100,1,190,5,209,1,215
test4sub94of100,test4pub98of100,1,190,5,212,0,217
test4sub62of100,test4pub98of100,1,190,5,219,1,225
test4sub60of100,test4pub98of100,1,190,5,219,1,225
test4sub65of100,test4pub98of100,1,190,5,221,1,227
test4sub79of100,test4pub98of100,1,190,5,224,1,230
test4sub12of100,test4pub98of100,1,190,5,224,0,229
test4sub44of100,test4pub98of100,1,190,5,228,0,233
test4sub97of100,test4pub98of100,1,190,5,233,0,238
test4sub87of100,test4pub98of100,1,190,5,239,1,245
test4sub19of100,test4pub98of100,1,190,5,244,1,250
test4sub54of100,test4pub98of100,1,190,5,248,0,253
test4sub67of100,test4pub98of100,1,190,5,250,0,255
test4sub22of100,test4pub98of100,1,190,5,253,0,258
test4sub98of100,test4pub98of100,1,190,5,258,1,264
test4sub29of100,test4pub98of100,1,190,5,260,1,266
test4sub25of100,test4pub98of100,1,190,5,259,2,266
test4sub36of100,test4pub98of100,1,190,5,267,1,273
test4sub96of100,test4pub98of100,1,190,5,274,1,280
test4sub33of100,test4pub98of100,1,190,5,282,1,288
test4sub30of100,test4pub98of100,1,190,5,284,1,290
test4sub6of100,test4pub98of100,1,190,5,288,1,294
test4sub7of100,test4pub98of100,1,190,5,292,1,298
test4sub83of100,test4pub98of100,1,190,5,313,1,319
test4sub48of100,test4pub98of100,1,190,5,314,2,321
test4sub15of100,test4pub98of100,1,190,5,315,0,320
test4sub45of100,test4pub98of100,1,190,5,330,1,336
test4sub40of100,test4pub98of100,1,190,5,332,1,338
test4sub26of100,test4pub98of100,1,190,5,333,1,339
test4sub55of100,test4pub98of100,1,190,5,338,0,343
test4sub90of100,test4pub99of100,1,190,5,17,1,23
test4sub15of100,test4pub99of100,1,190,5,19,1,25
test4sub13of100,test4pub98of100,1,190,5,357,1,363
test4sub42of100,test4pub98of100,1,190,5,358,0,363
test4sub75of100,test4pub98of100,1,190,5,362,1,368
test4sub70of100,test4pub99of100,1,190,5,40,0,45
test4sub14of100,test4pub98of100,1,190,5,377,1,383
test4sub38of100,test4pub98of100,1,190,5,383,1,389
test4sub9of100,test4pub98of100,1,190,5,383,0,388
test4sub97of100,test4pub99of100,1,190,5,58,1,64
test4sub58of100,test4pub99of100,1,190,5,60,2,67
test4sub5of100,test4pub98of100,1,190,5,393,2,400
test4sub47of100,test4pub99of100,1,190,5,61,2,68
test4sub53of100,test4pub98of100,1,190,5,394,2,401
test4sub68of100,test4pub98of100,1,190,5,391,5,401
test4sub75of100,test4pub99of100,1,190,5,61,4,70
test4sub80of100,test4pub99of100,1,190,5,70,1,76
test4sub41of100,test4pub98of100,1,190,5,408,1,414
test4sub91of100,test4pub99of100,1,190,5,83,0,88
test4sub92of100,test4pub99of100,1,190,5,85,1,91
test4sub95of100,test4pub99of100,1,190,5,85,1,91
test4sub51of100,test4pub98of100,1,190,5,421,1,427
test4sub47of100,test4pub98of100,1,190,5,422,2,429
test4sub85of100,test4pub99of100,1,190,5,91,0,96
test4sub37of100,test4pub99of100,1,190,5,92,1,98
test4sub26of100,test4pub99of100,1,190,5,96,1,102
test4sub89of100,test4pub98of100,1,190,5,432,1,438
test4sub74of100,test4pub99of100,1,190,5,108,0,113
test4sub92of100,test4pub98of100,1,190,5,442,1,448
test4sub1of100,test4pub99of100,1,190,5,110,1,116
test4sub17of100,test4pub99of100,1,190,5,111,1,117
test4sub52of100,test4pub98of100,1,190,5,450,1,456
test4sub85of100,test4pub98of100,1,190,5,450,1,456
test4sub31of100,test4pub98of100,1,190,5,452,0,457
test4sub71of100,test4pub98of100,1,190,5,458,1,464
test4sub99of100,test4pub99of100,1,190,5,127,1,133
test4sub73of100,test4pub98of100,1,190,5,463,1,469
test4sub51of100,test4pub99of100,1,190,5,131,0,136
test4sub48of100,test4pub99of100,1,190,5,135,1,141
test4sub63of100,test4pub99of100,1,190,5,154,1,160
test4sub23of100,test4pub98of100,1,190,5,499,1,505
test4sub17of100,test4pub98of100,1,190,5,498,1,504
test4sub59of100,test4pub98of100,1,190,5,503,7,515
test4sub81of100,test4pub98of100,1,190,5,503,4,512
test4sub84of100,test4pub98of100,1,190,5,510,6,521
test4sub38of100,test4pub99of100,1,190,5,178,5,188
test4sub24of100,test4pub99of100,1,190,5,179,4,188
test4sub66of100,test4pub98of100,1,190,5,512,5,522
test4sub58of100,test4pub98of100,1,190,5,512,4,521
test4sub10of100,test4pub98of100,1,190,5,512,4,521
test4sub69of100,test4pub98of100,1,190,5,513,5,523
test4sub71of100,test4pub99of100,1,190,5,181,4,190
test4sub64of100,test4pub99of100,1,190,5,182,5,192
test4sub90of100,test4pub98of100,1,190,5,520,0,525
test4sub28of100,test4pub99of100,1,190,5,189,1,195
test4sub76of100,test4pub98of100,1,190,5,522,1,528
test4sub31of100,test4pub99of100,1,190,5,191,1,197
test4sub89of100,test4pub99of100,1,190,5,191,1,197
test4sub18of100,test4pub99of100,1,190,5,197,1,203
test4sub63of100,test4pub98of100,1,190,5,531,0,536
test4sub44of100,test4pub99of100,1,190,5,201,2,208
test4sub93of100,test4pub98of100,1,190,5,533,1,539
test4sub27of100,test4pub98of100,1,190,5,534,1,540
test4sub82of100,test4pub98of100,1,190,5,537,1,543
test4sub6of100,test4pub99of100,1,190,5,211,1,217
test4sub22of100,test4pub99of100,1,190,5,213,0,218
test4sub61of100,test4pub99of100,1,190,5,216,1,222
test4sub35of100,test4pub99of100,1,190,5,217,1,223
test4sub24of100,test4pub98of100,1,190,5,553,0,558
test4sub66of100,test4pub99of100,1,190,5,223,1,229
test4sub19of100,test4pub99of100,1,190,5,226,1,232
test4sub20of100,test4pub99of100,1,190,5,226,0,231
test4sub98of100,test4pub99of100,1,190,5,233,1,239
test4sub21of100,test4pub99of100,1,190,5,234,1,240
test4sub32of100,test4pub99of100,1,190,5,237,1,243
test4sub76of100,test4pub99of100,1,190,5,238,0,243
test4sub53of100,test4pub99of100,1,190,5,244,0,249
test4sub50of100,test4pub99of100,1,190,5,256,0,261
test4sub14of100,test4pub99of100,1,190,5,261,1,267
test4sub65of100,test4pub99of100,1,190,5,264,1,270
test4sub30of100,test4pub99of100,1,190,5,264,1,270
test4sub83of100,test4pub99of100,1,190,5,270,0,275
test4sub4of100,test4pub99of100,1,190,5,287,0,292
test4sub69of100,test4pub99of100,1,190,5,290,1,296
test4sub39of100,test4pub99of100,1,190,5,298,1,304
test4sub60of100,test4pub99of100,1,190,5,308,1,314
test4sub93of100,test4pub99of100,1,190,5,314,0,319
test4sub43of100,test4pub99of100,1,190,5,319,1,325
test4sub55of100,test4pub99of100,1,190,5,333,1,339
test4sub23of100,test4pub99of100,1,190,5,338,1,344
test4sub5of100,test4pub99of100,1,190,5,339,0,344
test4sub41of100,test4pub99of100,1,190,5,353,0,358
test4sub3of100,test4pub99of100,1,190,5,361,0,366
test4sub10of100,test4pub99of100,1,190,5,370,0,375
test4sub83of100,test4pub100of100,1,191,5,10,1,16
test4sub79of100,test4pub99of100,1,190,5,392,0,397
test4sub12of100,test4pub100of100,1,191,5,19,1,25
test4sub87of100,test4pub100of100,1,191,5,29,1,35
test4sub42of100,test4pub99of100,1,190,5,422,1,428
test4sub68of100,test4pub100of100,1,191,5,47,1,53
test4sub35of100,test4pub100of100,1,191,5,51,1,57
test4sub65of100,test4pub100of100,1,191,5,74,1,80
test4sub33of100,test4pub100of100,1,191,5,82,0,87
test4sub66of100,test4pub100of100,1,191,5,87,1,93
test4sub29of100,test4pub99of100,1,190,5,474,1,480
test4sub73of100,test4pub99of100,1,190,5,477,0,482
test4sub2of100,test4pub99of100,1,190,5,485,1,491
test4sub28of100,test4pub100of100,1,191,5,111,1,117
test4sub16of100,test4pub100of100,1,191,5,128,1,134
test4sub56of100,test4pub99of100,1,190,5,511,0,516
test4sub33of100,test4pub99of100,1,190,5,518,1,524
test4sub87of100,test4pub99of100,1,190,5,521,1,527
test4sub34of100,test4pub99of100,1,190,5,522,1,528
test4sub86of100,test4pub99of100,1,190,5,524,0,529
test4sub7of100,test4pub100of100,1,191,5,148,1,154
test4sub62of100,test4pub99of100,1,190,5,531,0,536
test4sub6of100,test4pub100of100,1,191,5,163,2,170
test4sub13of100,test4pub99of100,1,190,5,544,1,550
test4sub68of100,test4pub99of100,1,190,5,543,2,550
test4sub55of100,test4pub100of100,1,191,5,164,2,171
test4sub8of100,test4pub99of100,1,190,5,546,1,552
test4sub89of100,test4pub100of100,1,191,5,186,1,192
test4sub9of100,test4pub100of100,1,191,5,192,0,197
test4sub30of100,test4pub100of100,1,191,5,202,1,208
test4sub63of100,test4pub100of100,1,191,5,208,0,213
test4sub7of100,test4pub99of100,1,190,5,592,1,598
test4sub73of100,test4pub100of100,1,191,5,215,1,221
test4sub10of100,test4pub100of100,1,191,5,216,1,222
test4sub1of100,test4pub100of100,1,191,5,223,1,229
test4sub81of100,test4pub100of100,1,191,5,226,0,231
test4sub37of100,test4pub100of100,1,191,5,228,0,233
test4sub4of100,test4pub100of100,1,191,5,232,0,237
test4sub49of100,test4pub99of100,1,190,5,623,1,629
test4sub67of100,test4pub100of100,1,191,5,247,1,253
test4sub25of100,test4pub99of100,1,190,5,632,0,637
test4sub11of100,test4pub99of100,1,190,5,647,0,652
test4sub16of100,test4pub99of100,1,190,5,654,1,660
test4sub67of100,test4pub99of100,1,190,5,668,1,674
test4sub52of100,test4pub99of100,1,190,5,670,1,676
test4sub94of100,test4pub99of100,1,190,5,677,0,682
test4sub50of100,test4pub100of100,1,191,5,298,0,303
test4sub46of100,test4pub99of100,1,190,5,681,0,686
test4sub40of100,test4pub99of100,1,190,5,683,1,689
test4sub12of100,test4pub99of100,1,190,5,688,0,693
test4sub59of100,test4pub99of100,1,190,5,694,0,699
test4sub26of100,test4pub100of100,1,191,5,329,1,335
test4sub70of100,test4pub100of100,1,191,5,330,1,336
test4sub82of100,test4pub99of100,1,190,5,713,1,719
test4sub19of100,test4pub100of100,1,191,5,334,1,340
test4sub38of100,test4pub100of100,1,191,5,340,0,345
test4sub36of100,test4pub99of100,1,190,5,724,1,730
test4sub79of100,test4pub100of100,1,191,5,357,0,362
test4sub27of100,test4pub99of100,1,190,5,753,1,759
test4sub96of100,test4pub100of100,1,191,5,375,0,380
test4sub59of100,test4pub100of100,1,191,5,380,1,386
test4sub96of100,test4pub99of100,1,190,5,767,1,773
test4sub22of100,test4pub100of100,1,191,5,397,0,402
test4sub88of100,test4pub99of100,1,190,5,781,1,787
test4sub77of100,test4pub99of100,1,190,5,785,0,790
test4sub21of100,test4pub100of100,1,191,5,411,1,417
test4sub78of100,test4pub99of100,1,190,5,799,0,804
test4sub84of100,test4pub99of100,1,190,5,811,1,817
test4sub57of100,test4pub99of100,1,190,5,817,1,823
test4sub100of100,test4pub99of100,1,190,5,820,1,826
test4sub69of100,test4pub100of100,1,191,5,445,0,450
test4sub20of100,test4pub100of100,1,191,5,449,1,455
test4sub45of100,test4pub99of100,1,190,5,829,1,835
test4sub58of100,test4pub100of100,1,191,5,459,1,465
test4sub46of100,test4pub100of100,1,191,5,461,1,467
test4sub54of100,test4pub99of100,1,190,5,855,1,861
test4sub23of100,test4pub100of100,1,191,5,478,0,483
test4sub85of100,test4pub100of100,1,191,5,483,1,489
test4sub36of100,test4pub100of100,1,191,5,488,0,493
test4sub72of100,test4pub99of100,1,190,5,874,2,881
test4sub9of100,test4pub99of100,1,190,5,875,1,881
test4sub81of100,test4pub99of100,1,190,5,877,1,883
test4sub40of100,test4pub100of100,1,191,5,501,1,507
test4sub71of100,test4pub100of100,1,191,5,508,1,514
test4sub64of100,test4pub100of100,1,191,5,512,1,518
test4sub99of100,test4pub100of100,1,191,5,512,1,518
test4sub88of100,test4pub100of100,1,191,5,541,1,547
test4sub31of100,test4pub100of100,1,191,5,542,1,548
test4sub60of100,test4pub100of100,1,191,5,548,0,553
test4sub17of100,test4pub100of100,1,191,5,553,1,559
test4sub75of100,test4pub100of100,1,191,5,568,0,573
test4sub90of100,test4pub100of100,1,191,5,573,1,579
test4sub18of100,test4pub100of100,1,191,5,576,6,587
test4sub51of100,test4pub100of100,1,191,5,582,1,588
test4sub45of100,test4pub100of100,1,191,5,586,0,591
test4sub77of100,test4pub100of100,1,191,5,591,1,597
test4sub93of100,test4pub100of100,1,191,5,592,0,597
test4sub25of100,test4pub100of100,1,191,5,599,1,605
test4sub80of100,test4pub100of100,1,191,5,607,1,613
test4sub15of100,test4pub100of100,1,191,5,619,1,625
test4sub41of100,test4pub100of100,1,191,5,629,1,635
test4sub100of100,test4pub100of100,1,191,5,638,1,644
test4sub86of100,test4pub100of100,1,191,5,649,1,655
test4sub84of100,test4pub100of100,1,191,5,655,1,661
test4sub2of100,test4pub100of100,1,191,5,661,1,667
test4sub32of100,test4pub100of100,1,191,5,664,1,670
test4sub57of100,test4pub100of100,1,191,5,669,1,675
test4sub8of100,test4pub100of100,1,191,5,674,1,680
test4sub56of100,test4pub100of100,1,191,5,689,1,695
test4sub47of100,test4pub100of100,1,191,5,690,0,695
test4sub3of100,test4pub100of100,1,191,5,698,1,704
test4sub13of100,test4pub100of100,1,191,5,701,0,706
test4sub74of100,test4pub100of100,1,191,5,708,1,714
test4sub14of100,test4pub100of100,1,191,5,710,1,716
test4sub48of100,test4pub100of100,1,191,5,728,1,734
test4sub5of100,test4pub100of100,1,191,5,730,0,735
test4sub61of100,test4pub100of100,1,191,5,731,1,737
test4sub42of100,test4pub100of100,1,191,5,734,1,740
test4sub39of100,test4pub100of100,1,191,5,743,1,749
test4sub76of100,test4pub100of100,1,191,5,750,1,756
test4sub95of100,test4pub100of100,1,191,5,754,1,760
test4sub52of100,test4pub100of100,1,191,5,756,2,763
test4sub92of100,test4pub100of100,1,191,5,756,1,762
test4sub54of100,test4pub100of100,1,191,5,768,1,774
test4sub78of100,test4pub100of100,1,191,5,774,0,779
test4sub91of100,test4pub100of100,1,191,5,787,0,792
test4sub43of100,test4pub100of100,1,191,5,789,1,795
test4sub24of100,test4pub100of100,1,191,5,791,1,797
test4sub97of100,test4pub100of100,1,191,5,809,1,815
test4sub82of100,test4pub100of100,1,191,5,811,1,817
test4sub72of100,test4pub100of100,1,191,5,813,1,819
test4sub98of100,test4pub100of100,1,191,5,818,1,824
test4sub49of100,test4pub100of100,1,191,5,821,0,826
test4sub11of100,test4pub100of100,1,191,5,837,0,842
test4sub27of100,test4pub100of100,1,191,5,844,1,850
test4sub29of100,test4pub100of100,1,191,5,848,1,854
test4sub94of100,test4pub100of100,1,191,5,858,0,863
test4sub53of100,test4pub100of100,1,191,5,863,0,868
test4sub62of100,test4pub100of100,1,191,5,868,0,873
test4sub34of100,test4pub100of100,1,191,5,870,1,876
test4sub44of100,test4pub100of100,1,191,5,876,1,882
test4sub75of100,test4pub1of100,10,1469,12,18,42,72
test4sub13of100,test4pub1of100,10,1469,12,19,81,112
test4sub1of100,test4pub1of100,10,1469,12,32,108,152
test4sub94of100,test4pub2of100,10,190,6,20,102,128
test4sub88of100,test4pub2of100,10,190,6,39,83,128
test4sub68of100,test4pub3of100,10,190,5,32,69,106
test4sub87of100,test4pub1of100,10,1469,12,78,102,192
test4sub96of100,test4pub3of100,10,190,5,42,99,146
test4sub48of100,test4pub2of100,10,190,6,67,96,169
test4sub29of100,test4pub5of100,10,190,5,24,92,121
test4sub95of100,test4pub5of100,10,190,5,27,88,120
test4sub86of100,test4pub5of100,10,190,5,28,88,121
test4sub41of100,test4pub2of100,10,190,6,88,77,171
test4sub51of100,test4pub6of100,10,190,6,18,76,100
test4sub73of100,test4pub3of100,10,190,5,71,75,151
test4sub81of100,test4pub7of100,10,190,5,10,68,83
test4sub92of100,test4pub4of100,10,190,5,67,66,138
test4sub40of100,test4pub7of100,10,190,5,15,66,86
test4sub44of100,test4pub3of100,10,190,5,93,56,154
test4sub89of100,test4pub6of100,10,190,6,43,55,104
test4sub1of100,test4pub6of100,10,190,6,49,49,104
test4sub58of100,test4pub7of100,10,190,5,33,49,87
test4sub14of100,test4pub1of100,10,1469,12,147,84,243
test4sub13of100,test4pub7of100,10,190,5,49,74,128
test4sub31of100,test4pub7of100,10,190,5,54,70,129
test4sub69of100,test4pub7of100,10,190,5,56,69,130
test4sub54of100,test4pub6of100,10,190,6,73,68,147
test4sub25of100,test4pub2of100,10,190,6,155,59,220
test4sub62of100,test4pub10of100,10,191,6,13,59,78
test4sub26of100,test4pub10of100,10,191,6,16,55,77
test4sub87of100,test4pub2of100,10,190,6,162,53,221
test4sub93of100,test4pub2of100,10,190,6,163,54,223
test4sub7of100,test4pub5of100,10,190,5,118,90,213
test4sub8of100,test4pub3of100,10,190,5,147,91,243
test4sub20of100,test4pub6of100,10,190,6,96,91,193
test4sub48of100,test4pub1of100,10,1469,12,183,97,292
test4sub78of100,test4pub11of100,10,191,5,17,87,109
test4sub44of100,test4pub7of100,10,190,5,81,91,177
test4sub28of100,test4pub1of100,10,1469,12,200,119,331
test4sub100of100,test4pub10of100,10,191,6,40,117,163
test4sub66of100,test4pub8of100,10,190,5,83,117,205
test4sub65of100,test4pub6of100,10,190,6,126,103,235
test4sub45of100,test4pub6of100,10,190,6,127,103,236
test4sub23of100,test4pub4of100,10,190,5,174,93,272
test4sub64of100,test4pub7of100,10,190,5,130,83,218
test4sub47of100,test4pub3of100,10,190,5,200,83,288
test4sub9of100,test4pub2of100,10,190,6,228,76,310
test4sub70of100,test4pub2of100,10,190,6,249,57,312
test4sub51of100,test4pub2of100,10,190,6,249,57,312
test4sub3of100,test4pub2of100,10,190,6,250,56,312
test4sub17of100,test4pub13of100,10,191,5,63,54,122
test4sub35of100,test4pub6of100,10,190,6,180,54,240
test4sub76of100,test4pub5of100,10,190,5,205,54,264
test4sub69of100,test4pub4of100,10,190,5,220,53,278
test4sub82of100,test4pub12of100,10,191,5,80,51,136
test4sub7of100,test4pub1of100,10,1469,12,277,91,380
test4sub19of100,test4pub12of100,10,191,5,81,90,176
test4sub44of100,test4pub5of100,10,190,5,214,87,306
test4sub50of100,test4pub5of100,10,190,5,214,87,306
test4sub20of100,test4pub1of100,10,1469,12,286,122,420
test4sub78of100,test4pub8of100,10,190,5,167,122,294
test4sub16of100,test4pub8of100,10,190,5,167,122,294
test4sub61of100,test4pub2of100,10,190,6,272,120,398
test4sub79of100,test4pub14of100,10,191,5,56,120,181
test4sub58of100,test4pub9of100,10,190,5,156,126,287
test4sub21of100,test4pub2of100,10,190,6,275,125,406
test4sub41of100,test4pub15of100,10,191,5,21,119,145
test4sub63of100,test4pub14of100,10,191,5,69,115,189
test4sub26of100,test4pub13of100,10,191,5,98,113,216
test4sub46of100,test4pub2of100,10,190,6,299,103,408
test4sub100of100,test4pub12of100,10,191,5,124,100,229
test4sub45of100,test4pub7of100,10,190,5,214,99,318
test4sub47of100,test4pub7of100,10,190,5,215,98,318
test4sub9of100,test4pub8of100,10,190,5,204,98,307
test4sub51of100,test4pub5of100,10,190,5,258,98,361
test4sub76of100,test4pub11of100,10,191,5,152,96,253
test4sub11of100,test4pub13of100,10,191,5,139,77,221
test4sub34of100,test4pub17of100,10,191,6,34,76,116
test4sub86of100,test4pub2of100,10,190,6,340,68,414
test4sub17of100,test4pub5of100,10,190,5,291,67,363
test4sub7of100,test4pub14of100,10,191,5,133,58,196
test4sub19of100,test4pub5of100,10,190,5,301,58,364
test4sub66of100,test4pub7of100,10,190,5,270,49,324
test4sub5of100,test4pub2of100,10,190,6,367,42,415
test4sub55of100,test4pub5of100,10,190,5,322,39,366
test4sub24of100,test4pub15of100,10,191,5,115,38,158
test4sub48of100,test4pub3of100,10,190,5,359,33,397
test4sub73of100,test4pub13of100,10,191,5,189,32,226
test4sub62of100,test4pub6of100,10,190,6,310,31,347
test4sub59of100,test4pub4of100,10,190,5,353,24,382
test4sub94of100,test4pub4of100,10,190,5,354,24,383
test4sub16of100,test4pub3of100,10,190,5,371,23,399
test4sub95of100,test4pub12of100,10,191,5,222,16,243
test4sub47of100,test4pub4of100,10,190,5,368,13,386
test4sub9of100,test4pub11of100,10,191,5,247,12,264
test4sub21of100,test4pub17of100,10,191,6,111,10,127
test4sub19of100,test4pub7of100,10,190,5,319,8,332
test4sub5of100,test4pub13of100,10,191,5,220,7,232
test4sub55of100,test4pub17of100,10,191,6,115,7,128
test4sub71of100,test4pub15of100,10,191,5,155,4,164
test4sub2of100,test4pub15of100,10,191,5,155,4,164
test4sub84of100,test4pub3of100,10,190,5,401,0,406
test4sub91of100,test4pub5of100,10,190,5,381,1,387
test4sub76of100,test4pub9of100,10,190,5,315,1,321
test4sub61of100,test4pub7of100,10,190,5,346,0,351
test4sub96of100,test4pub7of100,10,190,5,348,0,353
test4sub50of100,test4pub3of100,10,190,5,422,0,427
test4sub19of100,test4pub8of100,10,190,5,343,0,348
test4sub85of100,test4pub16of100,10,191,5,167,1,173
test4sub1of100,test4pub5of100,10,190,5,402,1,408
test4sub39of100,test4pub5of100,10,190,5,404,1,410
test4sub40of100,test4pub14of100,10,191,5,244,1,250
test4sub96of100,test4pub12of100,10,191,5,305,1,311
test4sub1of100,test4pub13of100,10,191,5,294,1,300
test4sub93of100,test4pub11of100,10,191,5,329,2,336
test4sub12of100,test4pub6of100,10,190,6,414,2,422
test4sub90of100,test4pub11of100,10,191,5,330,2,337
test4sub32of100,test4pub12of100,10,191,5,310,2,317
test4sub55of100,test4pub10of100,10,191,6,352,1,359
test4sub34of100,test4pub10of100,10,191,6,355,1,362
test4sub33of100,test4pub5of100,10,190,5,458,1,464
test4sub82of100,test4pub2of100,10,190,6,508,1,515
test4sub61of100,test4pub17of100,10,191,6,214,0,220
test4sub59of100,test4pub3of100,10,190,5,495,1,501
test4sub6of100,test4pub10of100,10,191,6,381,1,388
test4sub15of100,test4pub2of100,10,190,6,526,1,533
test4sub2of100,test4pub13of100,10,191,5,338,1,344
test4sub17of100,test4pub10of100,10,191,6,390,1,397
test4sub5of100,test4pub1of100,10,1469,12,559,42,613
test4sub13of100,test4pub14of100,10,191,5,326,39,370
test4sub85of100,test4pub14of100,10,191,5,326,39,370
test4sub83of100,test4pub3of100,10,190,5,526,36,567
test4sub11of100,test4pub11of100,10,191,5,395,31,431
test4sub51of100,test4pub11of100,10,191,5,398,28,431
test4sub57of100,test4pub12of100,10,191,5,380,25,410
test4sub82of100,test4pub4of100,10,190,5,523,24,552
test4sub68of100,test4pub15of100,10,191,5,304,21,330
test4sub96of100,test4pub6of100,10,190,6,502,9,517
test4sub82of100,test4pub15of100,10,191,5,325,1,331
test4sub28of100,test4pub15of100,10,191,5,329,1,335
test4sub98of100,test4pub15of100,10,191,5,334,0,339
test4sub95of100,test4pub15of100,10,191,5,338,1,344
test4sub39of100,test4pub6of100,10,190,6,525,1,532
test4sub17of100,test4pub6of100,10,190,6,530,3,539
test4sub11of100,test4pub6of100,10,190,6,531,4,541
test4sub89of100,test4pub15of100,10,191,5,345,3,353
test4sub51of100,test4pub15of100,10,191,5,345,3,353
test4sub45of100,test4pub15of100,10,191,5,346,3,354
test4sub55of100,test4pub15of100,10,191,5,346,2,353
test4sub91of100,test4pub3of100,10,190,5,586,3,594
test4sub73of100,test4pub11of100,10,191,5,456,1,462
test4sub90of100,test4pub4of100,10,190,5,577,1,583
test4sub21of100,test4pub3of100,10,190,5,596,1,602
test4sub35of100,test4pub9of100,10,190,5,503,0,508
test4sub4of100,test4pub10of100,10,191,6,488,1,495
test4sub13of100,test4pub6of100,10,190,6,561,0,567
test4sub37of100,test4pub3of100,10,190,5,617,1,623
test4sub32of100,test4pub11of100,10,191,5,489,2,496
test4sub28of100,test4pub7of100,10,190,5,557,2,564
test4sub50of100,test4pub12of100,10,191,5,469,2,476
test4sub41of100,test4pub9of100,10,190,5,531,3,539
test4sub21of100,test4pub12of100,10,191,5,471,3,479
test4sub71of100,test4pub5of100,10,190,5,601,1,607
test4sub75of100,test4pub4of100,10,190,5,614,2,621
test4sub16of100,test4pub2of100,10,190,6,658,1,665
test4sub60of100,test4pub11of100,10,191,5,503,1,509
test4sub30of100,test4pub13of100,10,191,5,472,1,478
test4sub48of100,test4pub11of100,10,191,5,506,1,512
test4sub76of100,test4pub2of100,10,190,6,664,1,671
test4sub72of100,test4pub12of100,10,191,5,488,2,495
test4sub36of100,test4pub16of100,10,191,5,386,1,392
test4sub43of100,test4pub10of100,10,191,6,541,0,547
test4sub62of100,test4pub12of100,10,191,5,511,0,516
test4sub98of100,test4pub13of100,10,191,5,512,0,517
test4sub31of100,test4pub11of100,10,191,5,550,1,556
test4sub24of100,test4pub17of100,10,191,6,421,1,428
test4sub14of100,test4pub6of100,10,190,6,645,1,652
test4sub53of100,test4pub9of100,10,190,5,601,2,608
test4sub4of100,test4pub17of100,10,191,6,424,3,433
test4sub98of100,test4pub11of100,10,191,5,563,2,570
test4sub5of100,test4pub12of100,10,191,5,543,2,550
test4sub71of100,test4pub8of100,10,190,5,633,1,639
test4sub78of100,test4pub5of100,10,190,5,695,1,701
test4sub62of100,test4pub11of100,10,191,5,589,1,595
test4sub54of100,test4pub11of100,10,191,5,589,2,596
test4sub52of100,test4pub13of100,10,191,5,558,1,564
test4sub85of100,test4pub2of100,10,190,6,753,0,759
test4sub77of100,test4pub4of100,10,190,5,724,1,730
test4sub44of100,test4pub13of100,10,191,5,572,0,577
test4sub90of100,test4pub3of100,10,190,5,749,1,755
test4sub8of100,test4pub8of100,10,190,5,674,1,680
test4sub67of100,test4pub3of100,10,190,5,774,1,780
test4sub14of100,test4pub3of100,10,190,5,778,1,784
test4sub65of100,test4pub4of100,10,190,5,764,1,770
test4sub21of100,test4pub16of100,10,191,5,521,1,527
test4sub12of100,test4pub16of100,10,191,5,522,1,528
test4sub48of100,test4pub9of100,10,190,5,694,1,700
test4sub98of100,test4pub1of100,10,1469,12,849,40,901
test4sub23of100,test4pub6of100,10,190,6,761,37,804
test4sub41of100,test4pub11of100,10,191,5,681,33,719
test4sub18of100,test4pub15of100,10,191,5,581,31,617
test4sub95of100,test4pub4of100,10,190,5,808,27,840
test4sub32of100,test4pub10of100,10,191,6,708,21,735
test4sub86of100,test4pub10of100,10,191,6,709,20,735
test4sub27of100,test4pub3of100,10,190,5,841,11,857
test4sub82of100,test4pub11of100,10,191,5,708,8,721
test4sub64of100,test4pub16of100,10,191,5,587,6,598
test4sub36of100,test4pub4of100,10,190,5,834,3,842
test4sub26of100,test4pub5of100,10,190,5,830,0,835
test4sub30of100,test4pub9of100,10,190,5,763,0,768
test4sub77of100,test4pub11of100,10,191,5,728,1,734
test4sub56of100,test4pub7of100,10,190,5,796,1,802
test4sub64of100,test4pub17of100,10,191,6,591,0,597
test4sub4of100,test4pub16of100,10,191,5,612,0,617
test4sub74of100,test4pub17of100,10,191,6,606,1,613
test4sub17of100,test4pub3of100,10,190,5,884,1,890
test4sub68of100,test4pub4of100,10,190,5,874,1,880
test4sub40of100,test4pub16of100,10,191,5,639,1,645
test4sub66of100,test4pub1of100,10,1469,12,945,38,995
test4sub37of100,test4pub4of100,10,190,5,902,27,934
test4sub26of100,test4pub9of100,10,190,5,826,21,852
test4sub21of100,test4pub9of100,10,190,5,832,17,854
test4sub74of100,test4pub1of100,10,1469,12,969,56,1037
test4sub34of100,test4pub11of100,10,191,5,807,41,853
test4sub49of100,test4pub14of100,10,191,5,751,38,794
test4sub62of100,test4pub3of100,10,190,5,949,36,990
test4sub25of100,test4pub7of100,10,190,5,884,34,923
test4sub88of100,test4pub3of100,10,190,5,956,31,992
test4sub97of100,test4pub15of100,10,191,5,721,27,753
test4sub55of100,test4pub3of100,10,190,5,966,21,992
test4sub51of100,test4pub3of100,10,190,5,967,20,992
test4sub45of100,test4pub3of100,10,190,5,969,20,994
test4sub49of100,test4pub5of100,10,190,5,958,2,965
test4sub29of100,test4pub7of100,10,190,5,922,1,928
test4sub64of100,test4pub8of100,10,190,5,917,2,924
test4sub65of100,test4pub15of100,10,191,5,760,1,766
test4sub30of100,test4pub15of100,10,191,5,761,2,768
test4sub1of100,test4pub11of100,10,191,5,865,1,871
test4sub78of100,test4pub15of100,10,191,5,765,1,771
test4sub19of100,test4pub4of100,10,190,5,995,1,1001
test4sub35of100,test4pub16of100,10,191,5,752,0,757
test4sub2of100,test4pub12of100,10,191,5,860,1,866
test4sub86of100,test4pub15of100,10,191,5,780,0,785
test4sub23of100,test4pub13of100,10,191,5,852,1,858
test4sub38of100,test4pub9of100,10,190,5,934,1,940
test4sub14of100,test4pub16of100,10,191,5,773,1,779
test4sub70of100,test4pub11of100,10,191,5,897,0,902
test4sub74of100,test4pub10of100,10,191,6,913,1,920
test4sub86of100,test4pub7of100,10,190,5,972,1,978
test4sub11of100,test4pub12of100,10,191,5,887,1,893
test4sub57of100,test4pub6of100,10,190,6,993,0,999
test4sub76of100,test4pub4of100,10,190,5,1035,0,1040
test4sub53of100,test4pub16of100,10,191,5,798,1,804
test4sub64of100,test4pub14of100,10,191,5,861,1,867
test4sub99of100,test4pub4of100,10,190,5,1048,0,1053
test4sub65of100,test4pub3of100,10,190,5,1064,1,1070
test4sub83of100,test4pub6of100,10,190,6,1019,0,1025
test4sub34of100,test4pub15of100,10,191,5,836,1,842
test4sub33of100,test4pub11of100,10,191,5,944,1,950
test4sub25of100,test4pub10of100,10,191,6,959,1,966
test4sub59of100,test4pub16of100,10,191,5,826,1,832
test4sub16of100,test4pub7of100,10,190,5,1022,0,1027
test4sub64of100,test4pub10of100,10,191,6,977,1,984
test4sub92of100,test4pub2of100,10,190,6,1122,1,1129
test4sub16of100,test4pub11of100,10,191,5,966,1,972
test4sub60of100,test4pub4of100,10,190,5,1092,1,1098
test4sub87of100,test4pub6of100,10,190,6,1058,1,1065
test4sub37of100,test4pub6of100,10,190,6,1060,1,1067
test4sub91of100,test4pub11of100,10,191,5,988,1,994
test4sub4of100,test4pub4of100,10,190,5,1114,0,1119
test4sub80of100,test4pub5of100,10,190,5,1103,1,1109
test4sub58of100,test4pub5of100,10,190,5,1105,1,1111
test4sub73of100,test4pub7of100,10,190,5,1070,1,1076
test4sub99of100,test4pub14of100,10,191,5,944,1,950
test4sub27of100,test4pub9of100,10,190,5,1046,1,1052
test4sub23of100,test4pub10of100,10,191,6,1021,1,1028
test4sub96of100,test4pub5of100,10,190,5,1119,0,1124
test4sub98of100,test4pub7of100,10,190,5,1082,1,1088
test4sub41of100,test4pub1of100,10,1469,12,1195,41,1248
test4sub62of100,test4pub8of100,10,190,5,1077,39,1121
test4sub34of100,test4pub13of100,10,191,5,1004,23,1032
test4sub26of100,test4pub16of100,10,191,5,916,23,944
test4sub46of100,test4pub12of100,10,191,5,1027,13,1045
test4sub28of100,test4pub12of100,10,191,5,1028,13,1046
test4sub78of100,test4pub1of100,10,1469,12,1230,46,1288
test4sub84of100,test4pub13of100,10,191,5,1031,35,1071
test4sub22of100,test4pub11of100,10,191,5,1066,35,1106
test4sub59of100,test4pub6of100,10,190,6,1155,32,1193
test4sub93of100,test4pub6of100,10,190,6,1157,31,1194
test4sub39of100,test4pub4of100,10,190,5,1195,30,1230
test4sub32of100,test4pub15of100,10,191,5,987,14,1006
test4sub17of100,test4pub1of100,10,1469,12,1270,51,1333
test4sub78of100,test4pub9of100,10,190,5,1140,44,1189
test4sub61of100,test4pub12of100,10,191,5,1081,44,1130
test4sub67of100,test4pub12of100,10,191,5,1082,44,1131
test4sub45of100,test4pub5of100,10,190,5,1214,40,1259
test4sub55of100,test4pub7of100,10,190,5,1187,27,1219
test4sub49of100,test4pub15of100,10,191,5,1019,26,1050
test4sub16of100,test4pub1of100,10,1469,12,1305,59,1376
test4sub87of100,test4pub17of100,10,191,6,992,57,1055
test4sub83of100,test4pub5of100,10,190,5,1241,56,1302
test4sub30of100,test4pub3of100,10,190,5,1269,56,1330
test4sub89of100,test4pub2of100,10,190,6,1298,49,1353
test4sub71of100,test4pub9of100,10,190,5,1183,47,1235
test4sub41of100,test4pub3of100,10,190,5,1281,46,1332
test4sub12of100,test4pub14of100,10,191,5,1093,39,1137
test4sub99of100,test4pub13of100,10,191,5,1124,34,1163
test4sub90of100,test4pub16of100,10,191,5,1038,32,1075
test4sub34of100,test4pub1of100,10,1469,12,1351,57,1420
test4sub61of100,test4pub4of100,10,190,5,1300,54,1359
test4sub10of100,test4pub4of100,10,190,5,1311,43,1359
test4sub1of100,test4pub3of100,10,190,5,1332,38,1375
test4sub79of100,test4pub4of100,10,190,5,1321,35,1361
test4sub26of100,test4pub17of100,10,191,6,1064,32,1102
test4sub11of100,test4pub4of100,10,190,5,1329,27,1361
test4sub49of100,test4pub11of100,10,191,5,1212,24,1241
test4sub12of100,test4pub8of100,10,190,5,1269,22,1296
test4sub60of100,test4pub1of100,10,1469,12,1396,56,1464
test4sub37of100,test4pub1of100,10,1469,12,1400,93,1505
test4sub31of100,test4pub17of100,10,191,6,1086,93,1185
test4sub65of100,test4pub17of100,10,191,6,1087,92,1185
test4sub47of100,test4pub9of100,10,190,5,1269,89,1363
test4sub3of100,test4pub16of100,10,191,5,1110,86,1201
test4sub27of100,test4pub7of100,10,190,5,1308,79,1392
test4sub91of100,test4pub7of100,10,190,5,1309,80,1394
test4sub89of100,test4pub4of100,10,190,5,1367,75,1447
test4sub44of100,test4pub10of100,10,191,6,1264,72,1342
test4sub33of100,test4pub15of100,10,191,5,1164,57,1226
test4sub32of100,test4pub1of100,10,1469,12,1456,84,1552
test4sub21of100,test4pub11of100,10,191,5,1287,78,1370
test4sub93of100,test4pub16of100,10,191,5,1164,78,1247
test4sub59of100,test4pub12of100,10,191,5,1268,76,1349
test4sub70of100,test4pub5of100,10,190,5,1400,75,1480
test4sub61of100,test4pub6of100,10,190,6,1377,74,1457
test4sub74of100,test4pub15of100,10,191,5,1204,60,1269
test4sub13of100,test4pub10of100,10,191,6,1326,55,1387
test4sub20of100,test4pub17of100,10,191,6,1178,50,1234
test4sub47of100,test4pub17of100,10,191,6,1180,48,1234
test4sub12of100,test4pub13of100,10,191,5,1286,50,1341
test4sub82of100,test4pub14of100,10,191,5,1261,49,1315
test4sub91of100,test4pub15of100,10,191,5,1219,49,1273
test4sub3of100,test4pub1of100,10,1469,12,1500,88,1600
test4sub84of100,test4pub7of100,10,190,5,1392,87,1484
test4sub36of100,test4pub12of100,10,191,5,1306,86,1397
test4sub85of100,test4pub9of100,10,190,5,1375,77,1457
test4sub15of100,test4pub5of100,10,190,5,1444,78,1527
test4sub64of100,test4pub5of100,10,190,5,1445,77,1527
test4sub30of100,test4pub6of100,10,190,6,1421,78,1505
test4sub58of100,test4pub14of100,10,191,5,1280,75,1360
test4sub38of100,test4pub6of100,10,190,6,1446,55,1507
test4sub21of100,test4pub10of100,10,191,6,1378,51,1435
test4sub47of100,test4pub5of100,10,190,5,1477,48,1530
test4sub57of100,test4pub2of100,10,190,6,1526,49,1581
test4sub12of100,test4pub15of100,10,191,5,1267,48,1320
test4sub82of100,test4pub6of100,10,190,6,1455,48,1509
test4sub27of100,test4pub12of100,10,191,5,1352,46,1403
test4sub8of100,test4pub15of100,10,191,5,1273,43,1321
test4sub22of100,test4pub15of100,10,191,5,1276,42,1323
test4sub2of100,test4pub16of100,10,191,5,1257,42,1304
test4sub91of100,test4pub8of100,10,190,5,1436,41,1482
test4sub80of100,test4pub17of100,10,191,6,1243,39,1288
test4sub14of100,test4pub11of100,10,191,5,1397,25,1427
test4sub9of100,test4pub15of100,10,191,5,1297,23,1325
test4sub23of100,test4pub3of100,10,190,5,1540,20,1565
test4sub26of100,test4pub14of100,10,191,5,1350,15,1370
test4sub3of100,test4pub4of100,10,190,5,1534,11,1550
test4sub15of100,test4pub14of100,10,191,5,1355,10,1370
test4sub21of100,test4pub4of100,10,190,5,1538,8,1551
test4sub25of100,test4pub14of100,10,191,5,1360,5,1370
test4sub14of100,test4pub8of100,10,190,5,1478,2,1485
test4sub48of100,test4pub12of100,10,191,5,1419,1,1425
test4sub50of100,test4pub9of100,10,190,5,1484,1,1490
test4sub85of100,test4pub11of100,10,191,5,1450,1,1456
test4sub99of100,test4pub11of100,10,191,5,1452,1,1458
test4sub72of100,test4pub10of100,10,191,6,1468,1,1475
test4sub94of100,test4pub9of100,10,190,5,1495,2,1502
test4sub32of100,test4pub6of100,10,190,6,1541,1,1548
test4sub87of100,test4pub3of100,10,190,5,1597,1,1603
test4sub63of100,test4pub3of100,10,190,5,1597,1,1603
test4sub85of100,test4pub15of100,10,191,5,1361,1,1367
test4sub69of100,test4pub12of100,10,191,5,1451,0,1456
test4sub100of100,test4pub5of100,10,190,5,1584,0,1589
test4sub20of100,test4pub5of100,10,190,5,1589,1,1595
test4sub75of100,test4pub5of100,10,190,5,1590,0,1595
test4sub46of100,test4pub4of100,10,190,5,1604,0,1609
test4sub70of100,test4pub13of100,10,191,5,1451,0,1456
test4sub6of100,test4pub9of100,10,190,5,1529,1,1535
test4sub23of100,test4pub11of100,10,191,5,1490,0,1495
test4sub18of100,test4pub2of100,10,190,6,1666,1,1673
test4sub51of100,test4pub13of100,10,191,5,1476,0,1481
test4sub79of100,test4pub12of100,10,191,5,1493,1,1499
test4sub60of100,test4pub16of100,10,191,5,1392,1,1398
test4sub55of100,test4pub16of100,10,191,5,1396,1,1402
test4sub18of100,test4pub1of100,10,1469,12,1706,38,1756
test4sub51of100,test4pub7of100,10,190,5,1600,36,1641
test4sub71of100,test4pub13of100,10,191,5,1501,34,1540
test4sub1of100,test4pub8of100,10,190,5,1594,31,1630
test4sub88of100,test4pub15of100,10,191,5,1439,27,1471
test4sub45of100,test4pub17of100,10,191,6,1416,16,1438
test4sub34of100,test4pub8of100,10,190,5,1612,13,1630
test4sub60of100,test4pub12of100,10,191,5,1536,13,1554
test4sub92of100,test4pub16of100,10,191,5,1437,12,1454
test4sub14of100,test4pub7of100,10,190,5,1640,1,1646
test4sub88of100,test4pub16of100,10,191,5,1456,0,1461
test4sub43of100,test4pub5of100,10,190,5,1687,1,1693
test4sub39of100,test4pub8of100,10,190,5,1640,1,1646
test4sub6of100,test4pub16of100,10,191,5,1464,1,1470
test4sub86of100,test4pub11of100,10,191,5,1591,1,1597
test4sub88of100,test4pub11of100,10,191,5,1591,1,1597
test4sub75of100,test4pub3of100,10,190,5,1733,1,1739
test4sub57of100,test4pub8of100,10,190,5,1653,1,1659
test4sub56of100,test4pub3of100,10,190,5,1737,1,1743
test4sub64of100,test4pub2of100,10,190,6,1762,0,1768
test4sub80of100,test4pub14of100,10,191,5,1553,0,1558
test4sub41of100,test4pub16of100,10,191,5,1492,1,1498
test4sub77of100,test4pub3of100,10,190,5,1759,1,1765
test4sub46of100,test4pub6of100,10,190,6,1709,1,1716
test4sub17of100,test4pub8of100,10,190,5,1682,0,1687
test4sub88of100,test4pub14of100,10,191,5,1582,1,1588
test4sub8of100,test4pub14of100,10,191,5,1584,2,1591
test4sub65of100,test4pub2of100,10,190,6,1802,1,1809
test4sub78of100,test4pub2of100,10,190,6,1802,2,1810
test4sub53of100,test4pub6of100,10,190,6,1741,1,1748
test4sub73of100,test4pub10of100,10,191,6,1677,1,1684
test4sub33of100,test4pub2of100,10,190,6,1827,1,1834
test4sub50of100,test4pub6of100,10,190,6,1761,1,1768
test4sub67of100,test4pub17of100,10,191,6,1543,1,1550
test4sub4of100,test4pub9of100,10,190,5,1721,1,1727
test4sub85of100,test4pub10of100,10,191,6,1697,1,1704
test4sub64of100,test4pub9of100,10,190,5,1727,1,1733
test4sub51of100,test4pub16of100,10,191,5,1570,1,1576
test4sub83of100,test4pub4of100,10,190,5,1815,0,1820
test4sub78of100,test4pub17of100,10,191,6,1570,1,1577
test4sub40of100,test4pub11of100,10,191,5,1710,1,1716
test4sub20of100,test4pub16of100,10,191,5,1591,1,1597
test4sub61of100,test4pub15of100,10,191,5,1612,1,1618
test4sub75of100,test4pub6of100,10,190,6,1803,1,1810
test4sub59of100,test4pub8of100,10,190,5,1782,1,1788
test4sub81of100,test4pub5of100,10,190,5,1837,2,1844
test4sub11of100,test4pub5of100,10,190,5,1837,1,1843
test4sub29of100,test4pub11of100,10,191,5,1731,1,1737
test4sub10of100,test4pub7of100,10,190,5,1798,1,1804
test4sub63of100,test4pub11of100,10,191,5,1733,0,1738
test4sub51of100,test4pub1of100,10,1469,12,1925,39,1976
test4sub37of100,test4pub15of100,10,191,5,1647,40,1692
test4sub92of100,test4pub3of100,10,190,5,1888,37,1930
test4sub79of100,test4pub3of100,10,190,5,1891,36,1932
test4sub18of100,test4pub11of100,10,191,5,1759,32,1796
test4sub27of100,test4pub2of100,10,190,6,1923,24,1953
test4sub10of100,test4pub8of100,10,190,5,1824,23,1852
test4sub24of100,test4pub13of100,10,191,5,1737,21,1763
test4sub90of100,test4pub7of100,10,190,5,1845,14,1864
test4sub98of100,test4pub9of100,10,190,5,1828,4,1837
test4sub74of100,test4pub9of100,10,190,5,1841,1,1847
test4sub4of100,test4pub2of100,10,190,6,1958,1,1965
test4sub39of100,test4pub14of100,10,191,5,1746,1,1752
test4sub22of100,test4pub17of100,10,191,6,1670,2,1678
test4sub81of100,test4pub13of100,10,191,5,1776,1,1782
test4sub62of100,test4pub13of100,10,191,5,1776,1,1782
test4sub91of100,test4pub4of100,10,190,5,1934,1,1940
test4sub38of100,test4pub8of100,10,190,5,1869,0,1874
test4sub79of100,test4pub2of100,10,190,6,1978,1,1985
test4sub100of100,test4pub15of100,10,191,5,1724,2,1731
test4sub32of100,test4pub4of100,10,190,5,1954,1,1960
test4sub93of100,test4pub3of100,10,190,5,1969,2,1976
test4sub26of100,test4pub15of100,10,191,5,1731,1,1737
test4sub62of100,test4pub4of100,10,190,5,1963,1,1969
test4sub98of100,test4pub16of100,10,191,5,1720,1,1726
test4sub44of100,test4pub15of100,10,191,5,1745,1,1751
test4sub47of100,test4pub10of100,10,191,6,1867,0,1873
test4sub76of100,test4pub3of100,10,190,5,1991,2,1998
test4sub55of100,test4pub9of100,10,190,5,1895,1,1901
test4sub70of100,test4pub16of100,10,191,5,1745,1,1751
test4sub3of100,test4pub17of100,10,191,6,1729,1,1736
test4sub49of100,test4pub13of100,10,191,5,1842,1,1848
test4sub95of100,test4pub2of100,10,190,6,2036,0,2042
test4sub53of100,test4pub2of100,10,190,6,2037,1,2044
test4sub73of100,test4pub5of100,10,190,5,1992,1,1998
test4sub100of100,test4pub7of100,10,190,5,1952,1,1958
test4sub81of100,test4pub16of100,10,191,5,1764,1,1770
test4sub4of100,test4pub5of100,10,190,5,2005,0,2010
test4sub63of100,test4pub10of100,10,191,6,1912,1,1919
test4sub15of100,test4pub9of100,10,190,5,1941,0,1946
test4sub51of100,test4pub8of100,10,190,5,1960,0,1965
test4sub44of100,test4pub4of100,10,190,5,2030,1,2036
test4sub72of100,test4pub3of100,10,190,5,2056,2,2063
test4sub93of100,test4pub4of100,10,190,5,2042,0,2047
test4sub15of100,test4pub4of100,10,190,5,2045,1,2051
test4sub38of100,test4pub12of100,10,191,5,1914,1,1920
test4sub80of100,test4pub12of100,10,191,5,1917,0,1922
test4sub54of100,test4pub12of100,10,191,5,1920,1,1926
test4sub76of100,test4pub12of100,10,191,5,1924,1,1930
test4sub78of100,test4pub12of100,10,191,5,1924,1,1930
test4sub80of100,test4pub15of100,10,191,5,1848,1,1854
test4sub62of100,test4pub15of100,10,191,5,1850,0,1855
test4sub9of100,test4pub12of100,10,191,5,1939,1,1945
test4sub75of100,test4pub12of100,10,191,5,1942,1,1948
test4sub43of100,test4pub2of100,10,190,6,2122,1,2129
test4sub22of100,test4pub8of100,10,190,5,2027,1,2033
test4sub5of100,test4pub11of100,10,191,5,1972,2,1979
test4sub85of100,test4pub4of100,10,190,5,2095,1,2101
test4sub31of100,test4pub1of100,10,1469,12,2150,42,2204
test4sub35of100,test4pub1of100,10,1469,12,2153,79,2244
test4sub44of100,test4pub1of100,10,1469,12,2157,115,2284
test4sub6of100,test4pub1of100,10,1469,12,2160,153,2325
test4sub80of100,test4pub4of100,10,190,5,2110,147,2262
test4sub88of100,test4pub8of100,10,190,5,2044,148,2197
test4sub53of100,test4pub8of100,10,190,5,2045,148,2198
test4sub63of100,test4pub13of100,10,191,5,1963,141,2109
test4sub3of100,test4pub3of100,10,190,5,2139,135,2279
test4sub85of100,test4pub3of100,10,190,5,2140,136,2281
test4sub78of100,test4pub14of100,10,191,5,1950,131,2086
test4sub24of100,test4pub9of100,10,190,5,2054,126,2185
test4sub7of100,test4pub13of100,10,191,5,1985,122,2112
test4sub98of100,test4pub3of100,10,190,5,2157,121,2283
test4sub71of100,test4pub4of100,10,190,5,2147,117,2269
test4sub38of100,test4pub2of100,10,190,6,2195,105,2306
test4sub84of100,test4pub1of100,10,1469,12,2219,141,2372
test4sub58of100,test4pub15of100,10,191,5,1948,134,2087
test4sub36of100,test4pub7of100,10,190,5,2127,125,2257
test4sub11of100,test4pub1of100,10,1469,12,2236,164,2412
test4sub10of100,test4pub5of100,10,190,5,2173,160,2338
test4sub73of100,test4pub16of100,10,191,5,1945,157,2107
test4sub96of100,test4pub8of100,10,190,5,2124,156,2285
test4sub13of100,test4pub3of100,10,190,5,2213,149,2367
test4sub48of100,test4pub17of100,10,191,6,1939,149,2094
test4sub66of100,test4pub10of100,10,191,6,2098,141,2245
test4sub45of100,test4pub10of100,10,191,6,2101,139,2246
test4sub49of100,test4pub10of100,10,191,6,2102,139,2247
test4sub29of100,test4pub2of100,10,190,6,2247,139,2392
test4sub22of100,test4pub9of100,10,190,5,2132,136,2273
test4sub67of100,test4pub16of100,10,191,5,1973,134,2112
test4sub77of100,test4pub6of100,10,190,6,2184,131,2321
test4sub1of100,test4pub2of100,10,190,6,2264,125,2395
test4sub31of100,test4pub16of100,10,191,5,1990,120,2115
test4sub79of100,test4pub16of100,10,191,5,1992,119,2116
test4sub26of100,test4pub3of100,10,190,5,2253,118,2376
test4sub41of100,test4pub10of100,10,191,6,2140,108,2254
test4sub50of100,test4pub1of100,10,1469,12,2307,145,2464
test4sub83of100,test4pub15of100,10,191,5,2032,142,2179
test4sub6of100,test4pub17of100,10,191,6,1998,139,2143
test4sub63of100,test4pub17of100,10,191,6,2000,138,2144
test4sub24of100,test4pub1of100,10,1469,12,2317,175,2504
test4sub98of100,test4pub17of100,10,191,6,2004,174,2184
test4sub17of100,test4pub2of100,10,190,6,2306,168,2480
test4sub38of100,test4pub10of100,10,191,6,2162,169,2337
test4sub42of100,test4pub11of100,10,191,5,2161,158,2324
test4sub51of100,test4pub12of100,10,191,5,2147,151,2303
test4sub54of100,test4pub4of100,10,190,5,2298,143,2446
test4sub52of100,test4pub4of100,10,190,5,2300,142,2447
test4sub70of100,test4pub4of100,10,190,5,2303,139,2447
test4sub69of100,test4pub13of100,10,191,5,2151,136,2292
test4sub64of100,test4pub6of100,10,190,6,2276,131,2413
test4sub7of100,test4pub2of100,10,190,6,2366,113,2485
test4sub72of100,test4pub9of100,10,190,5,2256,105,2366
test4sub82of100,test4pub9of100,10,190,5,2258,104,2367
test4sub13of100,test4pub2of100,10,190,6,2383,97,2486
test4sub57of100,test4pub4of100,10,190,5,2350,96,2451
test4sub29of100,test4pub4of100,10,190,5,2350,95,2450
test4sub22of100,test4pub2of100,10,190,6,2388,95,2489
test4sub67of100,test4pub11of100,10,191,5,2231,95,2331
test4sub1of100,test4pub15of100,10,191,5,2130,94,2229
test4sub31of100,test4pub2of100,10,190,6,2390,95,2491
test4sub26of100,test4pub4of100,10,190,5,2356,94,2455
test4sub23of100,test4pub15of100,10,191,5,2143,83,2231
test4sub11of100,test4pub8of100,10,190,5,2316,70,2391
test4sub33of100,test4pub14of100,10,191,5,2208,63,2276
test4sub97of100,test4pub16of100,10,191,5,2158,49,2212
test4sub43of100,test4pub8of100,10,190,5,2343,43,2391
test4sub71of100,test4pub14of100,10,191,5,2252,20,2277
test4sub5of100,test4pub6of100,10,190,6,2400,17,2423
test4sub17of100,test4pub7of100,10,190,5,2385,15,2405
test4sub38of100,test4pub11of100,10,191,5,2318,14,2337
test4sub42of100,test4pub17of100,10,191,6,2180,14,2200
test4sub54of100,test4pub7of100,10,190,5,2388,13,2406
test4sub57of100,test4pub15of100,10,191,5,2222,9,2236
test4sub98of100,test4pub4of100,10,190,5,2448,7,2460
test4sub58of100,test4pub2of100,10,190,6,2485,7,2498
test4sub38of100,test4pub5of100,10,190,5,2442,7,2454
test4sub38of100,test4pub15of100,10,191,5,2238,1,2244
test4sub60of100,test4pub17of100,10,191,6,2209,1,2216
test4sub67of100,test4pub10of100,10,191,6,2366,1,2373
test4sub28of100,test4pub13of100,10,191,5,2329,0,2334
test4sub7of100,test4pub17of100,10,191,6,2224,1,2231
test4sub31of100,test4pub8of100,10,190,5,2421,1,2427
test4sub7of100,test4pub4of100,10,190,5,2501,1,2507
test4sub97of100,test4pub10of100,10,191,6,2400,1,2407
test4sub54of100,test4pub3of100,10,190,5,2524,1,2530
test4sub74of100,test4pub11of100,10,191,5,2394,1,2400
test4sub54of100,test4pub13of100,10,191,5,2360,1,2366
test4sub45of100,test4pub11of100,10,191,5,2396,1,2402
test4sub54of100,test4pub16of100,10,191,5,2281,0,2286
test4sub42of100,test4pub5of100,10,190,5,2517,0,2522
test4sub59of100,test4pub14of100,10,191,5,2354,1,2360
test4sub73of100,test4pub9of100,10,190,5,2454,1,2460
test4sub33of100,test4pub7of100,10,190,5,2483,1,2489
test4sub77of100,test4pub14of100,10,191,5,2360,1,2366
test4sub90of100,test4pub6of100,10,190,6,2506,0,2512
test4sub59of100,test4pub1of100,10,1469,12,2602,38,2652
test4sub66of100,test4pub13of100,10,191,5,2416,15,2436
test4sub94of100,test4pub11of100,10,191,5,2457,8,2470
test4sub92of100,test4pub8of100,10,190,5,2523,0,2528
test4sub31of100,test4pub15of100,10,191,5,2371,0,2376
test4sub52of100,test4pub15of100,10,191,5,2385,1,2391
test4sub85of100,test4pub5of100,10,190,5,2598,0,2603
test4sub2of100,test4pub2of100,10,190,6,2646,1,2653
test4sub22of100,test4pub4of100,10,190,5,2618,1,2624
test4sub71of100,test4pub1of100,10,1469,12,2673,39,2724
test4sub97of100,test4pub1of100,10,1469,12,2675,77,2764
test4sub12of100,test4pub3of100,10,190,5,2641,72,2718
test4sub75of100,test4pub8of100,10,190,5,2565,67,2637
test4sub49of100,test4pub8of100,10,190,5,2572,61,2638
test4sub59of100,test4pub7of100,10,190,5,2589,56,2650
test4sub89of100,test4pub9of100,10,190,5,2562,55,2622
test4sub41of100,test4pub5of100,10,190,5,2633,53,2691
test4sub93of100,test4pub5of100,10,190,5,2634,54,2693
test4sub33of100,test4pub12of100,10,191,5,2505,53,2563
test4sub36of100,test4pub5of100,10,190,5,2639,48,2692
test4sub66of100,test4pub6of100,10,190,6,2616,48,2670
test4sub95of100,test4pub14of100,10,191,5,2473,48,2526
test4sub58of100,test4pub11of100,10,191,5,2537,45,2587
test4sub99of100,test4pub1of100,10,1469,12,2714,83,2809
test4sub32of100,test4pub13of100,10,191,5,2518,68,2591
test4sub13of100,test4pub13of100,10,191,5,2521,65,2591
test4sub7of100,test4pub6of100,10,190,6,2645,61,2712
test4sub25of100,test4pub9of100,10,190,5,2605,57,2667
test4sub84of100,test4pub11of100,10,191,5,2570,54,2629
test4sub97of100,test4pub7of100,10,190,5,2644,49,2698
test4sub57of100,test4pub16of100,10,191,5,2461,41,2507
test4sub38of100,test4pub1of100,10,1469,12,2771,70,2853
test4sub59of100,test4pub10of100,10,191,6,2615,63,2684
test4sub9of100,test4pub16of100,10,191,5,2479,62,2546
test4sub3of100,test4pub12of100,10,191,5,2584,61,2650
test4sub15of100,test4pub11of100,10,191,5,2607,59,2671
test4sub10of100,test4pub3of100,10,190,5,2750,52,2807
test4sub95of100,test4pub1of100,10,1469,12,2798,82,2892
test4sub94of100,test4pub6of100,10,190,6,2707,82,2795
test4sub91of100,test4pub6of100,10,190,6,2708,81,2795
test4sub97of100,test4pub12of100,10,191,5,2605,81,2691
test4sub48of100,test4pub10of100,10,191,6,2643,77,2726
test4sub57of100,test4pub3of100,10,190,5,2781,63,2849
test4sub4of100,test4pub13of100,10,191,5,2626,49,2680
test4sub27of100,test4pub6of100,10,190,6,2750,43,2799
test4sub13of100,test4pub16of100,10,191,5,2554,33,2592
test4sub67of100,test4pub4of100,10,190,5,2802,29,2836
test4sub93of100,test4pub14of100,10,191,5,2630,20,2655
test4sub30of100,test4pub2of100,10,190,6,2851,17,2874
test4sub47of100,test4pub2of100,10,190,6,2853,16,2875
test4sub63of100,test4pub9of100,10,190,5,2736,15,2756
test4sub31of100,test4pub6of100,10,190,6,2786,10,2802
test4sub58of100,test4pub13of100,10,191,5,2669,9,2683
test4sub90of100,test4pub13of100,10,191,5,2671,8,2684
test4sub29of100,test4pub8of100,10,190,5,2762,6,2773
test4sub57of100,test4pub1of100,10,1469,12,2885,44,2941
test4sub42of100,test4pub16of100,10,191,5,2591,38,2634
test4sub44of100,test4pub16of100,10,191,5,2591,39,2635
test4sub80of100,test4pub3of100,10,190,5,2855,34,2894
test4sub56of100,test4pub5of100,10,190,5,2831,31,2867
test4sub43of100,test4pub4of100,10,190,5,2848,28,2881
test4sub8of100,test4pub9of100,10,190,5,2771,24,2800
test4sub69of100,test4pub15of100,10,191,5,2629,23,2657
test4sub36of100,test4pub1of100,10,1469,12,2917,55,2984
test4sub39of100,test4pub9of100,10,190,5,2782,54,2841
test4sub28of100,test4pub14of100,10,191,5,2692,45,2742
test4sub42of100,test4pub4of100,10,190,5,2875,44,2924
test4sub66of100,test4pub4of100,10,190,5,2889,29,2923
test4sub30of100,test4pub8of100,10,190,5,2824,30,2859
test4sub55of100,test4pub4of100,10,190,5,2892,28,2925
test4sub71of100,test4pub2of100,10,190,6,2934,22,2962
test4sub61of100,test4pub1of100,10,1469,12,2960,53,3025
test4sub4of100,test4pub12of100,10,191,5,2765,52,2822
test4sub73of100,test4pub17of100,10,191,6,2651,49,2706
test4sub86of100,test4pub4of100,10,190,5,2915,44,2964
test4sub84of100,test4pub15of100,10,191,5,2699,38,2742
test4sub57of100,test4pub17of100,10,191,6,2667,34,2707
test4sub79of100,test4pub1of100,10,1469,12,2986,70,3068
test4sub66of100,test4pub2of100,10,190,6,2972,66,3044
test4sub97of100,test4pub8of100,10,190,5,2873,62,2940
test4sub10of100,test4pub13of100,10,191,5,2788,60,2853
test4sub49of100,test4pub9of100,10,190,5,2864,58,2927
test4sub23of100,test4pub12of100,10,191,5,2807,54,2866
test4sub1of100,test4pub16of100,10,191,5,2708,51,2764
test4sub76of100,test4pub14of100,10,191,5,2776,47,2828
test4sub70of100,test4pub15of100,10,191,5,2734,46,2785
test4sub58of100,test4pub17of100,10,191,6,2699,46,2751
test4sub47of100,test4pub8of100,10,190,5,2896,43,2944
test4sub44of100,test4pub12of100,10,191,5,2825,39,2869
test4sub17of100,test4pub12of100,10,191,5,2826,39,2870
test4sub64of100,test4pub13of100,10,191,5,2815,36,2856
test4sub15of100,test4pub10of100,10,191,6,2866,34,2906
test4sub22of100,test4pub7of100,10,190,5,2920,33,2958
test4sub27of100,test4pub14of100,10,191,5,2797,29,2831
test4sub11of100,test4pub3of100,10,190,5,2995,29,3029
test4sub28of100,test4pub16of100,10,191,5,2749,16,2770
test4sub100of100,test4pub2of100,10,190,6,3035,9,3050
test4sub45of100,test4pub2of100,10,190,6,3036,10,3052
test4sub97of100,test4pub17of100,10,191,6,2743,7,2756
test4sub97of100,test4pub2of100,10,190,6,3046,1,3053
test4sub92of100,test4pub13of100,10,191,5,2855,1,2861
test4sub21of100,test4pub6of100,10,190,6,2976,1,2983
test4sub39of100,test4pub3of100,10,190,5,3040,1,3046
test4sub84of100,test4pub12of100,10,191,5,2885,0,2890
test4sub41of100,test4pub4of100,10,190,5,3032,2,3039
test4sub69of100,test4pub5of100,10,190,5,3020,2,3027
test4sub60of100,test4pub13of100,10,191,5,2878,1,2884
test4sub70of100,test4pub9of100,10,190,5,2958,1,2964
test4sub39of100,test4pub17of100,10,191,6,2783,0,2789
test4sub69of100,test4pub10of100,10,191,6,2942,1,2949
test4sub84of100,test4pub2of100,10,190,6,3087,1,3094
test4sub33of100,test4pub3of100,10,190,5,3071,1,3077
test4sub31of100,test4pub14of100,10,191,5,2875,1,2881
test4sub52of100,test4pub12of100,10,191,5,2921,1,2927
test4sub7of100,test4pub3of100,10,190,5,3082,1,3088
test4sub32of100,test4pub16of100,10,191,5,2826,1,2832
test4sub53of100,test4pub15of100,10,191,5,2848,1,2854
test4sub5of100,test4pub4of100,10,190,5,3079,0,3084
test4sub5of100,test4pub17of100,10,191,6,2824,0,2830
test4sub19of100,test4pub14of100,10,191,5,2905,1,2911
test4sub96of100,test4pub11of100,10,191,5,2974,1,2980
test4sub62of100,test4pub16of100,10,191,5,2851,2,2858
test4sub61of100,test4pub3of100,10,190,5,3111,1,3117
test4sub58of100,test4pub16of100,10,191,5,2857,1,2863
test4sub53of100,test4pub17of100,10,191,6,2842,1,2849
test4sub11of100,test4pub2of100,10,190,6,3143,1,3150
test4sub63of100,test4pub6of100,10,190,6,3072,1,3079
test4sub53of100,test4pub11of100,10,191,5,2999,1,3005
test4sub6of100,test4pub3of100,10,190,5,3135,2,3142
test4sub46of100,test4pub11of100,10,191,5,3000,1,3006
test4sub75of100,test4pub11of100,10,191,5,2999,2,3006
test4sub55of100,test4pub6of100,10,190,6,3084,2,3092
test4sub24of100,test4pub5of100,10,190,5,3113,1,3119
test4sub20of100,test4pub10of100,10,191,6,3030,0,3036
test4sub86of100,test4pub6of100,10,190,6,3104,1,3111
test4sub48of100,test4pub7of100,10,190,5,3087,1,3093
test4sub64of100,test4pub12of100,10,191,5,3010,1,3016
test4sub13of100,test4pub15of100,10,191,5,2934,1,2940
test4sub48of100,test4pub6of100,10,190,6,3122,1,3129
test4sub68of100,test4pub2of100,10,190,6,3196,0,3202
test4sub77of100,test4pub7of100,10,190,5,3117,0,3122
test4sub50of100,test4pub14of100,10,191,5,2990,1,2996
test4sub41of100,test4pub6of100,10,190,6,3141,1,3148
test4sub94of100,test4pub5of100,10,190,5,3176,1,3182
test4sub8of100,test4pub5of100,10,190,5,3194,0,3199
test4sub53of100,test4pub12of100,10,191,5,3070,0,3075
test4sub16of100,test4pub10of100,10,191,6,3112,1,3119
test4sub5of100,test4pub5of100,10,190,5,3214,1,3220
test4sub68of100,test4pub1of100,10,1469,12,3286,39,3337
test4sub28of100,test4pub6of100,10,190,6,3194,39,3239
test4sub14of100,test4pub5of100,10,190,5,3222,37,3264
test4sub26of100,test4pub12of100,10,191,5,3099,31,3135
test4sub42of100,test4pub15of100,10,191,5,3017,30,3052
test4sub90of100,test4pub2of100,10,190,6,3278,32,3316
test4sub80of100,test4pub2of100,10,190,6,3278,32,3316
test4sub18of100,test4pub14of100,10,191,5,3062,32,3099
test4sub81of100,test4pub8of100,10,190,5,3178,31,3214
test4sub87of100,test4pub5of100,10,190,5,3237,25,3267
test4sub70of100,test4pub6of100,10,190,6,3220,19,3245
test4sub88of100,test4pub6of100,10,190,6,3212,27,3245
test4sub9of100,test4pub6of100,10,190,6,3220,20,3246
test4sub59of100,test4pub13of100,10,191,5,3103,20,3128
test4sub19of100,test4pub6of100,10,190,6,3225,17,3248
test4sub15of100,test4pub6of100,10,190,6,3227,16,3249
test4sub84of100,test4pub6of100,10,190,6,3227,15,3248
test4sub58of100,test4pub8of100,10,190,5,3203,12,3220
test4sub92of100,test4pub15of100,10,191,5,3046,11,3062
test4sub6of100,test4pub2of100,10,190,6,3306,12,3324
test4sub36of100,test4pub15of100,10,191,5,3049,8,3062
test4sub32of100,test4pub5of100,10,190,5,3263,5,3273
test4sub10of100,test4pub15of100,10,191,5,3053,4,3062
test4sub18of100,test4pub6of100,10,190,6,3243,3,3252
test4sub59of100,test4pub2of100,10,190,6,3344,1,3351
test4sub28of100,test4pub5of100,10,190,5,3296,0,3301
test4sub55of100,test4pub12of100,10,191,5,3171,3,3179
test4sub49of100,test4pub12of100,10,191,5,3172,3,3180
test4sub73of100,test4pub12of100,10,191,5,3172,2,3179
test4sub74of100,test4pub2of100,10,190,6,3359,0,3365
test4sub13of100,test4pub17of100,10,191,6,3064,1,3071
test4sub1of100,test4pub17of100,10,191,6,3072,1,3079
test4sub79of100,test4pub17of100,10,191,6,3081,0,3087
test4sub89of100,test4pub1of100,10,1469,12,3404,40,3456
test4sub24of100,test4pub16of100,10,191,5,3111,34,3150
test4sub86of100,test4pub16of100,10,191,5,3111,34,3150
test4sub2of100,test4pub14of100,10,191,5,3175,34,3214
test4sub91of100,test4pub17of100,10,191,6,3097,34,3137
test4sub17of100,test4pub16of100,10,191,5,3114,34,3153
test4sub67of100,test4pub6of100,10,190,6,3321,34,3361
test4sub93of100,test4pub12of100,10,191,5,3217,33,3255
test4sub19of100,test4pub15of100,10,191,5,3136,32,3173
test4sub64of100,test4pub4of100,10,190,5,3363,29,3397
test4sub49of100,test4pub3of100,10,190,5,3383,24,3412
test4sub66of100,test4pub3of100,10,190,5,3397,11,3413
test4sub48of100,test4pub16of100,10,191,5,3152,0,3157
test4sub15of100,test4pub1of100,10,1469,12,3462,39,3513
test4sub96of100,test4pub2of100,10,190,6,3449,32,3487
test4sub81of100,test4pub2of100,10,190,6,3450,33,3489
test4sub89of100,test4pub17of100,10,191,6,3158,28,3192
test4sub25of100,test4pub1of100,10,1469,12,3477,64,3553
test4sub51of100,test4pub9of100,10,190,5,3341,63,3409
test4sub29of100,test4pub1of100,10,1469,12,3478,102,3592
test4sub86of100,test4pub12of100,10,191,5,3286,97,3388
test4sub9of100,test4pub5of100,10,190,5,3419,94,3518
test4sub19of100,test4pub3of100,10,190,5,3454,87,3546
test4sub66of100,test4pub9of100,10,190,5,3357,87,3449
test4sub15of100,test4pub3of100,10,190,5,3461,81,3547
test4sub78of100,test4pub16of100,10,191,5,3226,59,3290
test4sub47of100,test4pub16of100,10,191,5,3239,46,3290
test4sub7of100,test4pub16of100,10,191,5,3239,47,3291
test4sub22of100,test4pub10of100,10,191,6,3376,46,3428
test4sub16of100,test4pub14of100,10,191,5,3303,46,3354
test4sub97of100,test4pub4of100,10,190,5,3485,45,3535
test4sub14of100,test4pub2of100,10,190,6,3521,45,3572
test4sub32of100,test4pub2of100,10,190,6,3522,45,3573
test4sub55of100,test4pub2of100,10,190,6,3523,45,3574
test4sub43of100,test4pub1of100,10,1469,12,3549,76,3637
test4sub20of100,test4pub2of100,10,190,6,3534,73,3613
test4sub77of100,test4pub5of100,10,190,5,3486,71,3562
test4sub100of100,test4pub4of100,10,190,5,3504,67,3576
test4sub67of100,test4pub14of100,10,191,5,3331,60,3396
test4sub45of100,test4pub14of100,10,191,5,3332,61,3398
test4sub50of100,test4pub15of100,10,191,5,3294,55,3354
test4sub75of100,test4pub15of100,10,191,5,3294,55,3354
test4sub92of100,test4pub5of100,10,190,5,3508,53,3566
test4sub19of100,test4pub13of100,10,191,5,3372,47,3424
test4sub90of100,test4pub15of100,10,191,5,3304,47,3356
test4sub93of100,test4pub1of100,10,1469,12,3594,74,3680
test4sub42of100,test4pub10of100,10,191,6,3432,74,3512
test4sub35of100,test4pub10of100,10,191,6,3436,69,3511
test4sub71of100,test4pub6of100,10,190,6,3508,70,3584
test4sub36of100,test4pub17of100,10,191,6,3285,69,3360
test4sub54of100,test4pub17of100,10,191,6,3286,71,3363
test4sub98of100,test4pub6of100,10,190,6,3525,55,3586
test4sub10of100,test4pub6of100,10,190,6,3526,54,3586
test4sub3of100,test4pub13of100,10,191,5,3414,49,3468
test4sub40of100,test4pub1of100,10,1469,12,3625,87,3724
test4sub23of100,test4pub2of100,10,190,6,3608,86,3700
test4sub75of100,test4pub14of100,10,191,5,3394,83,3482
test4sub48of100,test4pub4of100,10,190,5,3578,80,3663
test4sub73of100,test4pub4of100,10,190,5,3584,74,3663
test4sub21of100,test4pub13of100,10,191,5,3433,71,3509
test4sub28of100,test4pub3of100,10,190,5,3604,70,3679
test4sub95of100,test4pub7of100,10,190,5,3561,45,3611
test4sub36of100,test4pub11of100,10,191,5,3495,45,3545
test4sub35of100,test4pub11of100,10,191,5,3495,45,3545
test4sub10of100,test4pub11of100,10,191,5,3497,43,3545
test4sub56of100,test4pub11of100,10,191,5,3511,29,3545
test4sub42of100,test4pub1of100,10,1469,12,3688,72,3772
test4sub46of100,test4pub9of100,10,190,5,3552,71,3628
test4sub20of100,test4pub9of100,10,190,5,3553,72,3630
test4sub83of100,test4pub7of100,10,190,5,3582,72,3659
test4sub99of100,test4pub2of100,10,190,6,3681,63,3750
test4sub44of100,test4pub2of100,10,190,6,3682,61,3749
test4sub64of100,test4pub11of100,10,191,5,3533,54,3592
test4sub68of100,test4pub11of100,10,191,5,3534,55,3594
test4sub76of100,test4pub1of100,10,1469,12,3723,81,3816
test4sub79of100,test4pub7of100,10,190,5,3614,81,3700
test4sub39of100,test4pub15of100,10,191,5,3445,81,3531
test4sub48of100,test4pub15of100,10,191,5,3446,81,3532
test4sub18of100,test4pub4of100,10,190,5,3669,81,3755
test4sub71of100,test4pub17of100,10,191,6,3411,82,3499
test4sub69of100,test4pub1of100,10,1469,12,3732,116,3860
test4sub52of100,test4pub2of100,10,190,6,3722,108,3836
test4sub100of100,test4pub1of100,10,1469,12,3743,145,3900
test4sub7of100,test4pub7of100,10,190,5,3642,138,3785
test4sub30of100,test4pub7of100,10,190,5,3643,137,3785
test4sub25of100,test4pub16of100,10,191,5,3462,129,3596
test4sub31of100,test4pub4of100,10,190,5,3709,126,3840
test4sub3of100,test4pub8of100,10,190,5,3650,121,3776
test4sub53of100,test4pub14of100,10,191,5,3544,112,3661
test4sub35of100,test4pub14of100,10,191,5,3544,112,3661
test4sub26of100,test4pub1of100,10,1469,12,3799,134,3945
test4sub9of100,test4pub4of100,10,190,5,3744,133,3882
test4sub68of100,test4pub9of100,10,190,5,3663,133,3801
test4sub1of100,test4pub9of100,10,190,5,3664,134,3803
test4sub11of100,test4pub17of100,10,191,6,3486,133,3625
test4sub10of100,test4pub17of100,10,191,6,3490,129,3625
test4sub48of100,test4pub13of100,10,191,5,3597,128,3730
test4sub72of100,test4pub2of100,10,190,6,3807,109,3922
test4sub83of100,test4pub2of100,10,190,6,3810,108,3924
test4sub44of100,test4pub14of100,10,191,5,3593,107,3705
test4sub43of100,test4pub12of100,10,191,5,3638,103,3746
test4sub87of100,test4pub10of100,10,191,6,3673,102,3781
test4sub56of100,test4pub12of100,10,191,5,3649,93,3747
test4sub89of100,test4pub11of100,10,191,5,3683,80,3768
test4sub70of100,test4pub7of100,10,190,5,3757,74,3836
test4sub52of100,test4pub10of100,10,191,6,3709,69,3784
test4sub90of100,test4pub17of100,10,191,6,3566,59,3631
test4sub82of100,test4pub7of100,10,190,5,3780,53,3838
test4sub30of100,test4pub4of100,10,190,5,3835,51,3891
test4sub6of100,test4pub12of100,10,191,5,3706,39,3750
test4sub65of100,test4pub11of100,10,191,5,3729,38,3772
test4sub67of100,test4pub9of100,10,190,5,3768,39,3812
test4sub2of100,test4pub3of100,10,190,5,3866,39,3910
test4sub5of100,test4pub15of100,10,191,5,3628,37,3670
test4sub51of100,test4pub14of100,10,191,5,3678,31,3714
test4sub60of100,test4pub2of100,10,190,6,3896,31,3933
test4sub58of100,test4pub6of100,10,190,6,3839,16,3861
test4sub9of100,test4pub3of100,10,190,5,3893,13,3911
test4sub68of100,test4pub16of100,10,191,5,3635,14,3654
test4sub72of100,test4pub14of100,10,191,5,3701,11,3717
test4sub12of100,test4pub4of100,10,190,5,3884,10,3899
test4sub82of100,test4pub10of100,10,191,6,3779,12,3797
test4sub6of100,test4pub4of100,10,190,5,3888,11,3904
test4sub60of100,test4pub14of100,10,191,5,3710,9,3724
test4sub42of100,test4pub6of100,10,190,6,3862,2,3870
test4sub80of100,test4pub13of100,10,191,5,3746,1,3752
test4sub81of100,test4pub6of100,10,190,6,3872,2,3880
test4sub33of100,test4pub6of100,10,190,6,3873,2,3881
test4sub35of100,test4pub15of100,10,191,5,3687,1,3693
test4sub8of100,test4pub11of100,10,191,5,3797,1,3803
test4sub95of100,test4pub8of100,10,190,5,3857,2,3864
test4sub12of100,test4pub2of100,10,190,6,3960,1,3967
test4sub54of100,test4pub2of100,10,190,6,3960,2,3968
test4sub83of100,test4pub1of100,10,1469,12,3991,41,4044
test4sub96of100,test4pub10of100,10,191,6,3829,41,3876
test4sub74of100,test4pub14of100,10,191,5,3758,39,3802
test4sub39of100,test4pub7of100,10,190,5,3887,38,3930
test4sub11of100,test4pub7of100,10,190,5,3889,37,3931
test4sub53of100,test4pub3of100,10,190,5,3958,37,4000
test4sub100of100,test4pub13of100,10,191,5,3789,35,3829
test4sub42of100,test4pub13of100,10,191,5,3790,35,3830
test4sub2of100,test4pub1of100,10,1469,12,4003,73,4088
test4sub14of100,test4pub13of100,10,191,5,3803,63,3871
test4sub92of100,test4pub1of100,10,1469,12,4013,103,4128
test4sub58of100,test4pub1of100,10,1469,12,4020,137,4169
test4sub77of100,test4pub9of100,10,190,5,3885,135,4025
test4sub70of100,test4pub8of100,10,190,5,3907,128,4040
test4sub25of100,test4pub8of100,10,190,5,3909,128,4042
test4sub93of100,test4pub7of100,10,190,5,3922,126,4053
test4sub63of100,test4pub4of100,10,190,5,3982,121,4108
test4sub56of100,test4pub10of100,10,191,6,3875,121,4002
test4sub5of100,test4pub10of100,10,191,6,3879,117,4002
test4sub33of100,test4pub16of100,10,191,5,3748,112,3865
test4sub52of100,test4pub17of100,10,191,6,3737,108,3851
test4sub82of100,test4pub5of100,10,190,5,3985,107,4097
test4sub6of100,test4pub5of100,10,190,5,3990,103,4098
test4sub65of100,test4pub1of100,10,1469,12,4064,136,4212
test4sub50of100,test4pub16of100,10,191,5,3767,135,3907
test4sub53of100,test4pub13of100,10,191,5,3861,131,3997
test4sub2of100,test4pub5of100,10,190,5,4009,125,4139
test4sub14of100,test4pub10of100,10,191,6,3914,126,4046
test4sub8of100,test4pub17of100,10,191,6,3769,120,3895
test4sub57of100,test4pub14of100,10,191,5,3850,119,3974
test4sub86of100,test4pub1of100,10,1469,12,4090,155,4257
test4sub87of100,test4pub14of100,10,191,5,3856,153,4014
test4sub84of100,test4pub10of100,10,191,6,3932,152,4090
test4sub37of100,test4pub8of100,10,190,5,3976,151,4132
test4sub43of100,test4pub14of100,10,191,5,3861,150,4016
test4sub29of100,test4pub10of100,10,191,6,3935,150,4091
test4sub76of100,test4pub15of100,10,191,5,3828,142,3975
test4sub100of100,test4pub9of100,10,190,5,3972,140,4117
test4sub81of100,test4pub4of100,10,190,5,4055,140,4200
test4sub97of100,test4pub9of100,10,190,5,3973,141,4119
test4sub85of100,test4pub1of100,10,1469,12,4111,180,4303
test4sub47of100,test4pub1of100,10,1469,12,4112,220,4344
test4sub13of100,test4pub4of100,10,190,5,4059,219,4283
test4sub92of100,test4pub12of100,10,191,5,3920,216,4141
test4sub31of100,test4pub12of100,10,191,5,3925,212,4142
test4sub35of100,test4pub3of100,10,190,5,4085,210,4300
test4sub42of100,test4pub9of100,10,190,5,3998,200,4203
test4sub80of100,test4pub10of100,10,191,6,3976,197,4179
test4sub95of100,test4pub13of100,10,191,5,3934,194,4133
test4sub91of100,test4pub13of100,10,191,5,3938,190,4133
test4sub7of100,test4pub10of100,10,191,6,3989,187,4182
test4sub25of100,test4pub13of100,10,191,5,3948,180,4133
test4sub56of100,test4pub13of100,10,191,5,3950,179,4134
test4sub20of100,test4pub4of100,10,190,5,4110,175,4290
test4sub89of100,test4pub16of100,10,191,5,3870,171,4046
test4sub55of100,test4pub1of100,10,1469,12,4172,208,4392
test4sub93of100,test4pub9of100,10,190,5,4039,205,4249
test4sub54of100,test4pub14of100,10,191,5,3946,199,4150
test4sub4of100,test4pub11of100,10,191,5,4016,190,4211
test4sub74of100,test4pub6of100,10,190,6,4107,183,4296
test4sub71of100,test4pub12of100,10,191,5,4003,183,4191
test4sub65of100,test4pub16of100,10,191,5,3902,182,4089
test4sub53of100,test4pub4of100,10,190,5,4148,180,4333
test4sub22of100,test4pub3of100,10,190,5,4181,163,4349
test4sub68of100,test4pub13of100,10,191,5,4025,149,4179
test4sub72of100,test4pub1of100,10,1469,12,4240,184,4436
test4sub86of100,test4pub14of100,10,191,5,4009,180,4194
test4sub87of100,test4pub8of100,10,190,5,4125,181,4311
test4sub2of100,test4pub6of100,10,190,6,4155,180,4341
test4sub37of100,test4pub14of100,10,191,5,4012,179,4196
test4sub76of100,test4pub13of100,10,191,5,4040,178,4223
test4sub18of100,test4pub12of100,10,191,5,4054,179,4238
test4sub17of100,test4pub17of100,10,191,6,3945,169,4120
test4sub75of100,test4pub17of100,10,191,6,3951,165,4122
test4sub83of100,test4pub9of100,10,190,5,4131,163,4299
test4sub30of100,test4pub12of100,10,191,5,4078,155,4238
test4sub88of100,test4pub13of100,10,191,5,4069,153,4227
test4sub60of100,test4pub5of100,10,190,5,4215,149,4369
test4sub61of100,test4pub5of100,10,190,5,4215,148,4368
test4sub58of100,test4pub4of100,10,190,5,4235,144,4384
test4sub46of100,test4pub14of100,10,191,5,4057,140,4202
test4sub69of100,test4pub3of100,10,190,5,4263,131,4399
test4sub12of100,test4pub17of100,10,191,6,3992,128,4126
test4sub66of100,test4pub14of100,10,191,5,4075,124,4204
test4sub3of100,test4pub5of100,10,190,5,4256,113,4374
test4sub50of100,test4pub4of100,10,190,5,4271,111,4387
test4sub1of100,test4pub4of100,10,190,5,4272,109,4386
test4sub96of100,test4pub4of100,10,190,5,4276,107,4388
test4sub33of100,test4pub10of100,10,191,6,4168,107,4281
test4sub47of100,test4pub6of100,10,190,6,4241,105,4352
test4sub35of100,test4pub17of100,10,191,6,4020,104,4130
test4sub80of100,test4pub1of100,10,1469,12,4337,144,4493
test4sub56of100,test4pub4of100,10,190,5,4285,140,4430
test4sub90of100,test4pub14of100,10,191,5,4123,123,4251
test4sub92of100,test4pub14of100,10,191,5,4125,120,4250
test4sub24of100,test4pub2of100,10,190,6,4345,118,4469
test4sub4of100,test4pub8of100,10,190,5,4261,100,4366
test4sub74of100,test4pub4of100,10,190,5,4327,102,4434
test4sub68of100,test4pub7of100,10,190,5,4276,99,4380
test4sub36of100,test4pub10of100,10,191,6,4237,85,4328
test4sub89of100,test4pub12of100,10,191,5,4204,85,4294
test4sub7of100,test4pub11of100,10,191,5,4230,81,4316
test4sub14of100,test4pub14of100,10,191,5,4181,70,4256
test4sub40of100,test4pub4of100,10,190,5,4366,66,4437
test4sub32of100,test4pub7of100,10,190,5,4316,63,4384
test4sub63of100,test4pub2of100,10,190,6,4406,63,4475
test4sub87of100,test4pub4of100,10,190,5,4372,61,4438
test4sub37of100,test4pub13of100,10,191,5,4218,60,4283
test4sub76of100,test4pub10of100,10,191,6,4266,61,4333
test4sub60of100,test4pub3of100,10,190,5,4392,58,4455
test4sub61of100,test4pub11of100,10,191,5,4257,58,4320
test4sub69of100,test4pub2of100,10,190,6,4416,56,4478
test4sub8of100,test4pub6of100,10,190,6,4347,53,4406
test4sub47of100,test4pub14of100,10,191,5,4203,53,4261
test4sub97of100,test4pub6of100,10,190,6,4349,52,4407
test4sub39of100,test4pub11of100,10,191,5,4280,37,4322
test4sub34of100,test4pub3of100,10,190,5,4421,32,4458
test4sub81of100,test4pub15of100,10,191,5,4182,32,4219
test4sub35of100,test4pub12of100,10,191,5,4269,27,4301
test4sub25of100,test4pub5of100,10,190,5,4403,23,4431
test4sub84of100,test4pub5of100,10,190,5,4408,18,4431
test4sub79of100,test4pub5of100,10,190,5,4408,18,4431
test4sub80of100,test4pub6of100,10,190,6,4389,13,4408
test4sub24of100,test4pub12of100,10,191,5,4286,12,4303
test4sub4of100,test4pub14of100,10,191,5,4247,12,4264
test4sub3of100,test4pub9of100,10,190,5,4348,11,4364
test4sub14of100,test4pub9of100,10,190,5,4350,9,4364
test4sub37of100,test4pub9of100,10,190,5,4353,8,4366
test4sub76of100,test4pub6of100,10,190,6,4398,7,4411
test4sub8of100,test4pub2of100,10,190,6,4478,2,4486
test4sub37of100,test4pub2of100,10,190,6,4479,1,4486
test4sub89of100,test4pub10of100,10,191,6,4337,1,4344
test4sub65of100,test4pub8of100,10,190,5,4386,1,4392
test4sub78of100,test4pub10of100,10,191,6,4345,1,4352
test4sub41of100,test4pub12of100,10,191,5,4312,1,4318
test4sub91of100,test4pub10of100,10,191,6,4353,1,4360
test4sub59of100,test4pub11of100,10,191,5,4352,1,4358
test4sub27of100,test4pub11of100,10,191,5,4353,0,4358
test4sub96of100,test4pub9of100,10,190,5,4395,1,4401
test4sub88of100,test4pub9of100,10,190,5,4396,1,4402
test4sub49of100,test4pub1of100,10,1469,12,4536,42,4590
test4sub51of100,test4pub17of100,10,191,6,4222,40,4268
test4sub95of100,test4pub17of100,10,191,6,4223,41,4270
test4sub66of100,test4pub17of100,10,191,6,4222,41,4269
test4sub34of100,test4pub6of100,10,190,6,4450,36,4492
test4sub11of100,test4pub10of100,10,191,6,4381,35,4422
test4sub79of100,test4pub15of100,10,191,5,4273,28,4306
test4sub72of100,test4pub6of100,10,190,6,4460,28,4494
test4sub86of100,test4pub17of100,10,191,6,4247,19,4272
test4sub27of100,test4pub4of100,10,190,5,4512,14,4531
test4sub24of100,test4pub7of100,10,190,5,4463,10,4478
test4sub88of100,test4pub1of100,10,1469,12,4573,50,4635
test4sub4of100,test4pub6of100,10,190,6,4482,49,4537
test4sub36of100,test4pub2of100,10,190,6,4556,49,4611
test4sub39of100,test4pub1of100,10,1469,12,4574,90,4676
test4sub21of100,test4pub8of100,10,190,5,4455,88,4548
test4sub11of100,test4pub16of100,10,191,5,4281,84,4370
test4sub99of100,test4pub16of100,10,191,5,4288,80,4373
test4sub91of100,test4pub16of100,10,191,5,4290,77,4372
test4sub22of100,test4pub6of100,10,190,6,4500,75,4581
test4sub18of100,test4pub5of100,10,190,5,4531,71,4607
test4sub66of100,test4pub11of100,10,191,5,4429,65,4499
test4sub46of100,test4pub15of100,10,191,5,4333,59,4397
test4sub23of100,test4pub17of100,10,191,6,4298,57,4361
test4sub98of100,test4pub2of100,10,190,6,4599,53,4658
test4sub1of100,test4pub10of100,10,191,6,4456,54,4516
test4sub74of100,test4pub5of100,10,190,5,4554,50,4609
test4sub10of100,test4pub2of100,10,190,6,4619,35,4660
test4sub14of100,test4pub4of100,10,190,5,4595,23,4623
test4sub32of100,test4pub14of100,10,191,5,4426,12,4443
test4sub5of100,test4pub8of100,10,190,5,4543,11,4559
test4sub24of100,test4pub8of100,10,190,5,4545,9,4559
test4sub99of100,test4pub7of100,10,190,5,4558,8,4571
test4sub27of100,test4pub8of100,10,190,5,4547,8,4560
test4sub22of100,test4pub13of100,10,191,5,4459,8,4472
test4sub66of100,test4pub16of100,10,191,5,4372,7,4384
test4sub14of100,test4pub15of100,10,191,5,4395,3,4403
test4sub24of100,test4pub6of100,10,190,6,4584,2,4592
test4sub71of100,test4pub10of100,10,191,6,4518,1,4525
test4sub23of100,test4pub8of100,10,190,5,4572,1,4578
test4sub30of100,test4pub10of100,10,191,6,4534,0,4540
test4sub41of100,test4pub13of100,10,191,5,4497,1,4503
test4sub20of100,test4pub3of100,10,190,5,4670,1,4676
test4sub87of100,test4pub16of100,10,191,5,4422,1,4428
test4sub62of100,test4pub9of100,10,190,5,4589,1,4595
test4sub68of100,test4pub12of100,10,191,5,4529,1,4535
test4sub65of100,test4pub9of100,10,190,5,4591,2,4598
test4sub95of100,test4pub3of100,10,190,5,4689,0,4694
test4sub71of100,test4pub11of100,10,191,5,4557,1,4563
test4sub28of100,test4pub4of100,10,190,5,4685,0,4690
test4sub10of100,test4pub14of100,10,191,5,4512,1,4518
test4sub91of100,test4pub14of100,10,191,5,4514,1,4520
test4sub6of100,test4pub14of100,10,191,5,4516,1,4522
test4sub61of100,test4pub9of100,10,190,5,4631,0,4636
test4sub17of100,test4pub9of100,10,190,5,4633,1,4639
test4sub65of100,test4pub13of100,10,191,5,4560,1,4566
test4sub48of100,test4pub8of100,10,190,5,4650,0,4655
test4sub87of100,test4pub13of100,10,191,5,4563,1,4569
test4sub8of100,test4pub1of100,10,1469,12,4775,44,4831
test4sub56of100,test4pub1of100,10,1469,12,4775,85,4872
test4sub98of100,test4pub5of100,10,190,5,4709,84,4798
test4sub92of100,test4pub10of100,10,191,6,4615,83,4704
test4sub67of100,test4pub1of100,10,1469,12,4779,121,4912
test4sub44of100,test4pub11of100,10,191,5,4604,121,4730
test4sub75of100,test4pub10of100,10,191,6,4617,121,4744
test4sub89of100,test4pub3of100,10,190,5,4743,118,4866
test4sub21of100,test4pub15of100,10,191,5,4513,110,4628
test4sub12of100,test4pub10of100,10,191,6,4632,107,4745
test4sub96of100,test4pub1of100,10,1469,12,4806,134,4952
test4sub77of100,test4pub1of100,10,1469,12,4811,170,4993
test4sub35of100,test4pub4of100,10,190,5,4765,161,4931
test4sub61of100,test4pub13of100,10,191,5,4610,161,4776
test4sub42of100,test4pub3of100,10,190,5,4783,159,4947
test4sub29of100,test4pub12of100,10,191,5,4635,151,4791
test4sub6of100,test4pub11of100,10,191,5,4660,146,4811
test4sub80of100,test4pub9of100,10,190,5,4700,147,4852
test4sub30of100,test4pub16of100,10,191,5,4540,146,4691
test4sub50of100,test4pub11of100,10,191,5,4663,145,4813
test4sub17of100,test4pub11of100,10,191,5,4673,136,4814
test4sub3of100,test4pub15of100,10,191,5,4575,132,4712
test4sub92of100,test4pub6of100,10,190,6,4770,125,4901
test4sub7of100,test4pub15of100,10,191,5,4589,119,4713
test4sub20of100,test4pub12of100,10,191,5,4681,110,4796
test4sub54of100,test4pub1of100,10,1469,12,4887,142,5041
test4sub81of100,test4pub1of100,10,1469,12,4890,178,5080
test4sub12of100,test4pub1of100,10,1469,12,4903,205,5120
test4sub9of100,test4pub9of100,10,190,5,4769,202,4976
test4sub84of100,test4pub4of100,10,190,5,4860,194,5059
test4sub24of100,test4pub4of100,10,190,5,4866,189,5060
test4sub19of100,test4pub1of100,10,1469,12,4924,224,5160
test4sub28of100,test4pub2of100,10,190,6,4915,214,5135
test4sub18of100,test4pub16of100,10,191,5,4654,197,4856
test4sub35of100,test4pub2of100,10,190,6,4962,169,5137
test4sub61of100,test4pub10of100,10,191,6,4819,169,4994
test4sub29of100,test4pub15of100,10,191,5,4704,168,4877
test4sub50of100,test4pub2of100,10,190,6,4966,168,5140
test4sub30of100,test4pub1of100,10,1469,12,4985,206,5203
test4sub92of100,test4pub11of100,10,191,5,4811,205,5021
test4sub70of100,test4pub10of100,10,191,6,4831,198,5035
test4sub16of100,test4pub4of100,10,190,5,4944,195,5144
test4sub2of100,test4pub4of100,10,190,5,4946,192,5143
test4sub89of100,test4pub13of100,10,191,5,4793,191,4989
test4sub5of100,test4pub3of100,10,190,5,4976,178,5159
test4sub64of100,test4pub3of100,10,190,5,4979,177,5161
test4sub68of100,test4pub14of100,10,191,5,4784,175,4964
test4sub86of100,test4pub3of100,10,190,5,4987,170,5162
test4sub95of100,test4pub10of100,10,191,6,4868,166,5040
test4sub54of100,test4pub10of100,10,191,6,4869,166,5041
test4sub49of100,test4pub17of100,10,191,6,4727,155,4888
test4sub69of100,test4pub14of100,10,191,5,4811,152,4968
test4sub20of100,test4pub7of100,10,190,5,4949,140,5094
test4sub38of100,test4pub4of100,10,190,5,5008,137,5150
test4sub96of100,test4pub15of100,10,191,5,4790,130,4925
test4sub41of100,test4pub14of100,10,191,5,4835,129,4969
test4sub72of100,test4pub16of100,10,191,5,4776,125,4906
test4sub13of100,test4pub5of100,10,190,5,5016,117,5138
test4sub39of100,test4pub12of100,10,191,5,4893,111,5009
test4sub3of100,test4pub6of100,10,190,6,5005,105,5116
test4sub65of100,test4pub14of100,10,191,5,4866,101,4972
test4sub87of100,test4pub15of100,10,191,5,4823,101,4929
test4sub9of100,test4pub7of100,10,190,5,5000,94,5099
test4sub21of100,test4pub7of100,10,190,5,5006,89,5100
test4sub33of100,test4pub4of100,10,190,5,5068,82,5155
test4sub82of100,test4pub16of100,10,191,5,4829,78,4912
test4sub34of100,test4pub16of100,10,191,5,4831,76,4912
test4sub27of100,test4pub16of100,10,191,5,4834,72,4911
test4sub19of100,test4pub10of100,10,191,6,4986,57,5049
test4sub22of100,test4pub16of100,10,191,5,4851,57,4913
test4sub35of100,test4pub13of100,10,191,5,4941,55,5001
test4sub29of100,test4pub17of100,10,191,6,4838,55,4899
test4sub2of100,test4pub17of100,10,191,6,4879,13,4898
test4sub68of100,test4pub6of100,10,190,6,5104,11,5121
test4sub49of100,test4pub4of100,10,190,5,5143,10,5158
test4sub72of100,test4pub11of100,10,191,5,5025,7,5037
test4sub39of100,test4pub13of100,10,191,5,4992,6,5003
test4sub89of100,test4pub14of100,10,191,5,5358,0,5363
test4sub9of100,test4pub1of100,10,1469,12,5603,41,5656
test4sub5of100,test4pub9of100,10,190,5,5467,41,5513
test4sub34of100,test4pub9of100,10,190,5,5469,39,5513
test4sub45of100,test4pub9of100,10,190,5,5469,39,5513
test4sub83of100,test4pub8of100,10,190,5,5488,36,5529
test4sub100of100,test4pub8of100,10,190,5,5491,34,5530
test4sub94of100,test4pub8of100,10,190,5,5507,18,5530
test4sub42of100,test4pub14of100,10,191,5,5397,13,5415
test4sub46of100,test4pub3of100,10,190,5,5597,10,5612
test4sub93of100,test4pub10of100,10,191,6,5478,7,5491
test4sub72of100,test4pub5of100,10,190,5,5595,0,5600
test4sub58of100,test4pub3of100,10,190,5,5627,1,5633
test4sub95of100,test4pub11of100,10,191,5,5494,0,5499
test4sub70of100,test4pub3of100,10,190,5,5632,1,5638
test4sub34of100,test4pub12of100,10,191,5,5474,2,5481
test4sub19of100,test4pub16of100,10,191,5,5374,1,5380
test4sub85of100,test4pub6of100,10,190,6,5584,1,5591
test4sub72of100,test4pub4of100,10,190,5,5623,1,5629
test4sub78of100,test4pub3of100,10,190,5,5642,1,5648
test4sub25of100,test4pub4of100,10,190,5,5633,0,5638
test4sub52of100,test4pub9of100,10,190,5,5552,1,5558
test4sub82of100,test4pub1of100,10,1469,12,5701,40,5753
test4sub42of100,test4pub2of100,10,190,6,5717,5,5728
test4sub84of100,test4pub17of100,10,191,6,5423,2,5431
test4sub16of100,test4pub6of100,10,190,6,5647,3,5656
test4sub57of100,test4pub5of100,10,190,5,5688,0,5693
test4sub43of100,test4pub6of100,10,190,6,5666,1,5673
test4sub47of100,test4pub15of100,10,191,5,5479,0,5484
test4sub17of100,test4pub4of100,10,190,5,5716,1,5722
test4sub34of100,test4pub5of100,10,190,5,5703,1,5709
test4sub41of100,test4pub8of100,10,190,5,5662,1,5668
test4sub45of100,test4pub1of100,10,1469,12,5786,38,5836
test4sub80of100,test4pub11of100,10,191,5,5612,37,5654
test4sub18of100,test4pub13of100,10,191,5,5582,33,5620
test4sub25of100,test4pub11of100,10,191,5,5633,17,5655
test4sub10of100,test4pub1of100,10,1469,12,5811,52,5875
test4sub19of100,test4pub11of100,10,191,5,5640,49,5694
test4sub37of100,test4pub5of100,10,190,5,5750,47,5802
test4sub49of100,test4pub6of100,10,190,6,5728,45,5779
test4sub74of100,test4pub3of100,10,190,5,5781,46,5832
test4sub91of100,test4pub2of100,10,190,6,5803,46,5855
test4sub67of100,test4pub2of100,10,190,6,5803,45,5854
test4sub81of100,test4pub10of100,10,191,6,5681,25,5712
test4sub68of100,test4pub10of100,10,191,6,5685,21,5712
test4sub25of100,test4pub17of100,10,191,6,5533,20,5559
test4sub6of100,test4pub6of100,10,190,6,5758,19,5783
test4sub39of100,test4pub2of100,10,190,6,5837,13,5856
test4sub82of100,test4pub13of100,10,191,5,5647,13,5665
test4sub10of100,test4pub10of100,10,191,6,5702,6,5714
test4sub37of100,test4pub12of100,10,191,5,5669,5,5679
test4sub49of100,test4pub16of100,10,191,5,5567,4,5576
test4sub49of100,test4pub2of100,10,190,6,5853,1,5860
test4sub63of100,test4pub15of100,10,191,5,5593,1,5599
test4sub27of100,test4pub15of100,10,191,5,5598,0,5603
test4sub67of100,test4pub15of100,10,191,5,5602,1,5608
test4sub55of100,test4pub8of100,10,190,5,5762,0,5767
test4sub39of100,test4pub10of100,10,191,6,5724,2,5732
test4sub30of100,test4pub11of100,10,191,5,5711,2,5718
test4sub81of100,test4pub11of100,10,191,5,5712,1,5718
test4sub77of100,test4pub8of100,10,190,5,5775,0,5780
test4sub35of100,test4pub8of100,10,190,5,5782,1,5788
test4sub38of100,test4pub14of100,10,191,5,5679,0,5684
test4sub72of100,test4pub15of100,10,191,5,5656,1,5662
test4sub92of100,test4pub17of100,10,191,6,5634,1,5641
test4sub93of100,test4pub17of100,10,191,6,5638,0,5644
test4sub40of100,test4pub15of100,10,191,5,5683,1,5689
test4sub62of100,test4pub7of100,10,190,5,5859,8,5872
test4sub73of100,test4pub8of100,10,190,5,5848,1,5854
test4sub19of100,test4pub17of100,10,191,6,5660,2,5668
test4sub95of100,test4pub9of100,10,190,5,5839,1,5845
test4sub78of100,test4pub4of100,10,190,5,5936,1,5942
test4sub2of100,test4pub8of100,10,190,5,5885,0,5890
test4sub58of100,test4pub10of100,10,191,6,5858,0,5864
test4sub44of100,test4pub8of100,10,190,5,5901,0,5906
test4sub52of100,test4pub5of100,10,190,5,5957,0,5962
test4sub98of100,test4pub10of100,10,191,6,5866,1,5873
test4sub88of100,test4pub10of100,10,191,6,5869,1,5876
test4sub28of100,test4pub10of100,10,191,6,5870,0,5876
test4sub43of100,test4pub17of100,10,191,6,5729,0,5735
test4sub69of100,test4pub11of100,10,191,5,5871,0,5876
test4sub73of100,test4pub15of100,10,191,5,5770,1,5776
test4sub95of100,test4pub6of100,10,190,6,5958,1,5965
test4sub76of100,test4pub8of100,10,190,5,5931,1,5937
test4sub65of100,test4pub7of100,10,190,5,5944,1,5950
test4sub75of100,test4pub16of100,10,191,5,5757,0,5762
test4sub74of100,test4pub16of100,10,191,5,5758,0,5763
test4sub12of100,test4pub12of100,10,191,5,5862,1,5868
test4sub94of100,test4pub7of100,10,190,5,5952,1,5958
test4sub97of100,test4pub11of100,10,191,5,5887,1,5893
test4sub4of100,test4pub1of100,10,1469,12,6064,41,6117
test4sub51of100,test4pub4of100,10,190,5,6015,35,6055
test4sub52of100,test4pub11of100,10,191,5,5896,35,5936
test4sub22of100,test4pub14of100,10,191,5,5841,30,5876
test4sub88of100,test4pub7of100,10,190,5,5973,25,6003
test4sub85of100,test4pub12of100,10,191,5,5885,26,5916
test4sub44of100,test4pub9of100,10,190,5,5949,22,5976
test4sub33of100,test4pub1of100,10,1469,12,6090,58,6160
test4sub97of100,test4pub5of100,10,190,5,6030,51,6086
test4sub63of100,test4pub1of100,10,1469,12,6102,86,6200
test4sub68of100,test4pub17of100,10,191,6,5790,83,5879
test4sub50of100,test4pub17of100,10,191,6,5791,82,5879
test4sub85of100,test4pub7of100,10,190,5,6000,80,6085
test4sub46of100,test4pub17of100,10,191,6,5795,80,5881
test4sub59of100,test4pub5of100,10,190,5,6043,79,6127
test4sub94of100,test4pub1of100,10,1469,12,6111,118,6241
test4sub44of100,test4pub6of100,10,190,6,6022,115,6143
test4sub60of100,test4pub10of100,10,191,6,5985,82,6073
test4sub33of100,test4pub17of100,10,191,6,5834,80,5920
test4sub97of100,test4pub14of100,10,191,5,5914,82,6001
test4sub73of100,test4pub1of100,10,1469,12,6152,120,6284
test4sub93of100,test4pub13of100,10,191,5,5943,119,6067
test4sub4of100,test4pub15of100,10,191,5,5875,120,6000
test4sub8of100,test4pub4of100,10,190,5,6104,115,6224
test4sub72of100,test4pub17of100,10,191,6,5852,108,5966
test4sub57of100,test4pub10of100,10,191,6,6006,107,6119
test4sub100of100,test4pub16of100,10,191,5,5872,106,5983
test4sub32of100,test4pub17of100,10,191,6,5857,105,5968
test4sub18of100,test4pub9of100,10,190,5,6042,98,6145
test4sub10of100,test4pub9of100,10,190,5,6042,99,6146
test4sub77of100,test4pub13of100,10,191,5,5970,97,6072
test4sub15of100,test4pub8of100,10,190,5,6061,98,6164
test4sub46of100,test4pub5of100,10,190,5,6122,89,6216
test4sub79of100,test4pub11of100,10,191,5,6027,77,6109
test4sub13of100,test4pub11of100,10,191,5,6030,75,6110
test4sub37of100,test4pub10of100,10,191,6,6048,70,6124
test4sub29of100,test4pub14of100,10,191,5,5977,69,6051
test4sub98of100,test4pub12of100,10,191,5,6017,69,6091
test4sub43of100,test4pub15of100,10,191,5,5945,58,6008
test4sub94of100,test4pub10of100,10,191,6,6066,54,6126
test4sub33of100,test4pub8of100,10,190,5,6110,54,6169
test4sub60of100,test4pub15of100,10,191,5,5951,54,6010
test4sub89of100,test4pub8of100,10,190,5,6119,46,6170
test4sub40of100,test4pub10of100,10,191,6,6083,40,6129
test4sub42of100,test4pub8of100,10,190,5,6127,39,6171
test4sub53of100,test4pub10of100,10,191,6,6087,38,6131
test4sub66of100,test4pub15of100,10,191,5,5977,33,6015
test4sub70of100,test4pub1of100,10,1469,12,6256,72,6340
test4sub97of100,test4pub3of100,10,190,5,6223,66,6294
test4sub73of100,test4pub2of100,10,190,6,6254,55,6315
test4sub93of100,test4pub15of100,10,191,5,5994,56,6055
test4sub8of100,test4pub10of100,10,191,6,6112,54,6172
test4sub18of100,test4pub17of100,10,191,6,5963,54,6023
test4sub77of100,test4pub17of100,10,191,6,5964,53,6023
test4sub13of100,test4pub12of100,10,191,5,6084,50,6139
test4sub29of100,test4pub3of100,10,190,5,6242,50,6297
test4sub43of100,test4pub3of100,10,190,5,6244,49,6298
test4sub94of100,test4pub15of100,10,191,5,6005,49,6059
test4sub60of100,test4pub8of100,10,190,5,6165,48,6218
test4sub89of100,test4pub7of100,10,190,5,6177,48,6230
test4sub40of100,test4pub8of100,10,190,5,6167,47,6219
test4sub53of100,test4pub1of100,10,1469,12,6289,88,6389
test4sub100of100,test4pub3of100,10,190,5,6251,85,6341
test4sub90of100,test4pub12of100,10,191,5,6097,83,6185
test4sub79of100,test4pub6of100,10,190,6,6214,71,6291
test4sub85of100,test4pub13of100,10,191,5,6097,71,6173
test4sub25of100,test4pub12of100,10,191,5,6111,71,6187
test4sub6of100,test4pub15of100,10,191,5,6037,62,6104
test4sub27of100,test4pub13of100,10,191,5,6111,59,6175
test4sub93of100,test4pub8of100,10,190,5,6209,49,6263
test4sub8of100,test4pub16of100,10,191,5,6032,49,6086
test4sub29of100,test4pub13of100,10,191,5,6123,47,6175
test4sub60of100,test4pub6of100,10,190,6,6243,46,6295
test4sub31of100,test4pub10of100,10,191,6,6178,41,6225
test4sub42of100,test4pub12of100,10,191,5,6159,25,6189
test4sub90of100,test4pub8of100,10,190,5,6257,5,6267
test4sub8of100,test4pub12of100,10,191,5,6184,2,6191
test4sub59of100,test4pub9of100,10,190,5,6246,2,6253
test4sub60of100,test4pub9of100,10,190,5,6247,2,6254
test4sub72of100,test4pub13of100,10,191,5,6175,1,6181
test4sub70of100,test4pub17of100,10,191,6,6071,1,6078
test4sub24of100,test4pub14of100,10,191,5,6163,1,6169
test4sub77of100,test4pub10of100,10,191,6,6251,1,6258
test4sub28of100,test4pub9of100,10,190,5,6277,0,6282
test4sub63of100,test4pub12of100,10,191,5,6232,1,6238
test4sub10of100,test4pub16of100,10,191,5,6130,1,6136
test4sub68of100,test4pub5of100,10,190,5,6366,0,6371
test4sub20of100,test4pub8of100,10,190,5,6324,1,6330
test4sub43of100,test4pub9of100,10,190,5,6310,1,6316
test4sub9of100,test4pub10of100,10,191,6,6295,1,6302
test4sub94of100,test4pub13of100,10,191,5,6248,1,6254
test4sub40of100,test4pub9of100,10,190,5,6332,1,6338
test4sub91of100,test4pub12of100,10,191,5,6275,1,6281
test4sub97of100,test4pub13of100,10,191,5,6264,0,6269
test4sub59of100,test4pub15of100,10,191,5,6196,1,6202
test4sub56of100,test4pub2of100,10,190,6,6458,1,6465
test4sub83of100,test4pub10of100,10,191,6,6315,1,6322
test4sub54of100,test4pub15of100,10,191,5,6202,1,6208
test4sub23of100,test4pub5of100,10,190,5,6414,2,6421
test4sub6of100,test4pub13of100,10,191,5,6275,1,6281
test4sub77of100,test4pub2of100,10,190,6,6473,0,6479
test4sub84of100,test4pub16of100,10,191,5,6209,1,6215
test4sub36of100,test4pub14of100,10,191,5,6281,0,6286
test4sub27of100,test4pub10of100,10,191,6,6356,1,6363
test4sub69of100,test4pub6of100,10,190,6,6426,3,6435
test4sub26of100,test4pub6of100,10,190,6,6427,2,6435
test4sub99of100,test4pub5of100,10,190,5,6452,3,6460
test4sub47of100,test4pub13of100,10,191,5,6313,9,6327
test4sub34of100,test4pub2of100,10,190,6,6505,9,6520
test4sub62of100,test4pub2of100,10,190,6,6504,11,6521
test4sub19of100,test4pub2of100,10,190,6,6503,12,6521
test4sub16of100,test4pub5of100,10,190,5,6453,13,6471
test4sub75of100,test4pub2of100,10,190,6,6506,10,6522
test4sub30of100,test4pub5of100,10,190,5,6457,11,6473
test4sub80of100,test4pub8of100,10,190,5,6411,4,6420
test4sub98of100,test4pub8of100,10,190,5,6412,3,6420
test4sub34of100,test4pub7of100,10,190,5,6424,4,6433
test4sub45of100,test4pub13of100,10,191,5,6324,4,6333
test4sub62of100,test4pub5of100,10,190,5,6467,4,6476
test4sub17of100,test4pub14of100,10,191,5,6302,1,6308
test4sub45of100,test4pub12of100,10,191,5,6342,2,6349
test4sub17of100,test4pub15of100,10,191,5,6261,2,6268
test4sub32of100,test4pub8of100,10,190,5,6420,2,6427
test4sub37of100,test4pub17of100,10,191,6,6227,1,6234
test4sub45of100,test4pub16of100,10,191,5,6243,2,6250
test4sub38of100,test4pub16of100,10,191,5,6245,2,6252
test4sub64of100,test4pub15of100,10,191,5,6266,1,6272
test4sub45of100,test4pub4of100,10,190,5,6491,1,6497
test4sub45of100,test4pub8of100,10,190,5,6427,1,6433
test4sub59of100,test4pub17of100,10,191,6,6241,1,6248
test4sub56of100,test4pub6of100,10,190,6,6464,0,6470
test4sub56of100,test4pub9of100,10,190,5,6421,1,6427
test4sub56of100,test4pub15of100,10,191,5,6280,0,6285
test4sub5of100,test4pub16of100,10,191,5,6260,1,6266
test4sub83of100,test4pub16of100,10,191,5,6269,1,6275
test4sub33of100,test4pub13of100,10,191,5,6360,3,6368
test4sub23of100,test4pub7of100,10,190,5,6461,3,6469
test4sub77of100,test4pub15of100,10,191,5,6292,3,6300
test4sub84of100,test4pub14of100,10,191,5,6335,3,6343
test4sub36of100,test4pub9of100,10,190,5,6435,3,6443
test4sub26of100,test4pub11of100,10,191,5,6397,2,6404
test4sub35of100,test4pub7of100,10,190,5,6466,1,6472
test4sub36of100,test4pub6of100,10,190,6,6484,0,6490
test4sub36of100,test4pub3of100,10,190,5,6538,1,6544
test4sub99of100,test4pub15of100,10,191,5,6299,1,6305
test4sub15of100,test4pub17of100,10,191,6,6270,0,6276
test4sub80of100,test4pub16of100,10,191,5,6289,0,6294
test4sub16of100,test4pub15of100,10,191,5,6314,1,6320
test4sub27of100,test4pub1of100,10,1469,12,6593,39,6644
test4sub65of100,test4pub10of100,10,191,6,6434,37,6477
test4sub28of100,test4pub11of100,10,191,5,6421,37,6463
test4sub22of100,test4pub12of100,10,191,5,6401,36,6442
test4sub1of100,test4pub12of100,10,191,5,6401,37,6443
test4sub38of100,test4pub3of100,10,190,5,6560,34,6599
test4sub90of100,test4pub9of100,10,190,5,6464,34,6503
test4sub5of100,test4pub7of100,10,190,5,6496,29,6530
test4sub50of100,test4pub10of100,10,191,6,6452,20,6478
test4sub25of100,test4pub3of100,10,190,5,6592,3,6600
test4sub46of100,test4pub7of100,10,190,5,6536,1,6542
test4sub61of100,test4pub16of100,10,191,5,6348,1,6354
test4sub67of100,test4pub5of100,10,190,5,6579,1,6585
test4sub54of100,test4pub9of100,10,190,5,6509,3,6517
test4sub15of100,test4pub15of100,10,191,5,6370,2,6377
test4sub8of100,test4pub7of100,10,190,5,6536,6,6547
test4sub96of100,test4pub16of100,10,191,5,6351,1,6357
test4sub52of100,test4pub14of100,10,191,5,6415,3,6423
test4sub86of100,test4pub13of100,10,191,5,6442,2,6449
test4sub12of100,test4pub7of100,10,190,5,6544,2,6551
test4sub40of100,test4pub5of100,10,190,5,6590,2,6597
test4sub100of100,test4pub6of100,10,190,6,6567,2,6575
test4sub23of100,test4pub16of100,10,191,5,6361,1,6367
test4sub88of100,test4pub5of100,10,190,5,6592,2,6599
test4sub81of100,test4pub9of100,10,190,5,6531,0,6536
test4sub21of100,test4pub5of100,10,190,5,6604,1,6610
test4sub37of100,test4pub16of100,10,191,5,6374,1,6380
test4sub34of100,test4pub4of100,10,190,5,6633,1,6639
test4sub22of100,test4pub1of100,10,1469,12,6727,41,6780
test4sub10of100,test4pub12of100,10,191,5,6536,36,6577
test4sub77of100,test4pub12of100,10,191,5,6537,36,6578
test4sub94of100,test4pub12of100,10,191,5,6538,35,6578
test4sub88of100,test4pub4of100,10,190,5,6681,34,6720
test4sub90of100,test4pub10of100,10,191,6,6595,13,6614
test4sub2of100,test4pub10of100,10,191,6,6601,7,6614
test4sub40of100,test4pub6of100,10,190,6,6673,7,6686
test4sub78of100,test4pub6of100,10,190,6,6673,6,6685
test4sub51of100,test4pub10of100,10,191,6,6603,7,6616
test4sub3of100,test4pub10of100,10,191,6,6605,5,6616
test4sub99of100,test4pub6of100,10,190,6,6682,2,6690
test4sub73of100,test4pub6of100,10,190,6,6682,3,6691
test4sub84of100,test4pub8of100,10,190,5,6652,5,6662
test4sub29of100,test4pub6of100,10,190,6,6683,3,6692
test4sub52of100,test4pub3of100,10,190,5,6736,2,6743
test4sub18of100,test4pub7of100,10,190,5,6668,1,6674
test4sub98of100,test4pub14of100,10,191,5,6545,2,6552
test4sub34of100,test4pub18of100,10,191,6,6431,3,6440
test4sub71of100,test4pub3of100,10,190,5,6743,5,6753
test4sub43of100,test4pub7of100,10,190,5,6675,6,6686
test4sub72of100,test4pub8of100,10,190,5,6664,6,6675
test4sub46of100,test4pub16of100,10,191,5,6486,6,6497
test4sub82of100,test4pub8of100,10,190,5,6665,5,6675
test4sub26of100,test4pub8of100,10,190,5,6665,5,6675
test4sub14of100,test4pub12of100,10,191,5,6590,4,6599
test4sub13of100,test4pub9of100,10,190,5,6651,5,6661
test4sub37of100,test4pub11of100,10,191,5,6613,4,6622
test4sub41of100,test4pub17of100,10,191,6,6474,3,6483
test4sub40of100,test4pub2of100,10,190,6,6778,0,6784
test4sub12of100,test4pub5of100,10,190,5,6736,2,6743
test4sub11of100,test4pub15of100,10,191,5,6526,2,6533
test4sub27of100,test4pub5of100,10,190,5,6737,1,6743
test4sub53of100,test4pub7of100,10,190,5,6708,1,6714
test4sub2of100,test4pub7of100,10,190,5,6710,1,6716
test4sub85of100,test4pub17of100,10,191,6,6507,1,6514
test4sub3of100,test4pub11of100,10,191,5,6647,1,6653
test4sub15of100,test4pub16of100,10,191,5,6542,0,6547
test4sub47of100,test4pub11of100,10,191,5,6667,0,6672
test4sub20of100,test4pub15of100,10,191,5,6575,1,6581
test4sub52of100,test4pub1of100,10,1469,12,6855,41,6908
test4sub18of100,test4pub8of100,10,190,5,6735,40,6780
test4sub91of100,test4pub1of100,10,1469,12,6860,75,6947
test4sub24of100,test4pub3of100,10,190,5,6822,75,6902
test4sub46of100,test4pub8of100,10,190,5,6747,69,6821
test4sub82of100,test4pub17of100,10,191,6,6554,68,6628
test4sub26of100,test4pub2of100,10,190,6,6853,66,6925
test4sub18of100,test4pub10of100,10,191,6,6734,40,6780
test4sub82of100,test4pub3of100,10,190,5,6898,1,6904
test4sub21of100,test4pub1of100,10,1469,12,6957,39,7008
test4sub73of100,test4pub14of100,10,191,5,6723,38,6766
test4sub25of100,test4pub6of100,10,190,6,6867,39,6912
test4sub76of100,test4pub7of100,10,190,5,6852,37,6894
test4sub81of100,test4pub18of100,10,191,6,6613,35,6654
test4sub65of100,test4pub18of100,10,191,6,6615,33,6654
test4sub94of100,test4pub14of100,10,191,5,6731,33,6769
test4sub90of100,test4pub1of100,10,1469,12,6985,55,7052
test4sub100of100,test4pub14of100,10,191,5,6754,51,6810
test4sub92of100,test4pub18of100,10,191,6,6639,50,6695
test4sub48of100,test4pub5of100,10,190,5,6923,51,6979
test4sub1of100,test4pub7of100,10,190,5,6882,50,6937
test4sub31of100,test4pub3of100,10,190,5,6952,51,7008
test4sub32of100,test4pub18of100,10,191,6,6643,50,6699
test4sub23of100,test4pub1of100,10,1469,12,6996,88,7096
test4sub54of100,test4pub5of100,10,190,5,6930,87,7022
test4sub38of100,test4pub13of100,10,191,5,6804,72,6881
test4sub34of100,test4pub14of100,10,191,5,6790,60,6855
test4sub40of100,test4pub3of100,10,190,5,6995,50,7050
test4sub12of100,test4pub9of100,10,190,5,6901,48,6954
test4sub11of100,test4pub9of100,10,190,5,6903,47,6955
test4sub16of100,test4pub13of100,10,191,5,6833,44,6882
test4sub6of100,test4pub8of100,10,190,5,6922,44,6971
test4sub79of100,test4pub10of100,10,191,6,6882,43,6931
test4sub75of100,test4pub13of100,10,191,5,6836,43,6884
test4sub99of100,test4pub12of100,10,191,5,6849,43,6897
test4sub15of100,test4pub13of100,10,191,5,6837,42,6884
test4sub52of100,test4pub6of100,10,190,6,6956,43,7005
test4sub24of100,test4pub10of100,10,191,6,6887,42,6935
test4sub46of100,test4pub1of100,10,1469,12,7051,81,7144
test4sub62of100,test4pub1of100,10,1469,12,7053,119,7184
test4sub25of100,test4pub15of100,10,191,5,6774,119,6898
test4sub76of100,test4pub17of100,10,191,6,6740,119,6865
test4sub69of100,test4pub8of100,10,190,5,6934,118,7057
test4sub94of100,test4pub3of100,10,190,5,7016,118,7139
test4sub30of100,test4pub17of100,10,191,6,6745,115,6866
test4sub31of100,test4pub13of100,10,191,5,6852,114,6971
test4sub32of100,test4pub3of100,10,190,5,7022,114,7141
test4sub90of100,test4pub5of100,10,190,5,7003,105,7113
test4sub4of100,test4pub3of100,10,190,5,7040,97,7142
test4sub87of100,test4pub9of100,10,190,5,6945,96,7046
test4sub33of100,test4pub9of100,10,190,5,6945,96,7046
test4sub16of100,test4pub16of100,10,191,5,6788,91,6884
test4sub55of100,test4pub11of100,10,191,5,6912,90,7007
test4sub99of100,test4pub10of100,10,191,6,6927,89,7022
test4sub15of100,test4pub7of100,10,190,5,6981,89,7075
test4sub52of100,test4pub18of100,10,191,6,6741,89,6836
test4sub35of100,test4pub5of100,10,190,5,7029,83,7117
test4sub13of100,test4pub8of100,10,190,5,6979,81,7065
test4sub29of100,test4pub18of100,10,191,6,6750,81,6837
test4sub18of100,test4pub3of100,10,190,5,7080,62,7147
test4sub36of100,test4pub13of100,10,191,5,6915,58,6978
test4sub96of100,test4pub13of100,10,191,5,6916,56,6977
test4sub86of100,test4pub9of100,10,190,5,6991,54,7050
test4sub46of100,test4pub13of100,10,191,5,6923,49,6977
test4sub74of100,test4pub13of100,10,191,5,6930,44,6979
test4sub12of100,test4pub11of100,10,191,5,6979,29,7013
test4sub81of100,test4pub3of100,10,190,5,7122,23,7150
test4sub69of100,test4pub18of100,10,191,6,6823,11,6840
test4sub94of100,test4pub16of100,10,191,5,6876,11,6892
test4sub87of100,test4pub11of100,10,191,5,7002,7,7014
test4sub99of100,test4pub3of100,10,190,5,7140,6,7151
test4sub46of100,test4pub10of100,10,191,6,7021,3,7030
test4sub69of100,test4pub17of100,10,191,6,6871,2,6879
test4sub20of100,test4pub11of100,10,191,5,7021,1,7027
test4sub52of100,test4pub7of100,10,190,5,7097,1,7103
test4sub92of100,test4pub9of100,10,190,5,7069,0,7074
test4sub100of100,test4pub17of100,10,191,6,6904,1,6911
test4sub68of100,test4pub8of100,10,190,5,7102,1,7108
test4sub56of100,test4pub8of100,10,190,5,7108,1,7114
test4sub62of100,test4pub14of100,10,191,5,7004,1,7010
test4sub24of100,test4pub11of100,10,191,5,7071,1,7077
test4sub100of100,test4pub11of100,10,191,5,7073,1,7079
test4sub83of100,test4pub12of100,10,191,5,7054,1,7060
test4sub61of100,test4pub8of100,10,190,5,7130,0,7135
test4sub67of100,test4pub7of100,10,190,5,7144,1,7150
test4sub81of100,test4pub14of100,10,191,5,7018,0,7023
test4sub64of100,test4pub1of100,10,1469,12,7258,38,7308
test4sub50of100,test4pub18of100,10,191,6,6908,37,6951
test4sub65of100,test4pub12of100,10,191,5,7063,37,7105
test4sub56of100,test4pub14of100,10,191,5,7025,37,7067
test4sub11of100,test4pub14of100,10,191,5,7027,34,7066
test4sub29of100,test4pub16of100,10,191,5,6969,31,7005
test4sub99of100,test4pub8of100,10,190,5,7147,32,7184
test4sub23of100,test4pub9of100,10,190,5,7132,31,7168
test4sub1of100,test4pub14of100,10,191,5,7034,31,7070
test4sub79of100,test4pub8of100,10,190,5,7149,31,7185
test4sub4of100,test4pub18of100,10,191,6,6921,30,6957
test4sub87of100,test4pub12of100,10,191,5,7075,29,7109
test4sub67of100,test4pub8of100,10,190,5,7174,7,7186
test4sub56of100,test4pub17of100,10,191,6,6984,5,6995
test4sub15of100,test4pub12of100,10,191,5,7103,3,7111
test4sub69of100,test4pub16of100,10,191,5,7004,2,7011
test4sub62of100,test4pub18of100,10,191,6,6955,1,6962
test4sub63of100,test4pub5of100,10,190,5,7241,1,7247
test4sub65of100,test4pub5of100,10,190,5,7254,1,7260
test4sub70of100,test4pub14of100,10,191,5,7092,1,7098
test4sub86of100,test4pub8of100,10,190,5,7209,1,7215
test4sub89of100,test4pub5of100,10,190,5,7277,1,7283
test4sub66of100,test4pub5of100,10,190,5,7279,1,7285
test4sub31of100,test4pub5of100,10,190,5,7280,0,7285
test4sub2of100,test4pub11of100,10,191,5,7175,1,7181
test4sub9of100,test4pub17of100,10,191,6,7036,1,7043
test4sub9of100,test4pub14of100,10,191,5,7117,1,7123
test4sub32of100,test4pub9of100,10,190,5,7222,1,7228
test4sub16of100,test4pub9of100,10,190,5,7225,1,7231
test4sub7of100,test4pub9of100,10,190,5,7226,0,7231
test4sub39of100,test4pub16of100,10,191,5,7079,1,7085
test4sub96of100,test4pub14of100,10,191,5,7145,1,7151
test4sub21of100,test4pub14of100,10,191,5,7146,1,7152
test4sub70of100,test4pub12of100,10,191,5,7193,1,7199
test4sub57of100,test4pub9of100,10,190,5,7256,1,7262
test4sub77of100,test4pub16of100,10,191,5,7113,0,7118
test4sub3of100,test4pub14of100,10,191,5,7202,1,7208
test4sub91of100,test4pub9of100,10,190,5,7314,0,7319
test4sub88of100,test4pub12of100,10,191,5,7261,0,7266
test4sub19of100,test4pub9of100,10,190,5,7327,0,7332
test4sub83of100,test4pub11of100,10,191,5,7293,0,7298
test4sub40of100,test4pub17of100,10,191,6,7158,1,7165
test4sub89of100,test4pub18of100,10,191,6,7123,0,7129
test4sub57of100,test4pub13of100,10,191,5,7267,1,7273
test4sub53of100,test4pub5of100,10,190,5,7417,1,7423
test4sub79of100,test4pub9of100,10,190,5,7354,2,7361
test4sub87of100,test4pub7of100,10,190,5,7382,2,7389
test4sub63of100,test4pub7of100,10,190,5,7383,1,7389
test4sub22of100,test4pub5of100,10,190,5,7428,1,7434
test4sub60of100,test4pub7of100,10,190,5,7388,2,7395
test4sub50of100,test4pub13of100,10,191,5,7288,1,7294
test4sub16of100,test4pub12of100,10,191,5,7302,1,7308
test4sub58of100,test4pub12of100,10,191,5,7304,0,7309
test4sub74of100,test4pub8of100,10,190,5,7391,1,7397
test4sub61of100,test4pub14of100,10,191,5,7280,0,7285
test4sub28of100,test4pub8of100,10,190,5,7410,0,7415
test4sub18of100,test4pub18of100,10,191,6,7183,1,7190
test4sub27of100,test4pub18of100,10,191,6,7183,1,7190
test4sub47of100,test4pub12of100,10,191,5,7341,0,7346
test4sub57of100,test4pub11of100,10,191,5,7367,1,7373
test4sub75of100,test4pub9of100,10,190,5,7415,1,7421
test4sub8of100,test4pub13of100,10,191,5,7343,1,7349
test4sub79of100,test4pub13of100,10,191,5,7345,1,7351
test4sub9of100,test4pub13of100,10,191,5,7352,0,7357
test4sub62of100,test4pub17of100,10,191,6,7241,2,7249
test4sub41of100,test4pub7of100,10,190,5,7461,1,7467
test4sub14of100,test4pub17of100,10,191,6,7254,2,7262
test4sub99of100,test4pub9of100,10,190,5,7434,1,7440
test4sub74of100,test4pub12of100,10,191,5,7375,1,7381
test4sub40of100,test4pub13of100,10,191,5,7369,1,7375
test4sub83of100,test4pub13of100,10,191,5,7371,1,7377
test4sub78of100,test4pub13of100,10,191,5,7372,2,7379
test4sub66of100,test4pub12of100,10,191,5,7386,1,7392
test4sub38of100,test4pub7of100,10,190,5,7475,1,7481
test4sub6of100,test4pub7of100,10,190,5,7476,2,7483
test4sub55of100,test4pub13of100,10,191,5,7376,2,7383
test4sub16of100,test4pub17of100,10,191,6,7272,2,7280
test4sub81of100,test4pub12of100,10,191,5,7391,3,7399
test4sub27of100,test4pub17of100,10,191,6,7273,3,7282
test4sub67of100,test4pub13of100,10,191,5,7379,2,7386
test4sub43of100,test4pub11of100,10,191,5,7414,1,7420
test4sub20of100,test4pub13of100,10,191,5,7386,1,7392
test4sub24of100,test4pub18of100,10,191,6,7246,1,7253
test4sub100of100,test4pub18of100,10,191,6,7247,0,7253
test4sub88of100,test4pub17of100,10,191,6,7288,1,7295
test4sub54of100,test4pub8of100,10,190,5,7484,1,7490
test4sub95of100,test4pub16of100,10,191,5,7305,2,7312
test4sub76of100,test4pub16of100,10,191,5,7314,0,7319
test4sub7of100,test4pub8of100,10,190,5,7493,1,7499
test4sub36of100,test4pub8of100,10,190,5,7498,1,7504
test4sub99of100,test4pub17of100,10,191,6,7322,1,7329
test4sub78of100,test4pub7of100,10,190,5,7542,1,7548
test4sub55of100,test4pub14of100,10,191,5,7421,0,7426
test4sub38of100,test4pub17of100,10,191,6,7350,0,7356
test4sub30of100,test4pub14of100,10,191,5,7432,1,7438
test4sub29of100,test4pub9of100,10,190,5,7533,1,7539
test4sub43of100,test4pub13of100,10,191,5,7462,1,7468
test4sub80of100,test4pub7of100,10,190,5,7564,1,7570
test4sub43of100,test4pub16of100,10,191,5,7375,1,7381
test4sub83of100,test4pub17of100,10,191,6,7367,1,7374
test4sub71of100,test4pub7of100,10,190,5,7574,1,7580
test4sub81of100,test4pub17of100,10,191,6,7370,1,7377
test4sub20of100,test4pub14of100,10,191,5,7450,1,7456
test4sub94of100,test4pub17of100,10,191,6,7393,1,7400
test4sub42of100,test4pub7of100,10,190,5,7600,1,7606
test4sub7of100,test4pub12of100,10,191,5,7513,2,7520
test4sub28of100,test4pub17of100,10,191,6,7397,1,7404
test4sub40of100,test4pub12of100,10,191,5,7514,3,7522
test4sub2of100,test4pub9of100,10,190,5,7575,1,7581
test4sub96of100,test4pub17of100,10,191,6,7402,1,7409
test4sub37of100,test4pub7of100,10,190,5,7608,1,7614
test4sub44of100,test4pub17of100,10,191,6,7403,1,7410
test4sub5of100,test4pub14of100,10,191,5,7490,0,7495
test4sub72of100,test4pub7of100,10,190,5,7619,1,7625
test4sub3of100,test4pub7of100,10,190,5,7620,1,7626
test4sub50of100,test4pub7of100,10,190,5,7622,1,7628
test4sub52of100,test4pub8of100,10,190,5,7610,3,7618
test4sub26of100,test4pub7of100,10,190,5,7623,3,7631
test4sub69of100,test4pub9of100,10,190,5,7596,3,7604
test4sub63of100,test4pub8of100,10,190,5,7612,3,7620
test4sub85of100,test4pub8of100,10,190,5,7613,3,7621
test4sub31of100,test4pub9of100,10,190,5,7597,2,7604
test4sub84of100,test4pub9of100,10,190,5,7612,1,7618
test4sub56of100,test4pub16of100,10,191,5,7450,0,7455
test4sub48of100,test4pub14of100,10,191,5,7518,1,7524
test4sub71of100,test4pub16of100,10,191,5,7460,1,7466
test4sub75of100,test4pub7of100,10,190,5,7673,1,7679
test4sub4of100,test4pub7of100,10,190,5,7676,0,7681
test4sub83of100,test4pub14of100,10,191,5,7560,1,7566
test4sub23of100,test4pub14of100,10,191,5,7564,0,7569
test4sub8of100,test4pub18of100,10,191,6,7451,0,7457
test4sub42of100,test4pub18of100,10,191,6,7453,1,7460
test4sub50of100,test4pub8of100,10,190,5,7691,1,7697
test4sub52of100,test4pub16of100,10,191,5,7513,1,7519
test4sub92of100,test4pub7of100,10,190,5,7705,1,7711
test4sub74of100,test4pub7of100,10,190,5,7706,1,7712
test4sub63of100,test4pub16of100,10,191,5,7516,1,7522
test4sub57of100,test4pub7of100,10,190,5,7707,1,7713
test4sub85of100,test4pub18of100,10,191,6,7468,1,7475
test4sub28of100,test4pub18of100,10,191,6,7468,3,7477
test4sub33of100,test4pub18of100,10,191,6,7469,3,7478
test4sub49of100,test4pub7of100,10,190,5,7712,2,7719
test4sub53of100,test4pub18of100,10,191,6,7471,3,7480
test4sub40of100,test4pub18of100,10,191,6,7472,2,7480
test4sub1of100,test4pub18of100,10,191,6,7473,1,7480
test4sub30of100,test4pub18of100,10,191,6,7475,1,7482
test4sub13of100,test4pub18of100,10,191,6,7476,0,7482
test4sub88of100,test4pub18of100,10,191,6,7482,0,7488
test4sub55of100,test4pub18of100,10,191,6,7485,1,7492
test4sub10of100,test4pub18of100,10,191,6,7488,0,7494
test4sub11of100,test4pub18of100,10,191,6,7494,0,7500
test4sub77of100,test4pub18of100,10,191,6,7497,1,7504
test4sub7of100,test4pub18of100,10,191,6,7531,1,7538
test4sub57of100,test4pub18of100,10,191,6,7544,1,7551
test4sub15of100,test4pub18of100,10,191,6,7546,0,7552
test4sub54of100,test4pub18of100,10,191,6,7545,1,7552
test4sub75of100,test4pub18of100,10,191,6,7548,1,7555
test4sub64of100,test4pub18of100,10,191,6,7548,0,7554
test4sub90of100,test4pub18of100,10,191,6,7563,1,7570
test4sub43of100,test4pub18of100,10,191,6,7563,2,7571
test4sub58of100,test4pub18of100,10,191,6,7589,1,7596
test4sub45of100,test4pub18of100,10,191,6,7590,2,7598
test4sub3of100,test4pub18of100,10,191,6,7591,2,7599
test4sub49of100,test4pub18of100,10,191,6,7592,0,7598
test4sub39of100,test4pub18of100,10,191,6,7604,1,7611
test4sub51of100,test4pub18of100,10,191,6,7605,0,7611
test4sub71of100,test4pub18of100,10,191,6,7615,0,7621
test4sub93of100,test4pub18of100,10,191,6,7620,1,7627
test4sub91of100,test4pub18of100,10,191,6,7623,1,7630
test4sub19of100,test4pub18of100,10,191,6,7623,1,7630
test4sub26of100,test4pub18of100,10,191,6,7632,1,7639
test4sub76of100,test4pub18of100,10,191,6,7641,0,7647
test4sub6of100,test4pub18of100,10,191,6,7648,1,7655
test4sub95of100,test4pub18of100,10,191,6,7655,1,7662
test4sub41of100,test4pub18of100,10,191,6,7657,1,7664
test4sub70of100,test4pub18of100,10,191,6,7660,1,7667
test4sub68of100,test4pub18of100,10,191,6,7668,1,7675
test4sub94of100,test4pub18of100,10,191,6,7670,1,7677
test4sub21of100,test4pub18of100,10,191,6,7690,1,7697
test4sub98of100,test4pub18of100,10,191,6,7695,1,7702
test4sub25of100,test4pub18of100,10,191,6,7700,1,7707
test4sub80of100,test4pub18of100,10,191,6,7704,0,7710
test4sub83of100,test4pub18of100,10,191,6,7708,1,7715
test4sub2of100,test4pub18of100,10,191,6,7709,1,7716
test4sub84of100,test4pub18of100,10,191,6,7714,1,7721
test4sub48of100,test4pub18of100,10,191,6,7717,0,7723
test4sub5of100,test4pub18of100,10,191,6,7721,1,7728
test4sub56of100,test4pub18of100,10,191,6,7728,2,7736
test4sub96of100,test4pub18of100,10,191,6,7727,1,7734
test4sub44of100,test4pub18of100,10,191,6,7727,1,7734
test4sub74of100,test4pub18of100,10,191,6,7733,1,7740
test4sub12of100,test4pub18of100,10,191,6,7738,1,7745
test4sub79of100,test4pub18of100,10,191,6,7741,1,7748
test4sub66of100,test4pub18of100,10,191,6,7744,1,7751
test4sub82of100,test4pub18of100,10,191,6,7750,1,7757
test4sub16of100,test4pub18of100,10,191,6,7754,0,7760
test4sub86of100,test4pub18of100,10,191,6,7765,1,7772
test4sub72of100,test4pub18of100,10,191,6,7770,0,7776
test4sub67of100,test4pub18of100,10,191,6,7790,1,7797
test4sub31of100,test4pub18of100,10,191,6,7794,1,7801
test4sub46of100,test4pub18of100,10,191,6,7802,1,7809
test4sub47of100,test4pub18of100,10,191,6,7808,1,7815
test4sub37of100,test4pub18of100,10,191,6,7813,0,7819
test4sub36of100,test4pub18of100,10,191,6,7815,1,7822
test4sub60of100,test4pub18of100,10,191,6,7816,1,7823
test4sub63of100,test4pub18of100,10,191,6,7822,1,7829
test4sub35of100,test4pub18of100,10,191,6,7823,0,7829
test4sub61of100,test4pub18of100,10,191,6,7825,1,7832
test4sub73of100,test4pub18of100,10,191,6,7825,0,7831
test4sub78of100,test4pub18of100,10,191,6,7835,1,7842
test4sub22of100,test4pub18of100,10,191,6,7839,0,7845
test4sub38of100,test4pub18of100,10,191,6,7846,0,7852
test4sub17of100,test4pub18of100,10,191,6,7847,1,7854
test4sub99of100,test4pub18of100,10,191,6,7854,0,7860
test4sub20of100,test4pub18of100,10,191,6,7859,0,7865
test4sub59of100,test4pub18of100,10,191,6,7867,1,7874
test4sub87of100,test4pub18of100,10,191,6,7885,1,7892
test4sub14of100,test4pub18of100,10,191,6,7895,1,7902
test4sub9of100,test4pub18of100,10,191,6,7898,0,7904
test4sub23of100,test4pub18of100,10,191,6,7903,1,7910
test4sub97of100,test4pub18of100,10,191,6,7908,1,7915
