subtest21of10,pubtest21of1,1,319,8035,21,110,8166
subtest29of10,pubtest21of1,1,319,8035,17,109,8161
subtest28of10,pubtest21of1,1,319,8035,29,111,8175
subtest24of10,pubtest21of1,1,319,8035,17,111,8163
subtest25of10,pubtest21of1,1,319,8035,18,111,8164
subtest22of10,pubtest21of1,1,319,8035,33,114,8182
subtest26of10,pubtest21of1,1,319,8035,19,113,8167
subtest27of10,pubtest21of1,1,319,8035,17,114,8166
subtest23of10,pubtest21of1,1,319,8035,34,113,8182
subtest210of10,pubtest21of1,1,319,8035,24,115,8174
subtest26of10,pubtest21of1,1,319,7904,6,1,7911
subtest29of10,pubtest21of1,1,319,7904,10,6,7920
subtest25of10,pubtest21of1,1,319,7904,14,4,7922
subtest24of10,pubtest21of1,1,319,7904,9,1,7914
subtest27of10,pubtest21of1,1,319,7904,7,3,7914
subtest21of10,pubtest21of1,1,319,7904,19,1,7924
subtest210of10,pubtest21of1,1,319,7904,28,0,7932
subtest28of10,pubtest21of1,1,319,7904,31,1,7936
subtest22of10,pubtest21of1,1,319,7904,34,1,7939
subtest23of10,pubtest21of1,1,319,7904,35,1,7940
subtest26of10,pubtest21of1,1,319,7913,3,1,7917
subtest27of10,pubtest21of1,1,319,7913,6,0,7919
subtest24of10,pubtest21of1,1,319,7913,8,0,7921
subtest29of10,pubtest21of1,1,319,7913,13,1,7927
subtest21of10,pubtest21of1,1,319,7913,17,1,7931
subtest210of10,pubtest21of1,1,319,7913,20,1,7934
subtest25of10,pubtest21of1,1,319,7913,16,0,7929
subtest28of10,pubtest21of1,1,319,7913,21,3,7937
subtest22of10,pubtest21of1,1,319,7913,24,0,7937
subtest23of10,pubtest21of1,1,319,7913,26,0,7939
subtest27of10,pubtest21of1,1,319,7977,6,2,7985
subtest21of10,pubtest21of1,1,319,7977,23,4,8004
subtest210of10,pubtest21of1,1,319,7977,24,4,8005
subtest28of10,pubtest21of1,1,319,7977,23,1,8001
subtest23of10,pubtest21of1,1,319,7977,25,16,8018
subtest26of10,pubtest21of1,1,319,7977,8,18,8003
subtest29of10,pubtest21of1,1,319,7977,9,23,8009
subtest24of10,pubtest21of1,1,319,7977,10,12,7999
subtest25of10,pubtest21of1,1,319,7977,22,1,8000
subtest22of10,pubtest21of1,1,319,7977,23,11,8011
subtest27of10,pubtest21of1,1,319,7950,2,0,7952
subtest29of10,pubtest21of1,1,319,7950,5,1,7956
subtest25of10,pubtest21of1,1,319,7950,8,1,7959
subtest26of10,pubtest21of1,1,319,7950,2,11,7963
subtest21of10,pubtest21of1,1,319,7950,9,4,7963
subtest28of10,pubtest21of1,1,319,7950,18,3,7971
subtest22of10,pubtest21of1,1,319,7950,21,1,7972
subtest210of10,pubtest21of1,1,319,7950,11,9,7970
subtest23of10,pubtest21of1,1,319,7950,29,0,7979
subtest24of10,pubtest21of1,1,319,7950,18,8,7976
subtest24of10,pubtest21of1,1,319,8131,27,344,8502
subtest210of10,pubtest21of1,1,319,8131,27,383,8541
subtest29of10,pubtest21of1,1,319,8131,27,421,8579
subtest22of10,pubtest21of1,1,319,8131,24,465,8620
subtest27of10,pubtest21of1,1,319,8131,24,504,8659
subtest23of10,pubtest21of1,1,319,8131,28,543,8702
subtest21of10,pubtest21of1,1,319,8131,28,583,8742
subtest26of10,pubtest21of1,1,319,8131,25,620,8776
subtest28of10,pubtest21of1,1,319,8131,26,663,8820
subtest25of10,pubtest21of1,1,319,8131,27,701,8859
subtest24of10,pubtest21of1,1,319,7934,6,49,7989
subtest26of10,pubtest21of1,1,319,7934,5,87,8026
subtest27of10,pubtest21of1,1,319,7934,4,124,8062
subtest22of10,pubtest21of1,1,319,7934,17,157,8108
subtest28of10,pubtest21of1,1,319,7934,19,194,8147
subtest21of10,pubtest21of1,1,319,7934,15,327,8276
subtest23of10,pubtest21of1,1,319,7934,24,327,8285
subtest25of10,pubtest21of1,1,319,7934,21,367,8322
subtest29of10,pubtest21of1,1,319,7934,16,406,8356
subtest210of10,pubtest21of1,1,319,7934,19,440,8393
subtest26of10,pubtest21of1,1,319,7950,5,39,7994
subtest27of10,pubtest21of1,1,319,7950,6,77,8033
subtest29of10,pubtest21of1,1,319,7950,11,112,8073
subtest24of10,pubtest21of1,1,319,7950,11,151,8112
subtest25of10,pubtest21of1,1,319,7950,15,175,8140
subtest22of10,pubtest21of1,1,319,7950,31,212,8193
subtest23of10,pubtest21of1,1,319,7950,32,253,8235
subtest21of10,pubtest21of1,1,319,7950,15,289,8254
subtest28of10,pubtest21of1,1,319,7950,34,326,8310
subtest210of10,pubtest21of1,1,319,7950,37,366,8353
subtest27of10,pubtest21of1,1,319,7934,3,38,7975
subtest26of10,pubtest21of1,1,319,7934,7,74,8015
subtest24of10,pubtest21of1,1,319,7934,8,113,8055
subtest29of10,pubtest21of1,1,319,7934,10,150,8094
subtest25of10,pubtest21of1,1,319,7934,20,180,8134
subtest21of10,pubtest21of1,1,319,7934,21,219,8174
subtest210of10,pubtest21of1,1,319,7934,27,253,8214
subtest28of10,pubtest21of1,1,319,7934,28,293,8255
subtest23of10,pubtest21of1,1,319,7934,31,329,8294
subtest22of10,pubtest21of1,1,319,7934,31,365,8330
subtest27of10,pubtest21of1,1,319,8017,6,42,8065
subtest29of10,pubtest21of1,1,319,8017,11,77,8105
subtest25of10,pubtest21of1,1,319,8017,11,115,8143
subtest26of10,pubtest21of1,1,319,8017,10,154,8181
subtest23of10,pubtest21of1,1,319,8017,18,190,8225
subtest21of10,pubtest21of1,1,319,8017,17,228,8262
subtest210of10,pubtest21of1,1,319,8017,19,267,8303
subtest28of10,pubtest21of1,1,319,8017,22,305,8344
subtest22of10,pubtest21of1,1,319,8017,25,352,8394
subtest24of10,pubtest21of1,1,319,8017,15,382,8414
subtest26of10,pubtest21of1,1,319,7920,2,39,7961
subtest27of10,pubtest21of1,1,319,7920,5,76,8001
subtest24of10,pubtest21of1,1,319,7920,11,110,8041
subtest29of10,pubtest21of1,1,319,7920,16,145,8081
subtest25of10,pubtest21of1,1,319,7920,22,179,8121
subtest21of10,pubtest21of1,1,319,7920,24,215,8159
subtest210of10,pubtest21of1,1,319,7920,31,249,8200
subtest28of10,pubtest21of1,1,319,7920,33,287,8240
subtest22of10,pubtest21of1,1,319,7920,34,326,8280
subtest23of10,pubtest21of1,1,319,7920,36,364,8320
subtest26of10,pubtest21of1,1,319,7990,3,53,8046
subtest27of10,pubtest21of1,1,319,7990,5,91,8086
subtest24of10,pubtest21of1,1,319,7990,7,129,8126
subtest25of10,pubtest21of1,1,319,7990,10,166,8166
subtest21of10,pubtest21of1,1,319,7990,13,203,8206
subtest210of10,pubtest21of1,1,319,7990,16,240,8246
subtest29of10,pubtest21of1,1,319,7990,14,279,8283
subtest28of10,pubtest21of1,1,319,7990,19,316,8325
subtest22of10,pubtest21of1,1,319,7990,22,353,8365
subtest23of10,pubtest21of1,1,319,7990,23,392,8405
subtest27of10,pubtest21of1,1,319,8301,3,40,8344
subtest26of10,pubtest21of1,1,319,8301,9,74,8384
subtest24of10,pubtest21of1,1,319,8301,14,109,8424
subtest29of10,pubtest21of1,1,319,8301,16,147,8464
subtest25of10,pubtest21of1,1,319,8301,19,184,8504
subtest21of10,pubtest21of1,1,319,8301,22,220,8543
subtest22of10,pubtest21of1,1,319,8301,28,254,8583
subtest23of10,pubtest21of1,1,319,8301,31,292,8624
subtest210of10,pubtest21of1,1,319,8301,24,331,8656
subtest28of10,pubtest21of1,1,319,8301,34,370,8705
subtest27of10,pubtest21of1,1,319,8832,2,41,8875
subtest26of10,pubtest21of1,1,319,8832,4,79,8915
subtest29of10,pubtest21of1,1,319,8832,5,117,8954
subtest25of10,pubtest21of1,1,319,8832,32,131,8995
subtest21of10,pubtest21of1,1,319,8832,33,171,9036
subtest24of10,pubtest21of1,1,319,8832,32,208,9072
subtest210of10,pubtest21of1,1,319,8832,36,246,9114
subtest28of10,pubtest21of1,1,319,8832,42,282,9156
subtest22of10,pubtest21of1,1,319,8832,42,321,9195
subtest23of10,pubtest21of1,1,319,8832,46,356,9234
subtest27of10,pubtest21of1,1,319,8481,1,42,8524
subtest26of10,pubtest21of1,1,319,8481,7,75,8563
subtest24of10,pubtest21of1,1,319,8481,10,111,8602
subtest29of10,pubtest21of1,1,319,8481,13,149,8643
subtest25of10,pubtest21of1,1,319,8481,25,177,8683
subtest210of10,pubtest21of1,1,319,8481,27,215,8723
subtest28of10,pubtest21of1,1,319,8481,30,253,8764
subtest22of10,pubtest21of1,1,319,8481,29,293,8803
subtest21of10,pubtest21of1,1,319,8481,27,331,8839
subtest23of10,pubtest21of1,1,319,8481,30,370,8881
subtest26of10,pubtest21of1,1,319,8707,3,41,8751
subtest27of10,pubtest21of1,1,319,8707,7,77,8791
subtest29of10,pubtest21of1,1,319,8707,6,114,8827
subtest25of10,pubtest21of1,1,319,8707,10,154,8871
subtest24of10,pubtest21of1,1,319,8707,6,192,8905
subtest21of10,pubtest21of1,1,319,8707,14,229,8950
subtest210of10,pubtest21of1,1,319,8707,17,266,8990
subtest28of10,pubtest21of1,1,319,8707,26,297,9030
subtest22of10,pubtest21of1,1,319,8707,28,335,9070
subtest23of10,pubtest21of1,1,319,8707,30,373,9110
subtest27of10,pubtest21of1,1,319,8785,3,39,8827
subtest26of10,pubtest21of1,1,319,8785,2,78,8865
subtest24of10,pubtest21of1,1,319,8785,6,114,8905
subtest29of10,pubtest21of1,1,319,8785,12,149,8946
subtest25of10,pubtest21of1,1,319,8785,19,181,8985
subtest210of10,pubtest21of1,1,319,8785,22,220,9027
subtest21of10,pubtest21of1,1,319,8785,20,261,9066
subtest28of10,pubtest21of1,1,319,8785,26,295,9106
subtest22of10,pubtest21of1,1,319,8785,27,334,9146
subtest23of10,pubtest21of1,1,319,8785,28,372,9185
subtest26of10,pubtest21of1,1,319,8884,6,40,8930
subtest27of10,pubtest21of1,1,319,8884,6,79,8969
subtest25of10,pubtest21of1,1,319,8884,9,116,9009
subtest28of10,pubtest21of1,1,319,8884,11,153,9048
subtest210of10,pubtest21of1,1,319,8884,11,193,9088
subtest29of10,pubtest21of1,1,319,8884,11,231,9126
subtest21of10,pubtest21of1,1,319,8884,13,271,9168
subtest23of10,pubtest21of1,1,319,8884,22,303,9209
subtest22of10,pubtest21of1,1,319,8884,25,340,9249
subtest24of10,pubtest21of1,1,319,8884,8,379,9271
subtest27of10,pubtest21of1,1,319,8962,10,42,9014
subtest29of10,pubtest21of1,1,319,8962,13,78,9053
subtest25of10,pubtest21of1,1,319,8962,14,116,9092
subtest21of10,pubtest21of1,1,319,8962,16,154,9132
subtest23of10,pubtest21of1,1,319,8962,19,192,9173
subtest26of10,pubtest21of1,1,319,8962,21,229,9212
subtest24of10,pubtest21of1,1,319,8962,23,268,9253
subtest210of10,pubtest21of1,1,319,8962,25,305,9292
subtest28of10,pubtest21of1,1,319,8962,31,340,9333
subtest22of10,pubtest21of1,1,319,8962,36,374,9372
subtest27of10,pubtest21of1,1,319,9241,0,41,9282
subtest26of10,pubtest21of1,1,319,9241,2,78,9321
subtest29of10,pubtest21of1,1,319,9241,7,114,9362
subtest24of10,pubtest21of1,1,319,9241,9,151,9401
subtest210of10,pubtest21of1,1,319,9241,14,187,9442
subtest25of10,pubtest21of1,1,319,9241,16,225,9482
subtest21of10,pubtest21of1,1,319,9241,19,262,9522
subtest28of10,pubtest21of1,1,319,9241,21,300,9562
subtest22of10,pubtest21of1,1,319,9241,24,337,9602
subtest23of10,pubtest21of1,1,319,9241,24,379,9644
subtest26of10,pubtest21of1,1,319,9477,6,39,9522
subtest29of10,pubtest21of1,1,319,9477,9,75,9561
subtest27of10,pubtest21of1,1,319,9477,9,115,9601
subtest24of10,pubtest21of1,1,319,9477,12,153,9642
subtest25of10,pubtest21of1,1,319,9477,12,192,9681
subtest21of10,pubtest21of1,1,319,9477,22,222,9721
subtest210of10,pubtest21of1,1,319,9477,22,262,9761
subtest28of10,pubtest21of1,1,319,9477,29,295,9801
subtest22of10,pubtest21of1,1,319,9477,35,329,9841
subtest23of10,pubtest21of1,1,319,9477,35,369,9881
subtest27of10,pubtest21of1,1,319,9881,1,40,9922
subtest26of10,pubtest21of1,1,319,9881,5,75,9961
subtest24of10,pubtest21of1,1,319,9881,7,113,10001
subtest29of10,pubtest21of1,1,319,9881,10,151,10042
subtest25of10,pubtest21of1,1,319,9881,15,184,10080
subtest210of10,pubtest21of1,1,319,9881,16,223,10120
subtest28of10,pubtest21of1,1,319,9881,17,262,10160
subtest22of10,pubtest21of1,1,319,9881,19,301,10201
subtest21of10,pubtest21of1,1,319,9881,15,340,10236
subtest23of10,pubtest21of1,1,319,9881,24,375,10280
subtest27of10,pubtest21of1,1,319,9901,1,42,9944
subtest26of10,pubtest21of1,1,319,9901,2,82,9985
subtest24of10,pubtest21of1,1,319,9901,11,112,10024
subtest29of10,pubtest21of1,1,319,9901,14,149,10064
subtest25of10,pubtest21of1,1,319,9901,28,175,10104
subtest21of10,pubtest21of1,1,319,9901,29,211,10141
subtest210of10,pubtest21of1,1,319,9901,33,249,10183
subtest28of10,pubtest21of1,1,319,9901,35,287,10223
subtest22of10,pubtest21of1,1,319,9901,38,324,10263
subtest23of10,pubtest21of1,1,319,9901,39,363,10303
subtest26of10,pubtest21of1,1,319,9915,3,41,9959
subtest27of10,pubtest21of1,1,319,9915,6,77,9998
subtest29of10,pubtest21of1,1,319,9915,12,112,10039
subtest24of10,pubtest21of1,1,319,9915,13,152,10080
subtest25of10,pubtest21of1,1,319,9915,15,188,10118
subtest21of10,pubtest21of1,1,319,9915,16,227,10158
subtest210of10,pubtest21of1,1,319,9915,18,265,10198
subtest28of10,pubtest21of1,1,319,9915,19,305,10239
subtest23of10,pubtest21of1,1,319,9915,20,343,10278
subtest22of10,pubtest21of1,1,319,9915,21,382,10318
subtest26of10,pubtest21of1,1,319,9931,3,42,9976
subtest29of10,pubtest21of1,1,319,9931,6,80,10017
subtest25of10,pubtest21of1,1,319,9931,7,118,10056
subtest27of10,pubtest21of1,1,319,9931,4,159,10094
subtest24of10,pubtest21of1,1,319,9931,8,195,10134
subtest21of10,pubtest21of1,1,319,9931,11,232,10174
subtest28of10,pubtest21of1,1,319,9931,16,267,10214
subtest22of10,pubtest21of1,1,319,9931,20,304,10255
subtest23of10,pubtest21of1,1,319,9931,20,344,10295
subtest210of10,pubtest21of1,1,319,9931,16,383,10330
subtest26of10,pubtest21of1,1,319,9990,2,49,10041
subtest24of10,pubtest21of1,1,319,9990,4,86,10080
subtest27of10,pubtest21of1,1,319,9990,2,128,10120
subtest210of10,pubtest21of1,1,319,9990,9,161,10160
subtest25of10,pubtest21of1,1,319,9990,9,201,10200
subtest28of10,pubtest21of1,1,319,9990,12,237,10239
subtest22of10,pubtest21of1,1,319,9990,13,276,10279
subtest29of10,pubtest21of1,1,319,9990,7,315,10312
subtest23of10,pubtest21of1,1,319,9990,12,354,10356
subtest21of10,pubtest21of1,1,319,9990,12,393,10395
subtest26of10,pubtest21of1,1,319,9605,1,56,9662
subtest27of10,pubtest21of1,1,319,9605,2,94,9701
subtest24of10,pubtest21of1,1,319,9605,4,132,9741
subtest25of10,pubtest21of1,1,319,9605,7,170,9782
subtest210of10,pubtest21of1,1,319,9605,9,207,9821
subtest23of10,pubtest21of1,1,319,9605,13,244,9862
subtest21of10,pubtest21of1,1,319,9605,9,283,9897
subtest28of10,pubtest21of1,1,319,9605,16,321,9942
subtest29of10,pubtest21of1,1,319,9605,18,359,9982
subtest22of10,pubtest21of1,1,319,9605,15,395,10015
subtest27of10,pubtest21of1,1,320,10429,1,41,10471
subtest26of10,pubtest21of1,1,320,10429,2,80,10511
subtest29of10,pubtest21of1,1,320,10429,10,113,10552
subtest25of10,pubtest21of1,1,320,10429,12,152,10593
subtest21of10,pubtest21of1,1,320,10429,12,191,10632
subtest23of10,pubtest21of1,1,320,10429,15,229,10673
subtest24of10,pubtest21of1,1,320,10429,17,266,10712
subtest210of10,pubtest21of1,1,320,10429,17,306,10752
subtest28of10,pubtest21of1,1,320,10429,20,344,10793
subtest22of10,pubtest21of1,1,320,10429,20,383,10832
subtest26of10,pubtest21of1,1,320,10278,3,43,10324
subtest27of10,pubtest21of1,1,320,10278,4,81,10363
subtest24of10,pubtest21of1,1,320,10278,8,117,10403
subtest29of10,pubtest21of1,1,320,10278,9,157,10444
subtest21of10,pubtest21of1,1,320,10278,13,192,10483
subtest25of10,pubtest21of1,1,320,10278,13,232,10523
subtest28of10,pubtest21of1,1,320,10278,16,270,10564
subtest210of10,pubtest21of1,1,320,10278,16,310,10604
subtest22of10,pubtest21of1,1,320,10278,19,347,10644
subtest23of10,pubtest21of1,1,320,10278,19,386,10683
subtest27of10,pubtest21of1,1,320,10316,3,39,10358
subtest26of10,pubtest21of1,1,320,10316,6,75,10397
subtest24of10,pubtest21of1,1,320,10316,7,114,10437
subtest29of10,pubtest21of1,1,320,10316,10,152,10478
subtest25of10,pubtest21of1,1,320,10316,12,189,10517
subtest21of10,pubtest21of1,1,320,10316,14,228,10558
subtest210of10,pubtest21of1,1,320,10316,22,260,10598
subtest28of10,pubtest21of1,1,320,10316,24,298,10638
subtest22of10,pubtest21of1,1,320,10316,28,333,10677
subtest23of10,pubtest21of1,1,320,10316,31,370,10717
subtest26of10,pubtest21of1,1,320,10639,3,48,10690
subtest27of10,pubtest21of1,1,320,10639,3,87,10729
subtest24of10,pubtest21of1,1,320,10639,6,125,10770
subtest29of10,pubtest21of1,1,320,10639,18,152,10809
subtest21of10,pubtest21of1,1,320,10639,22,188,10849
subtest25of10,pubtest21of1,1,320,10639,22,228,10889
subtest210of10,pubtest21of1,1,320,10639,26,264,10929
subtest28of10,pubtest21of1,1,320,10639,26,304,10969
subtest22of10,pubtest21of1,1,320,10639,30,340,11009
subtest23of10,pubtest21of1,1,320,10639,31,380,11050
subtest26of10,pubtest21of1,1,320,11020,3,52,11075
subtest24of10,pubtest21of1,1,320,11020,9,81,11110
subtest210of10,pubtest21of1,1,320,11020,12,122,11154
subtest29of10,pubtest21of1,1,320,11020,10,164,11194
subtest21of10,pubtest21of1,1,320,11020,9,205,11234
subtest27of10,pubtest21of1,1,320,11020,4,247,11271
subtest25of10,pubtest21of1,1,320,11020,7,287,11314
subtest28of10,pubtest21of1,1,320,11020,17,315,11352
subtest23of10,pubtest21of1,1,320,11020,20,354,11394
subtest22of10,pubtest21of1,1,320,11020,18,393,11431
subtest26of10,pubtest21of1,1,320,10208,7,42,10257
subtest27of10,pubtest21of1,1,320,10208,6,82,10296
subtest24of10,pubtest21of1,1,320,10208,9,119,10336
subtest29of10,pubtest21of1,1,320,10208,10,158,10376
subtest25of10,pubtest21of1,1,320,10208,13,195,10416
subtest21of10,pubtest21of1,1,320,10208,13,235,10456
subtest210of10,pubtest21of1,1,320,10208,19,269,10496
subtest28of10,pubtest21of1,1,320,10208,23,305,10536
subtest22of10,pubtest21of1,1,320,10208,27,341,10576
subtest23of10,pubtest21of1,1,320,10208,30,378,10616
subtest27of10,pubtest21of1,1,320,10140,3,39,10182
subtest26of10,pubtest21of1,1,320,10140,3,78,10221
subtest24of10,pubtest21of1,1,320,10140,6,115,10261
subtest29of10,pubtest21of1,1,320,10140,5,155,10300
subtest25of10,pubtest21of1,1,320,10140,11,190,10341
subtest21of10,pubtest21of1,1,320,10140,14,226,10380
subtest210of10,pubtest21of1,1,320,10140,16,264,10420
subtest28of10,pubtest21of1,1,320,10140,21,300,10461
subtest22of10,pubtest21of1,1,320,10140,23,338,10501
subtest23of10,pubtest21of1,1,320,10140,27,374,10541
subtest24of10,pubtest21of1,1,320,10752,4,55,10811
subtest27of10,pubtest21of1,1,320,10752,3,95,10850
subtest26of10,pubtest21of1,1,320,10752,5,133,10890
subtest29of10,pubtest21of1,1,320,10752,7,172,10931
subtest28of10,pubtest21of1,1,320,10752,10,209,10971
subtest210of10,pubtest21of1,1,320,10752,12,247,11011
subtest25of10,pubtest21of1,1,320,10752,12,286,11050
subtest23of10,pubtest21of1,1,320,10752,14,324,11090
subtest21of10,pubtest21of1,1,320,10752,16,364,11132
subtest22of10,pubtest21of1,1,320,10752,14,401,11167
subtest26of10,pubtest21of1,10,1482,11393,8,138,11539
subtest29of10,pubtest21of1,10,1482,11393,12,175,11580
subtest24of10,pubtest21of1,10,1482,11393,15,212,11620
subtest27of10,pubtest21of1,10,1482,11393,10,249,11652
subtest25of10,pubtest21of1,10,1482,11393,20,286,11699
subtest21of10,pubtest21of1,10,1482,11393,28,320,11741
subtest210of10,pubtest21of1,10,1482,11393,29,357,11779
subtest28of10,pubtest21of1,10,1482,11393,33,393,11819
subtest23of10,pubtest21of1,10,1482,11393,42,425,11860
subtest22of10,pubtest21of1,10,1482,11393,37,464,11894
subtest26of10,pubtest21of1,10,1482,10774,8,39,10821
subtest24of10,pubtest21of1,10,1482,10774,19,68,10861
subtest27of10,pubtest21of1,10,1482,10774,21,106,10901
subtest29of10,pubtest21of1,10,1482,10774,27,140,10941
subtest25of10,pubtest21of1,10,1482,10774,29,178,10981
subtest21of10,pubtest21of1,10,1482,10774,35,212,11021
subtest210of10,pubtest21of1,10,1482,10774,37,250,11061
subtest28of10,pubtest21of1,10,1482,10774,39,288,11101
subtest22of10,pubtest21of1,10,1482,10774,42,325,11141
subtest23of10,pubtest21of1,10,1482,10774,46,361,11181
subtest27of10,pubtest21of1,10,1482,10125,13,45,10183
subtest24of10,pubtest21of1,10,1482,10125,16,78,10219
subtest29of10,pubtest21of1,10,1482,10125,25,114,10264
subtest25of10,pubtest21of1,10,1482,10125,27,151,10303
subtest21of10,pubtest21of1,10,1482,10125,30,188,10343
subtest210of10,pubtest21of1,10,1482,10125,32,226,10383
subtest28of10,pubtest21of1,10,1482,10125,37,262,10424
subtest22of10,pubtest21of1,10,1482,10125,41,297,10463
subtest23of10,pubtest21of1,10,1482,10125,44,335,10504
subtest26of10,pubtest21of1,10,1482,10125,11,160,10296
subtest26of10,pubtest21of1,10,1482,11004,7,41,11052
subtest27of10,pubtest21of1,10,1482,11004,10,79,11093
subtest29of10,pubtest21of1,10,1482,11004,22,107,11133
subtest25of10,pubtest21of1,10,1482,11004,51,117,11172
subtest21of10,pubtest21of1,10,1482,11004,53,155,11212
subtest210of10,pubtest21of1,10,1482,11004,65,184,11253
subtest28of10,pubtest21of1,10,1482,11004,67,221,11292
subtest22of10,pubtest21of1,10,1482,11004,77,251,11332
subtest23of10,pubtest21of1,10,1482,11004,78,290,11372
subtest24of10,pubtest21of1,10,1482,11004,19,41,11064
subtest27of10,pubtest21of1,10,1482,10573,19,39,10631
subtest29of10,pubtest21of1,10,1482,10573,22,76,10671
subtest25of10,pubtest21of1,10,1482,10573,25,114,10712
subtest21of10,pubtest21of1,10,1482,10573,26,152,10751
subtest23of10,pubtest21of1,10,1482,10573,29,190,10792
subtest26of10,pubtest21of1,10,1482,10573,31,228,10832
subtest24of10,pubtest21of1,10,1482,10573,32,267,10872
subtest210of10,pubtest21of1,10,1482,10573,34,305,10912
subtest22of10,pubtest21of1,10,1482,10573,35,343,10951
subtest28of10,pubtest21of1,10,1482,10573,37,382,10992
subtest26of10,pubtest21of1,10,1481,9706,7,44,9757
subtest27of10,pubtest21of1,10,1481,9706,10,82,9798
subtest24of10,pubtest21of1,10,1481,9706,14,119,9839
subtest29of10,pubtest21of1,10,1481,9706,28,144,9878
subtest25of10,pubtest21of1,10,1481,9706,31,181,9918
subtest21of10,pubtest21of1,10,1481,9706,32,220,9958
subtest210of10,pubtest21of1,10,1481,9706,36,256,9998
subtest28of10,pubtest21of1,10,1481,9706,42,290,10038
subtest22of10,pubtest21of1,10,1481,9706,47,326,10079
subtest23of10,pubtest21of1,10,1481,9706,50,362,10118
subtest27of10,pubtest21of1,10,1481,9831,17,39,9887
subtest29of10,pubtest21of1,10,1481,9831,18,78,9927
subtest25of10,pubtest21of1,10,1481,9831,21,116,9968
subtest21of10,pubtest21of1,10,1481,9831,27,150,10008
subtest23of10,pubtest21of1,10,1481,9831,31,186,10048
subtest26of10,pubtest21of1,10,1481,9831,37,219,10087
subtest24of10,pubtest21of1,10,1481,9831,44,250,10125
subtest210of10,pubtest21of1,10,1481,9831,47,289,10167
subtest28of10,pubtest21of1,10,1481,9831,50,326,10207
subtest22of10,pubtest21of1,10,1481,9831,53,363,10247
subtest26of10,pubtest21of1,10,1481,9767,7,51,9825
subtest29of10,pubtest21of1,10,1481,9767,13,86,9866
subtest27of10,pubtest21of1,10,1481,9767,10,119,9896
subtest25of10,pubtest21of1,10,1481,9767,20,157,9944
subtest21of10,pubtest21of1,10,1481,9767,22,197,9986
subtest210of10,pubtest21of1,10,1481,9767,24,234,10025
subtest28of10,pubtest21of1,10,1481,9767,27,272,10066
subtest22of10,pubtest21of1,10,1481,9767,29,309,10105
subtest23of10,pubtest21of1,10,1481,9767,31,347,10145
subtest24of10,pubtest21of1,10,1481,9767,19,384,10170
subtest26of10,pubtest21of1,10,1481,9741,9,40,9790
subtest27of10,pubtest21of1,10,1481,9741,13,75,9829
subtest24of10,pubtest21of1,10,1481,9741,16,112,9869
subtest29of10,pubtest21of1,10,1481,9741,22,146,9909
subtest25of10,pubtest21of1,10,1481,9741,25,183,9949
subtest21of10,pubtest21of1,10,1481,9741,26,222,9989
subtest210of10,pubtest21of1,10,1481,9741,33,256,10030
subtest28of10,pubtest21of1,10,1481,9741,36,293,10070
subtest22of10,pubtest21of1,10,1481,9741,41,328,10110
subtest23of10,pubtest21of1,10,1481,9741,41,367,10149
subtest26of10,pubtest21of1,10,1481,9734,7,39,9780
subtest27of10,pubtest21of1,10,1481,9734,11,75,9820
subtest24of10,pubtest21of1,10,1481,9734,12,114,9860
subtest29of10,pubtest21of1,10,1481,9734,21,143,9898
subtest25of10,pubtest21of1,10,1481,9734,24,182,9940
subtest21of10,pubtest21of1,10,1481,9734,27,219,9980
subtest210of10,pubtest21of1,10,1481,9734,29,257,10020
subtest28of10,pubtest21of1,10,1481,9734,29,296,10059
subtest23of10,pubtest21of1,10,1481,9734,31,334,10099
subtest22of10,pubtest21of1,10,1481,9734,32,373,10139
subtest26of10,pubtest21of1,10,1481,9867,5,49,9921
subtest27of10,pubtest21of1,10,1481,9867,7,87,9961
subtest24of10,pubtest21of1,10,1481,9867,20,114,10001
subtest29of10,pubtest21of1,10,1481,9867,29,146,10042
subtest25of10,pubtest21of1,10,1481,9867,30,184,10081
subtest21of10,pubtest21of1,10,1481,9867,32,222,10121
subtest210of10,pubtest21of1,10,1481,9867,35,259,10161
subtest28of10,pubtest21of1,10,1481,9867,36,298,10201
subtest22of10,pubtest21of1,10,1481,9867,40,333,10240
subtest23of10,pubtest21of1,10,1481,9867,43,371,10281
subtest26of10,pubtest21of1,10,1481,9920,9,44,9973
subtest27of10,pubtest21of1,10,1481,9920,11,81,10012
subtest24of10,pubtest21of1,10,1481,9920,28,104,10052
subtest29of10,pubtest21of1,10,1481,9920,33,140,10093
subtest25of10,pubtest21of1,10,1481,9920,41,172,10133
subtest21of10,pubtest21of1,10,1481,9920,44,209,10173
subtest210of10,pubtest21of1,10,1481,9920,62,230,10212
subtest28of10,pubtest21of1,10,1481,9920,64,269,10253
subtest22of10,pubtest21of1,10,1481,9920,75,298,10293
subtest23of10,pubtest21of1,10,1481,9920,76,337,10333
subtest26of10,pubtest21of1,10,1481,9818,5,40,9863
subtest27of10,pubtest21of1,10,1481,9818,13,71,9902
subtest24of10,pubtest21of1,10,1481,9818,18,107,9943
subtest29of10,pubtest21of1,10,1481,9818,23,142,9983
subtest25of10,pubtest21of1,10,1481,9818,26,179,10023
subtest21of10,pubtest21of1,10,1481,9818,29,215,10062
subtest210of10,pubtest21of1,10,1481,9818,31,253,10102
subtest28of10,pubtest21of1,10,1481,9818,37,288,10143
subtest22of10,pubtest21of1,10,1481,9818,39,325,10182
subtest23of10,pubtest21of1,10,1481,9818,41,364,10223
subtest26of10,pubtest21of1,10,1482,10226,10,40,10276
subtest27of10,pubtest21of1,10,1482,10226,11,79,10316
subtest24of10,pubtest21of1,10,1482,10226,13,116,10355
subtest29of10,pubtest21of1,10,1482,10226,15,154,10395
subtest25of10,pubtest21of1,10,1482,10226,19,189,10434
subtest21of10,pubtest21of1,10,1482,10226,25,224,10475
subtest210of10,pubtest21of1,10,1482,10226,28,262,10516
subtest28of10,pubtest21of1,10,1482,10226,34,295,10555
subtest22of10,pubtest21of1,10,1482,10226,36,333,10595
subtest23of10,pubtest21of1,10,1482,10226,39,370,10635
subtest26of10,pubtest21of1,10,1481,9966,11,58,10035
subtest27of10,pubtest21of1,10,1481,9966,12,96,10074
subtest29of10,pubtest21of1,10,1481,9966,16,133,10115
subtest24of10,pubtest21of1,10,1481,9966,18,171,10155
subtest25of10,pubtest21of1,10,1481,9966,20,208,10194
subtest21of10,pubtest21of1,10,1481,9966,23,245,10234
subtest210of10,pubtest21of1,10,1481,9966,24,285,10275
subtest28of10,pubtest21of1,10,1481,9966,25,323,10314
subtest22of10,pubtest21of1,10,1481,9966,29,359,10354
subtest23of10,pubtest21of1,10,1481,9966,30,396,10392
subtest26of10,pubtest21of1,10,1482,10222,16,50,10288
subtest27of10,pubtest21of1,10,1482,10222,18,88,10328
subtest24of10,pubtest21of1,10,1482,10222,21,125,10368
subtest29of10,pubtest21of1,10,1482,10222,23,163,10408
subtest25of10,pubtest21of1,10,1482,10222,25,201,10448
subtest21of10,pubtest21of1,10,1482,10222,29,238,10489
subtest210of10,pubtest21of1,10,1482,10222,37,269,10528
subtest28of10,pubtest21of1,10,1482,10222,38,309,10569
subtest22of10,pubtest21of1,10,1482,10222,41,345,10608
subtest23of10,pubtest21of1,10,1482,10222,42,384,10648
subtest26of10,pubtest21of1,10,1482,10012,10,40,10062
subtest27of10,pubtest21of1,10,1482,10012,14,76,10102
subtest24of10,pubtest21of1,10,1482,10012,16,114,10142
subtest29of10,pubtest21of1,10,1482,10012,22,147,10181
subtest25of10,pubtest21of1,10,1482,10012,27,182,10221
subtest21of10,pubtest21of1,10,1482,10012,33,216,10261
subtest210of10,pubtest21of1,10,1482,10012,41,249,10302
subtest28of10,pubtest21of1,10,1482,10012,47,283,10342
subtest22of10,pubtest21of1,10,1482,10012,51,318,10381
subtest23of10,pubtest21of1,10,1482,10012,58,352,10422
subtest26of10,pubtest21of1,10,1482,10090,7,40,10137
subtest27of10,pubtest21of1,10,1482,10090,9,78,10177
subtest29of10,pubtest21of1,10,1482,10090,11,117,10218
subtest24of10,pubtest21of1,10,1482,10090,13,153,10256
subtest25of10,pubtest21of1,10,1482,10090,16,191,10297
subtest21of10,pubtest21of1,10,1482,10090,21,227,10338
subtest210of10,pubtest21of1,10,1482,10090,22,265,10377
subtest28of10,pubtest21of1,10,1482,10090,28,299,10417
subtest22of10,pubtest21of1,10,1482,10090,33,335,10458
subtest23of10,pubtest21of1,10,1482,10090,34,374,10498
subtest26of10,pubtest21of1,10,1482,10102,2,41,10145
subtest27of10,pubtest21of1,10,1482,10102,7,76,10185
subtest24of10,pubtest21of1,10,1482,10102,8,115,10225
subtest29of10,pubtest21of1,10,1482,10102,11,153,10266
subtest25of10,pubtest21of1,10,1482,10102,15,188,10305
subtest21of10,pubtest21of1,10,1482,10102,16,228,10346
subtest210of10,pubtest21of1,10,1482,10102,25,259,10386
subtest28of10,pubtest21of1,10,1482,10102,27,295,10424
subtest22of10,pubtest21of1,10,1482,10102,29,334,10465
subtest23of10,pubtest21of1,10,1482,10102,31,372,10505
subtest26of10,pubtest21of1,10,1482,10139,12,48,10199
subtest27of10,pubtest21of1,10,1482,10139,14,86,10239
subtest24of10,pubtest21of1,10,1482,10139,16,124,10279
subtest29of10,pubtest21of1,10,1482,10139,18,162,10319
subtest25of10,pubtest21of1,10,1482,10139,28,193,10360
subtest21of10,pubtest21of1,10,1482,10139,35,226,10400
subtest210of10,pubtest21of1,10,1482,10139,43,257,10439
subtest28of10,pubtest21of1,10,1482,10139,47,293,10479
subtest22of10,pubtest21of1,10,1482,10139,48,332,10519
subtest23of10,pubtest21of1,10,1482,10139,49,372,10560
subtest26of10,pubtest21of1,10,1482,10362,9,47,10418
subtest24of10,pubtest21of1,10,1482,10362,14,81,10457
subtest25of10,pubtest21of1,10,1482,10362,16,119,10497
subtest29of10,pubtest21of1,10,1482,10362,17,159,10538
subtest27of10,pubtest21of1,10,1482,10362,14,198,10574
subtest21of10,pubtest21of1,10,1482,10362,19,236,10617
subtest210of10,pubtest21of1,10,1482,10362,27,268,10657
subtest28of10,pubtest21of1,10,1482,10362,33,303,10698
subtest22of10,pubtest21of1,10,1482,10362,34,341,10737
subtest23of10,pubtest21of1,10,1482,10362,35,380,10777
subtest26of10,pubtest21of1,10,1482,10322,10,43,10375
subtest27of10,pubtest21of1,10,1482,10322,20,71,10413
subtest24of10,pubtest21of1,10,1482,10322,21,110,10453
subtest29of10,pubtest21of1,10,1482,10322,25,147,10494
subtest25of10,pubtest21of1,10,1482,10322,27,184,10533
subtest21of10,pubtest21of1,10,1482,10322,33,219,10574
subtest210of10,pubtest21of1,10,1482,10322,38,254,10614
subtest28of10,pubtest21of1,10,1482,10322,44,288,10654
subtest22of10,pubtest21of1,10,1482,10322,49,322,10693
subtest23of10,pubtest21of1,10,1482,10322,54,357,10733
subtest26of10,pubtest21of1,10,1482,10402,4,40,10446
subtest27of10,pubtest21of1,10,1482,10402,7,78,10487
subtest24of10,pubtest21of1,10,1482,10402,9,115,10526
subtest29of10,pubtest21of1,10,1482,10402,16,148,10566
subtest25of10,pubtest21of1,10,1482,10402,22,183,10607
subtest21of10,pubtest21of1,10,1482,10402,23,221,10646
subtest210of10,pubtest21of1,10,1482,10402,25,259,10686
subtest28of10,pubtest21of1,10,1482,10402,27,297,10726
subtest22of10,pubtest21of1,10,1482,10402,35,329,10766
subtest23of10,pubtest21of1,10,1482,10402,37,368,10807
subtest27of10,pubtest21of1,10,1482,10562,9,42,10613
subtest29of10,pubtest21of1,10,1482,10562,22,67,10651
subtest25of10,pubtest21of1,10,1482,10562,27,103,10692
subtest21of10,pubtest21of1,10,1482,10562,37,132,10731
subtest23of10,pubtest21of1,10,1482,10562,43,166,10771
subtest26of10,pubtest21of1,10,1482,10562,49,201,10812
subtest24of10,pubtest21of1,10,1482,10562,53,235,10850
subtest210of10,pubtest21of1,10,1482,10562,58,271,10891
subtest28of10,pubtest21of1,10,1482,10562,62,308,10932
subtest22of10,pubtest21of1,10,1482,10562,62,347,10971
subtest26of10,pubtest21of1,10,1482,10570,5,41,10616
subtest27of10,pubtest21of1,10,1482,10570,6,79,10655
subtest24of10,pubtest21of1,10,1482,10570,8,118,10696
subtest29of10,pubtest21of1,10,1482,10570,9,156,10735
subtest25of10,pubtest21of1,10,1482,10570,17,189,10776
subtest21of10,pubtest21of1,10,1482,10570,20,226,10816
subtest210of10,pubtest21of1,10,1482,10570,25,261,10856
subtest28of10,pubtest21of1,10,1482,10570,26,300,10896
subtest22of10,pubtest21of1,10,1482,10570,29,336,10935
subtest23of10,pubtest21of1,10,1482,10570,34,371,10975
subtest26of10,pubtest21of1,10,1482,10055,6,41,10102
subtest27of10,pubtest21of1,10,1482,10055,10,77,10142
subtest24of10,pubtest21of1,10,1482,10055,27,99,10181
subtest29of10,pubtest21of1,10,1482,10055,35,131,10221
subtest25of10,pubtest21of1,10,1482,10055,37,170,10262
subtest21of10,pubtest21of1,10,1482,10055,38,208,10301
subtest210of10,pubtest21of1,10,1482,10055,39,247,10341
subtest28of10,pubtest21of1,10,1482,10055,41,286,10382
subtest22of10,pubtest21of1,10,1482,10055,43,323,10421
subtest23of10,pubtest21of1,10,1482,10055,46,361,10462
subtest27of10,pubtest21of1,10,1482,10155,3,39,10197
subtest26of10,pubtest21of1,10,1482,10155,12,70,10237
subtest24of10,pubtest21of1,10,1482,10155,17,105,10277
subtest29of10,pubtest21of1,10,1482,10155,18,143,10316
subtest25of10,pubtest21of1,10,1482,10155,20,182,10357
subtest28of10,pubtest21of1,10,1482,10155,23,219,10397
subtest210of10,pubtest21of1,10,1482,10155,22,259,10436
subtest21of10,pubtest21of1,10,1482,10155,21,298,10474
subtest22of10,pubtest21of1,10,1482,10155,37,325,10517
subtest23of10,pubtest21of1,10,1482,10155,41,360,10556
subtest25of10,pubtest21of1,10,1482,10511,26,51,10588
subtest27of10,pubtest21of1,10,1482,10511,23,92,10626
subtest23of10,pubtest21of1,10,1482,10511,28,129,10668
subtest210of10,pubtest21of1,10,1482,10511,31,166,10708
subtest24of10,pubtest21of1,10,1482,10511,33,204,10748
subtest26of10,pubtest21of1,10,1482,10511,34,244,10789
subtest21of10,pubtest21of1,10,1482,10511,26,281,10818
subtest22of10,pubtest21of1,10,1482,10511,36,321,10868
subtest29of10,pubtest21of1,10,1482,10511,36,359,10906
subtest28of10,pubtest21of1,10,1482,10511,39,399,10949
subtest26of10,pubtest21of1,10,1482,10178,7,38,10223
subtest27of10,pubtest21of1,10,1482,10178,13,73,10264
subtest24of10,pubtest21of1,10,1482,10178,18,106,10302
subtest29of10,pubtest21of1,10,1482,10178,26,139,10343
subtest25of10,pubtest21of1,10,1482,10178,28,178,10384
subtest21of10,pubtest21of1,10,1482,10178,30,215,10423
subtest210of10,pubtest21of1,10,1482,10178,32,254,10464
subtest28of10,pubtest21of1,10,1482,10178,33,291,10502
subtest23of10,pubtest21of1,10,1482,10178,35,331,10544
subtest22of10,pubtest21of1,10,1482,10178,34,370,10582
subtest26of10,pubtest21of1,10,1482,10935,7,42,10984
subtest27of10,pubtest21of1,10,1482,10935,9,78,11022
subtest24of10,pubtest21of1,10,1482,10935,12,116,11063
subtest29of10,pubtest21of1,10,1482,10935,15,152,11102
subtest25of10,pubtest21of1,10,1482,10935,28,180,11143
subtest21of10,pubtest21of1,10,1482,10935,29,218,11182
subtest210of10,pubtest21of1,10,1482,10935,31,257,11223
subtest28of10,pubtest21of1,10,1482,10935,33,295,11263
subtest22of10,pubtest21of1,10,1482,10935,35,332,11302
subtest23of10,pubtest21of1,10,1482,10935,37,371,11343
subtest26of10,pubtest21of1,100,13080,12621,74,55,12750
subtest27of10,pubtest21of1,100,13080,12621,121,47,12789
subtest24of10,pubtest21of1,100,13080,12621,153,64,12838
subtest25of10,pubtest21of1,100,13080,12621,188,69,12878
subtest21of10,pubtest21of1,100,13080,12621,192,103,12916
subtest29of10,pubtest21of1,100,13080,12621,188,140,12949
subtest210of10,pubtest21of1,100,13080,12621,196,202,13019
subtest23of10,pubtest21of1,100,13080,12621,203,242,13066
subtest28of10,pubtest21of1,100,13080,12621,197,280,13098
subtest22of10,pubtest21of1,100,13080,12621,207,315,13143
subtest26of10,pubtest21of1,100,13080,11315,107,45,11467
subtest24of10,pubtest21of1,100,13080,11315,131,69,11515
subtest27of10,pubtest21of1,100,13080,11315,191,52,11558
subtest25of10,pubtest21of1,100,13080,11315,196,88,11599
subtest28of10,pubtest21of1,100,13080,11315,204,123,11642
subtest21of10,pubtest21of1,100,13080,11315,207,160,11682
subtest210of10,pubtest21of1,100,13080,11315,201,199,11715
subtest23of10,pubtest21of1,100,13080,11315,198,238,11751
subtest22of10,pubtest21of1,100,13080,11315,209,277,11801
subtest29of10,pubtest21of1,100,13080,11315,192,316,11823
subtest26of10,pubtest21of1,100,13080,10898,132,43,11073
subtest27of10,pubtest21of1,100,13080,10898,198,48,11144
subtest25of10,pubtest21of1,100,13080,10898,223,68,11189
subtest21of10,pubtest21of1,100,13080,10898,226,105,11229
subtest29of10,pubtest21of1,100,13080,10898,223,140,11261
subtest24of10,pubtest21of1,100,13080,10898,220,179,11297
subtest210of10,pubtest21of1,100,13080,10898,229,219,11346
subtest23of10,pubtest21of1,100,13080,10898,238,253,11389
subtest28of10,pubtest21of1,100,13080,10898,237,291,11426
subtest22of10,pubtest21of1,100,13080,10898,231,334,11463
subtest26of10,pubtest21of1,100,13080,11445,135,43,11623
subtest27of10,pubtest21of1,100,13080,11445,189,42,11676
subtest22of10,pubtest21of1,100,13080,11445,212,62,11719
subtest210of10,pubtest21of1,100,13080,11445,218,96,11759
subtest23of10,pubtest21of1,100,13080,11445,218,136,11799
subtest21of10,pubtest21of1,100,13080,11445,221,172,11838
subtest29of10,pubtest21of1,100,13080,11445,207,212,11864
subtest25of10,pubtest21of1,100,13080,11445,208,251,11904
subtest24of10,pubtest21of1,100,13080,11445,207,293,11945
subtest28of10,pubtest21of1,100,13080,11445,213,334,11992
subtest26of10,pubtest21of1,100,13080,11656,137,45,11838
subtest27of10,pubtest21of1,100,13080,11656,219,43,11918
subtest29of10,pubtest21of1,100,13080,11656,223,83,11962
subtest25of10,pubtest21of1,100,13080,11656,227,119,12002
subtest23of10,pubtest21of1,100,13080,11656,232,152,12040
subtest22of10,pubtest21of1,100,13080,11656,234,194,12084
subtest210of10,pubtest21of1,100,13080,11656,228,233,12117
subtest28of10,pubtest21of1,100,13080,11656,239,271,12166
subtest24of10,pubtest21of1,100,13080,11656,220,310,12186
subtest21of10,pubtest21of1,100,13080,11656,243,347,12246
subtest26of10,pubtest21of1,100,13080,10226,141,50,10417
subtest24of10,pubtest21of1,100,13080,10226,161,71,10458
subtest27of10,pubtest21of1,100,13080,10226,188,87,10501
subtest25of10,pubtest21of1,100,13080,10226,202,118,10546
subtest29of10,pubtest21of1,100,13080,10226,202,158,10586
subtest21of10,pubtest21of1,100,13080,10226,207,198,10631
subtest210of10,pubtest21of1,100,13080,10226,216,228,10670
subtest22of10,pubtest21of1,100,13080,10226,221,264,10711
subtest23of10,pubtest21of1,100,13080,10226,225,299,10750
subtest28of10,pubtest21of1,100,13080,10226,236,328,10790
subtest26of10,pubtest21of1,100,13080,10168,114,44,10326
subtest24of10,pubtest21of1,100,13080,10168,165,46,10379
subtest25of10,pubtest21of1,100,13080,10168,193,61,10422
subtest21of10,pubtest21of1,100,13080,10168,193,100,10461
subtest27of10,pubtest21of1,100,13080,10168,196,142,10506
subtest210of10,pubtest21of1,100,13080,10168,198,179,10545
subtest28of10,pubtest21of1,100,13080,10168,205,213,10586
subtest22of10,pubtest21of1,100,13080,10168,206,249,10623
subtest23of10,pubtest21of1,100,13080,10168,202,289,10659
subtest29of10,pubtest21of1,100,13080,10168,464,74,10706
subtest26of10,pubtest21of1,100,13080,10818,158,44,11020
subtest29of10,pubtest21of1,100,13080,10818,173,73,11064
subtest25of10,pubtest21of1,100,13080,10818,175,111,11104
subtest21of10,pubtest21of1,100,13080,10818,178,148,11144
subtest210of10,pubtest21of1,100,13080,10818,182,185,11185
subtest28of10,pubtest21of1,100,13080,10818,186,218,11222
subtest22of10,pubtest21of1,100,13080,10818,186,260,11264
subtest23of10,pubtest21of1,100,13080,10818,193,297,11308
subtest27of10,pubtest21of1,100,13080,10818,409,122,11349
subtest24of10,pubtest21of1,100,13080,10818,416,154,11388
subtest26of10,pubtest21of1,100,13080,10391,46,45,10482
subtest27of10,pubtest21of1,100,13080,10391,169,47,10607
subtest25of10,pubtest21of1,100,13080,10391,173,80,10644
subtest29of10,pubtest21of1,100,13080,10391,174,124,10689
subtest21of10,pubtest21of1,100,13080,10391,183,159,10733
subtest210of10,pubtest21of1,100,13080,10391,183,195,10769
subtest28of10,pubtest21of1,100,13080,10391,187,239,10817
subtest24of10,pubtest21of1,100,13080,10391,184,276,10851
subtest22of10,pubtest21of1,100,13080,10391,191,315,10897
subtest23of10,pubtest21of1,100,13080,10391,195,352,10938
subtest26of10,pubtest21of1,100,13080,10263,175,48,10486
subtest24of10,pubtest21of1,100,13080,10263,202,63,10528
subtest28of10,pubtest21of1,100,13080,10263,212,97,10572
subtest22of10,pubtest21of1,100,13080,10263,211,139,10613
subtest21of10,pubtest21of1,100,13080,10263,218,179,10660
subtest210of10,pubtest21of1,100,13080,10263,215,217,10695
subtest25of10,pubtest21of1,100,13080,10263,207,258,10728
subtest29of10,pubtest21of1,100,13080,10263,207,314,10784
subtest27of10,pubtest21of1,100,13080,10263,444,117,10824
subtest23of10,pubtest21of1,100,13080,10263,476,129,10868
subtest26of10,pubtest21of1,100,13080,10248,100,43,10391
subtest24of10,pubtest21of1,100,13080,10248,182,45,10475
subtest27of10,pubtest21of1,100,13080,10248,188,79,10515
subtest21of10,pubtest21of1,100,13080,10248,198,109,10555
subtest210of10,pubtest21of1,100,13080,10248,197,149,10594
subtest29of10,pubtest21of1,100,13080,10248,191,188,10627
subtest25of10,pubtest21of1,100,13080,10248,191,227,10666
subtest22of10,pubtest21of1,100,13080,10248,215,251,10714
subtest23of10,pubtest21of1,100,13080,10248,215,291,10754
subtest28of10,pubtest21of1,100,13080,10248,457,91,10796
subtest26of10,pubtest21of1,100,13080,10907,118,44,11069
subtest27of10,pubtest21of1,100,13080,10907,146,62,11115
subtest24of10,pubtest21of1,100,13080,10907,163,86,11156
subtest29of10,pubtest21of1,100,13080,10907,174,115,11196
subtest25of10,pubtest21of1,100,13080,10907,180,149,11236
subtest21of10,pubtest21of1,100,13080,10907,187,186,11280
subtest210of10,pubtest21of1,100,13080,10907,190,222,11319
subtest22of10,pubtest21of1,100,13080,10907,195,257,11359
subtest23of10,pubtest21of1,100,13080,10907,197,294,11398
subtest28of10,pubtest21of1,100,13080,10907,205,328,11440
subtest27of10,pubtest21of1,100,13080,11398,183,54,11635
subtest25of10,pubtest21of1,100,13080,11398,193,88,11679
subtest26of10,pubtest21of1,100,13080,11398,199,119,11716
subtest210of10,pubtest21of1,100,13080,11398,205,156,11759
subtest24of10,pubtest21of1,100,13080,11398,206,195,11799
subtest28of10,pubtest21of1,100,13080,11398,214,227,11839
subtest22of10,pubtest21of1,100,13080,11398,211,270,11879
subtest29of10,pubtest21of1,100,13080,11398,186,330,11914
subtest21of10,pubtest21of1,100,13080,11398,189,346,11933
subtest23of10,pubtest21of1,100,13080,11398,196,389,11983
subtest26of10,pubtest21of1,100,13080,11598,146,42,11786
subtest27of10,pubtest21of1,100,13080,11598,182,50,11830
subtest24of10,pubtest21of1,100,13080,11598,211,65,11874
subtest210of10,pubtest21of1,100,13080,11598,218,98,11914
subtest29of10,pubtest21of1,100,13080,11598,215,142,11955
subtest22of10,pubtest21of1,100,13080,11598,223,175,11996
subtest28of10,pubtest21of1,100,13080,11598,218,218,12034
subtest23of10,pubtest21of1,100,13080,11598,224,256,12078
subtest21of10,pubtest21of1,100,13080,11598,228,296,12122
subtest25of10,pubtest21of1,100,13080,11598,214,335,12147
subtest26of10,pubtest21of1,100,13080,10353,120,44,10517
subtest27of10,pubtest21of1,100,13080,10353,167,44,10564
subtest24of10,pubtest21of1,100,13080,10353,175,76,10604
subtest29of10,pubtest21of1,100,13080,10353,176,114,10643
subtest25of10,pubtest21of1,100,13080,10353,180,152,10685
subtest21of10,pubtest21of1,100,13080,10353,184,188,10725
subtest210of10,pubtest21of1,100,13080,10353,192,220,10765
subtest28of10,pubtest21of1,100,13080,10353,196,257,10806
subtest23of10,pubtest21of1,100,13080,10353,200,289,10842
subtest22of10,pubtest21of1,100,13080,10353,200,329,10882
subtest26of10,pubtest21of1,100,13080,10706,180,58,10944
subtest27of10,pubtest21of1,100,13080,10706,207,74,10987
subtest24of10,pubtest21of1,100,13080,10706,209,114,11029
subtest29of10,pubtest21of1,100,13080,10706,222,142,11070
subtest21of10,pubtest21of1,100,13080,10706,232,175,11113
subtest210of10,pubtest21of1,100,13080,10706,232,219,11157
subtest22of10,pubtest21of1,100,13080,10706,236,256,11198
subtest23of10,pubtest21of1,100,13080,10706,240,292,11238
subtest25of10,pubtest21of1,100,13080,10706,226,331,11263
subtest28of10,pubtest21of1,100,13080,10706,434,178,11318
subtest26of10,pubtest21of1,100,13080,10080,184,51,10315
subtest27of10,pubtest21of1,100,13080,10080,185,94,10359
subtest25of10,pubtest21of1,100,13080,10080,204,116,10400
subtest21of10,pubtest21of1,100,13080,10080,204,156,10440
subtest29of10,pubtest21of1,100,13080,10080,202,194,10476
subtest24of10,pubtest21of1,100,13080,10080,200,234,10514
subtest210of10,pubtest21of1,100,13080,10080,211,269,10560
subtest28of10,pubtest21of1,100,13080,10080,213,306,10599
subtest22of10,pubtest21of1,100,13080,10080,217,343,10640
subtest23of10,pubtest21of1,100,13080,10080,222,376,10678
subtest26of10,pubtest21of1,100,13080,10131,132,44,10307
subtest27of10,pubtest21of1,100,13080,10131,213,43,10387
subtest24of10,pubtest21of1,100,13080,10131,217,83,10431
subtest25of10,pubtest21of1,100,13080,10131,230,110,10471
subtest28of10,pubtest21of1,100,13080,10131,236,144,10511
subtest23of10,pubtest21of1,100,13080,10131,243,177,10551
subtest29of10,pubtest21of1,100,13080,10131,230,216,10577
subtest21of10,pubtest21of1,100,13080,10131,234,266,10631
subtest22of10,pubtest21of1,100,13080,10131,241,297,10669
subtest210of10,pubtest21of1,100,13080,10131,238,327,10696
subtest26of10,pubtest21of1,100,13080,10055,169,42,10266
subtest29of10,pubtest21of1,100,13080,10055,262,46,10363
subtest27of10,pubtest21of1,100,13080,10055,261,85,10401
subtest22of10,pubtest21of1,100,13080,10055,265,135,10455
subtest21of10,pubtest21of1,100,13080,10055,267,173,10495
subtest25of10,pubtest21of1,100,13080,10055,268,211,10534
subtest210of10,pubtest21of1,100,13080,10055,271,245,10571
subtest24of10,pubtest21of1,100,13080,10055,261,284,10600
subtest23of10,pubtest21of1,100,13080,10055,278,321,10654
subtest28of10,pubtest21of1,100,13080,10055,277,359,10691
subtest26of10,pubtest21of1,100,13080,10550,206,45,10801
subtest24of10,pubtest21of1,100,13080,10550,267,43,10860
subtest29of10,pubtest21of1,100,13080,10550,271,83,10904
subtest21of10,pubtest21of1,100,13080,10550,278,115,10943
subtest28of10,pubtest21of1,100,13080,10550,285,149,10984
subtest22of10,pubtest21of1,100,13080,10550,286,188,11024
subtest210of10,pubtest21of1,100,13080,10550,279,228,11057
subtest25of10,pubtest21of1,100,13080,10550,276,266,11092
subtest23of10,pubtest21of1,100,13080,10550,299,295,11144
subtest27of10,pubtest21of1,100,13080,10550,504,130,11184
subtest26of10,pubtest21of1,100,13080,11087,117,44,11248
subtest27of10,pubtest21of1,100,13080,11087,217,47,11351
subtest24of10,pubtest21of1,100,13080,11087,219,90,11396
subtest25of10,pubtest21of1,100,13080,11087,223,125,11435
subtest28of10,pubtest21of1,100,13080,11087,225,158,11470
subtest29of10,pubtest21of1,100,13080,11087,233,195,11515
subtest21of10,pubtest21of1,100,13080,11087,234,234,11555
subtest210of10,pubtest21of1,100,13080,11087,226,273,11586
subtest22of10,pubtest21of1,100,13080,11087,238,309,11634
subtest23of10,pubtest21of1,100,13080,11087,240,348,11675
subtest26of10,pubtest21of1,100,13080,10350,129,43,10522
subtest27of10,pubtest21of1,100,13080,10350,179,54,10583
subtest23of10,pubtest21of1,100,13080,10350,221,55,10626
subtest22of10,pubtest21of1,100,13080,10350,221,99,10670
subtest28of10,pubtest21of1,100,13080,10350,216,138,10704
subtest24of10,pubtest21of1,100,13080,10350,213,176,10739
subtest210of10,pubtest21of1,100,13080,10350,224,216,10790
subtest21of10,pubtest21of1,100,13080,10350,228,252,10830
subtest25of10,pubtest21of1,100,13080,10350,228,292,10870
subtest29of10,pubtest21of1,100,13080,10350,213,347,10910
subtest27of10,pubtest21of1,100,13080,10106,179,43,10328
subtest29of10,pubtest21of1,100,13080,10106,255,46,10407
subtest21of10,pubtest21of1,100,13080,10106,267,75,10448
subtest23of10,pubtest21of1,100,13080,10106,266,113,10485
subtest26of10,pubtest21of1,100,13080,10106,270,152,10528
subtest25of10,pubtest21of1,100,13080,10106,260,191,10557
subtest24of10,pubtest21of1,100,13080,10106,265,230,10601
subtest28of10,pubtest21of1,100,13080,10106,276,266,10648
subtest210of10,pubtest21of1,100,13080,10106,277,305,10688
subtest22of10,pubtest21of1,100,13080,10106,276,346,10728
subtest26of10,pubtest21of1,100,13080,10377,153,43,10573
subtest27of10,pubtest21of1,100,13080,10377,224,43,10644
subtest24of10,pubtest21of1,100,13080,10377,234,78,10689
subtest210of10,pubtest21of1,100,13080,10377,244,112,10733
subtest25of10,pubtest21of1,100,13080,10377,241,156,10774
subtest21of10,pubtest21of1,100,13080,10377,245,195,10817
subtest28of10,pubtest21of1,100,13080,10377,249,231,10857
subtest29of10,pubtest21of1,100,13080,10377,241,267,10885
subtest22of10,pubtest21of1,100,13080,10377,254,306,10937
subtest23of10,pubtest21of1,100,13080,10377,257,343,10977
subtest26of10,pubtest21of1,100,13080,12106,170,44,12320
subtest27of10,pubtest21of1,100,13080,12106,183,74,12363
subtest24of10,pubtest21of1,100,13080,12106,202,98,12406
subtest29of10,pubtest21of1,100,13080,12106,209,132,12447
subtest210of10,pubtest21of1,100,13080,12106,219,165,12490
subtest28of10,pubtest21of1,100,13080,12106,220,205,12531
subtest25of10,pubtest21of1,100,13080,12106,215,241,12562
subtest21of10,pubtest21of1,100,13080,12106,224,280,12610
subtest23of10,pubtest21of1,100,13080,12106,237,307,12650
subtest22of10,pubtest21of1,100,13080,12106,242,340,12688
subtest26of10,pubtest21of1,100,13080,10207,223,59,10489
subtest29of10,pubtest21of1,100,13080,10207,231,95,10533
subtest24of10,pubtest21of1,100,13080,10207,234,132,10573
subtest22of10,pubtest21of1,100,13080,10207,237,169,10613
subtest23of10,pubtest21of1,100,13080,10207,238,209,10654
subtest21of10,pubtest21of1,100,13080,10207,232,242,10681
subtest28of10,pubtest21of1,100,13080,10207,242,281,10730
subtest27of10,pubtest21of1,100,13080,10207,224,321,10752
subtest25of10,pubtest21of1,100,13080,10207,229,367,10803
subtest210of10,pubtest21of1,100,13080,10207,248,397,10852
subtest26of10,pubtest21of1,100,13080,10429,133,44,10606
subtest27of10,pubtest21of1,100,13080,10429,167,57,10653
subtest29of10,pubtest21of1,100,13080,10429,203,65,10697
subtest28of10,pubtest21of1,100,13080,10429,211,97,10737
subtest23of10,pubtest21of1,100,13080,10429,215,133,10777
subtest22of10,pubtest21of1,100,13080,10429,216,172,10817
subtest24of10,pubtest21of1,100,13080,10429,202,211,10842
subtest25of10,pubtest21of1,100,13080,10429,206,260,10895
subtest210of10,pubtest21of1,100,13080,10429,218,287,10934
subtest21of10,pubtest21of1,100,13080,10429,221,327,10977
subtest26of10,pubtest21of1,100,13079,9934,108,42,10084
subtest27of10,pubtest21of1,100,13079,9934,171,45,10150
subtest25of10,pubtest21of1,100,13079,9934,195,63,10192
subtest29of10,pubtest21of1,100,13079,9934,193,104,10231
subtest21of10,pubtest21of1,100,13079,9934,202,142,10278
subtest22of10,pubtest21of1,100,13079,9934,203,187,10324
subtest24of10,pubtest21of1,100,13079,9934,193,225,10352
subtest210of10,pubtest21of1,100,13079,9934,206,263,10403
subtest28of10,pubtest21of1,100,13079,9934,198,301,10433
subtest23of10,pubtest21of1,100,13079,9934,210,339,10483
subtest26of10,pubtest21of1,100,13080,10021,171,44,10236
subtest24of10,pubtest21of1,100,13080,10021,240,54,10315
subtest29of10,pubtest21of1,100,13080,10021,243,91,10355
subtest27of10,pubtest21of1,100,13080,10021,240,133,10394
subtest25of10,pubtest21of1,100,13080,10021,250,164,10435
subtest21of10,pubtest21of1,100,13080,10021,254,201,10476
subtest210of10,pubtest21of1,100,13080,10021,252,236,10509
subtest28of10,pubtest21of1,100,13080,10021,257,274,10552
subtest22of10,pubtest21of1,100,13080,10021,265,309,10595
subtest23of10,pubtest21of1,100,13080,10021,263,348,10632
subtest26of10,pubtest21of1,100,13080,10747,201,42,10990
subtest24of10,pubtest21of1,100,13080,10747,333,59,11139
subtest27of10,pubtest21of1,100,13080,10747,333,102,11182
subtest25of10,pubtest21of1,100,13080,10747,377,100,11224
subtest28of10,pubtest21of1,100,13080,10747,384,135,11266
subtest29of10,pubtest21of1,100,13080,10747,376,176,11299
subtest23of10,pubtest21of1,100,13080,10747,388,215,11350
subtest22of10,pubtest21of1,100,13080,10747,381,254,11382
subtest210of10,pubtest21of1,100,13080,10747,385,293,11425
subtest21of10,pubtest21of1,100,13080,10747,391,332,11470
subtest26of10,pubtest21of10,1,321,10497,1,41,10539
subtest27of10,pubtest21of10,1,321,10497,3,78,10578
subtest24of10,pubtest21of10,1,321,10497,7,114,10618
subtest29of10,pubtest21of10,1,321,10497,6,154,10657
subtest25of10,pubtest21of10,1,321,10497,11,190,10698
subtest21of10,pubtest21of10,1,321,10497,16,225,10738
subtest210of10,pubtest21of10,1,321,10497,23,258,10778
subtest28of10,pubtest21of10,1,321,10497,23,298,10818
subtest22of10,pubtest21of10,1,321,10497,25,336,10858
subtest23of10,pubtest21of10,1,321,10497,25,376,10898
subtest24of10,pubtest22of10,1,320,5272,3,41,5316
subtest27of10,pubtest22of10,1,320,5272,5,78,5355
subtest29of10,pubtest22of10,1,320,5272,5,117,5394
subtest28of10,pubtest22of10,1,320,5272,8,155,5435
subtest210of10,pubtest22of10,1,320,5272,9,194,5475
subtest26of10,pubtest22of10,1,320,5272,10,233,5515
subtest23of10,pubtest22of10,1,320,5272,16,267,5555
subtest25of10,pubtest22of10,1,320,5272,16,306,5594
subtest22of10,pubtest22of10,1,320,5272,18,345,5635
subtest21of10,pubtest22of10,1,320,5272,29,374,5675
subtest23of10,pubtest23of10,1,320,5376,2,41,5419
subtest28of10,pubtest23of10,1,320,5376,3,79,5458
subtest29of10,pubtest23of10,1,320,5376,9,113,5498
subtest24of10,pubtest23of10,1,320,5376,13,149,5538
subtest27of10,pubtest23of10,1,320,5376,22,180,5578
subtest25of10,pubtest23of10,1,320,5376,24,217,5617
subtest26of10,pubtest23of10,1,320,5376,29,253,5658
subtest21of10,pubtest23of10,1,320,5376,36,286,5698
subtest22of10,pubtest23of10,1,320,5376,36,325,5737
subtest210of10,pubtest23of10,1,320,5376,38,364,5778
subtest24of10,pubtest24of10,1,320,5331,3,53,5387
subtest23of10,pubtest24of10,1,320,5331,3,92,5426
subtest25of10,pubtest24of10,1,320,5331,8,127,5466
subtest22of10,pubtest24of10,1,320,5331,9,165,5505
subtest28of10,pubtest24of10,1,320,5331,10,205,5546
subtest210of10,pubtest24of10,1,320,5331,11,243,5585
subtest21of10,pubtest24of10,1,320,5331,8,283,5622
subtest29of10,pubtest24of10,1,320,5331,16,320,5667
subtest27of10,pubtest24of10,1,320,5331,17,357,5705
subtest26of10,pubtest24of10,1,320,5331,17,397,5745
subtest28of10,pubtest25of10,1,320,5471,2,40,5513
subtest210of10,pubtest25of10,1,320,5471,5,79,5555
subtest21of10,pubtest25of10,1,320,5471,6,117,5594
subtest27of10,pubtest25of10,1,320,5471,11,152,5634
subtest26of10,pubtest25of10,1,320,5471,11,192,5674
subtest22of10,pubtest25of10,1,320,5471,13,230,5714
subtest25of10,pubtest25of10,1,320,5471,18,264,5753
subtest29of10,pubtest25of10,1,320,5471,18,304,5793
subtest23of10,pubtest25of10,1,320,5471,18,343,5832
subtest24of10,pubtest25of10,1,320,5471,20,383,5874
subtest21of10,pubtest26of10,1,320,6216,0,40,6256
subtest22of10,pubtest26of10,1,320,6216,6,73,6295
subtest29of10,pubtest26of10,1,320,6216,11,108,6335
subtest23of10,pubtest26of10,1,320,6216,18,141,6375
subtest26of10,pubtest26of10,1,320,6216,22,177,6415
subtest210of10,pubtest26of10,1,320,6216,25,214,6455
subtest28of10,pubtest26of10,1,320,6216,27,252,6495
subtest24of10,pubtest26of10,1,320,6216,34,284,6534
subtest25of10,pubtest26of10,1,320,6216,35,323,6574
subtest27of10,pubtest26of10,1,320,6216,34,363,6613
subtest27of10,pubtest27of10,1,319,6204,2,39,6245
subtest23of10,pubtest27of10,1,319,6204,10,70,6284
subtest29of10,pubtest27of10,1,319,6204,15,105,6324
subtest25of10,pubtest27of10,1,319,6204,16,142,6362
subtest26of10,pubtest27of10,1,319,6204,18,182,6404
subtest210of10,pubtest27of10,1,319,6204,17,221,6442
subtest24of10,pubtest27of10,1,319,6204,17,261,6482
subtest21of10,pubtest27of10,1,319,6204,17,300,6521
subtest22of10,pubtest27of10,1,319,6204,21,339,6564
subtest28of10,pubtest27of10,1,319,6204,22,379,6605
subtest27of10,pubtest28of10,1,320,5777,-2,45,5820
subtest28of10,pubtest28of10,1,320,5777,-1,84,5860
subtest21of10,pubtest28of10,1,320,5777,1,121,5899
subtest29of10,pubtest28of10,1,320,5777,2,160,5939
subtest23of10,pubtest28of10,1,320,5777,7,195,5979
subtest210of10,pubtest28of10,1,320,5777,11,230,6018
subtest25of10,pubtest28of10,1,320,5777,11,271,6059
subtest26of10,pubtest28of10,1,320,5777,18,305,6100
subtest24of10,pubtest28of10,1,320,5777,19,342,6138
subtest22of10,pubtest28of10,1,320,5777,20,381,6178
subtest210of10,pubtest29of10,1,320,6146,15,42,6203
subtest23of10,pubtest29of10,1,320,6146,16,79,6241
subtest29of10,pubtest29of10,1,320,6146,19,117,6282
subtest22of10,pubtest29of10,1,320,6146,20,155,6321
subtest25of10,pubtest29of10,1,320,6146,21,194,6361
subtest21of10,pubtest29of10,1,320,6146,23,233,6402
subtest28of10,pubtest29of10,1,320,6146,26,270,6442
subtest24of10,pubtest29of10,1,320,6146,27,308,6481
subtest27of10,pubtest29of10,1,320,6146,28,348,6522
subtest26of10,pubtest29of10,1,320,6146,30,386,6562
subtest29of10,pubtest210of10,1,322,5769,0,38,5807
subtest21of10,pubtest210of10,1,322,5769,17,61,5847
subtest210of10,pubtest210of10,1,322,5769,18,100,5887
subtest27of10,pubtest210of10,1,322,5769,20,138,5927
subtest24of10,pubtest210of10,1,322,5769,21,177,5967
subtest28of10,pubtest210of10,1,322,5769,21,217,6007
subtest22of10,pubtest210of10,1,322,5769,24,255,6048
subtest23of10,pubtest210of10,1,322,5769,25,292,6086
subtest26of10,pubtest210of10,1,322,5769,26,332,6127
subtest25of10,pubtest210of10,1,322,5769,28,370,6167
subtest27of10,pubtest21of10,1,321,11157,0,46,11203
subtest26of10,pubtest21of10,1,321,11157,0,85,11242
subtest24of10,pubtest21of10,1,321,11157,6,119,11282
subtest29of10,pubtest21of10,1,321,11157,11,154,11322
subtest25of10,pubtest21of10,1,321,11157,14,190,11361
subtest21of10,pubtest21of10,1,321,11157,16,228,11401
subtest28of10,pubtest21of10,1,321,11157,19,266,11442
subtest210of10,pubtest21of10,1,321,11157,17,306,11480
subtest22of10,pubtest21of10,1,321,11157,22,343,11522
subtest23of10,pubtest21of10,1,321,11157,22,383,11562
subtest29of10,pubtest22of10,1,320,6023,3,41,6067
subtest24of10,pubtest22of10,1,320,6023,6,77,6106
subtest27of10,pubtest22of10,1,320,6023,9,114,6146
subtest28of10,pubtest22of10,1,320,6023,12,151,6186
subtest26of10,pubtest22of10,1,320,6023,14,189,6226
subtest23of10,pubtest22of10,1,320,6023,17,226,6266
subtest210of10,pubtest22of10,1,320,6023,17,264,6304
subtest22of10,pubtest22of10,1,320,6023,18,304,6345
subtest25of10,pubtest22of10,1,320,6023,17,343,6383
subtest21of10,pubtest22of10,1,320,6023,26,376,6425
subtest23of10,pubtest23of10,1,320,5773,5,42,5820
subtest29of10,pubtest23of10,1,320,5773,9,78,5860
subtest24of10,pubtest23of10,1,320,5773,9,117,5899
subtest28of10,pubtest23of10,1,320,5773,10,156,5939
subtest27of10,pubtest23of10,1,320,5773,11,195,5979
subtest25of10,pubtest23of10,1,320,5773,17,228,6018
subtest26of10,pubtest23of10,1,320,5773,18,268,6059
subtest22of10,pubtest23of10,1,320,5773,29,297,6099
subtest21of10,pubtest23of10,1,320,5773,29,337,6139
subtest210of10,pubtest23of10,1,320,5773,31,375,6179
subtest23of10,pubtest24of10,1,320,5526,6,40,5572
subtest24of10,pubtest24of10,1,320,5526,7,79,5612
subtest28of10,pubtest24of10,1,320,5526,11,113,5650
subtest25of10,pubtest24of10,1,320,5526,14,150,5690
subtest22of10,pubtest24of10,1,320,5526,17,188,5731
subtest21of10,pubtest24of10,1,320,5526,20,224,5770
subtest210of10,pubtest24of10,1,320,5526,23,261,5810
subtest29of10,pubtest24of10,1,320,5526,26,298,5850
subtest27of10,pubtest24of10,1,320,5526,28,337,5891
subtest26of10,pubtest24of10,1,320,5526,30,374,5930
subtest28of10,pubtest25of10,1,320,5672,6,41,5719
subtest210of10,pubtest25of10,1,320,5672,7,80,5759
subtest21of10,pubtest25of10,1,320,5672,12,114,5798
subtest26of10,pubtest25of10,1,320,5672,14,152,5838
subtest27of10,pubtest25of10,1,320,5672,14,192,5878
subtest22of10,pubtest25of10,1,320,5672,16,230,5918
subtest23of10,pubtest25of10,1,320,5672,18,268,5958
subtest25of10,pubtest25of10,1,320,5672,18,307,5997
subtest29of10,pubtest25of10,1,320,5672,20,346,6038
subtest24of10,pubtest25of10,1,320,5672,22,385,6079
subtest21of10,pubtest26of10,1,320,5647,3,42,5692
subtest22of10,pubtest26of10,1,320,5647,4,80,5731
subtest29of10,pubtest26of10,1,320,5647,10,114,5771
subtest23of10,pubtest26of10,1,320,5647,13,151,5811
subtest26of10,pubtest26of10,1,320,5647,15,188,5850
subtest210of10,pubtest26of10,1,320,5647,18,225,5890
subtest28of10,pubtest26of10,1,320,5647,24,259,5930
subtest27of10,pubtest26of10,1,320,5647,26,300,5973
subtest24of10,pubtest26of10,1,320,5647,28,336,6011
subtest25of10,pubtest26of10,1,320,5647,31,373,6051
subtest28of10,pubtest27of10,1,319,5576,5,48,5629
subtest27of10,pubtest27of10,1,319,5576,4,87,5667
subtest23of10,pubtest27of10,1,319,5576,10,122,5708
subtest24of10,pubtest27of10,1,319,5576,12,160,5748
subtest210of10,pubtest27of10,1,319,5576,18,194,5788
subtest29of10,pubtest27of10,1,319,5576,18,234,5828
subtest22of10,pubtest27of10,1,319,5576,21,271,5868
subtest25of10,pubtest27of10,1,319,5576,21,310,5907
subtest21of10,pubtest27of10,1,319,5576,23,349,5948
subtest26of10,pubtest27of10,1,319,5576,22,388,5986
subtest27of10,pubtest28of10,1,320,5172,4,44,5220
subtest21of10,pubtest28of10,1,320,5172,8,79,5259
subtest28of10,pubtest28of10,1,320,5172,6,118,5296
subtest29of10,pubtest28of10,1,320,5172,11,156,5339
subtest210of10,pubtest28of10,1,320,5172,16,191,5379
subtest23of10,pubtest28of10,1,320,5172,18,228,5418
subtest26of10,pubtest28of10,1,320,5172,19,267,5458
subtest25of10,pubtest28of10,1,320,5172,24,303,5499
subtest22of10,pubtest28of10,1,320,5172,26,341,5539
subtest24of10,pubtest28of10,1,320,5172,25,380,5577
subtest23of10,pubtest29of10,1,320,5452,11,46,5509
subtest210of10,pubtest29of10,1,320,5452,16,79,5547
subtest29of10,pubtest29of10,1,320,5452,19,117,5588
subtest25of10,pubtest29of10,1,320,5452,23,152,5627
subtest22of10,pubtest29of10,1,320,5452,28,187,5667
subtest28of10,pubtest29of10,1,320,5452,29,226,5707
subtest24of10,pubtest29of10,1,320,5452,34,260,5746
subtest21of10,pubtest29of10,1,320,5452,35,300,5787
subtest26of10,pubtest29of10,1,320,5452,38,337,5827
subtest27of10,pubtest29of10,1,320,5452,37,377,5866
subtest29of10,pubtest210of10,1,322,6100,3,41,6144
subtest21of10,pubtest210of10,1,322,6100,12,73,6185
subtest210of10,pubtest210of10,1,322,6100,16,108,6224
subtest27of10,pubtest210of10,1,322,6100,19,144,6263
subtest28of10,pubtest210of10,1,322,6100,23,182,6305
subtest24of10,pubtest210of10,1,322,6100,26,218,6344
subtest22of10,pubtest210of10,1,322,6100,30,255,6385
subtest26of10,pubtest210of10,1,322,6100,32,292,6424
subtest23of10,pubtest210of10,1,322,6100,34,329,6463
subtest25of10,pubtest210of10,1,322,6100,38,363,6501
subtest27of10,pubtest21of10,1,321,11062,0,41,11103
subtest24of10,pubtest21of10,1,321,11062,3,78,11143
subtest26of10,pubtest21of10,1,321,11062,2,119,11183
subtest29of10,pubtest21of10,1,321,11062,4,157,11223
subtest25of10,pubtest21of10,1,321,11062,5,196,11263
subtest21of10,pubtest21of10,1,321,11062,11,230,11303
subtest28of10,pubtest21of10,1,321,11062,13,268,11343
subtest210of10,pubtest21of10,1,321,11062,13,308,11383
subtest22of10,pubtest21of10,1,321,11062,16,345,11423
subtest23of10,pubtest21of10,1,321,11062,17,384,11463
subtest24of10,pubtest22of10,1,320,5211,1,38,5250
subtest29of10,pubtest22of10,1,320,5211,0,78,5289
subtest27of10,pubtest22of10,1,320,5211,9,109,5329
subtest28of10,pubtest22of10,1,320,5211,12,146,5369
subtest26of10,pubtest22of10,1,320,5211,14,184,5409
subtest210of10,pubtest22of10,1,320,5211,19,219,5449
subtest23of10,pubtest22of10,1,320,5211,22,256,5489
subtest25of10,pubtest22of10,1,320,5211,25,292,5528
subtest21of10,pubtest22of10,1,320,5211,32,326,5569
subtest22of10,pubtest22of10,1,320,5211,36,362,5609
subtest23of10,pubtest23of10,1,320,5728,1,41,5770
subtest28of10,pubtest23of10,1,320,5728,4,77,5809
subtest24of10,pubtest23of10,1,320,5728,6,114,5848
subtest27of10,pubtest23of10,1,320,5728,8,152,5888
subtest25of10,pubtest23of10,1,320,5728,9,192,5929
subtest26of10,pubtest23of10,1,320,5728,11,230,5969
subtest29of10,pubtest23of10,1,320,5728,4,269,6001
subtest21of10,pubtest23of10,1,320,5728,14,307,6049
subtest22of10,pubtest23of10,1,320,5728,14,347,6089
subtest210of10,pubtest23of10,1,320,5728,16,385,6129
subtest24of10,pubtest24of10,1,320,5154,1,47,5202
subtest23of10,pubtest24of10,1,320,5154,1,85,5240
subtest28of10,pubtest24of10,1,320,5154,5,120,5279
subtest25of10,pubtest24of10,1,320,5154,6,160,5320
subtest22of10,pubtest24of10,1,320,5154,7,198,5359
subtest26of10,pubtest24of10,1,320,5154,14,232,5400
subtest21of10,pubtest24of10,1,320,5154,14,272,5440
subtest29of10,pubtest24of10,1,320,5154,16,310,5480
subtest27of10,pubtest24of10,1,320,5154,16,350,5520
subtest210of10,pubtest24of10,1,320,5154,14,390,5558
subtest28of10,pubtest25of10,1,320,5409,0,183,5592
subtest210of10,pubtest25of10,1,320,5409,8,213,5630
subtest26of10,pubtest25of10,1,320,5409,9,252,5670
subtest25of10,pubtest25of10,1,320,5409,11,290,5710
subtest22of10,pubtest25of10,1,320,5409,10,329,5748
subtest23of10,pubtest25of10,1,320,5409,12,369,5790
subtest27of10,pubtest25of10,1,320,5409,14,407,5830
subtest24of10,pubtest25of10,1,320,5409,14,448,5871
subtest21of10,pubtest25of10,1,320,5409,8,486,5903
subtest29of10,pubtest25of10,1,320,5409,16,524,5949
subtest21of10,pubtest26of10,1,320,5226,1,39,5266
subtest22of10,pubtest26of10,1,320,5226,1,78,5305
subtest29of10,pubtest26of10,1,320,5226,12,107,5345
subtest23of10,pubtest26of10,1,320,5226,16,143,5385
subtest26of10,pubtest26of10,1,320,5226,17,182,5425
subtest210of10,pubtest26of10,1,320,5226,20,219,5465
subtest28of10,pubtest26of10,1,320,5226,24,255,5505
subtest27of10,pubtest26of10,1,320,5226,26,293,5545
subtest24of10,pubtest26of10,1,320,5226,30,329,5585
subtest25of10,pubtest26of10,1,320,5226,34,365,5625
subtest27of10,pubtest27of10,1,319,5177,4,47,5228
subtest23of10,pubtest27of10,1,319,5177,11,79,5267
subtest24of10,pubtest27of10,1,319,5177,12,118,5307
subtest28of10,pubtest27of10,1,319,5177,13,157,5347
subtest210of10,pubtest27of10,1,319,5177,24,186,5387
subtest29of10,pubtest27of10,1,319,5177,41,209,5427
subtest25of10,pubtest27of10,1,319,5177,47,243,5467
subtest22of10,pubtest27of10,1,319,5177,57,273,5507
subtest21of10,pubtest27of10,1,319,5177,60,311,5548
subtest26of10,pubtest27of10,1,319,5177,82,328,5587
subtest27of10,pubtest28of10,1,320,5101,5,52,5158
subtest29of10,pubtest28of10,1,320,5101,6,90,5197
subtest210of10,pubtest28of10,1,320,5101,8,127,5236
subtest25of10,pubtest28of10,1,320,5101,10,165,5276
subtest26of10,pubtest28of10,1,320,5101,12,204,5317
subtest28of10,pubtest28of10,1,320,5101,6,243,5350
subtest23of10,pubtest28of10,1,320,5101,15,281,5397
subtest24of10,pubtest28of10,1,320,5101,17,318,5436
subtest21of10,pubtest28of10,1,320,5101,5,357,5463
subtest22of10,pubtest28of10,1,320,5101,22,394,5517
subtest23of10,pubtest29of10,1,320,5109,2,42,5153
subtest210of10,pubtest29of10,1,320,5109,7,76,5192
subtest29of10,pubtest29of10,1,320,5109,8,115,5232
subtest25of10,pubtest29of10,1,320,5109,10,153,5272
subtest22of10,pubtest29of10,1,320,5109,10,193,5312
subtest21of10,pubtest29of10,1,320,5109,14,228,5351
subtest28of10,pubtest29of10,1,320,5109,14,267,5390
subtest24of10,pubtest29of10,1,320,5109,16,307,5432
subtest27of10,pubtest29of10,1,320,5109,15,345,5469
subtest26of10,pubtest29of10,1,320,5109,18,385,5512
subtest29of10,pubtest210of10,1,322,5155,-2,43,5196
subtest21of10,pubtest210of10,1,322,5155,3,77,5235
subtest210of10,pubtest210of10,1,322,5155,6,114,5275
subtest27of10,pubtest210of10,1,322,5155,8,153,5316
subtest28of10,pubtest210of10,1,322,5155,9,191,5355
subtest25of10,pubtest210of10,1,322,5155,11,229,5395
subtest23of10,pubtest210of10,1,322,5155,11,268,5434
subtest26of10,pubtest210of10,1,322,5155,12,307,5474
subtest24of10,pubtest210of10,1,322,5155,11,347,5513
subtest22of10,pubtest210of10,1,322,5155,13,387,5555
subtest27of10,pubtest21of10,1,321,10261,3,39,10303
subtest26of10,pubtest21of10,1,321,10261,3,79,10343
subtest24of10,pubtest21of10,1,321,10261,5,116,10382
subtest29of10,pubtest21of10,1,321,10261,6,155,10422
subtest25of10,pubtest21of10,1,321,10261,9,192,10462
subtest210of10,pubtest21of10,1,321,10261,15,224,10500
subtest28of10,pubtest21of10,1,321,10261,17,263,10541
subtest21of10,pubtest21of10,1,321,10261,14,303,10578
subtest22of10,pubtest21of10,1,321,10261,21,340,10622
subtest23of10,pubtest21of10,1,321,10261,25,376,10662
subtest29of10,pubtest22of10,1,320,5082,0,40,5122
subtest24of10,pubtest22of10,1,320,5082,1,79,5162
subtest27of10,pubtest22of10,1,320,5082,10,109,5201
subtest28of10,pubtest22of10,1,320,5082,11,147,5240
subtest23of10,pubtest22of10,1,320,5082,11,188,5281
subtest25of10,pubtest22of10,1,320,5082,13,226,5321
subtest26of10,pubtest22of10,1,320,5082,19,259,5360
subtest21of10,pubtest22of10,1,320,5082,20,300,5402
subtest22of10,pubtest22of10,1,320,5082,34,325,5441
subtest210of10,pubtest22of10,1,320,5082,34,364,5480
subtest23of10,pubtest23of10,1,320,5177,1,42,5220
subtest28of10,pubtest23of10,1,320,5177,2,81,5260
subtest29of10,pubtest23of10,1,320,5177,4,118,5299
subtest24of10,pubtest23of10,1,320,5177,7,156,5340
subtest25of10,pubtest23of10,1,320,5177,8,193,5378
subtest26of10,pubtest23of10,1,320,5177,9,233,5419
subtest27of10,pubtest23of10,1,320,5177,7,272,5456
subtest22of10,pubtest23of10,1,320,5177,25,297,5499
subtest21of10,pubtest23of10,1,320,5177,28,334,5539
subtest210of10,pubtest23of10,1,320,5177,29,373,5579
subtest24of10,pubtest24of10,1,320,5263,1,48,5312
subtest23of10,pubtest24of10,1,320,5263,1,88,5352
subtest28of10,pubtest24of10,1,320,5263,6,123,5392
subtest25of10,pubtest24of10,1,320,5263,4,164,5431
subtest22of10,pubtest24of10,1,320,5263,9,201,5473
subtest210of10,pubtest24of10,1,320,5263,11,239,5513
subtest21of10,pubtest24of10,1,320,5263,8,280,5551
subtest29of10,pubtest24of10,1,320,5263,19,311,5593
subtest26of10,pubtest24of10,1,320,5263,37,332,5632
subtest27of10,pubtest24of10,1,320,5263,37,370,5670
subtest28of10,pubtest25of10,1,320,5242,2,40,5284
subtest21of10,pubtest25of10,1,320,5242,3,78,5323
subtest210of10,pubtest25of10,1,320,5242,4,117,5363
subtest26of10,pubtest25of10,1,320,5242,6,155,5403
subtest27of10,pubtest25of10,1,320,5242,8,193,5443
subtest22of10,pubtest25of10,1,320,5242,13,228,5483
subtest25of10,pubtest25of10,1,320,5242,17,263,5522
subtest23of10,pubtest25of10,1,320,5242,24,297,5563
subtest29of10,pubtest25of10,1,320,5242,25,336,5603
subtest24of10,pubtest25of10,1,320,5242,26,375,5643
subtest21of10,pubtest26of10,1,320,5575,6,39,5620
subtest22of10,pubtest26of10,1,320,5575,6,79,5660
subtest29of10,pubtest26of10,1,320,5575,7,119,5701
subtest23of10,pubtest26of10,1,320,5575,9,156,5740
subtest26of10,pubtest26of10,1,320,5575,10,195,5780
subtest27of10,pubtest26of10,1,320,5575,11,234,5820
subtest210of10,pubtest26of10,1,320,5575,12,273,5860
subtest25of10,pubtest26of10,1,320,5575,14,311,5900
subtest28of10,pubtest26of10,1,320,5575,14,351,5940
subtest24of10,pubtest26of10,1,320,5575,15,390,5980
subtest27of10,pubtest27of10,1,319,5239,0,41,5280
subtest28of10,pubtest27of10,1,319,5239,0,81,5320
subtest23of10,pubtest27of10,1,319,5239,11,110,5360
subtest24of10,pubtest27of10,1,319,5239,13,147,5399
subtest210of10,pubtest27of10,1,319,5239,16,183,5438
subtest29of10,pubtest27of10,1,319,5239,22,218,5479
subtest25of10,pubtest27of10,1,319,5239,25,255,5519
subtest22of10,pubtest27of10,1,319,5239,28,292,5559
subtest26of10,pubtest27of10,1,319,5239,31,329,5599
subtest21of10,pubtest27of10,1,319,5239,34,365,5638
subtest27of10,pubtest28of10,1,320,5156,0,42,5198
subtest28of10,pubtest28of10,1,320,5156,4,76,5236
subtest21of10,pubtest28of10,1,320,5156,6,114,5276
subtest29of10,pubtest28of10,1,320,5156,9,151,5316
subtest210of10,pubtest28of10,1,320,5156,16,183,5355
subtest26of10,pubtest28of10,1,320,5156,17,223,5396
subtest23of10,pubtest28of10,1,320,5156,16,262,5434
subtest25of10,pubtest28of10,1,320,5156,21,299,5476
subtest24of10,pubtest28of10,1,320,5156,21,339,5516
subtest22of10,pubtest28of10,1,320,5156,23,377,5556
subtest23of10,pubtest29of10,1,320,5097,0,40,5137
subtest210of10,pubtest29of10,1,320,5097,2,77,5176
subtest29of10,pubtest29of10,1,320,5097,4,114,5215
subtest22of10,pubtest29of10,1,320,5097,4,154,5255
subtest25of10,pubtest29of10,1,320,5097,6,193,5296
subtest28of10,pubtest29of10,1,320,5097,12,227,5336
subtest21of10,pubtest29of10,1,320,5097,12,267,5376
subtest24of10,pubtest29of10,1,320,5097,17,302,5416
subtest27of10,pubtest29of10,1,320,5097,21,338,5456
subtest26of10,pubtest29of10,1,320,5097,24,375,5496
subtest29of10,pubtest210of10,1,322,5108,2,41,5151
subtest21of10,pubtest210of10,1,322,5108,2,81,5191
subtest210of10,pubtest210of10,1,322,5108,12,110,5230
subtest27of10,pubtest210of10,1,322,5108,13,148,5269
subtest28of10,pubtest210of10,1,322,5108,16,185,5309
subtest24of10,pubtest210of10,1,322,5108,18,224,5350
subtest22of10,pubtest210of10,1,322,5108,22,260,5390
subtest26of10,pubtest210of10,1,322,5108,27,295,5430
subtest23of10,pubtest210of10,1,322,5108,31,330,5469
subtest25of10,pubtest210of10,1,322,5108,34,368,5510
subtest27of10,pubtest21of10,1,321,10045,13,39,10097
subtest29of10,pubtest21of10,1,321,10045,13,78,10136
subtest21of10,pubtest21of10,1,321,10045,15,115,10175
subtest25of10,pubtest21of10,1,321,10045,15,155,10215
subtest23of10,pubtest21of10,1,321,10045,17,194,10256
subtest26of10,pubtest21of10,1,321,10045,17,233,10295
subtest24of10,pubtest21of10,1,321,10045,19,270,10334
subtest22of10,pubtest21of10,1,321,10045,22,309,10376
subtest28of10,pubtest21of10,1,321,10045,22,348,10415
subtest210of10,pubtest21of10,1,321,10045,19,389,10453
subtest29of10,pubtest22of10,1,320,5050,0,39,5089
subtest24of10,pubtest22of10,1,320,5050,7,73,5130
subtest27of10,pubtest22of10,1,320,5050,8,110,5168
subtest28of10,pubtest22of10,1,320,5050,10,150,5210
subtest26of10,pubtest22of10,1,320,5050,23,176,5249
subtest23of10,pubtest22of10,1,320,5050,24,214,5288
subtest210of10,pubtest22of10,1,320,5050,27,252,5329
subtest25of10,pubtest22of10,1,320,5050,35,285,5370
subtest22of10,pubtest22of10,1,320,5050,36,324,5410
subtest21of10,pubtest22of10,1,320,5050,44,355,5449
subtest23of10,pubtest23of10,1,320,5094,10,40,5144
subtest28of10,pubtest23of10,1,320,5094,11,79,5184
subtest24of10,pubtest23of10,1,320,5094,19,110,5223
subtest29of10,pubtest23of10,1,320,5094,25,145,5264
subtest27of10,pubtest23of10,1,320,5094,27,182,5303
subtest25of10,pubtest23of10,1,320,5094,27,222,5343
subtest26of10,pubtest23of10,1,320,5094,45,244,5383
subtest22of10,pubtest23of10,1,320,5094,48,282,5424
subtest210of10,pubtest23of10,1,320,5094,49,321,5464
subtest21of10,pubtest23of10,1,320,5094,48,359,5501
subtest23of10,pubtest24of10,1,320,5180,1,41,5222
subtest24of10,pubtest24of10,1,320,5180,1,79,5260
subtest25of10,pubtest24of10,1,320,5180,9,113,5302
subtest28of10,pubtest24of10,1,320,5180,11,151,5342
subtest21of10,pubtest24of10,1,320,5180,16,185,5381
subtest29of10,pubtest24of10,1,320,5180,17,225,5422
subtest22of10,pubtest24of10,1,320,5180,16,265,5461
subtest27of10,pubtest24of10,1,320,5180,18,303,5501
subtest210of10,pubtest24of10,1,320,5180,20,341,5541
subtest26of10,pubtest24of10,1,320,5180,21,381,5582
subtest28of10,pubtest25of10,1,320,5129,1,41,5171
subtest210of10,pubtest25of10,1,320,5129,2,79,5210
subtest21of10,pubtest25of10,1,320,5129,3,118,5250
subtest26of10,pubtest25of10,1,320,5129,7,153,5289
subtest27of10,pubtest25of10,1,320,5129,6,192,5327
subtest22of10,pubtest25of10,1,320,5129,12,228,5369
subtest25of10,pubtest25of10,1,320,5129,12,268,5409
subtest24of10,pubtest25of10,1,320,5129,16,304,5449
subtest23of10,pubtest25of10,1,320,5129,20,340,5489
subtest29of10,pubtest25of10,1,320,5129,20,380,5529
subtest29of10,pubtest26of10,1,320,5158,3,39,5200
subtest22of10,pubtest26of10,1,320,5158,3,77,5238
subtest21of10,pubtest26of10,1,320,5158,1,120,5279
subtest27of10,pubtest26of10,1,320,5158,29,132,5319
subtest23of10,pubtest26of10,1,320,5158,29,173,5360
subtest26of10,pubtest26of10,1,320,5158,31,210,5399
subtest25of10,pubtest26of10,1,320,5158,31,250,5439
subtest210of10,pubtest26of10,1,320,5158,37,285,5480
subtest28of10,pubtest26of10,1,320,5158,38,323,5519
subtest24of10,pubtest26of10,1,320,5158,39,362,5559
subtest28of10,pubtest27of10,1,319,5578,1,49,5628
subtest27of10,pubtest27of10,1,319,5578,1,89,5668
subtest24of10,pubtest27of10,1,319,5578,14,115,5707
subtest23of10,pubtest27of10,1,319,5578,16,153,5747
subtest29of10,pubtest27of10,1,319,5578,20,189,5787
subtest22of10,pubtest27of10,1,319,5578,21,227,5826
subtest210of10,pubtest27of10,1,319,5578,21,268,5867
subtest26of10,pubtest27of10,1,319,5578,23,307,5908
subtest21of10,pubtest27of10,1,319,5578,24,345,5947
subtest25of10,pubtest27of10,1,319,5578,23,384,5985
subtest28of10,pubtest28of10,1,320,6165,9,39,6213
subtest27of10,pubtest28of10,1,320,6165,9,79,6253
subtest21of10,pubtest28of10,1,320,6165,10,116,6291
subtest29of10,pubtest28of10,1,320,6165,23,145,6333
subtest210of10,pubtest28of10,1,320,6165,26,182,6373
subtest23of10,pubtest28of10,1,320,6165,32,215,6412
subtest26of10,pubtest28of10,1,320,6165,35,252,6452
subtest25of10,pubtest28of10,1,320,6165,47,280,6492
subtest24of10,pubtest28of10,1,320,6165,66,301,6532
subtest22of10,pubtest28of10,1,320,6165,67,340,6572
subtest29of10,pubtest29of10,1,320,5862,6,352,6220
subtest23of10,pubtest29of10,1,320,5862,5,391,6258
subtest210of10,pubtest29of10,1,320,5862,8,428,6298
subtest25of10,pubtest29of10,1,320,5862,8,467,6337
subtest28of10,pubtest29of10,1,320,5862,10,505,6377
subtest22of10,pubtest29of10,1,320,5862,10,545,6417
subtest21of10,pubtest29of10,1,320,5862,22,574,6458
subtest27of10,pubtest29of10,1,320,5862,25,611,6498
subtest24of10,pubtest29of10,1,320,5862,29,647,6538
subtest26of10,pubtest29of10,1,320,5862,35,681,6578
subtest29of10,pubtest210of10,1,322,5845,-3,266,6108
subtest21of10,pubtest210of10,1,322,5845,-1,300,6144
subtest210of10,pubtest210of10,1,322,5845,9,330,6184
subtest27of10,pubtest210of10,1,322,5845,13,366,6224
subtest28of10,pubtest210of10,1,322,5845,17,403,6265
subtest23of10,pubtest210of10,1,322,5845,20,441,6306
subtest25of10,pubtest210of10,1,322,5845,22,479,6346
subtest24of10,pubtest210of10,1,322,5845,25,515,6385
subtest22of10,pubtest210of10,1,322,5845,28,553,6426
subtest26of10,pubtest210of10,1,322,5845,32,588,6465
subtest24of10,pubtest21of10,1,321,11773,12,44,11829
subtest29of10,pubtest21of10,1,321,11773,13,83,11869
subtest21of10,pubtest21of10,1,321,11773,15,121,11909
subtest25of10,pubtest21of10,1,321,11773,15,161,11949
subtest26of10,pubtest21of10,1,321,11773,11,204,11988
subtest27of10,pubtest21of10,1,321,11773,11,243,12027
subtest210of10,pubtest21of10,1,321,11773,29,267,12069
subtest28of10,pubtest21of10,1,321,11773,31,305,12109
subtest22of10,pubtest21of10,1,321,11773,33,344,12150
subtest23of10,pubtest21of10,1,321,11773,36,380,12189
subtest29of10,pubtest22of10,1,320,6062,2,40,6104
subtest24of10,pubtest22of10,1,320,6062,2,79,6143
subtest27of10,pubtest22of10,1,320,6062,16,106,6184
subtest28of10,pubtest22of10,1,320,6062,19,142,6223
subtest26of10,pubtest22of10,1,320,6062,21,180,6263
subtest210of10,pubtest22of10,1,320,6062,24,217,6303
subtest23of10,pubtest22of10,1,320,6062,26,256,6344
subtest21of10,pubtest22of10,1,320,6062,28,292,6382
subtest25of10,pubtest22of10,1,320,6062,28,332,6422
subtest22of10,pubtest22of10,1,320,6062,30,371,6463
subtest23of10,pubtest23of10,1,320,5320,-1,40,5359
subtest29of10,pubtest23of10,1,320,5320,1,78,5399
subtest24of10,pubtest23of10,1,320,5320,2,120,5442
subtest28of10,pubtest23of10,1,320,5320,3,159,5482
subtest27of10,pubtest23of10,1,320,5320,12,190,5522
subtest25of10,pubtest23of10,1,320,5320,13,231,5564
subtest26of10,pubtest23of10,1,320,5320,14,269,5603
subtest22of10,pubtest23of10,1,320,5320,16,306,5642
subtest21of10,pubtest23of10,1,320,5320,17,344,5681
subtest210of10,pubtest23of10,1,320,5320,18,384,5722
subtest24of10,pubtest24of10,1,320,5194,0,40,5234
subtest23of10,pubtest24of10,1,320,5194,0,80,5274
subtest28of10,pubtest24of10,1,320,5194,7,112,5313
subtest25of10,pubtest24of10,1,320,5194,14,146,5354
subtest21of10,pubtest24of10,1,320,5194,16,183,5393
subtest22of10,pubtest24of10,1,320,5194,20,219,5433
subtest210of10,pubtest24of10,1,320,5194,24,255,5473
subtest29of10,pubtest24of10,1,320,5194,28,290,5512
subtest26of10,pubtest24of10,1,320,5194,29,330,5553
subtest27of10,pubtest24of10,1,320,5194,30,369,5593
subtest28of10,pubtest25of10,1,320,5108,2,46,5156
subtest210of10,pubtest25of10,1,320,5108,3,85,5196
subtest21of10,pubtest25of10,1,320,5108,3,123,5234
subtest26of10,pubtest25of10,1,320,5108,10,157,5275
subtest27of10,pubtest25of10,1,320,5108,17,190,5315
subtest25of10,pubtest25of10,1,320,5108,18,229,5355
subtest22of10,pubtest25of10,1,320,5108,17,268,5393
subtest23of10,pubtest25of10,1,320,5108,20,307,5435
subtest29of10,pubtest25of10,1,320,5108,25,342,5475
subtest24of10,pubtest25of10,1,320,5108,26,382,5516
subtest21of10,pubtest26of10,1,320,5210,1,40,5251
subtest29of10,pubtest26of10,1,320,5210,2,81,5293
subtest22of10,pubtest26of10,1,320,5210,3,119,5332
subtest23of10,pubtest26of10,1,320,5210,13,148,5371
subtest26of10,pubtest26of10,1,320,5210,14,187,5411
subtest210of10,pubtest26of10,1,320,5210,29,212,5451
subtest28of10,pubtest26of10,1,320,5210,30,251,5491
subtest27of10,pubtest26of10,1,320,5210,31,290,5531
subtest24of10,pubtest26of10,1,320,5210,37,324,5571
subtest25of10,pubtest26of10,1,320,5210,38,363,5611
subtest27of10,pubtest27of10,1,319,6161,5,40,6206
subtest28of10,pubtest27of10,1,319,6161,8,77,6246
subtest24of10,pubtest27of10,1,319,6161,15,110,6286
subtest23of10,pubtest27of10,1,319,6161,15,150,6326
subtest29of10,pubtest27of10,1,319,6161,17,188,6366
subtest25of10,pubtest27of10,1,319,6161,17,228,6406
subtest210of10,pubtest27of10,1,319,6161,17,267,6445
subtest22of10,pubtest27of10,1,319,6161,28,297,6486
subtest26of10,pubtest27of10,1,319,6161,28,336,6525
subtest21of10,pubtest27of10,1,319,6161,30,375,6566
subtest27of10,pubtest28of10,1,320,5553,-3,46,5596
subtest28of10,pubtest28of10,1,320,5553,-3,85,5635
subtest26of10,pubtest28of10,1,320,5553,1,121,5675
subtest29of10,pubtest28of10,1,320,5553,3,159,5715
subtest210of10,pubtest28of10,1,320,5553,4,200,5757
subtest21of10,pubtest28of10,1,320,5553,5,237,5795
subtest23of10,pubtest28of10,1,320,5553,16,265,5834
subtest25of10,pubtest28of10,1,320,5553,17,305,5875
subtest24of10,pubtest28of10,1,320,5553,16,344,5913
subtest22of10,pubtest28of10,1,320,5553,24,378,5955
subtest210of10,pubtest29of10,1,320,5823,2,40,5865
subtest23of10,pubtest29of10,1,320,5823,2,79,5904
subtest29of10,pubtest29of10,1,320,5823,4,117,5944
subtest21of10,pubtest29of10,1,320,5823,8,153,5984
subtest25of10,pubtest29of10,1,320,5823,8,193,6024
subtest22of10,pubtest29of10,1,320,5823,11,230,6064
subtest27of10,pubtest29of10,1,320,5823,15,266,6104
subtest28of10,pubtest29of10,1,320,5823,15,306,6144
subtest26of10,pubtest29of10,1,320,5823,19,341,6183
subtest24of10,pubtest29of10,1,320,5823,19,380,6222
subtest21of10,pubtest210of10,1,322,5106,0,41,5147
subtest29of10,pubtest210of10,1,322,5106,0,80,5186
subtest210of10,pubtest210of10,1,322,5106,7,113,5226
subtest27of10,pubtest210of10,1,322,5106,7,152,5265
subtest28of10,pubtest210of10,1,322,5106,9,191,5306
subtest22of10,pubtest210of10,1,322,5106,11,229,5346
subtest24of10,pubtest210of10,1,322,5106,10,269,5385
subtest23of10,pubtest210of10,1,322,5106,18,302,5426
subtest25of10,pubtest210of10,1,322,5106,18,342,5466
subtest26of10,pubtest210of10,1,322,5106,18,381,5505
subtest27of10,pubtest21of10,1,321,10280,1,38,10319
subtest26of10,pubtest21of10,1,321,10280,6,80,10366
subtest24of10,pubtest21of10,1,321,10280,8,118,10406
subtest29of10,pubtest21of10,1,321,10280,12,155,10447
subtest25of10,pubtest21of10,1,321,10280,16,191,10487
subtest21of10,pubtest21of10,1,321,10280,17,229,10526
subtest210of10,pubtest21of10,1,321,10280,18,267,10565
subtest28of10,pubtest21of10,1,321,10280,20,305,10605
subtest23of10,pubtest21of10,1,321,10280,23,343,10646
subtest22of10,pubtest21of10,1,321,10280,23,383,10686
subtest29of10,pubtest22of10,1,320,5123,0,39,5162
subtest24of10,pubtest22of10,1,320,5123,0,78,5201
subtest28of10,pubtest22of10,1,320,5123,3,115,5241
subtest27of10,pubtest22of10,1,320,5123,5,153,5281
subtest26of10,pubtest22of10,1,320,5123,5,193,5321
subtest23of10,pubtest22of10,1,320,5123,7,231,5361
subtest210of10,pubtest22of10,1,320,5123,19,259,5401
subtest25of10,pubtest22of10,1,320,5123,19,299,5441
subtest21of10,pubtest22of10,1,320,5123,20,337,5480
subtest22of10,pubtest22of10,1,320,5123,21,377,5521
subtest23of10,pubtest23of10,1,320,5112,1,39,5152
subtest28of10,pubtest23of10,1,320,5112,2,77,5191
subtest29of10,pubtest23of10,1,320,5112,4,116,5232
subtest24of10,pubtest23of10,1,320,5112,4,155,5271
subtest26of10,pubtest23of10,1,320,5112,15,184,5311
subtest27of10,pubtest23of10,1,320,5112,16,223,5351
subtest25of10,pubtest23of10,1,320,5112,17,262,5391
subtest22of10,pubtest23of10,1,320,5112,18,302,5432
subtest21of10,pubtest23of10,1,320,5112,18,341,5471
subtest210of10,pubtest23of10,1,320,5112,23,377,5512
subtest23of10,pubtest24of10,1,320,5200,6,39,5245
subtest24of10,pubtest24of10,1,320,5200,6,77,5283
subtest28of10,pubtest24of10,1,320,5200,12,112,5324
subtest25of10,pubtest24of10,1,320,5200,14,150,5364
subtest21of10,pubtest24of10,1,320,5200,14,190,5404
subtest22of10,pubtest24of10,1,320,5200,16,229,5445
subtest29of10,pubtest24of10,1,320,5200,17,267,5484
subtest210of10,pubtest24of10,1,320,5200,27,297,5524
subtest27of10,pubtest24of10,1,320,5200,31,334,5565
subtest26of10,pubtest24of10,1,320,5200,39,365,5604
subtest28of10,pubtest25of10,1,320,5146,4,51,5201
subtest21of10,pubtest25of10,1,320,5146,4,478,5628
subtest210of10,pubtest25of10,1,320,5146,6,512,5664
subtest26of10,pubtest25of10,1,320,5146,13,545,5704
subtest25of10,pubtest25of10,1,320,5146,13,585,5744
subtest27of10,pubtest25of10,1,320,5146,12,624,5782
subtest23of10,pubtest25of10,1,320,5146,16,663,5825
subtest29of10,pubtest25of10,1,320,5146,15,703,5864
subtest22of10,pubtest25of10,1,320,5146,17,741,5904
subtest24of10,pubtest25of10,1,320,5146,22,776,5944
subtest29of10,pubtest26of10,1,320,5229,1,43,5273
subtest21of10,pubtest26of10,1,320,5229,1,79,5309
subtest23of10,pubtest26of10,1,320,5229,12,108,5349
subtest22of10,pubtest26of10,1,320,5229,15,145,5389
subtest26of10,pubtest26of10,1,320,5229,21,179,5429
subtest210of10,pubtest26of10,1,320,5229,24,216,5469
subtest27of10,pubtest26of10,1,320,5229,27,253,5509
subtest28of10,pubtest26of10,1,320,5229,30,289,5548
subtest24of10,pubtest26of10,1,320,5229,32,328,5589
subtest25of10,pubtest26of10,1,320,5229,36,364,5629
subtest27of10,pubtest27of10,1,319,5109,2,39,5150
subtest28of10,pubtest27of10,1,319,5109,3,76,5188
subtest23of10,pubtest27of10,1,319,5109,5,115,5229
subtest24of10,pubtest27of10,1,319,5109,6,154,5269
subtest29of10,pubtest27of10,1,319,5109,7,193,5309
subtest210of10,pubtest27of10,1,319,5109,18,222,5349
subtest25of10,pubtest27of10,1,319,5109,25,256,5390
subtest22of10,pubtest27of10,1,319,5109,26,295,5430
subtest26of10,pubtest27of10,1,319,5109,30,329,5468
subtest21of10,pubtest27of10,1,319,5109,30,369,5508
subtest27of10,pubtest28of10,1,320,5129,-1,41,5169
subtest28of10,pubtest28of10,1,320,5129,0,78,5207
subtest21of10,pubtest28of10,1,320,5129,2,117,5248
subtest29of10,pubtest28of10,1,320,5129,4,155,5288
subtest210of10,pubtest28of10,1,320,5129,11,189,5329
subtest23of10,pubtest28of10,1,320,5129,17,222,5368
subtest26of10,pubtest28of10,1,320,5129,20,259,5408
subtest25of10,pubtest28of10,1,320,5129,20,300,5449
subtest24of10,pubtest28of10,1,320,5129,22,338,5489
subtest22of10,pubtest28of10,1,320,5129,22,377,5528
subtest23of10,pubtest29of10,1,320,5113,5,42,5160
subtest29of10,pubtest29of10,1,320,5113,7,80,5200
subtest210of10,pubtest29of10,1,320,5113,5,121,5239
subtest25of10,pubtest29of10,1,320,5113,8,158,5279
subtest22of10,pubtest29of10,1,320,5113,16,190,5319
subtest21of10,pubtest29of10,1,320,5113,17,229,5359
subtest27of10,pubtest29of10,1,320,5113,21,265,5399
subtest28of10,pubtest29of10,1,320,5113,20,305,5438
subtest24of10,pubtest29of10,1,320,5113,22,343,5478
subtest26of10,pubtest29of10,1,320,5113,26,380,5519
subtest29of10,pubtest210of10,1,322,5147,-1,38,5184
subtest21of10,pubtest210of10,1,322,5147,0,77,5224
subtest210of10,pubtest210of10,1,322,5147,29,88,5264
subtest27of10,pubtest210of10,1,322,5147,30,126,5303
subtest28of10,pubtest210of10,1,322,5147,31,165,5343
subtest24of10,pubtest210of10,1,322,5147,32,204,5383
subtest25of10,pubtest210of10,1,322,5147,33,244,5424
subtest23of10,pubtest210of10,1,322,5147,34,281,5462
subtest22of10,pubtest210of10,1,322,5147,37,319,5503
subtest26of10,pubtest210of10,1,322,5147,38,358,5543
subtest26of10,pubtest21of10,1,321,10185,12,39,10236
subtest27of10,pubtest21of10,1,321,10185,23,67,10275
subtest24of10,pubtest21of10,1,321,10185,28,101,10314
subtest29of10,pubtest21of10,1,321,10185,31,139,10355
subtest25of10,pubtest21of10,1,321,10185,31,179,10395
subtest21of10,pubtest21of10,1,321,10185,36,214,10435
subtest210of10,pubtest21of10,1,321,10185,40,250,10475
subtest28of10,pubtest21of10,1,321,10185,42,288,10515
subtest22of10,pubtest21of10,1,321,10185,46,324,10555
subtest23of10,pubtest21of10,1,321,10185,50,360,10595
subtest29of10,pubtest22of10,1,320,5092,2,39,5133
subtest24of10,pubtest22of10,1,320,5092,2,78,5172
subtest27of10,pubtest22of10,1,320,5092,9,111,5212
subtest28of10,pubtest22of10,1,320,5092,10,149,5251
subtest26of10,pubtest22of10,1,320,5092,12,188,5292
subtest23of10,pubtest22of10,1,320,5092,12,228,5332
subtest25of10,pubtest22of10,1,320,5092,21,259,5372
subtest210of10,pubtest22of10,1,320,5092,21,299,5412
subtest22of10,pubtest22of10,1,320,5092,23,337,5452
subtest21of10,pubtest22of10,1,320,5092,23,377,5492
subtest23of10,pubtest23of10,1,320,5180,5,47,5232
subtest28of10,pubtest23of10,1,320,5180,5,88,5273
subtest29of10,pubtest23of10,1,320,5180,7,125,5312
subtest26of10,pubtest23of10,1,320,5180,9,163,5352
subtest27of10,pubtest23of10,1,320,5180,10,202,5392
subtest25of10,pubtest23of10,1,320,5180,11,241,5432
subtest24of10,pubtest23of10,1,320,5180,11,280,5471
subtest22of10,pubtest23of10,1,320,5180,16,315,5511
subtest21of10,pubtest23of10,1,320,5180,16,355,5551
subtest210of10,pubtest23of10,1,320,5180,18,394,5592
subtest23of10,pubtest24of10,1,320,5111,-1,39,5149
subtest24of10,pubtest24of10,1,320,5111,0,79,5190
subtest28of10,pubtest24of10,1,320,5111,4,114,5229
subtest25of10,pubtest24of10,1,320,5111,11,148,5270
subtest21of10,pubtest24of10,1,320,5111,18,179,5308
subtest22of10,pubtest24of10,1,320,5111,18,219,5348
subtest29of10,pubtest24of10,1,320,5111,21,258,5390
subtest210of10,pubtest24of10,1,320,5111,21,298,5430
subtest27of10,pubtest24of10,1,320,5111,23,335,5469
subtest26of10,pubtest24of10,1,320,5111,23,375,5509
subtest28of10,pubtest25of10,1,320,5181,7,41,5229
subtest210of10,pubtest25of10,1,320,5181,14,74,5269
subtest21of10,pubtest25of10,1,320,5181,23,105,5309
subtest26of10,pubtest25of10,1,320,5181,25,143,5349
subtest27of10,pubtest25of10,1,320,5181,28,179,5388
subtest22of10,pubtest25of10,1,320,5181,30,217,5428
subtest23of10,pubtest25of10,1,320,5181,32,255,5468
subtest25of10,pubtest25of10,1,320,5181,32,294,5507
subtest29of10,pubtest25of10,1,320,5181,34,333,5548
subtest24of10,pubtest25of10,1,320,5181,34,373,5588
subtest22of10,pubtest26of10,1,320,5176,11,42,5229
subtest21of10,pubtest26of10,1,320,5176,16,77,5269
subtest29of10,pubtest26of10,1,320,5176,17,115,5308
subtest23of10,pubtest26of10,1,320,5176,39,133,5348
subtest26of10,pubtest26of10,1,320,5176,42,171,5389
subtest210of10,pubtest26of10,1,320,5176,45,208,5429
subtest28of10,pubtest26of10,1,320,5176,48,244,5468
subtest27of10,pubtest26of10,1,320,5176,51,281,5508
subtest25of10,pubtest26of10,1,320,5176,53,319,5548
subtest24of10,pubtest26of10,1,320,5176,56,357,5589
subtest27of10,pubtest27of10,1,319,5147,1,39,5187
subtest28of10,pubtest27of10,1,319,5147,3,76,5226
subtest23of10,pubtest27of10,1,319,5147,8,111,5266
subtest24of10,pubtest27of10,1,319,5147,7,151,5305
subtest29of10,pubtest27of10,1,319,5147,11,188,5346
subtest210of10,pubtest27of10,1,319,5147,11,229,5387
subtest25of10,pubtest27of10,1,319,5147,16,264,5427
subtest22of10,pubtest27of10,1,319,5147,17,302,5466
subtest21of10,pubtest27of10,1,319,5147,18,341,5506
subtest26of10,pubtest27of10,1,319,5147,19,381,5547
subtest27of10,pubtest28of10,1,320,5150,0,43,5193
subtest21of10,pubtest28of10,1,320,5150,2,80,5232
subtest28of10,pubtest28of10,1,320,5150,1,121,5272
subtest29of10,pubtest28of10,1,320,5150,3,159,5312
subtest210of10,pubtest28of10,1,320,5150,6,197,5353
subtest23of10,pubtest28of10,1,320,5150,7,235,5392
subtest26of10,pubtest28of10,1,320,5150,8,274,5432
subtest25of10,pubtest28of10,1,320,5150,13,309,5472
subtest22of10,pubtest28of10,1,320,5150,16,346,5512
subtest24of10,pubtest28of10,1,320,5150,16,386,5552
subtest23of10,pubtest29of10,1,320,5210,3,43,5256
subtest210of10,pubtest29of10,1,320,5210,10,76,5296
subtest29of10,pubtest29of10,1,320,5210,13,112,5335
subtest22of10,pubtest29of10,1,320,5210,16,149,5375
subtest25of10,pubtest29of10,1,320,5210,20,185,5415
subtest28of10,pubtest29of10,1,320,5210,23,222,5455
subtest21of10,pubtest29of10,1,320,5210,25,260,5495
subtest24of10,pubtest29of10,1,320,5210,29,296,5535
subtest27of10,pubtest29of10,1,320,5210,29,336,5575
subtest26of10,pubtest29of10,1,320,5210,31,374,5615
subtest29of10,pubtest210of10,1,322,5218,8,44,5270
subtest27of10,pubtest210of10,1,322,5218,16,77,5311
subtest21of10,pubtest210of10,1,322,5218,16,116,5350
subtest210of10,pubtest210of10,1,322,5218,18,154,5390
subtest28of10,pubtest210of10,1,322,5218,18,194,5430
subtest23of10,pubtest210of10,1,322,5218,31,221,5470
subtest24of10,pubtest210of10,1,322,5218,58,234,5510
subtest25of10,pubtest210of10,1,322,5218,58,273,5549
subtest22of10,pubtest210of10,1,322,5218,60,309,5587
subtest26of10,pubtest210of10,1,322,5218,60,349,5627
subtest27of10,pubtest21of10,1,321,11731,6,39,11776
subtest26of10,pubtest21of10,1,321,11731,7,78,11816
subtest29of10,pubtest21of10,1,321,11731,9,116,11856
subtest24of10,pubtest21of10,1,321,11731,9,156,11896
subtest210of10,pubtest21of10,1,321,11731,17,188,11936
subtest25of10,pubtest21of10,1,321,11731,19,226,11976
subtest21of10,pubtest21of10,1,321,11731,21,264,12016
subtest28of10,pubtest21of10,1,321,11731,24,302,12057
subtest23of10,pubtest21of10,1,321,11731,26,338,12095
subtest22of10,pubtest21of10,1,321,11731,27,378,12136
subtest24of10,pubtest22of10,1,320,5524,5,47,5576
subtest29of10,pubtest22of10,1,320,5524,5,87,5616
subtest27of10,pubtest22of10,1,320,5524,12,120,5656
subtest28of10,pubtest22of10,1,320,5524,13,159,5696
subtest26of10,pubtest22of10,1,320,5524,26,186,5736
subtest23of10,pubtest22of10,1,320,5524,39,213,5776
subtest25of10,pubtest22of10,1,320,5524,45,247,5816
subtest21of10,pubtest22of10,1,320,5524,47,285,5856
subtest210of10,pubtest22of10,1,320,5524,50,323,5897
subtest22of10,pubtest22of10,1,320,5524,53,359,5936
subtest23of10,pubtest23of10,1,320,5750,9,39,5798
subtest28of10,pubtest23of10,1,320,5750,12,75,5837
subtest27of10,pubtest23of10,1,320,5750,23,103,5876
subtest26of10,pubtest23of10,1,320,5750,24,143,5917
subtest24of10,pubtest23of10,1,320,5750,25,182,5957
subtest25of10,pubtest23of10,1,320,5750,26,221,5997
subtest21of10,pubtest23of10,1,320,5750,27,260,6037
subtest29of10,pubtest23of10,1,320,5750,23,300,6073
subtest22of10,pubtest23of10,1,320,5750,28,338,6116
subtest210of10,pubtest23of10,1,320,5750,32,374,6156
subtest23of10,pubtest24of10,1,320,5806,4,45,5855
subtest28of10,pubtest24of10,1,320,5806,6,82,5894
subtest25of10,pubtest24of10,1,320,5806,8,120,5934
subtest24of10,pubtest24of10,1,320,5806,5,159,5970
subtest21of10,pubtest24of10,1,320,5806,32,177,6015
subtest22of10,pubtest24of10,1,320,5806,32,216,6054
subtest29of10,pubtest24of10,1,320,5806,34,254,6094
subtest210of10,pubtest24of10,1,320,5806,35,292,6133
subtest27of10,pubtest24of10,1,320,5806,36,331,6173
subtest26of10,pubtest24of10,1,320,5806,38,370,6214
subtest28of10,pubtest25of10,1,320,5254,5,40,5299
subtest21of10,pubtest25of10,1,320,5254,5,79,5338
subtest210of10,pubtest25of10,1,320,5254,7,116,5377
subtest27of10,pubtest25of10,1,320,5254,8,156,5418
subtest26of10,pubtest25of10,1,320,5254,8,195,5457
subtest22of10,pubtest25of10,1,320,5254,10,234,5498
subtest25of10,pubtest25of10,1,320,5254,20,263,5537
subtest29of10,pubtest25of10,1,320,5254,24,300,5578
subtest23of10,pubtest25of10,1,320,5254,24,340,5618
subtest24of10,pubtest25of10,1,320,5254,29,375,5658
subtest21of10,pubtest26of10,1,320,5235,-3,39,5271
subtest29of10,pubtest26of10,1,320,5235,0,75,5310
subtest22of10,pubtest26of10,1,320,5235,-1,115,5349
subtest23of10,pubtest26of10,1,320,5235,5,150,5390
subtest26of10,pubtest26of10,1,320,5235,11,183,5429
subtest27of10,pubtest26of10,1,320,5235,11,224,5470
subtest210of10,pubtest26of10,1,320,5235,13,262,5510
subtest24of10,pubtest26of10,1,320,5235,14,301,5550
subtest25of10,pubtest26of10,1,320,5235,15,340,5590
subtest28of10,pubtest26of10,1,320,5235,16,379,5630
subtest27of10,pubtest27of10,1,319,5132,2,40,5174
subtest28of10,pubtest27of10,1,319,5132,16,65,5213
subtest23of10,pubtest27of10,1,319,5132,19,102,5253
subtest24of10,pubtest27of10,1,319,5132,22,139,5293
subtest29of10,pubtest27of10,1,319,5132,25,178,5335
subtest210of10,pubtest27of10,1,319,5132,27,215,5374
subtest25of10,pubtest27of10,1,319,5132,31,249,5412
subtest22of10,pubtest27of10,1,319,5132,34,287,5453
subtest26of10,pubtest27of10,1,319,5132,37,324,5493
subtest21of10,pubtest27of10,1,319,5132,40,361,5533
subtest27of10,pubtest28of10,1,320,5111,2,44,5157
subtest28of10,pubtest28of10,1,320,5111,13,73,5197
subtest21of10,pubtest28of10,1,320,5111,15,110,5236
subtest210of10,pubtest28of10,1,320,5111,19,147,5277
subtest29of10,pubtest28of10,1,320,5111,19,186,5316
subtest23of10,pubtest28of10,1,320,5111,24,221,5356
subtest25of10,pubtest28of10,1,320,5111,24,262,5397
subtest26of10,pubtest28of10,1,320,5111,26,298,5435
subtest24of10,pubtest28of10,1,320,5111,27,337,5475
subtest22of10,pubtest28of10,1,320,5111,29,376,5516
subtest23of10,pubtest29of10,1,320,5156,5,44,5205
subtest210of10,pubtest29of10,1,320,5156,5,81,5242
subtest29of10,pubtest29of10,1,320,5156,9,116,5281
subtest25of10,pubtest29of10,1,320,5156,9,155,5320
subtest22of10,pubtest29of10,1,320,5156,19,186,5361
subtest21of10,pubtest29of10,1,320,5156,20,225,5401
subtest28of10,pubtest29of10,1,320,5156,21,264,5441
subtest27of10,pubtest29of10,1,320,5156,22,303,5481
subtest24of10,pubtest29of10,1,320,5156,23,342,5521
subtest26of10,pubtest29of10,1,320,5156,24,381,5561
subtest21of10,pubtest210of10,1,322,5362,10,40,5412
subtest29of10,pubtest210of10,1,322,5362,10,78,5450
subtest210of10,pubtest210of10,1,322,5362,13,115,5490
subtest28of10,pubtest210of10,1,322,5362,13,152,5527
subtest23of10,pubtest210of10,1,322,5362,17,192,5571
subtest26of10,pubtest210of10,1,322,5362,16,231,5609
subtest24of10,pubtest210of10,1,322,5362,15,271,5648
subtest22of10,pubtest210of10,1,322,5362,16,311,5689
subtest27of10,pubtest210of10,1,322,5362,14,351,5727
subtest25of10,pubtest210of10,1,322,5362,22,387,5771
subtest26of10,pubtest21of10,1,321,10481,10,40,10531
subtest27of10,pubtest21of10,1,321,10481,16,73,10570
subtest24of10,pubtest21of10,1,321,10481,17,112,10610
subtest29of10,pubtest21of10,1,321,10481,20,149,10650
subtest25of10,pubtest21of10,1,321,10481,22,187,10690
subtest210of10,pubtest21of10,1,321,10481,27,222,10730
subtest21of10,pubtest21of10,1,321,10481,28,261,10770
subtest28of10,pubtest21of10,1,321,10481,29,300,10810
subtest22of10,pubtest21of10,1,321,10481,33,336,10850
subtest23of10,pubtest21of10,1,321,10481,35,374,10890
subtest29of10,pubtest22of10,1,320,5422,-4,41,5459
subtest24of10,pubtest22of10,1,320,5422,-3,79,5498
subtest27of10,pubtest22of10,1,320,5422,3,112,5537
subtest28of10,pubtest22of10,1,320,5422,5,151,5578
subtest23of10,pubtest22of10,1,320,5422,7,189,5618
subtest26of10,pubtest22of10,1,320,5422,9,225,5656
subtest25of10,pubtest22of10,1,320,5422,10,265,5697
subtest21of10,pubtest22of10,1,320,5422,23,293,5738
subtest210of10,pubtest22of10,1,320,5422,23,333,5778
subtest22of10,pubtest22of10,1,320,5422,25,371,5818
subtest23of10,pubtest23of10,1,320,5502,18,39,5559
subtest28of10,pubtest23of10,1,320,5502,19,77,5598
subtest29of10,pubtest23of10,1,320,5502,26,111,5639
subtest24of10,pubtest23of10,1,320,5502,26,150,5678
subtest27of10,pubtest23of10,1,320,5502,30,186,5718
subtest26of10,pubtest23of10,1,320,5502,30,226,5758
subtest25of10,pubtest23of10,1,320,5502,37,259,5798
subtest22of10,pubtest23of10,1,320,5502,41,295,5838
subtest21of10,pubtest23of10,1,320,5502,41,335,5878
subtest210of10,pubtest23of10,1,320,5502,43,373,5918
subtest24of10,pubtest24of10,1,320,5843,-1,38,5880
subtest23of10,pubtest24of10,1,320,5843,-1,76,5918
subtest28of10,pubtest24of10,1,320,5843,5,112,5960
subtest25of10,pubtest24of10,1,320,5843,8,149,6000
subtest21of10,pubtest24of10,1,320,5843,25,171,6039
subtest22of10,pubtest24of10,1,320,5843,28,209,6080
subtest27of10,pubtest24of10,1,320,5843,30,247,6120
subtest26of10,pubtest24of10,1,320,5843,31,287,6161
subtest29of10,pubtest24of10,1,320,5843,29,325,6197
subtest210of10,pubtest24of10,1,320,5843,34,363,6240
subtest21of10,pubtest25of10,1,320,5990,4,39,6033
subtest28of10,pubtest25of10,1,320,5990,4,78,6072
subtest210of10,pubtest25of10,1,320,5990,11,112,6113
subtest27of10,pubtest25of10,1,320,5990,13,150,6153
subtest26of10,pubtest25of10,1,320,5990,16,187,6193
subtest22of10,pubtest25of10,1,320,5990,18,225,6233
subtest25of10,pubtest25of10,1,320,5990,22,261,6273
subtest23of10,pubtest25of10,1,320,5990,24,299,6313
subtest29of10,pubtest25of10,1,320,5990,27,336,6353
subtest24of10,pubtest25of10,1,320,5990,30,374,6394
subtest21of10,pubtest26of10,1,320,5406,-1,46,5451
subtest23of10,pubtest26of10,1,320,5406,5,79,5490
subtest210of10,pubtest26of10,1,320,5406,4,118,5528
subtest28of10,pubtest26of10,1,320,5406,7,157,5570
subtest29of10,pubtest26of10,1,320,5406,1,195,5602
subtest22of10,pubtest26of10,1,320,5406,-1,235,5640
subtest27of10,pubtest26of10,1,320,5406,9,275,5690
subtest25of10,pubtest26of10,1,320,5406,10,313,5729
subtest24of10,pubtest26of10,1,320,5406,9,353,5768
subtest26of10,pubtest26of10,1,320,5406,4,392,5802
subtest27of10,pubtest27of10,1,319,5951,5,41,5997
subtest28of10,pubtest27of10,1,319,5951,5,81,6037
subtest23of10,pubtest27of10,1,319,5951,7,117,6075
subtest210of10,pubtest27of10,1,319,5951,7,157,6115
subtest24of10,pubtest27of10,1,319,5951,7,196,6154
subtest29of10,pubtest27of10,1,319,5951,41,204,6196
subtest22of10,pubtest27of10,1,319,5951,43,242,6236
subtest26of10,pubtest27of10,1,319,5951,44,282,6277
subtest21of10,pubtest27of10,1,319,5951,63,302,6316
subtest25of10,pubtest27of10,1,319,5951,63,342,6356
subtest28of10,pubtest28of10,1,320,5488,-1,39,5526
subtest27of10,pubtest28of10,1,320,5488,-2,79,5565
subtest21of10,pubtest28of10,1,320,5488,2,115,5605
subtest29of10,pubtest28of10,1,320,5488,13,144,5645
subtest23of10,pubtest28of10,1,320,5488,16,182,5686
subtest25of10,pubtest28of10,1,320,5488,23,214,5725
subtest210of10,pubtest28of10,1,320,5488,25,252,5765
subtest26of10,pubtest28of10,1,320,5488,28,289,5805
subtest24of10,pubtest28of10,1,320,5488,29,329,5846
subtest22of10,pubtest28of10,1,320,5488,32,365,5885
subtest23of10,pubtest29of10,1,320,5713,-2,42,5753
subtest210of10,pubtest29of10,1,320,5713,1,77,5791
subtest29of10,pubtest29of10,1,320,5713,2,115,5830
subtest25of10,pubtest29of10,1,320,5713,7,150,5870
subtest22of10,pubtest29of10,1,320,5713,8,189,5910
subtest21of10,pubtest29of10,1,320,5713,9,228,5950
subtest27of10,pubtest29of10,1,320,5713,15,262,5990
subtest28of10,pubtest29of10,1,320,5713,15,302,6030
subtest24of10,pubtest29of10,1,320,5713,17,340,6070
subtest26of10,pubtest29of10,1,320,5713,17,380,6110
subtest29of10,pubtest210of10,1,322,5824,-1,39,5862
subtest21of10,pubtest210of10,1,322,5824,4,73,5901
subtest27of10,pubtest210of10,1,322,5824,7,110,5941
subtest210of10,pubtest210of10,1,322,5824,9,148,5981
subtest28of10,pubtest210of10,1,322,5824,13,184,6021
subtest24of10,pubtest210of10,1,322,5824,19,218,6061
subtest22of10,pubtest210of10,1,322,5824,21,256,6101
subtest26of10,pubtest210of10,1,322,5824,24,293,6141
subtest23of10,pubtest210of10,1,322,5824,26,331,6181
subtest25of10,pubtest210of10,1,322,5824,29,367,6220
subtest27of10,pubtest21of10,1,321,11354,-1,42,11395
subtest26of10,pubtest21of10,1,321,11354,-1,81,11434
subtest29of10,pubtest21of10,1,321,11354,5,115,11474
subtest25of10,pubtest21of10,1,321,11354,5,155,11514
subtest21of10,pubtest21of10,1,321,11354,7,193,11554
subtest24of10,pubtest21of10,1,321,11354,10,230,11594
subtest210of10,pubtest21of10,1,321,11354,16,264,11634
subtest28of10,pubtest21of10,1,321,11354,16,304,11674
subtest22of10,pubtest21of10,1,321,11354,19,341,11714
subtest23of10,pubtest21of10,1,321,11354,21,379,11754
subtest24of10,pubtest22of10,1,320,5266,-2,41,5305
subtest29of10,pubtest22of10,1,320,5266,-2,81,5345
subtest27of10,pubtest22of10,1,320,5266,2,117,5385
subtest28of10,pubtest22of10,1,320,5266,7,151,5424
subtest26of10,pubtest22of10,1,320,5266,10,188,5464
subtest23of10,pubtest22of10,1,320,5266,14,224,5504
subtest210of10,pubtest22of10,1,320,5266,16,262,5544
subtest25of10,pubtest22of10,1,320,5266,16,302,5584
subtest21of10,pubtest22of10,1,320,5266,18,340,5624
subtest22of10,pubtest22of10,1,320,5266,18,380,5664
subtest28of10,pubtest23of10,1,320,5133,-1,38,5170
subtest23of10,pubtest23of10,1,320,5133,7,70,5210
subtest29of10,pubtest23of10,1,320,5133,10,107,5250
subtest24of10,pubtest23of10,1,320,5133,16,141,5290
subtest27of10,pubtest23of10,1,320,5133,16,182,5331
subtest25of10,pubtest23of10,1,320,5133,21,216,5370
subtest26of10,pubtest23of10,1,320,5133,25,252,5410
subtest22of10,pubtest23of10,1,320,5133,27,290,5450
subtest21of10,pubtest23of10,1,320,5133,30,327,5490
subtest210of10,pubtest23of10,1,320,5133,34,363,5530
subtest24of10,pubtest24of10,1,320,5125,-1,40,5164
subtest23of10,pubtest24of10,1,320,5125,-2,80,5203
subtest25of10,pubtest24of10,1,320,5125,9,109,5243
subtest21of10,pubtest24of10,1,320,5125,9,148,5282
subtest28of10,pubtest24of10,1,320,5125,11,187,5323
subtest29of10,pubtest24of10,1,320,5125,13,224,5362
subtest22of10,pubtest24of10,1,320,5125,13,264,5402
subtest27of10,pubtest24of10,1,320,5125,15,304,5444
subtest26of10,pubtest24of10,1,320,5125,15,343,5483
subtest210of10,pubtest24of10,1,320,5125,15,382,5522
subtest28of10,pubtest25of10,1,320,5371,-4,40,5407
subtest21of10,pubtest25of10,1,320,5371,0,75,5446
subtest210of10,pubtest25of10,1,320,5371,0,115,5486
subtest26of10,pubtest25of10,1,320,5371,2,154,5527
subtest27of10,pubtest25of10,1,320,5371,2,193,5566
subtest24of10,pubtest25of10,1,320,5371,9,226,5606
subtest25of10,pubtest25of10,1,320,5371,9,267,5647
subtest29of10,pubtest25of10,1,320,5371,11,305,5687
subtest23of10,pubtest25of10,1,320,5371,11,344,5726
subtest22of10,pubtest25of10,1,320,5371,12,383,5766
subtest22of10,pubtest26of10,1,320,5436,-2,40,5474
subtest21of10,pubtest26of10,1,320,5436,-2,79,5513
subtest29of10,pubtest26of10,1,320,5436,8,109,5553
subtest23of10,pubtest26of10,1,320,5436,9,148,5593
subtest27of10,pubtest26of10,1,320,5436,10,187,5633
subtest26of10,pubtest26of10,1,320,5436,12,225,5673
subtest25of10,pubtest26of10,1,320,5436,13,265,5714
subtest210of10,pubtest26of10,1,320,5436,17,300,5753
subtest28of10,pubtest26of10,1,320,5436,18,338,5792
subtest24of10,pubtest26of10,1,320,5436,19,378,5833
subtest27of10,pubtest27of10,1,319,5177,-3,44,5218
subtest24of10,pubtest27of10,1,319,5177,0,82,5259
subtest28of10,pubtest27of10,1,319,5177,-1,120,5296
subtest23of10,pubtest27of10,1,319,5177,2,160,5339
subtest210of10,pubtest27of10,1,319,5177,4,197,5378
subtest25of10,pubtest27of10,1,319,5177,6,232,5415
subtest26of10,pubtest27of10,1,319,5177,8,272,5457
subtest22of10,pubtest27of10,1,319,5177,9,311,5497
subtest29of10,pubtest27of10,1,319,5177,6,351,5534
subtest21of10,pubtest27of10,1,319,5177,21,381,5579
subtest21of10,pubtest28of10,1,320,5180,1,196,5377
subtest29of10,pubtest28of10,1,320,5180,2,237,5419
subtest27of10,pubtest28of10,1,320,5180,0,278,5458
subtest28of10,pubtest28of10,1,320,5180,1,314,5495
subtest23of10,pubtest28of10,1,320,5180,16,342,5538
subtest210of10,pubtest28of10,1,320,5180,16,382,5578
subtest26of10,pubtest28of10,1,320,5180,18,420,5618
subtest25of10,pubtest28of10,1,320,5180,22,456,5658
subtest24of10,pubtest28of10,1,320,5180,23,495,5698
subtest22of10,pubtest28of10,1,320,5180,30,528,5738
subtest23of10,pubtest29of10,1,320,5364,-1,40,5403
subtest210of10,pubtest29of10,1,320,5364,4,73,5441
subtest29of10,pubtest29of10,1,320,5364,5,113,5482
subtest25of10,pubtest29of10,1,320,5364,6,152,5522
subtest22of10,pubtest29of10,1,320,5364,7,191,5562
subtest28of10,pubtest29of10,1,320,5364,8,231,5603
subtest21of10,pubtest29of10,1,320,5364,10,264,5638
subtest27of10,pubtest29of10,1,320,5364,11,304,5679
subtest24of10,pubtest29of10,1,320,5364,15,344,5723
subtest26of10,pubtest29of10,1,320,5364,17,381,5762
subtest29of10,pubtest210of10,1,322,5914,-3,42,5953
subtest27of10,pubtest210of10,1,322,5914,3,74,5991
subtest21of10,pubtest210of10,1,322,5914,3,113,6030
subtest210of10,pubtest210of10,1,322,5914,13,145,6072
subtest24of10,pubtest210of10,1,322,5914,14,183,6111
subtest28of10,pubtest210of10,1,322,5914,14,223,6151
subtest23of10,pubtest210of10,1,322,5914,16,262,6192
subtest22of10,pubtest210of10,1,322,5914,17,301,6232
subtest25of10,pubtest210of10,1,322,5914,19,339,6272
subtest26of10,pubtest210of10,1,322,5914,28,370,6312
subtest26of10,pubtest21of10,1,321,11800,-3,46,11843
subtest27of10,pubtest21of10,1,321,11800,-1,83,11882
subtest29of10,pubtest21of10,1,321,11800,1,121,11922
subtest24of10,pubtest21of10,1,321,11800,3,159,11962
subtest25of10,pubtest21of10,1,321,11800,28,174,12002
subtest21of10,pubtest21of10,1,321,11800,29,213,12042
subtest28of10,pubtest21of10,1,321,11800,30,249,12079
subtest23of10,pubtest21of10,1,321,11800,33,289,12122
subtest210of10,pubtest21of10,1,321,11800,29,328,12157
subtest22of10,pubtest21of10,1,321,11800,35,367,12202
subtest29of10,pubtest22of10,1,320,5521,4,46,5571
subtest27of10,pubtest22of10,1,320,5521,5,84,5610
subtest24of10,pubtest22of10,1,320,5521,7,122,5650
subtest28of10,pubtest22of10,1,320,5521,9,160,5690
subtest26of10,pubtest22of10,1,320,5521,12,197,5730
subtest23of10,pubtest22of10,1,320,5521,13,236,5770
subtest25of10,pubtest22of10,1,320,5521,14,275,5810
subtest21of10,pubtest22of10,1,320,5521,18,311,5850
subtest210of10,pubtest22of10,1,320,5521,26,343,5890
subtest22of10,pubtest22of10,1,320,5521,46,363,5930
subtest23of10,pubtest23of10,1,320,5167,0,44,5211
subtest28of10,pubtest23of10,1,320,5167,1,81,5249
subtest29of10,pubtest23of10,1,320,5167,4,118,5289
subtest24of10,pubtest23of10,1,320,5167,5,157,5329
subtest27of10,pubtest23of10,1,320,5167,8,194,5369
subtest25of10,pubtest23of10,1,320,5167,8,234,5409
subtest26of10,pubtest23of10,1,320,5167,10,272,5449
subtest22of10,pubtest23of10,1,320,5167,17,304,5488
subtest21of10,pubtest23of10,1,320,5167,19,343,5529
subtest210of10,pubtest23of10,1,320,5167,21,381,5569
subtest23of10,pubtest24of10,1,320,5121,1,45,5167
subtest28of10,pubtest24of10,1,320,5121,3,83,5207
subtest21of10,pubtest24of10,1,320,5121,5,121,5247
subtest22of10,pubtest24of10,1,320,5121,5,161,5287
subtest24of10,pubtest24of10,1,320,5121,2,200,5323
subtest25of10,pubtest24of10,1,320,5121,4,242,5367
subtest210of10,pubtest24of10,1,320,5121,7,279,5407
subtest29of10,pubtest24of10,1,320,5121,9,317,5447
subtest27of10,pubtest24of10,1,320,5121,12,354,5487
subtest26of10,pubtest24of10,1,320,5121,14,392,5527
subtest28of10,pubtest25of10,1,320,5169,0,42,5211
subtest21of10,pubtest25of10,1,320,5169,0,80,5249
subtest210of10,pubtest25of10,1,320,5169,2,118,5289
subtest27of10,pubtest25of10,1,320,5169,3,158,5330
subtest26of10,pubtest25of10,1,320,5169,6,195,5370
subtest22of10,pubtest25of10,1,320,5169,11,230,5410
subtest23of10,pubtest25of10,1,320,5169,13,266,5448
subtest24of10,pubtest25of10,1,320,5169,15,306,5490
subtest25of10,pubtest25of10,1,320,5169,13,345,5527
subtest29of10,pubtest25of10,1,320,5169,17,383,5569
subtest21of10,pubtest26of10,1,320,5261,0,38,5299
subtest22of10,pubtest26of10,1,320,5261,0,77,5338
subtest29of10,pubtest26of10,1,320,5261,5,112,5378
subtest23of10,pubtest26of10,1,320,5261,6,151,5418
subtest26of10,pubtest26of10,1,320,5261,10,187,5458
subtest210of10,pubtest26of10,1,320,5261,12,225,5498
subtest28of10,pubtest26of10,1,320,5261,13,265,5539
subtest27of10,pubtest26of10,1,320,5261,17,300,5578
subtest24of10,pubtest26of10,1,320,5261,17,340,5618
subtest25of10,pubtest26of10,1,320,5261,19,378,5658
subtest27of10,pubtest27of10,1,319,5170,5,39,5214
subtest23of10,pubtest27of10,1,319,5170,5,78,5253
subtest29of10,pubtest27of10,1,319,5170,8,115,5293
subtest25of10,pubtest27of10,1,319,5170,20,144,5334
subtest21of10,pubtest27of10,1,319,5170,21,183,5374
subtest28of10,pubtest27of10,1,319,5170,27,217,5414
subtest24of10,pubtest27of10,1,319,5170,28,254,5452
subtest210of10,pubtest27of10,1,319,5170,30,293,5493
subtest22of10,pubtest27of10,1,319,5170,32,332,5534
subtest26of10,pubtest27of10,1,319,5170,39,365,5574
subtest27of10,pubtest28of10,1,320,5101,7,41,5149
subtest28of10,pubtest28of10,1,320,5101,8,80,5189
subtest21of10,pubtest28of10,1,320,5101,14,114,5229
subtest29of10,pubtest28of10,1,320,5101,16,152,5269
subtest210of10,pubtest28of10,1,320,5101,17,191,5309
subtest23of10,pubtest28of10,1,320,5101,18,229,5348
subtest26of10,pubtest28of10,1,320,5101,24,264,5389
subtest25of10,pubtest28of10,1,320,5101,24,304,5429
subtest22of10,pubtest28of10,1,320,5101,25,342,5468
subtest24of10,pubtest28of10,1,320,5101,25,382,5508
subtest23of10,pubtest29of10,1,320,5139,0,49,5188
subtest210of10,pubtest29of10,1,320,5139,1,88,5228
subtest29of10,pubtest29of10,1,320,5139,9,120,5268
subtest22of10,pubtest29of10,1,320,5139,10,157,5306
subtest28of10,pubtest29of10,1,320,5139,14,194,5347
subtest25of10,pubtest29of10,1,320,5139,14,234,5387
subtest21of10,pubtest29of10,1,320,5139,18,270,5427
subtest27of10,pubtest29of10,1,320,5139,18,310,5467
subtest24of10,pubtest29of10,1,320,5139,17,349,5505
subtest26of10,pubtest29of10,1,320,5139,25,383,5547
subtest21of10,pubtest210of10,1,322,5225,-4,198,5419
subtest29of10,pubtest210of10,1,322,5225,-5,237,5457
subtest210of10,pubtest210of10,1,322,5225,2,270,5497
subtest27of10,pubtest210of10,1,322,5225,6,306,5537
subtest28of10,pubtest210of10,1,322,5225,7,344,5576
subtest24of10,pubtest210of10,1,322,5225,8,384,5617
subtest23of10,pubtest210of10,1,322,5225,9,423,5657
subtest25of10,pubtest210of10,1,322,5225,16,456,5697
subtest26of10,pubtest210of10,1,322,5225,17,495,5737
subtest22of10,pubtest210of10,1,322,5225,17,535,5777
subtest26of10,pubtest21of10,1,321,10327,-2,42,10367
subtest27of10,pubtest21of10,1,321,10327,-2,81,10406
subtest29of10,pubtest21of10,1,321,10327,0,120,10447
subtest24of10,pubtest21of10,1,321,10327,10,150,10487
subtest25of10,pubtest21of10,1,321,10327,15,184,10526
subtest210of10,pubtest21of10,1,321,10327,22,217,10566
subtest28of10,pubtest21of10,1,321,10327,23,257,10607
subtest22of10,pubtest21of10,1,321,10327,24,296,10647
subtest21of10,pubtest21of10,1,321,10327,24,336,10687
subtest23of10,pubtest21of10,1,321,10327,26,374,10727
subtest29of10,pubtest22of10,1,320,5136,1,39,5176
subtest24of10,pubtest22of10,1,320,5136,5,75,5216
subtest26of10,pubtest22of10,1,320,5136,26,94,5256
subtest27of10,pubtest22of10,1,320,5136,25,133,5294
subtest28of10,pubtest22of10,1,320,5136,27,172,5335
subtest23of10,pubtest22of10,1,320,5136,28,212,5376
subtest25of10,pubtest22of10,1,320,5136,32,247,5415
subtest210of10,pubtest22of10,1,320,5136,46,273,5455
subtest21of10,pubtest22of10,1,320,5136,46,314,5496
subtest22of10,pubtest22of10,1,320,5136,48,351,5535
subtest23of10,pubtest23of10,1,320,5338,-2,46,5382
subtest28of10,pubtest23of10,1,320,5338,0,83,5421
subtest29of10,pubtest23of10,1,320,5338,4,118,5460
subtest24of10,pubtest23of10,1,320,5338,2,157,5497
subtest27of10,pubtest23of10,1,320,5338,7,195,5540
subtest26of10,pubtest23of10,1,320,5338,10,232,5580
subtest25of10,pubtest23of10,1,320,5338,15,267,5620
subtest22of10,pubtest23of10,1,320,5338,20,301,5659
subtest21of10,pubtest23of10,1,320,5338,21,341,5700
subtest210of10,pubtest23of10,1,320,5338,22,379,5739
subtest23of10,pubtest24of10,1,320,6081,1,45,6127
subtest24of10,pubtest24of10,1,320,6081,1,85,6167
subtest21of10,pubtest24of10,1,320,6081,3,121,6205
subtest28of10,pubtest24of10,1,320,6081,5,160,6246
subtest29of10,pubtest24of10,1,320,6081,5,200,6286
subtest25of10,pubtest24of10,1,320,6081,7,238,6326
subtest27of10,pubtest24of10,1,320,6081,12,273,6366
subtest22of10,pubtest24of10,1,320,6081,14,311,6406
subtest210of10,pubtest24of10,1,320,6081,16,349,6446
subtest26of10,pubtest24of10,1,320,6081,17,388,6486
subtest28of10,pubtest25of10,1,320,5484,-2,138,5620
subtest26of10,pubtest25of10,1,320,5484,1,173,5658
subtest21of10,pubtest25of10,1,320,5484,2,213,5699
subtest27of10,pubtest25of10,1,320,5484,4,250,5738
subtest210of10,pubtest25of10,1,320,5484,3,290,5777
subtest22of10,pubtest25of10,1,320,5484,13,321,5818
subtest23of10,pubtest25of10,1,320,5484,14,360,5858
subtest25of10,pubtest25of10,1,320,5484,14,400,5898
subtest29of10,pubtest25of10,1,320,5484,16,438,5938
subtest24of10,pubtest25of10,1,320,5484,22,472,5978
subtest21of10,pubtest26of10,1,320,5147,-1,38,5184
subtest22of10,pubtest26of10,1,320,5147,0,77,5224
subtest24of10,pubtest26of10,1,320,5147,17,116,5280
subtest25of10,pubtest26of10,1,320,5147,17,155,5319
subtest28of10,pubtest26of10,1,320,5147,16,194,5357
subtest29of10,pubtest26of10,1,320,5147,3,234,5384
subtest26of10,pubtest26of10,1,320,5147,5,273,5425
subtest23of10,pubtest26of10,1,320,5147,5,313,5465
subtest27of10,pubtest26of10,1,320,5147,15,352,5514
subtest210of10,pubtest26of10,1,320,5147,12,390,5549
subtest27of10,pubtest27of10,1,319,5246,-1,49,5294
subtest24of10,pubtest27of10,1,319,5246,2,85,5333
subtest28of10,pubtest27of10,1,319,5246,-1,129,5374
subtest23of10,pubtest27of10,1,319,5246,1,166,5413
subtest29of10,pubtest27of10,1,319,5246,4,202,5452
subtest210of10,pubtest27of10,1,319,5246,6,240,5492
subtest25of10,pubtest27of10,1,319,5246,15,272,5533
subtest22of10,pubtest27of10,1,319,5246,15,312,5573
subtest21of10,pubtest27of10,1,319,5246,17,351,5614
subtest26of10,pubtest27of10,1,319,5246,18,389,5653
subtest27of10,pubtest28of10,1,320,5165,-2,41,5204
subtest28of10,pubtest28of10,1,320,5165,-2,81,5244
subtest21of10,pubtest28of10,1,320,5165,0,119,5284
subtest29of10,pubtest28of10,1,320,5165,3,156,5324
subtest210of10,pubtest28of10,1,320,5165,10,190,5365
subtest23of10,pubtest28of10,1,320,5165,16,223,5404
subtest25of10,pubtest28of10,1,320,5165,16,264,5445
subtest26of10,pubtest28of10,1,320,5165,18,301,5484
subtest24of10,pubtest28of10,1,320,5165,21,338,5524
subtest22of10,pubtest28of10,1,320,5165,21,378,5564
subtest23of10,pubtest29of10,1,320,5556,13,42,5611
subtest29of10,pubtest29of10,1,320,5556,19,76,5651
subtest210of10,pubtest29of10,1,320,5556,27,107,5690
subtest25of10,pubtest29of10,1,320,5556,28,146,5730
subtest22of10,pubtest29of10,1,320,5556,37,177,5770
subtest28of10,pubtest29of10,1,320,5556,43,212,5811
subtest21of10,pubtest29of10,1,320,5556,48,247,5851
subtest27of10,pubtest29of10,1,320,5556,88,246,5890
subtest24of10,pubtest29of10,1,320,5556,92,282,5930
subtest26of10,pubtest29of10,1,320,5556,111,303,5970
subtest29of10,pubtest210of10,1,322,6160,4,41,6205
subtest21of10,pubtest210of10,1,322,6160,4,81,6245
subtest210of10,pubtest210of10,1,322,6160,6,118,6284
subtest27of10,pubtest210of10,1,322,6160,7,158,6325
subtest28of10,pubtest210of10,1,322,6160,17,187,6364
subtest22of10,pubtest210of10,1,322,6160,19,226,6405
subtest24of10,pubtest210of10,1,322,6160,18,266,6444
subtest23of10,pubtest210of10,1,322,6160,27,297,6484
subtest26of10,pubtest210of10,1,322,6160,30,333,6523
subtest25of10,pubtest210of10,1,322,6160,32,371,6563
subtest27of10,pubtest21of10,1,321,12247,-1,40,12286
subtest26of10,pubtest21of10,1,321,12247,-2,79,12324
subtest29of10,pubtest21of10,1,321,12247,0,117,12364
subtest24of10,pubtest21of10,1,321,12247,4,154,12405
subtest25of10,pubtest21of10,1,321,12247,5,193,12445
subtest21of10,pubtest21of10,1,321,12247,12,226,12485
subtest28of10,pubtest21of10,1,321,12247,13,264,12524
subtest210of10,pubtest21of10,1,321,12247,13,304,12564
subtest22of10,pubtest21of10,1,321,12247,18,340,12605
subtest23of10,pubtest21of10,1,321,12247,20,377,12644
subtest29of10,pubtest22of10,1,320,5182,4,41,5227
subtest24of10,pubtest22of10,1,320,5182,6,78,5266
subtest27of10,pubtest22of10,1,320,5182,10,113,5305
subtest28of10,pubtest22of10,1,320,5182,10,152,5344
subtest23of10,pubtest22of10,1,320,5182,13,191,5386
subtest26of10,pubtest22of10,1,320,5182,15,355,5552
subtest25of10,pubtest22of10,1,320,5182,17,391,5590
subtest21of10,pubtest22of10,1,320,5182,17,431,5630
subtest210of10,pubtest22of10,1,320,5182,19,469,5670
subtest22of10,pubtest22of10,1,320,5182,22,506,5710
subtest23of10,pubtest23of10,1,320,5236,3,42,5281
subtest29of10,pubtest23of10,1,320,5236,4,82,5322
subtest28of10,pubtest23of10,1,320,5236,3,120,5359
subtest24of10,pubtest23of10,1,320,5236,13,152,5401
subtest27of10,pubtest23of10,1,320,5236,12,192,5440
subtest25of10,pubtest23of10,1,320,5236,14,231,5481
subtest26of10,pubtest23of10,1,320,5236,14,270,5520
subtest21of10,pubtest23of10,1,320,5236,18,307,5561
subtest22of10,pubtest23of10,1,320,5236,17,348,5601
subtest210of10,pubtest23of10,1,320,5236,21,385,5642
subtest23of10,pubtest24of10,1,320,5322,-1,44,5365
subtest24of10,pubtest24of10,1,320,5322,-1,83,5404
subtest28of10,pubtest24of10,1,320,5322,1,121,5444
subtest25of10,pubtest24of10,1,320,5322,2,160,5484
subtest21of10,pubtest24of10,1,320,5322,16,186,5524
subtest22of10,pubtest24of10,1,320,5322,24,218,5564
subtest29of10,pubtest24of10,1,320,5322,25,257,5604
subtest27of10,pubtest24of10,1,320,5322,34,288,5644
subtest210of10,pubtest24of10,1,320,5322,34,328,5684
subtest26of10,pubtest24of10,1,320,5322,41,361,5724
subtest21of10,pubtest25of10,1,320,5393,-2,42,5433
subtest25of10,pubtest25of10,1,320,5393,0,79,5472
subtest29of10,pubtest25of10,1,320,5393,1,118,5512
subtest27of10,pubtest25of10,1,320,5393,-1,157,5549
subtest23of10,pubtest25of10,1,320,5393,3,196,5592
subtest28of10,pubtest25of10,1,320,5393,3,235,5631
subtest210of10,pubtest25of10,1,320,5393,16,263,5672
subtest22of10,pubtest25of10,1,320,5393,19,300,5712
subtest26of10,pubtest25of10,1,320,5393,19,340,5752
subtest24of10,pubtest25of10,1,320,5393,22,377,5792
subtest21of10,pubtest26of10,1,320,5980,-2,388,6366
subtest22of10,pubtest26of10,1,320,5980,-1,424,6403
subtest29of10,pubtest26of10,1,320,5980,0,462,6442
subtest23of10,pubtest26of10,1,320,5980,29,474,6483
subtest210of10,pubtest26of10,1,320,5980,30,513,6523
subtest27of10,pubtest26of10,1,320,5980,31,552,6563
subtest25of10,pubtest26of10,1,320,5980,32,591,6603
subtest28of10,pubtest26of10,1,320,5980,33,630,6643
subtest24of10,pubtest26of10,1,320,5980,34,669,6683
subtest26of10,pubtest26of10,1,320,5980,29,709,6718
subtest23of10,pubtest27of10,1,319,5439,0,41,5480
subtest27of10,pubtest27of10,1,319,5439,0,80,5519
subtest28of10,pubtest27of10,1,319,5439,0,118,5557
subtest24of10,pubtest27of10,1,319,5439,2,158,5599
subtest29of10,pubtest27of10,1,319,5439,4,191,5634
subtest210of10,pubtest27of10,1,319,5439,4,231,5674
subtest21of10,pubtest27of10,1,319,5439,11,268,5718
subtest22of10,pubtest27of10,1,319,5439,13,307,5759
subtest25of10,pubtest27of10,1,319,5439,15,345,5799
subtest26of10,pubtest27of10,1,319,5439,20,380,5839
subtest27of10,pubtest28of10,1,320,5216,-2,45,5259
subtest21of10,pubtest28of10,1,320,5216,1,82,5299
subtest28of10,pubtest28of10,1,320,5216,2,120,5338
subtest29of10,pubtest28of10,1,320,5216,4,158,5378
subtest210of10,pubtest28of10,1,320,5216,9,193,5418
subtest23of10,pubtest28of10,1,320,5216,20,222,5458
subtest26of10,pubtest28of10,1,320,5216,21,260,5497
subtest25of10,pubtest28of10,1,320,5216,22,299,5537
subtest24of10,pubtest28of10,1,320,5216,25,337,5578
subtest22of10,pubtest28of10,1,320,5216,26,376,5618
subtest23of10,pubtest29of10,1,320,5677,2,40,5719
subtest210of10,pubtest29of10,1,320,5677,4,78,5759
subtest22of10,pubtest29of10,1,320,5677,12,109,5798
subtest29of10,pubtest29of10,1,320,5677,13,148,5838
subtest28of10,pubtest29of10,1,320,5677,15,186,5878
subtest25of10,pubtest29of10,1,320,5677,40,201,5918
subtest24of10,pubtest29of10,1,320,5677,43,238,5958
subtest21of10,pubtest29of10,1,320,5677,46,275,5998
subtest27of10,pubtest29of10,1,320,5677,46,315,6038
subtest26of10,pubtest29of10,1,320,5677,50,351,6078
subtest29of10,pubtest210of10,1,322,8357,-4,41,8394
subtest21of10,pubtest210of10,1,322,8357,-1,77,8433
subtest210of10,pubtest210of10,1,322,8357,8,108,8473
subtest27of10,pubtest210of10,1,322,8357,9,147,8513
subtest23of10,pubtest210of10,1,322,8357,13,183,8553
subtest28of10,pubtest210of10,1,322,8357,13,223,8593
subtest25of10,pubtest210of10,1,322,8357,16,261,8634
subtest24of10,pubtest210of10,1,322,8357,15,301,8673
subtest26of10,pubtest210of10,1,322,8357,17,337,8711
subtest22of10,pubtest210of10,1,322,8357,19,376,8752
subtest26of10,pubtest21of10,1,321,13491,-3,38,13526
subtest27of10,pubtest21of10,1,321,13491,-1,75,13565
subtest24of10,pubtest21of10,1,321,13491,-1,115,13605
subtest29of10,pubtest21of10,1,321,13491,6,148,13645
subtest25of10,pubtest21of10,1,321,13491,8,186,13685
subtest21of10,pubtest21of10,1,321,13491,12,222,13725
subtest210of10,pubtest21of10,1,321,13491,12,262,13765
subtest28of10,pubtest21of10,1,321,13491,17,297,13805
subtest23of10,pubtest21of10,1,321,13491,17,337,13845
subtest22of10,pubtest21of10,1,321,13491,19,375,13885
subtest29of10,pubtest22of10,1,320,5307,-3,39,5343
subtest24of10,pubtest22of10,1,320,5307,-1,75,5381
subtest27of10,pubtest22of10,1,320,5307,-1,114,5420
subtest28of10,pubtest22of10,1,320,5307,3,152,5462
subtest26of10,pubtest22of10,1,320,5307,29,166,5502
subtest23of10,pubtest22of10,1,320,5307,29,205,5541
subtest25of10,pubtest22of10,1,320,5307,33,242,5582
subtest21of10,pubtest22of10,1,320,5307,34,281,5622
subtest210of10,pubtest22of10,1,320,5307,33,322,5662
subtest22of10,pubtest22of10,1,320,5307,36,359,5702
subtest28of10,pubtest23of10,1,320,5555,3,41,5599
subtest29of10,pubtest23of10,1,320,5555,4,82,5641
subtest23of10,pubtest23of10,1,320,5555,3,120,5678
subtest24of10,pubtest23of10,1,320,5555,14,150,5719
subtest27of10,pubtest23of10,1,320,5555,15,189,5759
subtest26of10,pubtest23of10,1,320,5555,21,223,5799
subtest25of10,pubtest23of10,1,320,5555,21,263,5839
subtest21of10,pubtest23of10,1,320,5555,21,302,5878
subtest22of10,pubtest23of10,1,320,5555,27,337,5919
subtest210of10,pubtest23of10,1,320,5555,28,375,5958
subtest23of10,pubtest24of10,1,320,5600,-1,42,5641
subtest24of10,pubtest24of10,1,320,5600,0,80,5680
subtest25of10,pubtest24of10,1,320,5600,3,116,5719
subtest28of10,pubtest24of10,1,320,5600,5,154,5759
subtest21of10,pubtest24of10,1,320,5600,6,194,5800
subtest22of10,pubtest24of10,1,320,5600,7,233,5840
subtest210of10,pubtest24of10,1,320,5600,8,271,5879
subtest29of10,pubtest24of10,1,320,5600,8,311,5919
subtest26of10,pubtest24of10,1,320,5600,45,314,5959
subtest27of10,pubtest24of10,1,320,5600,45,354,5999
subtest28of10,pubtest25of10,1,320,5887,-3,39,5923
subtest21of10,pubtest25of10,1,320,5887,0,76,5963
subtest210of10,pubtest25of10,1,320,5887,2,114,6003
subtest27of10,pubtest25of10,1,320,5887,6,151,6044
subtest25of10,pubtest25of10,1,320,5887,15,180,6082
subtest26of10,pubtest25of10,1,320,5887,20,216,6123
subtest22of10,pubtest25of10,1,320,5887,21,255,6163
subtest23of10,pubtest25of10,1,320,5887,20,294,6201
subtest24of10,pubtest25of10,1,320,5887,22,333,6242
subtest29of10,pubtest25of10,1,320,5887,22,373,6282
subtest22of10,pubtest26of10,1,320,5551,-3,41,5589
subtest21of10,pubtest26of10,1,320,5551,-3,80,5628
subtest29of10,pubtest26of10,1,320,5551,-1,117,5667
subtest26of10,pubtest26of10,1,320,5551,0,158,5709
subtest23of10,pubtest26of10,1,320,5551,0,196,5747
subtest27of10,pubtest26of10,1,320,5551,2,235,5788
subtest210of10,pubtest26of10,1,320,5551,3,275,5829
subtest25of10,pubtest26of10,1,320,5551,4,313,5868
subtest28of10,pubtest26of10,1,320,5551,5,351,5907
subtest24of10,pubtest26of10,1,320,5551,11,386,5948
subtest27of10,pubtest27of10,1,319,5095,-2,41,5134
subtest28of10,pubtest27of10,1,319,5095,-1,80,5174
subtest23of10,pubtest27of10,1,319,5095,1,118,5214
subtest24of10,pubtest27of10,1,319,5095,3,155,5253
subtest29of10,pubtest27of10,1,319,5095,19,179,5293
subtest25of10,pubtest27of10,1,319,5095,21,218,5334
subtest22of10,pubtest27of10,1,319,5095,21,256,5372
subtest21of10,pubtest27of10,1,319,5095,22,295,5412
subtest210of10,pubtest27of10,1,319,5095,20,335,5450
subtest26of10,pubtest27of10,1,319,5095,24,374,5493
subtest27of10,pubtest28of10,1,320,5232,1,40,5273
subtest28of10,pubtest28of10,1,320,5232,2,78,5312
subtest21of10,pubtest28of10,1,320,5232,5,115,5352
subtest210of10,pubtest28of10,1,320,5232,4,153,5389
subtest29of10,pubtest28of10,1,320,5232,4,193,5429
subtest23of10,pubtest28of10,1,320,5232,9,231,5472
subtest25of10,pubtest28of10,1,320,5232,12,268,5512
subtest26of10,pubtest28of10,1,320,5232,12,308,5552
subtest24of10,pubtest28of10,1,320,5232,15,345,5592
subtest22of10,pubtest28of10,1,320,5232,15,386,5633
subtest23of10,pubtest29of10,1,320,5306,-2,42,5346
subtest210of10,pubtest29of10,1,320,5306,-1,79,5384
subtest29of10,pubtest29of10,1,320,5306,4,114,5424
subtest25of10,pubtest29of10,1,320,5306,4,155,5465
subtest22of10,pubtest29of10,1,320,5306,6,192,5504
subtest21of10,pubtest29of10,1,320,5306,11,229,5546
subtest27of10,pubtest29of10,1,320,5306,12,267,5585
subtest24of10,pubtest29of10,1,320,5306,16,302,5624
subtest28of10,pubtest29of10,1,320,5306,16,342,5664
subtest26of10,pubtest29of10,1,320,5306,20,378,5704
subtest21of10,pubtest210of10,1,322,5202,-2,42,5242
subtest29of10,pubtest210of10,1,322,5202,-2,81,5281
subtest27of10,pubtest210of10,1,322,5202,0,119,5321
subtest210of10,pubtest210of10,1,322,5202,1,158,5361
subtest28of10,pubtest210of10,1,322,5202,2,197,5401
subtest24of10,pubtest210of10,1,322,5202,5,234,5441
subtest23of10,pubtest210of10,1,322,5202,6,273,5481
subtest22of10,pubtest210of10,1,322,5202,7,313,5522
subtest25of10,pubtest210of10,1,322,5202,11,347,5560
subtest26of10,pubtest210of10,1,322,5202,13,386,5601
subtest27of10,pubtest21of10,1,321,10571,3,42,10616
subtest26of10,pubtest21of10,1,321,10571,4,79,10654
subtest24of10,pubtest21of10,1,321,10571,5,119,10695
subtest25of10,pubtest21of10,1,321,10571,10,154,10735
subtest21of10,pubtest21of10,1,321,10571,11,193,10775
subtest29of10,pubtest21of10,1,321,10571,10,232,10813
subtest210of10,pubtest21of10,1,321,10571,13,271,10855
subtest22of10,pubtest21of10,1,321,10571,17,307,10895
subtest28of10,pubtest21of10,1,321,10571,17,347,10935
subtest23of10,pubtest21of10,1,321,10571,19,385,10975
subtest29of10,pubtest22of10,1,320,5131,-5,41,5167
subtest24of10,pubtest22of10,1,320,5131,-5,80,5206
subtest27of10,pubtest22of10,1,320,5131,-1,116,5246
subtest23of10,pubtest22of10,1,320,5131,0,154,5285
subtest28of10,pubtest22of10,1,320,5131,2,193,5326
subtest25of10,pubtest22of10,1,320,5131,3,231,5365
subtest21of10,pubtest22of10,1,320,5131,8,267,5406
subtest26of10,pubtest22of10,1,320,5131,10,305,5446
subtest210of10,pubtest22of10,1,320,5131,14,341,5486
subtest22of10,pubtest22of10,1,320,5131,16,379,5526
subtest23of10,pubtest23of10,1,320,5629,-2,39,5666
subtest28of10,pubtest23of10,1,320,5629,6,70,5705
subtest24of10,pubtest23of10,1,320,5629,8,109,5746
subtest27of10,pubtest23of10,1,320,5629,9,148,5786
subtest29of10,pubtest23of10,1,320,5629,7,188,5824
subtest25of10,pubtest23of10,1,320,5629,10,227,5866
subtest26of10,pubtest23of10,1,320,5629,20,257,5906
subtest22of10,pubtest23of10,1,320,5629,21,296,5946
subtest210of10,pubtest23of10,1,320,5629,22,334,5985
subtest21of10,pubtest23of10,1,320,5629,22,374,6025
subtest23of10,pubtest24of10,1,320,5283,-2,40,5321
subtest24of10,pubtest24of10,1,320,5283,-1,78,5360
subtest21of10,pubtest24of10,1,320,5283,3,115,5401
subtest22of10,pubtest24of10,1,320,5283,3,154,5440
subtest28of10,pubtest24of10,1,320,5283,5,192,5480
subtest27of10,pubtest24of10,1,320,5283,5,232,5520
subtest25of10,pubtest24of10,1,320,5283,1,271,5555
subtest29of10,pubtest24of10,1,320,5283,7,310,5600
subtest210of10,pubtest24of10,1,320,5283,9,347,5639
subtest26of10,pubtest24of10,1,320,5283,11,386,5680
subtest28of10,pubtest25of10,1,320,5923,1,42,5966
subtest21of10,pubtest25of10,1,320,5923,3,78,6004
subtest26of10,pubtest25of10,1,320,5923,4,118,6045
subtest25of10,pubtest25of10,1,320,5923,5,157,6085
subtest210of10,pubtest25of10,1,320,5923,1,201,6125
subtest27of10,pubtest25of10,1,320,5923,5,236,6164
subtest24of10,pubtest25of10,1,320,5923,7,275,6205
subtest22of10,pubtest25of10,1,320,5923,5,314,6242
subtest29of10,pubtest25of10,1,320,5923,8,354,6285
subtest23of10,pubtest25of10,1,320,5923,10,390,6323
subtest22of10,pubtest26of10,1,320,5852,-1,39,5890
subtest21of10,pubtest26of10,1,320,5852,8,69,5929
subtest29of10,pubtest26of10,1,320,5852,8,109,5969
subtest23of10,pubtest26of10,1,320,5852,26,131,6009
subtest26of10,pubtest26of10,1,320,5852,26,171,6049
subtest27of10,pubtest26of10,1,320,5852,28,209,6089
subtest210of10,pubtest26of10,1,320,5852,28,249,6129
subtest28of10,pubtest26of10,1,320,5852,30,287,6169
subtest24of10,pubtest26of10,1,320,5852,33,324,6209
subtest25of10,pubtest26of10,1,320,5852,33,364,6249
subtest27of10,pubtest27of10,1,319,5827,-3,39,5863
subtest28of10,pubtest27of10,1,319,5827,2,73,5902
subtest24of10,pubtest27of10,1,319,5827,5,110,5942
subtest23of10,pubtest27of10,1,319,5827,6,149,5982
subtest29of10,pubtest27of10,1,319,5827,16,179,6022
subtest25of10,pubtest27of10,1,319,5827,20,215,6062
subtest210of10,pubtest27of10,1,319,5827,20,255,6102
subtest22of10,pubtest27of10,1,319,5827,23,292,6142
subtest21of10,pubtest27of10,1,319,5827,23,332,6182
subtest26of10,pubtest27of10,1,319,5827,25,370,6222
subtest27of10,pubtest28of10,1,320,5579,-2,39,5616
subtest21of10,pubtest28of10,1,320,5579,-1,78,5656
subtest28of10,pubtest28of10,1,320,5579,1,117,5697
subtest29of10,pubtest28of10,1,320,5579,5,151,5735
subtest23of10,pubtest28of10,1,320,5579,7,189,5775
subtest210of10,pubtest28of10,1,320,5579,8,230,5817
subtest25of10,pubtest28of10,1,320,5579,10,267,5856
subtest26of10,pubtest28of10,1,320,5579,12,303,5894
subtest24of10,pubtest28of10,1,320,5579,12,343,5934
subtest22of10,pubtest28of10,1,320,5579,15,381,5975
subtest23of10,pubtest29of10,1,320,6093,-2,41,6132
subtest29of10,pubtest29of10,1,320,6093,1,77,6171
subtest210of10,pubtest29of10,1,320,6093,1,117,6211
subtest25of10,pubtest29of10,1,320,6093,4,154,6251
subtest22of10,pubtest29of10,1,320,6093,4,194,6291
subtest28of10,pubtest29of10,1,320,6093,9,230,6332
subtest21of10,pubtest29of10,1,320,6093,9,385,6487
subtest27of10,pubtest29of10,1,320,6093,11,420,6524
subtest26of10,pubtest29of10,1,320,6093,18,452,6563
subtest24of10,pubtest29of10,1,320,6093,18,492,6603
subtest29of10,pubtest210of10,1,322,5662,-2,41,5701
subtest28of10,pubtest210of10,1,322,5662,0,80,5742
subtest27of10,pubtest210of10,1,322,5662,1,118,5781
subtest210of10,pubtest210of10,1,322,5662,2,158,5822
subtest21of10,pubtest210of10,1,322,5662,-2,198,5858
subtest24of10,pubtest210of10,1,322,5662,11,229,5902
subtest23of10,pubtest210of10,1,322,5662,12,268,5942
subtest25of10,pubtest210of10,1,322,5662,13,306,5981
subtest22of10,pubtest210of10,1,322,5662,18,342,6022
subtest26of10,pubtest210of10,1,322,5662,18,382,6062
subtest26of10,pubtest21of10,1,321,10735,-4,40,10771
subtest27of10,pubtest21of10,1,321,10735,-4,79,10810
subtest29of10,pubtest21of10,1,321,10735,-1,116,10850
subtest24of10,pubtest21of10,1,321,10735,-1,156,10890
subtest25of10,pubtest21of10,1,321,10735,2,194,10931
subtest21of10,pubtest21of10,1,321,10735,3,232,10970
subtest210of10,pubtest21of10,1,321,10735,4,272,11011
subtest28of10,pubtest21of10,1,321,10735,5,309,11049
subtest22of10,pubtest21of10,1,321,10735,6,347,11088
subtest23of10,pubtest21of10,1,321,10735,9,387,11131
subtest29of10,pubtest22of10,1,320,5228,2,40,5270
subtest24of10,pubtest22of10,1,320,5228,2,79,5309
subtest27of10,pubtest22of10,1,320,5228,4,117,5349
subtest28of10,pubtest22of10,1,320,5228,4,156,5388
subtest26of10,pubtest22of10,1,320,5228,6,195,5429
subtest23of10,pubtest22of10,1,320,5228,7,234,5469
subtest25of10,pubtest22of10,1,320,5228,8,272,5508
subtest210of10,pubtest22of10,1,320,5228,11,310,5549
subtest22of10,pubtest22of10,1,320,5228,14,347,5589
subtest21of10,pubtest22of10,1,320,5228,22,379,5629
subtest28of10,pubtest23of10,1,320,5231,3,44,5278
subtest29of10,pubtest23of10,1,320,5231,3,83,5317
subtest23of10,pubtest23of10,1,320,5231,1,122,5354
subtest24of10,pubtest23of10,1,320,5231,6,160,5397
subtest27of10,pubtest23of10,1,320,5231,6,199,5436
subtest26of10,pubtest23of10,1,320,5231,9,238,5478
subtest25of10,pubtest23of10,1,320,5231,9,277,5517
subtest22of10,pubtest23of10,1,320,5231,10,315,5556
subtest21of10,pubtest23of10,1,320,5231,11,355,5597
subtest210of10,pubtest23of10,1,320,5231,13,392,5636
subtest23of10,pubtest24of10,1,320,5673,6,40,5719
subtest24of10,pubtest24of10,1,320,5673,7,78,5758
subtest21of10,pubtest24of10,1,320,5673,9,115,5797
subtest22of10,pubtest24of10,1,320,5673,9,155,5837
subtest25of10,pubtest24of10,1,320,5673,10,194,5877
subtest210of10,pubtest24of10,1,320,5673,11,233,5917
subtest28of10,pubtest24of10,1,320,5673,12,272,5957
subtest29of10,pubtest24of10,1,320,5673,17,307,5997
subtest26of10,pubtest24of10,1,320,5673,30,335,6038
subtest27of10,pubtest24of10,1,320,5673,30,374,6077
subtest21of10,pubtest25of10,1,320,5458,-1,39,5496
subtest28of10,pubtest25of10,1,320,5458,-1,77,5534
subtest210of10,pubtest25of10,1,320,5458,1,116,5575
subtest27of10,pubtest25of10,1,320,5458,3,154,5615
subtest26of10,pubtest25of10,1,320,5458,3,194,5655
subtest22of10,pubtest25of10,1,320,5458,11,226,5695
subtest25of10,pubtest25of10,1,320,5458,11,266,5735
subtest23of10,pubtest25of10,1,320,5458,17,300,5775
subtest29of10,pubtest25of10,1,320,5458,19,338,5815
subtest24of10,pubtest25of10,1,320,5458,20,377,5855
subtest22of10,pubtest26of10,1,320,5217,-2,40,5255
subtest21of10,pubtest26of10,1,320,5217,-1,79,5295
subtest29of10,pubtest26of10,1,320,5217,0,117,5334
subtest23of10,pubtest26of10,1,320,5217,5,153,5375
subtest27of10,pubtest26of10,1,320,5217,11,187,5415
subtest26of10,pubtest26of10,1,320,5217,11,228,5456
subtest210of10,pubtest26of10,1,320,5217,13,265,5495
subtest25of10,pubtest26of10,1,320,5217,14,304,5535
subtest28of10,pubtest26of10,1,320,5217,15,343,5575
subtest24of10,pubtest26of10,1,320,5217,19,379,5615
subtest27of10,pubtest27of10,1,319,5575,0,40,5615
subtest28of10,pubtest27of10,1,319,5575,1,78,5654
subtest24of10,pubtest27of10,1,319,5575,4,115,5694
subtest23of10,pubtest27of10,1,319,5575,5,154,5734
subtest29of10,pubtest27of10,1,319,5575,11,188,5774
subtest210of10,pubtest27of10,1,319,5575,12,227,5814
subtest22of10,pubtest27of10,1,319,5575,13,264,5852
subtest25of10,pubtest27of10,1,319,5575,16,303,5894
subtest26of10,pubtest27of10,1,319,5575,13,343,5931
subtest21of10,pubtest27of10,1,319,5575,22,377,5974
subtest27of10,pubtest28of10,1,320,5367,-2,42,5407
subtest28of10,pubtest28of10,1,320,5367,-1,81,5447
subtest21of10,pubtest28of10,1,320,5367,2,117,5486
subtest29of10,pubtest28of10,1,320,5367,9,151,5527
subtest23of10,pubtest28of10,1,320,5367,10,189,5566
subtest210of10,pubtest28of10,1,320,5367,10,229,5606
subtest25of10,pubtest28of10,1,320,5367,12,267,5646
subtest26of10,pubtest28of10,1,320,5367,12,310,5689
subtest22of10,pubtest28of10,1,320,5367,14,345,5726
subtest24of10,pubtest28of10,1,320,5367,15,384,5766
subtest23of10,pubtest29of10,1,320,5513,-1,41,5553
subtest210of10,pubtest29of10,1,320,5513,0,78,5591
subtest29of10,pubtest29of10,1,320,5513,6,112,5631
subtest22of10,pubtest29of10,1,320,5513,8,151,5672
subtest28of10,pubtest29of10,1,320,5513,8,189,5710
subtest27of10,pubtest29of10,1,320,5513,10,228,5751
subtest21of10,pubtest29of10,1,320,5513,10,268,5791
subtest25of10,pubtest29of10,1,320,5513,12,306,5831
subtest24of10,pubtest29of10,1,320,5513,12,346,5871
subtest26of10,pubtest29of10,1,320,5513,13,385,5911
subtest27of10,pubtest210of10,1,322,5476,3,39,5518
subtest29of10,pubtest210of10,1,322,5476,1,81,5558
subtest21of10,pubtest210of10,1,322,5476,2,118,5596
subtest210of10,pubtest210of10,1,322,5476,5,156,5637
subtest28of10,pubtest210of10,1,322,5476,7,194,5677
subtest24of10,pubtest210of10,1,322,5476,8,232,5716
subtest22of10,pubtest210of10,1,322,5476,13,268,5757
subtest23of10,pubtest210of10,1,322,5476,15,306,5797
subtest26of10,pubtest210of10,1,322,5476,15,346,5837
subtest25of10,pubtest210of10,1,322,5476,17,384,5877
subtest27of10,pubtest21of10,1,321,10300,-2,39,10337
subtest26of10,pubtest21of10,1,321,10300,-1,78,10377
subtest24of10,pubtest21of10,1,321,10300,1,116,10417
subtest29of10,pubtest21of10,1,321,10300,5,152,10457
subtest21of10,pubtest21of10,1,321,10300,6,191,10497
subtest25of10,pubtest21of10,1,321,10300,5,232,10537
subtest210of10,pubtest21of10,1,321,10300,9,269,10578
subtest28of10,pubtest21of10,1,321,10300,10,306,10616
subtest23of10,pubtest21of10,1,321,10300,11,346,10657
subtest22of10,pubtest21of10,1,321,10300,14,383,10697
subtest27of10,pubtest22of10,1,320,5173,3,41,5217
subtest29of10,pubtest22of10,1,320,5173,2,80,5255
subtest24of10,pubtest22of10,1,320,5173,2,118,5293
subtest28of10,pubtest22of10,1,320,5173,5,158,5336
subtest26of10,pubtest22of10,1,320,5173,6,197,5376
subtest23of10,pubtest22of10,1,320,5173,23,220,5416
subtest210of10,pubtest22of10,1,320,5173,23,260,5456
subtest25of10,pubtest22of10,1,320,5173,25,298,5496
subtest21of10,pubtest22of10,1,320,5173,25,337,5535
subtest22of10,pubtest22of10,1,320,5173,27,376,5576
subtest24of10,pubtest23of10,1,320,5148,8,40,5196
subtest23of10,pubtest23of10,1,320,5148,8,80,5236
subtest26of10,pubtest23of10,1,320,5148,10,118,5276
subtest21of10,pubtest23of10,1,320,5148,13,154,5315
subtest27of10,pubtest23of10,1,320,5148,12,194,5354
subtest29of10,pubtest23of10,1,320,5148,10,233,5391
subtest22of10,pubtest23of10,1,320,5148,17,272,5437
subtest210of10,pubtest23of10,1,320,5148,16,311,5475
subtest28of10,pubtest23of10,1,320,5148,8,351,5507
subtest25of10,pubtest23of10,1,320,5148,12,390,5550
subtest24of10,pubtest24of10,1,320,5217,4,43,5264
subtest22of10,pubtest24of10,1,320,5217,7,78,5302
subtest28of10,pubtest24of10,1,320,5217,6,118,5341
subtest25of10,pubtest24of10,1,320,5217,8,156,5381
subtest23of10,pubtest24of10,1,320,5217,8,196,5421
subtest210of10,pubtest24of10,1,320,5217,29,216,5462
subtest21of10,pubtest24of10,1,320,5217,29,256,5502
subtest29of10,pubtest24of10,1,320,5217,29,295,5541
subtest27of10,pubtest24of10,1,320,5217,31,334,5582
subtest26of10,pubtest24of10,1,320,5217,34,373,5624
subtest28of10,pubtest25of10,1,320,5117,4,40,5161
subtest27of10,pubtest25of10,1,320,5117,5,76,5198
subtest26of10,pubtest25of10,1,320,5117,6,115,5238
subtest210of10,pubtest25of10,1,320,5117,7,154,5278
subtest21of10,pubtest25of10,1,320,5117,4,194,5315
subtest22of10,pubtest25of10,1,320,5117,10,231,5358
subtest25of10,pubtest25of10,1,320,5117,15,267,5399
subtest23of10,pubtest25of10,1,320,5117,20,302,5439
subtest29of10,pubtest25of10,1,320,5117,27,334,5478
subtest24of10,pubtest25of10,1,320,5117,33,368,5518
subtest21of10,pubtest26of10,1,320,5085,2,39,5126
subtest29of10,pubtest26of10,1,320,5085,4,77,5166
subtest22of10,pubtest26of10,1,320,5085,2,117,5204
subtest23of10,pubtest26of10,1,320,5085,7,152,5244
subtest26of10,pubtest26of10,1,320,5085,7,191,5283
subtest210of10,pubtest26of10,1,320,5085,10,231,5326
subtest28of10,pubtest26of10,1,320,5085,18,263,5366
subtest27of10,pubtest26of10,1,320,5085,21,300,5406
subtest25of10,pubtest26of10,1,320,5085,22,339,5446
subtest24of10,pubtest26of10,1,320,5085,28,373,5486
subtest27of10,pubtest27of10,1,319,5105,0,44,5149
subtest28of10,pubtest27of10,1,319,5105,0,83,5188
subtest23of10,pubtest27of10,1,319,5105,2,121,5228
subtest25of10,pubtest27of10,1,319,5105,7,156,5268
subtest210of10,pubtest27of10,1,319,5105,7,197,5309
subtest29of10,pubtest27of10,1,319,5105,6,235,5346
subtest24of10,pubtest27of10,1,319,5105,6,275,5386
subtest22of10,pubtest27of10,1,319,5105,10,313,5428
subtest26of10,pubtest27of10,1,319,5105,10,353,5468
subtest21of10,pubtest27of10,1,319,5105,13,390,5508
subtest27of10,pubtest28of10,1,320,5185,-2,44,5227
subtest28of10,pubtest28of10,1,320,5185,9,74,5268
subtest21of10,pubtest28of10,1,320,5185,10,113,5308
subtest29of10,pubtest28of10,1,320,5185,11,152,5348
subtest23of10,pubtest28of10,1,320,5185,12,191,5388
subtest210of10,pubtest28of10,1,320,5185,16,227,5428
subtest25of10,pubtest28of10,1,320,5185,17,265,5467
subtest24of10,pubtest28of10,1,320,5185,18,305,5508
subtest26of10,pubtest28of10,1,320,5185,17,344,5546
subtest22of10,pubtest28of10,1,320,5185,20,383,5588
subtest23of10,pubtest29of10,1,320,5670,-2,39,5707
subtest210of10,pubtest29of10,1,320,5670,3,73,5746
subtest29of10,pubtest29of10,1,320,5670,5,111,5786
subtest25of10,pubtest29of10,1,320,5670,7,148,5825
subtest21of10,pubtest29of10,1,320,5670,16,180,5866
subtest27of10,pubtest29of10,1,320,5670,17,219,5906
subtest22of10,pubtest29of10,1,320,5670,17,258,5945
subtest28of10,pubtest29of10,1,320,5670,19,297,5986
subtest24of10,pubtest29of10,1,320,5670,20,336,6026
subtest26of10,pubtest29of10,1,320,5670,25,371,6066
subtest29of10,pubtest210of10,1,322,5823,-1,38,5860
subtest21of10,pubtest210of10,1,322,5823,14,62,5899
subtest210of10,pubtest210of10,1,322,5823,18,98,5939
subtest28of10,pubtest210of10,1,322,5823,19,137,5979
subtest24of10,pubtest210of10,1,322,5823,19,177,6019
subtest27of10,pubtest210of10,1,322,5823,18,217,6058
subtest26of10,pubtest210of10,1,322,5823,23,253,6099
subtest22of10,pubtest210of10,1,322,5823,23,293,6139
subtest25of10,pubtest210of10,1,322,5823,25,331,6179
subtest23of10,pubtest210of10,1,322,5823,25,370,6218
subtest27of10,pubtest21of10,1,321,11024,1,39,11064
subtest29of10,pubtest21of10,1,321,11024,1,78,11103
subtest25of10,pubtest21of10,1,321,11024,3,116,11143
subtest21of10,pubtest21of10,1,321,11024,4,155,11183
subtest23of10,pubtest21of10,1,321,11024,6,193,11223
subtest26of10,pubtest21of10,1,321,11024,9,231,11264
subtest24of10,pubtest21of10,1,321,11024,13,266,11303
subtest210of10,pubtest21of10,1,321,11024,18,300,11342
subtest28of10,pubtest21of10,1,321,11024,19,340,11383
subtest22of10,pubtest21of10,1,321,11024,22,377,11423
subtest27of10,pubtest22of10,1,320,5510,-1,39,5548
subtest24of10,pubtest22of10,1,320,5510,0,76,5586
subtest29of10,pubtest22of10,1,320,5510,-1,114,5623
subtest28of10,pubtest22of10,1,320,5510,3,153,5666
subtest23of10,pubtest22of10,1,320,5510,14,183,5707
subtest26of10,pubtest22of10,1,320,5510,14,223,5747
subtest25of10,pubtest22of10,1,320,5510,15,262,5787
subtest210of10,pubtest22of10,1,320,5510,16,302,5828
subtest21of10,pubtest22of10,1,320,5510,17,341,5868
subtest22of10,pubtest22of10,1,320,5510,17,380,5907
subtest23of10,pubtest23of10,1,320,5705,1,43,5749
subtest28of10,pubtest23of10,1,320,5705,3,81,5789
subtest29of10,pubtest23of10,1,320,5705,4,121,5830
subtest27of10,pubtest23of10,1,320,5705,5,160,5870
subtest24of10,pubtest23of10,1,320,5705,6,199,5910
subtest26of10,pubtest23of10,1,320,5705,8,237,5950
subtest25of10,pubtest23of10,1,320,5705,8,277,5990
subtest21of10,pubtest23of10,1,320,5705,12,313,6030
subtest22of10,pubtest23of10,1,320,5705,12,353,6070
subtest210of10,pubtest23of10,1,320,5705,22,382,6109
subtest23of10,pubtest24of10,1,320,5455,8,40,5503
subtest24of10,pubtest24of10,1,320,5455,8,78,5541
subtest27of10,pubtest24of10,1,320,5455,10,117,5582
subtest29of10,pubtest24of10,1,320,5455,11,156,5622
subtest28of10,pubtest24of10,1,320,5455,11,197,5663
subtest22of10,pubtest24of10,1,320,5455,12,235,5702
subtest26of10,pubtest24of10,1,320,5455,13,274,5742
subtest210of10,pubtest24of10,1,320,5455,14,313,5782
subtest25of10,pubtest24of10,1,320,5455,8,352,5815
subtest21of10,pubtest24of10,1,320,5455,16,391,5862
subtest28of10,pubtest25of10,1,320,5306,-1,152,5457
subtest21of10,pubtest25of10,1,320,5306,5,188,5499
subtest210of10,pubtest25of10,1,320,5306,14,218,5538
subtest27of10,pubtest25of10,1,320,5306,15,256,5577
subtest26of10,pubtest25of10,1,320,5306,16,296,5618
subtest22of10,pubtest25of10,1,320,5306,22,330,5658
subtest23of10,pubtest25of10,1,320,5306,24,368,5698
subtest25of10,pubtest25of10,1,320,5306,23,408,5737
subtest29of10,pubtest25of10,1,320,5306,30,442,5778
subtest24of10,pubtest25of10,1,320,5306,30,482,5818
subtest21of10,pubtest26of10,1,320,5362,2,40,5404
subtest29of10,pubtest26of10,1,320,5362,4,77,5443
subtest22of10,pubtest26of10,1,320,5362,5,117,5484
subtest26of10,pubtest26of10,1,320,5362,6,154,5522
subtest210of10,pubtest26of10,1,320,5362,7,195,5564
subtest23of10,pubtest26of10,1,320,5362,8,233,5603
subtest28of10,pubtest26of10,1,320,5362,9,270,5641
subtest24of10,pubtest26of10,1,320,5362,12,308,5682
subtest27of10,pubtest26of10,1,320,5362,13,348,5723
subtest25of10,pubtest26of10,1,320,5362,10,388,5760
subtest27of10,pubtest27of10,1,319,5227,1,41,5269
subtest28of10,pubtest27of10,1,319,5227,2,79,5308
subtest23of10,pubtest27of10,1,319,5227,3,117,5347
subtest24of10,pubtest27of10,1,319,5227,10,151,5388
subtest29of10,pubtest27of10,1,319,5227,12,189,5428
subtest210of10,pubtest27of10,1,319,5227,13,228,5468
subtest25of10,pubtest27of10,1,319,5227,21,260,5508
subtest22of10,pubtest27of10,1,319,5227,29,293,5549
subtest21of10,pubtest27of10,1,319,5227,30,331,5588
subtest26of10,pubtest27of10,1,319,5227,30,371,5628
subtest28of10,pubtest28of10,1,320,5216,0,42,5258
subtest27of10,pubtest28of10,1,320,5216,0,82,5298
subtest21of10,pubtest28of10,1,320,5216,2,120,5338
subtest29of10,pubtest28of10,1,320,5216,4,158,5378
subtest210of10,pubtest28of10,1,320,5216,9,194,5419
subtest23of10,pubtest28of10,1,320,5216,10,233,5459
subtest25of10,pubtest28of10,1,320,5216,14,269,5499
subtest26of10,pubtest28of10,1,320,5216,14,309,5539
subtest24of10,pubtest28of10,1,320,5216,16,346,5578
subtest22of10,pubtest28of10,1,320,5216,21,381,5618
subtest210of10,pubtest29of10,1,320,5369,1,42,5412
subtest29of10,pubtest29of10,1,320,5369,2,80,5451
subtest23of10,pubtest29of10,1,320,5369,1,119,5489
subtest25of10,pubtest29of10,1,320,5369,5,157,5531
subtest22of10,pubtest29of10,1,320,5369,5,197,5571
subtest21of10,pubtest29of10,1,320,5369,14,228,5611
subtest27of10,pubtest29of10,1,320,5369,16,266,5651
subtest24of10,pubtest29of10,1,320,5369,16,306,5691
subtest26of10,pubtest29of10,1,320,5369,18,344,5731
subtest28of10,pubtest29of10,1,320,5369,16,384,5769
subtest29of10,pubtest210of10,1,322,5496,-2,43,5537
subtest21of10,pubtest210of10,1,322,5496,0,80,5576
subtest210of10,pubtest210of10,1,322,5496,1,118,5615
subtest27of10,pubtest210of10,1,322,5496,2,157,5655
subtest23of10,pubtest210of10,1,322,5496,5,194,5695
subtest28of10,pubtest210of10,1,322,5496,5,234,5735
subtest24of10,pubtest210of10,1,322,5496,6,273,5775
subtest25of10,pubtest210of10,1,322,5496,16,303,5815
subtest22of10,pubtest210of10,1,322,5496,19,340,5855
subtest26of10,pubtest210of10,1,322,5496,20,379,5895
subtest27of10,pubtest21of10,1,321,10612,-2,42,10652
subtest29of10,pubtest21of10,1,321,10612,7,71,10690
subtest26of10,pubtest21of10,1,321,10612,7,111,10730
subtest24of10,pubtest21of10,1,321,10612,11,148,10771
subtest25of10,pubtest21of10,1,321,10612,12,187,10811
subtest210of10,pubtest21of10,1,321,10612,13,226,10851
subtest21of10,pubtest21of10,1,321,10612,14,265,10891
subtest22of10,pubtest21of10,1,321,10612,15,303,10930
subtest23of10,pubtest21of10,1,321,10612,15,343,10970
subtest28of10,pubtest21of10,1,321,10612,15,382,11009
subtest29of10,pubtest22of10,1,320,5526,-3,41,5564
subtest24of10,pubtest22of10,1,320,5526,4,73,5603
subtest27of10,pubtest22of10,1,320,5526,5,111,5642
subtest28of10,pubtest22of10,1,320,5526,9,148,5683
subtest26of10,pubtest22of10,1,320,5526,15,182,5723
subtest23of10,pubtest22of10,1,320,5526,17,220,5763
subtest210of10,pubtest22of10,1,320,5526,33,244,5803
subtest21of10,pubtest22of10,1,320,5526,35,282,5843
subtest22of10,pubtest22of10,1,320,5526,36,321,5883
subtest25of10,pubtest22of10,1,320,5526,35,360,5921
subtest23of10,pubtest23of10,1,320,6191,-1,40,6230
subtest28of10,pubtest23of10,1,320,6191,0,79,6270
subtest29of10,pubtest23of10,1,320,6191,11,107,6309
subtest24of10,pubtest23of10,1,320,6191,15,142,6348
subtest27of10,pubtest23of10,1,320,6191,21,177,6389
subtest25of10,pubtest23of10,1,320,6191,22,216,6429
subtest26of10,pubtest23of10,1,320,6191,23,255,6469
subtest21of10,pubtest23of10,1,320,6191,40,278,6509
subtest22of10,pubtest23of10,1,320,6191,50,309,6550
subtest210of10,pubtest23of10,1,320,6191,69,329,6589
subtest24of10,pubtest24of10,1,320,5580,-2,41,5619
subtest23of10,pubtest24of10,1,320,5580,-1,80,5659
subtest28of10,pubtest24of10,1,320,5580,8,112,5700
subtest25of10,pubtest24of10,1,320,5580,8,151,5739
subtest22of10,pubtest24of10,1,320,5580,11,188,5779
subtest21of10,pubtest24of10,1,320,5580,11,228,5819
subtest27of10,pubtest24of10,1,320,5580,15,264,5859
subtest29of10,pubtest24of10,1,320,5580,14,304,5898
subtest26of10,pubtest24of10,1,320,5580,16,342,5938
subtest210of10,pubtest24of10,1,320,5580,16,383,5979
subtest26of10,pubtest25of10,1,320,5758,3,43,5804
subtest27of10,pubtest25of10,1,320,5758,5,82,5845
subtest28of10,pubtest25of10,1,320,5758,-1,128,5885
subtest210of10,pubtest25of10,1,320,5758,1,165,5924
subtest21of10,pubtest25of10,1,320,5758,7,199,5964
subtest22of10,pubtest25of10,1,320,5758,9,236,6003
subtest25of10,pubtest25of10,1,320,5758,11,275,6044
subtest23of10,pubtest25of10,1,320,5758,12,315,6085
subtest29of10,pubtest25of10,1,320,5758,13,353,6124
subtest24of10,pubtest25of10,1,320,5758,15,391,6164
subtest21of10,pubtest26of10,1,320,5871,-1,44,5914
subtest22of10,pubtest26of10,1,320,5871,0,81,5952
subtest23of10,pubtest26of10,1,320,5871,2,120,5993
subtest29of10,pubtest26of10,1,320,5871,4,158,6033
subtest27of10,pubtest26of10,1,320,5871,7,195,6073
subtest26of10,pubtest26of10,1,320,5871,8,234,6113
subtest25of10,pubtest26of10,1,320,5871,9,271,6151
subtest210of10,pubtest26of10,1,320,5871,9,310,6190
subtest28of10,pubtest26of10,1,320,5871,11,349,6231
subtest24of10,pubtest26of10,1,320,5871,14,388,6273
subtest27of10,pubtest27of10,1,319,5494,-5,53,5542
subtest28of10,pubtest27of10,1,319,5494,3,84,5581
subtest23of10,pubtest27of10,1,319,5494,4,123,5621
subtest24of10,pubtest27of10,1,319,5494,5,163,5662
subtest29of10,pubtest27of10,1,319,5494,7,199,5700
subtest210of10,pubtest27of10,1,319,5494,7,239,5740
subtest25of10,pubtest27of10,1,319,5494,7,279,5780
subtest22of10,pubtest27of10,1,319,5494,11,317,5822
subtest21of10,pubtest27of10,1,319,5494,11,356,5861
subtest26of10,pubtest27of10,1,319,5494,12,394,5900
subtest27of10,pubtest28of10,1,320,6057,-3,41,6095
subtest21of10,pubtest28of10,1,320,6057,2,75,6134
subtest28of10,pubtest28of10,1,320,6057,2,115,6174
subtest29of10,pubtest28of10,1,320,6057,4,153,6214
subtest210of10,pubtest28of10,1,320,6057,10,187,6254
subtest23of10,pubtest28of10,1,320,6057,12,225,6294
subtest25of10,pubtest28of10,1,320,6057,22,254,6333
subtest26of10,pubtest28of10,1,320,6057,23,294,6374
subtest24of10,pubtest28of10,1,320,6057,25,333,6415
subtest22of10,pubtest28of10,1,320,6057,30,367,6454
subtest23of10,pubtest29of10,1,320,5388,-2,41,5427
subtest210of10,pubtest29of10,1,320,5388,2,76,5466
subtest29of10,pubtest29of10,1,320,5388,3,114,5505
subtest22of10,pubtest29of10,1,320,5388,5,152,5545
subtest28of10,pubtest29of10,1,320,5388,5,190,5583
subtest25of10,pubtest29of10,1,320,5388,8,228,5624
subtest21of10,pubtest29of10,1,320,5388,9,268,5665
subtest24of10,pubtest29of10,1,320,5388,12,305,5705
subtest27of10,pubtest29of10,1,320,5388,13,344,5745
subtest26of10,pubtest29of10,1,320,5388,14,383,5785
subtest29of10,pubtest210of10,1,322,5639,0,39,5678
subtest21of10,pubtest210of10,1,322,5639,1,77,5717
subtest27of10,pubtest210of10,1,322,5639,5,114,5758
subtest210of10,pubtest210of10,1,322,5639,5,153,5797
subtest24of10,pubtest210of10,1,322,5639,7,191,5837
subtest28of10,pubtest210of10,1,322,5639,7,231,5877
subtest22of10,pubtest210of10,1,322,5639,9,269,5917
subtest23of10,pubtest210of10,1,322,5639,10,308,5957
subtest26of10,pubtest210of10,1,322,5639,10,348,5997
subtest25of10,pubtest210of10,1,322,5639,12,386,6037
subtest27of10,pubtest21of10,1,321,10682,4,40,10726
subtest26of10,pubtest21of10,1,321,10682,6,77,10765
subtest24of10,pubtest21of10,1,321,10682,6,117,10805
subtest29of10,pubtest21of10,1,321,10682,8,155,10845
subtest25of10,pubtest21of10,1,321,10682,8,195,10885
subtest28of10,pubtest21of10,1,321,10682,10,233,10925
subtest210of10,pubtest21of10,1,321,10682,11,272,10965
subtest23of10,pubtest21of10,1,321,10682,12,311,11005
subtest21of10,pubtest21of10,1,321,10682,10,351,11043
subtest22of10,pubtest21of10,1,321,10682,12,389,11083
subtest29of10,pubtest22of10,1,320,5409,1,39,5449
subtest27of10,pubtest22of10,1,320,5409,5,73,5487
subtest25of10,pubtest22of10,1,320,5409,7,112,5528
subtest21of10,pubtest22of10,1,320,5409,8,152,5569
subtest26of10,pubtest22of10,1,320,5409,10,190,5609
subtest28of10,pubtest22of10,1,320,5409,10,230,5649
subtest24of10,pubtest22of10,1,320,5409,5,269,5683
subtest210of10,pubtest22of10,1,320,5409,11,309,5729
subtest22of10,pubtest22of10,1,320,5409,12,347,5768
subtest23of10,pubtest22of10,1,320,5409,11,387,5807
subtest23of10,pubtest23of10,1,320,5688,1,39,5728
subtest28of10,pubtest23of10,1,320,5688,2,77,5767
subtest29of10,pubtest23of10,1,320,5688,3,116,5807
subtest24of10,pubtest23of10,1,320,5688,5,154,5847
subtest27of10,pubtest23of10,1,320,5688,7,192,5887
subtest26of10,pubtest23of10,1,320,5688,9,230,5927
subtest25of10,pubtest23of10,1,320,5688,10,269,5967
subtest21of10,pubtest23of10,1,320,5688,20,299,6007
subtest22of10,pubtest23of10,1,320,5688,18,338,6044
subtest210of10,pubtest23of10,1,320,5688,23,376,6087
subtest23of10,pubtest24of10,1,320,5460,1,39,5500
subtest24of10,pubtest24of10,1,320,5460,2,78,5540
subtest28of10,pubtest24of10,1,320,5460,4,115,5579
subtest22of10,pubtest24of10,1,320,5460,4,155,5619
subtest25of10,pubtest24of10,1,320,5460,4,193,5657
subtest21of10,pubtest24of10,1,320,5460,6,233,5699
subtest210of10,pubtest24of10,1,320,5460,7,272,5739
subtest29of10,pubtest24of10,1,320,5460,8,310,5778
subtest26of10,pubtest24of10,1,320,5460,10,349,5819
subtest27of10,pubtest24of10,1,320,5460,10,389,5859
subtest21of10,pubtest25of10,1,320,5905,1,46,5952
subtest28of10,pubtest25of10,1,320,5905,-1,86,5990
subtest27of10,pubtest25of10,1,320,5905,7,120,6032
subtest26of10,pubtest25of10,1,320,5905,7,158,6070
subtest210of10,pubtest25of10,1,320,5905,5,198,6108
subtest22of10,pubtest25of10,1,320,5905,11,234,6150
subtest25of10,pubtest25of10,1,320,5905,13,273,6191
subtest23of10,pubtest25of10,1,320,5905,14,312,6231
subtest24of10,pubtest25of10,1,320,5905,17,349,6271
subtest29of10,pubtest25of10,1,320,5905,17,389,6311
subtest22of10,pubtest26of10,1,320,6275,-1,39,6313
subtest21of10,pubtest26of10,1,320,6275,-1,78,6352
subtest26of10,pubtest26of10,1,320,6275,11,104,6390
subtest29of10,pubtest26of10,1,320,6275,11,143,6429
subtest27of10,pubtest26of10,1,320,6275,16,182,6473
subtest28of10,pubtest26of10,1,320,6275,15,222,6512
subtest23of10,pubtest26of10,1,320,6275,11,262,6548
subtest210of10,pubtest26of10,1,320,6275,17,301,6593
subtest24of10,pubtest26of10,1,320,6275,18,340,6633
subtest25of10,pubtest26of10,1,320,6275,18,379,6672
subtest27of10,pubtest27of10,1,319,5488,-1,39,5526
subtest23of10,pubtest27of10,1,319,5488,0,77,5565
subtest28of10,pubtest27of10,1,319,5488,-1,241,5728
subtest29of10,pubtest27of10,1,319,5488,4,238,5730
subtest24of10,pubtest27of10,1,319,5488,2,277,5767
subtest210of10,pubtest27of10,1,319,5488,4,317,5809
subtest25of10,pubtest27of10,1,319,5488,8,354,5850
subtest22of10,pubtest27of10,1,319,5488,10,392,5890
subtest26of10,pubtest27of10,1,319,5488,13,428,5929
subtest21of10,pubtest27of10,1,319,5488,18,463,5969
subtest27of10,pubtest28of10,1,320,5348,-2,206,5552
subtest21of10,pubtest28of10,1,320,5348,7,237,5592
subtest28of10,pubtest28of10,1,320,5348,7,276,5631
subtest29of10,pubtest28of10,1,320,5348,9,314,5671
subtest23of10,pubtest28of10,1,320,5348,12,351,5711
subtest210of10,pubtest28of10,1,320,5348,13,391,5752
subtest26of10,pubtest28of10,1,320,5348,14,429,5791
subtest24of10,pubtest28of10,1,320,5348,15,467,5830
subtest22of10,pubtest28of10,1,320,5348,16,507,5871
subtest25of10,pubtest28of10,1,320,5348,15,546,5909
subtest23of10,pubtest29of10,1,320,5435,-2,41,5474
subtest210of10,pubtest29of10,1,320,5435,1,78,5514
subtest29of10,pubtest29of10,1,320,5435,6,114,5555
subtest22of10,pubtest29of10,1,320,5435,7,154,5596
subtest25of10,pubtest29of10,1,320,5435,6,193,5634
subtest21of10,pubtest29of10,1,320,5435,9,231,5675
subtest28of10,pubtest29of10,1,320,5435,9,272,5716
subtest24of10,pubtest29of10,1,320,5435,10,310,5755
subtest27of10,pubtest29of10,1,320,5435,13,348,5796
subtest26of10,pubtest29of10,1,320,5435,16,385,5836
subtest29of10,pubtest210of10,1,322,6362,-3,41,6400
subtest21of10,pubtest210of10,1,322,6362,-2,79,6439
subtest210of10,pubtest210of10,1,322,6362,0,117,6479
subtest27of10,pubtest210of10,1,322,6362,3,154,6519
subtest28of10,pubtest210of10,1,322,6362,16,181,6559
subtest23of10,pubtest210of10,1,322,6362,16,218,6596
subtest25of10,pubtest210of10,1,322,6362,21,256,6639
subtest26of10,pubtest210of10,1,322,6362,21,296,6679
subtest22of10,pubtest210of10,1,322,6362,22,334,6718
subtest24of10,pubtest210of10,1,322,6362,23,374,6759
subtest26of10,pubtest21of10,1,321,11270,1,39,11310
subtest27of10,pubtest21of10,1,321,11270,4,75,11349
subtest29of10,pubtest21of10,1,321,11270,11,109,11390
subtest24of10,pubtest21of10,1,321,11270,12,147,11429
subtest25of10,pubtest21of10,1,321,11270,13,186,11469
subtest210of10,pubtest21of10,1,321,11270,15,224,11509
subtest21of10,pubtest21of10,1,321,11270,16,263,11549
subtest28of10,pubtest21of10,1,321,11270,24,294,11588
subtest23of10,pubtest21of10,1,321,11270,32,327,11629
subtest22of10,pubtest21of10,1,321,11270,33,366,11669
subtest24of10,pubtest22of10,1,320,5337,0,39,5376
subtest29of10,pubtest22of10,1,320,5337,0,78,5415
subtest28of10,pubtest22of10,1,320,5337,2,116,5455
subtest27of10,pubtest22of10,1,320,5337,2,156,5495
subtest23of10,pubtest22of10,1,320,5337,6,192,5535
subtest26of10,pubtest22of10,1,320,5337,12,226,5575
subtest25of10,pubtest22of10,1,320,5337,13,265,5615
subtest210of10,pubtest22of10,1,320,5337,15,303,5655
subtest21of10,pubtest22of10,1,320,5337,16,342,5695
subtest22of10,pubtest22of10,1,320,5337,17,381,5735
subtest23of10,pubtest23of10,1,320,5188,-2,42,5228
subtest28of10,pubtest23of10,1,320,5188,-2,80,5266
subtest24of10,pubtest23of10,1,320,5188,2,117,5307
subtest29of10,pubtest23of10,1,320,5188,2,158,5348
subtest27of10,pubtest23of10,1,320,5188,8,191,5387
subtest26of10,pubtest23of10,1,320,5188,8,231,5427
subtest25of10,pubtest23of10,1,320,5188,10,269,5467
subtest21of10,pubtest23of10,1,320,5188,10,309,5507
subtest22of10,pubtest23of10,1,320,5188,10,348,5546
subtest210of10,pubtest23of10,1,320,5188,12,387,5587
subtest25of10,pubtest24of10,1,320,5227,5,43,5275
subtest23of10,pubtest24of10,1,320,5227,5,83,5315
subtest28of10,pubtest24of10,1,320,5227,7,120,5354
subtest24of10,pubtest24of10,1,320,5227,7,159,5393
subtest29of10,pubtest24of10,1,320,5227,9,198,5434
subtest21of10,pubtest24of10,1,320,5227,9,238,5474
subtest22of10,pubtest24of10,1,320,5227,10,277,5514
subtest27of10,pubtest24of10,1,320,5227,11,316,5554
subtest210of10,pubtest24of10,1,320,5227,12,355,5594
subtest26of10,pubtest24of10,1,320,5227,17,390,5634
subtest28of10,pubtest25of10,1,320,5920,10,39,5969
subtest21of10,pubtest25of10,1,320,5920,12,77,6009
subtest210of10,pubtest25of10,1,320,5920,12,116,6048
subtest26of10,pubtest25of10,1,320,5920,14,155,6089
subtest27of10,pubtest25of10,1,320,5920,14,194,6128
subtest22of10,pubtest25of10,1,320,5920,17,230,6167
subtest25of10,pubtest25of10,1,320,5920,19,268,6207
subtest29of10,pubtest25of10,1,320,5920,22,308,6250
subtest23of10,pubtest25of10,1,320,5920,22,347,6289
subtest24of10,pubtest25of10,1,320,5920,24,384,6328
subtest29of10,pubtest26of10,1,320,5670,11,41,5722
subtest21of10,pubtest26of10,1,320,5670,9,84,5763
subtest26of10,pubtest26of10,1,320,5670,11,122,5803
subtest210of10,pubtest26of10,1,320,5670,12,161,5843
subtest27of10,pubtest26of10,1,320,5670,14,199,5883
subtest28of10,pubtest26of10,1,320,5670,15,238,5923
subtest25of10,pubtest26of10,1,320,5670,16,278,5964
subtest22of10,pubtest26of10,1,320,5670,9,324,6003
subtest24of10,pubtest26of10,1,320,5670,17,356,6043
subtest23of10,pubtest26of10,1,320,5670,11,396,6077
subtest28of10,pubtest27of10,1,319,5262,0,41,5303
subtest27of10,pubtest27of10,1,319,5262,1,79,5342
subtest24of10,pubtest27of10,1,319,5262,2,117,5381
subtest210of10,pubtest27of10,1,319,5262,6,152,5420
subtest23of10,pubtest27of10,1,319,5262,6,191,5459
subtest22of10,pubtest27of10,1,319,5262,8,231,5501
subtest25of10,pubtest27of10,1,319,5262,9,270,5541
subtest21of10,pubtest27of10,1,319,5262,11,309,5582
subtest26of10,pubtest27of10,1,319,5262,12,348,5622
subtest29of10,pubtest27of10,1,319,5262,8,388,5658
subtest27of10,pubtest28of10,1,320,5273,-2,40,5311
subtest28of10,pubtest28of10,1,320,5273,0,76,5349
subtest21of10,pubtest28of10,1,320,5273,0,116,5389
subtest29of10,pubtest28of10,1,320,5273,4,152,5429
subtest23of10,pubtest28of10,1,320,5273,7,188,5468
subtest210of10,pubtest28of10,1,320,5273,7,228,5508
subtest25of10,pubtest28of10,1,320,5273,10,266,5549
subtest26of10,pubtest28of10,1,320,5273,13,303,5589
subtest24of10,pubtest28of10,1,320,5273,17,339,5629
subtest22of10,pubtest28of10,1,320,5273,20,375,5668
subtest23of10,pubtest29of10,1,320,5345,-4,41,5382
subtest210of10,pubtest29of10,1,320,5345,3,74,5422
subtest29of10,pubtest29of10,1,320,5345,3,113,5461
subtest28of10,pubtest29of10,1,320,5345,7,150,5502
subtest22of10,pubtest29of10,1,320,5345,6,189,5540
subtest27of10,pubtest29of10,1,320,5345,9,227,5581
subtest24of10,pubtest29of10,1,320,5345,9,266,5620
subtest26of10,pubtest29of10,1,320,5345,9,306,5660
subtest21of10,pubtest29of10,1,320,5345,10,346,5701
subtest25of10,pubtest29of10,1,320,5345,6,385,5736
subtest29of10,pubtest210of10,1,322,5168,-3,43,5208
subtest27of10,pubtest210of10,1,322,5168,9,73,5250
subtest28of10,pubtest210of10,1,322,5168,11,111,5290
subtest24of10,pubtest210of10,1,322,5168,10,151,5329
subtest26of10,pubtest210of10,1,322,5168,12,189,5369
subtest22of10,pubtest210of10,1,322,5168,11,229,5408
subtest23of10,pubtest210of10,1,322,5168,11,269,5448
subtest21of10,pubtest210of10,1,322,5168,8,313,5489
subtest25of10,pubtest210of10,1,322,5168,14,347,5529
subtest210of10,pubtest210of10,1,322,5168,8,387,5563
subtest27of10,pubtest21of10,1,321,10230,1,39,10270
subtest26of10,pubtest21of10,1,321,10230,2,77,10309
subtest29of10,pubtest21of10,1,321,10230,4,116,10350
subtest24of10,pubtest21of10,1,321,10230,5,155,10390
subtest25of10,pubtest21of10,1,321,10230,6,194,10430
subtest210of10,pubtest21of10,1,321,10230,8,231,10469
subtest28of10,pubtest21of10,1,321,10230,10,270,10510
subtest21of10,pubtest21of10,1,321,10230,7,310,10547
subtest22of10,pubtest21of10,1,321,10230,14,346,10590
subtest23of10,pubtest21of10,1,321,10230,14,386,10630
subtest29of10,pubtest22of10,1,320,5285,-1,40,5324
subtest24of10,pubtest22of10,1,320,5285,2,75,5362
subtest27of10,pubtest22of10,1,320,5285,3,115,5403
subtest28of10,pubtest22of10,1,320,5285,4,155,5444
subtest26of10,pubtest22of10,1,320,5285,6,193,5484
subtest23of10,pubtest22of10,1,320,5285,7,231,5523
subtest210of10,pubtest22of10,1,320,5285,8,270,5563
subtest25of10,pubtest22of10,1,320,5285,9,310,5604
subtest21of10,pubtest22of10,1,320,5285,10,348,5643
subtest22of10,pubtest22of10,1,320,5285,10,388,5683
subtest23of10,pubtest23of10,1,320,5329,-2,46,5373
subtest28of10,pubtest23of10,1,320,5329,-1,84,5412
subtest24of10,pubtest23of10,1,320,5329,1,122,5452
subtest25of10,pubtest23of10,1,320,5329,3,160,5492
subtest27of10,pubtest23of10,1,320,5329,4,199,5532
subtest26of10,pubtest23of10,1,320,5329,5,238,5572
subtest29of10,pubtest23of10,1,320,5329,5,278,5612
subtest22of10,pubtest23of10,1,320,5329,11,313,5653
subtest21of10,pubtest23of10,1,320,5329,13,350,5692
subtest210of10,pubtest23of10,1,320,5329,13,390,5732
subtest23of10,pubtest24of10,1,320,5235,2,43,5280
subtest24of10,pubtest24of10,1,320,5235,4,80,5319
subtest28of10,pubtest24of10,1,320,5235,5,117,5357
subtest25of10,pubtest24of10,1,320,5235,7,156,5398
subtest29of10,pubtest24of10,1,320,5235,9,195,5439
subtest22of10,pubtest24of10,1,320,5235,10,234,5479
subtest27of10,pubtest24of10,1,320,5235,10,274,5519
subtest21of10,pubtest24of10,1,320,5235,11,313,5559
subtest210of10,pubtest24of10,1,320,5235,13,351,5599
subtest26of10,pubtest24of10,1,320,5235,14,391,5640
subtest28of10,pubtest25of10,1,320,5207,3,42,5252
subtest21of10,pubtest25of10,1,320,5207,3,81,5291
subtest210of10,pubtest25of10,1,320,5207,6,117,5330
subtest27of10,pubtest25of10,1,320,5207,7,156,5370
subtest26of10,pubtest25of10,1,320,5207,7,195,5409
subtest22of10,pubtest25of10,1,320,5207,9,234,5450
subtest25of10,pubtest25of10,1,320,5207,10,273,5490
subtest24of10,pubtest25of10,1,320,5207,11,312,5530
subtest23of10,pubtest25of10,1,320,5207,15,347,5569
subtest29of10,pubtest25of10,1,320,5207,15,387,5609
subtest21of10,pubtest26of10,1,320,5240,-1,39,5278
subtest22of10,pubtest26of10,1,320,5240,1,76,5317
subtest29of10,pubtest26of10,1,320,5240,2,115,5357
subtest23of10,pubtest26of10,1,320,5240,3,154,5397
subtest26of10,pubtest26of10,1,320,5240,4,194,5438
subtest28of10,pubtest26of10,1,320,5240,5,232,5477
subtest24of10,pubtest26of10,1,320,5240,5,272,5517
subtest25of10,pubtest26of10,1,320,5240,5,311,5556
subtest210of10,pubtest26of10,1,320,5240,5,350,5595
subtest27of10,pubtest26of10,1,320,5240,8,389,5637
subtest27of10,pubtest27of10,1,319,5375,-3,39,5411
subtest28of10,pubtest27of10,1,319,5375,3,72,5450
subtest23of10,pubtest27of10,1,319,5375,5,110,5490
subtest24of10,pubtest27of10,1,319,5375,9,146,5530
subtest210of10,pubtest27of10,1,319,5375,9,185,5569
subtest29of10,pubtest27of10,1,319,5375,11,224,5610
subtest22of10,pubtest27of10,1,319,5375,12,263,5650
subtest26of10,pubtest27of10,1,319,5375,13,302,5690
subtest25of10,pubtest27of10,1,319,5375,11,341,5727
subtest21of10,pubtest27of10,1,319,5375,14,381,5770
subtest27of10,pubtest28of10,1,320,5634,-2,40,5672
subtest28of10,pubtest28of10,1,320,5634,-1,78,5711
subtest21of10,pubtest28of10,1,320,5634,2,114,5750
subtest29of10,pubtest28of10,1,320,5634,2,154,5790
subtest23of10,pubtest28of10,1,320,5634,6,189,5829
subtest210of10,pubtest28of10,1,320,5634,14,223,5871
subtest25of10,pubtest28of10,1,320,5634,15,261,5910
subtest24of10,pubtest28of10,1,320,5634,27,290,5951
subtest22of10,pubtest28of10,1,320,5634,27,329,5990
subtest26of10,pubtest28of10,1,320,5634,27,368,6029
subtest23of10,pubtest29of10,1,320,5199,-2,40,5237
subtest210of10,pubtest29of10,1,320,5199,-1,78,5276
subtest29of10,pubtest29of10,1,320,5199,2,114,5315
subtest25of10,pubtest29of10,1,320,5199,6,150,5355
subtest22of10,pubtest29of10,1,320,5199,6,190,5395
subtest28of10,pubtest29of10,1,320,5199,17,219,5435
subtest21of10,pubtest29of10,1,320,5199,17,259,5475
subtest24of10,pubtest29of10,1,320,5199,20,296,5515
subtest26of10,pubtest29of10,1,320,5199,21,335,5555
subtest27of10,pubtest29of10,1,320,5199,22,374,5595
subtest21of10,pubtest210of10,1,322,5519,-3,41,5557
subtest29of10,pubtest210of10,1,322,5519,-3,80,5596
subtest210of10,pubtest210of10,1,322,5519,-1,117,5635
subtest27of10,pubtest210of10,1,322,5519,-1,157,5675
subtest28of10,pubtest210of10,1,322,5519,1,195,5715
subtest22of10,pubtest210of10,1,322,5519,6,230,5755
subtest24of10,pubtest210of10,1,322,5519,6,270,5795
subtest26of10,pubtest210of10,1,322,5519,14,302,5835
subtest23of10,pubtest210of10,1,322,5519,14,342,5875
subtest25of10,pubtest210of10,1,322,5519,19,377,5915
subtest26of10,pubtest21of10,1,321,10688,3,40,10731
subtest27of10,pubtest21of10,1,321,10688,3,79,10770
subtest24of10,pubtest21of10,1,321,10688,7,116,10811
subtest25of10,pubtest21of10,1,321,10688,9,155,10852
subtest29of10,pubtest21of10,1,321,10688,8,195,10891
subtest21of10,pubtest21of10,1,321,10688,10,235,10933
subtest28of10,pubtest21of10,1,321,10688,15,269,10972
subtest210of10,pubtest21of10,1,321,10688,15,309,11012
subtest22of10,pubtest21of10,1,321,10688,17,347,11052
subtest23of10,pubtest21of10,1,321,10688,21,383,11092
subtest24of10,pubtest22of10,1,320,5391,-2,39,5428
subtest29of10,pubtest22of10,1,320,5391,-2,78,5467
subtest27of10,pubtest22of10,1,320,5391,0,117,5508
subtest28of10,pubtest22of10,1,320,5391,1,156,5548
subtest26of10,pubtest22of10,1,320,5391,2,195,5588
subtest23of10,pubtest22of10,1,320,5391,9,228,5628
subtest25of10,pubtest22of10,1,320,5391,12,263,5666
subtest210of10,pubtest22of10,1,320,5391,14,303,5708
subtest22of10,pubtest22of10,1,320,5391,18,339,5748
subtest21of10,pubtest22of10,1,320,5391,20,377,5788
subtest28of10,pubtest23of10,1,320,5361,1,43,5405
subtest29of10,pubtest23of10,1,320,5361,3,80,5444
subtest23of10,pubtest23of10,1,320,5361,1,119,5481
subtest24of10,pubtest23of10,1,320,5361,3,159,5523
subtest26of10,pubtest23of10,1,320,5361,8,195,5564
subtest27of10,pubtest23of10,1,320,5361,7,235,5603
subtest25of10,pubtest23of10,1,320,5361,8,274,5643
subtest22of10,pubtest23of10,1,320,5361,9,314,5684
subtest21of10,pubtest23of10,1,320,5361,11,352,5724
subtest210of10,pubtest23of10,1,320,5361,14,391,5766
subtest23of10,pubtest24of10,1,320,5691,-5,41,5727
subtest24of10,pubtest24of10,1,320,5691,-3,78,5766
subtest25of10,pubtest24of10,1,320,5691,-3,118,5806
subtest22of10,pubtest24of10,1,320,5691,-1,156,5846
subtest28of10,pubtest24of10,1,320,5691,-1,196,5886
subtest21of10,pubtest24of10,1,320,5691,1,234,5926
subtest29of10,pubtest24of10,1,320,5691,1,274,5966
subtest210of10,pubtest24of10,1,320,5691,1,313,6005
subtest27of10,pubtest24of10,1,320,5691,5,350,6046
subtest26of10,pubtest24of10,1,320,5691,5,390,6086
subtest28of10,pubtest25of10,1,320,5302,-2,39,5339
subtest21of10,pubtest25of10,1,320,5302,0,76,5378
subtest210of10,pubtest25of10,1,320,5302,3,113,5418
subtest27of10,pubtest25of10,1,320,5302,6,150,5458
subtest26of10,pubtest25of10,1,320,5302,9,187,5498
subtest22of10,pubtest25of10,1,320,5302,9,227,5538
subtest25of10,pubtest25of10,1,320,5302,12,264,5578
subtest23of10,pubtest25of10,1,320,5302,14,302,5618
subtest24of10,pubtest25of10,1,320,5302,16,340,5658
subtest29of10,pubtest25of10,1,320,5302,16,380,5698
subtest21of10,pubtest26of10,1,320,5391,-6,299,5684
subtest29of10,pubtest26of10,1,320,5391,-4,334,5721
subtest23of10,pubtest26of10,1,320,5391,-1,371,5761
subtest22of10,pubtest26of10,1,320,5391,4,406,5801
subtest27of10,pubtest26of10,1,320,5391,7,443,5841
subtest26of10,pubtest26of10,1,320,5391,7,483,5881
subtest210of10,pubtest26of10,1,320,5391,9,521,5921
subtest25of10,pubtest26of10,1,320,5391,9,561,5961
subtest28of10,pubtest26of10,1,320,5391,13,597,6001
subtest24of10,pubtest26of10,1,320,5391,15,635,6041
subtest28of10,pubtest27of10,1,319,5737,-3,39,5773
subtest27of10,pubtest27of10,1,319,5737,-3,79,5813
subtest23of10,pubtest27of10,1,319,5737,-2,119,5854
subtest29of10,pubtest27of10,1,319,5737,8,148,5893
subtest25of10,pubtest27of10,1,319,5737,9,187,5933
subtest21of10,pubtest27of10,1,319,5737,10,227,5974
subtest24of10,pubtest27of10,1,319,5737,13,263,6013
subtest22of10,pubtest27of10,1,319,5737,15,301,6053
subtest210of10,pubtest27of10,1,319,5737,13,339,6089
subtest26of10,pubtest27of10,1,319,5737,17,379,6133
subtest27of10,pubtest28of10,1,320,5361,-3,40,5398
subtest28of10,pubtest28of10,1,320,5361,1,75,5437
subtest21of10,pubtest28of10,1,320,5361,2,114,5477
subtest29of10,pubtest28of10,1,320,5361,4,152,5517
subtest210of10,pubtest28of10,1,320,5361,5,191,5557
subtest23of10,pubtest28of10,1,320,5361,6,230,5597
subtest26of10,pubtest28of10,1,320,5361,7,269,5637
subtest25of10,pubtest28of10,1,320,5361,8,308,5677
subtest24of10,pubtest28of10,1,320,5361,9,347,5717
subtest22of10,pubtest28of10,1,320,5361,20,376,5757
subtest23of10,pubtest29of10,1,320,5305,-4,40,5341
subtest210of10,pubtest29of10,1,320,5305,-1,76,5380
subtest29of10,pubtest29of10,1,320,5305,-1,114,5418
subtest25of10,pubtest29of10,1,320,5305,1,154,5460
subtest22of10,pubtest29of10,1,320,5305,1,194,5500
subtest28of10,pubtest29of10,1,320,5305,6,228,5539
subtest21of10,pubtest29of10,1,320,5305,6,267,5578
subtest24of10,pubtest29of10,1,320,5305,10,304,5619
subtest27of10,pubtest29of10,1,320,5305,10,344,5659
subtest26of10,pubtest29of10,1,320,5305,12,382,5699
subtest29of10,pubtest210of10,1,322,5213,0,40,5253
subtest21of10,pubtest210of10,1,322,5213,1,77,5291
subtest210of10,pubtest210of10,1,322,5213,2,117,5332
subtest27of10,pubtest210of10,1,322,5213,3,155,5371
subtest28of10,pubtest210of10,1,322,5213,4,195,5412
subtest24of10,pubtest210of10,1,322,5213,5,234,5452
subtest23of10,pubtest210of10,1,322,5213,6,273,5492
subtest22of10,pubtest210of10,1,322,5213,7,312,5532
subtest26of10,pubtest210of10,1,322,5213,13,345,5571
subtest25of10,pubtest210of10,1,322,5213,13,384,5610
subtest26of10,pubtest21of10,1,321,10533,2,38,10573
subtest27of10,pubtest21of10,1,321,10533,2,76,10611
subtest24of10,pubtest21of10,1,321,10533,5,115,10653
subtest29of10,pubtest21of10,1,321,10533,4,155,10692
subtest210of10,pubtest21of10,1,321,10533,6,192,10731
subtest21of10,pubtest21of10,1,321,10533,7,232,10772
subtest25of10,pubtest21of10,1,321,10533,6,271,10810
subtest22of10,pubtest21of10,1,321,10533,9,310,10852
subtest28of10,pubtest21of10,1,321,10533,8,349,10890
subtest23of10,pubtest21of10,1,321,10533,10,389,10932
subtest29of10,pubtest22of10,1,320,5477,-2,39,5514
subtest24of10,pubtest22of10,1,320,5477,2,75,5554
subtest27of10,pubtest22of10,1,320,5477,2,116,5595
subtest28of10,pubtest22of10,1,320,5477,4,153,5634
subtest23of10,pubtest22of10,1,320,5477,4,193,5674
subtest26of10,pubtest22of10,1,320,5477,12,225,5714
subtest25of10,pubtest22of10,1,320,5477,12,265,5754
subtest21of10,pubtest22of10,1,320,5477,18,299,5794
subtest210of10,pubtest22of10,1,320,5477,27,331,5835
subtest22of10,pubtest22of10,1,320,5477,30,367,5874
subtest23of10,pubtest23of10,1,320,5217,0,42,5259
subtest28of10,pubtest23of10,1,320,5217,1,81,5299
subtest29of10,pubtest23of10,1,320,5217,2,119,5338
subtest24of10,pubtest23of10,1,320,5217,3,158,5378
subtest26of10,pubtest23of10,1,320,5217,5,197,5419
subtest25of10,pubtest23of10,1,320,5217,5,236,5458
subtest21of10,pubtest23of10,1,320,5217,7,275,5499
subtest27of10,pubtest23of10,1,320,5217,7,313,5537
subtest22of10,pubtest23of10,1,320,5217,11,351,5579
subtest210of10,pubtest23of10,1,320,5217,10,391,5618
subtest23of10,pubtest24of10,1,320,5210,0,44,5254
subtest24of10,pubtest24of10,1,320,5210,1,80,5291
subtest25of10,pubtest24of10,1,320,5210,3,118,5331
subtest28of10,pubtest24of10,1,320,5210,3,158,5371
subtest29of10,pubtest24of10,1,320,5210,5,196,5411
subtest21of10,pubtest24of10,1,320,5210,5,237,5452
subtest22of10,pubtest24of10,1,320,5210,6,276,5492
subtest27of10,pubtest24of10,1,320,5210,7,317,5534
subtest26of10,pubtest24of10,1,320,5210,11,351,5572
subtest210of10,pubtest24of10,1,320,5210,11,390,5611
subtest28of10,pubtest25of10,1,320,5129,0,45,5174
subtest21of10,pubtest25of10,1,320,5129,1,82,5212
subtest25of10,pubtest25of10,1,320,5129,3,121,5253
subtest210of10,pubtest25of10,1,320,5129,3,161,5293
subtest29of10,pubtest25of10,1,320,5129,5,199,5333
subtest23of10,pubtest25of10,1,320,5129,5,239,5373
subtest27of10,pubtest25of10,1,320,5129,7,277,5413
subtest22of10,pubtest25of10,1,320,5129,8,315,5452
subtest26of10,pubtest25of10,1,320,5129,7,357,5493
subtest24of10,pubtest25of10,1,320,5129,9,395,5533
subtest22of10,pubtest26of10,1,320,5275,-2,40,5313
subtest21of10,pubtest26of10,1,320,5275,-1,78,5352
subtest29of10,pubtest26of10,1,320,5275,1,117,5393
subtest23of10,pubtest26of10,1,320,5275,5,152,5432
subtest210of10,pubtest26of10,1,320,5275,6,191,5472
subtest26of10,pubtest26of10,1,320,5275,7,230,5512
subtest27of10,pubtest26of10,1,320,5275,12,265,5552
subtest25of10,pubtest26of10,1,320,5275,12,305,5592
subtest28of10,pubtest26of10,1,320,5275,12,344,5631
subtest24of10,pubtest26of10,1,320,5275,14,382,5671
subtest28of10,pubtest27of10,1,319,5285,1,38,5324
subtest27of10,pubtest27of10,1,319,5285,1,77,5363
subtest23of10,pubtest27of10,1,319,5285,4,113,5402
subtest24of10,pubtest27of10,1,319,5285,8,150,5443
subtest210of10,pubtest27of10,1,319,5285,16,182,5483
subtest25of10,pubtest27of10,1,319,5285,17,221,5523
subtest22of10,pubtest27of10,1,319,5285,18,260,5563
subtest29of10,pubtest27of10,1,319,5285,16,300,5601
subtest26of10,pubtest27of10,1,319,5285,25,332,5642
subtest21of10,pubtest27of10,1,319,5285,25,372,5682
subtest27of10,pubtest28of10,1,320,5153,-6,42,5189
subtest28of10,pubtest28of10,1,320,5153,-3,80,5230
subtest21of10,pubtest28of10,1,320,5153,-2,119,5270
subtest29of10,pubtest28of10,1,320,5153,0,159,5312
subtest23of10,pubtest28of10,1,320,5153,-1,198,5350
subtest25of10,pubtest28of10,1,320,5153,3,234,5390
subtest26of10,pubtest28of10,1,320,5153,11,265,5429
subtest210of10,pubtest28of10,1,320,5153,11,306,5470
subtest24of10,pubtest28of10,1,320,5153,12,344,5509
subtest22of10,pubtest28of10,1,320,5153,14,383,5550
subtest23of10,pubtest29of10,1,320,5230,-2,42,5270
subtest210of10,pubtest29of10,1,320,5230,3,74,5307
subtest29of10,pubtest29of10,1,320,5230,4,114,5348
subtest25of10,pubtest29of10,1,320,5230,5,153,5388
subtest22of10,pubtest29of10,1,320,5230,5,192,5427
subtest28of10,pubtest29of10,1,320,5230,6,232,5468
subtest21of10,pubtest29of10,1,320,5230,8,270,5508
subtest26of10,pubtest29of10,1,320,5230,10,308,5548
subtest24of10,pubtest29of10,1,320,5230,10,348,5588
subtest27of10,pubtest29of10,1,320,5230,9,387,5626
subtest21of10,pubtest210of10,1,322,5099,-2,271,5368
subtest29of10,pubtest210of10,1,322,5099,-3,309,5405
subtest27of10,pubtest210of10,1,322,5099,4,341,5444
subtest28of10,pubtest210of10,1,322,5099,7,379,5485
subtest210of10,pubtest210of10,1,322,5099,8,417,5524
subtest24of10,pubtest210of10,1,322,5099,10,455,5564
subtest26of10,pubtest210of10,1,322,5099,11,495,5605
subtest25of10,pubtest210of10,1,322,5099,13,533,5645
subtest23of10,pubtest210of10,1,322,5099,13,573,5685
subtest22of10,pubtest210of10,1,322,5099,14,612,5725
subtest27of10,pubtest21of10,1,321,10272,0,39,10311
subtest26of10,pubtest21of10,1,321,10272,1,77,10350
subtest29of10,pubtest21of10,1,321,10272,2,115,10389
subtest24of10,pubtest21of10,1,321,10272,3,155,10430
subtest25of10,pubtest21of10,1,321,10272,5,193,10470
subtest21of10,pubtest21of10,1,321,10272,8,230,10510
subtest210of10,pubtest21of10,1,321,10272,8,270,10550
subtest23of10,pubtest21of10,1,321,10272,13,305,10590
subtest28of10,pubtest21of10,1,321,10272,13,345,10630
subtest22of10,pubtest21of10,1,321,10272,15,382,10669
subtest29of10,pubtest22of10,1,320,5965,-3,39,6001
subtest27of10,pubtest22of10,1,320,5965,-2,78,6041
subtest24of10,pubtest22of10,1,320,5965,-1,116,6080
subtest28of10,pubtest22of10,1,320,5965,0,154,6119
subtest26of10,pubtest22of10,1,320,5965,2,193,6160
subtest23of10,pubtest22of10,1,320,5965,5,230,6200
subtest25of10,pubtest22of10,1,320,5965,17,258,6240
subtest21of10,pubtest22of10,1,320,5965,17,297,6279
subtest210of10,pubtest22of10,1,320,5965,19,336,6320
subtest22of10,pubtest22of10,1,320,5965,25,369,6359
subtest28of10,pubtest23of10,1,320,5460,-2,40,5498
subtest24of10,pubtest23of10,1,320,5460,0,78,5538
subtest29of10,pubtest23of10,1,320,5460,0,117,5577
subtest23of10,pubtest23of10,1,320,5460,-2,158,5616
subtest25of10,pubtest23of10,1,320,5460,8,190,5658
subtest27of10,pubtest23of10,1,320,5460,8,230,5698
subtest26of10,pubtest23of10,1,320,5460,12,268,5740
subtest22of10,pubtest23of10,1,320,5460,17,302,5779
subtest210of10,pubtest23of10,1,320,5460,24,336,5820
subtest21of10,pubtest23of10,1,320,5460,24,375,5859
subtest24of10,pubtest24of10,1,320,6273,-3,39,6309
subtest23of10,pubtest24of10,1,320,6273,-2,78,6349
subtest25of10,pubtest24of10,1,320,6273,1,115,6389
subtest28of10,pubtest24of10,1,320,6273,8,149,6430
subtest21of10,pubtest24of10,1,320,6273,9,187,6469
subtest29of10,pubtest24of10,1,320,6273,10,226,6509
subtest22of10,pubtest24of10,1,320,6273,13,262,6548
subtest27of10,pubtest24of10,1,320,6273,18,298,6589
subtest210of10,pubtest24of10,1,320,6273,19,337,6629
subtest26of10,pubtest24of10,1,320,6273,20,376,6669
subtest28of10,pubtest25of10,1,320,5423,-3,41,5461
subtest21of10,pubtest25of10,1,320,5423,-1,78,5500
subtest210of10,pubtest25of10,1,320,5423,-3,120,5540
subtest26of10,pubtest25of10,1,320,5423,1,156,5580
subtest27of10,pubtest25of10,1,320,5423,3,195,5621
subtest22of10,pubtest25of10,1,320,5423,4,233,5660
subtest25of10,pubtest25of10,1,320,5423,14,263,5700
subtest23of10,pubtest25of10,1,320,5423,17,301,5741
subtest29of10,pubtest25of10,1,320,5423,18,338,5779
subtest24of10,pubtest25of10,1,320,5423,22,375,5820
subtest21of10,pubtest26of10,1,320,5150,-2,39,5187
subtest22of10,pubtest26of10,1,320,5150,-2,78,5226
subtest29of10,pubtest26of10,1,320,5150,1,115,5266
subtest23of10,pubtest26of10,1,320,5150,2,155,5307
subtest26of10,pubtest26of10,1,320,5150,8,189,5347
subtest27of10,pubtest26of10,1,320,5150,9,227,5386
subtest210of10,pubtest26of10,1,320,5150,9,267,5426
subtest28of10,pubtest26of10,1,320,5150,11,305,5466
subtest24of10,pubtest26of10,1,320,5150,11,345,5506
subtest25of10,pubtest26of10,1,320,5150,11,383,5544
subtest23of10,pubtest27of10,1,319,5287,-3,41,5325
subtest27of10,pubtest27of10,1,319,5287,-3,81,5365
subtest28of10,pubtest27of10,1,319,5287,-1,116,5402
subtest24of10,pubtest27of10,1,319,5287,1,155,5443
subtest210of10,pubtest27of10,1,319,5287,6,191,5484
subtest29of10,pubtest27of10,1,319,5287,9,228,5524
subtest25of10,pubtest27of10,1,319,5287,11,266,5564
subtest22of10,pubtest27of10,1,319,5287,11,306,5604
subtest21of10,pubtest27of10,1,319,5287,13,344,5644
subtest26of10,pubtest27of10,1,319,5287,13,384,5684
subtest21of10,pubtest28of10,1,320,5415,0,42,5457
subtest28of10,pubtest28of10,1,320,5415,1,81,5497
subtest29of10,pubtest28of10,1,320,5415,3,118,5536
subtest23of10,pubtest28of10,1,320,5415,3,158,5576
subtest27of10,pubtest28of10,1,320,5415,0,196,5611
subtest25of10,pubtest28of10,1,320,5415,5,236,5656
subtest210of10,pubtest28of10,1,320,5415,6,275,5696
subtest24of10,pubtest28of10,1,320,5415,4,315,5734
subtest26of10,pubtest28of10,1,320,5415,5,352,5772
subtest22of10,pubtest28of10,1,320,5415,7,392,5814
subtest23of10,pubtest29of10,1,320,5985,-7,40,6018
subtest29of10,pubtest29of10,1,320,5985,-4,76,6057
subtest25of10,pubtest29of10,1,320,5985,-3,116,6098
subtest210of10,pubtest29of10,1,320,5985,-4,155,6136
subtest22of10,pubtest29of10,1,320,5985,2,190,6177
subtest21of10,pubtest29of10,1,320,5985,5,227,6217
subtest28of10,pubtest29of10,1,320,5985,6,266,6257
subtest26of10,pubtest29of10,1,320,5985,7,305,6297
subtest24of10,pubtest29of10,1,320,5985,8,344,6337
subtest27of10,pubtest29of10,1,320,5985,9,384,6378
subtest29of10,pubtest210of10,1,322,5582,1,45,5628
subtest210of10,pubtest210of10,1,322,5582,1,84,5667
subtest21of10,pubtest210of10,1,322,5582,3,122,5707
subtest28of10,pubtest210of10,1,322,5582,3,162,5747
subtest27of10,pubtest210of10,1,322,5582,4,201,5787
subtest24of10,pubtest210of10,1,322,5582,5,240,5827
subtest23of10,pubtest210of10,1,322,5582,7,278,5867
subtest22of10,pubtest210of10,1,322,5582,9,316,5907
subtest25of10,pubtest210of10,1,322,5582,11,354,5947
subtest26of10,pubtest210of10,1,322,5582,11,394,5987
subtest26of10,pubtest21of10,1,321,10720,-2,40,10758
subtest27of10,pubtest21of10,1,321,10720,0,77,10797
subtest29of10,pubtest21of10,1,321,10720,0,116,10836
subtest24of10,pubtest21of10,1,321,10720,1,155,10876
subtest28of10,pubtest21of10,1,321,10720,8,189,10917
subtest21of10,pubtest21of10,1,321,10720,8,229,10957
subtest25of10,pubtest21of10,1,321,10720,6,268,10994
subtest210of10,pubtest21of10,1,321,10720,9,307,11036
subtest22of10,pubtest21of10,1,321,10720,11,346,11077
subtest23of10,pubtest21of10,1,321,10720,16,381,11117
subtest29of10,pubtest22of10,1,320,5450,2,42,5494
subtest24of10,pubtest22of10,1,320,5450,3,80,5533
subtest27of10,pubtest22of10,1,320,5450,4,118,5572
subtest28of10,pubtest22of10,1,320,5450,9,153,5612
subtest23of10,pubtest22of10,1,320,5450,9,194,5653
subtest26of10,pubtest22of10,1,320,5450,11,231,5692
subtest25of10,pubtest22of10,1,320,5450,11,271,5732
subtest21of10,pubtest22of10,1,320,5450,12,309,5771
subtest22of10,pubtest22of10,1,320,5450,13,349,5812
subtest210of10,pubtest22of10,1,320,5450,13,388,5851
subtest23of10,pubtest23of10,1,320,5663,-2,41,5702
subtest28of10,pubtest23of10,1,320,5663,-2,79,5740
subtest29of10,pubtest23of10,1,320,5663,0,117,5780
subtest27of10,pubtest23of10,1,320,5663,1,157,5821
subtest24of10,pubtest23of10,1,320,5663,0,196,5859
subtest26of10,pubtest23of10,1,320,5663,6,232,5901
subtest25of10,pubtest23of10,1,320,5663,6,272,5941
subtest22of10,pubtest23of10,1,320,5663,12,306,5981
subtest21of10,pubtest23of10,1,320,5663,12,345,6020
subtest210of10,pubtest23of10,1,320,5663,16,382,6061
subtest23of10,pubtest24of10,1,320,5328,-4,40,5364
subtest24of10,pubtest24of10,1,320,5328,-3,77,5402
subtest25of10,pubtest24of10,1,320,5328,3,112,5443
subtest28of10,pubtest24of10,1,320,5328,3,152,5483
subtest21of10,pubtest24of10,1,320,5328,5,190,5523
subtest29of10,pubtest24of10,1,320,5328,11,224,5563
subtest27of10,pubtest24of10,1,320,5328,11,264,5603
subtest26of10,pubtest24of10,1,320,5328,13,302,5643
subtest22of10,pubtest24of10,1,320,5328,11,342,5681
subtest210of10,pubtest24of10,1,320,5328,13,381,5722
subtest28of10,pubtest25of10,1,320,5365,-3,217,5579
subtest21of10,pubtest25of10,1,320,5365,-1,253,5617
subtest27of10,pubtest25of10,1,320,5365,0,292,5657
subtest210of10,pubtest25of10,1,320,5365,1,331,5697
subtest26of10,pubtest25of10,1,320,5365,6,366,5737
subtest25of10,pubtest25of10,1,320,5365,11,401,5777
subtest23of10,pubtest25of10,1,320,5365,15,437,5817
subtest22of10,pubtest25of10,1,320,5365,15,477,5857
subtest29of10,pubtest25of10,1,320,5365,17,514,5896
subtest24of10,pubtest25of10,1,320,5365,17,554,5936
subtest21of10,pubtest26of10,1,320,5165,0,39,5204
subtest22of10,pubtest26of10,1,320,5165,2,76,5243
subtest29of10,pubtest26of10,1,320,5165,3,115,5283
subtest23of10,pubtest26of10,1,320,5165,8,150,5323
subtest26of10,pubtest26of10,1,320,5165,9,189,5363
subtest27of10,pubtest26of10,1,320,5165,10,230,5405
subtest25of10,pubtest26of10,1,320,5165,13,266,5444
subtest210of10,pubtest26of10,1,320,5165,14,303,5482
subtest28of10,pubtest26of10,1,320,5165,15,343,5523
subtest24of10,pubtest26of10,1,320,5165,18,381,5564
subtest27of10,pubtest27of10,1,319,5149,-2,40,5187
subtest28of10,pubtest27of10,1,319,5149,-2,78,5225
subtest23of10,pubtest27of10,1,319,5149,0,118,5267
subtest24of10,pubtest27of10,1,319,5149,1,156,5306
subtest210of10,pubtest27of10,1,319,5149,2,195,5346
subtest25of10,pubtest27of10,1,319,5149,9,228,5386
subtest29of10,pubtest27of10,1,319,5149,9,268,5426
subtest22of10,pubtest27of10,1,319,5149,11,306,5466
subtest26of10,pubtest27of10,1,319,5149,11,346,5506
subtest21of10,pubtest27of10,1,319,5149,13,384,5546
subtest21of10,pubtest28of10,1,320,5338,2,45,5385
subtest28of10,pubtest28of10,1,320,5338,1,85,5424
subtest27of10,pubtest28of10,1,320,5338,1,119,5458
subtest26of10,pubtest28of10,1,320,5338,6,159,5503
subtest25of10,pubtest28of10,1,320,5338,6,198,5542
subtest210of10,pubtest28of10,1,320,5338,5,237,5580
subtest24of10,pubtest28of10,1,320,5338,8,277,5623
subtest23of10,pubtest28of10,1,320,5338,5,316,5659
subtest22of10,pubtest28of10,1,320,5338,9,356,5703
subtest29of10,pubtest28of10,1,320,5338,11,394,5743
subtest23of10,pubtest29of10,1,320,5467,-3,41,5505
subtest210of10,pubtest29of10,1,320,5467,-2,80,5545
subtest29of10,pubtest29of10,1,320,5467,3,115,5585
subtest25of10,pubtest29of10,1,320,5467,4,154,5625
subtest22of10,pubtest29of10,1,320,5467,5,193,5665
subtest28of10,pubtest29of10,1,320,5467,6,231,5704
subtest21of10,pubtest29of10,1,320,5467,7,271,5745
subtest24of10,pubtest29of10,1,320,5467,8,308,5783
subtest26of10,pubtest29of10,1,320,5467,11,348,5826
subtest27of10,pubtest29of10,1,320,5467,9,387,5863
subtest29of10,pubtest210of10,1,322,5746,0,42,5788
subtest21of10,pubtest210of10,1,322,5746,0,81,5827
subtest210of10,pubtest210of10,1,322,5746,2,119,5867
subtest27of10,pubtest210of10,1,322,5746,8,153,5907
subtest28of10,pubtest210of10,1,322,5746,9,193,5948
subtest23of10,pubtest210of10,1,322,5746,10,232,5988
subtest25of10,pubtest210of10,1,322,5746,15,266,6027
subtest22of10,pubtest210of10,1,322,5746,16,305,6067
subtest24of10,pubtest210of10,1,322,5746,15,344,6105
subtest26of10,pubtest210of10,1,322,5746,18,382,6146
subtest27of10,pubtest21of10,1,321,11362,-2,38,11398
subtest26of10,pubtest21of10,1,321,11362,-1,76,11437
subtest24of10,pubtest21of10,1,321,11362,0,115,11477
subtest29of10,pubtest21of10,1,321,11362,1,154,11517
subtest210of10,pubtest21of10,1,321,11362,3,191,11556
subtest25of10,pubtest21of10,1,321,11362,3,231,11596
subtest28of10,pubtest21of10,1,321,11362,10,265,11637
subtest23of10,pubtest21of10,1,321,11362,10,305,11677
subtest21of10,pubtest21of10,1,321,11362,10,344,11716
subtest22of10,pubtest21of10,1,321,11362,12,383,11757
subtest29of10,pubtest22of10,1,320,5574,-3,40,5611
subtest24of10,pubtest22of10,1,320,5574,0,76,5650
subtest27of10,pubtest22of10,1,320,5574,6,111,5691
subtest28of10,pubtest22of10,1,320,5574,9,147,5730
subtest25of10,pubtest22of10,1,320,5574,10,186,5770
subtest23of10,pubtest22of10,1,320,5574,10,347,5931
subtest21of10,pubtest22of10,1,320,5574,11,384,5969
subtest26of10,pubtest22of10,1,320,5574,13,423,6010
subtest22of10,pubtest22of10,1,320,5574,16,460,6050
subtest210of10,pubtest22of10,1,320,5574,16,499,6089
subtest28of10,pubtest23of10,1,320,5427,-2,40,5465
subtest23of10,pubtest23of10,1,320,5427,-2,78,5503
subtest29of10,pubtest23of10,1,320,5427,0,116,5543
subtest24of10,pubtest23of10,1,320,5427,4,152,5583
subtest27of10,pubtest23of10,1,320,5427,7,189,5623
subtest25of10,pubtest23of10,1,320,5427,8,228,5663
subtest26of10,pubtest23of10,1,320,5427,7,268,5702
subtest22of10,pubtest23of10,1,320,5427,12,302,5741
subtest21of10,pubtest23of10,1,320,5427,12,342,5781
subtest210of10,pubtest23of10,1,320,5427,15,381,5823
subtest24of10,pubtest24of10,1,320,5618,-4,41,5655
subtest23of10,pubtest24of10,1,320,5618,-4,79,5693
subtest25of10,pubtest24of10,1,320,5618,-1,117,5734
subtest21of10,pubtest24of10,1,320,5618,0,156,5774
subtest28of10,pubtest24of10,1,320,5618,6,190,5814
subtest29of10,pubtest24of10,1,320,5618,8,228,5854
subtest22of10,pubtest24of10,1,320,5618,8,268,5894
subtest210of10,pubtest24of10,1,320,5618,15,303,5936
subtest27of10,pubtest24of10,1,320,5618,17,339,5974
subtest26of10,pubtest24of10,1,320,5618,18,378,6014
subtest28of10,pubtest25of10,1,320,5711,1,47,5759
subtest21of10,pubtest25of10,1,320,5711,2,86,5799
subtest26of10,pubtest25of10,1,320,5711,4,122,5837
subtest27of10,pubtest25of10,1,320,5711,6,161,5878
subtest210of10,pubtest25of10,1,320,5711,1,200,5912
subtest22of10,pubtest25of10,1,320,5711,8,239,5958
subtest25of10,pubtest25of10,1,320,5711,11,276,5998
subtest23of10,pubtest25of10,1,320,5711,20,307,6038
subtest29of10,pubtest25of10,1,320,5711,20,347,6078
subtest24of10,pubtest25of10,1,320,5711,22,385,6118
subtest21of10,pubtest26of10,1,320,7137,-1,40,7176
subtest22of10,pubtest26of10,1,320,7137,-1,80,7216
subtest29of10,pubtest26of10,1,320,7137,1,117,7255
subtest27of10,pubtest26of10,1,320,7137,4,154,7295
subtest26of10,pubtest26of10,1,320,7137,5,193,7335
subtest23of10,pubtest26of10,1,320,7137,1,234,7372
subtest210of10,pubtest26of10,1,320,7137,7,271,7415
subtest24of10,pubtest26of10,1,320,7137,6,310,7453
subtest25of10,pubtest26of10,1,320,7137,6,349,7492
subtest28of10,pubtest26of10,1,320,7137,7,389,7533
subtest27of10,pubtest27of10,1,319,7315,-4,40,7351
subtest28of10,pubtest27of10,1,319,7315,-3,78,7390
subtest23of10,pubtest27of10,1,319,7315,-2,116,7429
subtest24of10,pubtest27of10,1,319,7315,-1,156,7470
subtest210of10,pubtest27of10,1,319,7315,3,191,7509
subtest29of10,pubtest27of10,1,319,7315,3,231,7549
subtest25of10,pubtest27of10,1,319,7315,6,269,7590
subtest22of10,pubtest27of10,1,319,7315,6,309,7630
subtest21of10,pubtest27of10,1,319,7315,8,346,7669
subtest26of10,pubtest27of10,1,319,7315,8,385,7708
subtest27of10,pubtest28of10,1,320,5211,-1,40,5250
subtest28of10,pubtest28of10,1,320,5211,0,80,5291
subtest21of10,pubtest28of10,1,320,5211,1,118,5330
subtest29of10,pubtest28of10,1,320,5211,2,157,5370
subtest210of10,pubtest28of10,1,320,5211,3,196,5410
subtest23of10,pubtest28of10,1,320,5211,4,235,5450
subtest25of10,pubtest28of10,1,320,5211,9,270,5490
subtest26of10,pubtest28of10,1,320,5211,9,310,5530
subtest24of10,pubtest28of10,1,320,5211,11,349,5571
subtest22of10,pubtest28of10,1,320,5211,12,387,5610
subtest23of10,pubtest29of10,1,320,5268,-2,40,5306
subtest210of10,pubtest29of10,1,320,5268,-2,79,5345
subtest29of10,pubtest29of10,1,320,5268,0,117,5385
subtest22of10,pubtest29of10,1,320,5268,1,157,5426
subtest25of10,pubtest29of10,1,320,5268,13,184,5465
subtest28of10,pubtest29of10,1,320,5268,13,224,5505
subtest26of10,pubtest29of10,1,320,5268,15,262,5545
subtest21of10,pubtest29of10,1,320,5268,15,302,5585
subtest27of10,pubtest29of10,1,320,5268,17,340,5625
subtest24of10,pubtest29of10,1,320,5268,15,380,5663
subtest29of10,pubtest210of10,1,322,5285,-4,41,5322
subtest21of10,pubtest210of10,1,322,5285,0,77,5362
subtest210of10,pubtest210of10,1,322,5285,0,115,5400
subtest27of10,pubtest210of10,1,322,5285,2,152,5439
subtest28of10,pubtest210of10,1,322,5285,2,191,5478
subtest25of10,pubtest210of10,1,322,5285,6,230,5521
subtest23of10,pubtest210of10,1,322,5285,6,270,5561
subtest24of10,pubtest210of10,1,322,5285,9,307,5601
subtest22of10,pubtest210of10,1,322,5285,10,346,5641
subtest26of10,pubtest210of10,1,322,5285,16,380,5681
subtest27of10,pubtest21of10,1,321,10737,-3,39,10773
subtest26of10,pubtest21of10,1,321,10737,-3,78,10812
subtest24of10,pubtest21of10,1,321,10737,0,116,10853
subtest25of10,pubtest21of10,1,321,10737,1,155,10893
subtest29of10,pubtest21of10,1,321,10737,0,195,10932
subtest210of10,pubtest21of10,1,321,10737,8,227,10972
subtest21of10,pubtest21of10,1,321,10737,9,267,11013
subtest28of10,pubtest21of10,1,321,10737,10,305,11052
subtest22of10,pubtest21of10,1,321,10737,11,343,11091
subtest23of10,pubtest21of10,1,321,10737,12,382,11131
subtest29of10,pubtest22of10,1,320,5218,1,319,5538
subtest27of10,pubtest22of10,1,320,5218,2,356,5576
subtest24of10,pubtest22of10,1,320,5218,1,395,5614
subtest23of10,pubtest22of10,1,320,5218,13,425,5656
subtest28of10,pubtest22of10,1,320,5218,13,465,5696
subtest26of10,pubtest22of10,1,320,5218,15,503,5736
subtest25of10,pubtest22of10,1,320,5218,17,541,5776
subtest21of10,pubtest22of10,1,320,5218,19,579,5816
subtest210of10,pubtest22of10,1,320,5218,27,611,5856
subtest22of10,pubtest22of10,1,320,5218,28,650,5896
subtest23of10,pubtest23of10,1,320,5221,-4,39,5256
subtest28of10,pubtest23of10,1,320,5221,-2,77,5296
subtest29of10,pubtest23of10,1,320,5221,7,108,5336
subtest24of10,pubtest23of10,1,320,5221,9,146,5376
subtest25of10,pubtest23of10,1,320,5221,11,184,5416
subtest27of10,pubtest23of10,1,320,5221,11,224,5456
subtest26of10,pubtest23of10,1,320,5221,21,254,5496
subtest22of10,pubtest23of10,1,320,5221,22,294,5537
subtest210of10,pubtest23of10,1,320,5221,25,330,5576
subtest21of10,pubtest23of10,1,320,5221,25,370,5616
subtest23of10,pubtest24of10,1,320,5156,5,40,5201
subtest24of10,pubtest24of10,1,320,5156,11,74,5241
subtest25of10,pubtest24of10,1,320,5156,12,112,5280
subtest28of10,pubtest24of10,1,320,5156,16,148,5320
subtest21of10,pubtest24of10,1,320,5156,18,186,5360
subtest22of10,pubtest24of10,1,320,5156,41,202,5399
subtest29of10,pubtest24of10,1,320,5156,44,241,5441
subtest210of10,pubtest24of10,1,320,5156,56,267,5479
subtest27of10,pubtest24of10,1,320,5156,56,307,5519
subtest26of10,pubtest24of10,1,320,5156,56,347,5559
subtest28of10,pubtest25of10,1,320,5338,1,42,5381
subtest21of10,pubtest25of10,1,320,5338,2,81,5421
subtest210of10,pubtest25of10,1,320,5338,4,118,5460
subtest27of10,pubtest25of10,1,320,5338,5,156,5499
subtest26of10,pubtest25of10,1,320,5338,5,195,5538
subtest25of10,pubtest25of10,1,320,5338,7,234,5579
subtest22of10,pubtest25of10,1,320,5338,7,273,5618
subtest24of10,pubtest25of10,1,320,5338,23,298,5659
subtest29of10,pubtest25of10,1,320,5338,23,338,5699
subtest23of10,pubtest25of10,1,320,5338,25,376,5739
subtest21of10,pubtest26of10,1,320,5099,-3,41,5137
subtest23of10,pubtest26of10,1,320,5099,-1,78,5176
subtest29of10,pubtest26of10,1,320,5099,-1,118,5216
subtest22of10,pubtest26of10,1,320,5099,-2,157,5254
subtest26of10,pubtest26of10,1,320,5099,4,193,5296
subtest27of10,pubtest26of10,1,320,5099,7,230,5336
subtest210of10,pubtest26of10,1,320,5099,9,268,5376
subtest25of10,pubtest26of10,1,320,5099,12,305,5416
subtest28of10,pubtest26of10,1,320,5099,17,340,5456
subtest24of10,pubtest26of10,1,320,5099,17,381,5497
subtest27of10,pubtest27of10,1,319,5152,-3,39,5188
subtest28of10,pubtest27of10,1,319,5152,0,77,5229
subtest23of10,pubtest27of10,1,319,5152,1,116,5269
subtest24of10,pubtest27of10,1,319,5152,2,155,5309
subtest29of10,pubtest27of10,1,319,5152,23,174,5349
subtest25of10,pubtest27of10,1,319,5152,24,213,5389
subtest21of10,pubtest27of10,1,319,5152,26,252,5430
subtest26of10,pubtest27of10,1,319,5152,25,291,5468
subtest210of10,pubtest27of10,1,319,5152,23,330,5505
subtest22of10,pubtest27of10,1,319,5152,25,369,5546
subtest27of10,pubtest28of10,1,320,5098,-2,43,5139
subtest21of10,pubtest28of10,1,320,5098,-2,81,5177
subtest29of10,pubtest28of10,1,320,5098,0,120,5218
subtest28of10,pubtest28of10,1,320,5098,1,160,5259
subtest23of10,pubtest28of10,1,320,5098,8,192,5298
subtest210of10,pubtest28of10,1,320,5098,16,224,5338
subtest25of10,pubtest28of10,1,320,5098,17,263,5378
subtest26of10,pubtest28of10,1,320,5098,18,302,5418
subtest24of10,pubtest28of10,1,320,5098,18,341,5457
subtest22of10,pubtest28of10,1,320,5098,20,380,5498
subtest23of10,pubtest29of10,1,320,5146,-3,41,5184
subtest210of10,pubtest29of10,1,320,5146,-1,79,5224
subtest29of10,pubtest29of10,1,320,5146,1,116,5263
subtest22of10,pubtest29of10,1,320,5146,3,154,5303
subtest28of10,pubtest29of10,1,320,5146,4,192,5342
subtest25of10,pubtest29of10,1,320,5146,3,231,5380
subtest21of10,pubtest29of10,1,320,5146,9,267,5422
subtest26of10,pubtest29of10,1,320,5146,11,305,5462
subtest27of10,pubtest29of10,1,320,5146,11,345,5502
subtest24of10,pubtest29of10,1,320,5146,9,384,5539
subtest29of10,pubtest210of10,1,322,5545,-4,40,5581
subtest21of10,pubtest210of10,1,322,5545,-2,77,5620
subtest210of10,pubtest210of10,1,322,5545,5,110,5660
subtest27of10,pubtest210of10,1,322,5545,5,149,5699
subtest28of10,pubtest210of10,1,322,5545,7,188,5740
subtest24of10,pubtest210of10,1,322,5545,7,228,5780
subtest23of10,pubtest210of10,1,322,5545,9,266,5820
subtest22of10,pubtest210of10,1,322,5545,10,305,5860
subtest25of10,pubtest210of10,1,322,5545,10,345,5900
subtest26of10,pubtest210of10,1,322,5545,12,493,6050
subtest24of10,pubtest21of10,1,321,10135,1,41,10177
subtest25of10,pubtest21of10,1,321,10135,2,80,10217
subtest26of10,pubtest21of10,1,321,10135,0,120,10255
subtest29of10,pubtest21of10,1,321,10135,1,159,10295
subtest27of10,pubtest21of10,1,321,10135,4,197,10336
subtest210of10,pubtest21of10,1,321,10135,4,698,10837
subtest28of10,pubtest21of10,1,321,10135,7,695,10837
subtest21of10,pubtest21of10,1,321,10135,7,734,10876
subtest23of10,pubtest21of10,1,321,10135,10,771,10916
subtest22of10,pubtest21of10,1,321,10135,10,811,10956
subtest27of10,pubtest22of10,1,320,5227,7,40,5274
subtest24of10,pubtest22of10,1,320,5227,6,80,5313
subtest29of10,pubtest22of10,1,320,5227,6,118,5351
subtest28of10,pubtest22of10,1,320,5227,9,156,5392
subtest23of10,pubtest22of10,1,320,5227,9,196,5432
subtest21of10,pubtest22of10,1,320,5227,13,232,5472
subtest22of10,pubtest22of10,1,320,5227,14,272,5513
subtest26of10,pubtest22of10,1,320,5227,11,311,5549
subtest210of10,pubtest22of10,1,320,5227,13,351,5591
subtest25of10,pubtest22of10,1,320,5227,15,390,5632
subtest23of10,pubtest23of10,1,320,5152,-3,40,5189
subtest28of10,pubtest23of10,1,320,5152,-2,78,5228
subtest29of10,pubtest23of10,1,320,5152,0,116,5268
subtest24of10,pubtest23of10,1,320,5152,6,151,5309
subtest27of10,pubtest23of10,1,320,5152,7,189,5348
subtest26of10,pubtest23of10,1,320,5152,8,228,5388
subtest25of10,pubtest23of10,1,320,5152,10,267,5429
subtest21of10,pubtest23of10,1,320,5152,17,299,5468
subtest22of10,pubtest23of10,1,320,5152,18,338,5508
subtest210of10,pubtest23of10,1,320,5152,19,377,5548
subtest23of10,pubtest24of10,1,320,5203,-4,40,5239
subtest24of10,pubtest24of10,1,320,5203,-4,79,5278
subtest28of10,pubtest24of10,1,320,5203,0,114,5317
subtest22of10,pubtest24of10,1,320,5203,2,152,5357
subtest25of10,pubtest24of10,1,320,5203,2,192,5397
subtest29of10,pubtest24of10,1,320,5203,4,230,5437
subtest210of10,pubtest24of10,1,320,5203,4,270,5477
subtest21of10,pubtest24of10,1,320,5203,4,308,5515
subtest26of10,pubtest24of10,1,320,5203,8,346,5557
subtest27of10,pubtest24of10,1,320,5203,6,387,5596
subtest28of10,pubtest25of10,1,320,5150,-3,42,5189
subtest21of10,pubtest25of10,1,320,5150,-1,78,5227
subtest27of10,pubtest25of10,1,320,5150,2,115,5267
subtest210of10,pubtest25of10,1,320,5150,3,154,5307
subtest26of10,pubtest25of10,1,320,5150,6,190,5346
subtest22of10,pubtest25of10,1,320,5150,7,230,5387
subtest25of10,pubtest25of10,1,320,5150,8,269,5427
subtest29of10,pubtest25of10,1,320,5150,11,306,5467
subtest23of10,pubtest25of10,1,320,5150,12,345,5507
subtest24of10,pubtest25of10,1,320,5150,13,384,5547
subtest21of10,pubtest26of10,1,320,5198,-2,38,5234
subtest22of10,pubtest26of10,1,320,5198,-3,77,5272
subtest29of10,pubtest26of10,1,320,5198,0,114,5312
subtest23of10,pubtest26of10,1,320,5198,2,153,5353
subtest26of10,pubtest26of10,1,320,5198,2,190,5390
subtest210of10,pubtest26of10,1,320,5198,5,230,5433
subtest27of10,pubtest26of10,1,320,5198,6,269,5473
subtest28of10,pubtest26of10,1,320,5198,24,291,5513
subtest25of10,pubtest26of10,1,320,5198,25,330,5553
subtest24of10,pubtest26of10,1,320,5198,26,369,5593
subtest27of10,pubtest27of10,1,319,5160,2,46,5208
subtest28of10,pubtest27of10,1,319,5160,3,83,5246
subtest23of10,pubtest27of10,1,319,5160,6,121,5287
subtest29of10,pubtest27of10,1,319,5160,16,151,5327
subtest24of10,pubtest27of10,1,319,5160,16,191,5367
subtest210of10,pubtest27of10,1,319,5160,17,229,5406
subtest22of10,pubtest27of10,1,319,5160,18,269,5447
subtest21of10,pubtest27of10,1,319,5160,19,308,5487
subtest25of10,pubtest27of10,1,319,5160,19,348,5527
subtest26of10,pubtest27of10,1,319,5160,24,383,5567
subtest28of10,pubtest28of10,1,320,5162,4,42,5208
subtest27of10,pubtest28of10,1,320,5162,4,82,5248
subtest29of10,pubtest28of10,1,320,5162,6,120,5288
subtest210of10,pubtest28of10,1,320,5162,6,160,5328
subtest26of10,pubtest28of10,1,320,5162,8,198,5368
subtest23of10,pubtest28of10,1,320,5162,7,238,5407
subtest25of10,pubtest28of10,1,320,5162,7,278,5447
subtest24of10,pubtest28of10,1,320,5162,10,317,5489
subtest22of10,pubtest28of10,1,320,5162,10,354,5526
subtest21of10,pubtest28of10,1,320,5162,8,394,5564
subtest23of10,pubtest29of10,1,320,5192,-2,41,5231
subtest210of10,pubtest29of10,1,320,5192,-1,80,5271
subtest29of10,pubtest29of10,1,320,5192,2,116,5310
subtest22of10,pubtest29of10,1,320,5192,2,156,5350
subtest21of10,pubtest29of10,1,320,5192,8,190,5390
subtest28of10,pubtest29of10,1,320,5192,8,228,5428
subtest24of10,pubtest29of10,1,320,5192,10,268,5470
subtest27of10,pubtest29of10,1,320,5192,12,306,5510
subtest25of10,pubtest29of10,1,320,5192,8,346,5546
subtest26of10,pubtest29of10,1,320,5192,12,385,5589
subtest29of10,pubtest210of10,1,322,5184,1,41,5226
subtest21of10,pubtest210of10,1,322,5184,1,80,5265
subtest28of10,pubtest210of10,1,322,5184,3,115,5302
subtest27of10,pubtest210of10,1,322,5184,3,155,5342
subtest210of10,pubtest210of10,1,322,5184,3,194,5381
subtest23of10,pubtest210of10,1,322,5184,5,234,5423
subtest25of10,pubtest210of10,1,322,5184,5,272,5461
subtest24of10,pubtest210of10,1,322,5184,5,313,5502
subtest22of10,pubtest210of10,1,322,5184,11,350,5545
subtest26of10,pubtest210of10,1,322,5184,12,389,5585
subtest27of10,pubtest21of10,10,1483,10153,11,41,10205
subtest26of10,pubtest21of10,10,1483,10153,13,79,10245
subtest24of10,pubtest21of10,10,1483,10153,14,118,10285
subtest29of10,pubtest21of10,10,1483,10153,16,156,10325
subtest25of10,pubtest21of10,10,1483,10153,18,192,10363
subtest21of10,pubtest21of10,10,1483,10153,21,231,10405
subtest210of10,pubtest21of10,10,1483,10153,22,269,10444
subtest22of10,pubtest21of10,10,1483,10153,24,308,10485
subtest28of10,pubtest21of10,10,1483,10153,25,347,10525
subtest23of10,pubtest21of10,10,1483,10153,29,383,10565
subtest29of10,pubtest22of10,10,1482,5510,2,46,5558
subtest24of10,pubtest22of10,10,1482,5510,3,83,5596
subtest27of10,pubtest22of10,10,1482,5510,5,119,5634
subtest28of10,pubtest22of10,10,1482,5510,6,157,5673
subtest26of10,pubtest22of10,10,1482,5510,19,188,5717
subtest23of10,pubtest22of10,10,1482,5510,28,219,5757
subtest25of10,pubtest22of10,10,1482,5510,29,257,5796
subtest210of10,pubtest22of10,10,1482,5510,31,296,5837
subtest21of10,pubtest22of10,10,1482,5510,34,333,5877
subtest22of10,pubtest22of10,10,1482,5510,37,370,5917
subtest23of10,pubtest23of10,10,1482,5335,12,44,5391
subtest29of10,pubtest23of10,10,1482,5335,13,79,5427
subtest27of10,pubtest23of10,10,1482,5335,16,118,5469
subtest25of10,pubtest23of10,10,1482,5335,18,156,5509
subtest21of10,pubtest23of10,10,1482,5335,21,192,5548
subtest28of10,pubtest23of10,10,1482,5335,25,229,5589
subtest24of10,pubtest23of10,10,1482,5335,27,267,5629
subtest26of10,pubtest23of10,10,1482,5335,31,303,5669
subtest22of10,pubtest23of10,10,1482,5335,34,340,5709
subtest210of10,pubtest23of10,10,1482,5335,35,379,5749
subtest23of10,pubtest24of10,10,1482,5472,3,40,5515
subtest24of10,pubtest24of10,10,1482,5472,7,77,5556
subtest28of10,pubtest24of10,10,1482,5472,17,107,5596
subtest25of10,pubtest24of10,10,1482,5472,30,133,5635
subtest22of10,pubtest24of10,10,1482,5472,36,168,5676
subtest21of10,pubtest24of10,10,1482,5472,36,208,5716
subtest29of10,pubtest24of10,10,1482,5472,38,246,5756
subtest210of10,pubtest24of10,10,1482,5472,39,284,5795
subtest27of10,pubtest24of10,10,1482,5472,41,323,5836
subtest26of10,pubtest24of10,10,1482,5472,42,362,5876
subtest28of10,pubtest25of10,10,1482,5401,0,41,5442
subtest210of10,pubtest25of10,10,1482,5401,14,65,5480
subtest21of10,pubtest25of10,10,1482,5401,14,105,5520
subtest27of10,pubtest25of10,10,1482,5401,17,142,5560
subtest26of10,pubtest25of10,10,1482,5401,19,179,5599
subtest25of10,pubtest25of10,10,1482,5401,20,219,5640
subtest23of10,pubtest25of10,10,1482,5401,22,257,5680
subtest22of10,pubtest25of10,10,1482,5401,23,296,5720
subtest29of10,pubtest25of10,10,1482,5401,24,334,5759
subtest24of10,pubtest25of10,10,1482,5401,26,373,5800
subtest21of10,pubtest26of10,10,1482,5305,5,39,5349
subtest22of10,pubtest26of10,10,1482,5305,13,70,5388
subtest29of10,pubtest26of10,10,1482,5305,23,99,5427
subtest23of10,pubtest26of10,10,1482,5305,29,134,5468
subtest26of10,pubtest26of10,10,1482,5305,32,170,5507
subtest210of10,pubtest26of10,10,1482,5305,43,200,5548
subtest27of10,pubtest26of10,10,1482,5305,46,237,5588
subtest28of10,pubtest26of10,10,1482,5305,63,260,5628
subtest24of10,pubtest26of10,10,1482,5305,65,296,5666
subtest25of10,pubtest26of10,10,1482,5305,67,335,5707
subtest28of10,pubtest27of10,10,1481,5295,8,41,5344
subtest27of10,pubtest27of10,10,1481,5295,9,78,5382
subtest23of10,pubtest27of10,10,1481,5295,11,116,5422
subtest24of10,pubtest27of10,10,1481,5295,12,155,5462
subtest29of10,pubtest27of10,10,1481,5295,37,170,5502
subtest210of10,pubtest27of10,10,1481,5295,38,208,5541
subtest25of10,pubtest27of10,10,1481,5295,39,246,5580
subtest22of10,pubtest27of10,10,1481,5295,60,266,5621
subtest26of10,pubtest27of10,10,1481,5295,62,304,5661
subtest21of10,pubtest27of10,10,1481,5295,69,338,5702
subtest27of10,pubtest28of10,10,1480,5295,3,45,5343
subtest28of10,pubtest28of10,10,1480,5295,7,80,5382
subtest21of10,pubtest28of10,10,1480,5295,12,115,5422
subtest29of10,pubtest28of10,10,1480,5295,16,150,5461
subtest23of10,pubtest28of10,10,1480,5295,27,180,5502
subtest25of10,pubtest28of10,10,1480,5295,30,216,5541
subtest210of10,pubtest28of10,10,1480,5295,42,244,5581
subtest26of10,pubtest28of10,10,1480,5295,43,284,5622
subtest24of10,pubtest28of10,10,1480,5295,47,319,5661
subtest22of10,pubtest28of10,10,1480,5295,54,353,5702
subtest23of10,pubtest29of10,10,1482,5316,3,42,5361
subtest29of10,pubtest29of10,10,1482,5316,4,79,5399
subtest25of10,pubtest29of10,10,1482,5316,6,117,5439
subtest21of10,pubtest29of10,10,1482,5316,9,153,5478
subtest27of10,pubtest29of10,10,1482,5316,18,186,5520
subtest210of10,pubtest29of10,10,1482,5316,20,223,5559
subtest22of10,pubtest29of10,10,1482,5316,24,260,5600
subtest28of10,pubtest29of10,10,1482,5316,25,299,5640
subtest24of10,pubtest29of10,10,1482,5316,27,336,5679
subtest26of10,pubtest29of10,10,1482,5316,28,375,5719
subtest29of10,pubtest210of10,10,1493,5329,9,45,5383
subtest21of10,pubtest210of10,10,1493,5329,20,69,5418
subtest210of10,pubtest210of10,10,1493,5329,22,109,5460
subtest27of10,pubtest210of10,10,1493,5329,24,147,5500
subtest28of10,pubtest210of10,10,1493,5329,26,185,5540
subtest24of10,pubtest210of10,10,1493,5329,27,224,5580
subtest23of10,pubtest210of10,10,1493,5329,28,263,5620
subtest22of10,pubtest210of10,10,1493,5329,31,300,5660
subtest25of10,pubtest210of10,10,1493,5329,35,336,5700
subtest26of10,pubtest210of10,10,1493,5329,37,374,5740
subtest27of10,pubtest21of10,10,1483,10414,8,41,10463
subtest26of10,pubtest21of10,10,1483,10414,9,80,10503
subtest24of10,pubtest21of10,10,1483,10414,14,115,10543
subtest29of10,pubtest21of10,10,1483,10414,15,154,10583
subtest25of10,pubtest21of10,10,1483,10414,17,193,10624
subtest21of10,pubtest21of10,10,1483,10414,18,232,10664
subtest210of10,pubtest21of10,10,1483,10414,20,269,10703
subtest28of10,pubtest21of10,10,1483,10414,21,308,10743
subtest22of10,pubtest21of10,10,1483,10414,22,347,10783
subtest23of10,pubtest21of10,10,1483,10414,24,386,10824
subtest29of10,pubtest22of10,10,1482,5360,63,40,5463
subtest24of10,pubtest22of10,10,1482,5360,148,39,5547
subtest27of10,pubtest22of10,10,1482,5360,228,39,5627
subtest28of10,pubtest22of10,10,1482,5360,230,77,5667
subtest26of10,pubtest22of10,10,1482,5360,237,110,5707
subtest210of10,pubtest22of10,10,1482,5360,445,42,5847
subtest23of10,pubtest22of10,10,1482,5360,461,66,5887
subtest25of10,pubtest22of10,10,1482,5360,482,84,5926
subtest22of10,pubtest22of10,10,1482,5360,484,123,5967
subtest21of10,pubtest22of10,10,1482,5360,496,151,6007
subtest23of10,pubtest23of10,10,1482,5087,7,45,5139
subtest28of10,pubtest23of10,10,1482,5087,17,76,5180
subtest29of10,pubtest23of10,10,1482,5087,18,114,5219
subtest24of10,pubtest23of10,10,1482,5087,20,153,5260
subtest27of10,pubtest23of10,10,1482,5087,24,188,5299
subtest25of10,pubtest23of10,10,1482,5087,29,224,5340
subtest26of10,pubtest23of10,10,1482,5087,32,261,5380
subtest22of10,pubtest23of10,10,1482,5087,35,297,5419
subtest21of10,pubtest23of10,10,1482,5087,36,336,5459
subtest210of10,pubtest23of10,10,1482,5087,37,376,5500
subtest23of10,pubtest24of10,10,1482,5258,0,40,5298
subtest24of10,pubtest24of10,10,1482,5258,3,77,5338
subtest28of10,pubtest24of10,10,1482,5258,8,112,5378
subtest25of10,pubtest24of10,10,1482,5258,17,143,5418
subtest22of10,pubtest24of10,10,1482,5258,18,179,5455
subtest21of10,pubtest24of10,10,1482,5258,20,219,5497
subtest210of10,pubtest24of10,10,1482,5258,25,255,5538
subtest29of10,pubtest24of10,10,1482,5258,25,294,5577
subtest27of10,pubtest24of10,10,1482,5258,28,332,5618
subtest26of10,pubtest24of10,10,1482,5258,30,370,5658
subtest28of10,pubtest25of10,10,1482,5180,0,41,5221
subtest210of10,pubtest25of10,10,1482,5180,2,78,5260
subtest21of10,pubtest25of10,10,1482,5180,4,116,5300
subtest26of10,pubtest25of10,10,1482,5180,9,151,5340
subtest27of10,pubtest25of10,10,1482,5180,14,186,5380
subtest22of10,pubtest25of10,10,1482,5180,20,220,5420
subtest25of10,pubtest25of10,10,1482,5180,23,257,5460
subtest23of10,pubtest25of10,10,1482,5180,24,296,5500
subtest29of10,pubtest25of10,10,1482,5180,29,330,5539
subtest24of10,pubtest25of10,10,1482,5180,31,368,5579
subtest22of10,pubtest26of10,10,1482,5157,6,40,5203
subtest29of10,pubtest26of10,10,1482,5157,8,78,5243
subtest21of10,pubtest26of10,10,1482,5157,5,118,5280
subtest23of10,pubtest26of10,10,1482,5157,22,144,5323
subtest210of10,pubtest26of10,10,1482,5157,24,181,5362
subtest26of10,pubtest26of10,10,1482,5157,23,221,5401
subtest28of10,pubtest26of10,10,1482,5157,28,258,5443
subtest27of10,pubtest26of10,10,1482,5157,29,297,5483
subtest24of10,pubtest26of10,10,1482,5157,31,335,5523
subtest25of10,pubtest26of10,10,1482,5157,31,375,5563
subtest28of10,pubtest27of10,10,1481,5163,-2,41,5202
subtest27of10,pubtest27of10,10,1481,5163,1,79,5243
subtest23of10,pubtest27of10,10,1481,5163,5,114,5282
subtest24of10,pubtest27of10,10,1481,5163,7,152,5322
subtest29of10,pubtest27of10,10,1481,5163,13,186,5362
subtest210of10,pubtest27of10,10,1481,5163,18,221,5402
subtest25of10,pubtest27of10,10,1481,5163,25,254,5442
subtest22of10,pubtest27of10,10,1481,5163,27,291,5481
subtest26of10,pubtest27of10,10,1481,5163,29,329,5521
subtest21of10,pubtest27of10,10,1481,5163,34,365,5562
subtest27of10,pubtest28of10,10,1480,5306,4,44,5354
subtest21of10,pubtest28of10,10,1480,5306,6,81,5393
subtest28of10,pubtest28of10,10,1480,5306,8,120,5434
subtest29of10,pubtest28of10,10,1480,5306,9,158,5473
subtest210of10,pubtest28of10,10,1480,5306,19,189,5514
subtest23of10,pubtest28of10,10,1480,5306,27,221,5554
subtest26of10,pubtest28of10,10,1480,5306,33,255,5594
subtest25of10,pubtest28of10,10,1480,5306,35,293,5634
subtest24of10,pubtest28of10,10,1480,5306,38,329,5673
subtest22of10,pubtest28of10,10,1480,5306,39,369,5714
subtest23of10,pubtest29of10,10,1482,5110,2,99,5211
subtest210of10,pubtest29of10,10,1482,5110,4,136,5250
subtest22of10,pubtest29of10,10,1482,5110,19,161,5290
subtest29of10,pubtest29of10,10,1482,5110,22,198,5330
subtest25of10,pubtest29of10,10,1482,5110,23,237,5370
subtest28of10,pubtest29of10,10,1482,5110,26,274,5410
subtest27of10,pubtest29of10,10,1482,5110,30,310,5450
subtest21of10,pubtest29of10,10,1482,5110,27,350,5487
subtest26of10,pubtest29of10,10,1482,5110,32,388,5530
subtest24of10,pubtest29of10,10,1482,5110,32,428,5570
subtest29of10,pubtest210of10,10,1493,5089,0,43,5132
subtest21of10,pubtest210of10,10,1493,5089,17,64,5170
subtest27of10,pubtest210of10,10,1493,5089,20,101,5210
subtest210of10,pubtest210of10,10,1493,5089,21,138,5248
subtest28of10,pubtest210of10,10,1493,5089,25,176,5290
subtest23of10,pubtest210of10,10,1493,5089,31,210,5330
subtest24of10,pubtest210of10,10,1493,5089,35,245,5369
subtest25of10,pubtest210of10,10,1493,5089,37,283,5409
subtest22of10,pubtest210of10,10,1493,5089,38,323,5450
subtest26of10,pubtest210of10,10,1493,5089,40,361,5490
subtest26of10,pubtest21of10,10,1483,10421,10,39,10470
subtest24of10,pubtest21of10,10,1483,10421,12,75,10508
subtest25of10,pubtest21of10,10,1483,10421,15,115,10551
subtest21of10,pubtest21of10,10,1483,10421,17,152,10590
subtest27of10,pubtest21of10,10,1483,10421,12,192,10625
subtest29of10,pubtest21of10,10,1483,10421,17,233,10671
subtest28of10,pubtest21of10,10,1483,10421,20,270,10711
subtest210of10,pubtest21of10,10,1483,10421,20,310,10751
subtest23of10,pubtest21of10,10,1483,10421,22,349,10792
subtest22of10,pubtest21of10,10,1483,10421,29,381,10831
subtest29of10,pubtest22of10,10,1482,5098,8,46,5152
subtest24of10,pubtest22of10,10,1482,5098,12,81,5191
subtest27of10,pubtest22of10,10,1482,5098,13,119,5230
subtest28of10,pubtest22of10,10,1482,5098,16,157,5271
subtest26of10,pubtest22of10,10,1482,5098,17,196,5311
subtest210of10,pubtest22of10,10,1482,5098,26,227,5351
subtest23of10,pubtest22of10,10,1482,5098,29,264,5391
subtest25of10,pubtest22of10,10,1482,5098,31,302,5431
subtest21of10,pubtest22of10,10,1482,5098,46,327,5471
subtest22of10,pubtest22of10,10,1482,5098,47,366,5511
subtest23of10,pubtest23of10,10,1482,5152,4,44,5200
subtest28of10,pubtest23of10,10,1482,5152,6,80,5238
subtest24of10,pubtest23of10,10,1482,5152,9,117,5278
subtest29of10,pubtest23of10,10,1482,5152,12,154,5318
subtest27of10,pubtest23of10,10,1482,5152,21,184,5357
subtest26of10,pubtest23of10,10,1482,5152,23,223,5398
subtest25of10,pubtest23of10,10,1482,5152,37,249,5438
subtest22of10,pubtest23of10,10,1482,5152,44,282,5478
subtest21of10,pubtest23of10,10,1482,5152,46,317,5515
subtest210of10,pubtest23of10,10,1482,5152,50,356,5558
subtest24of10,pubtest24of10,10,1482,5179,6,40,5225
subtest23of10,pubtest24of10,10,1482,5179,8,79,5266
subtest28of10,pubtest24of10,10,1482,5179,10,117,5306
subtest25of10,pubtest24of10,10,1482,5179,29,138,5346
subtest21of10,pubtest24of10,10,1482,5179,34,173,5386
subtest22of10,pubtest24of10,10,1482,5179,67,178,5424
subtest29of10,pubtest24of10,10,1482,5179,70,217,5466
subtest210of10,pubtest24of10,10,1482,5179,72,255,5506
subtest27of10,pubtest24of10,10,1482,5179,73,293,5545
subtest26of10,pubtest24of10,10,1482,5179,100,307,5586
subtest28of10,pubtest25of10,10,1482,5133,0,39,5172
subtest210of10,pubtest25of10,10,1482,5133,4,76,5213
subtest21of10,pubtest25of10,10,1482,5133,18,102,5253
subtest26of10,pubtest25of10,10,1482,5133,22,136,5291
subtest27of10,pubtest25of10,10,1482,5133,28,172,5333
subtest22of10,pubtest25of10,10,1482,5133,38,201,5372
subtest25of10,pubtest25of10,10,1482,5133,58,222,5413
subtest23of10,pubtest25of10,10,1482,5133,69,251,5453
subtest29of10,pubtest25of10,10,1482,5133,76,284,5493
subtest24of10,pubtest25of10,10,1482,5133,80,320,5533
subtest21of10,pubtest26of10,10,1482,5398,1,43,5442
subtest22of10,pubtest26of10,10,1482,5398,4,78,5480
subtest29of10,pubtest26of10,10,1482,5398,11,111,5520
subtest23of10,pubtest26of10,10,1482,5398,14,148,5560
subtest26of10,pubtest26of10,10,1482,5398,16,186,5600
subtest210of10,pubtest26of10,10,1482,5398,17,225,5640
subtest27of10,pubtest26of10,10,1482,5398,20,262,5680
subtest28of10,pubtest26of10,10,1482,5398,33,289,5720
subtest24of10,pubtest26of10,10,1482,5398,34,328,5760
subtest25of10,pubtest26of10,10,1482,5398,35,367,5800
subtest27of10,pubtest27of10,10,1481,5310,0,40,5350
subtest28of10,pubtest27of10,10,1481,5310,5,74,5389
subtest24of10,pubtest27of10,10,1481,5310,7,113,5430
subtest23of10,pubtest27of10,10,1481,5310,9,150,5469
subtest29of10,pubtest27of10,10,1481,5310,19,181,5510
subtest210of10,pubtest27of10,10,1481,5310,19,220,5549
subtest25of10,pubtest27of10,10,1481,5310,28,252,5590
subtest22of10,pubtest27of10,10,1481,5310,34,286,5630
subtest26of10,pubtest27of10,10,1481,5310,35,325,5670
subtest21of10,pubtest27of10,10,1481,5310,37,362,5709
subtest27of10,pubtest28of10,10,1480,5249,3,39,5291
subtest28of10,pubtest28of10,10,1480,5249,6,76,5331
subtest21of10,pubtest28of10,10,1480,5249,11,111,5371
subtest29of10,pubtest28of10,10,1480,5249,13,148,5410
subtest210of10,pubtest28of10,10,1480,5249,24,178,5451
subtest23of10,pubtest28of10,10,1480,5249,30,212,5491
subtest25of10,pubtest28of10,10,1480,5249,31,249,5529
subtest26of10,pubtest28of10,10,1480,5249,37,284,5570
subtest24of10,pubtest28of10,10,1480,5249,39,323,5611
subtest22of10,pubtest28of10,10,1480,5249,40,361,5650
subtest23of10,pubtest29of10,10,1482,5503,0,41,5544
subtest210of10,pubtest29of10,10,1482,5503,20,61,5584
subtest29of10,pubtest29of10,10,1482,5503,21,100,5624
subtest25of10,pubtest29of10,10,1482,5503,24,137,5664
subtest22of10,pubtest29of10,10,1482,5503,25,175,5703
subtest21of10,pubtest29of10,10,1482,5503,28,213,5744
subtest28of10,pubtest29of10,10,1482,5503,28,253,5784
subtest27of10,pubtest29of10,10,1482,5503,30,290,5823
subtest24of10,pubtest29of10,10,1482,5503,41,319,5863
subtest26of10,pubtest29of10,10,1482,5503,44,356,5903
subtest29of10,pubtest210of10,10,1493,5713,-1,41,5753
subtest21of10,pubtest210of10,10,1493,5713,19,62,5794
subtest210of10,pubtest210of10,10,1493,5713,22,99,5834
subtest27of10,pubtest210of10,10,1493,5713,26,135,5874
subtest28of10,pubtest210of10,10,1493,5713,30,171,5914
subtest24of10,pubtest210of10,10,1493,5713,41,199,5953
subtest22of10,pubtest210of10,10,1493,5713,46,235,5994
subtest26of10,pubtest210of10,10,1493,5713,47,274,6034
subtest23of10,pubtest210of10,10,1493,5713,48,313,6074
subtest25of10,pubtest210of10,10,1493,5713,49,351,6113
subtest26of10,pubtest21of10,10,1483,10947,4,42,10993
subtest27of10,pubtest21of10,10,1483,10947,5,81,11033
subtest24of10,pubtest21of10,10,1483,10947,7,119,11073
subtest29of10,pubtest21of10,10,1483,10947,9,157,11113
subtest25of10,pubtest21of10,10,1483,10947,10,196,11153
subtest21of10,pubtest21of10,10,1483,10947,32,214,11193
subtest210of10,pubtest21of10,10,1483,10947,35,251,11233
subtest23of10,pubtest21of10,10,1483,10947,44,282,11273
subtest28of10,pubtest21of10,10,1483,10947,51,314,11312
subtest22of10,pubtest21of10,10,1483,10947,53,353,11353
subtest29of10,pubtest22of10,10,1482,5716,0,41,5757
subtest27of10,pubtest22of10,10,1482,5716,3,76,5795
subtest23of10,pubtest22of10,10,1482,5716,19,100,5835
subtest25of10,pubtest22of10,10,1482,5716,21,138,5875
subtest21of10,pubtest22of10,10,1482,5716,22,177,5915
subtest24of10,pubtest22of10,10,1482,5716,33,206,5955
subtest28of10,pubtest22of10,10,1482,5716,34,245,5995
subtest26of10,pubtest22of10,10,1482,5716,35,283,6034
subtest22of10,pubtest22of10,10,1482,5716,39,320,6075
subtest210of10,pubtest22of10,10,1482,5716,39,360,6115
subtest23of10,pubtest23of10,10,1482,5821,4,430,6255
subtest28of10,pubtest23of10,10,1482,5821,5,470,6296
subtest29of10,pubtest23of10,10,1482,5821,13,502,6336
subtest27of10,pubtest23of10,10,1482,5821,15,540,6376
subtest24of10,pubtest23of10,10,1482,5821,15,580,6416
subtest26of10,pubtest23of10,10,1482,5821,17,616,6454
subtest25of10,pubtest23of10,10,1482,5821,47,628,6496
subtest21of10,pubtest23of10,10,1482,5821,59,655,6535
subtest22of10,pubtest23of10,10,1482,5821,61,694,6576
subtest210of10,pubtest23of10,10,1482,5821,63,731,6615
subtest24of10,pubtest24of10,10,1482,5589,3,44,5636
subtest23of10,pubtest24of10,10,1482,5589,4,80,5673
subtest28of10,pubtest24of10,10,1482,5589,6,119,5714
subtest25of10,pubtest24of10,10,1482,5589,16,148,5753
subtest21of10,pubtest24of10,10,1482,5589,21,184,5794
subtest22of10,pubtest24of10,10,1482,5589,23,222,5834
subtest29of10,pubtest24of10,10,1482,5589,40,245,5874
subtest210of10,pubtest24of10,10,1482,5589,42,283,5914
subtest27of10,pubtest24of10,10,1482,5589,47,317,5953
subtest26of10,pubtest24of10,10,1482,5589,49,356,5994
subtest28of10,pubtest25of10,10,1482,5282,11,41,5334
subtest210of10,pubtest25of10,10,1482,5282,14,80,5376
subtest21of10,pubtest25of10,10,1482,5282,17,117,5416
subtest27of10,pubtest25of10,10,1482,5282,19,155,5456
subtest26of10,pubtest25of10,10,1482,5282,21,193,5496
subtest25of10,pubtest25of10,10,1482,5282,27,227,5536
subtest22of10,pubtest25of10,10,1482,5282,28,265,5575
subtest23of10,pubtest25of10,10,1482,5282,34,301,5617
subtest29of10,pubtest25of10,10,1482,5282,49,325,5656
subtest24of10,pubtest25of10,10,1482,5282,51,363,5696
subtest21of10,pubtest26of10,10,1482,5358,9,40,5407
subtest22of10,pubtest26of10,10,1482,5358,10,78,5446
subtest29of10,pubtest26of10,10,1482,5358,19,109,5486
subtest23of10,pubtest26of10,10,1482,5358,21,148,5527
subtest26of10,pubtest26of10,10,1482,5358,22,187,5567
subtest210of10,pubtest26of10,10,1482,5358,24,225,5607
subtest28of10,pubtest26of10,10,1482,5358,29,260,5647
subtest27of10,pubtest26of10,10,1482,5358,30,298,5686
subtest24of10,pubtest26of10,10,1482,5358,31,338,5727
subtest25of10,pubtest26of10,10,1482,5358,34,375,5767
subtest27of10,pubtest27of10,10,1481,5195,7,309,5511
subtest28of10,pubtest27of10,10,1481,5195,7,345,5547
subtest23of10,pubtest27of10,10,1481,5195,10,382,5587
subtest24of10,pubtest27of10,10,1481,5195,11,422,5628
subtest29of10,pubtest27of10,10,1481,5195,18,455,5668
subtest210of10,pubtest27of10,10,1481,5195,42,471,5708
subtest25of10,pubtest27of10,10,1481,5195,50,502,5747
subtest22of10,pubtest27of10,10,1481,5195,58,534,5787
subtest26of10,pubtest27of10,10,1481,5195,61,572,5828
subtest21of10,pubtest27of10,10,1481,5195,66,607,5868
subtest27of10,pubtest28of10,10,1480,5154,4,43,5201
subtest28of10,pubtest28of10,10,1480,5154,9,75,5238
subtest21of10,pubtest28of10,10,1480,5154,36,88,5278
subtest29of10,pubtest28of10,10,1480,5154,40,125,5319
subtest23of10,pubtest28of10,10,1480,5154,45,159,5358
subtest210of10,pubtest28of10,10,1480,5154,52,193,5399
subtest26of10,pubtest28of10,10,1480,5154,53,232,5439
subtest25of10,pubtest28of10,10,1480,5154,63,261,5478
subtest24of10,pubtest28of10,10,1480,5154,65,300,5519
subtest22of10,pubtest28of10,10,1480,5154,73,332,5559
subtest23of10,pubtest29of10,10,1482,5232,5,39,5276
subtest210of10,pubtest29of10,10,1482,5232,16,65,5313
subtest22of10,pubtest29of10,10,1482,5232,20,103,5355
subtest25of10,pubtest29of10,10,1482,5232,19,141,5392
subtest29of10,pubtest29of10,10,1482,5232,19,181,5432
subtest21of10,pubtest29of10,10,1482,5232,25,218,5475
subtest28of10,pubtest29of10,10,1482,5232,28,255,5515
subtest24of10,pubtest29of10,10,1482,5232,30,292,5554
subtest27of10,pubtest29of10,10,1482,5232,29,332,5593
subtest26of10,pubtest29of10,10,1482,5232,33,369,5634
subtest29of10,pubtest210of10,10,1493,5182,-1,39,5220
subtest21of10,pubtest210of10,10,1493,5182,39,43,5264
subtest210of10,pubtest210of10,10,1493,5182,40,82,5304
subtest27of10,pubtest210of10,10,1493,5182,41,120,5343
subtest28of10,pubtest210of10,10,1493,5182,43,159,5384
subtest24of10,pubtest210of10,10,1493,5182,44,197,5423
subtest22of10,pubtest210of10,10,1493,5182,45,236,5463
subtest26of10,pubtest210of10,10,1493,5182,47,275,5504
subtest23of10,pubtest210of10,10,1493,5182,50,311,5543
subtest25of10,pubtest210of10,10,1493,5182,51,349,5582
subtest27of10,pubtest21of10,10,1483,10197,-2,40,10235
subtest26of10,pubtest21of10,10,1483,10197,5,74,10276
subtest24of10,pubtest21of10,10,1483,10197,12,107,10316
subtest29of10,pubtest21of10,10,1483,10197,13,146,10356
subtest21of10,pubtest21of10,10,1483,10197,16,183,10396
subtest25of10,pubtest21of10,10,1483,10197,15,223,10435
subtest210of10,pubtest21of10,10,1483,10197,18,261,10476
subtest28of10,pubtest21of10,10,1483,10197,26,291,10514
subtest22of10,pubtest21of10,10,1483,10197,29,329,10555
subtest23of10,pubtest21of10,10,1483,10197,33,365,10595
subtest29of10,pubtest22of10,10,1482,5245,-2,41,5284
subtest24of10,pubtest22of10,10,1482,5245,3,75,5323
subtest27of10,pubtest22of10,10,1482,5245,10,108,5363
subtest23of10,pubtest22of10,10,1482,5245,12,146,5403
subtest28of10,pubtest22of10,10,1482,5245,24,174,5443
subtest25of10,pubtest22of10,10,1482,5245,31,206,5482
subtest26of10,pubtest22of10,10,1482,5245,37,241,5523
subtest21of10,pubtest22of10,10,1482,5245,38,280,5563
subtest210of10,pubtest22of10,10,1482,5245,45,313,5603
subtest22of10,pubtest22of10,10,1482,5245,46,352,5643
subtest23of10,pubtest23of10,10,1482,5181,12,44,5237
subtest28of10,pubtest23of10,10,1482,5181,14,82,5277
subtest29of10,pubtest23of10,10,1482,5181,15,120,5316
subtest24of10,pubtest23of10,10,1482,5181,18,158,5357
subtest27of10,pubtest23of10,10,1482,5181,20,196,5397
subtest25of10,pubtest23of10,10,1482,5181,21,234,5436
subtest26of10,pubtest23of10,10,1482,5181,23,273,5477
subtest22of10,pubtest23of10,10,1482,5181,50,286,5517
subtest21of10,pubtest23of10,10,1482,5181,53,323,5557
subtest210of10,pubtest23of10,10,1482,5181,56,360,5597
subtest23of10,pubtest24of10,10,1482,5310,1,42,5353
subtest24of10,pubtest24of10,10,1482,5310,3,81,5394
subtest28of10,pubtest24of10,10,1482,5310,4,119,5433
subtest25of10,pubtest24of10,10,1482,5310,25,139,5474
subtest21of10,pubtest24of10,10,1482,5310,26,178,5514
subtest22of10,pubtest24of10,10,1482,5310,27,217,5554
subtest210of10,pubtest24of10,10,1482,5310,29,255,5594
subtest29of10,pubtest24of10,10,1482,5310,30,294,5634
subtest27of10,pubtest24of10,10,1482,5310,31,332,5673
subtest26of10,pubtest24of10,10,1482,5310,34,370,5714
subtest28of10,pubtest25of10,10,1482,5141,-3,42,5180
subtest210of10,pubtest25of10,10,1482,5141,5,74,5220
subtest21of10,pubtest25of10,10,1482,5141,10,109,5260
subtest26of10,pubtest25of10,10,1482,5141,14,145,5300
subtest27of10,pubtest25of10,10,1482,5141,15,183,5339
subtest25of10,pubtest25of10,10,1482,5141,21,217,5379
subtest23of10,pubtest25of10,10,1482,5141,24,255,5420
subtest29of10,pubtest25of10,10,1482,5141,25,293,5459
subtest22of10,pubtest25of10,10,1482,5141,29,328,5498
subtest24of10,pubtest25of10,10,1482,5141,32,367,5540
subtest22of10,pubtest26of10,10,1482,5528,-2,44,5570
subtest21of10,pubtest26of10,10,1482,5528,5,77,5610
subtest29of10,pubtest26of10,10,1482,5528,21,101,5650
subtest23of10,pubtest26of10,10,1482,5528,22,139,5689
subtest26of10,pubtest26of10,10,1482,5528,27,175,5730
subtest210of10,pubtest26of10,10,1482,5528,31,210,5769
subtest28of10,pubtest26of10,10,1482,5528,32,247,5807
subtest24of10,pubtest26of10,10,1482,5528,35,287,5850
subtest25of10,pubtest26of10,10,1482,5528,37,325,5890
subtest27of10,pubtest26of10,10,1482,5528,40,362,5930
subtest28of10,pubtest27of10,10,1481,5341,3,39,5383
subtest27of10,pubtest27of10,10,1481,5341,5,76,5422
subtest23of10,pubtest27of10,10,1481,5341,7,115,5463
subtest24of10,pubtest27of10,10,1481,5341,10,150,5501
subtest210of10,pubtest27of10,10,1481,5341,17,185,5543
subtest29of10,pubtest27of10,10,1481,5341,19,223,5583
subtest25of10,pubtest27of10,10,1481,5341,25,257,5623
subtest22of10,pubtest27of10,10,1481,5341,29,293,5663
subtest26of10,pubtest27of10,10,1481,5341,34,328,5703
subtest21of10,pubtest27of10,10,1481,5341,35,367,5743
subtest27of10,pubtest28of10,10,1480,5199,-1,42,5240
subtest21of10,pubtest28of10,10,1480,5199,10,68,5277
subtest28of10,pubtest28of10,10,1480,5199,12,107,5318
subtest29of10,pubtest28of10,10,1480,5199,14,146,5359
subtest23of10,pubtest28of10,10,1480,5199,21,179,5399
subtest210of10,pubtest28of10,10,1480,5199,20,219,5438
subtest26of10,pubtest28of10,10,1480,5199,25,259,5483
subtest25of10,pubtest28of10,10,1480,5199,26,297,5522
subtest24of10,pubtest28of10,10,1480,5199,29,335,5563
subtest22of10,pubtest28of10,10,1480,5199,30,373,5602
subtest23of10,pubtest29of10,10,1482,5177,-2,271,5446
subtest29of10,pubtest29of10,10,1482,5177,13,295,5485
subtest210of10,pubtest29of10,10,1482,5177,14,333,5524
subtest25of10,pubtest29of10,10,1482,5177,17,371,5565
subtest22of10,pubtest29of10,10,1482,5177,18,410,5605
subtest28of10,pubtest29of10,10,1482,5177,25,443,5645
subtest21of10,pubtest29of10,10,1482,5177,27,480,5684
subtest27of10,pubtest29of10,10,1482,5177,28,520,5725
subtest24of10,pubtest29of10,10,1482,5177,26,558,5761
subtest26of10,pubtest29of10,10,1482,5177,30,598,5805
subtest29of10,pubtest210of10,10,1493,5354,7,39,5400
subtest21of10,pubtest210of10,10,1493,5354,14,71,5439
subtest210of10,pubtest210of10,10,1493,5354,15,110,5479
subtest27of10,pubtest210of10,10,1493,5354,17,149,5520
subtest23of10,pubtest210of10,10,1493,5354,19,186,5559
subtest25of10,pubtest210of10,10,1493,5354,21,224,5599
subtest28of10,pubtest210of10,10,1493,5354,20,264,5638
subtest24of10,pubtest210of10,10,1493,5354,25,300,5679
subtest22of10,pubtest210of10,10,1493,5354,28,337,5719
subtest26of10,pubtest210of10,10,1493,5354,30,376,5760
subtest26of10,pubtest21of10,10,1483,11675,-2,289,11962
subtest27of10,pubtest21of10,10,1483,11675,13,275,11963
subtest24of10,pubtest21of10,10,1483,11675,14,313,12002
subtest29of10,pubtest21of10,10,1483,11675,16,352,12043
subtest25of10,pubtest21of10,10,1483,11675,16,390,12081
subtest21of10,pubtest21of10,10,1483,11675,19,428,12122
subtest210of10,pubtest21of10,10,1483,11675,20,468,12163
subtest22of10,pubtest21of10,10,1483,11675,22,505,12202
subtest28of10,pubtest21of10,10,1483,11675,22,545,12242
subtest23of10,pubtest21of10,10,1483,11675,24,583,12282
subtest29of10,pubtest22of10,10,1482,5415,-3,40,5452
subtest27of10,pubtest22of10,10,1482,5415,7,70,5492
subtest24of10,pubtest22of10,10,1482,5415,11,107,5533
subtest28of10,pubtest22of10,10,1482,5415,16,142,5573
subtest26of10,pubtest22of10,10,1482,5415,17,181,5613
subtest210of10,pubtest22of10,10,1482,5415,27,211,5653
subtest23of10,pubtest22of10,10,1482,5415,29,248,5692
subtest25of10,pubtest22of10,10,1482,5415,30,288,5733
subtest22of10,pubtest22of10,10,1482,5415,33,325,5773
subtest21of10,pubtest22of10,10,1482,5415,36,362,5813
subtest23of10,pubtest23of10,10,1482,5610,0,45,5655
subtest29of10,pubtest23of10,10,1482,5610,5,79,5694
subtest28of10,pubtest23of10,10,1482,5610,13,110,5733
subtest24of10,pubtest23of10,10,1482,5610,33,131,5774
subtest25of10,pubtest23of10,10,1482,5610,38,166,5814
subtest21of10,pubtest23of10,10,1482,5610,41,203,5854
subtest26of10,pubtest23of10,10,1482,5610,52,232,5894
subtest22of10,pubtest23of10,10,1482,5610,54,270,5934
subtest210of10,pubtest23of10,10,1482,5610,58,306,5974
subtest27of10,pubtest23of10,10,1482,5610,276,127,6013
subtest23of10,pubtest24of10,10,1482,6051,2,43,6096
subtest24of10,pubtest24of10,10,1482,6051,13,70,6134
subtest28of10,pubtest24of10,10,1482,6051,18,105,6174
subtest25of10,pubtest24of10,10,1482,6051,27,136,6214
subtest22of10,pubtest24of10,10,1482,6051,30,173,6254
subtest21of10,pubtest24of10,10,1482,6051,34,208,6293
subtest210of10,pubtest24of10,10,1482,6051,41,242,6334
subtest29of10,pubtest24of10,10,1482,6051,46,277,6374
subtest27of10,pubtest24of10,10,1482,6051,51,311,6413
subtest26of10,pubtest24of10,10,1482,6051,53,349,6453
subtest28of10,pubtest25of10,10,1482,6078,3,39,6120
subtest210of10,pubtest25of10,10,1482,6078,4,77,6159
subtest21of10,pubtest25of10,10,1482,6078,9,113,6200
subtest26of10,pubtest25of10,10,1482,6078,17,143,6238
subtest27of10,pubtest25of10,10,1482,6078,18,182,6278
subtest22of10,pubtest25of10,10,1482,6078,20,221,6319
subtest25of10,pubtest25of10,10,1482,6078,39,242,6359
subtest23of10,pubtest25of10,10,1482,6078,40,282,6400
subtest29of10,pubtest25of10,10,1482,6078,43,319,6440
subtest24of10,pubtest25of10,10,1482,6078,44,358,6480
subtest21of10,pubtest26of10,10,1482,5270,0,40,5310
subtest22of10,pubtest26of10,10,1482,5270,8,70,5348
subtest29of10,pubtest26of10,10,1482,5270,10,110,5390
subtest23of10,pubtest26of10,10,1482,5270,16,144,5430
subtest26of10,pubtest26of10,10,1482,5270,28,171,5469
subtest210of10,pubtest26of10,10,1482,5270,29,211,5510
subtest27of10,pubtest26of10,10,1482,5270,31,249,5550
subtest28of10,pubtest26of10,10,1482,5270,35,285,5590
subtest25of10,pubtest26of10,10,1482,5270,35,324,5629
subtest24of10,pubtest26of10,10,1482,5270,36,363,5669
subtest27of10,pubtest27of10,10,1481,5226,-1,44,5269
subtest28of10,pubtest27of10,10,1481,5226,4,80,5310
subtest23of10,pubtest27of10,10,1481,5226,6,118,5350
subtest24of10,pubtest27of10,10,1481,5226,6,158,5390
subtest29of10,pubtest27of10,10,1481,5226,19,185,5430
subtest210of10,pubtest27of10,10,1481,5226,22,222,5470
subtest25of10,pubtest27of10,10,1481,5226,26,257,5509
subtest22of10,pubtest27of10,10,1481,5226,27,296,5549
subtest21of10,pubtest27of10,10,1481,5226,29,333,5588
subtest26of10,pubtest27of10,10,1481,5226,31,372,5629
subtest27of10,pubtest28of10,10,1480,5611,0,40,5651
subtest21of10,pubtest28of10,10,1480,5611,1,78,5690
subtest28of10,pubtest28of10,10,1480,5611,7,113,5731
subtest29of10,pubtest28of10,10,1480,5611,11,149,5771
subtest210of10,pubtest28of10,10,1480,5611,18,182,5811
subtest23of10,pubtest28of10,10,1480,5611,20,218,5849
subtest26of10,pubtest28of10,10,1480,5611,25,254,5890
subtest25of10,pubtest28of10,10,1480,5611,27,293,5931
subtest24of10,pubtest28of10,10,1480,5611,31,329,5971
subtest22of10,pubtest28of10,10,1480,5611,33,367,6011
subtest23of10,pubtest29of10,10,1482,5451,1,421,5873
subtest210of10,pubtest29of10,10,1482,5451,5,457,5913
subtest29of10,pubtest29of10,10,1482,5451,13,488,5952
subtest22of10,pubtest29of10,10,1482,5451,18,523,5992
subtest25of10,pubtest29of10,10,1482,5451,20,561,6032
subtest28of10,pubtest29of10,10,1482,5451,23,599,6073
subtest24of10,pubtest29of10,10,1482,5451,26,636,6113
subtest21of10,pubtest29of10,10,1482,5451,29,673,6153
subtest27of10,pubtest29of10,10,1482,5451,31,710,6192
subtest26of10,pubtest29of10,10,1482,5451,37,745,6233
subtest29of10,pubtest210of10,10,1493,5328,-2,41,5367
subtest21of10,pubtest210of10,10,1493,5328,0,80,5408
subtest210of10,pubtest210of10,10,1493,5328,19,100,5447
subtest27of10,pubtest210of10,10,1493,5328,22,138,5488
subtest28of10,pubtest210of10,10,1493,5328,23,177,5528
subtest24of10,pubtest210of10,10,1493,5328,24,216,5568
subtest22of10,pubtest210of10,10,1493,5328,25,254,5607
subtest26of10,pubtest210of10,10,1493,5328,27,293,5648
subtest23of10,pubtest210of10,10,1493,5328,28,332,5688
subtest25of10,pubtest210of10,10,1493,5328,29,369,5726
subtest27of10,pubtest21of10,10,1483,10400,-1,41,10440
subtest26of10,pubtest21of10,10,1483,10400,4,77,10481
subtest24of10,pubtest21of10,10,1483,10400,9,112,10521
subtest29of10,pubtest21of10,10,1483,10400,14,147,10561
subtest25of10,pubtest21of10,10,1483,10400,15,185,10600
subtest21of10,pubtest21of10,10,1483,10400,17,222,10639
subtest210of10,pubtest21of10,10,1483,10400,19,260,10679
subtest28of10,pubtest21of10,10,1483,10400,22,298,10720
subtest22of10,pubtest21of10,10,1483,10400,23,338,10761
subtest23of10,pubtest21of10,10,1483,10400,24,376,10800
subtest29of10,pubtest22of10,10,1482,6050,-2,46,6094
subtest24of10,pubtest22of10,10,1482,6050,4,80,6134
subtest28of10,pubtest22of10,10,1482,6050,7,116,6173
subtest27of10,pubtest22of10,10,1482,6050,11,153,6214
subtest26of10,pubtest22of10,10,1482,6050,11,192,6253
subtest210of10,pubtest22of10,10,1482,6050,23,221,6294
subtest23of10,pubtest22of10,10,1482,6050,30,253,6333
subtest25of10,pubtest22of10,10,1482,6050,31,293,6374
subtest22of10,pubtest22of10,10,1482,6050,33,330,6413
subtest21of10,pubtest22of10,10,1482,6050,35,369,6454
subtest23of10,pubtest23of10,10,1482,5900,1,39,5940
subtest29of10,pubtest23of10,10,1482,5900,4,76,5980
subtest28of10,pubtest23of10,10,1482,5900,10,110,6020
subtest27of10,pubtest23of10,10,1482,5900,25,135,6060
subtest24of10,pubtest23of10,10,1482,5900,26,173,6099
subtest25of10,pubtest23of10,10,1482,5900,30,210,6140
subtest26of10,pubtest23of10,10,1482,5900,36,244,6180
subtest22of10,pubtest23of10,10,1482,5900,37,283,6220
subtest21of10,pubtest23of10,10,1482,5900,41,316,6257
subtest210of10,pubtest23of10,10,1482,5900,44,355,6299
subtest24of10,pubtest24of10,10,1482,6644,1,41,6686
subtest23of10,pubtest24of10,10,1482,6644,6,76,6726
subtest28of10,pubtest24of10,10,1482,6644,16,105,6765
subtest22of10,pubtest24of10,10,1482,6644,20,142,6806
subtest25of10,pubtest24of10,10,1482,6644,20,181,6845
subtest21of10,pubtest24of10,10,1482,6644,27,213,6884
subtest210of10,pubtest24of10,10,1482,6644,28,253,6925
subtest29of10,pubtest24of10,10,1482,6644,31,291,6966
subtest27of10,pubtest24of10,10,1482,6644,30,331,7005
subtest26of10,pubtest24of10,10,1482,6644,34,368,7046
subtest28of10,pubtest25of10,10,1482,5379,0,44,5423
subtest210of10,pubtest25of10,10,1482,5379,21,61,5461
subtest21of10,pubtest25of10,10,1482,5379,34,87,5500
subtest26of10,pubtest25of10,10,1482,5379,37,125,5541
subtest27of10,pubtest25of10,10,1482,5379,43,158,5580
subtest22of10,pubtest25of10,10,1482,5379,52,190,5621
subtest25of10,pubtest25of10,10,1482,5379,70,212,5661
subtest23of10,pubtest25of10,10,1482,5379,72,250,5701
subtest29of10,pubtest25of10,10,1482,5379,73,289,5741
subtest24of10,pubtest25of10,10,1482,5379,75,327,5781
subtest21of10,pubtest26of10,10,1482,5998,0,41,6039
subtest22of10,pubtest26of10,10,1482,5998,8,73,6079
subtest29of10,pubtest26of10,10,1482,5998,22,99,6119
subtest23of10,pubtest26of10,10,1482,5998,25,137,6160
subtest26of10,pubtest26of10,10,1482,5998,37,165,6200
subtest210of10,pubtest26of10,10,1482,5998,49,192,6239
subtest28of10,pubtest26of10,10,1482,5998,51,231,6280
subtest27of10,pubtest26of10,10,1482,5998,69,252,6319
subtest24of10,pubtest26of10,10,1482,5998,77,285,6360
subtest25of10,pubtest26of10,10,1482,5998,91,311,6400
subtest27of10,pubtest27of10,10,1481,5324,2,45,5371
subtest28of10,pubtest27of10,10,1481,5324,3,84,5411
subtest23of10,pubtest27of10,10,1481,5324,24,103,5451
subtest24of10,pubtest27of10,10,1481,5324,26,141,5491
subtest29of10,pubtest27of10,10,1481,5324,39,166,5529
subtest25of10,pubtest27of10,10,1481,5324,64,183,5571
subtest210of10,pubtest27of10,10,1481,5324,69,218,5611
subtest22of10,pubtest27of10,10,1481,5324,73,254,5651
subtest26of10,pubtest27of10,10,1481,5324,74,292,5690
subtest21of10,pubtest27of10,10,1481,5324,76,331,5731
subtest27of10,pubtest28of10,10,1480,5242,1,41,5284
subtest21of10,pubtest28of10,10,1480,5242,6,74,5322
subtest28of10,pubtest28of10,10,1480,5242,8,112,5362
subtest29of10,pubtest28of10,10,1480,5242,17,144,5403
subtest210of10,pubtest28of10,10,1480,5242,26,174,5442
subtest23of10,pubtest28of10,10,1480,5242,27,213,5482
subtest26of10,pubtest28of10,10,1480,5242,32,247,5521
subtest25of10,pubtest28of10,10,1480,5242,41,279,5562
subtest24of10,pubtest28of10,10,1480,5242,43,316,5601
subtest22of10,pubtest28of10,10,1480,5242,45,354,5641
subtest23of10,pubtest29of10,10,1482,5380,6,39,5425
subtest210of10,pubtest29of10,10,1482,5380,17,67,5464
subtest29of10,pubtest29of10,10,1482,5380,18,107,5505
subtest22of10,pubtest29of10,10,1482,5380,20,145,5545
subtest25of10,pubtest29of10,10,1482,5380,27,177,5584
subtest28of10,pubtest29of10,10,1482,5380,35,211,5626
subtest21of10,pubtest29of10,10,1482,5380,36,249,5665
subtest24of10,pubtest29of10,10,1482,5380,53,272,5705
subtest26of10,pubtest29of10,10,1482,5380,54,311,5745
subtest27of10,pubtest29of10,10,1482,5380,52,351,5783
subtest29of10,pubtest210of10,10,1493,5737,-3,39,5773
subtest21of10,pubtest210of10,10,1493,5737,0,76,5813
subtest27of10,pubtest210of10,10,1493,5737,5,111,5853
subtest210of10,pubtest210of10,10,1493,5737,10,146,5893
subtest28of10,pubtest210of10,10,1493,5737,24,173,5934
subtest23of10,pubtest210of10,10,1493,5737,27,209,5973
subtest24of10,pubtest210of10,10,1493,5737,30,247,6014
subtest25of10,pubtest210of10,10,1493,5737,29,287,6053
subtest22of10,pubtest210of10,10,1493,5737,37,319,6093
subtest26of10,pubtest210of10,10,1493,5737,39,358,6134
subtest27of10,pubtest21of10,10,1483,11061,3,40,11104
subtest26of10,pubtest21of10,10,1483,11061,7,77,11145
subtest24of10,pubtest21of10,10,1483,11061,9,115,11185
subtest29of10,pubtest21of10,10,1483,11061,11,153,11225
subtest25of10,pubtest21of10,10,1483,11061,14,189,11264
subtest21of10,pubtest21of10,10,1483,11061,18,226,11305
subtest210of10,pubtest21of10,10,1483,11061,29,254,11344
subtest28of10,pubtest21of10,10,1483,11061,31,293,11385
subtest22of10,pubtest21of10,10,1483,11061,32,332,11425
subtest23of10,pubtest21of10,10,1483,11061,41,361,11463
subtest29of10,pubtest22of10,10,1482,5448,-2,40,5486
subtest24of10,pubtest22of10,10,1482,5448,1,76,5525
subtest27of10,pubtest22of10,10,1482,5448,14,103,5565
subtest28of10,pubtest22of10,10,1482,5448,15,142,5605
subtest26of10,pubtest22of10,10,1482,5448,16,180,5644
subtest23of10,pubtest22of10,10,1482,5448,18,219,5685
subtest25of10,pubtest22of10,10,1482,5448,33,243,5724
subtest210of10,pubtest22of10,10,1482,5448,42,275,5765
subtest21of10,pubtest22of10,10,1482,5448,44,313,5805
subtest22of10,pubtest22of10,10,1482,5448,46,351,5845
subtest23of10,pubtest23of10,10,1482,5180,-5,43,5218
subtest28of10,pubtest23of10,10,1482,5180,-2,77,5255
subtest24of10,pubtest23of10,10,1482,5180,6,110,5296
subtest29of10,pubtest23of10,10,1482,5180,12,144,5336
subtest27of10,pubtest23of10,10,1482,5180,13,182,5375
subtest26of10,pubtest23of10,10,1482,5180,13,221,5414
subtest25of10,pubtest23of10,10,1482,5180,19,257,5456
subtest22of10,pubtest23of10,10,1482,5180,22,294,5496
subtest21of10,pubtest23of10,10,1482,5180,26,330,5536
subtest210of10,pubtest23of10,10,1482,5180,29,367,5576
subtest23of10,pubtest24of10,10,1482,5191,0,41,5232
subtest24of10,pubtest24of10,10,1482,5191,4,75,5270
subtest25of10,pubtest24of10,10,1482,5191,18,102,5311
subtest28of10,pubtest24of10,10,1482,5191,20,140,5351
subtest21of10,pubtest24of10,10,1482,5191,22,178,5391
subtest22of10,pubtest24of10,10,1482,5191,22,217,5430
subtest29of10,pubtest24of10,10,1482,5191,25,255,5471
subtest210of10,pubtest24of10,10,1482,5191,28,291,5510
subtest27of10,pubtest24of10,10,1482,5191,29,331,5551
subtest26of10,pubtest24of10,10,1482,5191,31,367,5589
subtest28of10,pubtest25of10,10,1482,5279,-4,40,5315
subtest21of10,pubtest25of10,10,1482,5279,2,74,5355
subtest210of10,pubtest25of10,10,1482,5279,6,110,5395
subtest26of10,pubtest25of10,10,1482,5279,8,148,5435
subtest27of10,pubtest25of10,10,1482,5279,7,187,5473
subtest25of10,pubtest25of10,10,1482,5279,13,221,5513
subtest23of10,pubtest25of10,10,1482,5279,18,258,5555
subtest22of10,pubtest25of10,10,1482,5279,21,295,5595
subtest29of10,pubtest25of10,10,1482,5279,22,333,5634
subtest24of10,pubtest25of10,10,1482,5279,26,370,5675
subtest21of10,pubtest26of10,10,1482,5223,-2,39,5260
subtest22of10,pubtest26of10,10,1482,5223,-2,78,5299
subtest29of10,pubtest26of10,10,1482,5223,13,102,5338
subtest23of10,pubtest26of10,10,1482,5223,23,134,5380
subtest26of10,pubtest26of10,10,1482,5223,24,172,5419
subtest210of10,pubtest26of10,10,1482,5223,25,211,5459
subtest27of10,pubtest26of10,10,1482,5223,30,247,5500
subtest28of10,pubtest26of10,10,1482,5223,31,285,5539
subtest24of10,pubtest26of10,10,1482,5223,32,324,5579
subtest25of10,pubtest26of10,10,1482,5223,33,364,5620
subtest27of10,pubtest27of10,10,1481,5240,-3,42,5279
subtest28of10,pubtest27of10,10,1481,5240,13,65,5318
subtest23of10,pubtest27of10,10,1481,5240,15,103,5358
subtest24of10,pubtest27of10,10,1481,5240,19,138,5397
subtest29of10,pubtest27of10,10,1481,5240,24,174,5438
subtest25of10,pubtest27of10,10,1481,5240,26,212,5478
subtest210of10,pubtest27of10,10,1481,5240,25,252,5517
subtest22of10,pubtest27of10,10,1481,5240,28,288,5556
subtest21of10,pubtest27of10,10,1481,5240,28,328,5596
subtest26of10,pubtest27of10,10,1481,5240,28,366,5634
subtest27of10,pubtest28of10,10,1480,5204,-3,41,5242
subtest21of10,pubtest28of10,10,1480,5204,1,75,5280
subtest28of10,pubtest28of10,10,1480,5204,13,104,5321
subtest29of10,pubtest28of10,10,1480,5204,18,139,5361
subtest210of10,pubtest28of10,10,1480,5204,31,164,5399
subtest26of10,pubtest28of10,10,1480,5204,35,201,5440
subtest23of10,pubtest28of10,10,1480,5204,32,241,5477
subtest25of10,pubtest28of10,10,1480,5204,39,278,5521
subtest24of10,pubtest28of10,10,1480,5204,40,317,5561
subtest22of10,pubtest28of10,10,1480,5204,41,356,5601
subtest210of10,pubtest29of10,10,1482,5672,5,38,5715
subtest23of10,pubtest29of10,10,1482,5672,8,75,5755
subtest29of10,pubtest29of10,10,1482,5672,12,111,5795
subtest25of10,pubtest29of10,10,1482,5672,14,150,5836
subtest22of10,pubtest29of10,10,1482,5672,16,189,5877
subtest28of10,pubtest29of10,10,1482,5672,17,227,5916
subtest24of10,pubtest29of10,10,1482,5672,18,266,5956
subtest21of10,pubtest29of10,10,1482,5672,21,303,5996
subtest26of10,pubtest29of10,10,1482,5672,24,340,6036
subtest27of10,pubtest29of10,10,1482,5672,27,377,6076
subtest29of10,pubtest210of10,10,1493,5213,2,41,5256
subtest21of10,pubtest210of10,10,1493,5213,8,76,5297
subtest210of10,pubtest210of10,10,1493,5213,10,114,5337
subtest27of10,pubtest210of10,10,1493,5213,14,150,5377
subtest28of10,pubtest210of10,10,1493,5213,15,190,5418
subtest24of10,pubtest210of10,10,1493,5213,20,225,5458
subtest22of10,pubtest210of10,10,1493,5213,36,249,5498
subtest23of10,pubtest210of10,10,1493,5213,40,284,5537
subtest25of10,pubtest210of10,10,1493,5213,41,324,5578
subtest26of10,pubtest210of10,10,1493,5213,37,363,5613
subtest26of10,pubtest21of10,10,1483,10598,1,45,10644
subtest27of10,pubtest21of10,10,1483,10598,3,81,10682
subtest24of10,pubtest21of10,10,1483,10598,34,90,10722
subtest29of10,pubtest21of10,10,1483,10598,36,127,10761
subtest25of10,pubtest21of10,10,1483,10598,46,157,10801
subtest21of10,pubtest21of10,10,1483,10598,47,197,10842
subtest210of10,pubtest21of10,10,1483,10598,53,231,10882
subtest28of10,pubtest21of10,10,1483,10598,55,269,10922
subtest23of10,pubtest21of10,10,1483,10598,57,307,10962
subtest22of10,pubtest21of10,10,1483,10598,56,346,11000
subtest29of10,pubtest22of10,10,1482,5207,0,39,5246
subtest24of10,pubtest22of10,10,1482,5207,3,77,5287
subtest27of10,pubtest22of10,10,1482,5207,9,111,5327
subtest28of10,pubtest22of10,10,1482,5207,17,143,5367
subtest26of10,pubtest22of10,10,1482,5207,19,181,5407
subtest23of10,pubtest22of10,10,1482,5207,21,219,5447
subtest210of10,pubtest22of10,10,1482,5207,27,253,5487
subtest25of10,pubtest22of10,10,1482,5207,28,292,5527
subtest22of10,pubtest22of10,10,1482,5207,30,329,5566
subtest21of10,pubtest22of10,10,1482,5207,33,367,5607
subtest23of10,pubtest23of10,10,1482,5288,0,44,5332
subtest29of10,pubtest23of10,10,1482,5288,5,78,5371
subtest28of10,pubtest23of10,10,1482,5288,7,116,5411
subtest27of10,pubtest23of10,10,1482,5288,7,155,5450
subtest25of10,pubtest23of10,10,1482,5288,14,189,5491
subtest24of10,pubtest23of10,10,1482,5288,16,227,5531
subtest26of10,pubtest23of10,10,1482,5288,54,227,5569
subtest22of10,pubtest23of10,10,1482,5288,65,257,5610
subtest21of10,pubtest23of10,10,1482,5288,67,296,5651
subtest210of10,pubtest23of10,10,1482,5288,68,335,5691
subtest23of10,pubtest24of10,10,1482,5124,-2,151,5273
subtest24of10,pubtest24of10,10,1482,5124,0,187,5311
subtest25of10,pubtest24of10,10,1482,5124,5,222,5351
subtest28of10,pubtest24of10,10,1482,5124,8,258,5390
subtest21of10,pubtest24of10,10,1482,5124,17,289,5430
subtest22of10,pubtest24of10,10,1482,5124,21,326,5471
subtest210of10,pubtest24of10,10,1482,5124,24,362,5510
subtest29of10,pubtest24of10,10,1482,5124,25,401,5550
subtest27of10,pubtest24of10,10,1482,5124,27,441,5592
subtest26of10,pubtest24of10,10,1482,5124,28,479,5631
subtest28of10,pubtest25of10,10,1482,5150,-5,44,5189
subtest21of10,pubtest25of10,10,1482,5150,-3,87,5234
subtest210of10,pubtest25of10,10,1482,5150,2,123,5275
subtest27of10,pubtest25of10,10,1482,5150,7,158,5315
subtest26of10,pubtest25of10,10,1482,5150,8,197,5355
subtest25of10,pubtest25of10,10,1482,5150,12,233,5395
subtest22of10,pubtest25of10,10,1482,5150,14,271,5435
subtest23of10,pubtest25of10,10,1482,5150,17,308,5475
subtest29of10,pubtest25of10,10,1482,5150,28,336,5514
subtest24of10,pubtest25of10,10,1482,5150,31,374,5555
subtest21of10,pubtest26of10,10,1482,5220,1,43,5264
subtest22of10,pubtest26of10,10,1482,5220,3,79,5302
subtest29of10,pubtest26of10,10,1482,5220,12,110,5342
subtest23of10,pubtest26of10,10,1482,5220,18,144,5382
subtest26of10,pubtest26of10,10,1482,5220,19,183,5422
subtest210of10,pubtest26of10,10,1482,5220,22,219,5461
subtest27of10,pubtest26of10,10,1482,5220,23,258,5501
subtest28of10,pubtest26of10,10,1482,5220,25,296,5541
subtest25of10,pubtest26of10,10,1482,5220,25,336,5581
subtest24of10,pubtest26of10,10,1482,5220,31,371,5622
subtest27of10,pubtest27of10,10,1481,5155,11,42,5208
subtest23of10,pubtest27of10,10,1481,5155,22,72,5249
subtest28of10,pubtest27of10,10,1481,5155,23,109,5287
subtest24of10,pubtest27of10,10,1481,5155,25,148,5328
subtest29of10,pubtest27of10,10,1481,5155,43,170,5368
subtest210of10,pubtest27of10,10,1481,5155,46,206,5407
subtest25of10,pubtest27of10,10,1481,5155,59,234,5448
subtest22of10,pubtest27of10,10,1481,5155,79,254,5488
subtest26of10,pubtest27of10,10,1481,5155,91,282,5528
subtest21of10,pubtest27of10,10,1481,5155,92,318,5565
subtest27of10,pubtest28of10,10,1480,5212,-4,39,5247
subtest28of10,pubtest28of10,10,1480,5212,-3,78,5287
subtest21of10,pubtest28of10,10,1480,5212,0,115,5327
subtest29of10,pubtest28of10,10,1480,5212,3,152,5367
subtest23of10,pubtest28of10,10,1480,5212,19,176,5407
subtest210of10,pubtest28of10,10,1480,5212,20,215,5447
subtest25of10,pubtest28of10,10,1480,5212,21,252,5485
subtest26of10,pubtest28of10,10,1480,5212,28,287,5527
subtest24of10,pubtest28of10,10,1480,5212,31,323,5566
subtest22of10,pubtest28of10,10,1480,5212,32,363,5607
subtest23of10,pubtest29of10,10,1482,5158,2,41,5201
subtest210of10,pubtest29of10,10,1482,5158,6,75,5239
subtest29of10,pubtest29of10,10,1482,5158,24,96,5278
subtest22of10,pubtest29of10,10,1482,5158,29,132,5319
subtest25of10,pubtest29of10,10,1482,5158,30,171,5359
subtest28of10,pubtest29of10,10,1482,5158,31,209,5398
subtest24of10,pubtest29of10,10,1482,5158,33,248,5439
subtest21of10,pubtest29of10,10,1482,5158,39,282,5479
subtest27of10,pubtest29of10,10,1482,5158,50,310,5518
subtest26of10,pubtest29of10,10,1482,5158,53,349,5560
subtest29of10,pubtest210of10,10,1493,5178,-1,304,5481
subtest21of10,pubtest210of10,10,1493,5178,3,338,5519
subtest27of10,pubtest210of10,10,1493,5178,9,372,5559
subtest210of10,pubtest210of10,10,1493,5178,44,377,5599
subtest28of10,pubtest210of10,10,1493,5178,48,413,5639
subtest24of10,pubtest210of10,10,1493,5178,49,451,5678
subtest22of10,pubtest210of10,10,1493,5178,51,490,5719
subtest26of10,pubtest210of10,10,1493,5178,52,527,5757
subtest23of10,pubtest210of10,10,1493,5178,56,565,5799
subtest25of10,pubtest210of10,10,1493,5178,58,603,5839
subtest27of10,pubtest21of10,10,1483,10256,-1,41,10296
subtest26of10,pubtest21of10,10,1483,10256,2,78,10336
subtest24of10,pubtest21of10,10,1483,10256,6,114,10376
subtest29of10,pubtest21of10,10,1483,10256,7,152,10415
subtest25of10,pubtest21of10,10,1483,10256,11,188,10455
subtest21of10,pubtest21of10,10,1483,10256,25,214,10495
subtest210of10,pubtest21of10,10,1483,10256,26,253,10535
subtest28of10,pubtest21of10,10,1483,10256,31,289,10576
subtest22of10,pubtest21of10,10,1483,10256,33,327,10616
subtest23of10,pubtest21of10,10,1483,10256,37,364,10657
subtest29of10,pubtest22of10,10,1482,5181,1,40,5222
subtest24of10,pubtest22of10,10,1482,5181,7,75,5263
subtest28of10,pubtest22of10,10,1482,5181,10,112,5303
subtest27of10,pubtest22of10,10,1482,5181,9,151,5341
subtest26of10,pubtest22of10,10,1482,5181,26,176,5383
subtest210of10,pubtest22of10,10,1482,5181,27,214,5422
subtest23of10,pubtest22of10,10,1482,5181,29,253,5463
subtest22of10,pubtest22of10,10,1482,5181,32,290,5503
subtest25of10,pubtest22of10,10,1482,5181,30,327,5538
subtest21of10,pubtest22of10,10,1482,5181,34,366,5581
subtest23of10,pubtest23of10,10,1482,5333,1,45,5379
subtest28of10,pubtest23of10,10,1482,5333,3,82,5418
subtest29of10,pubtest23of10,10,1482,5333,7,119,5459
subtest24of10,pubtest23of10,10,1482,5333,10,156,5499
subtest27of10,pubtest23of10,10,1482,5333,17,188,5538
subtest25of10,pubtest23of10,10,1482,5333,20,225,5578
subtest26of10,pubtest23of10,10,1482,5333,24,262,5619
subtest22of10,pubtest23of10,10,1482,5333,25,301,5659
subtest21of10,pubtest23of10,10,1482,5333,31,335,5699
subtest210of10,pubtest23of10,10,1482,5333,35,371,5739
subtest24of10,pubtest24of10,10,1482,6440,8,40,6488
subtest28of10,pubtest24of10,10,1482,6440,9,79,6528
subtest23of10,pubtest24of10,10,1482,6440,5,119,6564
subtest25of10,pubtest24of10,10,1482,6440,11,157,6608
subtest21of10,pubtest24of10,10,1482,6440,12,196,6648
subtest22of10,pubtest24of10,10,1482,6440,15,233,6688
subtest29of10,pubtest24of10,10,1482,6440,25,263,6728
subtest210of10,pubtest24of10,10,1482,6440,27,301,6768
subtest27of10,pubtest24of10,10,1482,6440,32,335,6807
subtest26of10,pubtest24of10,10,1482,6440,41,366,6847
subtest28of10,pubtest25of10,10,1482,5456,-3,45,5498
subtest210of10,pubtest25of10,10,1482,5456,3,79,5538
subtest21of10,pubtest25of10,10,1482,5456,4,117,5577
subtest26of10,pubtest25of10,10,1482,5456,10,152,5618
subtest27of10,pubtest25of10,10,1482,5456,11,190,5657
subtest22of10,pubtest25of10,10,1482,5456,19,222,5697
subtest25of10,pubtest25of10,10,1482,5456,22,260,5738
subtest23of10,pubtest25of10,10,1482,5456,27,295,5778
subtest29of10,pubtest25of10,10,1482,5456,31,331,5818
subtest24of10,pubtest25of10,10,1482,5456,33,369,5858
subtest21of10,pubtest26of10,10,1482,5303,2,41,5346
subtest22of10,pubtest26of10,10,1482,5303,4,77,5384
subtest29of10,pubtest26of10,10,1482,5303,7,117,5427
subtest23of10,pubtest26of10,10,1482,5303,11,152,5466
subtest26of10,pubtest26of10,10,1482,5303,13,190,5506
subtest210of10,pubtest26of10,10,1482,5303,36,207,5546
subtest28of10,pubtest26of10,10,1482,5303,38,245,5586
subtest27of10,pubtest26of10,10,1482,5303,38,285,5626
subtest24of10,pubtest26of10,10,1482,5303,43,319,5665
subtest25of10,pubtest26of10,10,1482,5303,45,358,5706
subtest27of10,pubtest27of10,10,1481,5320,2,44,5366
subtest28of10,pubtest27of10,10,1481,5320,4,81,5405
subtest23of10,pubtest27of10,10,1481,5320,5,120,5445
subtest24of10,pubtest27of10,10,1481,5320,7,159,5486
subtest29of10,pubtest27of10,10,1481,5320,36,169,5525
subtest22of10,pubtest27of10,10,1481,5320,42,203,5565
subtest21of10,pubtest27of10,10,1481,5320,43,243,5606
subtest25of10,pubtest27of10,10,1481,5320,40,282,5642
subtest210of10,pubtest27of10,10,1481,5320,39,321,5680
subtest26of10,pubtest27of10,10,1481,5320,48,357,5725
subtest27of10,pubtest28of10,10,1480,5232,1,45,5278
subtest21of10,pubtest28of10,10,1480,5232,8,78,5318
subtest28of10,pubtest28of10,10,1480,5232,11,116,5359
subtest29of10,pubtest28of10,10,1480,5232,28,139,5399
subtest23of10,pubtest28of10,10,1480,5232,29,178,5439
subtest210of10,pubtest28of10,10,1480,5232,40,207,5479
subtest25of10,pubtest28of10,10,1480,5232,41,246,5519
subtest26of10,pubtest28of10,10,1480,5232,42,285,5559
subtest24of10,pubtest28of10,10,1480,5232,43,324,5599
subtest22of10,pubtest28of10,10,1480,5232,46,361,5639
subtest210of10,pubtest29of10,10,1482,5199,18,41,5258
subtest23of10,pubtest29of10,10,1482,5199,23,76,5298
subtest29of10,pubtest29of10,10,1482,5199,34,105,5338
subtest22of10,pubtest29of10,10,1482,5199,34,144,5377
subtest25of10,pubtest29of10,10,1482,5199,36,183,5418
subtest21of10,pubtest29of10,10,1482,5199,44,215,5458
subtest27of10,pubtest29of10,10,1482,5199,48,251,5498
subtest28of10,pubtest29of10,10,1482,5199,45,291,5535
subtest24of10,pubtest29of10,10,1482,5199,50,329,5578
subtest26of10,pubtest29of10,10,1482,5199,51,367,5617
subtest29of10,pubtest210of10,10,1493,5126,1,42,5169
subtest27of10,pubtest210of10,10,1493,5126,15,68,5209
subtest21of10,pubtest210of10,10,1493,5126,11,107,5244
subtest210of10,pubtest210of10,10,1493,5126,17,146,5289
subtest28of10,pubtest210of10,10,1493,5126,21,182,5329
subtest24of10,pubtest210of10,10,1493,5126,25,218,5369
subtest22of10,pubtest210of10,10,1493,5126,26,256,5408
subtest26of10,pubtest210of10,10,1493,5126,28,294,5448
subtest23of10,pubtest210of10,10,1493,5126,32,331,5489
subtest25of10,pubtest210of10,10,1493,5126,32,370,5528
subtest26of10,pubtest21of10,10,1483,10219,-1,40,10258
subtest27of10,pubtest21of10,10,1483,10219,2,78,10299
subtest24of10,pubtest21of10,10,1483,10219,6,114,10339
subtest29of10,pubtest21of10,10,1483,10219,7,153,10379
subtest210of10,pubtest21of10,10,1483,10219,16,183,10418
subtest25of10,pubtest21of10,10,1483,10219,18,222,10459
subtest28of10,pubtest21of10,10,1483,10219,34,246,10499
subtest23of10,pubtest21of10,10,1483,10219,36,284,10539
subtest21of10,pubtest21of10,10,1483,10219,36,324,10579
subtest22of10,pubtest21of10,10,1483,10219,34,363,10616
subtest24of10,pubtest22of10,10,1482,5148,9,39,5196
subtest29of10,pubtest22of10,10,1482,5148,7,81,5236
subtest28of10,pubtest22of10,10,1482,5148,13,115,5276
subtest27of10,pubtest22of10,10,1482,5148,13,156,5317
subtest26of10,pubtest22of10,10,1482,5148,14,193,5355
subtest23of10,pubtest22of10,10,1482,5148,21,227,5396
subtest25of10,pubtest22of10,10,1482,5148,29,259,5436
subtest210of10,pubtest22of10,10,1482,5148,31,297,5476
subtest21of10,pubtest22of10,10,1482,5148,32,336,5516
subtest22of10,pubtest22of10,10,1482,5148,34,374,5556
subtest23of10,pubtest23of10,10,1482,5429,-3,40,5466
subtest28of10,pubtest23of10,10,1482,5429,2,78,5509
subtest24of10,pubtest23of10,10,1482,5429,3,116,5548
subtest29of10,pubtest23of10,10,1482,5429,13,147,5589
subtest26of10,pubtest23of10,10,1482,5429,22,178,5629
subtest25of10,pubtest23of10,10,1482,5429,24,214,5667
subtest27of10,pubtest23of10,10,1482,5429,23,256,5708
subtest22of10,pubtest23of10,10,1482,5429,27,293,5749
subtest21of10,pubtest23of10,10,1482,5429,35,324,5788
subtest210of10,pubtest23of10,10,1482,5429,38,362,5829
subtest23of10,pubtest24of10,10,1482,5192,-2,39,5229
subtest24of10,pubtest24of10,10,1482,5192,2,74,5268
subtest28of10,pubtest24of10,10,1482,5192,6,111,5309
subtest22of10,pubtest24of10,10,1482,5192,10,147,5349
subtest25of10,pubtest24of10,10,1482,5192,17,180,5389
subtest21of10,pubtest24of10,10,1482,5192,23,213,5428
subtest210of10,pubtest24of10,10,1482,5192,25,252,5469
subtest29of10,pubtest24of10,10,1482,5192,28,289,5509
subtest27of10,pubtest24of10,10,1482,5192,29,327,5548
subtest26of10,pubtest24of10,10,1482,5192,32,365,5589
subtest28of10,pubtest25of10,10,1482,5248,-3,42,5287
subtest210of10,pubtest25of10,10,1482,5248,0,78,5326
subtest21of10,pubtest25of10,10,1482,5248,7,111,5366
subtest26of10,pubtest25of10,10,1482,5248,10,148,5406
subtest27of10,pubtest25of10,10,1482,5248,20,177,5445
subtest22of10,pubtest25of10,10,1482,5248,25,213,5486
subtest25of10,pubtest25of10,10,1482,5248,28,248,5524
subtest23of10,pubtest25of10,10,1482,5248,32,285,5565
subtest29of10,pubtest25of10,10,1482,5248,36,321,5605
subtest24of10,pubtest25of10,10,1482,5248,38,360,5646
subtest21of10,pubtest26of10,10,1482,5110,-2,40,5148
subtest22of10,pubtest26of10,10,1482,5110,3,75,5188
subtest29of10,pubtest26of10,10,1482,5110,15,102,5227
subtest23of10,pubtest26of10,10,1482,5110,19,139,5268
subtest26of10,pubtest26of10,10,1482,5110,22,177,5309
subtest210of10,pubtest26of10,10,1482,5110,25,213,5348
subtest27of10,pubtest26of10,10,1482,5110,26,251,5387
subtest28of10,pubtest26of10,10,1482,5110,27,291,5428
subtest25of10,pubtest26of10,10,1482,5110,31,327,5468
subtest24of10,pubtest26of10,10,1482,5110,32,366,5508
subtest27of10,pubtest27of10,10,1481,5127,0,41,5168
subtest28of10,pubtest27of10,10,1481,5127,2,78,5207
subtest23of10,pubtest27of10,10,1481,5127,3,117,5247
subtest24of10,pubtest27of10,10,1481,5127,8,152,5287
subtest210of10,pubtest27of10,10,1481,5127,23,177,5327
subtest29of10,pubtest27of10,10,1481,5127,24,216,5367
subtest22of10,pubtest27of10,10,1481,5127,34,246,5407
subtest25of10,pubtest27of10,10,1481,5127,31,286,5444
subtest26of10,pubtest27of10,10,1481,5127,35,323,5485
subtest21of10,pubtest27of10,10,1481,5127,36,363,5526
subtest27of10,pubtest28of10,10,1480,5186,-4,43,5225
subtest28of10,pubtest28of10,10,1480,5186,-3,80,5263
subtest21of10,pubtest28of10,10,1480,5186,2,114,5302
subtest29of10,pubtest28of10,10,1480,5186,13,144,5343
subtest23of10,pubtest28of10,10,1480,5186,27,170,5383
subtest210of10,pubtest28of10,10,1480,5186,27,210,5423
subtest26of10,pubtest28of10,10,1480,5186,31,247,5464
subtest25of10,pubtest28of10,10,1480,5186,33,285,5504
subtest24of10,pubtest28of10,10,1480,5186,35,322,5543
subtest22of10,pubtest28of10,10,1480,5186,37,361,5584
subtest23of10,pubtest29of10,10,1482,5145,4,46,5195
subtest210of10,pubtest29of10,10,1482,5145,26,60,5231
subtest29of10,pubtest29of10,10,1482,5145,28,98,5271
subtest22of10,pubtest29of10,10,1482,5145,32,134,5311
subtest25of10,pubtest29of10,10,1482,5145,38,168,5351
subtest28of10,pubtest29of10,10,1482,5145,42,203,5390
subtest27of10,pubtest29of10,10,1482,5145,45,237,5427
subtest24of10,pubtest29of10,10,1482,5145,49,277,5471
subtest21of10,pubtest29of10,10,1482,5145,44,434,5623
subtest26of10,pubtest29of10,10,1482,5145,50,470,5665
subtest29of10,pubtest210of10,10,1493,5095,-4,44,5135
subtest21of10,pubtest210of10,10,1493,5095,8,70,5173
subtest210of10,pubtest210of10,10,1493,5095,18,99,5212
subtest27of10,pubtest210of10,10,1493,5095,19,138,5252
subtest28of10,pubtest210of10,10,1493,5095,23,175,5293
subtest24of10,pubtest210of10,10,1493,5095,24,213,5332
subtest22of10,pubtest210of10,10,1493,5095,25,252,5372
subtest26of10,pubtest210of10,10,1493,5095,30,287,5412
subtest23of10,pubtest210of10,10,1493,5095,32,326,5453
subtest25of10,pubtest210of10,10,1493,5095,33,365,5493
subtest27of10,pubtest21of10,10,1483,10224,7,40,10271
subtest26of10,pubtest21of10,10,1483,10224,9,79,10312
subtest24of10,pubtest21of10,10,1483,10224,11,117,10352
subtest29of10,pubtest21of10,10,1483,10224,13,155,10392
subtest25of10,pubtest21of10,10,1483,10224,15,192,10431
subtest21of10,pubtest21of10,10,1483,10224,17,231,10472
subtest210of10,pubtest21of10,10,1483,10224,23,263,10510
subtest28of10,pubtest21of10,10,1483,10224,26,301,10551
subtest22of10,pubtest21of10,10,1483,10224,26,341,10591
subtest23of10,pubtest21of10,10,1483,10224,29,379,10632
subtest29of10,pubtest22of10,10,1482,5419,12,40,5471
subtest27of10,pubtest22of10,10,1482,5419,20,71,5510
subtest25of10,pubtest22of10,10,1482,5419,23,108,5550
subtest23of10,pubtest22of10,10,1482,5419,21,148,5588
subtest28of10,pubtest22of10,10,1482,5419,25,185,5629
subtest26of10,pubtest22of10,10,1482,5419,26,224,5669
subtest24of10,pubtest22of10,10,1482,5419,20,263,5702
subtest21of10,pubtest22of10,10,1482,5419,25,304,5748
subtest210of10,pubtest22of10,10,1482,5419,30,340,5789
subtest22of10,pubtest22of10,10,1482,5419,32,379,5830
subtest23of10,pubtest23of10,10,1482,5155,-1,40,5194
subtest28of10,pubtest23of10,10,1482,5155,6,71,5232
subtest29of10,pubtest23of10,10,1482,5155,7,109,5271
subtest24of10,pubtest23of10,10,1482,5155,10,146,5311
subtest27of10,pubtest23of10,10,1482,5155,13,184,5352
subtest25of10,pubtest23of10,10,1482,5155,17,220,5392
subtest26of10,pubtest23of10,10,1482,5155,21,256,5432
subtest21of10,pubtest23of10,10,1482,5155,26,291,5472
subtest22of10,pubtest23of10,10,1482,5155,38,318,5511
subtest210of10,pubtest23of10,10,1482,5155,41,356,5552
subtest24of10,pubtest24of10,10,1482,5148,9,40,5197
subtest23of10,pubtest24of10,10,1482,5148,13,76,5237
subtest25of10,pubtest24of10,10,1482,5148,18,110,5276
subtest28of10,pubtest24of10,10,1482,5148,21,148,5317
subtest22of10,pubtest24of10,10,1482,5148,28,180,5356
subtest21of10,pubtest24of10,10,1482,5148,30,219,5397
subtest210of10,pubtest24of10,10,1482,5148,33,256,5437
subtest29of10,pubtest24of10,10,1482,5148,33,295,5476
subtest27of10,pubtest24of10,10,1482,5148,35,333,5516
subtest26of10,pubtest24of10,10,1482,5148,36,373,5557
subtest28of10,pubtest25of10,10,1482,5303,-4,125,5424
subtest21of10,pubtest25of10,10,1482,5303,-3,163,5463
subtest210of10,pubtest25of10,10,1482,5303,3,198,5504
subtest27of10,pubtest25of10,10,1482,5303,8,233,5544
subtest26of10,pubtest25of10,10,1482,5303,19,261,5583
subtest25of10,pubtest25of10,10,1482,5303,24,296,5623
subtest22of10,pubtest25of10,10,1482,5303,25,335,5663
subtest23of10,pubtest25of10,10,1482,5303,29,371,5703
subtest24of10,pubtest25of10,10,1482,5303,31,410,5744
subtest29of10,pubtest25of10,10,1482,5303,31,450,5784
subtest22of10,pubtest26of10,10,1482,5094,1,43,5138
subtest21of10,pubtest26of10,10,1482,5094,3,84,5181
subtest29of10,pubtest26of10,10,1482,5094,8,119,5221
subtest23of10,pubtest26of10,10,1482,5094,14,153,5261
subtest26of10,pubtest26of10,10,1482,5094,18,190,5302
subtest210of10,pubtest26of10,10,1482,5094,20,227,5341
subtest28of10,pubtest26of10,10,1482,5094,25,263,5382
subtest27of10,pubtest26of10,10,1482,5094,31,297,5422
subtest24of10,pubtest26of10,10,1482,5094,36,332,5462
subtest25of10,pubtest26of10,10,1482,5094,46,362,5502
subtest27of10,pubtest27of10,10,1481,5160,11,40,5211
subtest28of10,pubtest27of10,10,1481,5160,11,79,5250
subtest23of10,pubtest27of10,10,1481,5160,14,117,5291
subtest24of10,pubtest27of10,10,1481,5160,16,154,5330
subtest29of10,pubtest27of10,10,1481,5160,23,187,5370
subtest210of10,pubtest27of10,10,1481,5160,25,226,5411
subtest25of10,pubtest27of10,10,1481,5160,27,260,5447
subtest26of10,pubtest27of10,10,1481,5160,31,299,5490
subtest21of10,pubtest27of10,10,1481,5160,33,337,5530
subtest22of10,pubtest27of10,10,1481,5160,28,376,5564
subtest27of10,pubtest28of10,10,1480,5242,-3,502,5741
subtest21of10,pubtest28of10,10,1480,5242,8,532,5782
subtest28of10,pubtest28of10,10,1480,5242,13,566,5821
subtest29of10,pubtest28of10,10,1480,5242,13,605,5860
subtest210of10,pubtest28of10,10,1480,5242,18,643,5903
subtest23of10,pubtest28of10,10,1480,5242,20,680,5942
subtest26of10,pubtest28of10,10,1480,5242,21,719,5982
subtest25of10,pubtest28of10,10,1480,5242,22,757,6021
subtest24of10,pubtest28of10,10,1480,5242,23,797,6062
subtest22of10,pubtest28of10,10,1480,5242,28,832,6102
subtest23of10,pubtest29of10,10,1482,5101,2,41,5144
subtest210of10,pubtest29of10,10,1482,5101,9,73,5183
subtest29of10,pubtest29of10,10,1482,5101,37,85,5223
subtest22of10,pubtest29of10,10,1482,5101,37,124,5262
subtest25of10,pubtest29of10,10,1482,5101,47,154,5302
subtest28of10,pubtest29of10,10,1482,5101,49,193,5343
subtest21of10,pubtest29of10,10,1482,5101,51,231,5383
subtest24of10,pubtest29of10,10,1482,5101,55,267,5423
subtest26of10,pubtest29of10,10,1482,5101,54,307,5462
subtest27of10,pubtest29of10,10,1482,5101,56,345,5502
subtest29of10,pubtest210of10,10,1493,5213,2,44,5259
subtest21of10,pubtest210of10,10,1493,5213,5,81,5299
subtest27of10,pubtest210of10,10,1493,5213,10,116,5339
subtest210of10,pubtest210of10,10,1493,5213,7,158,5378
subtest28of10,pubtest210of10,10,1493,5213,16,190,5419
subtest24of10,pubtest210of10,10,1493,5213,18,227,5458
subtest22of10,pubtest210of10,10,1493,5213,23,263,5499
subtest26of10,pubtest210of10,10,1493,5213,24,302,5539
subtest23of10,pubtest210of10,10,1493,5213,59,307,5579
subtest25of10,pubtest210of10,10,1493,5213,60,346,5619
subtest26of10,pubtest21of10,10,1483,10140,-2,39,10177
subtest27of10,pubtest21of10,10,1483,10140,4,74,10218
subtest24of10,pubtest21of10,10,1483,10140,4,114,10258
subtest29of10,pubtest21of10,10,1483,10140,7,151,10298
subtest25of10,pubtest21of10,10,1483,10140,13,184,10337
subtest21of10,pubtest21of10,10,1483,10140,15,223,10378
subtest210of10,pubtest21of10,10,1483,10140,16,262,10418
subtest28of10,pubtest21of10,10,1483,10140,20,298,10458
subtest22of10,pubtest21of10,10,1483,10140,34,324,10498
subtest23of10,pubtest21of10,10,1483,10140,34,363,10537
subtest29of10,pubtest22of10,10,1482,5204,-4,39,5239
subtest24of10,pubtest22of10,10,1482,5204,-1,77,5280
subtest28of10,pubtest22of10,10,1482,5204,3,111,5318
subtest27of10,pubtest22of10,10,1482,5204,6,150,5360
subtest26of10,pubtest22of10,10,1482,5204,8,188,5400
subtest210of10,pubtest22of10,10,1482,5204,21,215,5440
subtest23of10,pubtest22of10,10,1482,5204,22,253,5479
subtest25of10,pubtest22of10,10,1482,5204,25,290,5519
subtest22of10,pubtest22of10,10,1482,5204,30,326,5560
subtest21of10,pubtest22of10,10,1482,5204,31,365,5600
subtest23of10,pubtest23of10,10,1482,5236,3,45,5284
subtest28of10,pubtest23of10,10,1482,5236,6,82,5324
subtest29of10,pubtest23of10,10,1482,5236,9,119,5364
subtest24of10,pubtest23of10,10,1482,5236,11,157,5404
subtest27of10,pubtest23of10,10,1482,5236,13,195,5444
subtest25of10,pubtest23of10,10,1482,5236,14,233,5483
subtest26of10,pubtest23of10,10,1482,5236,18,270,5524
subtest22of10,pubtest23of10,10,1482,5236,21,305,5562
subtest21of10,pubtest23of10,10,1482,5236,23,344,5603
subtest210of10,pubtest23of10,10,1482,5236,24,383,5643
subtest24of10,pubtest24of10,10,1482,5154,0,39,5193
subtest23of10,pubtest24of10,10,1482,5154,4,75,5233
subtest28of10,pubtest24of10,10,1482,5154,5,112,5271
subtest25of10,pubtest24of10,10,1482,5154,6,151,5311
subtest21of10,pubtest24of10,10,1482,5154,9,190,5353
subtest22of10,pubtest24of10,10,1482,5154,30,209,5393
subtest210of10,pubtest24of10,10,1482,5154,31,248,5433
subtest29of10,pubtest24of10,10,1482,5154,32,287,5473
subtest27of10,pubtest24of10,10,1482,5154,33,325,5512
subtest26of10,pubtest24of10,10,1482,5154,34,365,5553
subtest28of10,pubtest25of10,10,1482,5134,-2,42,5174
subtest21of10,pubtest25of10,10,1482,5134,1,78,5213
subtest210of10,pubtest25of10,10,1482,5134,5,115,5254
subtest26of10,pubtest25of10,10,1482,5134,14,146,5294
subtest27of10,pubtest25of10,10,1482,5134,20,180,5334
subtest22of10,pubtest25of10,10,1482,5134,28,212,5374
subtest25of10,pubtest25of10,10,1482,5134,32,246,5412
subtest23of10,pubtest25of10,10,1482,5134,34,286,5454
subtest29of10,pubtest25of10,10,1482,5134,37,323,5494
subtest24of10,pubtest25of10,10,1482,5134,42,358,5534
subtest22of10,pubtest26of10,10,1482,5170,0,45,5215
subtest21of10,pubtest26of10,10,1482,5170,2,82,5254
subtest29of10,pubtest26of10,10,1482,5170,8,115,5293
subtest23of10,pubtest26of10,10,1482,5170,15,149,5334
subtest26of10,pubtest26of10,10,1482,5170,20,184,5374
subtest210of10,pubtest26of10,10,1482,5170,22,222,5414
subtest27of10,pubtest26of10,10,1482,5170,26,258,5454
subtest28of10,pubtest26of10,10,1482,5170,28,296,5494
subtest24of10,pubtest26of10,10,1482,5170,29,335,5534
subtest25of10,pubtest26of10,10,1482,5170,31,372,5573
subtest28of10,pubtest27of10,10,1481,5144,7,45,5196
subtest27of10,pubtest27of10,10,1481,5144,9,83,5236
subtest23of10,pubtest27of10,10,1481,5144,13,119,5276
subtest24of10,pubtest27of10,10,1481,5144,12,158,5314
subtest29of10,pubtest27of10,10,1481,5144,37,175,5356
subtest25of10,pubtest27of10,10,1481,5144,38,214,5396
subtest22of10,pubtest27of10,10,1481,5144,43,250,5437
subtest21of10,pubtest27of10,10,1481,5144,45,288,5477
subtest26of10,pubtest27of10,10,1481,5144,46,327,5517
subtest210of10,pubtest27of10,10,1481,5144,43,368,5555
subtest27of10,pubtest28of10,10,1480,5378,-2,44,5420
subtest21of10,pubtest28of10,10,1480,5378,0,78,5456
subtest28of10,pubtest28of10,10,1480,5378,5,113,5496
subtest29of10,pubtest28of10,10,1480,5378,11,148,5537
subtest210of10,pubtest28of10,10,1480,5378,20,179,5577
subtest23of10,pubtest28of10,10,1480,5378,22,217,5617
subtest25of10,pubtest28of10,10,1480,5378,27,252,5657
subtest26of10,pubtest28of10,10,1480,5378,28,291,5697
subtest24of10,pubtest28of10,10,1480,5378,35,324,5737
subtest22of10,pubtest28of10,10,1480,5378,41,358,5777
subtest23of10,pubtest29of10,10,1482,5217,-6,42,5253
subtest210of10,pubtest29of10,10,1482,5217,8,69,5294
subtest22of10,pubtest29of10,10,1482,5217,12,105,5334
subtest28of10,pubtest29of10,10,1482,5217,15,142,5374
subtest24of10,pubtest29of10,10,1482,5217,19,178,5414
subtest26of10,pubtest29of10,10,1482,5217,21,213,5451
subtest29of10,pubtest29of10,10,1482,5217,25,252,5494
subtest25of10,pubtest29of10,10,1482,5217,28,289,5534
subtest21of10,pubtest29of10,10,1482,5217,33,323,5573
subtest27of10,pubtest29of10,10,1482,5217,35,362,5614
subtest29of10,pubtest210of10,10,1493,5132,-6,40,5166
subtest21of10,pubtest210of10,10,1493,5132,0,76,5208
subtest27of10,pubtest210of10,10,1493,5132,3,113,5248
subtest210of10,pubtest210of10,10,1493,5132,6,150,5288
subtest28of10,pubtest210of10,10,1493,5132,15,180,5327
subtest23of10,pubtest210of10,10,1493,5132,17,219,5368
subtest25of10,pubtest210of10,10,1493,5132,18,257,5407
subtest24of10,pubtest210of10,10,1493,5132,22,294,5448
subtest22of10,pubtest210of10,10,1493,5132,24,332,5488
subtest26of10,pubtest210of10,10,1493,5132,27,368,5527
subtest27of10,pubtest21of10,10,1483,10134,-1,40,10173
subtest29of10,pubtest21of10,10,1483,10134,0,78,10212
subtest25of10,pubtest21of10,10,1483,10134,3,116,10253
subtest21of10,pubtest21of10,10,1483,10134,4,155,10293
subtest23of10,pubtest21of10,10,1483,10134,5,192,10331
subtest26of10,pubtest21of10,10,1483,10134,13,226,10373
subtest24of10,pubtest21of10,10,1483,10134,14,264,10412
subtest210of10,pubtest21of10,10,1483,10134,16,303,10453
subtest28of10,pubtest21of10,10,1483,10134,17,341,10492
subtest22of10,pubtest21of10,10,1483,10134,19,380,10533
subtest29of10,pubtest22of10,10,1482,5211,2,45,5258
subtest24of10,pubtest22of10,10,1482,5211,3,84,5298
subtest27of10,pubtest22of10,10,1482,5211,7,121,5339
subtest23of10,pubtest22of10,10,1482,5211,9,159,5379
subtest28of10,pubtest22of10,10,1482,5211,21,186,5418
subtest25of10,pubtest22of10,10,1482,5211,25,223,5459
subtest21of10,pubtest22of10,10,1482,5211,33,255,5499
subtest26of10,pubtest22of10,10,1482,5211,37,291,5539
subtest22of10,pubtest22of10,10,1482,5211,44,324,5579
subtest210of10,pubtest22of10,10,1482,5211,44,364,5619
subtest23of10,pubtest23of10,10,1482,5155,1,42,5198
subtest28of10,pubtest23of10,10,1482,5155,2,80,5237
subtest24of10,pubtest23of10,10,1482,5155,4,119,5278
subtest29of10,pubtest23of10,10,1482,5155,8,155,5318
subtest27of10,pubtest23of10,10,1482,5155,8,193,5356
subtest26of10,pubtest23of10,10,1482,5155,16,226,5397
subtest25of10,pubtest23of10,10,1482,5155,17,266,5438
subtest22of10,pubtest23of10,10,1482,5155,23,300,5478
subtest21of10,pubtest23of10,10,1482,5155,24,339,5518
subtest210of10,pubtest23of10,10,1482,5155,34,369,5558
subtest23of10,pubtest24of10,10,1482,5145,-4,39,5180
subtest24of10,pubtest24of10,10,1482,5145,-1,76,5220
subtest25of10,pubtest24of10,10,1482,5145,4,111,5260
subtest28of10,pubtest24of10,10,1482,5145,7,148,5300
subtest21of10,pubtest24of10,10,1482,5145,10,185,5340
subtest22of10,pubtest24of10,10,1482,5145,19,216,5380
subtest29of10,pubtest24of10,10,1482,5145,20,254,5419
subtest210of10,pubtest24of10,10,1482,5145,24,291,5460
subtest27of10,pubtest24of10,10,1482,5145,25,330,5500
subtest26of10,pubtest24of10,10,1482,5145,26,368,5539
subtest28of10,pubtest25of10,10,1482,5130,-1,39,5168
subtest21of10,pubtest25of10,10,1482,5130,9,69,5208
subtest210of10,pubtest25of10,10,1482,5130,13,106,5249
subtest27of10,pubtest25of10,10,1482,5130,18,141,5289
subtest26of10,pubtest25of10,10,1482,5130,19,180,5329
subtest22of10,pubtest25of10,10,1482,5130,20,219,5369
subtest25of10,pubtest25of10,10,1482,5130,28,251,5409
subtest23of10,pubtest25of10,10,1482,5130,30,289,5449
subtest29of10,pubtest25of10,10,1482,5130,36,323,5489
subtest24of10,pubtest25of10,10,1482,5130,38,361,5529
subtest22of10,pubtest26of10,10,1482,5141,0,42,5183
subtest21of10,pubtest26of10,10,1482,5141,1,79,5221
subtest29of10,pubtest26of10,10,1482,5141,4,117,5262
subtest23of10,pubtest26of10,10,1482,5141,52,109,5302
subtest26of10,pubtest26of10,10,1482,5141,55,145,5341
subtest27of10,pubtest26of10,10,1482,5141,59,182,5382
subtest28of10,pubtest26of10,10,1482,5141,59,220,5420
subtest25of10,pubtest26of10,10,1482,5141,61,260,5462
subtest210of10,pubtest26of10,10,1482,5141,57,300,5498
subtest24of10,pubtest26of10,10,1482,5141,80,321,5542
subtest27of10,pubtest27of10,10,1481,5179,4,41,5224
subtest28of10,pubtest27of10,10,1481,5179,21,64,5264
subtest24of10,pubtest27of10,10,1481,5179,27,98,5304
subtest23of10,pubtest27of10,10,1481,5179,31,134,5344
subtest29of10,pubtest27of10,10,1481,5179,56,149,5384
subtest210of10,pubtest27of10,10,1481,5179,57,188,5424
subtest25of10,pubtest27of10,10,1481,5179,82,203,5464
subtest22of10,pubtest27of10,10,1481,5179,104,221,5504
subtest26of10,pubtest27of10,10,1481,5179,127,237,5543
subtest21of10,pubtest27of10,10,1481,5179,137,268,5584
subtest27of10,pubtest28of10,10,1480,5097,3,41,5141
subtest21of10,pubtest28of10,10,1480,5097,6,77,5180
subtest28of10,pubtest28of10,10,1480,5097,5,117,5219
subtest29of10,pubtest28of10,10,1480,5097,18,144,5259
subtest210of10,pubtest28of10,10,1480,5097,21,180,5298
subtest26of10,pubtest28of10,10,1480,5097,26,217,5340
subtest23of10,pubtest28of10,10,1480,5097,29,254,5380
subtest25of10,pubtest28of10,10,1480,5097,33,290,5420
subtest24of10,pubtest28of10,10,1480,5097,34,330,5461
subtest22of10,pubtest28of10,10,1480,5097,40,363,5500
subtest23of10,pubtest29of10,10,1482,5177,-5,44,5216
subtest29of10,pubtest29of10,10,1482,5177,4,76,5257
subtest210of10,pubtest29of10,10,1482,5177,7,113,5297
subtest25of10,pubtest29of10,10,1482,5177,8,152,5337
subtest21of10,pubtest29of10,10,1482,5177,11,189,5377
subtest27of10,pubtest29of10,10,1482,5177,13,227,5417
subtest22of10,pubtest29of10,10,1482,5177,16,264,5457
subtest28of10,pubtest29of10,10,1482,5177,35,283,5495
subtest24of10,pubtest29of10,10,1482,5177,35,322,5534
subtest26of10,pubtest29of10,10,1482,5177,38,361,5576
subtest29of10,pubtest210of10,10,1493,5383,6,41,5430
subtest21of10,pubtest210of10,10,1493,5383,10,75,5468
subtest210of10,pubtest210of10,10,1493,5383,29,97,5509
subtest27of10,pubtest210of10,10,1493,5383,35,131,5549
subtest28of10,pubtest210of10,10,1493,5383,38,167,5588
subtest24of10,pubtest210of10,10,1493,5383,48,198,5629
subtest22of10,pubtest210of10,10,1493,5383,58,228,5669
subtest23of10,pubtest210of10,10,1493,5383,82,244,5709
subtest26of10,pubtest210of10,10,1493,5383,88,278,5749
subtest25of10,pubtest210of10,10,1493,5383,104,302,5789
subtest27of10,pubtest21of10,10,1483,10462,-2,42,10502
subtest26of10,pubtest21of10,10,1483,10462,0,80,10542
subtest24of10,pubtest21of10,10,1483,10462,10,110,10582
subtest29of10,pubtest21of10,10,1483,10462,11,149,10622
subtest25of10,pubtest21of10,10,1483,10462,13,187,10662
subtest210of10,pubtest21of10,10,1483,10462,25,215,10702
subtest21of10,pubtest21of10,10,1483,10462,27,251,10740
subtest28of10,pubtest21of10,10,1483,10462,31,289,10782
subtest22of10,pubtest21of10,10,1483,10462,30,329,10821
subtest23of10,pubtest21of10,10,1483,10462,33,367,10862
subtest29of10,pubtest22of10,10,1482,6097,0,40,6137
subtest24of10,pubtest22of10,10,1482,6097,5,76,6178
subtest27of10,pubtest22of10,10,1482,6097,11,110,6218
subtest28of10,pubtest22of10,10,1482,6097,16,144,6257
subtest26of10,pubtest22of10,10,1482,6097,22,179,6298
subtest23of10,pubtest22of10,10,1482,6097,37,204,6338
subtest210of10,pubtest22of10,10,1482,6097,47,234,6378
subtest25of10,pubtest22of10,10,1482,6097,48,272,6417
subtest22of10,pubtest22of10,10,1482,6097,53,307,6457
subtest21of10,pubtest22of10,10,1482,6097,56,344,6497
subtest23of10,pubtest23of10,10,1482,7902,1,39,7942
subtest28of10,pubtest23of10,10,1482,7902,5,75,7982
subtest29of10,pubtest23of10,10,1482,7902,5,114,8021
subtest24of10,pubtest23of10,10,1482,7902,11,149,8062
subtest27of10,pubtest23of10,10,1482,7902,12,188,8102
subtest26of10,pubtest23of10,10,1482,7902,13,225,8140
subtest25of10,pubtest23of10,10,1482,7902,25,255,8182
subtest22of10,pubtest23of10,10,1482,7902,28,292,8222
subtest21of10,pubtest23of10,10,1482,7902,29,331,8262
subtest210of10,pubtest23of10,10,1482,7902,31,369,8302
subtest23of10,pubtest24of10,10,1482,7249,-3,39,7285
subtest24of10,pubtest24of10,10,1482,7249,8,69,7326
subtest28of10,pubtest24of10,10,1482,7249,13,104,7366
subtest25of10,pubtest24of10,10,1482,7249,15,141,7405
subtest22of10,pubtest24of10,10,1482,7249,16,180,7445
subtest21of10,pubtest24of10,10,1482,7249,18,219,7486
subtest210of10,pubtest24of10,10,1482,7249,19,258,7526
subtest29of10,pubtest24of10,10,1482,7249,28,288,7565
subtest26of10,pubtest24of10,10,1482,7249,29,326,7604
subtest27of10,pubtest24of10,10,1482,7249,32,364,7645
subtest28of10,pubtest25of10,10,1482,5419,-1,39,5457
subtest210of10,pubtest25of10,10,1482,5419,1,77,5497
subtest21of10,pubtest25of10,10,1482,5419,17,101,5537
subtest26of10,pubtest25of10,10,1482,5419,19,138,5576
subtest27of10,pubtest25of10,10,1482,5419,28,170,5617
subtest22of10,pubtest25of10,10,1482,5419,29,209,5657
subtest25of10,pubtest25of10,10,1482,5419,32,246,5697
subtest23of10,pubtest25of10,10,1482,5419,36,282,5737
subtest29of10,pubtest25of10,10,1482,5419,36,322,5777
subtest24of10,pubtest25of10,10,1482,5419,42,356,5817
subtest22of10,pubtest26of10,10,1482,5490,-2,41,5529
subtest21of10,pubtest26of10,10,1482,5490,6,74,5570
subtest29of10,pubtest26of10,10,1482,5490,16,104,5610
subtest26of10,pubtest26of10,10,1482,5490,19,140,5649
subtest210of10,pubtest26of10,10,1482,5490,26,174,5690
subtest23of10,pubtest26of10,10,1482,5490,33,207,5730
subtest27of10,pubtest26of10,10,1482,5490,34,244,5768
subtest28of10,pubtest26of10,10,1482,5490,38,282,5810
subtest24of10,pubtest26of10,10,1482,5490,41,319,5850
subtest25of10,pubtest26of10,10,1482,5490,46,354,5890
subtest27of10,pubtest27of10,10,1481,5146,3,39,5188
subtest28of10,pubtest27of10,10,1481,5146,4,76,5226
subtest24of10,pubtest27of10,10,1481,5146,9,113,5268
subtest23of10,pubtest27of10,10,1481,5146,10,152,5308
subtest29of10,pubtest27of10,10,1481,5146,27,174,5347
subtest210of10,pubtest27of10,10,1481,5146,29,213,5388
subtest25of10,pubtest27of10,10,1481,5146,33,249,5428
subtest22of10,pubtest27of10,10,1481,5146,40,282,5468
subtest26of10,pubtest27of10,10,1481,5146,47,314,5507
subtest21of10,pubtest27of10,10,1481,5146,48,352,5546
subtest27of10,pubtest28of10,10,1480,5155,-3,266,5418
subtest28of10,pubtest28of10,10,1480,5155,2,300,5457
subtest21of10,pubtest28of10,10,1480,5155,13,330,5498
subtest29of10,pubtest28of10,10,1480,5155,16,367,5538
subtest210of10,pubtest28of10,10,1480,5155,20,401,5576
subtest23of10,pubtest28of10,10,1480,5155,23,440,5618
subtest26of10,pubtest28of10,10,1480,5155,24,479,5658
subtest25of10,pubtest28of10,10,1480,5155,25,518,5698
subtest24of10,pubtest28of10,10,1480,5155,28,555,5738
subtest22of10,pubtest28of10,10,1480,5155,31,591,5777
subtest23of10,pubtest29of10,10,1482,5170,-1,44,5213
subtest210of10,pubtest29of10,10,1482,5170,7,74,5251
subtest29of10,pubtest29of10,10,1482,5170,13,108,5291
subtest22of10,pubtest29of10,10,1482,5170,15,146,5331
subtest25of10,pubtest29of10,10,1482,5170,17,184,5371
subtest28of10,pubtest29of10,10,1482,5170,28,213,5411
subtest21of10,pubtest29of10,10,1482,5170,29,252,5451
subtest24of10,pubtest29of10,10,1482,5170,38,282,5490
subtest27of10,pubtest29of10,10,1482,5170,42,319,5531
subtest26of10,pubtest29of10,10,1482,5170,45,356,5571
subtest29of10,pubtest210of10,10,1493,5195,9,40,5244
subtest21of10,pubtest210of10,10,1493,5195,12,75,5282
subtest210of10,pubtest210of10,10,1493,5195,15,112,5322
subtest27of10,pubtest210of10,10,1493,5195,13,151,5359
subtest28of10,pubtest210of10,10,1493,5195,15,191,5401
subtest24of10,pubtest210of10,10,1493,5195,21,227,5443
subtest22of10,pubtest210of10,10,1493,5195,22,266,5483
subtest23of10,pubtest210of10,10,1493,5195,23,305,5523
subtest26of10,pubtest210of10,10,1493,5195,26,342,5563
subtest25of10,pubtest210of10,10,1493,5195,29,377,5601
subtest26of10,pubtest21of10,10,1483,10058,-4,45,10099
subtest27of10,pubtest21of10,10,1483,10058,-1,82,10139
subtest24of10,pubtest21of10,10,1483,10058,13,108,10179
subtest29of10,pubtest21of10,10,1483,10058,15,146,10219
subtest25of10,pubtest21of10,10,1483,10058,24,175,10257
subtest21of10,pubtest21of10,10,1483,10058,27,213,10298
subtest210of10,pubtest21of10,10,1483,10058,35,246,10339
subtest28of10,pubtest21of10,10,1483,10058,72,249,10379
subtest22of10,pubtest21of10,10,1483,10058,78,283,10419
subtest23of10,pubtest21of10,10,1483,10058,86,315,10459
subtest29of10,pubtest22of10,10,1482,5144,8,40,5192
subtest24of10,pubtest22of10,10,1482,5144,10,76,5230
subtest28of10,pubtest22of10,10,1482,5144,12,116,5272
subtest27of10,pubtest22of10,10,1482,5144,41,127,5312
subtest26of10,pubtest22of10,10,1482,5144,44,164,5352
subtest210of10,pubtest22of10,10,1482,5144,56,192,5392
subtest23of10,pubtest22of10,10,1482,5144,57,230,5431
subtest25of10,pubtest22of10,10,1482,5144,63,265,5472
subtest22of10,pubtest22of10,10,1482,5144,82,286,5512
subtest21of10,pubtest22of10,10,1482,5144,88,319,5551
subtest23of10,pubtest23of10,10,1482,5179,-3,42,5218
subtest28of10,pubtest23of10,10,1482,5179,-1,81,5259
subtest29of10,pubtest23of10,10,1482,5179,7,113,5299
subtest24of10,pubtest23of10,10,1482,5179,9,150,5338
subtest27of10,pubtest23of10,10,1482,5179,13,186,5378
subtest25of10,pubtest23of10,10,1482,5179,14,226,5419
subtest26of10,pubtest23of10,10,1482,5179,17,263,5459
subtest21of10,pubtest23of10,10,1482,5179,21,297,5497
subtest22of10,pubtest23of10,10,1482,5179,24,335,5538
subtest210of10,pubtest23of10,10,1482,5179,33,367,5579
subtest23of10,pubtest24of10,10,1482,5205,-1,45,5249
subtest24of10,pubtest24of10,10,1482,5205,1,82,5288
subtest28of10,pubtest24of10,10,1482,5205,5,118,5328
subtest25of10,pubtest24of10,10,1482,5205,7,154,5366
subtest21of10,pubtest24of10,10,1482,5205,7,194,5406
subtest29of10,pubtest24of10,10,1482,5205,22,221,5448
subtest22of10,pubtest24of10,10,1482,5205,28,255,5488
subtest27of10,pubtest24of10,10,1482,5205,32,291,5528
subtest210of10,pubtest24of10,10,1482,5205,33,329,5567
subtest26of10,pubtest24of10,10,1482,5205,40,362,5607
subtest28of10,pubtest25of10,10,1482,5824,-3,49,5870
subtest210of10,pubtest25of10,10,1482,5824,0,89,5913
subtest21of10,pubtest25of10,10,1482,5824,2,124,5950
subtest26of10,pubtest25of10,10,1482,5824,4,162,5990
subtest27of10,pubtest25of10,10,1482,5824,7,200,6031
subtest22of10,pubtest25of10,10,1482,5824,32,215,6071
subtest25of10,pubtest25of10,10,1482,5824,36,251,6111
subtest23of10,pubtest25of10,10,1482,5824,41,286,6151
subtest29of10,pubtest25of10,10,1482,5824,42,325,6191
subtest24of10,pubtest25of10,10,1482,5824,49,358,6231
subtest22of10,pubtest26of10,10,1482,5556,-5,41,5592
subtest21of10,pubtest26of10,10,1482,5556,-2,79,5633
subtest29of10,pubtest26of10,10,1482,5556,2,115,5673
subtest23of10,pubtest26of10,10,1482,5556,14,143,5713
subtest26of10,pubtest26of10,10,1482,5556,16,181,5753
subtest27of10,pubtest26of10,10,1482,5556,22,215,5793
subtest25of10,pubtest26of10,10,1482,5556,26,249,5831
subtest210of10,pubtest26of10,10,1482,5556,29,288,5873
subtest28of10,pubtest26of10,10,1482,5556,31,326,5913
subtest24of10,pubtest26of10,10,1482,5556,33,364,5953
subtest27of10,pubtest27of10,10,1481,5792,1,39,5832
subtest28of10,pubtest27of10,10,1481,5792,3,78,5873
subtest23of10,pubtest27of10,10,1481,5792,4,115,5911
subtest24of10,pubtest27of10,10,1481,5792,7,153,5952
subtest29of10,pubtest27of10,10,1481,5792,12,189,5993
subtest210of10,pubtest27of10,10,1481,5792,23,218,6033
subtest25of10,pubtest27of10,10,1481,5792,24,257,6073
subtest22of10,pubtest27of10,10,1481,5792,26,295,6113
subtest26of10,pubtest27of10,10,1481,5792,29,331,6152
subtest21of10,pubtest27of10,10,1481,5792,31,369,6192
subtest27of10,pubtest28of10,10,1480,5519,3,41,5563
subtest28of10,pubtest28of10,10,1480,5519,4,80,5603
subtest21of10,pubtest28of10,10,1480,5519,6,118,5643
subtest29of10,pubtest28of10,10,1480,5519,8,156,5683
subtest210of10,pubtest28of10,10,1480,5519,20,183,5722
subtest23of10,pubtest28of10,10,1480,5519,21,222,5762
subtest26of10,pubtest28of10,10,1480,5519,28,256,5803
subtest25of10,pubtest28of10,10,1480,5519,32,292,5843
subtest24of10,pubtest28of10,10,1480,5519,33,329,5881
subtest22of10,pubtest28of10,10,1480,5519,36,368,5923
subtest23of10,pubtest29of10,10,1482,5160,-4,38,5194
subtest210of10,pubtest29of10,10,1482,5160,2,73,5235
subtest29of10,pubtest29of10,10,1482,5160,11,104,5275
subtest25of10,pubtest29of10,10,1482,5160,14,141,5315
subtest22of10,pubtest29of10,10,1482,5160,17,178,5355
subtest28of10,pubtest29of10,10,1482,5160,20,214,5394
subtest21of10,pubtest29of10,10,1482,5160,25,250,5435
subtest24of10,pubtest29of10,10,1482,5160,28,287,5475
subtest27of10,pubtest29of10,10,1482,5160,29,326,5515
subtest26of10,pubtest29of10,10,1482,5160,30,365,5555
subtest29of10,pubtest210of10,10,1493,5276,6,41,5323
subtest21of10,pubtest210of10,10,1493,5276,14,73,5363
subtest210of10,pubtest210of10,10,1493,5276,16,111,5403
subtest28of10,pubtest210of10,10,1493,5276,17,149,5442
subtest27of10,pubtest210of10,10,1493,5276,15,189,5480
subtest24of10,pubtest210of10,10,1493,5276,19,227,5522
subtest22of10,pubtest210of10,10,1493,5276,21,265,5562
subtest23of10,pubtest210of10,10,1493,5276,25,301,5602
subtest26of10,pubtest210of10,10,1493,5276,26,340,5642
subtest25of10,pubtest210of10,10,1493,5276,28,377,5681
subtest26of10,pubtest21of10,10,1483,11944,-2,41,11983
subtest27of10,pubtest21of10,10,1483,11944,3,75,12022
subtest29of10,pubtest21of10,10,1483,11944,12,106,12062
subtest25of10,pubtest21of10,10,1483,11944,16,142,12102
subtest24of10,pubtest21of10,10,1483,11944,17,181,12142
subtest21of10,pubtest21of10,10,1483,11944,21,217,12182
subtest210of10,pubtest21of10,10,1483,11944,25,253,12222
subtest28of10,pubtest21of10,10,1483,11944,25,293,12262
subtest22of10,pubtest21of10,10,1483,11944,27,330,12301
subtest23of10,pubtest21of10,10,1483,11944,27,370,12341
subtest29of10,pubtest22of10,10,1482,7710,-3,42,7749
subtest24of10,pubtest22of10,10,1482,7710,6,72,7788
subtest27of10,pubtest22of10,10,1482,7710,7,111,7828
subtest28of10,pubtest22of10,10,1482,7710,9,149,7868
subtest26of10,pubtest22of10,10,1482,7710,10,186,7906
subtest23of10,pubtest22of10,10,1482,7710,14,224,7948
subtest210of10,pubtest22of10,10,1482,7710,22,255,7987
subtest25of10,pubtest22of10,10,1482,7710,30,288,8028
subtest22of10,pubtest22of10,10,1482,7710,32,326,8068
subtest21of10,pubtest22of10,10,1482,7710,35,363,8108
subtest23of10,pubtest23of10,10,1482,5268,-4,41,5305
subtest28of10,pubtest23of10,10,1482,5268,0,78,5346
subtest24of10,pubtest23of10,10,1482,5268,16,102,5386
subtest29of10,pubtest23of10,10,1482,5268,15,140,5423
subtest27of10,pubtest23of10,10,1482,5268,17,180,5465
subtest26of10,pubtest23of10,10,1482,5268,19,219,5506
subtest25of10,pubtest23of10,10,1482,5268,21,256,5545
subtest22of10,pubtest23of10,10,1482,5268,29,288,5585
subtest21of10,pubtest23of10,10,1482,5268,31,327,5626
subtest210of10,pubtest23of10,10,1482,5268,34,364,5666
subtest23of10,pubtest24of10,10,1482,5861,-3,45,5903
subtest25of10,pubtest24of10,10,1482,5861,0,82,5943
subtest24of10,pubtest24of10,10,1482,5861,-1,120,5980
subtest28of10,pubtest24of10,10,1482,5861,0,159,6020
subtest21of10,pubtest24of10,10,1482,5861,17,186,6064
subtest22of10,pubtest24of10,10,1482,5861,22,222,6105
subtest210of10,pubtest24of10,10,1482,5861,24,259,6144
subtest29of10,pubtest24of10,10,1482,5861,33,290,6184
subtest27of10,pubtest24of10,10,1482,5861,34,329,6224
subtest26of10,pubtest24of10,10,1482,5861,42,361,6264
subtest28of10,pubtest25of10,10,1482,5352,-3,42,5391
subtest21of10,pubtest25of10,10,1482,5352,-1,79,5430
subtest210of10,pubtest25of10,10,1482,5352,1,117,5470
subtest27of10,pubtest25of10,10,1482,5352,2,155,5509
subtest26of10,pubtest25of10,10,1482,5352,5,193,5550
subtest22of10,pubtest25of10,10,1482,5352,14,224,5590
subtest25of10,pubtest25of10,10,1482,5352,15,263,5630
subtest24of10,pubtest25of10,10,1482,5352,22,296,5670
subtest23of10,pubtest25of10,10,1482,5352,27,331,5710
subtest29of10,pubtest25of10,10,1482,5352,28,368,5748
subtest22of10,pubtest26of10,10,1482,5204,0,41,5245
subtest21of10,pubtest26of10,10,1482,5204,3,77,5284
subtest29of10,pubtest26of10,10,1482,5204,4,116,5324
subtest23of10,pubtest26of10,10,1482,5204,6,154,5364
subtest26of10,pubtest26of10,10,1482,5204,16,184,5404
subtest210of10,pubtest26of10,10,1482,5204,17,223,5444
subtest28of10,pubtest26of10,10,1482,5204,25,254,5483
subtest24of10,pubtest26of10,10,1482,5204,29,290,5523
subtest25of10,pubtest26of10,10,1482,5204,29,330,5563
subtest27of10,pubtest26of10,10,1482,5204,26,372,5602
subtest27of10,pubtest27of10,10,1481,5753,-2,40,5791
subtest28of10,pubtest27of10,10,1481,5753,-1,79,5831
subtest23of10,pubtest27of10,10,1481,5753,5,112,5870
subtest24of10,pubtest27of10,10,1481,5753,8,150,5911
subtest29of10,pubtest27of10,10,1481,5753,17,181,5951
subtest210of10,pubtest27of10,10,1481,5753,18,219,5990
subtest22of10,pubtest27of10,10,1481,5753,24,254,6031
subtest25of10,pubtest27of10,10,1481,5753,24,294,6071
subtest26of10,pubtest27of10,10,1481,5753,28,330,6111
subtest21of10,pubtest27of10,10,1481,5753,29,368,6150
subtest27of10,pubtest28of10,10,1480,5221,0,57,5278
subtest28of10,pubtest28of10,10,1480,5221,3,93,5317
subtest21of10,pubtest28of10,10,1480,5221,11,125,5357
subtest210of10,pubtest28of10,10,1480,5221,16,158,5395
subtest29of10,pubtest28of10,10,1480,5221,19,196,5436
subtest26of10,pubtest28of10,10,1480,5221,23,233,5477
subtest23of10,pubtest28of10,10,1480,5221,25,271,5517
subtest25of10,pubtest28of10,10,1480,5221,30,305,5556
subtest24of10,pubtest28of10,10,1480,5221,33,342,5596
subtest22of10,pubtest28of10,10,1480,5221,34,381,5636
subtest23of10,pubtest29of10,10,1482,5297,2,39,5338
subtest210of10,pubtest29of10,10,1482,5297,4,75,5376
subtest29of10,pubtest29of10,10,1482,5297,6,114,5417
subtest25of10,pubtest29of10,10,1482,5297,9,152,5458
subtest22of10,pubtest29of10,10,1482,5297,14,187,5498
subtest28of10,pubtest29of10,10,1482,5297,16,225,5538
subtest21of10,pubtest29of10,10,1482,5297,19,262,5578
subtest24of10,pubtest29of10,10,1482,5297,22,299,5618
subtest27of10,pubtest29of10,10,1482,5297,23,338,5658
subtest26of10,pubtest29of10,10,1482,5297,26,374,5697
subtest29of10,pubtest210of10,10,1493,5409,-2,40,5447
subtest21of10,pubtest210of10,10,1493,5409,7,71,5487
subtest27of10,pubtest210of10,10,1493,5409,9,109,5527
subtest210of10,pubtest210of10,10,1493,5409,17,141,5567
subtest28of10,pubtest210of10,10,1493,5409,18,180,5607
subtest24of10,pubtest210of10,10,1493,5409,20,218,5647
subtest22of10,pubtest210of10,10,1493,5409,27,251,5687
subtest26of10,pubtest210of10,10,1493,5409,28,289,5726
subtest23of10,pubtest210of10,10,1493,5409,31,327,5767
subtest25of10,pubtest210of10,10,1493,5409,31,367,5807
subtest26of10,pubtest21of10,10,1483,11255,-4,41,11292
subtest27of10,pubtest21of10,10,1483,11255,1,76,11332
subtest24of10,pubtest21of10,10,1483,11255,3,114,11372
subtest29of10,pubtest21of10,10,1483,11255,14,143,11412
subtest25of10,pubtest21of10,10,1483,11255,16,180,11451
subtest21of10,pubtest21of10,10,1483,11255,21,216,11492
subtest210of10,pubtest21of10,10,1483,11255,25,252,11532
subtest28of10,pubtest21of10,10,1483,11255,28,288,11571
subtest22of10,pubtest21of10,10,1483,11255,38,317,11610
subtest23of10,pubtest21of10,10,1483,11255,43,354,11652
subtest29of10,pubtest22of10,10,1482,6941,-2,38,6977
subtest24of10,pubtest22of10,10,1482,6941,0,76,7017
subtest27of10,pubtest22of10,10,1482,6941,2,115,7058
subtest28of10,pubtest22of10,10,1482,6941,8,148,7097
subtest26of10,pubtest22of10,10,1482,6941,19,178,7138
subtest210of10,pubtest22of10,10,1482,6941,51,186,7178
subtest23of10,pubtest22of10,10,1482,6941,53,223,7217
subtest25of10,pubtest22of10,10,1482,6941,56,261,7258
subtest21of10,pubtest22of10,10,1482,6941,57,300,7298
subtest22of10,pubtest22of10,10,1482,6941,62,335,7338
subtest23of10,pubtest23of10,10,1482,5278,-3,42,5317
subtest28of10,pubtest23of10,10,1482,5278,1,78,5357
subtest29of10,pubtest23of10,10,1482,5278,16,102,5396
subtest24of10,pubtest23of10,10,1482,5278,18,140,5436
subtest27of10,pubtest23of10,10,1482,5278,21,176,5475
subtest26of10,pubtest23of10,10,1482,5278,25,214,5517
subtest25of10,pubtest23of10,10,1482,5278,26,252,5556
subtest22of10,pubtest23of10,10,1482,5278,44,274,5596
subtest21of10,pubtest23of10,10,1482,5278,45,463,5786
subtest210of10,pubtest23of10,10,1482,5278,47,499,5824
subtest24of10,pubtest24of10,10,1482,6071,-4,40,6107
subtest23of10,pubtest24of10,10,1482,6071,4,73,6148
subtest28of10,pubtest24of10,10,1482,6071,20,95,6186
subtest25of10,pubtest24of10,10,1482,6071,23,134,6228
subtest22of10,pubtest24of10,10,1482,6071,24,172,6267
subtest21of10,pubtest24of10,10,1482,6071,26,211,6308
subtest210of10,pubtest24of10,10,1482,6071,29,248,6348
subtest29of10,pubtest24of10,10,1482,6071,30,286,6387
subtest27of10,pubtest24of10,10,1482,6071,32,325,6428
subtest26of10,pubtest24of10,10,1482,6071,33,364,6468
subtest28of10,pubtest25of10,10,1482,6813,-3,42,6852
subtest21of10,pubtest25of10,10,1482,6813,15,65,6893
subtest210of10,pubtest25of10,10,1482,6813,15,104,6932
subtest26of10,pubtest25of10,10,1482,6813,17,143,6973
subtest22of10,pubtest25of10,10,1482,6813,20,180,7013
subtest27of10,pubtest25of10,10,1482,6813,21,219,7053
subtest25of10,pubtest25of10,10,1482,6813,25,255,7093
subtest23of10,pubtest25of10,10,1482,6813,27,293,7133
subtest29of10,pubtest25of10,10,1482,6813,28,332,7173
subtest24of10,pubtest25of10,10,1482,6813,30,370,7213
subtest22of10,pubtest26of10,10,1482,7606,-3,40,7643
subtest29of10,pubtest26of10,10,1482,7606,0,77,7683
subtest21of10,pubtest26of10,10,1482,7606,0,117,7723
subtest23of10,pubtest26of10,10,1482,7606,18,139,7763
subtest26of10,pubtest26of10,10,1482,7606,27,170,7803
subtest210of10,pubtest26of10,10,1482,7606,28,208,7842
subtest28of10,pubtest26of10,10,1482,7606,30,247,7883
subtest27of10,pubtest26of10,10,1482,7606,31,285,7922
subtest24of10,pubtest26of10,10,1482,7606,33,323,7962
subtest25of10,pubtest26of10,10,1482,7606,34,363,8003
subtest27of10,pubtest27of10,10,1481,5353,4,41,5398
subtest28of10,pubtest27of10,10,1481,5353,6,78,5437
subtest23of10,pubtest27of10,10,1481,5353,7,116,5476
subtest24of10,pubtest27of10,10,1481,5353,9,155,5517
subtest29of10,pubtest27of10,10,1481,5353,11,193,5557
subtest210of10,pubtest27of10,10,1481,5353,13,230,5596
subtest25of10,pubtest27of10,10,1481,5353,15,268,5636
subtest22of10,pubtest27of10,10,1481,5353,17,305,5675
subtest26of10,pubtest27of10,10,1481,5353,21,343,5717
subtest21of10,pubtest27of10,10,1481,5353,27,377,5757
subtest27of10,pubtest28of10,10,1480,5325,-2,38,5361
subtest21of10,pubtest28of10,10,1480,5325,1,75,5401
subtest28of10,pubtest28of10,10,1480,5325,5,111,5441
subtest29of10,pubtest28of10,10,1480,5325,19,137,5481
subtest210of10,pubtest28of10,10,1480,5325,23,173,5521
subtest26of10,pubtest28of10,10,1480,5325,30,206,5561
subtest23of10,pubtest28of10,10,1480,5325,30,246,5601
subtest25of10,pubtest28of10,10,1480,5325,32,284,5641
subtest24of10,pubtest28of10,10,1480,5325,41,314,5680
subtest22of10,pubtest28of10,10,1480,5325,45,350,5720
subtest23of10,pubtest29of10,10,1482,5211,10,48,5269
subtest210of10,pubtest29of10,10,1482,5211,11,87,5309
subtest29of10,pubtest29of10,10,1482,5211,17,119,5347
subtest25of10,pubtest29of10,10,1482,5211,20,157,5388
subtest28of10,pubtest29of10,10,1482,5211,20,197,5428
subtest22of10,pubtest29of10,10,1482,5211,18,236,5465
subtest21of10,pubtest29of10,10,1482,5211,24,274,5509
subtest24of10,pubtest29of10,10,1482,5211,23,314,5548
subtest27of10,pubtest29of10,10,1482,5211,27,351,5589
subtest26of10,pubtest29of10,10,1482,5211,36,382,5629
subtest29of10,pubtest210of10,10,1493,5209,-3,38,5244
subtest21of10,pubtest210of10,10,1493,5209,5,70,5284
subtest210of10,pubtest210of10,10,1493,5209,10,106,5325
subtest27of10,pubtest210of10,10,1493,5209,9,145,5363
subtest28of10,pubtest210of10,10,1493,5209,14,182,5405
subtest24of10,pubtest210of10,10,1493,5209,16,219,5444
subtest23of10,pubtest210of10,10,1493,5209,22,254,5485
subtest22of10,pubtest210of10,10,1493,5209,21,293,5523
subtest26of10,pubtest210of10,10,1493,5209,25,331,5565
subtest25of10,pubtest210of10,10,1493,5209,29,366,5604
subtest27of10,pubtest21of10,10,1483,10144,-3,41,10182
subtest26of10,pubtest21of10,10,1483,10144,1,78,10223
subtest24of10,pubtest21of10,10,1483,10144,5,114,10263
subtest29of10,pubtest21of10,10,1483,10144,10,149,10303
subtest25of10,pubtest21of10,10,1483,10144,12,187,10343
subtest21of10,pubtest21of10,10,1483,10144,21,217,10382
subtest210of10,pubtest21of10,10,1483,10144,23,256,10423
subtest28of10,pubtest21of10,10,1483,10144,24,294,10462
subtest22of10,pubtest21of10,10,1483,10144,29,327,10500
subtest23of10,pubtest21of10,10,1483,10144,32,367,10543
subtest29of10,pubtest22of10,10,1482,5180,0,429,5609
subtest24of10,pubtest22of10,10,1482,5180,2,464,5646
subtest27of10,pubtest22of10,10,1482,5180,3,503,5686
subtest28of10,pubtest22of10,10,1482,5180,13,534,5727
subtest26of10,pubtest22of10,10,1482,5180,19,568,5767
subtest210of10,pubtest22of10,10,1482,5180,26,600,5806
subtest23of10,pubtest22of10,10,1482,5180,28,637,5845
subtest22of10,pubtest22of10,10,1482,5180,30,676,5886
subtest25of10,pubtest22of10,10,1482,5180,33,714,5927
subtest21of10,pubtest22of10,10,1482,5180,35,752,5967
subtest23of10,pubtest23of10,10,1482,5393,-4,39,5428
subtest29of10,pubtest23of10,10,1482,5393,1,74,5468
subtest28of10,pubtest23of10,10,1482,5393,7,108,5508
subtest24of10,pubtest23of10,10,1482,5393,15,138,5546
subtest27of10,pubtest23of10,10,1482,5393,19,176,5588
subtest26of10,pubtest23of10,10,1482,5393,22,213,5628
subtest25of10,pubtest23of10,10,1482,5393,23,252,5668
subtest22of10,pubtest23of10,10,1482,5393,35,278,5706
subtest21of10,pubtest23of10,10,1482,5393,37,318,5748
subtest210of10,pubtest23of10,10,1482,5393,39,356,5788
subtest23of10,pubtest24of10,10,1482,5222,-3,46,5265
subtest24of10,pubtest24of10,10,1482,5222,-1,84,5305
subtest25of10,pubtest24of10,10,1482,5222,4,120,5346
subtest28of10,pubtest24of10,10,1482,5222,10,154,5386
subtest21of10,pubtest24of10,10,1482,5222,13,191,5426
subtest29of10,pubtest24of10,10,1482,5222,18,226,5466
subtest22of10,pubtest24of10,10,1482,5222,21,263,5506
subtest27of10,pubtest24of10,10,1482,5222,26,299,5547
subtest210of10,pubtest24of10,10,1482,5222,26,338,5586
subtest26of10,pubtest24of10,10,1482,5222,30,374,5626
subtest28of10,pubtest25of10,10,1482,5261,-3,43,5301
subtest21of10,pubtest25of10,10,1482,5261,0,81,5342
subtest210of10,pubtest25of10,10,1482,5261,4,116,5381
subtest27of10,pubtest25of10,10,1482,5261,7,154,5422
subtest26of10,pubtest25of10,10,1482,5261,12,189,5462
subtest22of10,pubtest25of10,10,1482,5261,19,222,5502
subtest25of10,pubtest25of10,10,1482,5261,26,254,5541
subtest23of10,pubtest25of10,10,1482,5261,29,292,5582
subtest29of10,pubtest25of10,10,1482,5261,29,331,5621
subtest24of10,pubtest25of10,10,1482,5261,31,370,5662
subtest29of10,pubtest26of10,10,1482,5186,6,38,5230
subtest21of10,pubtest26of10,10,1482,5186,2,82,5270
subtest23of10,pubtest26of10,10,1482,5186,9,116,5311
subtest27of10,pubtest26of10,10,1482,5186,10,155,5351
subtest25of10,pubtest26of10,10,1482,5186,15,189,5390
subtest22of10,pubtest26of10,10,1482,5186,62,183,5431
subtest26of10,pubtest26of10,10,1482,5186,63,222,5471
subtest210of10,pubtest26of10,10,1482,5186,67,257,5510
subtest28of10,pubtest26of10,10,1482,5186,68,296,5550
subtest24of10,pubtest26of10,10,1482,5186,70,335,5591
subtest27of10,pubtest27of10,10,1481,5178,8,43,5229
subtest28of10,pubtest27of10,10,1481,5178,10,80,5268
subtest23of10,pubtest27of10,10,1481,5178,25,104,5307
subtest24of10,pubtest27of10,10,1481,5178,25,144,5347
subtest29of10,pubtest27of10,10,1481,5178,33,177,5388
subtest210of10,pubtest27of10,10,1481,5178,39,211,5428
subtest25of10,pubtest27of10,10,1481,5178,43,247,5468
subtest22of10,pubtest27of10,10,1481,5178,44,286,5508
subtest26of10,pubtest27of10,10,1481,5178,46,324,5548
subtest21of10,pubtest27of10,10,1481,5178,51,359,5588
subtest27of10,pubtest28of10,10,1480,5255,4,39,5298
subtest28of10,pubtest28of10,10,1480,5255,6,76,5337
subtest21of10,pubtest28of10,10,1480,5255,8,113,5376
subtest29of10,pubtest28of10,10,1480,5255,10,152,5417
subtest23of10,pubtest28of10,10,1480,5255,18,185,5458
subtest210of10,pubtest28of10,10,1480,5255,25,218,5498
subtest25of10,pubtest28of10,10,1480,5255,28,255,5538
subtest26of10,pubtest28of10,10,1480,5255,29,294,5578
subtest24of10,pubtest28of10,10,1480,5255,30,332,5617
subtest22of10,pubtest28of10,10,1480,5255,31,371,5657
subtest23of10,pubtest29of10,10,1482,5150,-2,42,5190
subtest210of10,pubtest29of10,10,1482,5150,5,75,5230
subtest29of10,pubtest29of10,10,1482,5150,9,111,5270
subtest25of10,pubtest29of10,10,1482,5150,16,144,5310
subtest22of10,pubtest29of10,10,1482,5150,17,183,5350
subtest21of10,pubtest29of10,10,1482,5150,21,219,5390
subtest27of10,pubtest29of10,10,1482,5150,27,253,5430
subtest28of10,pubtest29of10,10,1482,5150,59,260,5469
subtest24of10,pubtest29of10,10,1482,5150,61,299,5510
subtest26of10,pubtest29of10,10,1482,5150,65,335,5550
subtest29of10,pubtest210of10,10,1493,5303,8,42,5353
subtest21of10,pubtest210of10,10,1493,5303,9,81,5393
subtest27of10,pubtest210of10,10,1493,5303,11,119,5433
subtest210of10,pubtest210of10,10,1493,5303,11,158,5472
subtest24of10,pubtest210of10,10,1493,5303,13,196,5512
subtest28of10,pubtest210of10,10,1493,5303,13,235,5551
subtest26of10,pubtest210of10,10,1493,5303,15,274,5592
subtest23of10,pubtest210of10,10,1493,5303,17,313,5633
subtest22of10,pubtest210of10,10,1493,5303,17,350,5670
subtest25of10,pubtest210of10,10,1493,5303,21,389,5713
subtest26of10,pubtest21of10,10,1483,10345,-2,41,10384
subtest27of10,pubtest21of10,10,1483,10345,2,77,10424
subtest24of10,pubtest21of10,10,1483,10345,4,115,10464
subtest29of10,pubtest21of10,10,1483,10345,19,139,10503
subtest25of10,pubtest21of10,10,1483,10345,22,177,10544
subtest21of10,pubtest21of10,10,1483,10345,27,211,10583
subtest210of10,pubtest21of10,10,1483,10345,33,246,10624
subtest28of10,pubtest21of10,10,1483,10345,34,284,10663
subtest23of10,pubtest21of10,10,1483,10345,37,322,10704
subtest22of10,pubtest21of10,10,1483,10345,42,357,10744
subtest29of10,pubtest22of10,10,1482,5276,9,41,5326
subtest24of10,pubtest22of10,10,1482,5276,10,80,5366
subtest27of10,pubtest22of10,10,1482,5276,12,118,5406
subtest28of10,pubtest22of10,10,1482,5276,14,154,5444
subtest23of10,pubtest22of10,10,1482,5276,18,193,5487
subtest26of10,pubtest22of10,10,1482,5276,18,233,5527
subtest210of10,pubtest22of10,10,1482,5276,34,256,5566
subtest25of10,pubtest22of10,10,1482,5276,35,296,5607
subtest22of10,pubtest22of10,10,1482,5276,43,328,5647
subtest21of10,pubtest22of10,10,1482,5276,45,366,5687
subtest23of10,pubtest23of10,10,1482,5252,2,39,5293
subtest28of10,pubtest23of10,10,1482,5252,13,67,5332
subtest29of10,pubtest23of10,10,1482,5252,25,95,5372
subtest27of10,pubtest23of10,10,1482,5252,27,133,5412
subtest25of10,pubtest23of10,10,1482,5252,31,170,5453
subtest24of10,pubtest23of10,10,1482,5252,33,208,5493
subtest26of10,pubtest23of10,10,1482,5252,34,248,5534
subtest22of10,pubtest23of10,10,1482,5252,44,277,5573
subtest21of10,pubtest23of10,10,1482,5252,46,315,5613
subtest210of10,pubtest23of10,10,1482,5252,48,353,5653
subtest23of10,pubtest24of10,10,1482,5156,1,40,5197
subtest24of10,pubtest24of10,10,1482,5156,3,77,5236
subtest28of10,pubtest24of10,10,1482,5156,6,113,5275
subtest25of10,pubtest24of10,10,1482,5156,26,134,5316
subtest22of10,pubtest24of10,10,1482,5156,44,155,5355
subtest21of10,pubtest24of10,10,1482,5156,46,194,5396
subtest210of10,pubtest24of10,10,1482,5156,47,233,5436
subtest29of10,pubtest24of10,10,1482,5156,56,264,5476
subtest27of10,pubtest24of10,10,1482,5156,62,298,5516
subtest26of10,pubtest24of10,10,1482,5156,64,334,5554
subtest28of10,pubtest25of10,10,1482,5276,3,46,5325
subtest21of10,pubtest25of10,10,1482,5276,4,83,5363
subtest210of10,pubtest25of10,10,1482,5276,9,118,5403
subtest26of10,pubtest25of10,10,1482,5276,10,157,5443
subtest22of10,pubtest25of10,10,1482,5276,13,194,5483
subtest27of10,pubtest25of10,10,1482,5276,15,232,5523
subtest25of10,pubtest25of10,10,1482,5276,40,245,5561
subtest23of10,pubtest25of10,10,1482,5276,54,273,5603
subtest29of10,pubtest25of10,10,1482,5276,56,311,5643
subtest24of10,pubtest25of10,10,1482,5276,61,346,5683
subtest22of10,pubtest26of10,10,1482,5247,3,42,5292
subtest21of10,pubtest26of10,10,1482,5247,16,68,5331
subtest29of10,pubtest26of10,10,1482,5247,18,106,5371
subtest23of10,pubtest26of10,10,1482,5247,22,142,5411
subtest26of10,pubtest26of10,10,1482,5247,24,178,5449
subtest210of10,pubtest26of10,10,1482,5247,33,211,5491
subtest28of10,pubtest26of10,10,1482,5247,34,250,5531
subtest27of10,pubtest26of10,10,1482,5247,48,276,5571
subtest24of10,pubtest26of10,10,1482,5247,53,311,5611
subtest25of10,pubtest26of10,10,1482,5247,54,349,5650
subtest27of10,pubtest27of10,10,1481,5195,7,42,5244
subtest28of10,pubtest27of10,10,1481,5195,10,78,5283
subtest23of10,pubtest27of10,10,1481,5195,15,114,5324
subtest24of10,pubtest27of10,10,1481,5195,20,149,5364
subtest210of10,pubtest27of10,10,1481,5195,28,180,5403
subtest29of10,pubtest27of10,10,1481,5195,30,219,5444
subtest22of10,pubtest27of10,10,1481,5195,41,248,5484
subtest25of10,pubtest27of10,10,1481,5195,48,281,5524
subtest26of10,pubtest27of10,10,1481,5195,48,320,5563
subtest21of10,pubtest27of10,10,1481,5195,55,354,5604
subtest27of10,pubtest28of10,10,1480,5302,0,42,5344
subtest28of10,pubtest28of10,10,1480,5302,3,75,5380
subtest21of10,pubtest28of10,10,1480,5302,4,114,5420
subtest29of10,pubtest28of10,10,1480,5302,6,153,5461
subtest210of10,pubtest28of10,10,1480,5302,15,184,5501
subtest23of10,pubtest28of10,10,1480,5302,24,215,5541
subtest26of10,pubtest28of10,10,1480,5302,26,253,5581
subtest25of10,pubtest28of10,10,1480,5302,29,290,5621
subtest24of10,pubtest28of10,10,1480,5302,39,320,5661
subtest22of10,pubtest28of10,10,1480,5302,40,356,5698
subtest23of10,pubtest29of10,10,1482,5230,3,50,5283
subtest210of10,pubtest29of10,10,1482,5230,4,88,5322
subtest22of10,pubtest29of10,10,1482,5230,17,115,5362
subtest29of10,pubtest29of10,10,1482,5230,18,153,5401
subtest25of10,pubtest29of10,10,1482,5230,20,191,5441
subtest28of10,pubtest29of10,10,1482,5230,25,227,5482
subtest24of10,pubtest29of10,10,1482,5230,27,264,5521
subtest21of10,pubtest29of10,10,1482,5230,31,301,5562
subtest27of10,pubtest29of10,10,1482,5230,33,339,5602
subtest26of10,pubtest29of10,10,1482,5230,34,377,5641
subtest29of10,pubtest210of10,10,1493,5270,7,41,5318
subtest21of10,pubtest210of10,10,1493,5270,9,76,5355
subtest210of10,pubtest210of10,10,1493,5270,11,115,5396
subtest28of10,pubtest210of10,10,1493,5270,16,150,5436
subtest27of10,pubtest210of10,10,1493,5270,13,190,5473
subtest24of10,pubtest210of10,10,1493,5270,26,219,5515
subtest22of10,pubtest210of10,10,1493,5270,32,254,5556
subtest26of10,pubtest210of10,10,1493,5270,34,292,5596
subtest23of10,pubtest210of10,10,1493,5270,36,330,5636
subtest25of10,pubtest210of10,10,1493,5270,38,368,5676
subtest26of10,pubtest21of10,10,1483,10234,-6,42,10270
subtest27of10,pubtest21of10,10,1483,10234,-1,77,10310
subtest29of10,pubtest21of10,10,1483,10234,-1,117,10350
subtest24of10,pubtest21of10,10,1483,10234,8,148,10390
subtest25of10,pubtest21of10,10,1483,10234,16,181,10431
subtest21of10,pubtest21of10,10,1483,10234,21,215,10470
subtest210of10,pubtest21of10,10,1483,10234,21,254,10509
subtest28of10,pubtest21of10,10,1483,10234,23,293,10550
subtest22of10,pubtest21of10,10,1483,10234,36,319,10589
subtest23of10,pubtest21of10,10,1483,10234,38,358,10630
subtest29of10,pubtest22of10,10,1482,5238,1,43,5282
subtest24of10,pubtest22of10,10,1482,5238,3,81,5322
subtest27of10,pubtest22of10,10,1482,5238,14,110,5362
subtest28of10,pubtest22of10,10,1482,5238,26,137,5401
subtest26of10,pubtest22of10,10,1482,5238,27,177,5442
subtest23of10,pubtest22of10,10,1482,5238,47,197,5482
subtest210of10,pubtest22of10,10,1482,5238,50,234,5522
subtest25of10,pubtest22of10,10,1482,5238,59,264,5561
subtest22of10,pubtest22of10,10,1482,5238,61,301,5600
subtest21of10,pubtest22of10,10,1482,5238,69,335,5642
subtest23of10,pubtest23of10,10,1482,5444,12,61,5517
subtest28of10,pubtest23of10,10,1482,5444,13,99,5556
subtest27of10,pubtest23of10,10,1482,5444,18,135,5597
subtest25of10,pubtest23of10,10,1482,5444,18,174,5636
subtest24of10,pubtest23of10,10,1482,5444,16,214,5674
subtest29of10,pubtest23of10,10,1482,5444,19,254,5717
subtest21of10,pubtest23of10,10,1482,5444,25,288,5757
subtest22of10,pubtest23of10,10,1482,5444,25,328,5797
subtest210of10,pubtest23of10,10,1482,5444,27,365,5836
subtest26of10,pubtest23of10,10,1482,5444,30,403,5877
subtest23of10,pubtest24of10,10,1482,5322,6,74,5402
subtest24of10,pubtest24of10,10,1482,5322,4,108,5434
subtest28of10,pubtest24of10,10,1482,5322,8,145,5475
subtest25of10,pubtest24of10,10,1482,5322,10,121,5453
subtest27of10,pubtest24of10,10,1482,5322,74,159,5555
subtest29of10,pubtest24of10,10,1482,5322,76,197,5595
subtest210of10,pubtest24of10,10,1482,5322,77,236,5635
subtest22of10,pubtest24of10,10,1482,5322,78,275,5675
subtest26of10,pubtest24of10,10,1482,5322,78,315,5715
subtest21of10,pubtest24of10,10,1482,5322,78,353,5753
subtest21of10,pubtest25of10,10,1482,5172,5,42,5219
subtest28of10,pubtest25of10,10,1482,5172,6,82,5260
subtest210of10,pubtest25of10,10,1482,5172,9,117,5298
subtest27of10,pubtest25of10,10,1482,5172,18,149,5339
subtest26of10,pubtest25of10,10,1482,5172,23,184,5379
subtest25of10,pubtest25of10,10,1482,5172,44,203,5419
subtest22of10,pubtest25of10,10,1482,5172,50,236,5458
subtest23of10,pubtest25of10,10,1482,5172,60,267,5499
subtest29of10,pubtest25of10,10,1482,5172,63,304,5539
subtest24of10,pubtest25of10,10,1482,5172,67,340,5579
subtest21of10,pubtest26of10,10,1482,5214,3,52,5269
subtest22of10,pubtest26of10,10,1482,5214,8,87,5309
subtest29of10,pubtest26of10,10,1482,5214,33,102,5349
subtest23of10,pubtest26of10,10,1482,5214,38,136,5388
subtest210of10,pubtest26of10,10,1482,5214,39,175,5428
subtest26of10,pubtest26of10,10,1482,5214,40,214,5468
subtest28of10,pubtest26of10,10,1482,5214,42,253,5509
subtest25of10,pubtest26of10,10,1482,5214,61,274,5549
subtest27of10,pubtest26of10,10,1482,5214,61,314,5589
subtest24of10,pubtest26of10,10,1482,5214,65,350,5629
subtest27of10,pubtest27of10,10,1481,5196,27,40,5263
subtest28of10,pubtest27of10,10,1481,5196,38,69,5303
subtest24of10,pubtest27of10,10,1481,5196,60,86,5342
subtest23of10,pubtest27of10,10,1481,5196,89,97,5382
subtest29of10,pubtest27of10,10,1481,5196,135,90,5421
subtest210of10,pubtest27of10,10,1481,5196,149,117,5462
subtest25of10,pubtest27of10,10,1481,5196,158,148,5502
subtest22of10,pubtest27of10,10,1481,5196,178,168,5542
subtest21of10,pubtest27of10,10,1481,5196,192,194,5582
subtest26of10,pubtest27of10,10,1481,5196,238,188,5622
subtest27of10,pubtest28of10,10,1480,5776,0,38,5814
subtest21of10,pubtest28of10,10,1480,5776,8,70,5854
subtest29of10,pubtest28of10,10,1480,5776,10,109,5895
subtest28of10,pubtest28of10,10,1480,5776,10,149,5935
subtest210of10,pubtest28of10,10,1480,5776,18,181,5975
subtest23of10,pubtest28of10,10,1480,5776,19,219,6014
subtest26of10,pubtest28of10,10,1480,5776,21,258,6055
subtest25of10,pubtest28of10,10,1480,5776,22,296,6094
subtest24of10,pubtest28of10,10,1480,5776,24,335,6135
subtest22of10,pubtest28of10,10,1480,5776,26,373,6175
subtest23of10,pubtest29of10,10,1482,5821,11,167,5999
subtest29of10,pubtest29of10,10,1482,5821,15,205,6041
subtest210of10,pubtest29of10,10,1482,5821,17,243,6081
subtest25of10,pubtest29of10,10,1482,5821,19,281,6121
subtest22of10,pubtest29of10,10,1482,5821,22,318,6161
subtest28of10,pubtest29of10,10,1482,5821,24,356,6201
subtest21of10,pubtest29of10,10,1482,5821,26,394,6241
subtest27of10,pubtest29of10,10,1482,5821,29,431,6281
subtest24of10,pubtest29of10,10,1482,5821,30,468,6319
subtest26of10,pubtest29of10,10,1482,5821,33,507,6361
subtest29of10,pubtest210of10,10,1493,5446,7,38,5491
subtest21of10,pubtest210of10,10,1493,5446,32,54,5532
subtest27of10,pubtest210of10,10,1493,5446,34,92,5572
subtest210of10,pubtest210of10,10,1493,5446,36,130,5612
subtest28of10,pubtest210of10,10,1493,5446,37,167,5650
subtest24of10,pubtest210of10,10,1493,5446,38,206,5690
subtest22of10,pubtest210of10,10,1493,5446,41,244,5731
subtest26of10,pubtest210of10,10,1493,5446,41,284,5771
subtest25of10,pubtest210of10,10,1493,5446,44,322,5812
subtest23of10,pubtest210of10,10,1493,5446,40,362,5848
subtest26of10,pubtest21of10,10,1483,11010,0,42,11052
subtest27of10,pubtest21of10,10,1483,11010,1,81,11092
subtest24of10,pubtest21of10,10,1483,11010,4,118,11132
subtest29of10,pubtest21of10,10,1483,11010,4,158,11172
subtest25of10,pubtest21of10,10,1483,11010,20,181,11211
subtest21of10,pubtest21of10,10,1483,11010,21,221,11252
subtest23of10,pubtest21of10,10,1483,11010,23,259,11292
subtest210of10,pubtest21of10,10,1483,11010,23,299,11332
subtest28of10,pubtest21of10,10,1483,11010,25,336,11371
subtest22of10,pubtest21of10,10,1483,11010,26,375,11411
subtest29of10,pubtest22of10,10,1482,5506,1,128,5635
subtest24of10,pubtest22of10,10,1482,5506,8,161,5675
subtest27of10,pubtest22of10,10,1482,5506,10,200,5716
subtest28of10,pubtest22of10,10,1482,5506,13,237,5756
subtest26of10,pubtest22of10,10,1482,5506,18,272,5796
subtest23of10,pubtest22of10,10,1482,5506,19,311,5836
subtest210of10,pubtest22of10,10,1482,5506,22,347,5875
subtest25of10,pubtest22of10,10,1482,5506,23,386,5915
subtest22of10,pubtest22of10,10,1482,5506,27,423,5956
subtest21of10,pubtest22of10,10,1482,5506,33,457,5996
subtest23of10,pubtest23of10,10,1482,5711,7,49,5767
subtest28of10,pubtest23of10,10,1482,5711,8,88,5807
subtest24of10,pubtest23of10,10,1482,5711,10,125,5846
subtest29of10,pubtest23of10,10,1482,5711,13,163,5887
subtest26of10,pubtest23of10,10,1482,5711,15,201,5927
subtest25of10,pubtest23of10,10,1482,5711,17,239,5967
subtest27of10,pubtest23of10,10,1482,5711,17,279,6007
subtest22of10,pubtest23of10,10,1482,5711,23,313,6047
subtest21of10,pubtest23of10,10,1482,5711,25,351,6087
subtest210of10,pubtest23of10,10,1482,5711,27,389,6127
subtest24of10,pubtest24of10,10,1482,5621,-3,42,5660
subtest23of10,pubtest24of10,10,1482,5621,-2,79,5698
subtest28of10,pubtest24of10,10,1482,5621,2,115,5738
subtest25of10,pubtest24of10,10,1482,5621,7,150,5778
subtest22of10,pubtest24of10,10,1482,5621,11,187,5819
subtest21of10,pubtest24of10,10,1482,5621,27,210,5858
subtest29of10,pubtest24of10,10,1482,5621,30,247,5898
subtest210of10,pubtest24of10,10,1482,5621,33,284,5938
subtest27of10,pubtest24of10,10,1482,5621,34,323,5978
subtest26of10,pubtest24of10,10,1482,5621,35,362,6018
subtest28of10,pubtest25of10,10,1482,5398,-5,41,5434
subtest21of10,pubtest25of10,10,1482,5398,-1,74,5471
subtest210of10,pubtest25of10,10,1482,5398,2,112,5512
subtest26of10,pubtest25of10,10,1482,5398,9,145,5552
subtest27of10,pubtest25of10,10,1482,5398,15,178,5591
subtest22of10,pubtest25of10,10,1482,5398,17,217,5632
subtest25of10,pubtest25of10,10,1482,5398,23,251,5672
subtest23of10,pubtest25of10,10,1482,5398,25,288,5711
subtest29of10,pubtest25of10,10,1482,5398,26,328,5752
subtest24of10,pubtest25of10,10,1482,5398,31,363,5792
subtest22of10,pubtest26of10,10,1482,5824,10,45,5879
subtest29of10,pubtest26of10,10,1482,5824,13,82,5919
subtest21of10,pubtest26of10,10,1482,5824,11,121,5956
subtest23of10,pubtest26of10,10,1482,5824,29,146,5999
subtest26of10,pubtest26of10,10,1482,5824,32,183,6039
subtest210of10,pubtest26of10,10,1482,5824,37,218,6079
subtest28of10,pubtest26of10,10,1482,5824,40,255,6119
subtest27of10,pubtest26of10,10,1482,5824,67,267,6158
subtest24of10,pubtest26of10,10,1482,5824,69,305,6198
subtest25of10,pubtest26of10,10,1482,5824,70,345,6239
subtest27of10,pubtest27of10,10,1481,5571,6,40,5617
subtest28of10,pubtest27of10,10,1481,5571,14,72,5657
subtest24of10,pubtest27of10,10,1481,5571,26,99,5696
subtest23of10,pubtest27of10,10,1481,5571,28,137,5736
subtest29of10,pubtest27of10,10,1481,5571,43,162,5776
subtest210of10,pubtest27of10,10,1481,5571,59,186,5816
subtest25of10,pubtest27of10,10,1481,5571,81,205,5857
subtest22of10,pubtest27of10,10,1481,5571,88,238,5897
subtest26of10,pubtest27of10,10,1481,5571,113,252,5936
subtest21of10,pubtest27of10,10,1481,5571,136,270,5977
subtest27of10,pubtest28of10,10,1480,5199,-3,42,5238
subtest28of10,pubtest28of10,10,1480,5199,2,78,5279
subtest21of10,pubtest28of10,10,1480,5199,4,116,5319
subtest29of10,pubtest28of10,10,1480,5199,10,150,5359
subtest210of10,pubtest28of10,10,1480,5199,21,179,5399
subtest23of10,pubtest28of10,10,1480,5199,23,217,5439
subtest25of10,pubtest28of10,10,1480,5199,26,254,5479
subtest26of10,pubtest28of10,10,1480,5199,29,291,5519
subtest24of10,pubtest28of10,10,1480,5199,33,327,5559
subtest22of10,pubtest28of10,10,1480,5199,35,365,5599
subtest23of10,pubtest29of10,10,1482,5525,0,43,5568
subtest210of10,pubtest29of10,10,1482,5525,2,81,5608
subtest29of10,pubtest29of10,10,1482,5525,15,108,5648
subtest22of10,pubtest29of10,10,1482,5525,19,144,5688
subtest25of10,pubtest29of10,10,1482,5525,24,179,5728
subtest28of10,pubtest29of10,10,1482,5525,28,214,5767
subtest21of10,pubtest29of10,10,1482,5525,29,254,5808
subtest27of10,pubtest29of10,10,1482,5525,32,291,5848
subtest24of10,pubtest29of10,10,1482,5525,36,326,5887
subtest26of10,pubtest29of10,10,1482,5525,38,364,5927
subtest29of10,pubtest210of10,10,1493,5427,-3,44,5468
subtest21of10,pubtest210of10,10,1493,5427,2,77,5506
subtest27of10,pubtest210of10,10,1493,5427,3,116,5546
subtest210of10,pubtest210of10,10,1493,5427,13,146,5586
subtest28of10,pubtest210of10,10,1493,5427,19,179,5625
subtest24of10,pubtest210of10,10,1493,5427,21,217,5665
subtest22of10,pubtest210of10,10,1493,5427,22,256,5705
subtest26of10,pubtest210of10,10,1493,5427,24,295,5746
subtest23of10,pubtest210of10,10,1493,5427,26,333,5786
subtest25of10,pubtest210of10,10,1493,5427,27,372,5826
subtest27of10,pubtest21of10,10,1483,11016,-1,41,11056
subtest26of10,pubtest21of10,10,1483,11016,0,79,11095
subtest24of10,pubtest21of10,10,1483,11016,3,117,11136
subtest29of10,pubtest21of10,10,1483,11016,22,139,11177
subtest25of10,pubtest21of10,10,1483,11016,23,177,11216
subtest21of10,pubtest21of10,10,1483,11016,24,216,11256
subtest23of10,pubtest21of10,10,1483,11016,26,255,11297
subtest210of10,pubtest21of10,10,1483,11016,28,293,11337
subtest28of10,pubtest21of10,10,1483,11016,31,330,11377
subtest22of10,pubtest21of10,10,1483,11016,33,368,11417
subtest29of10,pubtest22of10,10,1482,5273,-3,41,5311
subtest24of10,pubtest22of10,10,1482,5273,-1,79,5351
subtest27of10,pubtest22of10,10,1482,5273,7,111,5391
subtest28of10,pubtest22of10,10,1482,5273,32,125,5430
subtest26of10,pubtest22of10,10,1482,5273,45,153,5471
subtest210of10,pubtest22of10,10,1482,5273,52,186,5511
subtest23of10,pubtest22of10,10,1482,5273,62,216,5551
subtest25of10,pubtest22of10,10,1482,5273,67,251,5591
subtest21of10,pubtest22of10,10,1482,5273,71,285,5629
subtest22of10,pubtest22of10,10,1482,5273,74,323,5670
subtest23of10,pubtest23of10,10,1482,5474,5,41,5520
subtest28of10,pubtest23of10,10,1482,5474,7,79,5560
subtest24of10,pubtest23of10,10,1482,5474,11,115,5600
subtest29of10,pubtest23of10,10,1482,5474,11,154,5639
subtest27of10,pubtest23of10,10,1482,5474,14,192,5680
subtest26of10,pubtest23of10,10,1482,5474,16,228,5718
subtest25of10,pubtest23of10,10,1482,5474,17,268,5759
subtest22of10,pubtest23of10,10,1482,5474,27,298,5799
subtest21of10,pubtest23of10,10,1482,5474,34,332,5840
subtest210of10,pubtest23of10,10,1482,5474,35,371,5880
subtest23of10,pubtest24of10,10,1482,5913,4,84,6001
subtest24of10,pubtest24of10,10,1482,5913,9,118,6040
subtest28of10,pubtest24of10,10,1482,5913,21,145,6079
subtest22of10,pubtest24of10,10,1482,5913,24,182,6119
subtest25of10,pubtest24of10,10,1482,5913,25,221,6159
subtest21of10,pubtest24of10,10,1482,5913,27,260,6200
subtest29of10,pubtest24of10,10,1482,5913,28,298,6239
subtest210of10,pubtest24of10,10,1482,5913,29,338,6280
subtest27of10,pubtest24of10,10,1482,5913,30,376,6319
subtest26of10,pubtest24of10,10,1482,5913,36,411,6360
subtest28of10,pubtest25of10,10,1482,5330,-4,42,5368
subtest210of10,pubtest25of10,10,1482,5330,-2,79,5407
subtest21of10,pubtest25of10,10,1482,5330,16,101,5447
subtest26of10,pubtest25of10,10,1482,5330,24,133,5487
subtest27of10,pubtest25of10,10,1482,5330,25,172,5527
subtest22of10,pubtest25of10,10,1482,5330,29,208,5567
subtest25of10,pubtest25of10,10,1482,5330,33,244,5607
subtest23of10,pubtest25of10,10,1482,5330,34,283,5647
subtest29of10,pubtest25of10,10,1482,5330,35,322,5687
subtest24of10,pubtest25of10,10,1482,5330,36,358,5724
subtest21of10,pubtest26of10,10,1482,5283,-2,39,5320
subtest22of10,pubtest26of10,10,1482,5283,2,74,5359
subtest29of10,pubtest26of10,10,1482,5283,7,110,5400
subtest23of10,pubtest26of10,10,1482,5283,10,146,5439
subtest26of10,pubtest26of10,10,1482,5283,14,183,5480
subtest210of10,pubtest26of10,10,1482,5283,18,219,5520
subtest27of10,pubtest26of10,10,1482,5283,21,254,5558
subtest28of10,pubtest26of10,10,1482,5283,24,293,5600
subtest24of10,pubtest26of10,10,1482,5283,28,329,5640
subtest25of10,pubtest26of10,10,1482,5283,32,365,5680
subtest27of10,pubtest27of10,10,1481,5531,-3,39,5567
subtest28of10,pubtest27of10,10,1481,5531,3,73,5607
subtest23of10,pubtest27of10,10,1481,5531,13,104,5648
subtest24of10,pubtest27of10,10,1481,5531,14,141,5686
subtest29of10,pubtest27of10,10,1481,5531,18,179,5728
subtest210of10,pubtest27of10,10,1481,5531,21,215,5767
subtest25of10,pubtest27of10,10,1481,5531,23,253,5807
subtest22of10,pubtest27of10,10,1481,5531,25,291,5847
subtest21of10,pubtest27of10,10,1481,5531,27,329,5887
subtest26of10,pubtest27of10,10,1481,5531,29,368,5928
subtest27of10,pubtest28of10,10,1480,5342,0,46,5388
subtest28of10,pubtest28of10,10,1480,5342,6,79,5427
subtest21of10,pubtest28of10,10,1480,5342,12,113,5467
subtest29of10,pubtest28of10,10,1480,5342,19,145,5506
subtest23of10,pubtest28of10,10,1480,5342,20,184,5546
subtest210of10,pubtest28of10,10,1480,5342,27,218,5587
subtest25of10,pubtest28of10,10,1480,5342,33,252,5627
subtest26of10,pubtest28of10,10,1480,5342,37,288,5667
subtest24of10,pubtest28of10,10,1480,5342,37,327,5706
subtest22of10,pubtest28of10,10,1480,5342,44,359,5745
subtest23of10,pubtest29of10,10,1482,5259,0,42,5301
subtest29of10,pubtest29of10,10,1482,5259,4,78,5341
subtest25of10,pubtest29of10,10,1482,5259,7,115,5381
subtest21of10,pubtest29of10,10,1482,5259,11,150,5420
subtest27of10,pubtest29of10,10,1482,5259,14,188,5461
subtest210of10,pubtest29of10,10,1482,5259,18,224,5501
subtest22of10,pubtest29of10,10,1482,5259,22,258,5539
subtest28of10,pubtest29of10,10,1482,5259,28,294,5581
subtest24of10,pubtest29of10,10,1482,5259,28,333,5620
subtest26of10,pubtest29of10,10,1482,5259,30,372,5661
subtest29of10,pubtest210of10,10,1493,6031,-4,38,6065
subtest21of10,pubtest210of10,10,1493,6031,-1,76,6106
subtest27of10,pubtest210of10,10,1493,6031,6,107,6144
subtest210of10,pubtest210of10,10,1493,6031,10,145,6186
subtest28of10,pubtest210of10,10,1493,6031,9,185,6225
subtest24of10,pubtest210of10,10,1493,6031,17,218,6266
subtest23of10,pubtest210of10,10,1493,6031,23,252,6306
subtest25of10,pubtest210of10,10,1493,6031,28,287,6346
subtest22of10,pubtest210of10,10,1493,6031,30,326,6387
subtest26of10,pubtest210of10,10,1493,6031,32,363,6426
subtest27of10,pubtest21of10,10,1483,10769,1,42,10812
subtest26of10,pubtest21of10,10,1483,10769,2,81,10852
subtest24of10,pubtest21of10,10,1483,10769,20,103,10892
subtest29of10,pubtest21of10,10,1483,10769,26,137,10932
subtest25of10,pubtest21of10,10,1483,10769,31,172,10972
subtest21of10,pubtest21of10,10,1483,10769,32,211,11012
subtest210of10,pubtest21of10,10,1483,10769,33,249,11051
subtest28of10,pubtest21of10,10,1483,10769,34,288,11091
subtest22of10,pubtest21of10,10,1483,10769,36,326,11131
subtest23of10,pubtest21of10,10,1483,10769,41,362,11172
subtest29of10,pubtest22of10,10,1482,5716,-4,43,5755
subtest27of10,pubtest22of10,10,1482,5716,3,74,5793
subtest23of10,pubtest22of10,10,1482,5716,6,111,5833
subtest25of10,pubtest22of10,10,1482,5716,9,148,5873
subtest21of10,pubtest22of10,10,1482,5716,26,171,5913
subtest26of10,pubtest22of10,10,1482,5716,38,199,5953
subtest28of10,pubtest22of10,10,1482,5716,37,239,5992
subtest24of10,pubtest22of10,10,1482,5716,35,278,6029
subtest210of10,pubtest22of10,10,1482,5716,48,308,6072
subtest22of10,pubtest22of10,10,1482,5716,50,347,6113
subtest23of10,pubtest23of10,10,1482,5680,-3,41,5718
subtest28of10,pubtest23of10,10,1482,5680,0,77,5757
subtest29of10,pubtest23of10,10,1482,5680,3,115,5798
subtest24of10,pubtest23of10,10,1482,5680,7,151,5838
subtest27of10,pubtest23of10,10,1482,5680,14,185,5879
subtest25of10,pubtest23of10,10,1482,5680,16,222,5918
subtest26of10,pubtest23of10,10,1482,5680,24,253,5957
subtest22of10,pubtest23of10,10,1482,5680,33,285,5998
subtest21of10,pubtest23of10,10,1482,5680,37,320,6037
subtest210of10,pubtest23of10,10,1482,5680,40,358,6078
subtest23of10,pubtest24of10,10,1482,5755,-3,42,5794
subtest24of10,pubtest24of10,10,1482,5755,1,78,5834
subtest28of10,pubtest24of10,10,1482,5755,6,113,5874
subtest25of10,pubtest24of10,10,1482,5755,9,149,5913
subtest21of10,pubtest24of10,10,1482,5755,12,187,5954
subtest22of10,pubtest24of10,10,1482,5755,17,222,5994
subtest29of10,pubtest24of10,10,1482,5755,18,260,6033
subtest210of10,pubtest24of10,10,1482,5755,22,295,6072
subtest27of10,pubtest24of10,10,1482,5755,27,332,6114
subtest26of10,pubtest24of10,10,1482,5755,28,370,6153
subtest28of10,pubtest25of10,10,1482,6140,-5,40,6175
subtest210of10,pubtest25of10,10,1482,6140,7,68,6215
subtest21of10,pubtest25of10,10,1482,6140,9,106,6255
subtest26of10,pubtest25of10,10,1482,6140,10,143,6293
subtest27of10,pubtest25of10,10,1482,6140,13,182,6335
subtest22of10,pubtest25of10,10,1482,6140,14,220,6374
subtest25of10,pubtest25of10,10,1482,6140,24,251,6415
subtest23of10,pubtest25of10,10,1482,6140,26,289,6455
subtest29of10,pubtest25of10,10,1482,6140,28,327,6495
subtest24of10,pubtest25of10,10,1482,6140,29,366,6535
subtest21of10,pubtest26of10,10,1482,6094,-1,41,6134
subtest22of10,pubtest26of10,10,1482,6094,4,75,6173
subtest29of10,pubtest26of10,10,1482,6094,7,112,6213
subtest23of10,pubtest26of10,10,1482,6094,21,139,6254
subtest26of10,pubtest26of10,10,1482,6094,26,174,6294
subtest210of10,pubtest26of10,10,1482,6094,30,210,6334
subtest28of10,pubtest26of10,10,1482,6094,30,249,6373
subtest27of10,pubtest26of10,10,1482,6094,33,287,6414
subtest24of10,pubtest26of10,10,1482,6094,35,323,6452
subtest25of10,pubtest26of10,10,1482,6094,36,362,6492
subtest28of10,pubtest27of10,10,1481,5203,-1,41,5243
subtest24of10,pubtest27of10,10,1481,5203,4,75,5282
subtest27of10,pubtest27of10,10,1481,5203,17,102,5322
subtest23of10,pubtest27of10,10,1481,5203,21,138,5362
subtest210of10,pubtest27of10,10,1481,5203,22,177,5402
subtest29of10,pubtest27of10,10,1481,5203,27,212,5442
subtest22of10,pubtest27of10,10,1481,5203,28,250,5481
subtest25of10,pubtest27of10,10,1481,5203,29,289,5521
subtest26of10,pubtest27of10,10,1481,5203,31,327,5561
subtest21of10,pubtest27of10,10,1481,5203,32,366,5601
subtest27of10,pubtest28of10,10,1480,5432,22,39,5493
subtest21of10,pubtest28of10,10,1480,5432,61,39,5532
subtest29of10,pubtest28of10,10,1480,5432,63,78,5573
subtest28of10,pubtest28of10,10,1480,5432,59,117,5608
subtest210of10,pubtest28of10,10,1480,5432,83,137,5652
subtest23of10,pubtest28of10,10,1480,5432,92,169,5693
subtest25of10,pubtest28of10,10,1480,5432,93,208,5733
subtest24of10,pubtest28of10,10,1480,5432,94,247,5773
subtest26of10,pubtest28of10,10,1480,5432,92,286,5810
subtest22of10,pubtest28of10,10,1480,5432,101,320,5853
subtest23of10,pubtest29of10,10,1482,5438,-5,41,5474
subtest210of10,pubtest29of10,10,1482,5438,2,72,5512
subtest29of10,pubtest29of10,10,1482,5438,13,101,5552
subtest22of10,pubtest29of10,10,1482,5438,17,137,5592
subtest25of10,pubtest29of10,10,1482,5438,18,176,5632
subtest28of10,pubtest29of10,10,1482,5438,24,209,5671
subtest21of10,pubtest29of10,10,1482,5438,25,246,5709
subtest24of10,pubtest29of10,10,1482,5438,27,285,5750
subtest26of10,pubtest29of10,10,1482,5438,30,324,5792
subtest27of10,pubtest29of10,10,1482,5438,30,364,5832
subtest29of10,pubtest210of10,10,1493,5219,-3,39,5255
subtest21of10,pubtest210of10,10,1493,5219,1,73,5293
subtest27of10,pubtest210of10,10,1493,5219,15,99,5333
subtest210of10,pubtest210of10,10,1493,5219,19,136,5374
subtest23of10,pubtest210of10,10,1493,5219,21,174,5414
subtest28of10,pubtest210of10,10,1493,5219,24,211,5454
subtest25of10,pubtest210of10,10,1493,5219,22,251,5492
subtest24of10,pubtest210of10,10,1493,5219,27,288,5534
subtest22of10,pubtest210of10,10,1493,5219,29,326,5574
subtest26of10,pubtest210of10,10,1493,5219,29,366,5614
subtest27of10,pubtest21of10,10,1483,10318,-3,40,10355
subtest26of10,pubtest21of10,10,1483,10318,-1,78,10395
subtest29of10,pubtest21of10,10,1483,10318,0,116,10434
subtest24of10,pubtest21of10,10,1483,10318,12,145,10475
subtest25of10,pubtest21of10,10,1483,10318,19,178,10515
subtest210of10,pubtest21of10,10,1483,10318,28,209,10555
subtest21of10,pubtest21of10,10,1483,10318,27,248,10593
subtest28of10,pubtest21of10,10,1483,10318,29,285,10632
subtest22of10,pubtest21of10,10,1483,10318,33,324,10675
subtest23of10,pubtest21of10,10,1483,10318,33,364,10715
subtest29of10,pubtest22of10,10,1482,6101,0,149,6250
subtest24of10,pubtest22of10,10,1482,6101,2,185,6288
subtest27of10,pubtest22of10,10,1482,6101,13,215,6329
subtest28of10,pubtest22of10,10,1482,6101,20,248,6369
subtest26of10,pubtest22of10,10,1482,6101,21,285,6407
subtest210of10,pubtest22of10,10,1482,6101,28,319,6448
subtest23of10,pubtest22of10,10,1482,6101,29,358,6488
subtest25of10,pubtest22of10,10,1482,6101,31,397,6529
subtest22of10,pubtest22of10,10,1482,6101,33,435,6569
subtest21of10,pubtest22of10,10,1482,6101,34,473,6608
subtest23of10,pubtest23of10,10,1482,6581,11,52,6644
subtest27of10,pubtest23of10,10,1482,6581,15,88,6684
subtest24of10,pubtest23of10,10,1482,6581,18,125,6724
subtest25of10,pubtest23of10,10,1482,6581,20,163,6764
subtest26of10,pubtest23of10,10,1482,6581,22,201,6804
subtest29of10,pubtest23of10,10,1482,6581,13,240,6834
subtest28of10,pubtest23of10,10,1482,6581,12,279,6872
subtest22of10,pubtest23of10,10,1482,6581,27,316,6924
subtest21of10,pubtest23of10,10,1482,6581,29,354,6964
subtest210of10,pubtest23of10,10,1482,6581,32,389,7002
subtest24of10,pubtest24of10,10,1482,5442,-2,40,5480
subtest23of10,pubtest24of10,10,1482,5442,0,77,5519
subtest28of10,pubtest24of10,10,1482,5442,2,115,5559
subtest25of10,pubtest24of10,10,1482,5442,3,155,5600
subtest21of10,pubtest24of10,10,1482,5442,6,192,5640
subtest22of10,pubtest24of10,10,1482,5442,8,228,5678
subtest210of10,pubtest24of10,10,1482,5442,26,252,5720
subtest29of10,pubtest24of10,10,1482,5442,39,279,5760
subtest27of10,pubtest24of10,10,1482,5442,40,317,5799
subtest26of10,pubtest24of10,10,1482,5442,42,356,5840
subtest28of10,pubtest25of10,10,1482,5404,5,42,5451
subtest21of10,pubtest25of10,10,1482,5404,16,70,5490
subtest26of10,pubtest25of10,10,1482,5404,18,107,5529
subtest210of10,pubtest25of10,10,1482,5404,17,148,5569
subtest27of10,pubtest25of10,10,1482,5404,20,185,5609
subtest22of10,pubtest25of10,10,1482,5404,21,224,5649
subtest25of10,pubtest25of10,10,1482,5404,24,262,5690
subtest23of10,pubtest25of10,10,1482,5404,25,300,5729
subtest29of10,pubtest25of10,10,1482,5404,26,340,5770
subtest24of10,pubtest25of10,10,1482,5404,28,378,5810
subtest22of10,pubtest26of10,10,1482,5215,-1,110,5324
subtest29of10,pubtest26of10,10,1482,5215,3,147,5365
subtest21of10,pubtest26of10,10,1482,5215,0,186,5401
subtest23of10,pubtest26of10,10,1482,5215,11,219,5445
subtest26of10,pubtest26of10,10,1482,5215,19,251,5485
subtest210of10,pubtest26of10,10,1482,5215,21,288,5524
subtest28of10,pubtest26of10,10,1482,5215,26,324,5565
subtest27of10,pubtest26of10,10,1482,5215,27,362,5604
subtest24of10,pubtest26of10,10,1482,5215,31,399,5645
subtest25of10,pubtest26of10,10,1482,5215,33,437,5685
subtest27of10,pubtest27of10,10,1481,5208,1,42,5251
subtest28of10,pubtest27of10,10,1481,5208,2,80,5290
subtest23of10,pubtest27of10,10,1481,5208,10,112,5330
subtest24of10,pubtest27of10,10,1481,5208,11,151,5370
subtest29of10,pubtest27of10,10,1481,5208,25,176,5409
subtest210of10,pubtest27of10,10,1481,5208,29,213,5450
subtest25of10,pubtest27of10,10,1481,5208,31,252,5491
subtest22of10,pubtest27of10,10,1481,5208,31,290,5529
subtest26of10,pubtest27of10,10,1481,5208,36,326,5570
subtest21of10,pubtest27of10,10,1481,5208,42,360,5610
subtest27of10,pubtest28of10,10,1480,5263,-6,40,5297
subtest21of10,pubtest28of10,10,1480,5263,-1,73,5335
subtest28of10,pubtest28of10,10,1480,5263,2,110,5375
subtest29of10,pubtest28of10,10,1480,5263,6,146,5415
subtest23of10,pubtest28of10,10,1480,5263,11,181,5455
subtest25of10,pubtest28of10,10,1480,5263,20,212,5495
subtest210of10,pubtest28of10,10,1480,5263,23,249,5535
subtest26of10,pubtest28of10,10,1480,5263,24,287,5574
subtest24of10,pubtest28of10,10,1480,5263,25,324,5612
subtest22of10,pubtest28of10,10,1480,5263,28,363,5654
subtest23of10,pubtest29of10,10,1482,5254,7,40,5301
subtest210of10,pubtest29of10,10,1482,5254,9,77,5340
subtest22of10,pubtest29of10,10,1482,5254,12,114,5380
subtest29of10,pubtest29of10,10,1482,5254,13,152,5419
subtest25of10,pubtest29of10,10,1482,5254,15,191,5460
subtest28of10,pubtest29of10,10,1482,5254,21,225,5500
subtest21of10,pubtest29of10,10,1482,5254,27,257,5538
subtest27of10,pubtest29of10,10,1482,5254,30,296,5580
subtest24of10,pubtest29of10,10,1482,5254,31,335,5620
subtest26of10,pubtest29of10,10,1482,5254,32,373,5659
subtest29of10,pubtest210of10,10,1493,6008,-6,42,6044
subtest21of10,pubtest210of10,10,1493,6008,13,63,6084
subtest27of10,pubtest210of10,10,1493,6008,14,101,6123
subtest210of10,pubtest210of10,10,1493,6008,18,138,6164
subtest28of10,pubtest210of10,10,1493,6008,21,175,6204
subtest22of10,pubtest210of10,10,1493,6008,22,214,6244
subtest24of10,pubtest210of10,10,1493,6008,21,253,6282
subtest26of10,pubtest210of10,10,1493,6008,24,291,6323
subtest23of10,pubtest210of10,10,1493,6008,26,330,6364
subtest25of10,pubtest210of10,10,1493,6008,28,367,6403
subtest27of10,pubtest21of10,10,1483,10660,12,42,10714
subtest26of10,pubtest21of10,10,1483,10660,14,78,10752
subtest29of10,pubtest21of10,10,1483,10660,15,117,10792
subtest24of10,pubtest21of10,10,1483,10660,24,150,10834
subtest25of10,pubtest21of10,10,1483,10660,25,188,10873
subtest21of10,pubtest21of10,10,1483,10660,26,228,10914
subtest28of10,pubtest21of10,10,1483,10660,28,265,10953
subtest23of10,pubtest21of10,10,1483,10660,30,304,10994
subtest22of10,pubtest21of10,10,1483,10660,30,344,11034
subtest210of10,pubtest21of10,10,1483,10660,27,386,11073
subtest29of10,pubtest22of10,10,1482,5584,6,41,5631
subtest24of10,pubtest22of10,10,1482,5584,11,77,5672
subtest27of10,pubtest22of10,10,1482,5584,17,111,5712
subtest28of10,pubtest22of10,10,1482,5584,18,149,5751
subtest26of10,pubtest22of10,10,1482,5584,19,189,5792
subtest23of10,pubtest22of10,10,1482,5584,21,227,5832
subtest25of10,pubtest22of10,10,1482,5584,22,265,5871
subtest210of10,pubtest22of10,10,1482,5584,32,296,5912
subtest21of10,pubtest22of10,10,1482,5584,32,335,5951
subtest22of10,pubtest22of10,10,1482,5584,45,363,5992
subtest23of10,pubtest23of10,10,1482,5287,3,51,5341
subtest28of10,pubtest23of10,10,1482,5287,36,58,5381
subtest29of10,pubtest23of10,10,1482,5287,38,96,5421
subtest27of10,pubtest23of10,10,1482,5287,40,134,5461
subtest24of10,pubtest23of10,10,1482,5287,44,169,5500
subtest25of10,pubtest23of10,10,1482,5287,57,197,5541
subtest26of10,pubtest23of10,10,1482,5287,60,234,5581
subtest21of10,pubtest23of10,10,1482,5287,65,269,5621
subtest210of10,pubtest23of10,10,1482,5287,68,305,5660
subtest22of10,pubtest23of10,10,1482,5287,68,345,5700
subtest24of10,pubtest24of10,10,1482,6150,0,39,6189
subtest23of10,pubtest24of10,10,1482,6150,3,76,6229
subtest28of10,pubtest24of10,10,1482,6150,6,113,6269
subtest25of10,pubtest24of10,10,1482,6150,7,151,6308
subtest21of10,pubtest24of10,10,1482,6150,13,185,6348
subtest22of10,pubtest24of10,10,1482,6150,14,223,6387
subtest210of10,pubtest24of10,10,1482,6150,18,261,6429
subtest29of10,pubtest24of10,10,1482,6150,19,299,6468
subtest26of10,pubtest24of10,10,1482,6150,22,336,6508
subtest27of10,pubtest24of10,10,1482,6150,22,376,6548
subtest28of10,pubtest25of10,10,1482,7184,2,42,7228
subtest210of10,pubtest25of10,10,1482,7184,9,75,7268
subtest21of10,pubtest25of10,10,1482,7184,10,114,7308
subtest26of10,pubtest25of10,10,1482,7184,11,151,7346
subtest22of10,pubtest25of10,10,1482,7184,14,189,7387
subtest27of10,pubtest25of10,10,1482,7184,15,229,7428
subtest25of10,pubtest25of10,10,1482,7184,17,267,7468
subtest23of10,pubtest25of10,10,1482,7184,18,306,7508
subtest29of10,pubtest25of10,10,1482,7184,19,345,7548
subtest24of10,pubtest25of10,10,1482,7184,21,383,7588
subtest21of10,pubtest26of10,10,1482,6490,5,41,6536
subtest22of10,pubtest26of10,10,1482,6490,13,73,6576
subtest29of10,pubtest26of10,10,1482,6490,17,109,6616
subtest23of10,pubtest26of10,10,1482,6490,20,146,6656
subtest26of10,pubtest26of10,10,1482,6490,21,184,6695
subtest210of10,pubtest26of10,10,1482,6490,22,225,6737
subtest27of10,pubtest26of10,10,1482,6490,24,262,6776
subtest28of10,pubtest26of10,10,1482,6490,28,298,6816
subtest24of10,pubtest26of10,10,1482,6490,31,334,6855
subtest25of10,pubtest26of10,10,1482,6490,34,371,6895
subtest27of10,pubtest27of10,10,1481,5750,2,42,5794
subtest28of10,pubtest27of10,10,1481,5750,5,79,5834
subtest23of10,pubtest27of10,10,1481,5750,8,116,5874
subtest24of10,pubtest27of10,10,1481,5750,9,155,5914
subtest29of10,pubtest27of10,10,1481,5750,17,187,5954
subtest210of10,pubtest27of10,10,1481,5750,18,225,5993
subtest25of10,pubtest27of10,10,1481,5750,19,264,6033
subtest22of10,pubtest27of10,10,1481,5750,21,303,6074
subtest26of10,pubtest27of10,10,1481,5750,26,338,6114
subtest21of10,pubtest27of10,10,1481,5750,47,356,6153
subtest21of10,pubtest28of10,10,1480,5468,8,43,5519
subtest27of10,pubtest28of10,10,1480,5468,6,86,5560
subtest28of10,pubtest28of10,10,1480,5468,9,122,5599
subtest29of10,pubtest28of10,10,1480,5468,11,161,5640
subtest210of10,pubtest28of10,10,1480,5468,12,199,5679
subtest23of10,pubtest28of10,10,1480,5468,13,239,5720
subtest26of10,pubtest28of10,10,1480,5468,17,273,5758
subtest25of10,pubtest28of10,10,1480,5468,17,313,5798
subtest24of10,pubtest28of10,10,1480,5468,21,351,5840
subtest22of10,pubtest28of10,10,1480,5468,23,389,5880
subtest23of10,pubtest29of10,10,1482,5674,-1,40,5713
subtest210of10,pubtest29of10,10,1482,5674,0,79,5753
subtest22of10,pubtest29of10,10,1482,5674,10,109,5793
subtest29of10,pubtest29of10,10,1482,5674,11,148,5833
subtest28of10,pubtest29of10,10,1482,5674,21,177,5872
subtest25of10,pubtest29of10,10,1482,5674,19,218,5911
subtest21of10,pubtest29of10,10,1482,5674,22,256,5952
subtest24of10,pubtest29of10,10,1482,5674,26,293,5993
subtest27of10,pubtest29of10,10,1482,5674,27,332,6033
subtest26of10,pubtest29of10,10,1482,5674,30,369,6073
subtest29of10,pubtest210of10,10,1493,5312,1,40,5353
subtest21of10,pubtest210of10,10,1493,5312,7,74,5393
subtest210of10,pubtest210of10,10,1493,5312,30,90,5432
subtest27of10,pubtest210of10,10,1493,5312,31,130,5473
subtest23of10,pubtest210of10,10,1493,5312,37,163,5512
subtest28of10,pubtest210of10,10,1493,5312,36,202,5550
subtest24of10,pubtest210of10,10,1493,5312,40,241,5593
subtest25of10,pubtest210of10,10,1493,5312,46,274,5632
subtest22of10,pubtest210of10,10,1493,5312,111,250,5673
subtest26of10,pubtest210of10,10,1493,5312,112,289,5713
subtest27of10,pubtest21of10,10,1483,11810,-2,44,11852
subtest26of10,pubtest21of10,10,1483,11810,-1,81,11890
subtest24of10,pubtest21of10,10,1483,11810,6,113,11929
subtest29of10,pubtest21of10,10,1483,11810,9,151,11970
subtest25of10,pubtest21of10,10,1483,11810,14,185,12009
subtest21of10,pubtest21of10,10,1483,11810,16,223,12049
subtest210of10,pubtest21of10,10,1483,11810,18,262,12090
subtest28of10,pubtest21of10,10,1483,11810,19,300,12129
subtest22of10,pubtest21of10,10,1483,11810,21,339,12170
subtest23of10,pubtest21of10,10,1483,11810,25,375,12210
subtest29of10,pubtest22of10,10,1482,6438,-3,45,6480
subtest27of10,pubtest22of10,10,1482,6438,-3,84,6519
subtest23of10,pubtest22of10,10,1482,6438,2,120,6560
subtest25of10,pubtest22of10,10,1482,6438,8,154,6600
subtest21of10,pubtest22of10,10,1482,6438,13,189,6640
subtest24of10,pubtest22of10,10,1482,6438,26,216,6680
subtest28of10,pubtest22of10,10,1482,6438,33,249,6720
subtest26of10,pubtest22of10,10,1482,6438,35,287,6760
subtest22of10,pubtest22of10,10,1482,6438,39,322,6799
subtest210of10,pubtest22of10,10,1482,6438,39,362,6839
subtest23of10,pubtest23of10,10,1482,5361,14,42,5417
subtest28of10,pubtest23of10,10,1482,5361,15,80,5456
subtest29of10,pubtest23of10,10,1482,5361,19,117,5497
subtest24of10,pubtest23of10,10,1482,5361,20,156,5537
subtest27of10,pubtest23of10,10,1482,5361,21,194,5576
subtest26of10,pubtest23of10,10,1482,5361,23,231,5615
subtest25of10,pubtest23of10,10,1482,5361,25,271,5657
subtest21of10,pubtest23of10,10,1482,5361,31,305,5697
subtest22of10,pubtest23of10,10,1482,5361,44,332,5737
subtest210of10,pubtest23of10,10,1482,5361,45,370,5776
subtest24of10,pubtest24of10,10,1482,5157,-1,49,5205
subtest28of10,pubtest24of10,10,1482,5157,1,86,5244
subtest23of10,pubtest24of10,10,1482,5157,-1,125,5281
subtest22of10,pubtest24of10,10,1482,5157,6,161,5324
subtest25of10,pubtest24of10,10,1482,5157,7,200,5364
subtest21of10,pubtest24of10,10,1482,5157,10,236,5403
subtest210of10,pubtest24of10,10,1482,5157,11,275,5443
subtest29of10,pubtest24of10,10,1482,5157,13,314,5484
subtest27of10,pubtest24of10,10,1482,5157,17,350,5524
subtest26of10,pubtest24of10,10,1482,5157,21,386,5564
subtest28of10,pubtest25of10,10,1482,5271,3,39,5313
subtest21of10,pubtest25of10,10,1482,5271,8,75,5354
subtest210of10,pubtest25of10,10,1482,5271,15,109,5395
subtest27of10,pubtest25of10,10,1482,5271,17,147,5435
subtest26of10,pubtest25of10,10,1482,5271,21,184,5476
subtest22of10,pubtest25of10,10,1482,5271,27,217,5515
subtest25of10,pubtest25of10,10,1482,5271,30,254,5555
subtest23of10,pubtest25of10,10,1482,5271,33,291,5595
subtest29of10,pubtest25of10,10,1482,5271,33,330,5634
subtest24of10,pubtest25of10,10,1482,5271,35,369,5675
subtest21of10,pubtest26of10,10,1482,5203,6,41,5250
subtest29of10,pubtest26of10,10,1482,5203,14,72,5289
subtest22of10,pubtest26of10,10,1482,5203,16,110,5329
subtest23of10,pubtest26of10,10,1482,5203,17,148,5368
subtest26of10,pubtest26of10,10,1482,5203,20,186,5409
subtest210of10,pubtest26of10,10,1482,5203,22,224,5449
subtest28of10,pubtest26of10,10,1482,5203,24,262,5489
subtest27of10,pubtest26of10,10,1482,5203,26,300,5529
subtest25of10,pubtest26of10,10,1482,5203,29,335,5567
subtest24of10,pubtest26of10,10,1482,5203,28,375,5606
subtest28of10,pubtest27of10,10,1481,5273,9,42,5324
subtest27of10,pubtest27of10,10,1481,5273,10,81,5364
subtest24of10,pubtest27of10,10,1481,5273,11,119,5403
subtest23of10,pubtest27of10,10,1481,5273,13,158,5444
subtest210of10,pubtest27of10,10,1481,5273,21,190,5484
subtest29of10,pubtest27of10,10,1481,5273,22,229,5524
subtest25of10,pubtest27of10,10,1481,5273,31,258,5562
subtest22of10,pubtest27of10,10,1481,5273,33,297,5603
subtest21of10,pubtest27of10,10,1481,5273,35,335,5643
subtest26of10,pubtest27of10,10,1481,5273,45,366,5684
subtest27of10,pubtest28of10,10,1480,5268,7,49,5324
subtest28of10,pubtest28of10,10,1480,5268,9,87,5364
subtest21of10,pubtest28of10,10,1480,5268,11,125,5404
subtest29of10,pubtest28of10,10,1480,5268,22,154,5444
subtest210of10,pubtest28of10,10,1480,5268,25,190,5483
subtest23of10,pubtest28of10,10,1480,5268,26,230,5524
subtest26of10,pubtest28of10,10,1480,5268,27,268,5563
subtest25of10,pubtest28of10,10,1480,5268,33,303,5604
subtest24of10,pubtest28of10,10,1480,5268,34,341,5643
subtest22of10,pubtest28of10,10,1480,5268,40,376,5684
subtest210of10,pubtest29of10,10,1482,5359,10,45,5414
subtest23of10,pubtest29of10,10,1482,5359,11,78,5448
subtest25of10,pubtest29of10,10,1482,5359,16,117,5492
subtest22of10,pubtest29of10,10,1482,5359,17,155,5531
subtest29of10,pubtest29of10,10,1482,5359,17,195,5571
subtest28of10,pubtest29of10,10,1482,5359,19,234,5612
subtest21of10,pubtest29of10,10,1482,5359,20,272,5651
subtest24of10,pubtest29of10,10,1482,5359,21,311,5691
subtest27of10,pubtest29of10,10,1482,5359,23,350,5732
subtest26of10,pubtest29of10,10,1482,5359,27,386,5772
subtest29of10,pubtest210of10,10,1493,5522,-5,41,5558
subtest21of10,pubtest210of10,10,1493,5522,13,62,5597
subtest27of10,pubtest210of10,10,1493,5522,13,101,5636
subtest210of10,pubtest210of10,10,1493,5522,17,138,5677
subtest28of10,pubtest210of10,10,1493,5522,20,175,5717
subtest22of10,pubtest210of10,10,1493,5522,24,211,5757
subtest24of10,pubtest210of10,10,1493,5522,23,251,5796
subtest23of10,pubtest210of10,10,1493,5522,30,285,5837
subtest26of10,pubtest210of10,10,1493,5522,32,323,5877
subtest25of10,pubtest210of10,10,1493,5522,34,359,5915
subtest26of10,pubtest21of10,10,1483,11303,-2,41,11342
subtest27of10,pubtest21of10,10,1483,11303,4,74,11381
subtest29of10,pubtest21of10,10,1483,11303,6,113,11422
subtest24of10,pubtest21of10,10,1483,11303,14,144,11461
subtest25of10,pubtest21of10,10,1483,11303,18,181,11502
subtest210of10,pubtest21of10,10,1483,11303,20,219,11542
subtest21of10,pubtest21of10,10,1483,11303,23,256,11582
subtest28of10,pubtest21of10,10,1483,11303,27,291,11621
subtest22of10,pubtest21of10,10,1483,11303,31,328,11662
subtest23of10,pubtest21of10,10,1483,11303,32,367,11702
subtest29of10,pubtest22of10,10,1482,5172,-4,42,5210
subtest24of10,pubtest22of10,10,1482,5172,-3,80,5249
subtest27of10,pubtest22of10,10,1482,5172,13,104,5289
subtest28of10,pubtest22of10,10,1482,5172,15,142,5329
subtest26of10,pubtest22of10,10,1482,5172,16,179,5367
subtest23of10,pubtest22of10,10,1482,5172,20,217,5409
subtest25of10,pubtest22of10,10,1482,5172,21,255,5448
subtest210of10,pubtest22of10,10,1482,5172,25,291,5488
subtest22of10,pubtest22of10,10,1482,5172,26,331,5529
subtest21of10,pubtest22of10,10,1482,5172,31,366,5569
subtest23of10,pubtest23of10,10,1482,5758,-3,40,5795
subtest28of10,pubtest23of10,10,1482,5758,12,65,5835
subtest29of10,pubtest23of10,10,1482,5758,15,101,5874
subtest24of10,pubtest23of10,10,1482,5758,16,141,5915
subtest27of10,pubtest23of10,10,1482,5758,17,180,5955
subtest26of10,pubtest23of10,10,1482,5758,19,218,5995
subtest25of10,pubtest23of10,10,1482,5758,23,254,6035
subtest22of10,pubtest23of10,10,1482,5758,26,290,6074
subtest21of10,pubtest23of10,10,1482,5758,28,329,6115
subtest210of10,pubtest23of10,10,1482,5758,32,364,6154
subtest23of10,pubtest24of10,10,1482,5985,4,40,6029
subtest24of10,pubtest24of10,10,1482,5985,5,79,6069
subtest28of10,pubtest24of10,10,1482,5985,7,117,6109
subtest25of10,pubtest24of10,10,1482,5985,8,156,6149
subtest21of10,pubtest24of10,10,1482,5985,32,172,6189
subtest22of10,pubtest24of10,10,1482,5985,33,210,6228
subtest210of10,pubtest24of10,10,1482,5985,36,247,6268
subtest29of10,pubtest24of10,10,1482,5985,51,272,6308
subtest27of10,pubtest24of10,10,1482,5985,56,308,6349
subtest26of10,pubtest24of10,10,1482,5985,58,344,6387
subtest28of10,pubtest25of10,10,1482,5495,22,84,5601
subtest210of10,pubtest25of10,10,1482,5495,23,123,5641
subtest21of10,pubtest25of10,10,1482,5495,25,161,5681
subtest26of10,pubtest25of10,10,1482,5495,25,201,5721
subtest22of10,pubtest25of10,10,1482,5495,27,239,5761
subtest27of10,pubtest25of10,10,1482,5495,27,279,5801
subtest25of10,pubtest25of10,10,1482,5495,41,303,5839
subtest24of10,pubtest25of10,10,1482,5495,44,341,5880
subtest29of10,pubtest25of10,10,1482,5495,44,381,5920
subtest23of10,pubtest25of10,10,1482,5495,41,420,5956
subtest21of10,pubtest26of10,10,1482,5184,-4,42,5222
subtest22of10,pubtest26of10,10,1482,5184,-1,78,5261
subtest29of10,pubtest26of10,10,1482,5184,14,102,5300
subtest23of10,pubtest26of10,10,1482,5184,16,141,5341
subtest210of10,pubtest26of10,10,1482,5184,21,174,5379
subtest26of10,pubtest26of10,10,1482,5184,21,214,5419
subtest28of10,pubtest26of10,10,1482,5184,25,251,5460
subtest25of10,pubtest26of10,10,1482,5184,26,290,5500
subtest27of10,pubtest26of10,10,1482,5184,25,330,5539
subtest24of10,pubtest26of10,10,1482,5184,34,362,5580
subtest27of10,pubtest27of10,10,1481,6005,8,40,6053
subtest28of10,pubtest27of10,10,1481,6005,12,77,6094
subtest23of10,pubtest27of10,10,1481,6005,13,114,6132
subtest24of10,pubtest27of10,10,1481,6005,20,149,6174
subtest210of10,pubtest27of10,10,1481,6005,26,183,6214
subtest29of10,pubtest27of10,10,1481,6005,25,222,6252
subtest25of10,pubtest27of10,10,1481,6005,27,261,6293
subtest22of10,pubtest27of10,10,1481,6005,29,300,6334
subtest26of10,pubtest27of10,10,1481,6005,30,338,6373
subtest21of10,pubtest27of10,10,1481,6005,34,375,6414
subtest27of10,pubtest28of10,10,1480,5276,-3,43,5316
subtest28of10,pubtest28of10,10,1480,5276,2,74,5352
subtest21of10,pubtest28of10,10,1480,5276,4,113,5393
subtest29of10,pubtest28of10,10,1480,5276,19,138,5433
subtest210of10,pubtest28of10,10,1480,5276,22,175,5473
subtest23of10,pubtest28of10,10,1480,5276,23,214,5513
subtest26of10,pubtest28of10,10,1480,5276,30,247,5553
subtest25of10,pubtest28of10,10,1480,5276,32,285,5593
subtest24of10,pubtest28of10,10,1480,5276,36,320,5632
subtest22of10,pubtest28of10,10,1480,5276,38,357,5671
subtest23of10,pubtest29of10,10,1482,5111,-9,42,5144
subtest29of10,pubtest29of10,10,1482,5111,4,69,5184
subtest25of10,pubtest29of10,10,1482,5111,7,107,5225
subtest21of10,pubtest29of10,10,1482,5111,8,146,5265
subtest27of10,pubtest29of10,10,1482,5111,14,180,5305
subtest210of10,pubtest29of10,10,1482,5111,16,218,5345
subtest22of10,pubtest29of10,10,1482,5111,17,256,5384
subtest28of10,pubtest29of10,10,1482,5111,18,294,5423
subtest24of10,pubtest29of10,10,1482,5111,22,332,5465
subtest26of10,pubtest29of10,10,1482,5111,27,367,5505
subtest29of10,pubtest210of10,10,1493,5342,-3,42,5381
subtest21of10,pubtest210of10,10,1493,5342,5,74,5421
subtest210of10,pubtest210of10,10,1493,5342,8,111,5461
subtest27of10,pubtest210of10,10,1493,5342,12,147,5501
subtest24of10,pubtest210of10,10,1493,5342,25,174,5541
subtest28of10,pubtest210of10,10,1493,5342,23,214,5579
subtest22of10,pubtest210of10,10,1493,5342,29,250,5621
subtest26of10,pubtest210of10,10,1493,5342,36,282,5660
subtest23of10,pubtest210of10,10,1493,5342,42,317,5701
subtest25of10,pubtest210of10,10,1493,5342,47,352,5741
subtest26of10,pubtest21of10,10,1483,10415,30,38,10483
subtest27of10,pubtest21of10,10,1483,10415,31,75,10521
subtest29of10,pubtest21of10,10,1483,10415,34,114,10563
subtest24of10,pubtest21of10,10,1483,10415,36,153,10604
subtest25of10,pubtest21of10,10,1483,10415,37,192,10644
subtest210of10,pubtest21of10,10,1483,10415,38,231,10684
subtest21of10,pubtest21of10,10,1483,10415,39,269,10723
subtest28of10,pubtest21of10,10,1483,10415,40,308,10763
subtest22of10,pubtest21of10,10,1483,10415,43,346,10804
subtest23of10,pubtest21of10,10,1483,10415,49,380,10844
subtest29of10,pubtest22of10,10,1482,5299,-2,39,5336
subtest27of10,pubtest22of10,10,1482,5299,0,76,5375
subtest24of10,pubtest22of10,10,1482,5299,1,115,5415
subtest28of10,pubtest22of10,10,1482,5299,4,153,5456
subtest26of10,pubtest22of10,10,1482,5299,6,191,5496
subtest23of10,pubtest22of10,10,1482,5299,12,225,5536
subtest25of10,pubtest22of10,10,1482,5299,22,255,5576
subtest210of10,pubtest22of10,10,1482,5299,23,293,5615
subtest21of10,pubtest22of10,10,1482,5299,25,331,5655
subtest22of10,pubtest22of10,10,1482,5299,27,368,5694
subtest23of10,pubtest23of10,10,1482,5199,14,40,5253
subtest29of10,pubtest23of10,10,1482,5199,17,78,5294
subtest28of10,pubtest23of10,10,1482,5199,29,106,5334
subtest24of10,pubtest23of10,10,1482,5199,30,144,5373
subtest27of10,pubtest23of10,10,1482,5199,32,183,5414
subtest25of10,pubtest23of10,10,1482,5199,37,218,5454
subtest26of10,pubtest23of10,10,1482,5199,41,254,5494
subtest22of10,pubtest23of10,10,1482,5199,46,289,5534
subtest21of10,pubtest23of10,10,1482,5199,47,328,5574
subtest210of10,pubtest23of10,10,1482,5199,50,365,5614
subtest24of10,pubtest24of10,10,1482,5650,-4,43,5689
subtest23of10,pubtest24of10,10,1482,5650,-3,81,5728
subtest28of10,pubtest24of10,10,1482,5650,10,107,5767
subtest25of10,pubtest24of10,10,1482,5650,12,144,5806
subtest22of10,pubtest24of10,10,1482,5650,15,182,5847
subtest27of10,pubtest24of10,10,1482,5650,16,222,5888
subtest21of10,pubtest24of10,10,1482,5650,18,260,5928
subtest210of10,pubtest24of10,10,1482,5650,18,300,5968
subtest29of10,pubtest24of10,10,1482,5650,18,338,6006
subtest26of10,pubtest24of10,10,1482,5650,21,376,6047
subtest28of10,pubtest25of10,10,1482,5476,-6,39,5509
subtest210of10,pubtest25of10,10,1482,5476,4,70,5550
subtest21of10,pubtest25of10,10,1482,5476,20,94,5590
subtest26of10,pubtest25of10,10,1482,5476,22,132,5630
subtest22of10,pubtest25of10,10,1482,5476,25,169,5670
subtest27of10,pubtest25of10,10,1482,5476,24,209,5709
subtest25of10,pubtest25of10,10,1482,5476,47,226,5749
subtest23of10,pubtest25of10,10,1482,5476,49,265,5790
subtest29of10,pubtest25of10,10,1482,5476,51,302,5829
subtest24of10,pubtest25of10,10,1482,5476,53,341,5870
subtest21of10,pubtest26of10,10,1482,5855,0,74,5929
subtest22of10,pubtest26of10,10,1482,5855,7,108,5970
subtest29of10,pubtest26of10,10,1482,5855,19,136,6010
subtest26of10,pubtest26of10,10,1482,5855,22,172,6049
subtest210of10,pubtest26of10,10,1482,5855,23,212,6090
subtest23of10,pubtest26of10,10,1482,5855,22,251,6128
subtest28of10,pubtest26of10,10,1482,5855,25,290,6170
subtest27of10,pubtest26of10,10,1482,5855,32,322,6209
subtest24of10,pubtest26of10,10,1482,5855,39,355,6249
subtest25of10,pubtest26of10,10,1482,5855,41,394,6290
subtest27of10,pubtest27of10,10,1481,5598,15,43,5656
subtest23of10,pubtest27of10,10,1481,5598,16,82,5696
subtest29of10,pubtest27of10,10,1481,5598,19,119,5736
subtest21of10,pubtest27of10,10,1481,5598,24,155,5777
subtest28of10,pubtest27of10,10,1481,5598,26,191,5815
subtest25of10,pubtest27of10,10,1481,5598,24,231,5853
subtest210of10,pubtest27of10,10,1481,5598,28,270,5896
subtest24of10,pubtest27of10,10,1481,5598,31,308,5937
subtest26of10,pubtest27of10,10,1481,5598,30,348,5976
subtest22of10,pubtest27of10,10,1481,5598,32,387,6017
subtest27of10,pubtest28of10,10,1480,6060,5,40,6105
subtest21of10,pubtest28of10,10,1480,6060,9,75,6144
subtest28of10,pubtest28of10,10,1480,6060,12,114,6186
subtest29of10,pubtest28of10,10,1480,6060,16,150,6226
subtest210of10,pubtest28of10,10,1480,6060,19,187,6266
subtest23of10,pubtest28of10,10,1480,6060,30,216,6306
subtest26of10,pubtest28of10,10,1480,6060,31,255,6346
subtest25of10,pubtest28of10,10,1480,6060,38,288,6386
subtest24of10,pubtest28of10,10,1480,6060,39,326,6425
subtest22of10,pubtest28of10,10,1480,6060,40,366,6466
subtest23of10,pubtest29of10,10,1482,5912,-5,38,5945
subtest210of10,pubtest29of10,10,1482,5912,5,68,5985
subtest22of10,pubtest29of10,10,1482,5912,19,95,6026
subtest29of10,pubtest29of10,10,1482,5912,20,134,6066
subtest25of10,pubtest29of10,10,1482,5912,25,168,6105
subtest21of10,pubtest29of10,10,1482,5912,27,206,6145
subtest27of10,pubtest29of10,10,1482,5912,29,245,6186
subtest28of10,pubtest29of10,10,1482,5912,28,285,6225
subtest24of10,pubtest29of10,10,1482,5912,38,314,6264
subtest26of10,pubtest29of10,10,1482,5912,41,352,6305
subtest29of10,pubtest210of10,10,1493,5933,-4,40,5969
subtest21of10,pubtest210of10,10,1493,5933,7,69,6009
subtest27of10,pubtest210of10,10,1493,5933,13,102,6048
subtest210of10,pubtest210of10,10,1493,5933,13,141,6087
subtest24of10,pubtest210of10,10,1493,5933,17,179,6129
subtest22of10,pubtest210of10,10,1493,5933,18,215,6166
subtest26of10,pubtest210of10,10,1493,5933,21,255,6209
subtest28of10,pubtest210of10,10,1493,5933,16,294,6243
subtest23of10,pubtest210of10,10,1493,5933,41,315,6289
subtest25of10,pubtest210of10,10,1493,5933,44,351,6328
subtest27of10,pubtest21of10,10,1483,11319,9,41,11369
subtest26of10,pubtest21of10,10,1483,11319,12,78,11409
subtest24of10,pubtest21of10,10,1483,11319,17,112,11448
subtest29of10,pubtest21of10,10,1483,11319,20,151,11490
subtest25of10,pubtest21of10,10,1483,11319,22,189,11530
subtest21of10,pubtest21of10,10,1483,11319,28,223,11570
subtest210of10,pubtest21of10,10,1483,11319,33,258,11610
subtest28of10,pubtest21of10,10,1483,11319,34,296,11649
subtest22of10,pubtest21of10,10,1483,11319,36,334,11689
subtest23of10,pubtest21of10,10,1483,11319,39,373,11731
subtest29of10,pubtest22of10,10,1482,5607,-2,41,5646
subtest27of10,pubtest22of10,10,1482,5607,2,78,5687
subtest24of10,pubtest22of10,10,1482,5607,22,98,5727
subtest28of10,pubtest22of10,10,1482,5607,29,131,5767
subtest26of10,pubtest22of10,10,1482,5607,30,170,5807
subtest23of10,pubtest22of10,10,1482,5607,32,207,5846
subtest25of10,pubtest22of10,10,1482,5607,55,225,5887
subtest21of10,pubtest22of10,10,1482,5607,57,262,5926
subtest210of10,pubtest22of10,10,1482,5607,56,303,5966
subtest22of10,pubtest22of10,10,1482,5607,59,339,6005
subtest23of10,pubtest23of10,10,1482,5653,-4,38,5687
subtest28of10,pubtest23of10,10,1482,5653,6,68,5727
subtest29of10,pubtest23of10,10,1482,5653,15,99,5767
subtest27of10,pubtest23of10,10,1482,5653,16,138,5807
subtest24of10,pubtest23of10,10,1482,5653,15,178,5846
subtest25of10,pubtest23of10,10,1482,5653,19,215,5887
subtest26of10,pubtest23of10,10,1482,5653,21,251,5925
subtest21of10,pubtest23of10,10,1482,5653,30,284,5967
subtest22of10,pubtest23of10,10,1482,5653,29,322,6004
subtest210of10,pubtest23of10,10,1482,5653,32,362,6047
subtest24of10,pubtest24of10,10,1482,5686,7,40,5733
subtest23of10,pubtest24of10,10,1482,5686,8,79,5773
subtest28of10,pubtest24of10,10,1482,5686,14,112,5812
subtest25of10,pubtest24of10,10,1482,5686,15,150,5851
subtest22of10,pubtest24of10,10,1482,5686,19,188,5893
subtest21of10,pubtest24of10,10,1482,5686,21,226,5933
subtest210of10,pubtest24of10,10,1482,5686,23,264,5973
subtest29of10,pubtest24of10,10,1482,5686,24,302,6012
subtest27of10,pubtest24of10,10,1482,5686,26,341,6053
subtest26of10,pubtest24of10,10,1482,5686,41,366,6093
subtest28of10,pubtest25of10,10,1482,5623,17,41,5681
subtest21of10,pubtest25of10,10,1482,5623,18,79,5720
subtest210of10,pubtest25of10,10,1482,5623,20,117,5760
subtest26of10,pubtest25of10,10,1482,5623,20,157,5800
subtest27of10,pubtest25of10,10,1482,5623,29,187,5839
subtest22of10,pubtest25of10,10,1482,5623,36,221,5880
subtest25of10,pubtest25of10,10,1482,5623,60,236,5919
subtest23of10,pubtest25of10,10,1482,5623,63,273,5959
subtest29of10,pubtest25of10,10,1482,5623,66,311,6000
subtest24of10,pubtest25of10,10,1482,5623,67,348,6038
subtest21of10,pubtest26of10,10,1482,5633,4,42,5679
subtest22of10,pubtest26of10,10,1482,5633,6,79,5718
subtest29of10,pubtest26of10,10,1482,5633,18,107,5758
subtest23of10,pubtest26of10,10,1482,5633,23,141,5797
subtest26of10,pubtest26of10,10,1482,5633,33,172,5838
subtest27of10,pubtest26of10,10,1482,5633,34,211,5878
subtest210of10,pubtest26of10,10,1482,5633,37,246,5916
subtest28of10,pubtest26of10,10,1482,5633,44,280,5957
subtest25of10,pubtest26of10,10,1482,5633,49,316,5998
subtest24of10,pubtest26of10,10,1482,5633,69,336,6038
subtest27of10,pubtest27of10,10,1481,5791,6,41,5838
subtest28of10,pubtest27of10,10,1481,5791,7,80,5878
subtest23of10,pubtest27of10,10,1481,5791,9,119,5919
subtest24of10,pubtest27of10,10,1481,5791,12,155,5958
subtest29of10,pubtest27of10,10,1481,5791,19,189,5999
subtest210of10,pubtest27of10,10,1481,5791,20,227,6038
subtest25of10,pubtest27of10,10,1481,5791,21,267,6079
subtest22of10,pubtest27of10,10,1481,5791,22,305,6118
subtest21of10,pubtest27of10,10,1481,5791,27,341,6159
subtest26of10,pubtest27of10,10,1481,5791,28,379,6198
subtest21of10,pubtest28of10,10,1480,5411,14,43,5468
subtest28of10,pubtest28of10,10,1480,5411,15,81,5507
subtest27of10,pubtest28of10,10,1480,5411,13,120,5544
subtest29of10,pubtest28of10,10,1480,5411,37,139,5587
subtest210of10,pubtest28of10,10,1480,5411,40,176,5627
subtest23of10,pubtest28of10,10,1480,5411,42,214,5667
subtest26of10,pubtest28of10,10,1480,5411,43,253,5707
subtest25of10,pubtest28of10,10,1480,5411,45,290,5746
subtest22of10,pubtest28of10,10,1480,5411,48,326,5785
subtest24of10,pubtest28of10,10,1480,5411,48,366,5825
subtest23of10,pubtest29of10,10,1482,5422,11,45,5478
subtest210of10,pubtest29of10,10,1482,5422,13,83,5518
subtest29of10,pubtest29of10,10,1482,5422,25,110,5557
subtest25of10,pubtest29of10,10,1482,5422,28,148,5598
subtest22of10,pubtest29of10,10,1482,5422,27,187,5636
subtest28of10,pubtest29of10,10,1482,5422,29,233,5684
subtest21of10,pubtest29of10,10,1482,5422,33,271,5726
subtest24of10,pubtest29of10,10,1482,5422,33,311,5766
subtest27of10,pubtest29of10,10,1482,5422,33,349,5804
subtest26of10,pubtest29of10,10,1482,5422,39,384,5845
subtest29of10,pubtest210of10,10,1493,5226,3,40,5269
subtest21of10,pubtest210of10,10,1493,5226,5,76,5307
subtest210of10,pubtest210of10,10,1493,5226,8,114,5348
subtest27of10,pubtest210of10,10,1493,5226,13,149,5388
subtest28of10,pubtest210of10,10,1493,5226,15,188,5429
subtest24of10,pubtest210of10,10,1493,5226,26,217,5469
subtest22of10,pubtest210of10,10,1493,5226,42,240,5508
subtest26of10,pubtest210of10,10,1493,5226,46,276,5548
subtest23of10,pubtest210of10,10,1493,5226,61,302,5589
subtest25of10,pubtest210of10,10,1493,5226,67,335,5628
subtest26of10,pubtest21of10,100,13081,11170,127,43,11340
subtest25of10,pubtest21of10,100,13081,11170,189,50,11409
subtest21of10,pubtest21of10,100,13081,11170,190,93,11453
subtest29of10,pubtest21of10,100,13081,11170,187,128,11485
subtest28of10,pubtest21of10,100,13081,11170,197,160,11527
subtest210of10,pubtest21of10,100,13081,11170,198,198,11566
subtest22of10,pubtest21of10,100,13081,11170,206,240,11616
subtest23of10,pubtest21of10,100,13081,11170,208,278,11656
subtest27of10,pubtest21of10,100,13081,11170,396,130,11696
subtest24of10,pubtest21of10,100,13081,11170,428,137,11735
subtest29of10,pubtest22of10,100,13083,7145,237,55,7437
subtest24of10,pubtest22of10,100,13083,7145,239,89,7473
subtest26of10,pubtest22of10,100,13083,7145,248,126,7519
subtest210of10,pubtest22of10,100,13083,7145,247,165,7557
subtest28of10,pubtest22of10,100,13083,7145,245,202,7592
subtest25of10,pubtest22of10,100,13083,7145,256,238,7639
subtest22of10,pubtest22of10,100,13083,7145,259,279,7683
subtest21of10,pubtest22of10,100,13083,7145,277,301,7723
subtest27of10,pubtest22of10,100,13083,7145,295,326,7766
subtest23of10,pubtest22of10,100,13083,7145,303,358,7806
subtest23of10,pubtest23of10,100,13082,6791,248,57,7096
subtest28of10,pubtest23of10,100,13082,6791,250,100,7141
subtest29of10,pubtest23of10,100,13082,6791,254,136,7181
subtest24of10,pubtest23of10,100,13082,6791,259,170,7220
subtest25of10,pubtest23of10,100,13082,6791,268,206,7265
subtest27of10,pubtest23of10,100,13082,6791,268,244,7303
subtest210of10,pubtest23of10,100,13082,6791,309,245,7345
subtest21of10,pubtest23of10,100,13082,6791,330,264,7385
subtest22of10,pubtest23of10,100,13082,6791,487,147,7425
subtest26of10,pubtest23of10,100,13082,6791,551,124,7466
subtest24of10,pubtest24of10,100,13085,6372,183,47,6602
subtest28of10,pubtest24of10,100,13085,6372,207,63,6642
subtest23of10,pubtest24of10,100,13085,6372,207,107,6686
subtest22of10,pubtest24of10,100,13085,6372,225,131,6728
subtest21of10,pubtest24of10,100,13085,6372,241,154,6767
subtest210of10,pubtest24of10,100,13085,6372,248,184,6804
subtest29of10,pubtest24of10,100,13085,6372,248,222,6842
subtest27of10,pubtest24of10,100,13085,6372,251,262,6885
subtest26of10,pubtest24of10,100,13085,6372,451,105,6928
subtest25of10,pubtest24of10,100,13085,6372,501,94,6967
subtest210of10,pubtest25of10,100,13082,6865,208,61,7134
subtest21of10,pubtest25of10,100,13082,6865,207,102,7174
subtest26of10,pubtest25of10,100,13082,6865,211,142,7218
subtest23of10,pubtest25of10,100,13082,6865,226,169,7260
subtest27of10,pubtest25of10,100,13082,6865,235,203,7303
subtest25of10,pubtest25of10,100,13082,6865,251,228,7344
subtest24of10,pubtest25of10,100,13082,6865,264,251,7380
subtest29of10,pubtest25of10,100,13082,6865,269,289,7423
subtest22of10,pubtest25of10,100,13082,6865,271,327,7463
subtest28of10,pubtest25of10,100,13082,6865,496,143,7504
subtest21of10,pubtest26of10,100,13075,6005,192,47,6244
subtest22of10,pubtest26of10,100,13075,6005,226,53,6284
subtest29of10,pubtest26of10,100,13075,6005,252,72,6329
subtest26of10,pubtest26of10,100,13075,6005,258,107,6370
subtest23of10,pubtest26of10,100,13075,6005,259,147,6411
subtest210of10,pubtest26of10,100,13075,6005,262,186,6453
subtest28of10,pubtest26of10,100,13075,6005,264,225,6494
subtest24of10,pubtest26of10,100,13075,6005,284,249,6538
subtest27of10,pubtest26of10,100,13075,6005,329,242,6576
subtest25of10,pubtest26of10,100,13075,6005,336,278,6619
subtest23of10,pubtest27of10,100,13083,6748,315,50,7113
subtest28of10,pubtest27of10,100,13083,6748,307,100,7155
subtest210of10,pubtest27of10,100,13083,6748,309,138,7195
subtest29of10,pubtest27of10,100,13083,6748,310,177,7235
subtest24of10,pubtest27of10,100,13083,6748,316,215,7279
subtest27of10,pubtest27of10,100,13083,6748,307,255,7310
subtest22of10,pubtest27of10,100,13083,6748,338,277,7363
subtest25of10,pubtest27of10,100,13083,6748,338,317,7403
subtest26of10,pubtest27of10,100,13083,6748,346,349,7443
subtest21of10,pubtest27of10,100,13083,6748,349,386,7483
subtest27of10,pubtest28of10,100,13085,6738,456,46,7240
subtest29of10,pubtest28of10,100,13085,6738,472,71,7281
subtest21of10,pubtest28of10,100,13085,6738,472,112,7322
subtest26of10,pubtest28of10,100,13085,6738,506,120,7364
subtest210of10,pubtest28of10,100,13085,6738,622,44,7404
subtest24of10,pubtest28of10,100,13085,6738,674,44,7456
subtest25of10,pubtest28of10,100,13085,6738,674,88,7500
subtest22of10,pubtest28of10,100,13085,6738,678,124,7540
subtest23of10,pubtest28of10,100,13085,6738,683,159,7580
subtest28of10,pubtest28of10,100,13085,6738,769,114,7621
subtest29of10,pubtest29of10,100,13081,6442,308,45,6795
subtest25of10,pubtest29of10,100,13081,6442,316,80,6838
subtest210of10,pubtest29of10,100,13081,6442,326,113,6881
subtest22of10,pubtest29of10,100,13081,6442,327,154,6923
subtest21of10,pubtest29of10,100,13081,6442,335,185,6962
subtest24of10,pubtest29of10,100,13081,6442,335,223,7000
subtest28of10,pubtest29of10,100,13081,6442,356,245,7043
subtest23of10,pubtest29of10,100,13081,6442,360,284,7086
subtest27of10,pubtest29of10,100,13081,6442,368,316,7126
subtest26of10,pubtest29of10,100,13081,6442,701,44,7187
subtest29of10,pubtest210of10,100,13188,5686,118,480,6284
subtest210of10,pubtest210of10,100,13188,5686,248,394,6328
subtest27of10,pubtest210of10,100,13188,5686,293,390,6369
subtest24of10,pubtest210of10,100,13188,5686,309,414,6409
subtest22of10,pubtest210of10,100,13188,5686,316,447,6449
subtest25of10,pubtest210of10,100,13188,5686,357,445,6488
subtest28of10,pubtest210of10,100,13188,5686,387,456,6529
subtest26of10,pubtest210of10,100,13188,5686,388,494,6568
subtest23of10,pubtest210of10,100,13188,5686,405,514,6605
subtest21of10,pubtest210of10,100,13188,5686,472,491,6649
subtest26of10,pubtest21of10,100,13081,10136,122,45,10303
subtest27of10,pubtest21of10,100,13081,10136,136,72,10344
subtest29of10,pubtest21of10,100,13081,10136,285,47,10468
subtest24of10,pubtest21of10,100,13081,10136,286,89,10511
subtest25of10,pubtest21of10,100,13081,10136,290,125,10551
subtest210of10,pubtest21of10,100,13081,10136,300,153,10589
subtest21of10,pubtest21of10,100,13081,10136,305,191,10632
subtest28of10,pubtest21of10,100,13081,10136,308,227,10671
subtest23of10,pubtest21of10,100,13081,10136,311,263,10710
subtest22of10,pubtest21of10,100,13081,10136,330,285,10751
subtest29of10,pubtest22of10,100,13083,5294,264,45,5603
subtest24of10,pubtest22of10,100,13083,5294,286,64,5644
subtest28of10,pubtest22of10,100,13083,5294,300,91,5685
subtest27of10,pubtest22of10,100,13083,5294,303,126,5723
subtest26of10,pubtest22of10,100,13083,5294,308,163,5765
subtest23of10,pubtest22of10,100,13083,5294,318,193,5805
subtest210of10,pubtest22of10,100,13083,5294,315,233,5842
subtest21of10,pubtest22of10,100,13083,5294,333,259,5886
subtest25of10,pubtest22of10,100,13083,5294,629,42,5965
subtest22of10,pubtest22of10,100,13083,5294,644,72,6010
subtest23of10,pubtest23of10,100,13082,5409,221,56,5686
subtest29of10,pubtest23of10,100,13082,5409,226,92,5727
subtest28of10,pubtest23of10,100,13082,5409,229,133,5771
subtest24of10,pubtest23of10,100,13082,5409,237,165,5811
subtest27of10,pubtest23of10,100,13082,5409,248,197,5854
subtest26of10,pubtest23of10,100,13082,5409,264,222,5895
subtest22of10,pubtest23of10,100,13082,5409,292,233,5934
subtest25of10,pubtest23of10,100,13082,5409,312,254,5975
subtest21of10,pubtest23of10,100,13082,5409,322,285,6016
subtest210of10,pubtest23of10,100,13082,5409,327,322,6058
subtest23of10,pubtest24of10,100,13085,5334,145,44,5523
subtest24of10,pubtest24of10,100,13085,5334,230,44,5608
subtest28of10,pubtest24of10,100,13085,5334,233,84,5651
subtest22of10,pubtest24of10,100,13085,5334,237,124,5695
subtest25of10,pubtest24of10,100,13085,5334,240,161,5735
subtest210of10,pubtest24of10,100,13085,5334,254,187,5775
subtest21of10,pubtest24of10,100,13085,5334,296,185,5815
subtest26of10,pubtest24of10,100,13085,5334,321,200,5855
subtest27of10,pubtest24of10,100,13085,5334,349,212,5895
subtest29of10,pubtest24of10,100,13085,5334,527,74,5935
subtest210of10,pubtest25of10,100,13082,5431,247,42,5720
subtest21of10,pubtest25of10,100,13082,5431,258,75,5764
subtest26of10,pubtest25of10,100,13082,5431,264,112,5807
subtest22of10,pubtest25of10,100,13082,5431,278,143,5852
subtest27of10,pubtest25of10,100,13082,5431,278,181,5890
subtest23of10,pubtest25of10,100,13082,5431,283,218,5932
subtest29of10,pubtest25of10,100,13082,5431,323,218,5972
subtest24of10,pubtest25of10,100,13082,5431,329,253,6013
subtest25of10,pubtest25of10,100,13082,5431,336,285,6052
subtest28of10,pubtest25of10,100,13082,5431,515,147,6093
subtest22of10,pubtest26of10,100,13075,5556,251,43,5850
subtest23of10,pubtest26of10,100,13075,5556,260,78,5894
subtest29of10,pubtest26of10,100,13075,5556,260,118,5934
subtest27of10,pubtest26of10,100,13075,5556,284,134,5974
subtest24of10,pubtest26of10,100,13075,5556,286,172,6014
subtest26of10,pubtest26of10,100,13075,5556,303,191,6050
subtest210of10,pubtest26of10,100,13075,5556,306,230,6092
subtest28of10,pubtest26of10,100,13075,5556,309,269,6134
subtest21of10,pubtest26of10,100,13075,5556,522,96,6174
subtest25of10,pubtest26of10,100,13075,5556,613,45,6214
subtest24of10,pubtest27of10,100,13083,6069,196,50,6315
subtest23of10,pubtest27of10,100,13083,6069,196,94,6359
subtest29of10,pubtest27of10,100,13083,6069,203,130,6402
subtest210of10,pubtest27of10,100,13083,6069,236,140,6445
subtest25of10,pubtest27of10,100,13083,6069,238,179,6486
subtest22of10,pubtest27of10,100,13083,6069,241,214,6524
subtest26of10,pubtest27of10,100,13083,6069,329,168,6566
subtest21of10,pubtest27of10,100,13083,6069,343,191,6603
subtest27of10,pubtest27of10,100,13083,6069,446,131,6646
subtest28of10,pubtest27of10,100,13083,6069,522,95,6686
subtest27of10,pubtest28of10,100,13085,5614,92,45,5751
subtest28of10,pubtest28of10,100,13085,5614,168,45,5827
subtest210of10,pubtest28of10,100,13085,5614,237,48,5899
subtest23of10,pubtest28of10,100,13085,5614,239,84,5937
subtest26of10,pubtest28of10,100,13085,5614,245,125,5984
subtest22of10,pubtest28of10,100,13085,5614,265,144,6023
subtest25of10,pubtest28of10,100,13085,5614,300,149,6063
subtest24of10,pubtest28of10,100,13085,5614,308,181,6103
subtest29of10,pubtest28of10,100,13085,5614,471,58,6143
subtest21of10,pubtest28of10,100,13085,5614,519,49,6182
subtest23of10,pubtest29of10,100,13081,5306,255,47,5608
subtest25of10,pubtest29of10,100,13081,5306,284,61,5651
subtest210of10,pubtest29of10,100,13081,5306,289,97,5692
subtest22of10,pubtest29of10,100,13081,5306,288,140,5734
subtest29of10,pubtest29of10,100,13081,5306,283,181,5770
subtest27of10,pubtest29of10,100,13081,5306,295,216,5817
subtest21of10,pubtest29of10,100,13081,5306,295,256,5857
subtest26of10,pubtest29of10,100,13081,5306,295,293,5894
subtest28of10,pubtest29of10,100,13081,5306,319,314,5939
subtest24of10,pubtest29of10,100,13081,5306,320,354,5980
subtest29of10,pubtest210of10,100,13188,5339,126,42,5507
subtest21of10,pubtest210of10,100,13188,5339,200,42,5581
subtest210of10,pubtest210of10,100,13188,5339,206,79,5624
subtest27of10,pubtest210of10,100,13188,5339,209,116,5664
subtest24of10,pubtest210of10,100,13188,5339,212,148,5699
subtest26of10,pubtest210of10,100,13188,5339,215,188,5742
subtest28of10,pubtest210of10,100,13188,5339,209,227,5775
subtest22of10,pubtest210of10,100,13188,5339,215,266,5820
subtest23of10,pubtest210of10,100,13188,5339,495,42,5876
subtest25of10,pubtest210of10,100,13188,5339,501,80,5920
subtest26of10,pubtest21of10,100,13081,10441,149,46,10636
subtest24of10,pubtest21of10,100,13081,10441,204,47,10692
subtest29of10,pubtest21of10,100,13081,10441,212,77,10730
subtest21of10,pubtest21of10,100,13081,10441,246,84,10771
subtest25of10,pubtest21of10,100,13081,10441,246,124,10811
subtest210of10,pubtest21of10,100,13081,10441,250,160,10851
subtest28of10,pubtest21of10,100,13081,10441,255,196,10892
subtest22of10,pubtest21of10,100,13081,10441,278,211,10930
subtest23of10,pubtest21of10,100,13081,10441,300,231,10972
subtest27of10,pubtest21of10,100,13081,10441,460,111,11012
subtest25of10,pubtest22of10,100,13083,5802,184,43,6029
subtest24of10,pubtest22of10,100,13083,5802,280,44,6126
subtest29of10,pubtest22of10,100,13083,5802,276,83,6161
subtest21of10,pubtest22of10,100,13083,5802,294,109,6205
subtest28of10,pubtest22of10,100,13083,5802,295,148,6245
subtest26of10,pubtest22of10,100,13083,5802,300,183,6285
subtest22of10,pubtest22of10,100,13083,5802,299,223,6324
subtest210of10,pubtest22of10,100,13083,5802,300,258,6360
subtest23of10,pubtest22of10,100,13083,5802,474,129,6405
subtest27of10,pubtest22of10,100,13083,5802,597,47,6446
subtest29of10,pubtest23of10,100,13082,5702,240,44,5986
subtest23of10,pubtest23of10,100,13082,5702,240,86,6028
subtest24of10,pubtest23of10,100,13082,5702,256,116,6074
subtest27of10,pubtest23of10,100,13082,5702,274,137,6113
subtest25of10,pubtest23of10,100,13082,5702,279,177,6158
subtest26of10,pubtest23of10,100,13082,5702,284,211,6197
subtest22of10,pubtest23of10,100,13082,5702,287,248,6237
subtest21of10,pubtest23of10,100,13082,5702,291,282,6275
subtest210of10,pubtest23of10,100,13082,5702,295,320,6317
subtest28of10,pubtest23of10,100,13082,5702,413,243,6358
subtest23of10,pubtest24of10,100,13085,5162,294,46,5502
subtest24of10,pubtest24of10,100,13085,5162,322,61,5545
subtest28of10,pubtest24of10,100,13085,5162,337,88,5587
subtest25of10,pubtest24of10,100,13085,5162,349,118,5629
subtest22of10,pubtest24of10,100,13085,5162,355,153,5670
subtest21of10,pubtest24of10,100,13085,5162,360,188,5710
subtest26of10,pubtest24of10,100,13085,5162,406,185,5753
subtest29of10,pubtest24of10,100,13085,5162,416,219,5797
subtest27of10,pubtest24of10,100,13085,5162,423,252,5837
subtest210of10,pubtest24of10,100,13085,5162,671,48,5881
subtest28of10,pubtest25of10,100,13082,5451,205,45,5701
subtest21of10,pubtest25of10,100,13082,5451,342,44,5837
subtest26of10,pubtest25of10,100,13082,5451,343,87,5881
subtest27of10,pubtest25of10,100,13082,5451,349,121,5921
subtest22of10,pubtest25of10,100,13082,5451,351,160,5962
subtest25of10,pubtest25of10,100,13082,5451,354,196,6001
subtest23of10,pubtest25of10,100,13082,5451,369,219,6039
subtest24of10,pubtest25of10,100,13082,5451,373,257,6081
subtest29of10,pubtest25of10,100,13082,5451,374,296,6121
subtest210of10,pubtest25of10,100,13082,5451,692,43,6186
subtest21of10,pubtest26of10,100,13075,5766,261,45,6072
subtest22of10,pubtest26of10,100,13075,5766,297,54,6117
subtest29of10,pubtest26of10,100,13075,5766,306,84,6156
subtest23of10,pubtest26of10,100,13075,5766,364,71,6201
subtest26of10,pubtest26of10,100,13075,5766,367,107,6240
subtest28of10,pubtest26of10,100,13075,5766,376,142,6284
subtest27of10,pubtest26of10,100,13075,5766,384,174,6324
subtest25of10,pubtest26of10,100,13075,5766,388,213,6367
subtest210of10,pubtest26of10,100,13075,5766,417,226,6409
subtest24of10,pubtest26of10,100,13075,5766,425,257,6448
subtest27of10,pubtest27of10,100,13083,5757,507,44,6308
subtest28of10,pubtest27of10,100,13083,5757,519,76,6352
subtest23of10,pubtest27of10,100,13083,5757,519,116,6392
subtest24of10,pubtest27of10,100,13083,5757,576,104,6437
subtest29of10,pubtest27of10,100,13083,5757,578,141,6476
subtest210of10,pubtest27of10,100,13083,5757,580,184,6521
subtest25of10,pubtest27of10,100,13083,5757,583,220,6560
subtest22of10,pubtest27of10,100,13083,5757,585,256,6598
subtest26of10,pubtest27of10,100,13083,5757,624,259,6640
subtest21of10,pubtest27of10,100,13083,5757,627,296,6680
subtest27of10,pubtest28of10,100,13085,5724,345,51,6120
subtest28of10,pubtest28of10,100,13085,5724,385,55,6164
subtest21of10,pubtest28of10,100,13085,5724,397,87,6208
subtest26of10,pubtest28of10,100,13085,5724,425,103,6252
subtest23of10,pubtest28of10,100,13085,5724,425,146,6295
subtest210of10,pubtest28of10,100,13085,5724,482,130,6336
subtest22of10,pubtest28of10,100,13085,5724,508,145,6377
subtest24of10,pubtest28of10,100,13085,5724,531,162,6417
subtest29of10,pubtest28of10,100,13085,5724,988,45,6757
subtest25of10,pubtest28of10,100,13085,5724,1063,44,6831
subtest23of10,pubtest29of10,100,13081,5747,304,42,6093
subtest28of10,pubtest29of10,100,13081,5747,321,64,6132
subtest24of10,pubtest29of10,100,13081,5747,333,93,6173
subtest27of10,pubtest29of10,100,13081,5747,340,126,6213
subtest21of10,pubtest29of10,100,13081,5747,337,166,6250
subtest26of10,pubtest29of10,100,13081,5747,341,206,6294
subtest25of10,pubtest29of10,100,13081,5747,351,237,6335
subtest29of10,pubtest29of10,100,13081,5747,702,44,6493
subtest210of10,pubtest29of10,100,13081,5747,762,44,6553
subtest22of10,pubtest29of10,100,13081,5747,773,77,6597
subtest29of10,pubtest210of10,100,13188,5804,128,357,6289
subtest28of10,pubtest210of10,100,13188,5804,212,315,6331
subtest27of10,pubtest210of10,100,13188,5804,208,352,6364
subtest24of10,pubtest210of10,100,13188,5804,214,395,6413
subtest210of10,pubtest210of10,100,13188,5804,207,434,6445
subtest21of10,pubtest210of10,100,13188,5804,207,474,6485
subtest26of10,pubtest210of10,100,13188,5804,230,500,6534
subtest23of10,pubtest210of10,100,13188,5804,236,534,6574
subtest25of10,pubtest210of10,100,13188,5804,254,558,6616
subtest22of10,pubtest210of10,100,13188,5804,285,569,6658
subtest26of10,pubtest21of10,100,13081,11196,98,45,11339
subtest27of10,pubtest21of10,100,13081,11196,149,42,11387
subtest29of10,pubtest21of10,100,13081,11196,160,74,11430
subtest21of10,pubtest21of10,100,13081,11196,166,108,11470
subtest25of10,pubtest21of10,100,13081,11196,166,156,11518
subtest210of10,pubtest21of10,100,13081,11196,170,196,11562
subtest24of10,pubtest21of10,100,13081,11196,159,239,11594
subtest28of10,pubtest21of10,100,13081,11196,174,273,11643
subtest23of10,pubtest21of10,100,13081,11196,179,308,11683
subtest22of10,pubtest21of10,100,13081,11196,188,338,11722
subtest29of10,pubtest22of10,100,13083,5757,139,42,5938
subtest24of10,pubtest22of10,100,13083,5757,216,49,6022
subtest27of10,pubtest22of10,100,13083,5757,222,83,6062
subtest28of10,pubtest22of10,100,13083,5757,224,121,6102
subtest26of10,pubtest22of10,100,13083,5757,225,160,6142
subtest25of10,pubtest22of10,100,13083,5757,242,181,6180
subtest22of10,pubtest22of10,100,13083,5757,247,218,6222
subtest21of10,pubtest22of10,100,13083,5757,248,257,6262
subtest210of10,pubtest22of10,100,13083,5757,252,296,6305
subtest23of10,pubtest22of10,100,13083,5757,499,90,6346
subtest28of10,pubtest23of10,100,13082,5326,244,43,5613
subtest29of10,pubtest23of10,100,13082,5326,259,73,5658
subtest24of10,pubtest23of10,100,13082,5326,301,71,5698
subtest27of10,pubtest23of10,100,13082,5326,303,112,5741
subtest25of10,pubtest23of10,100,13082,5326,321,134,5781
subtest26of10,pubtest23of10,100,13082,5326,321,174,5821
subtest23of10,pubtest23of10,100,13082,5326,363,171,5860
subtest210of10,pubtest23of10,100,13082,5326,403,173,5902
subtest21of10,pubtest23of10,100,13082,5326,652,43,6021
subtest22of10,pubtest23of10,100,13082,5326,663,73,6062
subtest28of10,pubtest24of10,100,13085,5773,253,42,6068
subtest21of10,pubtest24of10,100,13085,5773,319,44,6136
subtest29of10,pubtest24of10,100,13085,5773,327,79,6179
subtest210of10,pubtest24of10,100,13085,5773,326,120,6219
subtest27of10,pubtest24of10,100,13085,5773,331,160,6264
subtest22of10,pubtest24of10,100,13085,5773,343,188,6304
subtest24of10,pubtest24of10,100,13085,5773,444,129,6346
subtest25of10,pubtest24of10,100,13085,5773,520,95,6388
subtest23of10,pubtest24of10,100,13085,5773,607,48,6428
subtest26of10,pubtest24of10,100,13085,5773,666,44,6483
subtest21of10,pubtest25of10,100,13082,5482,217,44,5743
subtest28of10,pubtest25of10,100,13082,5482,274,42,5798
subtest210of10,pubtest25of10,100,13082,5482,324,45,5851
subtest27of10,pubtest25of10,100,13082,5482,330,83,5895
subtest22of10,pubtest25of10,100,13082,5482,333,120,5935
subtest29of10,pubtest25of10,100,13082,5482,340,156,5978
subtest25of10,pubtest25of10,100,13082,5482,337,192,6011
subtest24of10,pubtest25of10,100,13082,5482,343,231,6056
subtest26of10,pubtest25of10,100,13082,5482,356,260,6098
subtest23of10,pubtest25of10,100,13082,5482,371,285,6138
subtest23of10,pubtest26of10,100,13075,5419,198,59,5676
subtest29of10,pubtest26of10,100,13075,5419,192,96,5707
subtest22of10,pubtest26of10,100,13075,5419,191,142,5752
subtest26of10,pubtest26of10,100,13075,5419,199,171,5789
subtest27of10,pubtest26of10,100,13075,5419,209,205,5833
subtest25of10,pubtest26of10,100,13075,5419,213,243,5875
subtest21of10,pubtest26of10,100,13075,5419,191,282,5892
subtest210of10,pubtest26of10,100,13075,5419,202,334,5955
subtest28of10,pubtest26of10,100,13075,5419,206,370,5995
subtest24of10,pubtest26of10,100,13075,5419,215,401,6035
subtest28of10,pubtest27of10,100,13083,5433,252,44,5729
subtest27of10,pubtest27of10,100,13083,5433,306,45,5784
subtest23of10,pubtest27of10,100,13083,5433,313,79,5825
subtest24of10,pubtest27of10,100,13083,5433,325,106,5864
subtest210of10,pubtest27of10,100,13083,5433,330,144,5907
subtest29of10,pubtest27of10,100,13083,5433,328,182,5943
subtest22of10,pubtest27of10,100,13083,5433,360,198,5991
subtest25of10,pubtest27of10,100,13083,5433,360,239,6032
subtest26of10,pubtest27of10,100,13083,5433,388,252,6073
subtest21of10,pubtest27of10,100,13083,5433,389,294,6116
subtest27of10,pubtest28of10,100,13085,5624,171,42,5837
subtest28of10,pubtest28of10,100,13085,5624,244,42,5910
subtest29of10,pubtest28of10,100,13085,5624,264,67,5955
subtest210of10,pubtest28of10,100,13085,5624,267,103,5994
subtest23of10,pubtest28of10,100,13085,5624,285,125,6034
subtest26of10,pubtest28of10,100,13085,5624,309,141,6074
subtest25of10,pubtest28of10,100,13085,5624,343,148,6115
subtest24of10,pubtest28of10,100,13085,5624,351,177,6152
subtest22of10,pubtest28of10,100,13085,5624,390,185,6199
subtest21of10,pubtest28of10,100,13085,5624,512,103,6239
subtest23of10,pubtest29of10,100,13081,5421,240,44,5705
subtest29of10,pubtest29of10,100,13081,5421,242,86,5749
subtest25of10,pubtest29of10,100,13081,5421,247,116,5784
subtest22of10,pubtest29of10,100,13081,5421,251,156,5828
subtest210of10,pubtest29of10,100,13081,5421,250,195,5866
subtest28of10,pubtest29of10,100,13081,5421,257,235,5913
subtest24of10,pubtest29of10,100,13081,5421,259,273,5953
subtest27of10,pubtest29of10,100,13081,5421,276,297,5994
subtest26of10,pubtest29of10,100,13081,5421,280,332,6033
subtest21of10,pubtest29of10,100,13081,5421,441,212,6074
subtest29of10,pubtest210of10,100,13188,5211,125,45,5381
subtest21of10,pubtest210of10,100,13188,5211,242,51,5504
subtest210of10,pubtest210of10,100,13188,5211,248,86,5545
subtest27of10,pubtest210of10,100,13188,5211,286,93,5590
subtest28of10,pubtest210of10,100,13188,5211,290,128,5629
subtest24of10,pubtest210of10,100,13188,5211,291,168,5670
subtest22of10,pubtest210of10,100,13188,5211,300,198,5709
subtest26of10,pubtest210of10,100,13188,5211,302,233,5746
subtest23of10,pubtest210of10,100,13188,5211,306,272,5789
subtest25of10,pubtest210of10,100,13188,5211,359,260,5830
subtest26of10,pubtest21of10,100,13081,12640,139,45,12824
subtest27of10,pubtest21of10,100,13081,12640,219,44,12903
subtest24of10,pubtest21of10,100,13081,12640,234,74,12948
subtest29of10,pubtest21of10,100,13081,12640,254,93,12987
subtest25of10,pubtest21of10,100,13081,12640,317,70,13027
subtest21of10,pubtest21of10,100,13081,12640,320,107,13067
subtest210of10,pubtest21of10,100,13081,12640,324,141,13105
subtest28of10,pubtest21of10,100,13081,12640,325,182,13147
subtest23of10,pubtest21of10,100,13081,12640,330,218,13188
subtest22of10,pubtest21of10,100,13081,12640,329,258,13227
subtest29of10,pubtest22of10,100,13083,5875,207,42,6124
subtest27of10,pubtest22of10,100,13083,5875,258,43,6176
subtest28of10,pubtest22of10,100,13083,5875,256,86,6217
subtest26of10,pubtest22of10,100,13083,5875,260,124,6259
subtest210of10,pubtest22of10,100,13083,5875,264,161,6300
subtest22of10,pubtest22of10,100,13083,5875,275,188,6338
subtest21of10,pubtest22of10,100,13083,5875,275,231,6381
subtest25of10,pubtest22of10,100,13083,5875,447,102,6424
subtest24of10,pubtest22of10,100,13083,5875,571,43,6489
subtest23of10,pubtest22of10,100,13083,5875,587,70,6532
subtest210of10,pubtest23of10,100,13082,5189,417,131,5737
subtest28of10,pubtest23of10,100,13082,5189,243,136,5568
subtest26of10,pubtest23of10,100,13082,5189,425,170,5784
subtest21of10,pubtest23of10,100,13082,5189,418,209,5816
subtest22of10,pubtest23of10,100,13082,5189,421,258,5868
subtest29of10,pubtest23of10,100,13082,5189,242,290,5721
subtest23of10,pubtest23of10,100,13082,5189,428,334,5951
subtest25of10,pubtest23of10,100,13082,5189,431,369,5989
subtest24of10,pubtest23of10,100,13082,5189,437,406,6032
subtest27of10,pubtest23of10,100,13082,5189,439,444,6072
subtest23of10,pubtest24of10,100,13085,5418,243,46,5707
subtest24of10,pubtest24of10,100,13085,5418,290,44,5752
subtest25of10,pubtest24of10,100,13085,5418,311,62,5791
subtest22of10,pubtest24of10,100,13085,5418,314,104,5836
subtest21of10,pubtest24of10,100,13085,5418,329,130,5877
subtest210of10,pubtest24of10,100,13085,5418,355,147,5920
subtest29of10,pubtest24of10,100,13085,5418,360,184,5962
subtest27of10,pubtest24of10,100,13085,5418,364,221,6003
subtest26of10,pubtest24of10,100,13085,5418,447,177,6042
subtest28of10,pubtest24of10,100,13085,5418,545,121,6084
subtest210of10,pubtest25of10,100,13082,6139,285,62,6486
subtest21of10,pubtest25of10,100,13082,6139,285,106,6530
subtest26of10,pubtest25of10,100,13082,6139,295,136,6570
subtest22of10,pubtest25of10,100,13082,6139,299,172,6610
subtest27of10,pubtest25of10,100,13082,6139,303,208,6650
subtest28of10,pubtest25of10,100,13082,6139,306,242,6687
subtest29of10,pubtest25of10,100,13082,6139,331,260,6730
subtest24of10,pubtest25of10,100,13082,6139,331,300,6770
subtest25of10,pubtest25of10,100,13082,6139,601,70,6810
subtest23of10,pubtest25of10,100,13082,6139,611,101,6851
subtest21of10,pubtest26of10,100,13075,5634,210,43,5887
subtest29of10,pubtest26of10,100,13075,5634,224,71,5929
subtest22of10,pubtest26of10,100,13075,5634,238,101,5973
subtest23of10,pubtest26of10,100,13075,5634,246,138,6018
subtest26of10,pubtest26of10,100,13075,5634,248,176,6058
subtest24of10,pubtest26of10,100,13075,5634,300,164,6098
subtest28of10,pubtest26of10,100,13075,5634,305,199,6138
subtest27of10,pubtest26of10,100,13075,5634,306,239,6179
subtest25of10,pubtest26of10,100,13075,5634,312,273,6219
subtest210of10,pubtest26of10,100,13075,5634,527,98,6259
subtest23of10,pubtest27of10,100,13083,5839,194,44,6077
subtest28of10,pubtest27of10,100,13083,5839,220,58,6117
subtest24of10,pubtest27of10,100,13083,5839,261,60,6160
subtest27of10,pubtest27of10,100,13083,5839,261,104,6204
subtest29of10,pubtest27of10,100,13083,5839,272,133,6244
subtest25of10,pubtest27of10,100,13083,5839,278,171,6288
subtest210of10,pubtest27of10,100,13083,5839,294,196,6329
subtest22of10,pubtest27of10,100,13083,5839,315,219,6373
subtest26of10,pubtest27of10,100,13083,5839,400,173,6412
subtest21of10,pubtest27of10,100,13083,5839,410,204,6453
subtest27of10,pubtest28of10,100,13085,5664,99,354,6117
subtest28of10,pubtest28of10,100,13085,5664,227,270,6161
subtest21of10,pubtest28of10,100,13085,5664,231,306,6201
subtest29of10,pubtest28of10,100,13085,5664,239,338,6241
subtest210of10,pubtest28of10,100,13085,5664,256,361,6281
subtest26of10,pubtest28of10,100,13085,5664,265,392,6321
subtest22of10,pubtest28of10,100,13085,5664,272,425,6361
subtest23of10,pubtest28of10,100,13085,5664,290,447,6401
subtest25of10,pubtest28of10,100,13085,5664,294,487,6445
subtest24of10,pubtest28of10,100,13085,5664,296,525,6485
subtest29of10,pubtest29of10,100,13081,5883,249,48,6180
subtest23of10,pubtest29of10,100,13081,5883,248,93,6224
subtest210of10,pubtest29of10,100,13081,5883,252,129,6264
subtest22of10,pubtest29of10,100,13081,5883,264,157,6304
subtest25of10,pubtest29of10,100,13081,5883,263,195,6341
subtest28of10,pubtest29of10,100,13081,5883,267,302,6452
subtest24of10,pubtest29of10,100,13081,5883,270,343,6496
subtest21of10,pubtest29of10,100,13081,5883,287,364,6534
subtest27of10,pubtest29of10,100,13081,5883,293,400,6576
subtest26of10,pubtest29of10,100,13081,5883,304,429,6616
subtest29of10,pubtest210of10,100,13188,5835,199,43,6077
subtest21of10,pubtest210of10,100,13188,5835,285,44,6164
subtest210of10,pubtest210of10,100,13188,5835,287,87,6209
subtest28of10,pubtest210of10,100,13188,5835,292,119,6246
subtest27of10,pubtest210of10,100,13188,5835,291,157,6283
subtest24of10,pubtest210of10,100,13188,5835,297,196,6328
subtest26of10,pubtest210of10,100,13188,5835,307,226,6368
subtest25of10,pubtest210of10,100,13188,5835,480,94,6409
subtest23of10,pubtest210of10,100,13188,5835,666,43,6544
subtest22of10,pubtest210of10,100,13188,5835,699,42,6576
subtest26of10,pubtest21of10,100,13081,11192,151,42,11385
subtest27of10,pubtest21of10,100,13081,11192,238,44,11474
subtest24of10,pubtest21of10,100,13081,11192,243,82,11517
subtest29of10,pubtest21of10,100,13081,11192,252,112,11556
subtest21of10,pubtest21of10,100,13081,11192,266,138,11596
subtest28of10,pubtest21of10,100,13081,11192,269,175,11636
subtest210of10,pubtest21of10,100,13081,11192,270,215,11677
subtest22of10,pubtest21of10,100,13081,11192,293,232,11717
subtest23of10,pubtest21of10,100,13081,11192,490,75,11757
subtest25of10,pubtest21of10,100,13081,11192,541,63,11796
subtest24of10,pubtest22of10,100,13083,5249,255,46,5550
subtest27of10,pubtest22of10,100,13083,5249,256,89,5594
subtest28of10,pubtest22of10,100,13083,5249,260,125,5634
subtest26of10,pubtest22of10,100,13083,5249,267,162,5678
subtest210of10,pubtest22of10,100,13083,5249,273,195,5717
subtest23of10,pubtest22of10,100,13083,5249,276,236,5761
subtest25of10,pubtest22of10,100,13083,5249,294,259,5802
subtest22of10,pubtest22of10,100,13083,5249,302,290,5841
subtest21of10,pubtest22of10,100,13083,5249,337,295,5881
subtest29of10,pubtest22of10,100,13083,5249,526,150,5925
subtest23of10,pubtest23of10,100,13082,5557,140,45,5742
subtest28of10,pubtest23of10,100,13082,5557,186,43,5786
subtest29of10,pubtest23of10,100,13082,5557,200,73,5830
subtest24of10,pubtest23of10,100,13082,5557,200,113,5870
subtest27of10,pubtest23of10,100,13082,5557,211,140,5908
subtest25of10,pubtest23of10,100,13082,5557,232,162,5951
subtest22of10,pubtest23of10,100,13082,5557,241,192,5990
subtest26of10,pubtest23of10,100,13082,5557,255,218,6030
subtest21of10,pubtest23of10,100,13082,5557,259,254,6070
subtest210of10,pubtest23of10,100,13082,5557,266,291,6114
subtest23of10,pubtest24of10,100,13085,5184,189,43,5416
subtest24of10,pubtest24of10,100,13085,5184,222,54,5460
subtest28of10,pubtest24of10,100,13085,5184,279,44,5507
subtest25of10,pubtest24of10,100,13085,5184,292,75,5551
subtest22of10,pubtest24of10,100,13085,5184,292,114,5590
subtest21of10,pubtest24of10,100,13085,5184,302,146,5632
subtest29of10,pubtest24of10,100,13085,5184,317,174,5675
subtest210of10,pubtest24of10,100,13085,5184,317,214,5715
subtest27of10,pubtest24of10,100,13085,5184,372,199,5755
subtest26of10,pubtest24of10,100,13085,5184,459,152,5795
subtest21of10,pubtest25of10,100,13082,5495,140,45,5680
subtest28of10,pubtest25of10,100,13082,5495,200,43,5738
subtest210of10,pubtest25of10,100,13082,5495,277,46,5818
subtest26of10,pubtest25of10,100,13082,5495,277,88,5860
subtest25of10,pubtest25of10,100,13082,5495,285,122,5902
subtest29of10,pubtest25of10,100,13082,5495,291,156,5942
subtest23of10,pubtest25of10,100,13082,5495,292,190,5977
subtest24of10,pubtest25of10,100,13082,5495,294,229,6018
subtest22of10,pubtest25of10,100,13082,5495,299,268,6062
subtest27of10,pubtest25of10,100,13082,5495,405,203,6103
subtest23of10,pubtest26of10,100,13075,5458,280,141,5879
subtest29of10,pubtest26of10,100,13075,5458,274,145,5877
subtest22of10,pubtest26of10,100,13075,5458,273,149,5880
subtest24of10,pubtest26of10,100,13075,5458,288,166,5912
subtest25of10,pubtest26of10,100,13075,5458,289,204,5951
subtest26of10,pubtest26of10,100,13075,5458,299,234,5991
subtest28of10,pubtest26of10,100,13075,5458,300,278,6036
subtest27of10,pubtest26of10,100,13075,5458,311,312,6081
subtest21of10,pubtest26of10,100,13075,5458,577,85,6120
subtest210of10,pubtest26of10,100,13075,5458,597,105,6160
subtest28of10,pubtest27of10,100,13083,5382,250,46,5678
subtest23of10,pubtest27of10,100,13083,5382,254,84,5720
subtest24of10,pubtest27of10,100,13083,5382,258,118,5758
subtest29of10,pubtest27of10,100,13083,5382,263,156,5801
subtest25of10,pubtest27of10,100,13083,5382,272,187,5841
subtest27of10,pubtest27of10,100,13083,5382,281,219,5882
subtest210of10,pubtest27of10,100,13083,5382,312,227,5921
subtest21of10,pubtest27of10,100,13083,5382,314,265,5961
subtest22of10,pubtest27of10,100,13083,5382,575,47,6004
subtest26of10,pubtest27of10,100,13083,5382,594,70,6046
subtest28of10,pubtest28of10,100,13085,5669,459,42,6170
subtest21of10,pubtest28of10,100,13085,5669,497,48,6214
subtest23of10,pubtest28of10,100,13085,5669,517,68,6254
subtest210of10,pubtest28of10,100,13085,5669,517,111,6297
subtest26of10,pubtest28of10,100,13085,5669,522,146,6337
subtest24of10,pubtest28of10,100,13085,5669,561,148,6378
subtest22of10,pubtest28of10,100,13085,5669,573,175,6417
subtest27of10,pubtest28of10,100,13085,5669,759,42,6470
subtest25of10,pubtest28of10,100,13085,5669,987,43,6699
subtest29of10,pubtest28of10,100,13085,5669,1003,71,6743
subtest23of10,pubtest29of10,100,13081,6076,181,45,6302
subtest25of10,pubtest29of10,100,13081,6076,190,80,6346
subtest210of10,pubtest29of10,100,13081,6076,195,118,6389
subtest28of10,pubtest29of10,100,13081,6076,215,139,6430
subtest24of10,pubtest29of10,100,13081,6076,220,175,6471
subtest26of10,pubtest29of10,100,13081,6076,223,211,6510
subtest29of10,pubtest29of10,100,13081,6076,227,242,6545
subtest22of10,pubtest29of10,100,13081,6076,256,263,6595
subtest27of10,pubtest29of10,100,13081,6076,475,86,6637
subtest21of10,pubtest29of10,100,13081,6076,504,99,6679
subtest29of10,pubtest210of10,100,13188,5854,174,42,6070
subtest210of10,pubtest210of10,100,13188,5854,235,46,6135
subtest27of10,pubtest210of10,100,13188,5854,237,87,6178
subtest28of10,pubtest210of10,100,13188,5854,241,127,6222
subtest24of10,pubtest210of10,100,13188,5854,247,162,6263
subtest21of10,pubtest210of10,100,13188,5854,262,187,6303
subtest22of10,pubtest210of10,100,13188,5854,271,214,6339
subtest26of10,pubtest210of10,100,13188,5854,271,253,6378
subtest25of10,pubtest210of10,100,13188,5854,278,290,6422
subtest23of10,pubtest210of10,100,13188,5854,282,326,6462
subtest26of10,pubtest21of10,100,13081,10788,201,42,11031
subtest27of10,pubtest21of10,100,13081,10788,216,72,11076
subtest29of10,pubtest21of10,100,13081,10788,296,47,11131
subtest24of10,pubtest21of10,100,13081,10788,296,91,11175
subtest25of10,pubtest21of10,100,13081,10788,300,127,11215
subtest21of10,pubtest21of10,100,13081,10788,319,148,11255
subtest210of10,pubtest21of10,100,13081,10788,346,161,11295
subtest28of10,pubtest21of10,100,13081,10788,362,185,11335
subtest23of10,pubtest21of10,100,13081,10788,368,217,11373
subtest22of10,pubtest21of10,100,13081,10788,384,244,11416
subtest29of10,pubtest22of10,100,13083,5847,217,43,6107
subtest26of10,pubtest22of10,100,13083,5847,274,45,6166
subtest27of10,pubtest22of10,100,13083,5847,273,91,6211
subtest28of10,pubtest22of10,100,13083,5847,273,126,6246
subtest210of10,pubtest22of10,100,13083,5847,300,144,6291
subtest23of10,pubtest22of10,100,13083,5847,301,183,6331
subtest25of10,pubtest22of10,100,13083,5847,318,206,6371
subtest22of10,pubtest22of10,100,13083,5847,318,246,6411
subtest21of10,pubtest22of10,100,13083,5847,328,276,6451
subtest24of10,pubtest22of10,100,13083,5847,506,139,6492
subtest23of10,pubtest23of10,100,13082,7106,227,46,7379
subtest29of10,pubtest23of10,100,13082,7106,239,77,7422
subtest24of10,pubtest23of10,100,13082,7106,244,115,7465
subtest25of10,pubtest23of10,100,13082,7106,248,152,7506
subtest27of10,pubtest23of10,100,13082,7106,249,195,7550
subtest28of10,pubtest23of10,100,13082,7106,240,234,7580
subtest26of10,pubtest23of10,100,13082,7106,258,267,7631
subtest22of10,pubtest23of10,100,13082,7106,275,289,7670
subtest21of10,pubtest23of10,100,13082,7106,279,325,7710
subtest210of10,pubtest23of10,100,13082,7106,283,359,7748
subtest24of10,pubtest24of10,100,13085,6979,242,46,7267
subtest23of10,pubtest24of10,100,13085,6979,244,88,7311
subtest28of10,pubtest24of10,100,13085,6979,251,119,7349
subtest22of10,pubtest24of10,100,13085,6979,251,159,7389
subtest25of10,pubtest24of10,100,13085,6979,267,184,7430
subtest210of10,pubtest24of10,100,13085,6979,270,224,7473
subtest29of10,pubtest24of10,100,13085,6979,276,259,7514
subtest21of10,pubtest24of10,100,13085,6979,298,277,7554
subtest27of10,pubtest24of10,100,13085,6979,556,63,7598
subtest26of10,pubtest24of10,100,13085,6979,573,86,7638
subtest28of10,pubtest25of10,100,13082,5234,162,43,5439
subtest210of10,pubtest25of10,100,13082,5234,232,47,5513
subtest21of10,pubtest25of10,100,13082,5234,244,77,5555
subtest27of10,pubtest25of10,100,13082,5234,253,112,5599
subtest22of10,pubtest25of10,100,13082,5234,255,148,5637
subtest23of10,pubtest25of10,100,13082,5234,269,176,5679
subtest25of10,pubtest25of10,100,13082,5234,273,212,5719
subtest24of10,pubtest25of10,100,13082,5234,275,250,5759
subtest29of10,pubtest25of10,100,13082,5234,272,294,5800
subtest26of10,pubtest25of10,100,13082,5234,279,326,5839
subtest22of10,pubtest26of10,100,13075,5568,230,55,5853
subtest21of10,pubtest26of10,100,13075,5568,230,99,5897
subtest29of10,pubtest26of10,100,13075,5568,234,135,5937
subtest23of10,pubtest26of10,100,13075,5568,239,175,5982
subtest26of10,pubtest26of10,100,13075,5568,243,210,6021
subtest210of10,pubtest26of10,100,13075,5568,244,250,6062
subtest25of10,pubtest26of10,100,13075,5568,257,275,6100
subtest24of10,pubtest26of10,100,13075,5568,440,137,6145
subtest27of10,pubtest26of10,100,13075,5568,533,85,6186
subtest28of10,pubtest26of10,100,13075,5568,543,114,6225
subtest27of10,pubtest27of10,100,13083,5361,187,214,5762
subtest24of10,pubtest27of10,100,13083,5361,194,251,5806
subtest28of10,pubtest27of10,100,13083,5361,255,229,5845
subtest29of10,pubtest27of10,100,13083,5361,255,272,5888
subtest25of10,pubtest27of10,100,13083,5361,263,305,5929
subtest210of10,pubtest27of10,100,13083,5361,261,348,5970
subtest22of10,pubtest27of10,100,13083,5361,264,388,6013
subtest26of10,pubtest27of10,100,13083,5361,268,422,6051
subtest21of10,pubtest27of10,100,13083,5361,276,457,6094
subtest23of10,pubtest27of10,100,13083,5361,487,285,6133
subtest27of10,pubtest28of10,100,13085,5671,234,46,5951
subtest29of10,pubtest28of10,100,13085,5671,250,72,5993
subtest23of10,pubtest28of10,100,13085,5671,257,106,6034
subtest25of10,pubtest28of10,100,13085,5671,260,147,6078
subtest28of10,pubtest28of10,100,13085,5671,267,179,6117
subtest210of10,pubtest28of10,100,13085,5671,270,216,6157
subtest24of10,pubtest28of10,100,13085,5671,271,255,6197
subtest26of10,pubtest28of10,100,13085,5671,274,287,6232
subtest22of10,pubtest28of10,100,13085,5671,275,326,6272
subtest21of10,pubtest28of10,100,13085,5671,292,354,6317
subtest23of10,pubtest29of10,100,13081,5948,242,45,6235
subtest210of10,pubtest29of10,100,13081,5948,246,75,6269
subtest29of10,pubtest29of10,100,13081,5948,251,116,6315
subtest22of10,pubtest29of10,100,13081,5948,254,155,6357
subtest21of10,pubtest29of10,100,13081,5948,257,193,6398
subtest25of10,pubtest29of10,100,13081,5948,249,235,6432
subtest28of10,pubtest29of10,100,13081,5948,317,217,6482
subtest24of10,pubtest29of10,100,13081,5948,447,127,6522
subtest27of10,pubtest29of10,100,13081,5948,552,65,6565
subtest26of10,pubtest29of10,100,13081,5948,560,99,6607
subtest29of10,pubtest210of10,100,13188,6259,198,42,6499
subtest21of10,pubtest210of10,100,13188,6259,210,73,6542
subtest210of10,pubtest210of10,100,13188,6259,212,111,6582
subtest28of10,pubtest210of10,100,13188,6259,219,144,6622
subtest23of10,pubtest210of10,100,13188,6259,231,169,6659
subtest25of10,pubtest210of10,100,13188,6259,232,209,6700
subtest27of10,pubtest210of10,100,13188,6259,252,232,6743
subtest24of10,pubtest210of10,100,13188,6259,255,268,6782
subtest26of10,pubtest210of10,100,13188,6259,256,307,6822
subtest22of10,pubtest210of10,100,13188,6259,501,103,6863
subtest26of10,pubtest21of10,100,13081,10671,121,42,10834
subtest27of10,pubtest21of10,100,13081,10671,164,44,10879
subtest24of10,pubtest21of10,100,13081,10671,183,67,10921
subtest29of10,pubtest21of10,100,13081,10671,187,104,10962
subtest25of10,pubtest21of10,100,13081,10671,188,143,11002
subtest21of10,pubtest21of10,100,13081,10671,207,164,11042
subtest210of10,pubtest21of10,100,13081,10671,214,197,11082
subtest28of10,pubtest21of10,100,13081,10671,219,233,11123
subtest23of10,pubtest21of10,100,13081,10671,223,268,11162
subtest22of10,pubtest21of10,100,13081,10671,237,298,11206
subtest29of10,pubtest22of10,100,13083,5559,168,42,5769
subtest24of10,pubtest22of10,100,13083,5559,195,63,5817
subtest27of10,pubtest22of10,100,13083,5559,229,73,5861
subtest210of10,pubtest22of10,100,13083,5559,241,102,5902
subtest23of10,pubtest22of10,100,13083,5559,249,133,5941
subtest21of10,pubtest22of10,100,13083,5559,254,167,5980
subtest22of10,pubtest22of10,100,13083,5559,255,207,6021
subtest25of10,pubtest22of10,100,13083,5559,250,246,6055
subtest28of10,pubtest22of10,100,13083,5559,451,95,6105
subtest26of10,pubtest22of10,100,13083,5559,493,94,6146
subtest23of10,pubtest23of10,100,13082,5570,169,44,5783
subtest27of10,pubtest23of10,100,13082,5570,203,48,5821
subtest24of10,pubtest23of10,100,13082,5570,203,89,5862
subtest25of10,pubtest23of10,100,13082,5570,207,125,5902
subtest22of10,pubtest23of10,100,13082,5570,217,155,5942
subtest21of10,pubtest23of10,100,13082,5570,218,196,5984
subtest26of10,pubtest23of10,100,13082,5570,228,228,6026
subtest28of10,pubtest23of10,100,13082,5570,238,258,6066
subtest210of10,pubtest23of10,100,13082,5570,243,293,6106
subtest29of10,pubtest23of10,100,13082,5570,430,147,6147
subtest23of10,pubtest24of10,100,13085,5383,104,44,5531
subtest24of10,pubtest24of10,100,13085,5383,137,56,5576
subtest25of10,pubtest24of10,100,13085,5383,186,49,5618
subtest22of10,pubtest24of10,100,13085,5383,191,85,5659
subtest28of10,pubtest24of10,100,13085,5383,191,125,5699
subtest21of10,pubtest24of10,100,13085,5383,195,161,5739
subtest210of10,pubtest24of10,100,13085,5383,200,197,5780
subtest27of10,pubtest24of10,100,13085,5383,208,229,5820
subtest29of10,pubtest24of10,100,13085,5383,207,269,5859
subtest26of10,pubtest24of10,100,13085,5383,215,301,5899
subtest28of10,pubtest25of10,100,13082,5432,212,45,5689
subtest210of10,pubtest25of10,100,13082,5432,216,82,5730
subtest26of10,pubtest25of10,100,13082,5432,219,125,5776
subtest27of10,pubtest25of10,100,13082,5432,229,155,5816
subtest25of10,pubtest25of10,100,13082,5432,232,192,5856
subtest29of10,pubtest25of10,100,13082,5432,239,226,5897
subtest22of10,pubtest25of10,100,13082,5432,256,248,5936
subtest21of10,pubtest25of10,100,13082,5432,495,53,5980
subtest23of10,pubtest25of10,100,13082,5432,505,83,6020
subtest24of10,pubtest25of10,100,13082,5432,512,117,6061
subtest22of10,pubtest26of10,100,13075,5799,133,43,5975
subtest29of10,pubtest26of10,100,13075,5799,147,74,6020
subtest21of10,pubtest26of10,100,13075,5799,192,69,6060
subtest26of10,pubtest26of10,100,13075,5799,231,74,6104
subtest27of10,pubtest26of10,100,13075,5799,236,109,6144
subtest28of10,pubtest26of10,100,13075,5799,237,147,6183
subtest210of10,pubtest26of10,100,13075,5799,232,192,6223
subtest25of10,pubtest26of10,100,13075,5799,241,224,6264
subtest24of10,pubtest26of10,100,13075,5799,257,250,6306
subtest23of10,pubtest26of10,100,13075,5799,508,42,6349
subtest28of10,pubtest27of10,100,13083,5842,144,45,6031
subtest27of10,pubtest27of10,100,13083,5842,175,62,6079
subtest24of10,pubtest27of10,100,13083,5842,195,86,6123
subtest25of10,pubtest27of10,100,13083,5842,229,92,6163
subtest22of10,pubtest27of10,100,13083,5842,233,128,6203
subtest29of10,pubtest27of10,100,13083,5842,224,167,6233
subtest23of10,pubtest27of10,100,13083,5842,234,207,6283
subtest210of10,pubtest27of10,100,13083,5842,228,246,6316
subtest21of10,pubtest27of10,100,13083,5842,259,263,6364
subtest26of10,pubtest27of10,100,13083,5842,503,57,6402
subtest27of10,pubtest28of10,100,13085,5749,56,42,5847
subtest28of10,pubtest28of10,100,13085,5749,199,44,5992
subtest21of10,pubtest28of10,100,13085,5749,201,85,6035
subtest29of10,pubtest28of10,100,13085,5749,206,121,6076
subtest210of10,pubtest28of10,100,13085,5749,213,153,6115
subtest23of10,pubtest28of10,100,13085,5749,215,188,6152
subtest24of10,pubtest28of10,100,13085,5749,223,223,6195
subtest22of10,pubtest28of10,100,13085,5749,223,263,6235
subtest25of10,pubtest28of10,100,13085,5749,220,301,6270
subtest26of10,pubtest28of10,100,13085,5749,228,338,6315
subtest23of10,pubtest29of10,100,13081,5248,164,45,5457
subtest29of10,pubtest29of10,100,13081,5248,189,65,5502
subtest25of10,pubtest29of10,100,13081,5248,192,104,5544
subtest210of10,pubtest29of10,100,13081,5248,193,144,5585
subtest22of10,pubtest29of10,100,13081,5248,197,181,5626
subtest24of10,pubtest29of10,100,13081,5248,202,215,5665
subtest27of10,pubtest29of10,100,13081,5248,206,252,5706
subtest26of10,pubtest29of10,100,13081,5248,220,277,5745
subtest21of10,pubtest29of10,100,13081,5248,234,304,5786
subtest28of10,pubtest29of10,100,13081,5248,239,339,5826
subtest29of10,pubtest210of10,100,13188,6482,161,43,6686
subtest210of10,pubtest210of10,100,13188,6482,214,57,6753
subtest21of10,pubtest210of10,100,13188,6482,214,99,6795
subtest28of10,pubtest210of10,100,13188,6482,219,139,6840
subtest25of10,pubtest210of10,100,13188,6482,226,174,6882
subtest26of10,pubtest210of10,100,13188,6482,228,208,6918
subtest23of10,pubtest210of10,100,13188,6482,229,246,6957
subtest27of10,pubtest210of10,100,13188,6482,236,284,7002
subtest22of10,pubtest210of10,100,13188,6482,222,324,7028
subtest24of10,pubtest210of10,100,13188,6482,218,363,7063
subtest26of10,pubtest21of10,100,13081,10806,131,44,10981
subtest29of10,pubtest21of10,100,13081,10806,200,50,11056
subtest21of10,pubtest21of10,100,13081,10806,204,91,11101
subtest25of10,pubtest21of10,100,13081,10806,207,127,11140
subtest28of10,pubtest21of10,100,13081,10806,206,167,11179
subtest27of10,pubtest21of10,100,13081,10806,196,205,11207
subtest23of10,pubtest21of10,100,13081,10806,213,241,11260
subtest210of10,pubtest21of10,100,13081,10806,202,277,11285
subtest24of10,pubtest21of10,100,13081,10806,196,317,11319
subtest22of10,pubtest21of10,100,13081,10806,486,89,11381
subtest29of10,pubtest22of10,100,13083,5300,124,45,5469
subtest24of10,pubtest22of10,100,13083,5300,201,45,5546
subtest27of10,pubtest22of10,100,13083,5300,213,75,5588
subtest28of10,pubtest22of10,100,13083,5300,213,118,5631
subtest26of10,pubtest22of10,100,13083,5300,219,153,5672
subtest23of10,pubtest22of10,100,13083,5300,238,174,5712
subtest25of10,pubtest22of10,100,13083,5300,239,213,5752
subtest21of10,pubtest22of10,100,13083,5300,243,249,5792
subtest22of10,pubtest22of10,100,13083,5300,244,292,5836
subtest210of10,pubtest22of10,100,13083,5300,492,84,5876
subtest23of10,pubtest23of10,100,13082,5191,252,46,5489
subtest27of10,pubtest23of10,100,13082,5191,256,83,5530
subtest29of10,pubtest23of10,100,13082,5191,265,115,5571
subtest26of10,pubtest23of10,100,13082,5191,262,156,5609
subtest24of10,pubtest23of10,100,13082,5191,265,195,5651
subtest210of10,pubtest23of10,100,13082,5191,268,235,5694
subtest28of10,pubtest23of10,100,13082,5191,253,274,5718
subtest22of10,pubtest23of10,100,13082,5191,261,313,5765
subtest25of10,pubtest23of10,100,13082,5191,278,343,5812
subtest21of10,pubtest23of10,100,13082,5191,284,379,5854
subtest23of10,pubtest24of10,100,13085,5350,97,43,5490
subtest28of10,pubtest24of10,100,13085,5350,198,45,5593
subtest25of10,pubtest24of10,100,13085,5350,205,82,5637
subtest210of10,pubtest24of10,100,13085,5350,206,121,5677
subtest21of10,pubtest24of10,100,13085,5350,201,157,5708
subtest26of10,pubtest24of10,100,13085,5350,211,194,5755
subtest29of10,pubtest24of10,100,13085,5350,216,231,5797
subtest27of10,pubtest24of10,100,13085,5350,216,275,5841
subtest24of10,pubtest24of10,100,13085,5350,198,314,5862
subtest22of10,pubtest24of10,100,13085,5350,441,131,5922
subtest28of10,pubtest25of10,100,13082,5523,135,46,5704
subtest210of10,pubtest25of10,100,13082,5523,180,44,5747
subtest26of10,pubtest25of10,100,13082,5523,189,79,5791
subtest21of10,pubtest25of10,100,13082,5523,189,122,5834
subtest27of10,pubtest25of10,100,13082,5523,192,157,5872
subtest25of10,pubtest25of10,100,13082,5523,207,189,5919
subtest29of10,pubtest25of10,100,13082,5523,217,219,5959
subtest23of10,pubtest25of10,100,13082,5523,217,259,5999
subtest24of10,pubtest25of10,100,13082,5523,221,295,6039
subtest22of10,pubtest25of10,100,13082,5523,227,329,6079
subtest21of10,pubtest26of10,100,13075,6138,152,44,6334
subtest22of10,pubtest26of10,100,13075,6138,174,66,6378
subtest29of10,pubtest26of10,100,13075,6138,179,106,6423
subtest23of10,pubtest26of10,100,13075,6138,188,135,6461
subtest26of10,pubtest26of10,100,13075,6138,193,176,6507
subtest24of10,pubtest26of10,100,13075,6138,198,210,6546
subtest210of10,pubtest26of10,100,13075,6138,211,237,6586
subtest28of10,pubtest26of10,100,13075,6138,211,277,6626
subtest25of10,pubtest26of10,100,13075,6138,215,313,6666
subtest27of10,pubtest26of10,100,13075,6138,464,104,6706
subtest27of10,pubtest27of10,100,13083,5444,173,43,5660
subtest28of10,pubtest27of10,100,13083,5444,194,68,5706
subtest23of10,pubtest27of10,100,13083,5444,199,106,5749
subtest29of10,pubtest27of10,100,13083,5444,220,124,5788
subtest24of10,pubtest27of10,100,13083,5444,220,164,5828
subtest25of10,pubtest27of10,100,13083,5444,229,195,5868
subtest22of10,pubtest27of10,100,13083,5444,230,234,5908
subtest210of10,pubtest27of10,100,13083,5444,246,258,5948
subtest21of10,pubtest27of10,100,13083,5444,251,294,5989
subtest26of10,pubtest27of10,100,13083,5444,522,63,6029
subtest27of10,pubtest28of10,100,13085,5343,57,45,5445
subtest21of10,pubtest28of10,100,13085,5343,189,43,5575
subtest28of10,pubtest28of10,100,13085,5343,196,78,5617
subtest29of10,pubtest28of10,100,13085,5343,192,117,5652
subtest23of10,pubtest28of10,100,13085,5343,201,152,5696
subtest210of10,pubtest28of10,100,13085,5343,201,191,5735
subtest22of10,pubtest28of10,100,13085,5343,205,228,5776
subtest26of10,pubtest28of10,100,13085,5343,212,261,5816
subtest24of10,pubtest28of10,100,13085,5343,445,71,5859
subtest25of10,pubtest28of10,100,13085,5343,476,82,5901
subtest23of10,pubtest29of10,100,13081,5310,189,48,5547
subtest29of10,pubtest29of10,100,13081,5310,190,87,5587
subtest210of10,pubtest29of10,100,13081,5310,195,122,5627
subtest28of10,pubtest29of10,100,13081,5310,205,152,5667
subtest24of10,pubtest29of10,100,13081,5310,205,192,5707
subtest25of10,pubtest29of10,100,13081,5310,220,217,5747
subtest22of10,pubtest29of10,100,13081,5310,226,252,5788
subtest27of10,pubtest29of10,100,13081,5310,232,285,5827
subtest26of10,pubtest29of10,100,13081,5310,233,371,5914
subtest21of10,pubtest29of10,100,13081,5310,473,172,5955
subtest29of10,pubtest210of10,100,13188,5238,295,46,5579
subtest210of10,pubtest210of10,100,13188,5238,305,80,5623
subtest24of10,pubtest210of10,100,13188,5238,306,114,5658
subtest21of10,pubtest210of10,100,13188,5238,300,157,5695
subtest28of10,pubtest210of10,100,13188,5238,310,196,5744
subtest27of10,pubtest210of10,100,13188,5238,308,236,5782
subtest26of10,pubtest210of10,100,13188,5238,321,267,5826
subtest23of10,pubtest210of10,100,13188,5238,323,305,5866
subtest25of10,pubtest210of10,100,13188,5238,326,342,5906
subtest22of10,pubtest210of10,100,13188,5238,343,366,5947
subtest21of10,pubtest21of10,100,13081,10225,204,44,10473
subtest26of10,pubtest21of10,100,13081,10225,206,89,10520
subtest27of10,pubtest21of10,100,13081,10225,284,49,10558
subtest24of10,pubtest21of10,100,13081,10225,285,89,10599
subtest29of10,pubtest21of10,100,13081,10225,289,124,10638
subtest25of10,pubtest21of10,100,13081,10225,295,158,10678
subtest210of10,pubtest21of10,100,13081,10225,297,196,10718
subtest28of10,pubtest21of10,100,13081,10225,351,183,10759
subtest22of10,pubtest21of10,100,13081,10225,381,191,10797
subtest23of10,pubtest21of10,100,13081,10225,386,227,10838
subtest29of10,pubtest22of10,100,13083,5290,321,43,5654
subtest28of10,pubtest22of10,100,13083,5290,352,55,5697
subtest24of10,pubtest22of10,100,13083,5290,349,99,5738
subtest27of10,pubtest22of10,100,13083,5290,353,142,5785
subtest26of10,pubtest22of10,100,13083,5290,361,179,5830
subtest22of10,pubtest22of10,100,13083,5290,450,131,5871
subtest21of10,pubtest22of10,100,13083,5290,455,169,5914
subtest25of10,pubtest22of10,100,13083,5290,472,194,5956
subtest23of10,pubtest22of10,100,13083,5290,497,210,5997
subtest210of10,pubtest22of10,100,13083,5290,679,68,6037
subtest23of10,pubtest23of10,100,13082,6082,284,43,6409
subtest24of10,pubtest23of10,100,13082,6082,286,85,6453
subtest29of10,pubtest23of10,100,13082,6082,296,114,6492
subtest27of10,pubtest23of10,100,13082,6082,310,141,6533
subtest26of10,pubtest23of10,100,13082,6082,314,177,6573
subtest21of10,pubtest23of10,100,13082,6082,320,211,6613
subtest25of10,pubtest23of10,100,13082,6082,334,238,6654
subtest22of10,pubtest23of10,100,13082,6082,337,279,6698
subtest210of10,pubtest23of10,100,13082,6082,336,323,6741
subtest28of10,pubtest23of10,100,13082,6082,675,44,6801
subtest23of10,pubtest24of10,100,13085,5500,187,45,5732
subtest24of10,pubtest24of10,100,13085,5500,236,44,5780
subtest28of10,pubtest24of10,100,13085,5500,241,83,5824
subtest22of10,pubtest24of10,100,13085,5500,258,109,5867
subtest25of10,pubtest24of10,100,13085,5500,263,145,5908
subtest21of10,pubtest24of10,100,13085,5500,282,167,5949
subtest29of10,pubtest24of10,100,13085,5500,302,190,5992
subtest210of10,pubtest24of10,100,13085,5500,301,230,6031
subtest27of10,pubtest24of10,100,13085,5500,310,262,6072
subtest26of10,pubtest24of10,100,13085,5500,365,247,6112
subtest28of10,pubtest25of10,100,13082,5578,120,45,5743
subtest22of10,pubtest25of10,100,13082,5578,168,43,5789
subtest21of10,pubtest25of10,100,13082,5578,196,64,5838
subtest27of10,pubtest25of10,100,13082,5578,207,93,5878
subtest23of10,pubtest25of10,100,13082,5578,223,117,5918
subtest29of10,pubtest25of10,100,13082,5578,223,155,5956
subtest25of10,pubtest25of10,100,13082,5578,231,194,6003
subtest24of10,pubtest25of10,100,13082,5578,234,231,6043
subtest26of10,pubtest25of10,100,13082,5578,396,109,6083
subtest210of10,pubtest25of10,100,13082,5578,461,83,6122
subtest21of10,pubtest26of10,100,13075,6096,150,44,6290
subtest29of10,pubtest26of10,100,13075,6096,202,44,6342
subtest23of10,pubtest26of10,100,13075,6096,209,81,6386
subtest26of10,pubtest26of10,100,13075,6096,213,117,6426
subtest210of10,pubtest26of10,100,13075,6096,216,153,6465
subtest24of10,pubtest26of10,100,13075,6096,223,187,6506
subtest27of10,pubtest26of10,100,13075,6096,223,227,6546
subtest28of10,pubtest26of10,100,13075,6096,219,270,6585
subtest25of10,pubtest26of10,100,13075,6096,240,295,6631
subtest22of10,pubtest26of10,100,13075,6096,435,139,6670
subtest28of10,pubtest27of10,100,13083,6274,199,46,6519
subtest27of10,pubtest27of10,100,13083,6274,212,77,6563
subtest23of10,pubtest27of10,100,13083,6274,219,109,6602
subtest24of10,pubtest27of10,100,13083,6274,219,149,6642
subtest210of10,pubtest27of10,100,13083,6274,239,172,6685
subtest25of10,pubtest27of10,100,13083,6274,246,202,6722
subtest26of10,pubtest27of10,100,13083,6274,253,242,6769
subtest22of10,pubtest27of10,100,13083,6274,254,282,6810
subtest21of10,pubtest27of10,100,13083,6274,267,309,6850
subtest29of10,pubtest27of10,100,13083,6274,293,323,6890
subtest27of10,pubtest28of10,100,13085,6023,265,48,6336
subtest21of10,pubtest28of10,100,13085,6023,266,91,6380
subtest28of10,pubtest28of10,100,13085,6023,272,126,6421
subtest29of10,pubtest28of10,100,13085,6023,278,164,6465
subtest210of10,pubtest28of10,100,13085,6023,281,201,6505
subtest25of10,pubtest28of10,100,13085,6023,286,236,6545
subtest22of10,pubtest28of10,100,13085,6023,297,266,6586
subtest23of10,pubtest28of10,100,13085,6023,340,260,6623
subtest26of10,pubtest28of10,100,13085,6023,345,300,6668
subtest24of10,pubtest28of10,100,13085,6023,572,115,6710
subtest29of10,pubtest29of10,100,13081,5627,214,48,5889
subtest210of10,pubtest29of10,100,13081,5627,219,86,5932
subtest22of10,pubtest29of10,100,13081,5627,220,129,5976
subtest28of10,pubtest29of10,100,13081,5627,224,164,6015
subtest23of10,pubtest29of10,100,13081,5627,212,202,6041
subtest25of10,pubtest29of10,100,13081,5627,216,242,6085
subtest26of10,pubtest29of10,100,13081,5627,261,249,6137
subtest24of10,pubtest29of10,100,13081,5627,260,291,6178
subtest27of10,pubtest29of10,100,13081,5627,442,152,6221
subtest21of10,pubtest29of10,100,13081,5627,511,122,6260
subtest29of10,pubtest210of10,100,13188,5188,244,47,5479
subtest210of10,pubtest210of10,100,13188,5188,249,83,5520
subtest27of10,pubtest210of10,100,13188,5188,254,116,5558
subtest22of10,pubtest210of10,100,13188,5188,257,155,5600
subtest28of10,pubtest210of10,100,13188,5188,260,192,5640
subtest24of10,pubtest210of10,100,13188,5188,261,231,5680
subtest26of10,pubtest210of10,100,13188,5188,265,267,5720
subtest23of10,pubtest210of10,100,13188,5188,267,305,5760
subtest25of10,pubtest210of10,100,13188,5188,270,338,5796
subtest21of10,pubtest210of10,100,13188,5188,285,367,5840
subtest26of10,pubtest21of10,100,13081,10949,247,58,11254
subtest29of10,pubtest21of10,100,13081,10949,257,93,11299
subtest25of10,pubtest21of10,100,13081,10949,257,132,11338
subtest21of10,pubtest21of10,100,13081,10949,260,172,11381
subtest24of10,pubtest21of10,100,13081,10949,252,212,11413
subtest210of10,pubtest21of10,100,13081,10949,262,251,11462
subtest27of10,pubtest21of10,100,13081,10949,252,294,11495
subtest28of10,pubtest21of10,100,13081,10949,270,327,11546
subtest23of10,pubtest21of10,100,13081,10949,276,361,11586
subtest22of10,pubtest21of10,100,13081,10949,279,402,11630
subtest29of10,pubtest22of10,100,13083,5557,231,43,5831
subtest27of10,pubtest22of10,100,13083,5557,272,46,5875
subtest210of10,pubtest22of10,100,13083,5557,292,65,5914
subtest23of10,pubtest22of10,100,13083,5557,294,103,5954
subtest21of10,pubtest22of10,100,13083,5557,309,129,5995
subtest25of10,pubtest22of10,100,13083,5557,313,165,6035
subtest28of10,pubtest22of10,100,13083,5557,584,43,6184
subtest26of10,pubtest22of10,100,13083,5557,591,75,6223
subtest22of10,pubtest22of10,100,13083,5557,603,102,6262
subtest24of10,pubtest22of10,100,13083,5557,604,140,6301
subtest23of10,pubtest23of10,100,13082,5994,122,42,6158
subtest29of10,pubtest23of10,100,13082,5994,174,44,6212
subtest27of10,pubtest23of10,100,13082,5994,177,83,6254
subtest28of10,pubtest23of10,100,13082,5994,174,124,6292
subtest25of10,pubtest23of10,100,13082,5994,182,162,6338
subtest210of10,pubtest23of10,100,13082,5994,216,168,6378
subtest24of10,pubtest23of10,100,13082,5994,224,198,6416
subtest26of10,pubtest23of10,100,13082,5994,226,237,6457
subtest22of10,pubtest23of10,100,13082,5994,232,272,6498
subtest21of10,pubtest23of10,100,13082,5994,235,309,6538
subtest23of10,pubtest24of10,100,13085,5927,250,44,6221
subtest25of10,pubtest24of10,100,13085,5927,336,51,6314
subtest22of10,pubtest24of10,100,13085,5927,337,89,6353
subtest29of10,pubtest24of10,100,13085,5927,342,122,6391
subtest210of10,pubtest24of10,100,13085,5927,345,161,6433
subtest21of10,pubtest24of10,100,13085,5927,341,200,6468
subtest26of10,pubtest24of10,100,13085,5927,371,215,6513
subtest28of10,pubtest24of10,100,13085,5927,611,43,6581
subtest27of10,pubtest24of10,100,13085,5927,676,43,6646
subtest24of10,pubtest24of10,100,13085,5927,1078,44,7049
subtest28of10,pubtest25of10,100,13082,5774,169,42,5985
subtest210of10,pubtest25of10,100,13082,5774,253,44,6071
subtest21of10,pubtest25of10,100,13082,5774,259,83,6116
subtest22of10,pubtest25of10,100,13082,5774,269,114,6157
subtest25of10,pubtest25of10,100,13082,5774,277,149,6200
subtest23of10,pubtest25of10,100,13082,5774,281,186,6241
subtest26of10,pubtest25of10,100,13082,5774,289,217,6280
subtest24of10,pubtest25of10,100,13082,5774,294,253,6321
subtest29of10,pubtest25of10,100,13082,5774,382,205,6361
subtest27of10,pubtest25of10,100,13082,5774,459,168,6401
subtest22of10,pubtest26of10,100,13075,5846,184,45,6075
subtest21of10,pubtest26of10,100,13075,5846,187,84,6117
subtest29of10,pubtest26of10,100,13075,5846,238,77,6161
subtest23of10,pubtest26of10,100,13075,5846,242,113,6201
subtest210of10,pubtest26of10,100,13075,5846,259,140,6245
subtest25of10,pubtest26of10,100,13075,5846,280,159,6285
subtest26of10,pubtest26of10,100,13075,5846,330,153,6329
subtest24of10,pubtest26of10,100,13075,5846,340,183,6369
subtest28of10,pubtest26of10,100,13075,5846,343,220,6409
subtest27of10,pubtest26of10,100,13075,5846,510,93,6449
subtest24of10,pubtest27of10,100,13083,5402,169,43,5614
subtest29of10,pubtest27of10,100,13083,5402,176,80,5658
subtest210of10,pubtest27of10,100,13083,5402,187,112,5701
subtest25of10,pubtest27of10,100,13083,5402,195,145,5742
subtest28of10,pubtest27of10,100,13083,5402,196,183,5781
subtest26of10,pubtest27of10,100,13083,5402,206,213,5821
subtest21of10,pubtest27of10,100,13083,5402,207,256,5865
subtest27of10,pubtest27of10,100,13083,5402,232,269,5903
subtest22of10,pubtest27of10,100,13083,5402,254,293,5949
subtest23of10,pubtest27of10,100,13083,5402,420,167,5989
subtest21of10,pubtest28of10,100,13085,5769,152,43,5964
subtest29of10,pubtest28of10,100,13085,5769,214,46,6029
subtest210of10,pubtest28of10,100,13085,5769,239,63,6071
subtest26of10,pubtest28of10,100,13085,5769,249,93,6111
subtest25of10,pubtest28of10,100,13085,5769,252,127,6148
subtest23of10,pubtest28of10,100,13085,5769,250,166,6185
subtest27of10,pubtest28of10,100,13085,5769,257,205,6231
subtest28of10,pubtest28of10,100,13085,5769,276,226,6271
subtest22of10,pubtest28of10,100,13085,5769,275,267,6311
subtest24of10,pubtest28of10,100,13085,5769,535,47,6351
subtest29of10,pubtest29of10,100,13081,5819,242,43,6104
subtest25of10,pubtest29of10,100,13081,5819,263,66,6148
subtest210of10,pubtest29of10,100,13081,5819,265,145,6229
subtest22of10,pubtest29of10,100,13081,5819,271,182,6272
subtest21of10,pubtest29of10,100,13081,5819,276,218,6313
subtest28of10,pubtest29of10,100,13081,5819,273,260,6352
subtest24of10,pubtest29of10,100,13081,5819,278,299,6396
subtest27of10,pubtest29of10,100,13081,5819,297,324,6440
subtest26of10,pubtest29of10,100,13081,5819,484,177,6480
subtest23of10,pubtest29of10,100,13081,5819,496,205,6520
subtest29of10,pubtest210of10,100,13188,5629,177,45,5851
subtest24of10,pubtest210of10,100,13188,5629,214,50,5893
subtest21of10,pubtest210of10,100,13188,5629,287,44,5960
subtest210of10,pubtest210of10,100,13188,5629,340,43,6012
subtest27of10,pubtest210of10,100,13188,5629,346,77,6052
subtest28of10,pubtest210of10,100,13188,5629,349,118,6096
subtest22of10,pubtest210of10,100,13188,5629,357,150,6136
subtest23of10,pubtest210of10,100,13188,5629,622,42,6293
subtest25of10,pubtest210of10,100,13188,5629,701,42,6372
subtest26of10,pubtest210of10,100,13188,5629,861,43,6533
subtest29of10,pubtest21of10,100,13081,11252,301,46,11599
subtest24of10,pubtest21of10,100,13081,11252,301,90,11643
subtest21of10,pubtest21of10,100,13081,11252,312,120,11684
subtest28of10,pubtest21of10,100,13081,11252,313,162,11727
subtest210of10,pubtest21of10,100,13081,11252,312,197,11761
subtest23of10,pubtest21of10,100,13081,11252,320,235,11807
subtest26of10,pubtest21of10,100,13081,11252,323,272,11847
subtest25of10,pubtest21of10,100,13081,11252,327,308,11887
subtest27of10,pubtest21of10,100,13081,11252,605,70,11927
subtest22of10,pubtest21of10,100,13081,11252,756,44,12052
subtest29of10,pubtest22of10,100,13083,5739,111,45,5895
subtest27of10,pubtest22of10,100,13083,5739,188,45,5972
subtest28of10,pubtest22of10,100,13083,5739,190,87,6016
subtest26of10,pubtest22of10,100,13083,5739,198,120,6057
subtest210of10,pubtest22of10,100,13083,5739,200,158,6097
subtest23of10,pubtest22of10,100,13083,5739,202,197,6138
subtest25of10,pubtest22of10,100,13083,5739,205,235,6179
subtest22of10,pubtest22of10,100,13083,5739,215,266,6220
subtest24of10,pubtest22of10,100,13083,5739,478,47,6264
subtest21of10,pubtest22of10,100,13083,5739,513,53,6305
subtest28of10,pubtest23of10,100,13082,5273,168,45,5486
subtest23of10,pubtest23of10,100,13082,5273,187,69,5529
subtest24of10,pubtest23of10,100,13082,5273,190,106,5569
subtest29of10,pubtest23of10,100,13082,5273,192,141,5606
subtest27of10,pubtest23of10,100,13082,5273,195,179,5647
subtest25of10,pubtest23of10,100,13082,5273,201,217,5691
subtest22of10,pubtest23of10,100,13082,5273,234,225,5732
subtest21of10,pubtest23of10,100,13082,5273,238,262,5773
subtest26of10,pubtest23of10,100,13082,5273,241,299,5813
subtest210of10,pubtest23of10,100,13082,5273,249,332,5854
subtest23of10,pubtest24of10,100,13085,5849,211,45,6105
subtest28of10,pubtest24of10,100,13085,5849,233,63,6145
subtest22of10,pubtest24of10,100,13085,5849,265,75,6189
subtest25of10,pubtest24of10,100,13085,5849,270,110,6229
subtest210of10,pubtest24of10,100,13085,5849,278,142,6269
subtest29of10,pubtest24of10,100,13085,5849,279,181,6309
subtest27of10,pubtest24of10,100,13085,5849,285,215,6349
subtest21of10,pubtest24of10,100,13085,5849,325,216,6390
subtest26of10,pubtest24of10,100,13085,5849,351,230,6430
subtest24of10,pubtest24of10,100,13085,5849,511,109,6469
subtest28of10,pubtest25of10,100,13082,5263,250,43,5556
subtest210of10,pubtest25of10,100,13082,5263,265,71,5599
subtest22of10,pubtest25of10,100,13082,5263,606,86,5955
subtest21of10,pubtest25of10,100,13082,5263,269,105,5637
subtest26of10,pubtest25of10,100,13082,5263,273,143,5679
subtest23of10,pubtest25of10,100,13082,5263,283,173,5719
subtest25of10,pubtest25of10,100,13082,5263,299,197,5759
subtest24of10,pubtest25of10,100,13082,5263,300,236,5799
subtest27of10,pubtest25of10,100,13082,5263,566,43,5872
subtest29of10,pubtest25of10,100,13082,5263,583,68,5914
subtest21of10,pubtest26of10,100,13075,5766,241,42,6049
subtest23of10,pubtest26of10,100,13075,5766,250,76,6092
subtest26of10,pubtest26of10,100,13075,5766,254,115,6135
subtest210of10,pubtest26of10,100,13075,5766,255,153,6174
subtest29of10,pubtest26of10,100,13075,5766,250,192,6208
subtest24of10,pubtest26of10,100,13075,5766,261,234,6261
subtest25of10,pubtest26of10,100,13075,5766,263,271,6300
subtest27of10,pubtest26of10,100,13075,5766,265,309,6340
subtest22of10,pubtest26of10,100,13075,5766,311,303,6380
subtest28of10,pubtest26of10,100,13075,5766,331,324,6421
subtest27of10,pubtest27of10,100,13083,5296,216,46,5558
subtest29of10,pubtest27of10,100,13083,5296,343,42,5681
subtest23of10,pubtest27of10,100,13083,5296,396,45,5737
subtest24of10,pubtest27of10,100,13083,5296,401,80,5777
subtest210of10,pubtest27of10,100,13083,5296,411,112,5819
subtest25of10,pubtest27of10,100,13083,5296,413,149,5858
subtest22of10,pubtest27of10,100,13083,5296,416,189,5901
subtest21of10,pubtest27of10,100,13083,5296,462,184,5942
subtest28of10,pubtest27of10,100,13083,5296,584,102,5982
subtest26of10,pubtest27of10,100,13083,5296,865,44,6205
subtest27of10,pubtest28of10,100,13085,5205,309,58,5572
subtest28of10,pubtest28of10,100,13085,5205,315,101,5621
subtest21of10,pubtest28of10,100,13085,5205,331,129,5665
subtest23of10,pubtest28of10,100,13085,5205,347,153,5705
subtest210of10,pubtest28of10,100,13085,5205,403,137,5745
subtest24of10,pubtest28of10,100,13085,5205,408,169,5782
subtest29of10,pubtest28of10,100,13085,5205,414,206,5825
subtest25of10,pubtest28of10,100,13085,5205,405,246,5856
subtest22of10,pubtest28of10,100,13085,5205,415,285,5905
subtest26of10,pubtest28of10,100,13085,5205,823,45,6073
subtest23of10,pubtest29of10,100,13081,5565,164,45,5774
subtest29of10,pubtest29of10,100,13081,5565,245,45,5855
subtest25of10,pubtest29of10,100,13081,5565,253,80,5898
subtest210of10,pubtest29of10,100,13081,5565,254,122,5941
subtest28of10,pubtest29of10,100,13081,5565,272,145,5982
subtest21of10,pubtest29of10,100,13081,5565,273,184,6022
subtest27of10,pubtest29of10,100,13081,5565,281,217,6063
subtest22of10,pubtest29of10,100,13081,5565,276,260,6101
subtest26of10,pubtest29of10,100,13081,5565,290,290,6145
subtest24of10,pubtest29of10,100,13081,5565,442,179,6186
subtest29of10,pubtest210of10,100,13188,5554,218,47,5819
subtest21of10,pubtest210of10,100,13188,5554,225,83,5862
subtest27of10,pubtest210of10,100,13188,5554,233,116,5903
subtest25of10,pubtest210of10,100,13188,5554,248,145,5947
subtest210of10,pubtest210of10,100,13188,5554,253,179,5986
subtest26of10,pubtest210of10,100,13188,5554,263,207,6024
subtest24of10,pubtest210of10,100,13188,5554,273,239,6066
subtest23of10,pubtest210of10,100,13188,5554,274,278,6106
subtest28of10,pubtest210of10,100,13188,5554,278,314,6146
subtest22of10,pubtest210of10,100,13188,5554,542,94,6190
subtest26of10,pubtest21of10,100,13081,10674,113,46,10833
subtest27of10,pubtest21of10,100,13081,10674,143,59,10876
subtest24of10,pubtest21of10,100,13081,10674,147,102,10923
subtest29of10,pubtest21of10,100,13081,10674,151,138,10963
subtest25of10,pubtest21of10,100,13081,10674,157,172,11003
subtest21of10,pubtest21of10,100,13081,10674,161,208,11043
subtest28of10,pubtest21of10,100,13081,10674,187,220,11081
subtest210of10,pubtest21of10,100,13081,10674,200,249,11123
subtest22of10,pubtest21of10,100,13081,10674,206,283,11163
subtest23of10,pubtest21of10,100,13081,10674,208,321,11203
subtest29of10,pubtest22of10,100,13083,5444,1121,44,6609
subtest28of10,pubtest22of10,100,13083,5444,1190,44,6678
subtest27of10,pubtest22of10,100,13083,5444,1190,87,6721
subtest210of10,pubtest22of10,100,13083,5444,1207,110,6761
subtest25of10,pubtest22of10,100,13083,5444,1212,145,6801
subtest22of10,pubtest22of10,100,13083,5444,1213,183,6840
subtest23of10,pubtest22of10,100,13083,5444,1210,226,6880
subtest21of10,pubtest22of10,100,13083,5444,1230,251,6925
subtest26of10,pubtest22of10,100,13083,5444,1226,290,6960
subtest24of10,pubtest22of10,100,13083,5444,1439,123,7006
subtest23of10,pubtest23of10,100,13082,5837,139,49,6025
subtest28of10,pubtest23of10,100,13082,5837,178,52,6067
subtest25of10,pubtest23of10,100,13082,5837,183,93,6113
subtest24of10,pubtest23of10,100,13082,5837,184,132,6153
subtest27of10,pubtest23of10,100,13082,5837,188,168,6193
subtest29of10,pubtest23of10,100,13082,5837,178,207,6222
subtest21of10,pubtest23of10,100,13082,5837,208,229,6274
subtest210of10,pubtest23of10,100,13082,5837,210,267,6314
subtest26of10,pubtest23of10,100,13082,5837,215,301,6353
subtest22of10,pubtest23of10,100,13082,5837,215,341,6393
subtest23of10,pubtest24of10,100,13085,5484,167,49,5700
subtest24of10,pubtest24of10,100,13085,5484,196,64,5744
subtest28of10,pubtest24of10,100,13085,5484,199,100,5783
subtest22of10,pubtest24of10,100,13085,5484,208,136,5828
subtest21of10,pubtest24of10,100,13085,5484,210,173,5867
subtest25of10,pubtest24of10,100,13085,5484,211,213,5908
subtest27of10,pubtest24of10,100,13085,5484,239,224,5947
subtest26of10,pubtest24of10,100,13085,5484,239,264,5987
subtest29of10,pubtest24of10,100,13085,5484,317,226,6027
subtest210of10,pubtest24of10,100,13085,5484,317,266,6067
subtest28of10,pubtest25of10,100,13082,5336,122,45,5503
subtest21of10,pubtest25of10,100,13082,5336,204,45,5585
subtest26of10,pubtest25of10,100,13082,5336,203,88,5627
subtest210of10,pubtest25of10,100,13082,5336,201,139,5676
subtest27of10,pubtest25of10,100,13082,5336,210,169,5715
subtest23of10,pubtest25of10,100,13082,5336,223,196,5755
subtest24of10,pubtest25of10,100,13082,5336,240,219,5795
subtest29of10,pubtest25of10,100,13082,5336,240,259,5835
subtest22of10,pubtest25of10,100,13082,5336,254,285,5875
subtest25of10,pubtest25of10,100,13082,5336,270,309,5915
subtest210of10,pubtest26of10,100,13075,5804,188,45,6037
subtest21of10,pubtest26of10,100,13075,5804,219,57,6080
subtest29of10,pubtest26of10,100,13075,5804,230,92,6126
subtest23of10,pubtest26of10,100,13075,5804,233,129,6166
subtest26of10,pubtest26of10,100,13075,5804,237,169,6210
subtest24of10,pubtest26of10,100,13075,5804,243,203,6250
subtest22of10,pubtest26of10,100,13075,5804,271,217,6292
subtest28of10,pubtest26of10,100,13075,5804,272,251,6327
subtest27of10,pubtest26of10,100,13075,5804,276,294,6374
subtest25of10,pubtest26of10,100,13075,5804,280,328,6412
subtest27of10,pubtest27of10,100,13083,6159,263,54,6476
subtest29of10,pubtest27of10,100,13083,6159,271,89,6519
subtest24of10,pubtest27of10,100,13083,6159,272,128,6559
subtest28of10,pubtest27of10,100,13083,6159,274,166,6599
subtest23of10,pubtest27of10,100,13083,6159,269,205,6633
subtest22of10,pubtest27of10,100,13083,6159,276,248,6683
subtest26of10,pubtest27of10,100,13083,6159,281,283,6723
subtest210of10,pubtest27of10,100,13083,6159,304,300,6763
subtest25of10,pubtest27of10,100,13083,6159,433,211,6803
subtest21of10,pubtest27of10,100,13083,6159,514,170,6843
subtest27of10,pubtest28of10,100,13085,6053,256,45,6354
subtest21of10,pubtest28of10,100,13085,6053,258,76,6387
subtest28of10,pubtest28of10,100,13085,6053,265,114,6432
subtest22of10,pubtest28of10,100,13085,6053,271,156,6480
subtest26of10,pubtest28of10,100,13085,6053,265,199,6517
subtest29of10,pubtest28of10,100,13085,6053,261,239,6553
subtest210of10,pubtest28of10,100,13085,6053,277,271,6601
subtest24of10,pubtest28of10,100,13085,6053,283,305,6641
subtest25of10,pubtest28of10,100,13085,6053,288,341,6682
subtest23of10,pubtest28of10,100,13085,6053,297,371,6721
subtest22of10,pubtest29of10,100,13081,6085,228,43,6356
subtest28of10,pubtest29of10,100,13081,6085,236,80,6401
subtest21of10,pubtest29of10,100,13081,6085,242,115,6442
subtest27of10,pubtest29of10,100,13081,6085,246,151,6482
subtest24of10,pubtest29of10,100,13081,6085,242,190,6517
subtest26of10,pubtest29of10,100,13081,6085,246,228,6559
subtest210of10,pubtest29of10,100,13081,6085,250,273,6608
subtest29of10,pubtest29of10,100,13081,6085,445,118,6648
subtest25of10,pubtest29of10,100,13081,6085,473,131,6689
subtest23of10,pubtest29of10,100,13081,6085,522,123,6730
subtest21of10,pubtest210of10,100,13188,5419,199,42,5660
subtest210of10,pubtest210of10,100,13188,5419,205,74,5698
subtest27of10,pubtest210of10,100,13188,5419,218,107,5744
subtest24of10,pubtest210of10,100,13188,5419,246,122,5787
subtest22of10,pubtest210of10,100,13188,5419,250,156,5825
subtest23of10,pubtest210of10,100,13188,5419,281,166,5866
subtest29of10,pubtest210of10,100,13188,5419,285,204,5908
subtest26of10,pubtest210of10,100,13188,5419,296,236,5951
subtest25of10,pubtest210of10,100,13188,5419,303,270,5992
subtest28of10,pubtest210of10,100,13188,5419,493,120,6032
subtest26of10,pubtest21of10,100,13081,11025,207,48,11280
subtest24of10,pubtest21of10,100,13081,11025,211,90,11326
subtest27of10,pubtest21of10,100,13081,11025,214,127,11366
subtest29of10,pubtest21of10,100,13081,11025,217,164,11406
subtest25of10,pubtest21of10,100,13081,11025,234,191,11450
subtest21of10,pubtest21of10,100,13081,11025,236,229,11490
subtest210of10,pubtest21of10,100,13081,11025,239,266,11530
subtest28of10,pubtest21of10,100,13081,11025,245,298,11568
subtest22of10,pubtest21of10,100,13081,11025,245,336,11606
subtest23of10,pubtest21of10,100,13081,11025,250,375,11650
subtest29of10,pubtest22of10,100,13083,5368,134,45,5547
subtest28of10,pubtest22of10,100,13083,5368,157,63,5588
subtest24of10,pubtest22of10,100,13083,5368,212,55,5635
subtest210of10,pubtest22of10,100,13083,5368,245,65,5678
subtest23of10,pubtest22of10,100,13083,5368,264,87,5719
subtest25of10,pubtest22of10,100,13083,5368,266,125,5759
subtest21of10,pubtest22of10,100,13083,5368,274,157,5799
subtest22of10,pubtest22of10,100,13083,5368,275,197,5840
subtest27of10,pubtest22of10,100,13083,5368,448,65,5881
subtest26of10,pubtest22of10,100,13083,5368,512,41,5921
subtest29of10,pubtest23of10,100,13082,6979,379,58,7416
subtest23of10,pubtest23of10,100,13082,6979,379,101,7459
subtest25of10,pubtest23of10,100,13082,6979,384,137,7500
subtest28of10,pubtest23of10,100,13082,6979,388,176,7543
subtest27of10,pubtest23of10,100,13082,6979,389,215,7583
subtest24of10,pubtest23of10,100,13082,6979,392,252,7623
subtest26of10,pubtest23of10,100,13082,6979,406,277,7662
subtest210of10,pubtest23of10,100,13082,6979,503,221,7703
subtest21of10,pubtest23of10,100,13082,6979,625,140,7744
subtest22of10,pubtest23of10,100,13082,6979,701,104,7784
subtest23of10,pubtest24of10,100,13085,7919,198,45,8162
subtest24of10,pubtest24of10,100,13085,7919,263,45,8227
subtest28of10,pubtest24of10,100,13085,7919,287,68,8274
subtest25of10,pubtest24of10,100,13085,7919,287,108,8314
subtest21of10,pubtest24of10,100,13085,7919,307,128,8354
subtest210of10,pubtest24of10,100,13085,7919,312,163,8394
subtest29of10,pubtest24of10,100,13085,7919,312,203,8434
subtest27of10,pubtest24of10,100,13085,7919,615,45,8579
subtest26of10,pubtest24of10,100,13085,7919,649,52,8620
subtest22of10,pubtest24of10,100,13085,7919,701,42,8662
subtest28of10,pubtest25of10,100,13082,7397,183,45,7625
subtest210of10,pubtest25of10,100,13082,7397,240,45,7682
subtest21of10,pubtest25of10,100,13082,7397,242,86,7725
subtest25of10,pubtest25of10,100,13082,7397,265,108,7770
subtest26of10,pubtest25of10,100,13082,7397,274,138,7809
subtest22of10,pubtest25of10,100,13082,7397,283,170,7850
subtest27of10,pubtest25of10,100,13082,7397,280,209,7886
subtest24of10,pubtest25of10,100,13082,7397,311,222,7930
subtest23of10,pubtest25of10,100,13082,7397,546,42,7985
subtest29of10,pubtest25of10,100,13082,7397,566,63,8026
subtest21of10,pubtest26of10,100,13075,6093,156,42,6291
subtest22of10,pubtest26of10,100,13075,6093,201,47,6341
subtest210of10,pubtest26of10,100,13075,6093,238,50,6381
subtest26of10,pubtest26of10,100,13075,6093,238,95,6426
subtest28of10,pubtest26of10,100,13075,6093,241,130,6464
subtest27of10,pubtest26of10,100,13075,6093,245,168,6506
subtest25of10,pubtest26of10,100,13075,6093,253,200,6546
subtest24of10,pubtest26of10,100,13075,6093,250,238,6581
subtest29of10,pubtest26of10,100,13075,6093,257,276,6626
subtest23of10,pubtest26of10,100,13075,6093,263,310,6666
subtest28of10,pubtest27of10,100,13083,5224,172,45,5441
subtest23of10,pubtest27of10,100,13083,5224,225,42,5491
subtest29of10,pubtest27of10,100,13083,5224,232,78,5534
subtest210of10,pubtest27of10,100,13083,5224,251,101,5576
subtest25of10,pubtest27of10,100,13083,5224,252,139,5615
subtest22of10,pubtest27of10,100,13083,5224,257,181,5662
subtest26of10,pubtest27of10,100,13083,5224,262,216,5702
subtest21of10,pubtest27of10,100,13083,5224,262,260,5746
subtest24of10,pubtest27of10,100,13083,5224,471,91,5786
subtest27of10,pubtest27of10,100,13083,5224,536,65,5825
subtest27of10,pubtest28of10,100,13085,5376,93,44,5513
subtest28of10,pubtest28of10,100,13085,5376,203,43,5622
subtest29of10,pubtest28of10,100,13085,5376,227,67,5670
subtest210of10,pubtest28of10,100,13085,5376,234,103,5713
subtest23of10,pubtest28of10,100,13085,5376,237,138,5751
subtest22of10,pubtest28of10,100,13085,5376,246,171,5793
subtest26of10,pubtest28of10,100,13085,5376,276,182,5834
subtest25of10,pubtest28of10,100,13085,5376,280,217,5873
subtest24of10,pubtest28of10,100,13085,5376,292,245,5913
subtest21of10,pubtest28of10,100,13085,5376,467,108,5951
subtest23of10,pubtest29of10,100,13081,5459,223,43,5725
subtest210of10,pubtest29of10,100,13081,5459,238,72,5769
subtest29of10,pubtest29of10,100,13081,5459,240,109,5808
subtest25of10,pubtest29of10,100,13081,5459,248,139,5846
subtest22of10,pubtest29of10,100,13081,5459,250,177,5886
subtest21of10,pubtest29of10,100,13081,5459,260,209,5928
subtest28of10,pubtest29of10,100,13081,5459,299,211,5969
subtest24of10,pubtest29of10,100,13081,5459,305,245,6009
subtest27of10,pubtest29of10,100,13081,5459,522,66,6047
subtest26of10,pubtest29of10,100,13081,5459,579,51,6089
subtest29of10,pubtest210of10,100,13188,5197,158,45,5400
subtest210of10,pubtest210of10,100,13188,5197,258,43,5498
subtest27of10,pubtest210of10,100,13188,5197,258,84,5539
subtest28of10,pubtest210of10,100,13188,5197,266,120,5583
subtest22of10,pubtest210of10,100,13188,5197,275,151,5623
subtest24of10,pubtest210of10,100,13188,5197,275,191,5663
subtest26of10,pubtest210of10,100,13188,5197,284,223,5704
subtest25of10,pubtest210of10,100,13188,5197,310,237,5744
subtest21of10,pubtest210of10,100,13188,5197,487,99,5783
subtest23of10,pubtest210of10,100,13188,5197,592,43,5832
subtest26of10,pubtest21of10,100,13081,10995,94,43,11132
subtest27of10,pubtest21of10,100,13081,10995,105,70,11170
subtest24of10,pubtest21of10,100,13081,10995,173,48,11216
subtest29of10,pubtest21of10,100,13081,10995,193,72,11260
subtest25of10,pubtest21of10,100,13081,10995,198,108,11301
subtest21of10,pubtest21of10,100,13081,10995,209,134,11338
subtest210of10,pubtest21of10,100,13081,10995,209,173,11377
subtest28of10,pubtest21of10,100,13081,10995,215,210,11420
subtest22of10,pubtest21of10,100,13081,10995,224,241,11460
subtest23of10,pubtest21of10,100,13081,10995,249,257,11501
subtest29of10,pubtest22of10,100,13083,5695,132,44,5871
subtest24of10,pubtest22of10,100,13083,5695,178,42,5915
subtest27of10,pubtest22of10,100,13083,5695,234,43,5972
subtest26of10,pubtest22of10,100,13083,5695,237,83,6015
subtest210of10,pubtest22of10,100,13083,5695,244,114,6053
subtest21of10,pubtest22of10,100,13083,5695,249,155,6099
subtest22of10,pubtest22of10,100,13083,5695,251,193,6139
subtest25of10,pubtest22of10,100,13083,5695,246,231,6172
subtest23of10,pubtest22of10,100,13083,5695,258,266,6219
subtest28of10,pubtest22of10,100,13083,5695,481,87,6263
subtest23of10,pubtest23of10,100,13082,5904,192,43,6139
subtest29of10,pubtest23of10,100,13082,5904,226,53,6183
subtest27of10,pubtest23of10,100,13082,5904,231,87,6222
subtest24of10,pubtest23of10,100,13082,5904,227,134,6265
subtest28of10,pubtest23of10,100,13082,5904,231,168,6303
subtest22of10,pubtest23of10,100,13082,5904,244,198,6346
subtest210of10,pubtest23of10,100,13082,5904,251,232,6387
subtest25of10,pubtest23of10,100,13082,5904,254,266,6424
subtest21of10,pubtest23of10,100,13082,5904,258,304,6466
subtest26of10,pubtest23of10,100,13082,5904,261,341,6506
subtest23of10,pubtest24of10,100,13085,5595,159,43,5797
subtest24of10,pubtest24of10,100,13085,5595,178,73,5846
subtest28of10,pubtest24of10,100,13085,5595,201,90,5886
subtest22of10,pubtest24of10,100,13085,5595,216,119,5930
subtest29of10,pubtest24of10,100,13085,5595,244,129,5968
subtest27of10,pubtest24of10,100,13085,5595,248,171,6014
subtest210of10,pubtest24of10,100,13085,5595,243,210,6048
subtest25of10,pubtest24of10,100,13085,5595,268,231,6094
subtest21of10,pubtest24of10,100,13085,5595,272,267,6134
subtest26of10,pubtest24of10,100,13085,5595,296,281,6172
subtest210of10,pubtest25of10,100,13082,5337,278,63,5678
subtest21of10,pubtest25of10,100,13082,5337,282,101,5720
subtest22of10,pubtest25of10,100,13082,5337,294,130,5761
subtest25of10,pubtest25of10,100,13082,5337,296,164,5797
subtest24of10,pubtest25of10,100,13082,5337,305,198,5840
subtest23of10,pubtest25of10,100,13082,5337,317,226,5880
subtest29of10,pubtest25of10,100,13082,5337,318,263,5918
subtest27of10,pubtest25of10,100,13082,5337,320,303,5960
subtest28of10,pubtest25of10,100,13082,5337,556,107,6000
subtest26of10,pubtest25of10,100,13082,5337,575,126,6038
subtest21of10,pubtest26of10,100,13075,5311,253,54,5618
subtest22of10,pubtest26of10,100,13075,5311,253,94,5658
subtest210of10,pubtest26of10,100,13075,5311,266,126,5703
subtest23of10,pubtest26of10,100,13075,5311,267,164,5742
subtest28of10,pubtest26of10,100,13075,5311,272,197,5780
subtest29of10,pubtest26of10,100,13075,5311,261,250,5822
subtest25of10,pubtest26of10,100,13075,5311,279,272,5862
subtest24of10,pubtest26of10,100,13075,5311,276,315,5902
subtest26of10,pubtest26of10,100,13075,5311,281,351,5943
subtest27of10,pubtest26of10,100,13075,5311,306,366,5983
subtest27of10,pubtest27of10,100,13083,5356,174,43,5573
subtest23of10,pubtest27of10,100,13083,5356,254,50,5660
subtest28of10,pubtest27of10,100,13083,5356,254,95,5705
subtest29of10,pubtest27of10,100,13083,5356,260,133,5749
subtest210of10,pubtest27of10,100,13083,5356,264,168,5788
subtest25of10,pubtest27of10,100,13083,5356,268,201,5825
subtest22of10,pubtest27of10,100,13083,5356,273,239,5868
subtest21of10,pubtest27of10,100,13083,5356,279,273,5908
subtest24of10,pubtest27of10,100,13083,5356,350,242,5948
subtest26of10,pubtest27of10,100,13083,5356,578,54,5988
subtest27of10,pubtest28of10,100,13085,5239,238,51,5528
subtest28of10,pubtest28of10,100,13085,5239,242,91,5572
subtest21of10,pubtest28of10,100,13085,5239,246,131,5616
subtest29of10,pubtest28of10,100,13085,5239,251,165,5655
subtest210of10,pubtest28of10,100,13085,5239,255,205,5699
subtest23of10,pubtest28of10,100,13085,5239,265,236,5740
subtest25of10,pubtest28of10,100,13085,5239,271,268,5778
subtest24of10,pubtest28of10,100,13085,5239,289,292,5820
subtest22of10,pubtest28of10,100,13085,5239,300,322,5861
subtest26of10,pubtest28of10,100,13085,5239,329,332,5900
subtest22of10,pubtest29of10,100,13081,5218,348,65,5631
subtest210of10,pubtest29of10,100,13081,5218,345,110,5673
subtest29of10,pubtest29of10,100,13081,5218,342,145,5705
subtest23of10,pubtest29of10,100,13081,5218,342,182,5742
subtest27of10,pubtest29of10,100,13081,5218,354,222,5794
subtest25of10,pubtest29of10,100,13081,5218,345,255,5818
subtest28of10,pubtest29of10,100,13081,5218,347,298,5863
subtest21of10,pubtest29of10,100,13081,5218,351,336,5905
subtest26of10,pubtest29of10,100,13081,5218,368,372,5958
subtest24of10,pubtest29of10,100,13081,5218,364,416,5998
subtest210of10,pubtest210of10,100,13188,5300,261,46,5607
subtest27of10,pubtest210of10,100,13188,5300,266,81,5647
subtest28of10,pubtest210of10,100,13188,5300,275,118,5693
subtest24of10,pubtest210of10,100,13188,5300,288,145,5733
subtest22of10,pubtest210of10,100,13188,5300,289,188,5777
subtest26of10,pubtest210of10,100,13188,5300,305,216,5821
subtest23of10,pubtest210of10,100,13188,5300,308,253,5861
subtest25of10,pubtest210of10,100,13188,5300,327,274,5901
subtest29of10,pubtest210of10,100,13188,5300,468,171,5939
subtest21of10,pubtest210of10,100,13188,5300,530,151,5981
subtest26of10,pubtest21of10,100,13081,10277,154,51,10482
subtest24of10,pubtest21of10,100,13081,10277,220,62,10559
subtest29of10,pubtest21of10,100,13081,10277,232,93,10602
subtest25of10,pubtest21of10,100,13081,10277,237,131,10645
subtest210of10,pubtest21of10,100,13081,10277,256,156,10689
subtest21of10,pubtest21of10,100,13081,10277,254,196,10727
subtest28of10,pubtest21of10,100,13081,10277,266,234,10777
subtest22of10,pubtest21of10,100,13081,10277,279,265,10821
subtest23of10,pubtest21of10,100,13081,10277,318,270,10865
subtest27of10,pubtest21of10,100,13081,10277,490,142,10909
subtest24of10,pubtest22of10,100,13083,5283,217,57,5557
subtest27of10,pubtest22of10,100,13083,5283,224,96,5603
subtest26of10,pubtest22of10,100,13083,5283,247,116,5646
subtest210of10,pubtest22of10,100,13083,5283,251,144,5678
subtest23of10,pubtest22of10,100,13083,5283,255,188,5726
subtest25of10,pubtest22of10,100,13083,5283,258,229,5770
subtest22of10,pubtest22of10,100,13083,5283,262,272,5817
subtest28of10,pubtest22of10,100,13083,5283,240,316,5839
subtest21of10,pubtest22of10,100,13083,5283,284,344,5911
subtest29of10,pubtest22of10,100,13083,5283,417,255,5955
subtest28of10,pubtest23of10,100,13082,5192,255,45,5492
subtest23of10,pubtest23of10,100,13082,5192,254,89,5535
subtest29of10,pubtest23of10,100,13082,5192,266,118,5576
subtest24of10,pubtest23of10,100,13082,5192,266,159,5617
subtest27of10,pubtest23of10,100,13082,5192,268,199,5659
subtest25of10,pubtest23of10,100,13082,5192,273,236,5701
subtest26of10,pubtest23of10,100,13082,5192,276,273,5741
subtest210of10,pubtest23of10,100,13082,5192,281,308,5781
subtest21of10,pubtest23of10,100,13082,5192,282,348,5822
subtest22of10,pubtest23of10,100,13082,5192,279,386,5857
subtest23of10,pubtest24of10,100,13085,5176,210,263,5649
subtest22of10,pubtest24of10,100,13085,5176,219,297,5692
subtest25of10,pubtest24of10,100,13085,5176,220,336,5732
subtest28of10,pubtest24of10,100,13085,5176,223,374,5773
subtest21of10,pubtest24of10,100,13085,5176,226,411,5813
subtest29of10,pubtest24of10,100,13085,5176,241,435,5852
subtest27of10,pubtest24of10,100,13085,5176,267,449,5892
subtest26of10,pubtest24of10,100,13085,5176,268,492,5936
subtest210of10,pubtest24of10,100,13085,5176,274,527,5977
subtest24of10,pubtest24of10,100,13085,5176,485,353,6014
subtest28of10,pubtest25of10,100,13082,5207,178,47,5432
subtest27of10,pubtest25of10,100,13082,5207,201,70,5478
subtest22of10,pubtest25of10,100,13082,5207,203,109,5519
subtest25of10,pubtest25of10,100,13082,5207,223,129,5559
subtest23of10,pubtest25of10,100,13082,5207,225,167,5599
subtest29of10,pubtest25of10,100,13082,5207,229,204,5640
subtest24of10,pubtest25of10,100,13082,5207,234,242,5683
subtest21of10,pubtest25of10,100,13082,5207,440,76,5723
subtest26of10,pubtest25of10,100,13082,5207,490,67,5764
subtest210of10,pubtest25of10,100,13082,5207,493,103,5803
subtest21of10,pubtest26of10,100,13075,5191,232,43,5466
subtest22of10,pubtest26of10,100,13075,5191,234,84,5509
subtest29of10,pubtest26of10,100,13075,5191,280,80,5551
subtest23of10,pubtest26of10,100,13075,5191,310,92,5593
subtest26of10,pubtest26of10,100,13075,5191,342,101,5634
subtest28of10,pubtest26of10,100,13075,5191,350,130,5671
subtest24of10,pubtest26of10,100,13075,5191,353,169,5713
subtest210of10,pubtest26of10,100,13075,5191,350,207,5748
subtest27of10,pubtest26of10,100,13075,5191,357,245,5793
subtest25of10,pubtest26of10,100,13075,5191,676,43,5910
subtest27of10,pubtest27of10,100,13083,5262,176,46,5484
subtest28of10,pubtest27of10,100,13083,5262,208,58,5528
subtest23of10,pubtest27of10,100,13083,5262,218,89,5569
subtest210of10,pubtest27of10,100,13083,5262,228,119,5609
subtest24of10,pubtest27of10,100,13083,5262,225,159,5646
subtest29of10,pubtest27of10,100,13083,5262,232,195,5689
subtest22of10,pubtest27of10,100,13083,5262,242,226,5730
subtest25of10,pubtest27of10,100,13083,5262,441,66,5769
subtest21of10,pubtest27of10,100,13083,5262,550,101,5913
subtest26of10,pubtest27of10,100,13083,5262,556,140,5958
subtest27of10,pubtest28of10,100,13085,5328,271,46,5645
subtest21of10,pubtest28of10,100,13085,5328,311,55,5694
subtest28of10,pubtest28of10,100,13085,5328,319,86,5733
subtest29of10,pubtest28of10,100,13085,5328,324,122,5774
subtest210of10,pubtest28of10,100,13085,5328,328,157,5813
subtest23of10,pubtest28of10,100,13085,5328,330,195,5853
subtest26of10,pubtest28of10,100,13085,5328,333,232,5893
subtest25of10,pubtest28of10,100,13085,5328,339,266,5933
subtest24of10,pubtest28of10,100,13085,5328,341,301,5970
subtest22of10,pubtest28of10,100,13085,5328,348,338,6014
subtest29of10,pubtest29of10,100,13081,5728,304,44,6076
subtest23of10,pubtest29of10,100,13081,5728,304,84,6116
subtest210of10,pubtest29of10,100,13081,5728,314,117,6159
subtest22of10,pubtest29of10,100,13081,5728,314,158,6200
subtest25of10,pubtest29of10,100,13081,5728,310,197,6235
subtest21of10,pubtest29of10,100,13081,5728,335,216,6279
subtest27of10,pubtest29of10,100,13081,5728,344,249,6321
subtest26of10,pubtest29of10,100,13081,5728,346,287,6361
subtest28of10,pubtest29of10,100,13081,5728,385,288,6401
subtest24of10,pubtest29of10,100,13081,5728,626,87,6441
subtest29of10,pubtest210of10,100,13188,5319,186,44,5549
subtest21of10,pubtest210of10,100,13188,5319,328,55,5702
subtest210of10,pubtest210of10,100,13188,5319,333,89,5741
subtest27of10,pubtest210of10,100,13188,5319,334,126,5779
subtest28of10,pubtest210of10,100,13188,5319,338,165,5822
subtest26of10,pubtest210of10,100,13188,5319,356,187,5862
subtest24of10,pubtest210of10,100,13188,5319,369,213,5901
subtest23of10,pubtest210of10,100,13188,5319,382,240,5941
subtest25of10,pubtest210of10,100,13188,5319,630,43,5992
subtest22of10,pubtest210of10,100,13188,5319,652,63,6034
subtest26of10,pubtest21of10,100,13081,10182,171,46,10399
subtest27of10,pubtest21of10,100,13081,10182,183,78,10443
subtest29of10,pubtest21of10,100,13081,10182,198,106,10486
subtest24of10,pubtest21of10,100,13081,10182,198,140,10520
subtest210of10,pubtest21of10,100,13081,10182,203,181,10566
subtest25of10,pubtest21of10,100,13081,10182,202,216,10600
subtest28of10,pubtest21of10,100,13081,10182,206,256,10644
subtest21of10,pubtest21of10,100,13081,10182,202,296,10680
subtest22of10,pubtest21of10,100,13081,10182,219,329,10730
subtest23of10,pubtest21of10,100,13081,10182,435,153,10770
subtest29of10,pubtest22of10,100,13083,5219,204,44,5467
subtest27of10,pubtest22of10,100,13083,5219,294,45,5558
subtest28of10,pubtest22of10,100,13083,5219,303,81,5603
subtest24of10,pubtest22of10,100,13083,5219,304,120,5643
subtest210of10,pubtest22of10,100,13083,5219,308,156,5683
subtest26of10,pubtest22of10,100,13083,5219,308,196,5723
subtest23of10,pubtest22of10,100,13083,5219,311,233,5763
subtest25of10,pubtest22of10,100,13083,5219,321,263,5803
subtest22of10,pubtest22of10,100,13083,5219,321,303,5843
subtest21of10,pubtest22of10,100,13083,5219,325,337,5881
subtest23of10,pubtest23of10,100,13082,5195,223,48,5466
subtest29of10,pubtest23of10,100,13082,5195,263,58,5516
subtest28of10,pubtest23of10,100,13082,5195,269,92,5556
subtest24of10,pubtest23of10,100,13082,5195,271,133,5599
subtest210of10,pubtest23of10,100,13082,5195,286,159,5640
subtest21of10,pubtest23of10,100,13082,5195,283,198,5676
subtest27of10,pubtest23of10,100,13082,5195,275,247,5717
subtest25of10,pubtest23of10,100,13082,5195,277,277,5749
subtest26of10,pubtest23of10,100,13082,5195,285,319,5799
subtest22of10,pubtest23of10,100,13082,5195,295,350,5840
subtest24of10,pubtest24of10,100,13085,5604,260,47,5911
subtest28of10,pubtest24of10,100,13085,5604,263,89,5956
subtest22of10,pubtest24of10,100,13085,5604,267,129,6000
subtest25of10,pubtest24of10,100,13085,5604,268,168,6040
subtest29of10,pubtest24of10,100,13085,5604,273,203,6080
subtest27of10,pubtest24of10,100,13085,5604,281,236,6121
subtest210of10,pubtest24of10,100,13085,5604,311,246,6161
subtest26of10,pubtest24of10,100,13085,5604,320,277,6201
subtest21of10,pubtest24of10,100,13085,5604,561,79,6244
subtest23of10,pubtest24of10,100,13085,5604,557,123,6284
subtest28of10,pubtest25of10,100,13082,5322,162,44,5528
subtest210of10,pubtest25of10,100,13082,5322,215,42,5579
subtest21of10,pubtest25of10,100,13082,5322,228,73,5623
subtest26of10,pubtest25of10,100,13082,5322,243,101,5666
subtest27of10,pubtest25of10,100,13082,5322,243,141,5706
subtest23of10,pubtest25of10,100,13082,5322,302,123,5747
subtest24of10,pubtest25of10,100,13082,5322,311,159,5792
subtest25of10,pubtest25of10,100,13082,5322,398,114,5834
subtest22of10,pubtest25of10,100,13082,5322,622,43,5987
subtest29of10,pubtest25of10,100,13082,5322,707,45,6074
subtest21of10,pubtest26of10,100,13075,5218,192,45,5455
subtest23of10,pubtest26of10,100,13075,5218,209,68,5495
subtest26of10,pubtest26of10,100,13075,5218,211,108,5537
subtest29of10,pubtest26of10,100,13075,5218,209,145,5572
subtest28of10,pubtest26of10,100,13075,5218,222,176,5616
subtest27of10,pubtest26of10,100,13075,5218,223,215,5656
subtest210of10,pubtest26of10,100,13075,5218,225,251,5694
subtest24of10,pubtest26of10,100,13075,5218,231,287,5736
subtest25of10,pubtest26of10,100,13075,5218,232,326,5776
subtest22of10,pubtest26of10,100,13075,5218,238,361,5817
subtest27of10,pubtest27of10,100,13083,5239,217,45,5501
subtest24of10,pubtest27of10,100,13083,5239,238,74,5551
subtest29of10,pubtest27of10,100,13083,5239,243,110,5592
subtest210of10,pubtest27of10,100,13083,5239,243,153,5635
subtest22of10,pubtest27of10,100,13083,5239,259,178,5676
subtest21of10,pubtest27of10,100,13083,5239,267,211,5717
subtest23of10,pubtest27of10,100,13083,5239,268,252,5759
subtest25of10,pubtest27of10,100,13083,5239,271,290,5800
subtest26of10,pubtest27of10,100,13083,5239,293,308,5840
subtest28of10,pubtest27of10,100,13083,5239,479,163,5881
subtest27of10,pubtest28of10,100,13085,5222,146,174,5542
subtest21of10,pubtest28of10,100,13085,5222,187,175,5584
subtest29of10,pubtest28of10,100,13085,5222,193,209,5624
subtest210of10,pubtest28of10,100,13085,5222,200,241,5663
subtest23of10,pubtest28of10,100,13085,5222,202,277,5701
subtest26of10,pubtest28of10,100,13085,5222,209,316,5747
subtest24of10,pubtest28of10,100,13085,5222,211,355,5788
subtest22of10,pubtest28of10,100,13085,5222,215,394,5831
subtest25of10,pubtest28of10,100,13085,5222,236,414,5872
subtest28of10,pubtest28of10,100,13085,5222,483,206,5911
subtest29of10,pubtest29of10,100,13081,5188,187,56,5431
subtest23of10,pubtest29of10,100,13081,5188,187,100,5475
subtest25of10,pubtest29of10,100,13081,5188,192,136,5516
subtest28of10,pubtest29of10,100,13081,5188,197,170,5555
subtest22of10,pubtest29of10,100,13081,5188,195,209,5592
subtest21of10,pubtest29of10,100,13081,5188,198,246,5632
subtest210of10,pubtest29of10,100,13081,5188,194,285,5667
subtest27of10,pubtest29of10,100,13081,5188,206,321,5715
subtest24of10,pubtest29of10,100,13081,5188,207,361,5756
subtest26of10,pubtest29of10,100,13081,5188,210,397,5795
subtest29of10,pubtest210of10,100,13188,5186,351,45,5582
subtest210of10,pubtest210of10,100,13188,5186,363,77,5626
subtest21of10,pubtest210of10,100,13188,5186,363,116,5665
subtest27of10,pubtest210of10,100,13188,5186,371,149,5706
subtest28of10,pubtest210of10,100,13188,5186,376,184,5746
subtest24of10,pubtest210of10,100,13188,5186,391,209,5786
subtest26of10,pubtest210of10,100,13188,5186,406,232,5824
subtest23of10,pubtest210of10,100,13188,5186,422,259,5867
subtest22of10,pubtest210of10,100,13188,5186,447,273,5906
subtest25of10,pubtest210of10,100,13188,5186,453,307,5946
subtest26of10,pubtest21of10,100,13081,10302,146,45,10493
subtest24of10,pubtest21of10,100,13081,10302,273,42,10617
subtest27of10,pubtest21of10,100,13081,10302,273,86,10661
subtest29of10,pubtest21of10,100,13081,10302,298,101,10701
subtest210of10,pubtest21of10,100,13081,10302,338,105,10745
subtest21of10,pubtest21of10,100,13081,10302,335,148,10785
subtest28of10,pubtest21of10,100,13081,10302,339,183,10824
subtest23of10,pubtest21of10,100,13081,10302,347,217,10866
subtest25of10,pubtest21of10,100,13081,10302,377,227,10906
subtest22of10,pubtest21of10,100,13081,10302,383,260,10945
subtest29of10,pubtest22of10,100,13083,5730,239,45,6014
subtest24of10,pubtest22of10,100,13083,5730,251,75,6056
subtest28of10,pubtest22of10,100,13083,5730,263,107,6100
subtest27of10,pubtest22of10,100,13083,5730,268,142,6140
subtest23of10,pubtest22of10,100,13083,5730,277,177,6184
subtest21of10,pubtest22of10,100,13083,5730,296,199,6225
subtest26of10,pubtest22of10,100,13083,5730,308,226,6264
subtest22of10,pubtest22of10,100,13083,5730,321,256,6307
subtest210of10,pubtest22of10,100,13083,5730,329,289,6348
subtest25of10,pubtest22of10,100,13083,5730,608,55,6393
subtest23of10,pubtest23of10,100,13082,5358,266,42,5666
subtest28of10,pubtest23of10,100,13082,5358,315,41,5714
subtest24of10,pubtest23of10,100,13082,5358,326,74,5758
subtest27of10,pubtest23of10,100,13082,5358,329,111,5798
subtest26of10,pubtest23of10,100,13082,5358,349,132,5839
subtest22of10,pubtest23of10,100,13082,5358,350,170,5878
subtest25of10,pubtest23of10,100,13082,5358,394,165,5917
subtest21of10,pubtest23of10,100,13082,5358,398,202,5958
subtest29of10,pubtest23of10,100,13082,5358,629,44,6031
subtest210of10,pubtest23of10,100,13082,5358,721,43,6122
subtest23of10,pubtest24of10,100,13085,5298,337,56,5691
subtest25of10,pubtest24of10,100,13085,5298,344,94,5736
subtest22of10,pubtest24of10,100,13085,5298,341,141,5780
subtest24of10,pubtest24of10,100,13085,5298,344,178,5820
subtest29of10,pubtest24of10,100,13085,5298,352,207,5857
subtest21of10,pubtest24of10,100,13085,5298,351,247,5896
subtest28of10,pubtest24of10,100,13085,5298,348,286,5932
subtest210of10,pubtest24of10,100,13085,5298,360,322,5980
subtest27of10,pubtest24of10,100,13085,5298,361,361,6020
subtest26of10,pubtest24of10,100,13085,5298,368,398,6064
subtest28of10,pubtest25of10,100,13082,6010,203,43,6256
subtest26of10,pubtest25of10,100,13082,6010,230,59,6299
subtest27of10,pubtest25of10,100,13082,6010,231,98,6339
subtest21of10,pubtest25of10,100,13082,6010,234,136,6380
subtest24of10,pubtest25of10,100,13082,6010,326,83,6419
subtest25of10,pubtest25of10,100,13082,6010,480,42,6532
subtest23of10,pubtest25of10,100,13082,6010,490,75,6575
subtest29of10,pubtest25of10,100,13082,6010,558,47,6615
subtest210of10,pubtest25of10,100,13082,6010,583,62,6655
subtest22of10,pubtest25of10,100,13082,6010,1153,45,7208
subtest22of10,pubtest26of10,100,13075,5901,282,44,6227
subtest29of10,pubtest26of10,100,13075,5901,302,67,6270
subtest21of10,pubtest26of10,100,13075,5901,302,108,6311
subtest23of10,pubtest26of10,100,13075,5901,307,144,6352
subtest26of10,pubtest26of10,100,13075,5901,312,179,6392
subtest210of10,pubtest26of10,100,13075,5901,329,201,6431
subtest28of10,pubtest26of10,100,13075,5901,332,238,6471
subtest27of10,pubtest26of10,100,13075,5901,341,269,6511
subtest24of10,pubtest26of10,100,13075,5901,351,297,6549
subtest25of10,pubtest26of10,100,13075,5901,354,336,6591
subtest27of10,pubtest27of10,100,13083,5230,190,45,5465
subtest22of10,pubtest27of10,100,13083,5230,272,42,5544
subtest24of10,pubtest27of10,100,13083,5230,292,65,5587
subtest28of10,pubtest27of10,100,13083,5230,292,105,5627
subtest210of10,pubtest27of10,100,13083,5230,298,137,5665
subtest25of10,pubtest27of10,100,13083,5230,301,176,5707
subtest23of10,pubtest27of10,100,13083,5230,298,214,5742
subtest29of10,pubtest27of10,100,13083,5230,298,253,5781
subtest26of10,pubtest27of10,100,13083,5230,341,256,5827
subtest21of10,pubtest27of10,100,13083,5230,349,289,5868
subtest28of10,pubtest28of10,100,13085,5264,226,234,5724
subtest27of10,pubtest28of10,100,13085,5264,148,371,5783
subtest21of10,pubtest28of10,100,13085,5264,255,98,5617
subtest24of10,pubtest28of10,100,13085,5264,466,133,5863
subtest23of10,pubtest28of10,100,13085,5264,473,166,5903
subtest22of10,pubtest28of10,100,13085,5264,465,215,5944
subtest26of10,pubtest28of10,100,13085,5264,471,248,5983
subtest210of10,pubtest28of10,100,13085,5264,474,285,6023
subtest25of10,pubtest28of10,100,13085,5264,468,331,6063
subtest29of10,pubtest28of10,100,13085,5264,525,318,6107
subtest25of10,pubtest29of10,100,13081,5166,299,46,5511
subtest210of10,pubtest29of10,100,13081,5166,302,85,5553
subtest28of10,pubtest29of10,100,13081,5166,310,116,5592
subtest21of10,pubtest29of10,100,13081,5166,317,149,5632
subtest27of10,pubtest29of10,100,13081,5166,318,188,5672
subtest24of10,pubtest29of10,100,13081,5166,320,228,5714
subtest26of10,pubtest29of10,100,13081,5166,322,268,5756
subtest22of10,pubtest29of10,100,13081,5166,331,299,5796
subtest23of10,pubtest29of10,100,13081,5166,547,121,5834
subtest29of10,pubtest29of10,100,13081,5166,615,95,5876
subtest29of10,pubtest210of10,100,13188,5554,142,45,5741
subtest210of10,pubtest210of10,100,13188,5554,234,43,5831
subtest21of10,pubtest210of10,100,13188,5554,234,84,5872
subtest27of10,pubtest210of10,100,13188,5554,238,120,5912
subtest22of10,pubtest210of10,100,13188,5554,243,155,5952
subtest25of10,pubtest210of10,100,13188,5554,251,187,5992
subtest24of10,pubtest210of10,100,13188,5554,251,227,6032
subtest26of10,pubtest210of10,100,13188,5554,246,264,6064
subtest23of10,pubtest210of10,100,13188,5554,255,302,6111
subtest28of10,pubtest210of10,100,13188,5554,245,341,6140
subtest26of10,pubtest21of10,100,13081,10220,217,47,10484
subtest27of10,pubtest21of10,100,13081,10220,227,80,10527
subtest24of10,pubtest21of10,100,13081,10220,246,100,10566
subtest25of10,pubtest21of10,100,13081,10220,256,134,10610
subtest29of10,pubtest21of10,100,13081,10220,255,172,10647
subtest21of10,pubtest21of10,100,13081,10220,258,211,10689
subtest22of10,pubtest21of10,100,13081,10220,263,247,10730
subtest23of10,pubtest21of10,100,13081,10220,287,263,10770
subtest210of10,pubtest21of10,100,13081,10220,543,52,10815
subtest28of10,pubtest21of10,100,13081,10220,544,88,10852
subtest29of10,pubtest22of10,100,13083,5205,133,45,5383
subtest27of10,pubtest22of10,100,13083,5205,186,45,5436
subtest23of10,pubtest22of10,100,13083,5205,193,81,5479
subtest26of10,pubtest22of10,100,13083,5205,189,119,5513
subtest21of10,pubtest22of10,100,13083,5205,195,159,5559
subtest28of10,pubtest22of10,100,13083,5205,206,188,5599
subtest210of10,pubtest22of10,100,13083,5205,210,224,5639
subtest22of10,pubtest22of10,100,13083,5205,212,260,5677
subtest25of10,pubtest22of10,100,13083,5205,227,287,5719
subtest24of10,pubtest22of10,100,13083,5205,451,103,5759
subtest23of10,pubtest23of10,100,13082,5187,159,43,5389
subtest29of10,pubtest23of10,100,13082,5187,232,45,5464
subtest28of10,pubtest23of10,100,13082,5187,232,89,5508
subtest27of10,pubtest23of10,100,13082,5187,236,121,5544
subtest25of10,pubtest23of10,100,13082,5187,242,161,5590
subtest26of10,pubtest23of10,100,13082,5187,245,199,5631
subtest21of10,pubtest23of10,100,13082,5187,257,228,5672
subtest210of10,pubtest23of10,100,13082,5187,267,262,5716
subtest24of10,pubtest23of10,100,13082,5187,274,297,5758
subtest22of10,pubtest23of10,100,13082,5187,278,334,5799
subtest23of10,pubtest24of10,100,13085,5214,218,48,5480
subtest28of10,pubtest24of10,100,13085,5214,221,88,5523
subtest25of10,pubtest24of10,100,13085,5214,219,129,5562
subtest27of10,pubtest24of10,100,13085,5214,227,166,5607
subtest22of10,pubtest24of10,100,13085,5214,223,205,5642
subtest26of10,pubtest24of10,100,13085,5214,231,245,5690
subtest29of10,pubtest24of10,100,13085,5214,234,284,5732
subtest24of10,pubtest24of10,100,13085,5214,238,321,5773
subtest210of10,pubtest24of10,100,13085,5214,245,356,5815
subtest21of10,pubtest24of10,100,13085,5214,475,170,5859
subtest210of10,pubtest25of10,100,13082,5198,204,43,5445
subtest26of10,pubtest25of10,100,13082,5198,221,69,5488
subtest22of10,pubtest25of10,100,13082,5198,226,106,5530
subtest27of10,pubtest25of10,100,13082,5198,225,149,5572
subtest25of10,pubtest25of10,100,13082,5198,230,192,5620
subtest29of10,pubtest25of10,100,13082,5198,239,228,5665
subtest21of10,pubtest25of10,100,13082,5198,264,246,5708
subtest23of10,pubtest25of10,100,13082,5198,286,264,5748
subtest28of10,pubtest25of10,100,13082,5198,458,137,5793
subtest24of10,pubtest25of10,100,13082,5198,508,127,5833
subtest21of10,pubtest26of10,100,13075,5210,283,47,5540
subtest22of10,pubtest26of10,100,13075,5210,285,88,5583
subtest29of10,pubtest26of10,100,13075,5210,289,124,5623
subtest23of10,pubtest26of10,100,13075,5210,297,160,5667
subtest28of10,pubtest26of10,100,13075,5210,306,191,5707
subtest27of10,pubtest26of10,100,13075,5210,306,231,5747
subtest26of10,pubtest26of10,100,13075,5210,301,270,5781
subtest210of10,pubtest26of10,100,13075,5210,300,309,5819
subtest25of10,pubtest26of10,100,13075,5210,336,321,5867
subtest24of10,pubtest26of10,100,13075,5210,339,358,5907
subtest28of10,pubtest27of10,100,13083,5396,144,45,5585
subtest27of10,pubtest27of10,100,13083,5396,181,52,5629
subtest23of10,pubtest27of10,100,13083,5396,200,78,5674
subtest29of10,pubtest27of10,100,13083,5396,225,95,5716
subtest25of10,pubtest27of10,100,13083,5396,229,134,5759
subtest210of10,pubtest27of10,100,13083,5396,229,177,5802
subtest24of10,pubtest27of10,100,13083,5396,224,215,5835
subtest22of10,pubtest27of10,100,13083,5396,239,252,5887
subtest26of10,pubtest27of10,100,13083,5396,245,286,5927
subtest21of10,pubtest27of10,100,13083,5396,247,324,5967
subtest27of10,pubtest28of10,100,13085,5328,185,43,5556
subtest21of10,pubtest28of10,100,13085,5328,222,48,5598
subtest28of10,pubtest28of10,100,13085,5328,239,77,5644
subtest29of10,pubtest28of10,100,13085,5328,240,120,5688
subtest210of10,pubtest28of10,100,13085,5328,244,160,5732
subtest23of10,pubtest28of10,100,13085,5328,245,203,5776
subtest26of10,pubtest28of10,100,13085,5328,256,232,5816
subtest24of10,pubtest28of10,100,13085,5328,263,264,5855
subtest22of10,pubtest28of10,100,13085,5328,264,304,5896
subtest25of10,pubtest28of10,100,13085,5328,257,344,5929
subtest29of10,pubtest29of10,100,13081,5273,243,45,5561
subtest24of10,pubtest29of10,100,13081,5273,247,82,5602
subtest21of10,pubtest29of10,100,13081,5273,254,118,5645
subtest28of10,pubtest29of10,100,13081,5273,250,157,5680
subtest210of10,pubtest29of10,100,13081,5273,258,197,5728
subtest22of10,pubtest29of10,100,13081,5273,260,237,5770
subtest23of10,pubtest29of10,100,13081,5273,243,276,5792
subtest27of10,pubtest29of10,100,13081,5273,254,319,5846
subtest26of10,pubtest29of10,100,13081,5273,266,361,5900
subtest25of10,pubtest29of10,100,13081,5273,263,408,5944
subtest27of10,pubtest210of10,100,13188,5178,314,104,5596
subtest21of10,pubtest210of10,100,13188,5178,302,117,5597
subtest210of10,pubtest210of10,100,13188,5178,314,123,5615
subtest28of10,pubtest210of10,100,13188,5178,318,162,5658
subtest23of10,pubtest210of10,100,13188,5178,335,185,5698
subtest26of10,pubtest210of10,100,13188,5178,340,224,5742
subtest29of10,pubtest210of10,100,13188,5178,565,46,5789
subtest24of10,pubtest210of10,100,13188,5178,610,44,5832
subtest22of10,pubtest210of10,100,13188,5178,630,70,5878
subtest25of10,pubtest210of10,100,13188,5178,658,87,5923
subtest26of10,pubtest21of10,100,13081,10315,208,45,10568
subtest29of10,pubtest21of10,100,13081,10315,215,80,10610
subtest25of10,pubtest21of10,100,13081,10315,220,120,10655
subtest21of10,pubtest21of10,100,13081,10315,229,158,10702
subtest210of10,pubtest21of10,100,13081,10315,229,198,10742
subtest28of10,pubtest21of10,100,13081,10315,233,238,10786
subtest23of10,pubtest21of10,100,13081,10315,237,275,10827
subtest24of10,pubtest21of10,100,13081,10315,238,318,10871
subtest22of10,pubtest21of10,100,13081,10315,266,331,10912
subtest27of10,pubtest21of10,100,13081,10315,485,155,10955
subtest29of10,pubtest22of10,100,13083,5241,137,44,5422
subtest27of10,pubtest22of10,100,13083,5241,234,44,5519
subtest26of10,pubtest22of10,100,13083,5241,243,75,5559
subtest210of10,pubtest22of10,100,13083,5241,244,118,5603
subtest28of10,pubtest22of10,100,13083,5241,246,157,5644
subtest23of10,pubtest22of10,100,13083,5241,249,195,5685
subtest22of10,pubtest22of10,100,13083,5241,288,201,5730
subtest21of10,pubtest22of10,100,13083,5241,307,222,5770
subtest25of10,pubtest22of10,100,13083,5241,311,262,5814
subtest24of10,pubtest22of10,100,13083,5241,557,56,5854
subtest29of10,pubtest23of10,100,13082,5288,242,43,5573
subtest28of10,pubtest23of10,100,13082,5288,262,68,5618
subtest27of10,pubtest23of10,100,13082,5288,264,108,5660
subtest24of10,pubtest23of10,100,13082,5288,268,145,5701
subtest22of10,pubtest23of10,100,13082,5288,306,147,5741
subtest21of10,pubtest23of10,100,13082,5288,309,183,5780
subtest210of10,pubtest23of10,100,13082,5288,313,220,5821
subtest25of10,pubtest23of10,100,13082,5288,328,245,5861
subtest23of10,pubtest23of10,100,13082,5288,485,125,5898
subtest26of10,pubtest23of10,100,13082,5288,582,71,5941
subtest24of10,pubtest24of10,100,13085,5428,266,52,5746
subtest23of10,pubtest24of10,100,13085,5428,266,101,5795
subtest22of10,pubtest24of10,100,13085,5428,274,136,5838
subtest28of10,pubtest24of10,100,13085,5428,271,179,5878
subtest21of10,pubtest24of10,100,13085,5428,296,199,5923
subtest25of10,pubtest24of10,100,13085,5428,294,238,5960
subtest29of10,pubtest24of10,100,13085,5428,323,259,6010
subtest26of10,pubtest24of10,100,13085,5428,327,299,6054
subtest27of10,pubtest24of10,100,13085,5428,340,327,6095
subtest210of10,pubtest24of10,100,13085,5428,351,356,6135
subtest28of10,pubtest25of10,100,13082,5199,195,45,5439
subtest21of10,pubtest25of10,100,13082,5199,265,44,5508
subtest210of10,pubtest25of10,100,13082,5199,265,88,5552
subtest26of10,pubtest25of10,100,13082,5199,269,124,5592
subtest27of10,pubtest25of10,100,13082,5199,275,158,5632
subtest22of10,pubtest25of10,100,13082,5199,282,191,5672
subtest23of10,pubtest25of10,100,13082,5199,293,220,5712
subtest25of10,pubtest25of10,100,13082,5199,337,215,5751
subtest29of10,pubtest25of10,100,13082,5199,341,255,5795
subtest24of10,pubtest25of10,100,13082,5199,595,43,5837
subtest21of10,pubtest26of10,100,13075,5231,139,43,5413
subtest22of10,pubtest26of10,100,13075,5231,214,44,5489
subtest23of10,pubtest26of10,100,13075,5231,236,63,5530
subtest29of10,pubtest26of10,100,13075,5231,236,101,5568
subtest26of10,pubtest26of10,100,13075,5231,241,140,5612
subtest210of10,pubtest26of10,100,13075,5231,245,176,5652
subtest28of10,pubtest26of10,100,13075,5231,254,208,5693
subtest27of10,pubtest26of10,100,13075,5231,258,244,5733
subtest24of10,pubtest26of10,100,13075,5231,273,268,5772
subtest25of10,pubtest26of10,100,13075,5231,279,300,5810
subtest28of10,pubtest27of10,100,13083,5155,164,44,5363
subtest27of10,pubtest27of10,100,13083,5155,237,60,5452
subtest24of10,pubtest27of10,100,13083,5155,244,96,5495
subtest29of10,pubtest27of10,100,13083,5155,249,134,5538
subtest25of10,pubtest27of10,100,13083,5155,251,176,5582
subtest23of10,pubtest27of10,100,13083,5155,242,226,5623
subtest210of10,pubtest27of10,100,13083,5155,247,396,5798
subtest26of10,pubtest27of10,100,13083,5155,260,431,5846
subtest21of10,pubtest27of10,100,13083,5155,261,475,5891
subtest22of10,pubtest27of10,100,13083,5155,258,517,5930
subtest27of10,pubtest28of10,100,13085,5340,214,50,5604
subtest28of10,pubtest28of10,100,13085,5340,215,92,5647
subtest29of10,pubtest28of10,100,13085,5340,219,128,5687
subtest21of10,pubtest28of10,100,13085,5340,220,167,5727
subtest23of10,pubtest28of10,100,13085,5340,236,191,5767
subtest26of10,pubtest28of10,100,13085,5340,238,229,5807
subtest210of10,pubtest28of10,100,13085,5340,248,259,5847
subtest22of10,pubtest28of10,100,13085,5340,243,299,5882
subtest24of10,pubtest28of10,100,13085,5340,285,303,5928
subtest25of10,pubtest28of10,100,13085,5340,285,343,5968
subtest29of10,pubtest29of10,100,13081,5225,249,44,5518
subtest23of10,pubtest29of10,100,13081,5225,245,241,5711
subtest210of10,pubtest29of10,100,13081,5225,259,269,5753
subtest25of10,pubtest29of10,100,13081,5225,266,302,5793
subtest22of10,pubtest29of10,100,13081,5225,271,341,5837
subtest28of10,pubtest29of10,100,13081,5225,273,377,5875
subtest24of10,pubtest29of10,100,13081,5225,277,415,5917
subtest26of10,pubtest29of10,100,13081,5225,285,447,5957
subtest27of10,pubtest29of10,100,13081,5225,294,481,6000
subtest21of10,pubtest29of10,100,13081,5225,492,325,6042
subtest29of10,pubtest210of10,100,13188,5182,185,45,5412
subtest21of10,pubtest210of10,100,13188,5182,262,41,5485
subtest210of10,pubtest210of10,100,13188,5182,290,58,5530
subtest27of10,pubtest210of10,100,13188,5182,292,96,5570
subtest28of10,pubtest210of10,100,13188,5182,296,137,5615
subtest24of10,pubtest210of10,100,13188,5182,307,165,5654
subtest22of10,pubtest210of10,100,13188,5182,314,199,5695
subtest26of10,pubtest210of10,100,13188,5182,317,235,5734
subtest23of10,pubtest210of10,100,13188,5182,321,268,5771
subtest25of10,pubtest210of10,100,13188,5182,322,308,5812
subtest27of10,pubtest21of10,100,13081,10187,186,43,10416
subtest24of10,pubtest21of10,100,13081,10187,190,83,10460
subtest29of10,pubtest21of10,100,13081,10187,194,119,10500
subtest25of10,pubtest21of10,100,13081,10187,197,160,10544
subtest21of10,pubtest21of10,100,13081,10187,206,190,10583
subtest23of10,pubtest21of10,100,13081,10187,220,221,10628
subtest22of10,pubtest21of10,100,13081,10187,451,42,10680
subtest26of10,pubtest21of10,100,13081,10187,457,80,10724
subtest28of10,pubtest21of10,100,13081,10187,488,94,10769
subtest210of10,pubtest21of10,100,13081,10187,491,135,10813
subtest29of10,pubtest22of10,100,13083,5206,114,41,5361
subtest27of10,pubtest22of10,100,13083,5206,204,45,5455
subtest26of10,pubtest22of10,100,13083,5206,209,86,5501
subtest23of10,pubtest22of10,100,13083,5206,245,99,5550
subtest25of10,pubtest22of10,100,13083,5206,247,140,5593
subtest21of10,pubtest22of10,100,13083,5206,252,174,5632
subtest28of10,pubtest22of10,100,13083,5206,260,207,5673
subtest210of10,pubtest22of10,100,13083,5206,282,230,5718
subtest22of10,pubtest22of10,100,13083,5206,301,254,5761
subtest24of10,pubtest22of10,100,13083,5206,458,136,5800
subtest23of10,pubtest23of10,100,13082,5271,213,47,5531
subtest28of10,pubtest23of10,100,13082,5271,239,65,5575
subtest29of10,pubtest23of10,100,13082,5271,241,107,5619
subtest27of10,pubtest23of10,100,13082,5271,247,141,5659
subtest24of10,pubtest23of10,100,13082,5271,247,185,5703
subtest25of10,pubtest23of10,100,13082,5271,273,203,5747
subtest26of10,pubtest23of10,100,13082,5271,277,240,5788
subtest22of10,pubtest23of10,100,13082,5271,286,270,5827
subtest21of10,pubtest23of10,100,13082,5271,286,310,5867
subtest210of10,pubtest23of10,100,13082,5271,289,347,5907
subtest23of10,pubtest24of10,100,13085,5168,232,43,5443
subtest28of10,pubtest24of10,100,13085,5168,261,53,5482
subtest24of10,pubtest24of10,100,13085,5168,261,94,5523
subtest22of10,pubtest24of10,100,13085,5168,269,128,5565
subtest25of10,pubtest24of10,100,13085,5168,268,172,5608
subtest210of10,pubtest24of10,100,13085,5168,280,203,5651
subtest29of10,pubtest24of10,100,13085,5168,286,237,5691
subtest27of10,pubtest24of10,100,13085,5168,292,271,5731
subtest26of10,pubtest24of10,100,13085,5168,293,310,5771
subtest21of10,pubtest24of10,100,13085,5168,304,340,5812
subtest28of10,pubtest25of10,100,13082,5367,250,44,5661
subtest27of10,pubtest25of10,100,13082,5367,262,77,5706
subtest22of10,pubtest25of10,100,13082,5367,263,115,5745
subtest25of10,pubtest25of10,100,13082,5367,278,140,5785
subtest29of10,pubtest25of10,100,13082,5367,286,173,5826
subtest23of10,pubtest25of10,100,13082,5367,285,217,5869
subtest24of10,pubtest25of10,100,13082,5367,290,256,5913
subtest26of10,pubtest25of10,100,13082,5367,535,54,5956
subtest210of10,pubtest25of10,100,13082,5367,574,60,6001
subtest21of10,pubtest25of10,100,13082,5367,587,87,6041
subtest22of10,pubtest26of10,100,13075,5407,192,43,5642
subtest21of10,pubtest26of10,100,13075,5407,211,80,5698
subtest29of10,pubtest26of10,100,13075,5407,216,114,5737
subtest23of10,pubtest26of10,100,13075,5407,223,147,5777
subtest26of10,pubtest26of10,100,13075,5407,229,183,5819
subtest25of10,pubtest26of10,100,13075,5407,254,197,5858
subtest28of10,pubtest26of10,100,13075,5407,277,214,5898
subtest27of10,pubtest26of10,100,13075,5407,280,251,5938
subtest210of10,pubtest26of10,100,13075,5407,286,290,5983
subtest24of10,pubtest26of10,100,13075,5407,288,327,6022
subtest27of10,pubtest27of10,100,13083,5391,281,42,5714
subtest28of10,pubtest27of10,100,13083,5391,285,78,5754
subtest23of10,pubtest27of10,100,13083,5391,290,118,5799
subtest29of10,pubtest27of10,100,13083,5391,298,149,5838
subtest24of10,pubtest27of10,100,13083,5391,296,188,5875
subtest210of10,pubtest27of10,100,13083,5391,305,227,5923
subtest25of10,pubtest27of10,100,13083,5391,329,244,5964
subtest22of10,pubtest27of10,100,13083,5391,341,274,6006
subtest26of10,pubtest27of10,100,13083,5391,345,314,6050
subtest21of10,pubtest27of10,100,13083,5391,353,349,6093
subtest27of10,pubtest28of10,100,13085,5256,179,44,5479
subtest28of10,pubtest28of10,100,13085,5256,242,44,5542
subtest210of10,pubtest28of10,100,13085,5256,306,43,5605
subtest25of10,pubtest28of10,100,13085,5256,312,79,5647
subtest24of10,pubtest28of10,100,13085,5256,318,113,5687
subtest22of10,pubtest28of10,100,13085,5256,326,149,5731
subtest26of10,pubtest28of10,100,13085,5256,347,169,5772
subtest23of10,pubtest28of10,100,13085,5256,358,197,5811
subtest21of10,pubtest28of10,100,13085,5256,525,70,5851
subtest29of10,pubtest28of10,100,13085,5256,565,70,5891
subtest23of10,pubtest29of10,100,13081,5151,374,48,5573
subtest210of10,pubtest29of10,100,13081,5151,376,89,5616
subtest25of10,pubtest29of10,100,13081,5151,390,120,5661
subtest22of10,pubtest29of10,100,13081,5151,391,159,5701
subtest24of10,pubtest29of10,100,13081,5151,395,201,5747
subtest28of10,pubtest29of10,100,13081,5151,394,239,5784
subtest29of10,pubtest29of10,100,13081,5151,413,264,5828
subtest21of10,pubtest29of10,100,13081,5151,434,283,5868
subtest27of10,pubtest29of10,100,13081,5151,501,256,5908
subtest26of10,pubtest29of10,100,13081,5151,507,294,5952
subtest21of10,pubtest210of10,100,13188,5262,214,43,5519
subtest210of10,pubtest210of10,100,13188,5262,216,81,5559
subtest27of10,pubtest210of10,100,13188,5262,219,122,5603
subtest28of10,pubtest210of10,100,13188,5262,248,133,5643
subtest22of10,pubtest210of10,100,13188,5262,264,155,5681
subtest23of10,pubtest210of10,100,13188,5262,269,192,5723
subtest24of10,pubtest210of10,100,13188,5262,291,210,5763
subtest25of10,pubtest210of10,100,13188,5262,299,242,5803
subtest29of10,pubtest210of10,100,13188,5262,486,99,5847
subtest26of10,pubtest210of10,100,13188,5262,531,99,5892
subtest24of10,pubtest21of10,100,13081,10166,261,45,10472
subtest29of10,pubtest21of10,100,13081,10166,265,78,10509
subtest25of10,pubtest21of10,100,13081,10166,269,120,10555
subtest21of10,pubtest21of10,100,13081,10166,273,162,10601
subtest28of10,pubtest21of10,100,13081,10166,278,200,10644
subtest210of10,pubtest21of10,100,13081,10166,270,254,10690
subtest22of10,pubtest21of10,100,13081,10166,277,288,10731
subtest26of10,pubtest21of10,100,13081,10166,286,330,10782
subtest23of10,pubtest21of10,100,13081,10166,297,362,10825
subtest27of10,pubtest21of10,100,13081,10166,528,174,10868
subtest29of10,pubtest22of10,100,13083,5181,133,43,5357
subtest24of10,pubtest22of10,100,13083,5181,164,53,5398
subtest28of10,pubtest22of10,100,13083,5181,195,66,5442
subtest26of10,pubtest22of10,100,13083,5181,199,106,5486
subtest210of10,pubtest22of10,100,13083,5181,202,145,5528
subtest27of10,pubtest22of10,100,13083,5181,198,186,5565
subtest25of10,pubtest22of10,100,13083,5181,218,218,5617
subtest22of10,pubtest22of10,100,13083,5181,224,252,5657
subtest23of10,pubtest22of10,100,13083,5181,237,280,5698
subtest21of10,pubtest22of10,100,13083,5181,253,307,5741
subtest23of10,pubtest23of10,100,13082,5220,185,44,5449
subtest27of10,pubtest23of10,100,13082,5220,223,50,5493
subtest29of10,pubtest23of10,100,13082,5220,223,90,5533
subtest28of10,pubtest23of10,100,13082,5220,227,126,5573
subtest25of10,pubtest23of10,100,13082,5220,237,157,5614
subtest21of10,pubtest23of10,100,13082,5220,261,172,5653
subtest22of10,pubtest23of10,100,13082,5220,257,211,5688
subtest26of10,pubtest23of10,100,13082,5220,264,249,5733
subtest24of10,pubtest23of10,100,13082,5220,500,58,5778
subtest210of10,pubtest23of10,100,13082,5220,551,49,5820
subtest24of10,pubtest24of10,100,13085,5385,209,45,5639
subtest28of10,pubtest24of10,100,13085,5385,210,88,5683
subtest22of10,pubtest24of10,100,13085,5385,239,103,5727
subtest25of10,pubtest24of10,100,13085,5385,246,141,5772
subtest21of10,pubtest24of10,100,13085,5385,249,178,5812
subtest27of10,pubtest24of10,100,13085,5385,261,210,5856
subtest26of10,pubtest24of10,100,13085,5385,299,214,5898
subtest210of10,pubtest24of10,100,13085,5385,313,242,5940
subtest23of10,pubtest24of10,100,13085,5385,473,122,5980
subtest29of10,pubtest24of10,100,13085,5385,528,110,6023
subtest28of10,pubtest25of10,100,13082,5508,152,41,5701
subtest210of10,pubtest25of10,100,13082,5508,262,44,5814
subtest26of10,pubtest25of10,100,13082,5508,311,42,5861
subtest21of10,pubtest25of10,100,13082,5508,313,84,5905
subtest27of10,pubtest25of10,100,13082,5508,325,117,5950
subtest22of10,pubtest25of10,100,13082,5508,327,155,5990
subtest25of10,pubtest25of10,100,13082,5508,333,193,6034
subtest23of10,pubtest25of10,100,13082,5508,352,215,6075
subtest24of10,pubtest25of10,100,13082,5508,403,203,6114
subtest29of10,pubtest25of10,100,13082,5508,411,236,6155
subtest22of10,pubtest26of10,100,13075,5279,257,43,5579
subtest23of10,pubtest26of10,100,13075,5279,277,69,5625
subtest210of10,pubtest26of10,100,13075,5279,281,111,5671
subtest28of10,pubtest26of10,100,13075,5279,286,150,5715
subtest24of10,pubtest26of10,100,13075,5279,288,192,5759
subtest29of10,pubtest26of10,100,13075,5279,294,226,5799
subtest27of10,pubtest26of10,100,13075,5279,342,221,5842
subtest25of10,pubtest26of10,100,13075,5279,345,259,5883
subtest26of10,pubtest26of10,100,13075,5279,350,298,5927
subtest21of10,pubtest26of10,100,13075,5279,545,147,5971
subtest28of10,pubtest27of10,100,13083,5200,195,100,5495
subtest23of10,pubtest27of10,100,13083,5200,211,125,5536
subtest24of10,pubtest27of10,100,13083,5200,223,157,5580
subtest29of10,pubtest27of10,100,13083,5200,260,164,5624
subtest210of10,pubtest27of10,100,13083,5200,267,198,5665
subtest25of10,pubtest27of10,100,13083,5200,272,239,5711
subtest21of10,pubtest27of10,100,13083,5200,279,273,5752
subtest26of10,pubtest27of10,100,13083,5200,301,296,5797
subtest22of10,pubtest27of10,100,13083,5200,309,330,5839
subtest27of10,pubtest27of10,100,13083,5200,546,139,5885
subtest21of10,pubtest28of10,100,13085,5196,177,47,5420
subtest28of10,pubtest28of10,100,13085,5196,181,84,5461
subtest29of10,pubtest28of10,100,13085,5196,193,115,5504
subtest210of10,pubtest28of10,100,13085,5196,201,153,5550
subtest23of10,pubtest28of10,100,13085,5196,215,182,5593
subtest27of10,pubtest28of10,100,13085,5196,251,190,5637
subtest25of10,pubtest28of10,100,13085,5196,279,206,5681
subtest26of10,pubtest28of10,100,13085,5196,274,250,5720
subtest22of10,pubtest28of10,100,13085,5196,281,292,5769
subtest24of10,pubtest28of10,100,13085,5196,279,334,5809
subtest23of10,pubtest29of10,100,13081,5226,234,45,5505
subtest210of10,pubtest29of10,100,13081,5226,304,47,5577
subtest29of10,pubtest29of10,100,13081,5226,308,87,5621
subtest25of10,pubtest29of10,100,13081,5226,314,123,5663
subtest24of10,pubtest29of10,100,13081,5226,322,158,5706
subtest21of10,pubtest29of10,100,13081,5226,323,200,5749
subtest22of10,pubtest29of10,100,13081,5226,319,239,5784
subtest28of10,pubtest29of10,100,13081,5226,325,282,5833
subtest27of10,pubtest29of10,100,13081,5226,342,304,5872
subtest26of10,pubtest29of10,100,13081,5226,352,335,5913
subtest29of10,pubtest210of10,100,13188,5372,212,45,5629
subtest21of10,pubtest210of10,100,13188,5372,224,77,5673
subtest210of10,pubtest210of10,100,13188,5372,246,96,5714
subtest28of10,pubtest210of10,100,13188,5372,260,126,5758
subtest24of10,pubtest210of10,100,13188,5372,268,159,5799
subtest22of10,pubtest210of10,100,13188,5372,274,194,5840
subtest27of10,pubtest210of10,100,13188,5372,296,218,5886
subtest23of10,pubtest210of10,100,13188,5372,318,240,5930
subtest26of10,pubtest210of10,100,13188,5372,426,172,5970
subtest25of10,pubtest210of10,100,13188,5372,554,87,6013
subtest26of10,pubtest21of10,100,13081,10296,191,42,10529
subtest27of10,pubtest21of10,100,13081,10296,197,73,10566
subtest24of10,pubtest21of10,100,13081,10296,203,113,10612
subtest29of10,pubtest21of10,100,13081,10296,232,127,10655
subtest25of10,pubtest21of10,100,13081,10296,237,167,10700
subtest21of10,pubtest21of10,100,13081,10296,241,205,10742
subtest210of10,pubtest21of10,100,13081,10296,249,238,10783
subtest28of10,pubtest21of10,100,13081,10296,265,262,10823
subtest23of10,pubtest21of10,100,13081,10296,282,290,10868
subtest22of10,pubtest21of10,100,13081,10296,311,303,10910
subtest27of10,pubtest22of10,100,13083,5217,124,42,5383
subtest29of10,pubtest22of10,100,13083,5217,177,45,5439
subtest24of10,pubtest22of10,100,13083,5217,200,67,5484
subtest23of10,pubtest22of10,100,13083,5217,231,78,5526
subtest210of10,pubtest22of10,100,13083,5217,247,104,5568
subtest25of10,pubtest22of10,100,13083,5217,248,148,5613
subtest22of10,pubtest22of10,100,13083,5217,261,180,5658
subtest28of10,pubtest22of10,100,13083,5217,263,218,5698
subtest21of10,pubtest22of10,100,13083,5217,264,257,5738
subtest26of10,pubtest22of10,100,13083,5217,539,44,5800
subtest29of10,pubtest23of10,100,13082,5187,259,42,5488
subtest24of10,pubtest23of10,100,13082,5187,268,78,5533
subtest25of10,pubtest23of10,100,13082,5187,279,106,5572
subtest27of10,pubtest23of10,100,13082,5187,277,145,5609
subtest22of10,pubtest23of10,100,13082,5187,292,174,5653
subtest26of10,pubtest23of10,100,13082,5187,311,193,5691
subtest210of10,pubtest23of10,100,13082,5187,473,74,5734
subtest23of10,pubtest23of10,100,13082,5187,522,69,5778
subtest28of10,pubtest23of10,100,13082,5187,577,56,5820
subtest21of10,pubtest23of10,100,13082,5187,588,85,5860
subtest24of10,pubtest24of10,100,13085,5172,182,45,5399
subtest28of10,pubtest24of10,100,13085,5172,212,58,5442
subtest22of10,pubtest24of10,100,13085,5172,215,98,5485
subtest25of10,pubtest24of10,100,13085,5172,222,132,5526
subtest210of10,pubtest24of10,100,13085,5172,243,149,5564
subtest29of10,pubtest24of10,100,13085,5172,248,186,5606
subtest21of10,pubtest24of10,100,13085,5172,263,210,5645
subtest26of10,pubtest24of10,100,13085,5172,269,244,5685
subtest23of10,pubtest24of10,100,13085,5172,489,65,5726
subtest27of10,pubtest24of10,100,13085,5172,534,59,5765
subtest28of10,pubtest25of10,100,13082,5489,125,45,5659
subtest210of10,pubtest25of10,100,13082,5489,173,45,5707
subtest21of10,pubtest25of10,100,13082,5489,188,69,5746
subtest26of10,pubtest25of10,100,13082,5489,235,65,5789
subtest22of10,pubtest25of10,100,13082,5489,248,98,5835
subtest25of10,pubtest25of10,100,13082,5489,259,127,5875
subtest24of10,pubtest25of10,100,13082,5489,284,139,5912
subtest23of10,pubtest25of10,100,13082,5489,282,177,5948
subtest29of10,pubtest25of10,100,13082,5489,282,222,5993
subtest27of10,pubtest25of10,100,13082,5489,291,255,6035
subtest22of10,pubtest26of10,100,13075,5290,142,44,5476
subtest21of10,pubtest26of10,100,13075,5290,181,48,5519
subtest23of10,pubtest26of10,100,13075,5290,200,74,5564
subtest26of10,pubtest26of10,100,13075,5290,201,114,5605
subtest29of10,pubtest26of10,100,13075,5290,203,155,5648
subtest210of10,pubtest26of10,100,13075,5290,205,197,5692
subtest24of10,pubtest26of10,100,13075,5290,212,228,5730
subtest25of10,pubtest26of10,100,13075,5290,216,266,5772
subtest27of10,pubtest26of10,100,13075,5290,212,306,5808
subtest28of10,pubtest26of10,100,13075,5290,230,333,5853
subtest27of10,pubtest27of10,100,13083,5249,201,44,5494
subtest210of10,pubtest27of10,100,13083,5249,211,76,5536
subtest29of10,pubtest27of10,100,13083,5249,211,116,5576
subtest25of10,pubtest27of10,100,13083,5249,215,152,5616
subtest22of10,pubtest27of10,100,13083,5249,216,192,5657
subtest21of10,pubtest27of10,100,13083,5249,224,224,5697
subtest26of10,pubtest27of10,100,13083,5249,240,248,5737
subtest24of10,pubtest27of10,100,13083,5249,476,55,5780
subtest28of10,pubtest27of10,100,13083,5249,500,70,5819
subtest23of10,pubtest27of10,100,13083,5249,896,44,6189
subtest27of10,pubtest28of10,100,13085,5223,206,46,5475
subtest21of10,pubtest28of10,100,13085,5223,247,52,5522
subtest28of10,pubtest28of10,100,13085,5223,251,86,5560
subtest29of10,pubtest28of10,100,13085,5223,250,124,5597
subtest25of10,pubtest28of10,100,13085,5223,271,148,5642
subtest24of10,pubtest28of10,100,13085,5223,282,177,5682
subtest22of10,pubtest28of10,100,13085,5223,284,215,5722
subtest23of10,pubtest28of10,100,13085,5223,295,244,5762
subtest26of10,pubtest28of10,100,13085,5223,295,284,5802
subtest210of10,pubtest28of10,100,13085,5223,525,95,5843
subtest23of10,pubtest29of10,100,13081,5271,234,51,5556
subtest22of10,pubtest29of10,100,13081,5271,242,88,5601
subtest24of10,pubtest29of10,100,13081,5271,243,130,5644
subtest25of10,pubtest29of10,100,13081,5271,246,169,5686
subtest28of10,pubtest29of10,100,13081,5271,249,209,5729
subtest29of10,pubtest29of10,100,13081,5271,240,258,5769
subtest21of10,pubtest29of10,100,13081,5271,259,280,5810
subtest27of10,pubtest29of10,100,13081,5271,260,322,5853
subtest210of10,pubtest29of10,100,13081,5271,264,361,5896
subtest26of10,pubtest29of10,100,13081,5271,276,390,5937
subtest21of10,pubtest210of10,100,13188,5421,210,47,5678
subtest210of10,pubtest210of10,100,13188,5421,212,88,5721
subtest27of10,pubtest210of10,100,13188,5421,217,124,5762
subtest28of10,pubtest210of10,100,13188,5421,218,166,5805
subtest24of10,pubtest210of10,100,13188,5421,225,203,5849
subtest22of10,pubtest210of10,100,13188,5421,227,245,5893
subtest25of10,pubtest210of10,100,13188,5421,251,259,5931
subtest26of10,pubtest210of10,100,13188,5421,261,295,5977
subtest23of10,pubtest210of10,100,13188,5421,429,166,6016
subtest29of10,pubtest210of10,100,13188,5421,464,177,6062
subtest26of10,pubtest21of10,100,13081,10416,204,45,10665
subtest24of10,pubtest21of10,100,13081,10416,234,60,10710
subtest29of10,pubtest21of10,100,13081,10416,277,59,10752
subtest21of10,pubtest21of10,100,13081,10416,287,90,10793
subtest22of10,pubtest21of10,100,13081,10416,292,128,10836
subtest210of10,pubtest21of10,100,13081,10416,294,167,10877
subtest28of10,pubtest21of10,100,13081,10416,292,208,10916
subtest25of10,pubtest21of10,100,13081,10416,287,252,10955
subtest23of10,pubtest21of10,100,13081,10416,307,281,11004
subtest27of10,pubtest21of10,100,13081,10416,466,163,11045
subtest29of10,pubtest22of10,100,13083,5649,171,44,5864
subtest24of10,pubtest22of10,100,13083,5649,273,46,5968
subtest27of10,pubtest22of10,100,13083,5649,275,87,6011
subtest26of10,pubtest22of10,100,13083,5649,284,118,6051
subtest210of10,pubtest22of10,100,13083,5649,288,152,6089
subtest21of10,pubtest22of10,100,13083,5649,292,190,6131
subtest23of10,pubtest22of10,100,13083,5649,293,229,6171
subtest28of10,pubtest22of10,100,13083,5649,285,268,6202
subtest22of10,pubtest22of10,100,13083,5649,295,307,6251
subtest25of10,pubtest22of10,100,13083,5649,329,314,6292
subtest28of10,pubtest23of10,100,13082,5311,223,44,5578
subtest23of10,pubtest23of10,100,13082,5311,230,80,5621
subtest24of10,pubtest23of10,100,13082,5311,240,112,5663
subtest29of10,pubtest23of10,100,13082,5311,251,144,5706
subtest27of10,pubtest23of10,100,13082,5311,258,177,5746
subtest26of10,pubtest23of10,100,13082,5311,273,206,5790
subtest25of10,pubtest23of10,100,13082,5311,322,198,5831
subtest210of10,pubtest23of10,100,13082,5311,325,238,5874
subtest21of10,pubtest23of10,100,13082,5311,338,263,5912
subtest22of10,pubtest23of10,100,13082,5311,549,99,5959
subtest24of10,pubtest24of10,100,13085,5229,239,44,5512
subtest28of10,pubtest24of10,100,13085,5229,257,71,5557
subtest25of10,pubtest24of10,100,13085,5229,264,106,5599
subtest21of10,pubtest24of10,100,13085,5229,304,105,5638
subtest210of10,pubtest24of10,100,13085,5229,312,136,5677
subtest29of10,pubtest24of10,100,13085,5229,321,169,5719
subtest27of10,pubtest24of10,100,13085,5229,327,203,5759
subtest26of10,pubtest24of10,100,13085,5229,337,232,5798
subtest22of10,pubtest24of10,100,13085,5229,346,264,5839
subtest23of10,pubtest24of10,100,13085,5229,506,144,5879
subtest28of10,pubtest25of10,100,13082,5303,141,46,5490
subtest21of10,pubtest25of10,100,13082,5303,247,45,5595
subtest26of10,pubtest25of10,100,13082,5303,251,85,5639
subtest27of10,pubtest25of10,100,13082,5303,261,115,5679
subtest22of10,pubtest25of10,100,13082,5303,264,155,5722
subtest25of10,pubtest25of10,100,13082,5303,266,194,5763
subtest23of10,pubtest25of10,100,13082,5303,270,233,5806
subtest29of10,pubtest25of10,100,13082,5303,275,268,5846
subtest210of10,pubtest25of10,100,13082,5303,492,96,5891
subtest24of10,pubtest25of10,100,13082,5303,576,52,5931
subtest22of10,pubtest26of10,100,13075,5431,156,44,5631
subtest21of10,pubtest26of10,100,13075,5431,217,44,5692
subtest29of10,pubtest26of10,100,13075,5431,219,87,5737
subtest23of10,pubtest26of10,100,13075,5431,227,121,5779
subtest26of10,pubtest26of10,100,13075,5431,231,160,5822
subtest210of10,pubtest26of10,100,13075,5431,245,187,5863
subtest27of10,pubtest26of10,100,13075,5431,249,226,5906
subtest28of10,pubtest26of10,100,13075,5431,247,265,5943
subtest24of10,pubtest26of10,100,13075,5431,255,302,5988
subtest25of10,pubtest26of10,100,13075,5431,255,342,6028
subtest24of10,pubtest27of10,100,13083,5697,135,44,5876
subtest28of10,pubtest27of10,100,13083,5697,176,46,5919
subtest27of10,pubtest27of10,100,13083,5697,202,65,5964
subtest23of10,pubtest27of10,100,13083,5697,207,98,6002
subtest29of10,pubtest27of10,100,13083,5697,215,132,6044
subtest22of10,pubtest27of10,100,13083,5697,224,162,6083
subtest26of10,pubtest27of10,100,13083,5697,229,198,6124
subtest21of10,pubtest27of10,100,13083,5697,230,240,6167
subtest210of10,pubtest27of10,100,13083,5697,243,272,6212
subtest25of10,pubtest27of10,100,13083,5697,429,125,6251
subtest27of10,pubtest28of10,100,13085,5463,186,45,5694
subtest28of10,pubtest28of10,100,13085,5463,223,56,5742
subtest21of10,pubtest28of10,100,13085,5463,231,92,5786
subtest29of10,pubtest28of10,100,13085,5463,241,127,5831
subtest23of10,pubtest28of10,100,13085,5463,249,158,5870
subtest210of10,pubtest28of10,100,13085,5463,249,201,5913
subtest22of10,pubtest28of10,100,13085,5463,277,215,5955
subtest26of10,pubtest28of10,100,13085,5463,276,258,5997
subtest25of10,pubtest28of10,100,13085,5463,287,289,6039
subtest24of10,pubtest28of10,100,13085,5463,466,153,6082
subtest23of10,pubtest29of10,100,13081,5295,221,44,5560
subtest29of10,pubtest29of10,100,13081,5295,228,79,5602
subtest210of10,pubtest29of10,100,13081,5295,237,111,5643
subtest25of10,pubtest29of10,100,13081,5295,241,146,5682
subtest22of10,pubtest29of10,100,13081,5295,247,180,5722
subtest26of10,pubtest29of10,100,13081,5295,258,210,5763
subtest24of10,pubtest29of10,100,13081,5295,272,235,5802
subtest28of10,pubtest29of10,100,13081,5295,285,262,5842
subtest21of10,pubtest29of10,100,13081,5295,289,298,5882
subtest27of10,pubtest29of10,100,13081,5295,524,103,5922
subtest29of10,pubtest210of10,100,13188,5542,164,42,5748
subtest21of10,pubtest210of10,100,13188,5542,209,55,5806
subtest210of10,pubtest210of10,100,13188,5542,222,89,5853
subtest28of10,pubtest210of10,100,13188,5542,250,105,5897
subtest24of10,pubtest210of10,100,13188,5542,253,140,5935
subtest23of10,pubtest210of10,100,13188,5542,254,184,5980
subtest25of10,pubtest210of10,100,13188,5542,264,214,6020
subtest27of10,pubtest210of10,100,13188,5542,263,255,6060
subtest22of10,pubtest210of10,100,13188,5542,259,292,6093
subtest26of10,pubtest210of10,100,13188,5542,268,332,6142
subtest27of10,pubtest21of10,100,13081,10376,240,46,10662
subtest24of10,pubtest21of10,100,13081,10376,241,87,10704
subtest29of10,pubtest21of10,100,13081,10376,254,117,10747
subtest25of10,pubtest21of10,100,13081,10376,257,156,10789
subtest210of10,pubtest21of10,100,13081,10376,268,185,10829
subtest21of10,pubtest21of10,100,13081,10376,273,221,10870
subtest23of10,pubtest21of10,100,13081,10376,288,249,10913
subtest28of10,pubtest21of10,100,13081,10376,302,276,10954
subtest26of10,pubtest21of10,100,13081,10376,310,307,10993
subtest22of10,pubtest21of10,100,13081,10376,316,345,11037
subtest29of10,pubtest22of10,100,13083,5218,251,44,5513
subtest24of10,pubtest22of10,100,13083,5218,265,75,5558
subtest28of10,pubtest22of10,100,13083,5218,274,109,5601
subtest27of10,pubtest22of10,100,13083,5218,275,151,5644
subtest26of10,pubtest22of10,100,13083,5218,282,189,5689
subtest210of10,pubtest22of10,100,13083,5218,325,191,5734
subtest23of10,pubtest22of10,100,13083,5218,327,232,5777
subtest21of10,pubtest22of10,100,13083,5218,337,263,5818
subtest22of10,pubtest22of10,100,13083,5218,371,268,5857
subtest25of10,pubtest22of10,100,13083,5218,390,289,5897
subtest23of10,pubtest23of10,100,13082,5362,270,45,5677
subtest29of10,pubtest23of10,100,13082,5362,280,77,5719
subtest27of10,pubtest23of10,100,13082,5362,282,119,5763
subtest25of10,pubtest23of10,100,13082,5362,300,142,5804
subtest21of10,pubtest23of10,100,13082,5362,303,175,5840
subtest24of10,pubtest23of10,100,13082,5362,308,213,5883
subtest28of10,pubtest23of10,100,13082,5362,304,252,5918
subtest26of10,pubtest23of10,100,13082,5362,325,277,5964
subtest22of10,pubtest23of10,100,13082,5362,339,303,6004
subtest210of10,pubtest23of10,100,13082,5362,360,321,6043
subtest23of10,pubtest24of10,100,13085,5597,92,44,5733
subtest22of10,pubtest24of10,100,13085,5597,187,42,5826
subtest24of10,pubtest24of10,100,13085,5597,309,43,5949
subtest21of10,pubtest24of10,100,13085,5597,316,80,5993
subtest28of10,pubtest24of10,100,13085,5597,312,123,6032
subtest210of10,pubtest24of10,100,13085,5597,318,163,6078
subtest25of10,pubtest24of10,100,13085,5597,325,204,6126
subtest26of10,pubtest24of10,100,13085,5597,345,223,6165
subtest27of10,pubtest24of10,100,13085,5597,348,260,6205
subtest29of10,pubtest24of10,100,13085,5597,1105,43,6745
subtest28of10,pubtest25of10,100,13082,6083,174,43,6300
subtest210of10,pubtest25of10,100,13082,6083,215,47,6345
subtest21of10,pubtest25of10,100,13082,6083,226,81,6390
subtest26of10,pubtest25of10,100,13082,6083,231,119,6433
subtest27of10,pubtest25of10,100,13082,6083,238,153,6474
subtest22of10,pubtest25of10,100,13082,6083,242,192,6517
subtest25of10,pubtest25of10,100,13082,6083,257,217,6557
subtest23of10,pubtest25of10,100,13082,6083,259,260,6602
subtest24of10,pubtest25of10,100,13082,6083,265,293,6641
subtest29of10,pubtest25of10,100,13082,6083,278,325,6686
subtest22of10,pubtest26of10,100,13075,5263,230,194,5687
subtest29of10,pubtest26of10,100,13075,5263,238,228,5729
subtest23of10,pubtest26of10,100,13075,5263,243,266,5772
subtest26of10,pubtest26of10,100,13075,5263,243,307,5813
subtest210of10,pubtest26of10,100,13075,5263,250,340,5853
subtest28of10,pubtest26of10,100,13075,5263,277,352,5892
subtest24of10,pubtest26of10,100,13075,5263,282,389,5934
subtest25of10,pubtest26of10,100,13075,5263,284,431,5978
subtest27of10,pubtest26of10,100,13075,5263,530,225,6018
subtest21of10,pubtest26of10,100,13075,5263,543,251,6057
subtest27of10,pubtest27of10,100,13083,5456,218,50,5724
subtest24of10,pubtest27of10,100,13083,5456,221,91,5768
subtest23of10,pubtest27of10,100,13083,5456,226,129,5811
subtest29of10,pubtest27of10,100,13083,5456,239,159,5854
subtest210of10,pubtest27of10,100,13083,5456,247,193,5896
subtest21of10,pubtest27of10,100,13083,5456,276,208,5940
subtest28of10,pubtest27of10,100,13083,5456,463,61,5980
subtest25of10,pubtest27of10,100,13083,5456,533,43,6032
subtest26of10,pubtest27of10,100,13083,5456,541,75,6072
subtest22of10,pubtest27of10,100,13083,5456,553,105,6114
subtest27of10,pubtest28of10,100,13085,5227,103,44,5374
subtest21of10,pubtest28of10,100,13085,5227,204,42,5473
subtest28of10,pubtest28of10,100,13085,5227,207,83,5517
subtest29of10,pubtest28of10,100,13085,5227,211,123,5561
subtest210of10,pubtest28of10,100,13085,5227,229,146,5602
subtest23of10,pubtest28of10,100,13085,5227,247,170,5644
subtest22of10,pubtest28of10,100,13085,5227,255,203,5685
subtest24of10,pubtest28of10,100,13085,5227,252,243,5722
subtest25of10,pubtest28of10,100,13085,5227,270,266,5763
subtest26of10,pubtest28of10,100,13085,5227,270,306,5803
subtest29of10,pubtest29of10,100,13081,5538,231,48,5817
subtest25of10,pubtest29of10,100,13081,5538,234,89,5861
subtest21of10,pubtest29of10,100,13081,5538,250,112,5900
subtest27of10,pubtest29of10,100,13081,5538,255,152,5945
subtest210of10,pubtest29of10,100,13081,5538,260,189,5987
subtest26of10,pubtest29of10,100,13081,5538,259,232,6029
subtest24of10,pubtest29of10,100,13081,5538,263,272,6073
subtest23of10,pubtest29of10,100,13081,5538,507,73,6118
subtest22of10,pubtest29of10,100,13081,5538,520,104,6162
subtest28of10,pubtest29of10,100,13081,5538,536,127,6201
subtest29of10,pubtest210of10,100,13188,5305,103,44,5452
subtest21of10,pubtest210of10,100,13188,5305,143,48,5496
subtest27of10,pubtest210of10,100,13188,5305,178,57,5540
subtest22of10,pubtest210of10,100,13188,5305,196,82,5583
subtest23of10,pubtest210of10,100,13188,5305,204,119,5628
subtest25of10,pubtest210of10,100,13188,5305,203,162,5670
subtest26of10,pubtest210of10,100,13188,5305,198,202,5705
subtest28of10,pubtest210of10,100,13188,5305,191,247,5743
subtest210of10,pubtest210of10,100,13188,5305,221,266,5792
subtest24of10,pubtest210of10,100,13188,5305,223,303,5831
subtest26of10,pubtest21of10,100,13081,10478,118,43,10639
subtest22of10,pubtest21of10,100,13081,10478,165,42,10685
subtest25of10,pubtest21of10,100,13081,10478,177,71,10726
subtest28of10,pubtest21of10,100,13081,10478,178,114,10770
subtest24of10,pubtest21of10,100,13081,10478,181,151,10810
subtest27of10,pubtest21of10,100,13081,10478,171,193,10842
subtest210of10,pubtest21of10,100,13081,10478,184,232,10894
subtest29of10,pubtest21of10,100,13081,10478,172,276,10926
subtest21of10,pubtest21of10,100,13081,10478,191,309,10978
subtest23of10,pubtest21of10,100,13081,10478,202,343,11023
subtest29of10,pubtest22of10,100,13083,5249,198,41,5488
subtest27of10,pubtest22of10,100,13083,5249,211,74,5534
subtest28of10,pubtest22of10,100,13083,5249,218,106,5573
subtest26of10,pubtest22of10,100,13083,5249,221,147,5617
subtest210of10,pubtest22of10,100,13083,5249,222,186,5657
subtest22of10,pubtest22of10,100,13083,5249,235,217,5701
subtest25of10,pubtest22of10,100,13083,5249,235,261,5745
subtest23of10,pubtest22of10,100,13083,5249,230,304,5783
subtest21of10,pubtest22of10,100,13083,5249,411,173,5833
subtest24of10,pubtest22of10,100,13083,5249,466,161,5876
subtest23of10,pubtest23of10,100,13082,5230,185,45,5460
subtest29of10,pubtest23of10,100,13082,5230,222,47,5499
subtest28of10,pubtest23of10,100,13082,5230,222,87,5539
subtest24of10,pubtest23of10,100,13082,5230,235,114,5579
subtest27of10,pubtest23of10,100,13082,5230,241,149,5620
subtest25of10,pubtest23of10,100,13082,5230,243,193,5666
subtest22of10,pubtest23of10,100,13082,5230,253,224,5707
subtest210of10,pubtest23of10,100,13082,5230,262,256,5748
subtest26of10,pubtest23of10,100,13082,5230,276,284,5790
subtest21of10,pubtest23of10,100,13082,5230,282,324,5836
subtest24of10,pubtest24of10,100,13085,6249,196,42,6487
subtest28of10,pubtest24of10,100,13085,6249,209,72,6530
subtest22of10,pubtest24of10,100,13085,6249,217,109,6575
subtest25of10,pubtest24of10,100,13085,6249,219,150,6618
subtest210of10,pubtest24of10,100,13085,6249,226,184,6659
subtest21of10,pubtest24of10,100,13085,6249,246,203,6698
subtest26of10,pubtest24of10,100,13085,6249,255,238,6742
subtest23of10,pubtest24of10,100,13085,6249,466,72,6787
subtest29of10,pubtest24of10,100,13085,6249,509,73,6831
subtest27of10,pubtest24of10,100,13085,6249,560,66,6875
subtest28of10,pubtest25of10,100,13082,5364,198,46,5608
subtest210of10,pubtest25of10,100,13082,5364,226,63,5653
subtest21of10,pubtest25of10,100,13082,5364,233,98,5695
subtest22of10,pubtest25of10,100,13082,5364,237,140,5741
subtest23of10,pubtest25of10,100,13082,5364,241,180,5785
subtest29of10,pubtest25of10,100,13082,5364,244,217,5825
subtest25of10,pubtest25of10,100,13082,5364,260,245,5869
subtest27of10,pubtest25of10,100,13082,5364,265,281,5910
subtest24of10,pubtest25of10,100,13082,5364,466,124,5954
subtest26of10,pubtest25of10,100,13082,5364,500,134,5998
subtest29of10,pubtest26of10,100,13075,5492,210,45,5747
subtest21of10,pubtest26of10,100,13075,5492,238,59,5789
subtest22of10,pubtest26of10,100,13075,5492,248,89,5829
subtest27of10,pubtest26of10,100,13075,5492,277,103,5872
subtest23of10,pubtest26of10,100,13075,5492,313,108,5913
subtest26of10,pubtest26of10,100,13075,5492,316,143,5951
subtest210of10,pubtest26of10,100,13075,5492,317,182,5991
subtest25of10,pubtest26of10,100,13075,5492,332,210,6034
subtest24of10,pubtest26of10,100,13075,5492,341,241,6074
subtest28of10,pubtest26of10,100,13075,5492,565,56,6113
subtest28of10,pubtest27of10,100,13083,5727,204,44,5975
subtest27of10,pubtest27of10,100,13083,5727,216,75,6018
subtest23of10,pubtest27of10,100,13083,5727,241,95,6063
subtest24of10,pubtest27of10,100,13083,5727,246,134,6107
subtest29of10,pubtest27of10,100,13083,5727,269,152,6148
subtest26of10,pubtest27of10,100,13083,5727,281,180,6188
subtest25of10,pubtest27of10,100,13083,5727,279,219,6225
subtest21of10,pubtest27of10,100,13083,5727,282,256,6265
subtest210of10,pubtest27of10,100,13083,5727,276,304,6307
subtest22of10,pubtest27of10,100,13083,5727,300,321,6348
subtest28of10,pubtest28of10,100,13085,7522,286,43,7851
subtest210of10,pubtest28of10,100,13085,7522,290,85,7897
subtest21of10,pubtest28of10,100,13085,7522,286,126,7934
subtest29of10,pubtest28of10,100,13085,7522,287,165,7974
subtest23of10,pubtest28of10,100,13085,7522,297,211,8030
subtest24of10,pubtest28of10,100,13085,7522,304,248,8074
subtest22of10,pubtest28of10,100,13085,7522,516,78,8116
subtest25of10,pubtest28of10,100,13085,7522,547,89,8158
subtest27of10,pubtest28of10,100,13085,7522,580,98,8200
subtest26of10,pubtest28of10,100,13085,7522,601,117,8240
subtest210of10,pubtest29of10,100,13081,5576,205,58,5839
subtest23of10,pubtest29of10,100,13081,5576,208,95,5879
subtest28of10,pubtest29of10,100,13081,5576,211,132,5919
subtest29of10,pubtest29of10,100,13081,5576,212,170,5958
subtest25of10,pubtest29of10,100,13081,5576,216,206,5998
subtest22of10,pubtest29of10,100,13081,5576,208,247,6031
subtest21of10,pubtest29of10,100,13081,5576,217,287,6080
subtest27of10,pubtest29of10,100,13081,5576,227,321,6124
subtest24of10,pubtest29of10,100,13081,5576,230,357,6163
subtest26of10,pubtest29of10,100,13081,5576,244,383,6203
subtest29of10,pubtest210of10,100,13188,7396,194,44,7634
subtest21of10,pubtest210of10,100,13188,7396,301,45,7742
subtest210of10,pubtest210of10,100,13188,7396,310,81,7787
subtest27of10,pubtest210of10,100,13188,7396,311,123,7830
subtest25of10,pubtest210of10,100,13188,7396,330,149,7875
subtest22of10,pubtest210of10,100,13188,7396,357,165,7918
subtest23of10,pubtest210of10,100,13188,7396,363,198,7957
subtest26of10,pubtest210of10,100,13188,7396,385,217,7998
subtest24of10,pubtest210of10,100,13188,7396,403,243,8042
subtest28of10,pubtest210of10,100,13188,7396,627,63,8086
subtest27of10,pubtest21of10,100,13081,11668,259,46,11973
subtest29of10,pubtest21of10,100,13081,11668,276,68,12012
subtest25of10,pubtest21of10,100,13081,11668,279,112,12059
subtest24of10,pubtest21of10,100,13081,11668,276,150,12094
subtest21of10,pubtest21of10,100,13081,11668,301,173,12142
subtest210of10,pubtest21of10,100,13081,11668,305,209,12182
subtest23of10,pubtest21of10,100,13081,11668,317,238,12223
subtest28of10,pubtest21of10,100,13081,11668,334,258,12260
subtest22of10,pubtest21of10,100,13081,11668,342,293,12303
subtest26of10,pubtest21of10,100,13081,11668,548,127,12343
subtest29of10,pubtest22of10,100,13083,5645,170,44,5859
subtest24of10,pubtest22of10,100,13083,5645,240,44,5929
subtest27of10,pubtest22of10,100,13083,5645,281,49,5975
subtest28of10,pubtest22of10,100,13083,5645,283,90,6018
subtest25of10,pubtest22of10,100,13083,5645,293,125,6063
subtest23of10,pubtest22of10,100,13083,5645,296,161,6102
subtest210of10,pubtest22of10,100,13083,5645,290,198,6133
subtest21of10,pubtest22of10,100,13083,5645,296,238,6179
subtest26of10,pubtest22of10,100,13083,5645,331,246,6222
subtest22of10,pubtest22of10,100,13083,5645,352,265,6262
subtest23of10,pubtest23of10,100,13082,5222,190,203,5615
subtest28of10,pubtest23of10,100,13082,5222,202,232,5656
subtest29of10,pubtest23of10,100,13082,5222,209,266,5697
subtest24of10,pubtest23of10,100,13082,5222,211,303,5736
subtest25of10,pubtest23of10,100,13082,5222,217,341,5780
subtest210of10,pubtest23of10,100,13082,5222,233,367,5822
subtest21of10,pubtest23of10,100,13082,5222,252,388,5862
subtest22of10,pubtest23of10,100,13082,5222,266,415,5903
subtest26of10,pubtest23of10,100,13082,5222,497,227,5946
subtest27of10,pubtest23of10,100,13082,5222,501,263,5986
subtest23of10,pubtest24of10,100,13085,5141,182,179,5502
subtest24of10,pubtest24of10,100,13085,5141,183,216,5540
subtest25of10,pubtest24of10,100,13085,5141,197,244,5582
subtest22of10,pubtest24of10,100,13085,5141,202,283,5626
subtest28of10,pubtest24of10,100,13085,5141,200,325,5666
subtest21of10,pubtest24of10,100,13085,5141,205,360,5706
subtest29of10,pubtest24of10,100,13085,5141,211,395,5747
subtest27of10,pubtest24of10,100,13085,5141,232,413,5786
subtest26of10,pubtest24of10,100,13085,5141,232,456,5829
subtest210of10,pubtest24of10,100,13085,5141,475,257,5873
subtest28of10,pubtest25of10,100,13082,5193,179,43,5415
subtest21of10,pubtest25of10,100,13082,5193,256,45,5494
subtest26of10,pubtest25of10,100,13082,5193,261,82,5536
subtest27of10,pubtest25of10,100,13082,5193,268,119,5580
subtest22of10,pubtest25of10,100,13082,5193,271,157,5621
subtest25of10,pubtest25of10,100,13082,5193,275,190,5658
subtest24of10,pubtest25of10,100,13082,5193,278,228,5699
subtest23of10,pubtest25of10,100,13082,5193,297,250,5740
subtest29of10,pubtest25of10,100,13082,5193,299,288,5780
subtest210of10,pubtest25of10,100,13082,5193,560,71,5824
subtest21of10,pubtest26of10,100,13075,5105,139,46,5290
subtest22of10,pubtest26of10,100,13075,5105,164,65,5334
subtest23of10,pubtest26of10,100,13075,5105,210,65,5380
subtest26of10,pubtest26of10,100,13075,5105,214,109,5428
subtest27of10,pubtest26of10,100,13075,5105,220,144,5469
subtest28of10,pubtest26of10,100,13075,5105,218,186,5509
subtest24of10,pubtest26of10,100,13075,5105,223,221,5549
subtest29of10,pubtest26of10,100,13075,5105,231,251,5587
subtest210of10,pubtest26of10,100,13075,5105,236,288,5629
subtest25of10,pubtest26of10,100,13075,5105,251,314,5670
subtest27of10,pubtest27of10,100,13083,5244,208,45,5497
subtest23of10,pubtest27of10,100,13083,5244,235,58,5537
subtest24of10,pubtest27of10,100,13083,5244,248,90,5582
subtest25of10,pubtest27of10,100,13083,5244,266,111,5621
subtest22of10,pubtest27of10,100,13083,5244,269,148,5661
subtest29of10,pubtest27of10,100,13083,5244,305,152,5701
subtest210of10,pubtest27of10,100,13083,5244,310,188,5742
subtest21of10,pubtest27of10,100,13083,5244,325,212,5781
subtest26of10,pubtest27of10,100,13083,5244,332,244,5820
subtest28of10,pubtest27of10,100,13083,5244,466,151,5861
subtest27of10,pubtest28of10,100,13085,5403,121,42,5566
subtest21of10,pubtest28of10,100,13085,5403,183,44,5630
subtest210of10,pubtest28of10,100,13085,5403,218,51,5672
subtest23of10,pubtest28of10,100,13085,5403,237,77,5717
subtest26of10,pubtest28of10,100,13085,5403,245,109,5757
subtest25of10,pubtest28of10,100,13085,5403,246,152,5801
subtest22of10,pubtest28of10,100,13085,5403,255,188,5846
subtest24of10,pubtest28of10,100,13085,5403,264,221,5888
subtest28of10,pubtest28of10,100,13085,5403,519,44,5966
subtest29of10,pubtest28of10,100,13085,5403,532,75,6010
subtest23of10,pubtest29of10,100,13081,5208,269,105,5582
subtest25of10,pubtest29of10,100,13081,5208,274,101,5583
subtest29of10,pubtest29of10,100,13081,5208,274,132,5614
subtest210of10,pubtest29of10,100,13081,5208,277,170,5655
subtest22of10,pubtest29of10,100,13081,5208,283,206,5697
subtest28of10,pubtest29of10,100,13081,5208,287,243,5738
subtest21of10,pubtest29of10,100,13081,5208,292,278,5778
subtest24of10,pubtest29of10,100,13081,5208,292,318,5818
subtest27of10,pubtest29of10,100,13081,5208,299,351,5858
subtest26of10,pubtest29of10,100,13081,5208,302,314,5824
subtest29of10,pubtest210of10,100,13188,5139,282,44,5465
subtest21of10,pubtest210of10,100,13188,5139,298,73,5510
subtest27of10,pubtest210of10,100,13188,5139,331,78,5548
subtest22of10,pubtest210of10,100,13188,5139,337,121,5597
subtest26of10,pubtest210of10,100,13188,5139,374,128,5641
subtest25of10,pubtest210of10,100,13188,5139,378,169,5686
subtest28of10,pubtest210of10,100,13188,5139,372,212,5723
subtest210of10,pubtest210of10,100,13188,5139,571,62,5772
subtest24of10,pubtest210of10,100,13188,5139,578,101,5818
subtest23of10,pubtest210of10,100,13188,5139,600,118,5857
subtest26of10,pubtest21of10,100,13081,10815,365,44,11224
subtest24of10,pubtest21of10,100,13081,10815,414,42,11271
subtest29of10,pubtest21of10,100,13081,10815,419,80,11314
subtest25of10,pubtest21of10,100,13081,10815,427,112,11354
subtest21of10,pubtest21of10,100,13081,10815,431,154,11400
subtest28of10,pubtest21of10,100,13081,10815,445,183,11443
subtest22of10,pubtest21of10,100,13081,10815,447,221,11483
subtest27of10,pubtest21of10,100,13081,10815,461,251,11527
subtest210of10,pubtest21of10,100,13081,10815,507,245,11567
subtest23of10,pubtest21of10,100,13081,10815,522,274,11611
subtest24of10,pubtest22of10,100,13083,5063,176,44,5283
subtest29of10,pubtest22of10,100,13083,5063,217,46,5326
subtest28of10,pubtest22of10,100,13083,5063,285,45,5393
subtest26of10,pubtest22of10,100,13083,5063,312,61,5436
subtest23of10,pubtest22of10,100,13083,5063,323,92,5478
subtest21of10,pubtest22of10,100,13083,5063,332,123,5518
subtest25of10,pubtest22of10,100,13083,5063,360,139,5562
subtest27of10,pubtest22of10,100,13083,5063,362,176,5601
subtest210of10,pubtest22of10,100,13083,5063,473,106,5642
subtest22of10,pubtest22of10,100,13083,5063,601,42,5706
subtest23of10,pubtest23of10,100,13082,5375,175,48,5598
subtest29of10,pubtest23of10,100,13082,5375,188,77,5640
subtest24of10,pubtest23of10,100,13082,5375,188,119,5682
subtest25of10,pubtest23of10,100,13082,5375,191,158,5724
subtest26of10,pubtest23of10,100,13082,5375,201,192,5768
subtest21of10,pubtest23of10,100,13082,5375,210,224,5809
subtest210of10,pubtest23of10,100,13082,5375,213,264,5852
subtest27of10,pubtest23of10,100,13082,5375,222,299,5896
subtest22of10,pubtest23of10,100,13082,5375,222,339,5936
subtest28of10,pubtest23of10,100,13082,5375,434,171,5980
subtest23of10,pubtest24of10,100,13085,5462,148,56,5666
subtest24of10,pubtest24of10,100,13085,5462,151,96,5709
subtest22of10,pubtest24of10,100,13085,5462,184,105,5751
subtest21of10,pubtest24of10,100,13085,5462,191,141,5794
subtest210of10,pubtest24of10,100,13085,5462,195,182,5839
subtest25of10,pubtest24of10,100,13085,5462,190,220,5872
subtest27of10,pubtest24of10,100,13085,5462,197,260,5919
subtest26of10,pubtest24of10,100,13085,5462,200,300,5962
subtest29of10,pubtest24of10,100,13085,5462,202,342,6006
subtest28of10,pubtest24of10,100,13085,5462,451,133,6046
subtest28of10,pubtest25of10,100,13082,5197,128,44,5369
subtest210of10,pubtest25of10,100,13082,5197,174,46,5417
subtest26of10,pubtest25of10,100,13082,5197,200,59,5456
subtest22of10,pubtest25of10,100,13082,5197,204,95,5496
subtest29of10,pubtest25of10,100,13082,5197,225,116,5538
subtest23of10,pubtest25of10,100,13082,5197,231,156,5584
subtest24of10,pubtest25of10,100,13082,5197,231,196,5624
subtest25of10,pubtest25of10,100,13082,5197,221,235,5653
subtest27of10,pubtest25of10,100,13082,5197,236,276,5709
subtest21of10,pubtest25of10,100,13082,5197,460,96,5753
subtest21of10,pubtest26of10,100,13075,5236,110,47,5393
subtest22of10,pubtest26of10,100,13075,5236,155,44,5435
subtest29of10,pubtest26of10,100,13075,5236,161,83,5480
subtest26of10,pubtest26of10,100,13075,5236,171,118,5525
subtest28of10,pubtest26of10,100,13075,5236,188,144,5568
subtest27of10,pubtest26of10,100,13075,5236,194,183,5613
subtest24of10,pubtest26of10,100,13075,5236,196,224,5656
subtest25of10,pubtest26of10,100,13075,5236,213,248,5697
subtest23of10,pubtest26of10,100,13075,5236,426,79,5741
subtest210of10,pubtest26of10,100,13075,5236,441,106,5783
subtest28of10,pubtest27of10,100,13083,5207,144,45,5396
subtest27of10,pubtest27of10,100,13083,5207,191,44,5442
subtest24of10,pubtest27of10,100,13083,5207,211,63,5481
subtest29of10,pubtest27of10,100,13083,5207,241,73,5521
subtest25of10,pubtest27of10,100,13083,5207,269,89,5565
subtest22of10,pubtest27of10,100,13083,5207,272,127,5606
subtest26of10,pubtest27of10,100,13083,5207,273,167,5647
subtest23of10,pubtest27of10,100,13083,5207,282,198,5687
subtest210of10,pubtest27of10,100,13083,5207,306,214,5727
subtest21of10,pubtest27of10,100,13083,5207,537,45,5789
subtest27of10,pubtest28of10,100,13085,5215,159,51,5425
subtest28of10,pubtest28of10,100,13085,5215,175,76,5466
subtest29of10,pubtest28of10,100,13085,5215,178,114,5507
subtest210of10,pubtest28of10,100,13085,5215,193,138,5546
subtest23of10,pubtest28of10,100,13085,5215,202,169,5586
subtest25of10,pubtest28of10,100,13085,5215,206,205,5626
subtest22of10,pubtest28of10,100,13085,5215,212,239,5666
subtest21of10,pubtest28of10,100,13085,5215,216,275,5706
subtest26of10,pubtest28of10,100,13085,5215,221,310,5746
subtest24of10,pubtest28of10,100,13085,5215,222,352,5789
subtest23of10,pubtest29of10,100,13081,5213,167,47,5427
subtest29of10,pubtest29of10,100,13081,5213,167,92,5472
subtest25of10,pubtest29of10,100,13081,5213,174,125,5512
subtest22of10,pubtest29of10,100,13081,5213,179,161,5553
subtest210of10,pubtest29of10,100,13081,5213,178,199,5590
subtest24of10,pubtest29of10,100,13081,5213,182,238,5633
subtest21of10,pubtest29of10,100,13081,5213,188,272,5673
subtest27of10,pubtest29of10,100,13081,5213,190,308,5711
subtest26of10,pubtest29of10,100,13081,5213,204,336,5753
subtest28of10,pubtest29of10,100,13081,5213,204,379,5796
subtest29of10,pubtest210of10,100,13188,5304,178,47,5529
subtest21of10,pubtest210of10,100,13188,5304,202,69,5575
subtest210of10,pubtest210of10,100,13188,5304,218,97,5619
subtest27of10,pubtest210of10,100,13188,5304,220,136,5660
subtest28of10,pubtest210of10,100,13188,5304,224,173,5701
subtest23of10,pubtest210of10,100,13188,5304,241,195,5740
subtest24of10,pubtest210of10,100,13188,5304,251,225,5780
subtest22of10,pubtest210of10,100,13188,5304,255,262,5821
subtest25of10,pubtest210of10,100,13188,5304,263,294,5861
subtest26of10,pubtest210of10,100,13188,5304,271,326,5901
subtest26of10,pubtest21of10,100,13081,10584,144,46,10774
subtest27of10,pubtest21of10,100,13081,10584,153,81,10818
subtest24of10,pubtest21of10,100,13081,10584,164,114,10862
subtest29of10,pubtest21of10,100,13081,10584,165,152,10901
subtest25of10,pubtest21of10,100,13081,10584,180,177,10941
subtest21of10,pubtest21of10,100,13081,10584,183,212,10979
subtest210of10,pubtest21of10,100,13081,10584,184,252,11020
subtest28of10,pubtest21of10,100,13081,10584,189,292,11065
subtest23of10,pubtest21of10,100,13081,10584,204,321,11109
subtest22of10,pubtest21of10,100,13081,10584,215,349,11148
subtest29of10,pubtest22of10,100,13083,5191,148,42,5381
subtest24of10,pubtest22of10,100,13083,5191,220,43,5454
subtest28of10,pubtest22of10,100,13083,5191,226,80,5497
subtest27of10,pubtest22of10,100,13083,5191,242,106,5539
subtest25of10,pubtest22of10,100,13083,5191,271,122,5584
subtest210of10,pubtest22of10,100,13083,5191,269,166,5626
subtest23of10,pubtest22of10,100,13083,5191,275,204,5670
subtest21of10,pubtest22of10,100,13083,5191,464,61,5716
subtest26of10,pubtest22of10,100,13083,5191,517,54,5762
subtest22of10,pubtest22of10,100,13083,5191,527,87,5805
subtest28of10,pubtest23of10,100,13082,5201,180,45,5426
subtest23of10,pubtest23of10,100,13082,5201,196,65,5462
subtest27of10,pubtest23of10,100,13082,5201,199,105,5505
subtest24of10,pubtest23of10,100,13082,5201,199,145,5545
subtest29of10,pubtest23of10,100,13082,5201,203,186,5590
subtest26of10,pubtest23of10,100,13082,5201,236,192,5629
subtest25of10,pubtest23of10,100,13082,5201,234,239,5674
subtest22of10,pubtest23of10,100,13082,5201,240,272,5713
subtest21of10,pubtest23of10,100,13082,5201,240,316,5757
subtest210of10,pubtest23of10,100,13082,5201,413,182,5796
subtest23of10,pubtest24of10,100,13085,5282,263,46,5591
subtest28of10,pubtest24of10,100,13085,5282,265,87,5634
subtest22of10,pubtest24of10,100,13085,5282,275,117,5674
subtest26of10,pubtest24of10,100,13085,5282,299,134,5715
subtest29of10,pubtest24of10,100,13085,5282,319,154,5755
subtest210of10,pubtest24of10,100,13085,5282,318,193,5793
subtest27of10,pubtest24of10,100,13085,5282,325,228,5835
subtest25of10,pubtest24of10,100,13085,5282,563,46,5891
subtest21of10,pubtest24of10,100,13085,5282,566,83,5931
subtest24of10,pubtest24of10,100,13085,5282,577,111,5970
subtest28of10,pubtest25of10,100,13082,6020,263,46,6329
subtest210of10,pubtest25of10,100,13082,6020,289,66,6375
subtest26of10,pubtest25of10,100,13082,6020,302,99,6421
subtest27of10,pubtest25of10,100,13082,6020,310,132,6462
subtest22of10,pubtest25of10,100,13082,6020,321,165,6506
subtest23of10,pubtest25of10,100,13082,6020,323,213,6556
subtest24of10,pubtest25of10,100,13082,6020,340,237,6597
subtest21of10,pubtest25of10,100,13082,6020,353,264,6637
subtest25of10,pubtest25of10,100,13082,6020,356,300,6676
subtest29of10,pubtest25of10,100,13082,6020,359,341,6720
subtest21of10,pubtest26of10,100,13075,5687,143,46,5876
subtest22of10,pubtest26of10,100,13075,5687,192,46,5925
subtest23of10,pubtest26of10,100,13075,5687,196,82,5965
subtest27of10,pubtest26of10,100,13075,5687,208,115,6010
subtest210of10,pubtest26of10,100,13075,5687,207,155,6049
subtest24of10,pubtest26of10,100,13075,5687,212,195,6094
subtest25of10,pubtest26of10,100,13075,5687,215,235,6137
subtest29of10,pubtest26of10,100,13075,5687,217,277,6181
subtest28of10,pubtest26of10,100,13075,5687,228,311,6226
subtest26of10,pubtest26of10,100,13075,5687,491,91,6269
subtest23of10,pubtest27of10,100,13083,5124,190,45,5359
subtest29of10,pubtest27of10,100,13083,5124,209,69,5402
subtest25of10,pubtest27of10,100,13083,5124,215,103,5442
subtest22of10,pubtest27of10,100,13083,5124,222,137,5483
subtest28of10,pubtest27of10,100,13083,5124,233,168,5525
subtest24of10,pubtest27of10,100,13083,5124,246,201,5571
subtest26of10,pubtest27of10,100,13083,5124,251,235,5610
subtest21of10,pubtest27of10,100,13083,5124,260,270,5654
subtest27of10,pubtest27of10,100,13083,5124,432,142,5698
subtest210of10,pubtest27of10,100,13083,5124,483,131,5738
subtest27of10,pubtest28of10,100,13085,5067,176,44,5287
subtest28of10,pubtest28of10,100,13085,5067,222,43,5332
subtest23of10,pubtest28of10,100,13085,5067,241,66,5374
subtest26of10,pubtest28of10,100,13085,5067,245,101,5413
subtest25of10,pubtest28of10,100,13085,5067,245,142,5454
subtest24of10,pubtest28of10,100,13085,5067,252,180,5499
subtest22of10,pubtest28of10,100,13085,5067,257,217,5541
subtest210of10,pubtest28of10,100,13085,5067,263,250,5580
subtest21of10,pubtest28of10,100,13085,5067,542,41,5650
subtest29of10,pubtest28of10,100,13085,5067,552,76,5695
subtest25of10,pubtest29of10,100,13081,5116,350,187,5653
subtest210of10,pubtest29of10,100,13081,5116,368,210,5694
subtest24of10,pubtest29of10,100,13081,5116,380,239,5735
subtest21of10,pubtest29of10,100,13081,5116,380,284,5780
subtest26of10,pubtest29of10,100,13081,5116,400,307,5823
subtest28of10,pubtest29of10,100,13081,5116,413,333,5862
subtest29of10,pubtest29of10,100,13081,5116,753,42,5911
subtest22of10,pubtest29of10,100,13081,5116,763,75,5954
subtest23of10,pubtest29of10,100,13081,5116,775,106,5997
subtest27of10,pubtest29of10,100,13081,5116,833,94,6043
subtest21of10,pubtest210of10,100,13188,5470,256,54,5780
subtest210of10,pubtest210of10,100,13188,5470,258,100,5828
subtest28of10,pubtest210of10,100,13188,5470,263,136,5869
subtest24of10,pubtest210of10,100,13188,5470,269,170,5909
subtest26of10,pubtest210of10,100,13188,5470,278,201,5949
subtest25of10,pubtest210of10,100,13188,5470,304,215,5989
subtest29of10,pubtest210of10,100,13188,5470,307,251,6028
subtest27of10,pubtest210of10,100,13188,5470,307,291,6068
subtest23of10,pubtest210of10,100,13188,5470,313,329,6112
subtest22of10,pubtest210of10,100,13188,5470,313,368,6151
subtest26of10,pubtest21of10,100,13081,10717,132,43,10892
subtest27of10,pubtest21of10,100,13081,10717,272,43,11032
subtest24of10,pubtest21of10,100,13081,10717,274,81,11072
subtest29of10,pubtest21of10,100,13081,10717,288,112,11117
subtest21of10,pubtest21of10,100,13081,10717,300,144,11161
subtest25of10,pubtest21of10,100,13081,10717,299,184,11200
subtest210of10,pubtest21of10,100,13081,10717,304,221,11242
subtest28of10,pubtest21of10,100,13081,10717,341,227,11285
subtest22of10,pubtest21of10,100,13081,10717,347,263,11327
subtest23of10,pubtest21of10,100,13081,10717,348,302,11367
subtest24of10,pubtest22of10,100,13083,5505,277,298,6080
subtest27of10,pubtest22of10,100,13083,5505,294,326,6125
subtest26of10,pubtest22of10,100,13083,5505,313,351,6169
subtest210of10,pubtest22of10,100,13083,5505,325,379,6209
subtest21of10,pubtest22of10,100,13083,5505,376,371,6252
subtest28of10,pubtest22of10,100,13083,5505,386,402,6293
subtest23of10,pubtest22of10,100,13083,5505,401,427,6333
subtest22of10,pubtest22of10,100,13083,5505,411,454,6370
subtest29of10,pubtest22of10,100,13083,5505,636,275,6416
subtest25of10,pubtest22of10,100,13083,5505,640,311,6456
subtest23of10,pubtest23of10,100,13082,5162,223,45,5430
subtest28of10,pubtest23of10,100,13082,5162,249,58,5469
subtest29of10,pubtest23of10,100,13082,5162,256,98,5516
subtest24of10,pubtest23of10,100,13082,5162,256,137,5555
subtest27of10,pubtest23of10,100,13082,5162,275,162,5599
subtest22of10,pubtest23of10,100,13082,5162,302,179,5643
subtest210of10,pubtest23of10,100,13082,5162,321,204,5687
subtest25of10,pubtest23of10,100,13082,5162,329,235,5726
subtest21of10,pubtest23of10,100,13082,5162,591,43,5796
subtest26of10,pubtest23of10,100,13082,5162,603,75,5840
subtest23of10,pubtest24of10,100,13085,5430,165,92,5687
subtest25of10,pubtest24of10,100,13085,5430,254,45,5729
subtest24of10,pubtest24of10,100,13085,5430,208,96,5734
subtest22of10,pubtest24of10,100,13085,5430,255,132,5817
subtest28of10,pubtest24of10,100,13085,5430,259,169,5858
subtest210of10,pubtest24of10,100,13085,5430,283,184,5897
subtest27of10,pubtest24of10,100,13085,5430,284,223,5937
subtest21of10,pubtest24of10,100,13085,5430,306,242,5978
subtest29of10,pubtest24of10,100,13085,5430,310,280,6020
subtest26of10,pubtest24of10,100,13085,5430,314,316,6060
subtest28of10,pubtest25of10,100,13082,5131,150,45,5326
subtest21of10,pubtest25of10,100,13082,5131,231,43,5405
subtest27of10,pubtest25of10,100,13082,5131,255,62,5448
subtest23of10,pubtest25of10,100,13082,5131,269,88,5488
subtest26of10,pubtest25of10,100,13082,5131,279,119,5529
subtest29of10,pubtest25of10,100,13082,5131,276,158,5565
subtest24of10,pubtest25of10,100,13082,5131,322,155,5608
subtest210of10,pubtest25of10,100,13082,5131,467,52,5650
subtest22of10,pubtest25of10,100,13082,5131,553,42,5726
subtest25of10,pubtest25of10,100,13082,5131,554,84,5769
subtest21of10,pubtest26of10,100,13075,5161,211,337,5709
subtest29of10,pubtest26of10,100,13075,5161,272,322,5755
subtest23of10,pubtest26of10,100,13075,5161,273,361,5795
subtest26of10,pubtest26of10,100,13075,5161,295,384,5840
subtest210of10,pubtest26of10,100,13075,5161,323,400,5884
subtest27of10,pubtest26of10,100,13075,5161,335,425,5921
subtest24of10,pubtest26of10,100,13075,5161,340,466,5967
subtest25of10,pubtest26of10,100,13075,5161,354,495,6010
subtest28of10,pubtest26of10,100,13075,5161,604,290,6055
subtest22of10,pubtest26of10,100,13075,5161,687,247,6095
subtest27of10,pubtest27of10,100,13083,5176,194,43,5413
subtest23of10,pubtest27of10,100,13083,5176,197,83,5456
subtest24of10,pubtest27of10,100,13083,5176,211,113,5500
subtest29of10,pubtest27of10,100,13083,5176,212,156,5544
subtest210of10,pubtest27of10,100,13083,5176,218,188,5582
subtest26of10,pubtest27of10,100,13083,5176,225,227,5628
subtest25of10,pubtest27of10,100,13083,5176,249,244,5669
subtest22of10,pubtest27of10,100,13083,5176,255,278,5709
subtest28of10,pubtest27of10,100,13083,5176,442,128,5746
subtest21of10,pubtest27of10,100,13083,5176,513,100,5789
subtest27of10,pubtest28of10,100,13085,5313,257,44,5614
subtest28of10,pubtest28of10,100,13085,5313,298,47,5658
subtest29of10,pubtest28of10,100,13085,5313,315,68,5696
subtest21of10,pubtest28of10,100,13085,5313,315,112,5740
subtest210of10,pubtest28of10,100,13085,5313,327,142,5782
subtest23of10,pubtest28of10,100,13085,5313,368,140,5821
subtest26of10,pubtest28of10,100,13085,5313,373,175,5861
subtest22of10,pubtest28of10,100,13085,5313,376,210,5899
subtest25of10,pubtest28of10,100,13085,5313,381,247,5941
subtest24of10,pubtest28of10,100,13085,5313,392,276,5981
subtest21of10,pubtest29of10,100,13081,6091,258,45,6394
subtest29of10,pubtest29of10,100,13081,6091,283,65,6439
subtest210of10,pubtest29of10,100,13081,6091,289,101,6481
subtest25of10,pubtest29of10,100,13081,6091,293,138,6522
subtest22of10,pubtest29of10,100,13081,6091,294,181,6566
subtest28of10,pubtest29of10,100,13081,6091,298,216,6605
subtest24of10,pubtest29of10,100,13081,6091,305,254,6650
subtest23of10,pubtest29of10,100,13081,6091,317,283,6691
subtest27of10,pubtest29of10,100,13081,6091,326,317,6734
subtest26of10,pubtest29of10,100,13081,6091,504,178,6773
subtest21of10,pubtest210of10,100,13188,5168,218,42,5428
subtest210of10,pubtest210of10,100,13188,5168,224,79,5471
subtest27of10,pubtest210of10,100,13188,5168,228,111,5507
subtest28of10,pubtest210of10,100,13188,5168,229,156,5553
subtest26of10,pubtest210of10,100,13188,5168,233,192,5593
subtest23of10,pubtest210of10,100,13188,5168,236,234,5638
subtest25of10,pubtest210of10,100,13188,5168,258,254,5680
subtest24of10,pubtest210of10,100,13188,5168,266,283,5717
subtest22of10,pubtest210of10,100,13188,5168,266,327,5761
subtest29of10,pubtest210of10,100,13188,5168,492,144,5804
subtest27of10,pubtest21of100,1,322,10155,-5,39,10189
subtest26of10,pubtest21of100,1,322,10155,-3,76,10228
subtest29of10,pubtest21of100,1,322,10155,-2,115,10268
subtest24of10,pubtest21of100,1,322,10155,-1,154,10308
subtest25of10,pubtest21of100,1,322,10155,0,193,10348
subtest21of10,pubtest21of100,1,322,10155,2,231,10388
subtest210of10,pubtest21of100,1,322,10155,2,271,10428
subtest28of10,pubtest21of100,1,322,10155,4,309,10468
subtest23of10,pubtest21of100,1,322,10155,4,347,10506
subtest22of10,pubtest21of100,1,322,10155,7,386,10548
subtest29of10,pubtest22of100,1,321,5256,-7,39,5288
subtest24of10,pubtest22of100,1,321,5256,-5,76,5327
subtest28of10,pubtest22of100,1,321,5256,-4,115,5367
subtest27of10,pubtest22of100,1,321,5256,-2,153,5407
subtest26of10,pubtest22of100,1,321,5256,-2,193,5447
subtest23of10,pubtest22of100,1,321,5256,4,227,5487
subtest25of10,pubtest22of100,1,321,5256,7,264,5527
subtest21of10,pubtest22of100,1,321,5256,8,303,5567
subtest22of10,pubtest22of100,1,321,5256,9,342,5607
subtest210of10,pubtest22of100,1,321,5256,9,382,5647
subtest23of10,pubtest23of100,1,321,5684,-6,40,5718
subtest28of10,pubtest23of100,1,321,5684,-6,80,5758
subtest24of10,pubtest23of100,1,321,5684,2,111,5797
subtest27of10,pubtest23of100,1,321,5684,10,143,5837
subtest29of10,pubtest23of100,1,321,5684,10,183,5877
subtest25of10,pubtest23of100,1,321,5684,12,221,5917
subtest26of10,pubtest23of100,1,321,5684,12,261,5957
subtest21of10,pubtest23of100,1,321,5684,16,297,5997
subtest22of10,pubtest23of100,1,321,5684,21,333,6038
subtest210of10,pubtest23of100,1,321,5684,30,363,6077
subtest24of10,pubtest24of100,1,321,5585,-8,43,5620
subtest23of10,pubtest24of100,1,321,5585,-6,80,5659
subtest25of10,pubtest24of100,1,321,5585,-2,116,5699
subtest28of10,pubtest24of100,1,321,5585,1,153,5739
subtest21of10,pubtest24of100,1,321,5585,1,195,5781
subtest29of10,pubtest24of100,1,321,5585,6,228,5819
subtest27of10,pubtest24of100,1,321,5585,6,268,5859
subtest22of10,pubtest24of100,1,321,5585,7,307,5899
subtest210of10,pubtest24of100,1,321,5585,9,343,5937
subtest26of10,pubtest24of100,1,321,5585,11,383,5979
subtest28of10,pubtest25of100,1,321,5186,-2,45,5229
subtest21of10,pubtest25of100,1,321,5186,-1,84,5269
subtest27of10,pubtest25of100,1,321,5186,0,123,5309
subtest210of10,pubtest25of100,1,321,5186,0,163,5349
subtest25of10,pubtest25of100,1,321,5186,2,201,5389
subtest26of10,pubtest25of100,1,321,5186,2,241,5429
subtest23of10,pubtest25of100,1,321,5186,7,276,5469
subtest29of10,pubtest25of100,1,321,5186,9,314,5509
subtest22of10,pubtest25of100,1,321,5186,9,354,5549
subtest24of10,pubtest25of100,1,321,5186,10,393,5589
subtest21of10,pubtest26of100,1,321,5148,-7,38,5179
subtest29of10,pubtest26of100,1,321,5148,-3,73,5218
subtest23of10,pubtest26of100,1,321,5148,-2,112,5258
subtest22of10,pubtest26of100,1,321,5148,-1,151,5298
subtest27of10,pubtest26of100,1,321,5148,0,190,5338
subtest26of10,pubtest26of100,1,321,5148,1,229,5378
subtest25of10,pubtest26of100,1,321,5148,2,268,5418
subtest210of10,pubtest26of100,1,321,5148,8,302,5458
subtest28of10,pubtest26of100,1,321,5148,10,340,5498
subtest24of10,pubtest26of100,1,321,5148,11,380,5539
subtest27of10,pubtest27of100,1,320,5183,-1,40,5222
subtest28of10,pubtest27of100,1,320,5183,-1,79,5261
subtest23of10,pubtest27of100,1,320,5183,1,118,5302
subtest29of10,pubtest27of100,1,320,5183,2,157,5342
subtest24of10,pubtest27of100,1,320,5183,1,195,5379
subtest210of10,pubtest27of100,1,320,5183,4,234,5421
subtest25of10,pubtest27of100,1,320,5183,6,273,5462
subtest22of10,pubtest27of100,1,320,5183,9,309,5501
subtest21of10,pubtest27of100,1,320,5183,9,348,5540
subtest26of10,pubtest27of100,1,320,5183,9,388,5580
subtest27of10,pubtest28of100,1,321,5107,-7,40,5140
subtest28of10,pubtest28of100,1,321,5107,-3,76,5180
subtest21of10,pubtest28of100,1,321,5107,0,112,5219
subtest29of10,pubtest28of100,1,321,5107,3,149,5259
subtest210of10,pubtest28of100,1,321,5107,7,184,5298
subtest26of10,pubtest28of100,1,321,5107,8,223,5338
subtest23of10,pubtest28of100,1,321,5107,7,263,5377
subtest24of10,pubtest28of100,1,321,5107,9,302,5418
subtest25of10,pubtest28of100,1,321,5107,7,342,5456
subtest22of10,pubtest28of100,1,321,5107,19,373,5499
subtest23of10,pubtest29of100,1,321,5138,-3,40,5175
subtest210of10,pubtest29of100,1,321,5138,1,75,5214
subtest29of10,pubtest29of100,1,321,5138,2,113,5253
subtest22of10,pubtest29of100,1,321,5138,4,151,5293
subtest28of10,pubtest29of100,1,321,5138,5,191,5334
subtest25of10,pubtest29of100,1,321,5138,4,230,5372
subtest21of10,pubtest29of100,1,321,5138,6,269,5413
subtest27of10,pubtest29of100,1,321,5138,14,301,5453
subtest24of10,pubtest29of100,1,321,5138,16,339,5493
subtest26of10,pubtest29of100,1,321,5138,17,378,5533
subtest29of10,pubtest210of100,1,323,5119,-8,43,5154
subtest21of10,pubtest210of100,1,323,5119,-6,80,5193
subtest210of10,pubtest210of100,1,323,5119,-4,118,5233
subtest27of10,pubtest210of100,1,323,5119,-4,157,5272
subtest23of10,pubtest210of100,1,323,5119,-2,193,5310
subtest25of10,pubtest210of100,1,323,5119,0,233,5352
subtest28of10,pubtest210of100,1,323,5119,10,263,5392
subtest24of10,pubtest210of100,1,323,5119,15,298,5432
subtest22of10,pubtest210of100,1,323,5119,19,334,5472
subtest26of10,pubtest210of100,1,323,5119,22,371,5512
subtest210of10,pubtest211of100,1,323,5215,-1,41,5255
subtest24of10,pubtest211of100,1,323,5215,10,69,5294
subtest29of10,pubtest211of100,1,323,5215,11,108,5334
subtest21of10,pubtest211of100,1,323,5215,12,147,5374
subtest25of10,pubtest211of100,1,323,5215,13,187,5415
subtest23of10,pubtest211of100,1,323,5215,13,226,5454
subtest22of10,pubtest211of100,1,323,5215,13,265,5493
subtest26of10,pubtest211of100,1,323,5215,15,304,5534
subtest28of10,pubtest211of100,1,323,5215,22,337,5574
subtest27of10,pubtest211of100,1,323,5215,22,377,5614
subtest25of10,pubtest212of100,1,323,5248,8,40,5296
subtest28of10,pubtest212of100,1,323,5248,8,79,5335
subtest29of10,pubtest212of100,1,323,5248,15,112,5375
subtest23of10,pubtest212of100,1,323,5248,19,148,5415
subtest27of10,pubtest212of100,1,323,5248,23,184,5455
subtest21of10,pubtest212of100,1,323,5248,26,221,5495
subtest24of10,pubtest212of100,1,323,5248,28,259,5535
subtest22of10,pubtest212of100,1,323,5248,32,295,5575
subtest26of10,pubtest212of100,1,323,5248,36,331,5615
subtest210of10,pubtest212of100,1,323,5248,38,369,5655
subtest23of10,pubtest213of100,1,322,5285,0,42,5327
subtest26of10,pubtest213of100,1,322,5285,0,81,5366
subtest29of10,pubtest213of100,1,322,5285,2,118,5405
subtest27of10,pubtest213of100,1,322,5285,2,158,5445
subtest21of10,pubtest213of100,1,322,5285,7,194,5486
subtest24of10,pubtest213of100,1,322,5285,8,233,5526
subtest22of10,pubtest213of100,1,322,5285,7,273,5565
subtest210of10,pubtest213of100,1,322,5285,10,312,5607
subtest25of10,pubtest213of100,1,322,5285,9,352,5646
subtest28of10,pubtest213of100,1,322,5285,11,390,5686
subtest21of10,pubtest214of100,1,323,5260,-4,44,5300
subtest23of10,pubtest214of100,1,323,5260,-1,80,5339
subtest26of10,pubtest214of100,1,323,5260,1,118,5379
subtest25of10,pubtest214of100,1,323,5260,11,148,5419
subtest27of10,pubtest214of100,1,323,5260,14,185,5459
subtest29of10,pubtest214of100,1,323,5260,14,225,5499
subtest22of10,pubtest214of100,1,323,5260,16,263,5539
subtest210of10,pubtest214of100,1,323,5260,20,299,5579
subtest24of10,pubtest214of100,1,323,5260,23,336,5619
subtest28of10,pubtest214of100,1,323,5260,25,374,5659
subtest27of10,pubtest215of100,1,323,5216,-5,41,5252
subtest24of10,pubtest215of100,1,323,5216,-5,79,5290
subtest29of10,pubtest215of100,1,323,5216,-2,117,5331
subtest21of10,pubtest215of100,1,323,5216,-1,156,5371
subtest26of10,pubtest215of100,1,323,5216,0,195,5411
subtest25of10,pubtest215of100,1,323,5216,2,234,5452
subtest23of10,pubtest215of100,1,323,5216,5,270,5491
subtest210of10,pubtest215of100,1,323,5216,7,308,5531
subtest22of10,pubtest215of100,1,323,5216,7,348,5571
subtest28of10,pubtest215of100,1,323,5216,8,388,5612
subtest24of10,pubtest216of100,1,323,5537,1466,42,7045
subtest21of10,pubtest216of100,1,323,5537,1466,81,7084
subtest27of10,pubtest216of100,1,323,5537,1468,119,7124
subtest23of10,pubtest216of100,1,323,5537,1468,159,7164
subtest28of10,pubtest216of100,1,323,5537,1470,197,7204
subtest26of10,pubtest216of100,1,323,5537,1471,236,7244
subtest25of10,pubtest216of100,1,323,5537,1470,275,7282
subtest210of10,pubtest216of100,1,323,5537,1472,315,7324
subtest22of10,pubtest216of100,1,323,5537,1472,353,7362
subtest29of10,pubtest216of100,1,323,5537,1470,393,7400
subtest27of10,pubtest217of100,1,322,5208,-8,39,5239
subtest22of10,pubtest217of100,1,322,5208,0,70,5278
subtest26of10,pubtest217of100,1,322,5208,1,109,5318
subtest21of10,pubtest217of100,1,322,5208,4,146,5358
subtest23of10,pubtest217of100,1,322,5208,7,183,5398
subtest29of10,pubtest217of100,1,322,5208,11,219,5438
subtest24of10,pubtest217of100,1,322,5208,14,256,5478
subtest25of10,pubtest217of100,1,322,5208,16,294,5518
subtest28of10,pubtest217of100,1,322,5208,20,330,5558
subtest210of10,pubtest217of100,1,322,5208,20,370,5598
subtest29of10,pubtest218of100,1,323,5393,2,41,5436
subtest22of10,pubtest218of100,1,323,5393,3,78,5474
subtest21of10,pubtest218of100,1,323,5393,5,117,5515
subtest27of10,pubtest218of100,1,323,5393,8,154,5555
subtest28of10,pubtest218of100,1,323,5393,9,193,5595
subtest23of10,pubtest218of100,1,323,5393,10,232,5635
subtest24of10,pubtest218of100,1,323,5393,11,271,5675
subtest25of10,pubtest218of100,1,323,5393,12,310,5715
subtest210of10,pubtest218of100,1,323,5393,18,344,5755
subtest26of10,pubtest218of100,1,323,5393,21,381,5795
subtest210of10,pubtest219of100,1,323,5409,3,40,5452
subtest26of10,pubtest219of100,1,323,5409,6,77,5492
subtest25of10,pubtest219of100,1,323,5409,7,115,5531
subtest21of10,pubtest219of100,1,323,5409,8,154,5571
subtest22of10,pubtest219of100,1,323,5409,9,193,5611
subtest24of10,pubtest219of100,1,323,5409,15,227,5651
subtest29of10,pubtest219of100,1,323,5409,16,266,5691
subtest28of10,pubtest219of100,1,323,5409,16,306,5731
subtest23of10,pubtest219of100,1,323,5409,18,344,5771
subtest27of10,pubtest219of100,1,323,5409,18,384,5811
subtest25of10,pubtest220of100,1,323,5208,0,42,5250
subtest23of10,pubtest220of100,1,323,5208,2,79,5289
subtest29of10,pubtest220of100,1,323,5208,3,118,5329
subtest210of10,pubtest220of100,1,323,5208,2,158,5368
subtest21of10,pubtest220of100,1,323,5208,5,196,5409
subtest27of10,pubtest220of100,1,323,5208,5,236,5449
subtest28of10,pubtest220of100,1,323,5208,7,275,5490
subtest24of10,pubtest220of100,1,323,5208,7,314,5529
subtest26of10,pubtest220of100,1,323,5208,8,353,5569
subtest22of10,pubtest220of100,1,323,5208,8,393,5609
subtest24of10,pubtest221of100,1,323,5165,2,42,5209
subtest28of10,pubtest221of100,1,323,5165,4,77,5246
subtest21of10,pubtest221of100,1,323,5165,4,117,5286
subtest25of10,pubtest221of100,1,323,5165,5,155,5325
subtest22of10,pubtest221of100,1,323,5165,6,195,5366
subtest23of10,pubtest221of100,1,323,5165,5,233,5403
subtest29of10,pubtest221of100,1,323,5165,23,258,5446
subtest27of10,pubtest221of100,1,323,5165,25,296,5486
subtest210of10,pubtest221of100,1,323,5165,26,335,5526
subtest26of10,pubtest221of100,1,323,5165,26,375,5566
subtest22of10,pubtest222of100,1,323,5417,-6,40,5451
subtest21of10,pubtest222of100,1,323,5417,-4,77,5490
subtest29of10,pubtest222of100,1,323,5417,-2,115,5530
subtest27of10,pubtest222of100,1,323,5417,-2,155,5570
subtest28of10,pubtest222of100,1,323,5417,8,185,5610
subtest23of10,pubtest222of100,1,323,5417,8,225,5650
subtest210of10,pubtest222of100,1,323,5417,9,264,5690
subtest25of10,pubtest222of100,1,323,5417,9,303,5729
subtest26of10,pubtest222of100,1,323,5417,17,336,5770
subtest24of10,pubtest222of100,1,323,5417,17,376,5810
subtest21of10,pubtest223of100,1,323,5158,-2,39,5195
subtest23of10,pubtest223of100,1,323,5158,2,76,5236
subtest29of10,pubtest223of100,1,323,5158,4,112,5274
subtest28of10,pubtest223of100,1,323,5158,5,151,5314
subtest27of10,pubtest223of100,1,323,5158,6,190,5354
subtest24of10,pubtest223of100,1,323,5158,7,229,5394
subtest210of10,pubtest223of100,1,323,5158,8,269,5435
subtest25of10,pubtest223of100,1,323,5158,10,306,5474
subtest26of10,pubtest223of100,1,323,5158,12,390,5560
subtest22of10,pubtest223of100,1,323,5158,11,430,5599
subtest21of10,pubtest224of100,1,323,5160,-5,39,5194
subtest28of10,pubtest224of100,1,323,5160,-1,74,5233
subtest27of10,pubtest224of100,1,323,5160,-2,115,5273
subtest23of10,pubtest224of100,1,323,5160,4,149,5313
subtest26of10,pubtest224of100,1,323,5160,5,189,5354
subtest29of10,pubtest224of100,1,323,5160,9,224,5393
subtest22of10,pubtest224of100,1,323,5160,16,257,5433
subtest25of10,pubtest224of100,1,323,5160,16,297,5473
subtest24of10,pubtest224of100,1,323,5160,22,332,5514
subtest210of10,pubtest224of100,1,323,5160,30,363,5553
subtest27of10,pubtest225of100,1,323,5206,-5,41,5242
subtest22of10,pubtest225of100,1,323,5206,-4,81,5283
subtest21of10,pubtest225of100,1,323,5206,-1,116,5321
subtest26of10,pubtest225of100,1,323,5206,3,152,5361
subtest24of10,pubtest225of100,1,323,5206,4,191,5401
subtest28of10,pubtest225of100,1,323,5206,16,219,5441
subtest210of10,pubtest225of100,1,323,5206,17,259,5482
subtest25of10,pubtest225of100,1,323,5206,20,296,5522
subtest23of10,pubtest225of100,1,323,5206,25,330,5561
subtest29of10,pubtest225of100,1,323,5206,27,369,5602
subtest25of10,pubtest226of100,1,323,5135,-6,42,5171
subtest23of10,pubtest226of100,1,323,5135,-4,80,5211
subtest27of10,pubtest226of100,1,323,5135,-3,119,5251
subtest22of10,pubtest226of100,1,323,5135,-1,156,5290
subtest21of10,pubtest226of100,1,323,5135,5,190,5330
subtest29of10,pubtest226of100,1,323,5135,8,227,5370
subtest210of10,pubtest226of100,1,323,5135,12,263,5410
subtest28of10,pubtest226of100,1,323,5135,16,299,5450
subtest26of10,pubtest226of100,1,323,5135,23,332,5490
subtest24of10,pubtest226of100,1,323,5135,24,371,5530
subtest29of10,pubtest227of100,1,323,5225,-7,41,5259
subtest25of10,pubtest227of100,1,323,5225,-6,79,5298
subtest23of10,pubtest227of100,1,323,5225,1,112,5338
subtest27of10,pubtest227of100,1,323,5225,1,151,5377
subtest21of10,pubtest227of100,1,323,5225,4,189,5418
subtest24of10,pubtest227of100,1,323,5225,6,227,5458
subtest210of10,pubtest227of100,1,323,5225,6,266,5497
subtest26of10,pubtest227of100,1,323,5225,8,305,5538
subtest22of10,pubtest227of100,1,323,5225,8,345,5578
subtest28of10,pubtest227of100,1,323,5225,16,377,5618
subtest21of10,pubtest228of100,1,323,5167,-2,38,5203
subtest25of10,pubtest228of100,1,323,5167,-1,76,5242
subtest26of10,pubtest228of100,1,323,5167,1,113,5281
subtest24of10,pubtest228of100,1,323,5167,3,152,5322
subtest23of10,pubtest228of100,1,323,5167,2,192,5361
subtest27of10,pubtest228of100,1,323,5167,4,231,5402
subtest29of10,pubtest228of100,1,323,5167,5,270,5442
subtest210of10,pubtest228of100,1,323,5167,6,309,5482
subtest22of10,pubtest228of100,1,323,5167,7,348,5522
subtest28of10,pubtest228of100,1,323,5167,7,388,5562
subtest24of10,pubtest229of100,1,321,5187,-5,40,5222
subtest21of10,pubtest229of100,1,321,5187,4,70,5261
subtest28of10,pubtest229of100,1,321,5187,4,110,5301
subtest27of10,pubtest229of100,1,321,5187,10,144,5341
subtest22of10,pubtest229of100,1,321,5187,9,184,5380
subtest210of10,pubtest229of100,1,321,5187,14,220,5421
subtest25of10,pubtest229of100,1,321,5187,20,254,5461
subtest23of10,pubtest229of100,1,321,5187,20,294,5501
subtest29of10,pubtest229of100,1,321,5187,22,332,5541
subtest26of10,pubtest229of100,1,321,5187,27,367,5581
subtest22of10,pubtest230of100,1,323,5233,-4,41,5270
subtest21of10,pubtest230of100,1,323,5233,-3,80,5310
subtest27of10,pubtest230of100,1,323,5233,-1,117,5349
subtest28of10,pubtest230of100,1,323,5233,4,152,5389
subtest29of10,pubtest230of100,1,323,5233,7,189,5429
subtest25of10,pubtest230of100,1,323,5233,10,227,5470
subtest23of10,pubtest230of100,1,323,5233,17,259,5509
subtest210of10,pubtest230of100,1,323,5233,25,291,5549
subtest24of10,pubtest230of100,1,323,5233,31,326,5590
subtest26of10,pubtest230of100,1,323,5233,32,364,5629
subtest23of10,pubtest231of100,1,323,5316,2,46,5364
subtest28of10,pubtest231of100,1,323,5316,3,84,5403
subtest24of10,pubtest231of100,1,323,5316,6,121,5443
subtest210of10,pubtest231of100,1,323,5316,7,160,5483
subtest25of10,pubtest231of100,1,323,5316,8,199,5523
subtest29of10,pubtest231of100,1,323,5316,9,238,5563
subtest27of10,pubtest231of100,1,323,5316,18,269,5603
subtest26of10,pubtest231of100,1,323,5316,18,309,5643
subtest21of10,pubtest231of100,1,323,5316,22,345,5683
subtest22of10,pubtest231of100,1,323,5316,21,385,5722
subtest21of10,pubtest232of100,1,323,6473,-3,40,6510
subtest22of10,pubtest232of100,1,323,6473,-3,79,6549
subtest27of10,pubtest232of100,1,323,6473,-1,117,6589
subtest28of10,pubtest232of100,1,323,6473,1,155,6629
subtest23of10,pubtest232of100,1,323,6473,1,195,6669
subtest24of10,pubtest232of100,1,323,6473,3,233,6709
subtest210of10,pubtest232of100,1,323,6473,3,273,6749
subtest25of10,pubtest232of100,1,323,6473,3,312,6788
subtest26of10,pubtest232of100,1,323,6473,4,352,6829
subtest29of10,pubtest232of100,1,323,6473,2,392,6867
subtest24of10,pubtest233of100,1,323,5981,22,43,6046
subtest29of10,pubtest233of100,1,323,5981,24,79,6084
subtest25of10,pubtest233of100,1,323,5981,25,116,6122
subtest210of10,pubtest233of100,1,323,5981,24,156,6161
subtest28of10,pubtest233of100,1,323,5981,28,196,6205
subtest23of10,pubtest233of100,1,323,5981,28,235,6244
subtest22of10,pubtest233of100,1,323,5981,27,275,6283
subtest26of10,pubtest233of100,1,323,5981,27,314,6322
subtest21of10,pubtest233of100,1,323,5981,30,354,6365
subtest27of10,pubtest233of100,1,323,5981,26,394,6401
subtest26of10,pubtest234of100,1,323,5485,-3,39,5521
subtest25of10,pubtest234of100,1,323,5485,-1,77,5561
subtest27of10,pubtest234of100,1,323,5485,0,117,5602
subtest21of10,pubtest234of100,1,323,5485,6,150,5641
subtest29of10,pubtest234of100,1,323,5485,11,185,5681
subtest23of10,pubtest234of100,1,323,5485,14,222,5721
subtest22of10,pubtest234of100,1,323,5485,18,259,5762
subtest210of10,pubtest234of100,1,323,5485,21,295,5801
subtest24of10,pubtest234of100,1,323,5485,29,327,5841
subtest28of10,pubtest234of100,1,323,5485,38,357,5880
subtest210of10,pubtest235of100,1,321,5813,0,41,5854
subtest21of10,pubtest235of100,1,321,5813,0,80,5893
subtest23of10,pubtest235of100,1,321,5813,5,115,5933
subtest22of10,pubtest235of100,1,321,5813,5,154,5972
subtest27of10,pubtest235of100,1,321,5813,6,194,6013
subtest29of10,pubtest235of100,1,321,5813,7,233,6053
subtest25of10,pubtest235of100,1,321,5813,8,272,6093
subtest24of10,pubtest235of100,1,321,5813,9,311,6133
subtest26of10,pubtest235of100,1,321,5813,10,351,6174
subtest28of10,pubtest235of100,1,321,5813,11,389,6213
subtest210of10,pubtest236of100,1,323,5393,-4,42,5431
subtest23of10,pubtest236of100,1,323,5393,-4,81,5470
subtest28of10,pubtest236of100,1,323,5393,-2,119,5510
subtest27of10,pubtest236of100,1,323,5393,5,152,5550
subtest25of10,pubtest236of100,1,323,5393,9,189,5591
subtest21of10,pubtest236of100,1,323,5393,11,224,5628
subtest29of10,pubtest236of100,1,323,5393,18,259,5670
subtest24of10,pubtest236of100,1,323,5393,19,298,5710
subtest26of10,pubtest236of100,1,323,5393,22,335,5750
subtest22of10,pubtest236of100,1,323,5393,24,373,5790
subtest24of10,pubtest237of100,1,323,5574,-2,39,5611
subtest23of10,pubtest237of100,1,323,5574,1,75,5650
subtest28of10,pubtest237of100,1,323,5574,7,109,5690
subtest25of10,pubtest237of100,1,323,5574,8,148,5730
subtest27of10,pubtest237of100,1,323,5574,15,180,5769
subtest21of10,pubtest237of100,1,323,5574,16,220,5810
subtest26of10,pubtest237of100,1,323,5574,16,259,5849
subtest22of10,pubtest237of100,1,323,5574,18,298,5890
subtest29of10,pubtest237of100,1,323,5574,19,337,5930
subtest210of10,pubtest237of100,1,323,5574,21,375,5970
subtest29of10,pubtest238of100,1,323,5490,-4,40,5526
subtest22of10,pubtest238of100,1,323,5490,-3,78,5565
subtest27of10,pubtest238of100,1,323,5490,-2,117,5605
subtest28of10,pubtest238of100,1,323,5490,-2,157,5645
subtest25of10,pubtest238of100,1,323,5490,4,191,5685
subtest23of10,pubtest238of100,1,323,5490,8,227,5725
subtest210of10,pubtest238of100,1,323,5490,12,263,5765
subtest21of10,pubtest238of100,1,323,5490,14,301,5805
subtest26of10,pubtest238of100,1,323,5490,17,338,5845
subtest24of10,pubtest238of100,1,323,5490,21,372,5883
subtest21of10,pubtest239of100,1,323,5252,-6,38,5284
subtest28of10,pubtest239of100,1,323,5252,3,68,5323
subtest27of10,pubtest239of100,1,323,5252,4,107,5363
subtest25of10,pubtest239of100,1,323,5252,4,147,5403
subtest26of10,pubtest239of100,1,323,5252,10,181,5443
subtest29of10,pubtest239of100,1,323,5252,10,220,5482
subtest23of10,pubtest239of100,1,323,5252,12,259,5523
subtest22of10,pubtest239of100,1,323,5252,12,299,5563
subtest24of10,pubtest239of100,1,323,5252,13,338,5603
subtest210of10,pubtest239of100,1,323,5252,14,377,5643
subtest25of10,pubtest240of100,1,323,5217,2,44,5263
subtest210of10,pubtest240of100,1,323,5217,2,83,5302
subtest21of10,pubtest240of100,1,323,5217,4,121,5342
subtest27of10,pubtest240of100,1,323,5217,6,159,5382
subtest29of10,pubtest240of100,1,323,5217,7,198,5422
subtest23of10,pubtest240of100,1,323,5217,13,232,5462
subtest28of10,pubtest240of100,1,323,5217,15,270,5502
subtest24of10,pubtest240of100,1,323,5217,19,306,5542
subtest22of10,pubtest240of100,1,323,5217,22,343,5582
subtest26of10,pubtest240of100,1,323,5217,23,383,5623
subtest23of10,pubtest241of100,1,323,5612,4,187,5803
subtest27of10,pubtest241of100,1,323,5612,6,223,5841
subtest24of10,pubtest241of100,1,323,5612,8,260,5880
subtest210of10,pubtest241of100,1,323,5612,11,297,5920
subtest21of10,pubtest241of100,1,323,5612,12,390,6014
subtest29of10,pubtest241of100,1,323,5612,13,427,6052
subtest25of10,pubtest241of100,1,323,5612,14,467,6093
subtest28of10,pubtest241of100,1,323,5612,14,506,6132
subtest26of10,pubtest241of100,1,323,5612,18,542,6172
subtest22of10,pubtest241of100,1,323,5612,18,582,6212
subtest27of10,pubtest242of100,1,323,5532,3,49,5584
subtest26of10,pubtest242of100,1,323,5532,4,87,5623
subtest23of10,pubtest242of100,1,323,5532,11,120,5663
subtest25of10,pubtest242of100,1,323,5532,14,157,5703
subtest210of10,pubtest242of100,1,323,5532,18,193,5743
subtest29of10,pubtest242of100,1,323,5532,24,227,5783
subtest22of10,pubtest242of100,1,323,5532,24,267,5823
subtest24of10,pubtest242of100,1,323,5532,26,305,5863
subtest21of10,pubtest242of100,1,323,5532,26,345,5903
subtest28of10,pubtest242of100,1,323,5532,30,381,5943
subtest29of10,pubtest243of100,1,323,5417,-1,41,5457
subtest28of10,pubtest243of100,1,323,5417,-1,80,5496
subtest22of10,pubtest243of100,1,323,5417,5,112,5534
subtest23of10,pubtest243of100,1,323,5417,8,151,5576
subtest25of10,pubtest243of100,1,323,5417,12,187,5616
subtest26of10,pubtest243of100,1,323,5417,16,223,5656
subtest27of10,pubtest243of100,1,323,5417,18,261,5696
subtest21of10,pubtest243of100,1,323,5417,25,294,5736
subtest24of10,pubtest243of100,1,323,5417,32,327,5776
subtest210of10,pubtest243of100,1,323,5417,38,361,5816
subtest26of10,pubtest244of100,1,323,5393,1,40,5434
subtest27of10,pubtest244of100,1,323,5393,3,77,5473
subtest25of10,pubtest244of100,1,323,5393,4,116,5513
subtest29of10,pubtest244of100,1,323,5393,4,156,5553
subtest28of10,pubtest244of100,1,323,5393,6,194,5593
subtest21of10,pubtest244of100,1,323,5393,6,234,5633
subtest210of10,pubtest244of100,1,323,5393,8,273,5674
subtest23of10,pubtest244of100,1,323,5393,7,313,5713
subtest22of10,pubtest244of100,1,323,5393,14,346,5753
subtest24of10,pubtest244of100,1,323,5393,15,385,5793
subtest29of10,pubtest245of100,1,322,5563,10,41,5614
subtest26of10,pubtest245of100,1,322,5563,11,79,5653
subtest23of10,pubtest245of100,1,322,5563,13,117,5693
subtest22of10,pubtest245of100,1,322,5563,13,156,5732
subtest25of10,pubtest245of100,1,322,5563,14,196,5773
subtest24of10,pubtest245of100,1,322,5563,20,230,5813
subtest21of10,pubtest245of100,1,322,5563,26,264,5853
subtest28of10,pubtest245of100,1,322,5563,27,303,5893
subtest27of10,pubtest245of100,1,322,5563,30,341,5934
subtest210of10,pubtest245of100,1,322,5563,31,379,5973
subtest26of10,pubtest246of100,1,323,5333,-9,40,5364
subtest27of10,pubtest246of100,1,323,5333,-1,72,5404
subtest28of10,pubtest246of100,1,323,5333,2,108,5443
subtest21of10,pubtest246of100,1,323,5333,4,146,5483
subtest210of10,pubtest246of100,1,323,5333,7,183,5523
subtest29of10,pubtest246of100,1,323,5333,10,220,5563
subtest24of10,pubtest246of100,1,323,5333,16,254,5603
subtest23of10,pubtest246of100,1,323,5333,18,292,5643
subtest22of10,pubtest246of100,1,323,5333,21,329,5683
subtest25of10,pubtest246of100,1,323,5333,26,364,5723
subtest27of10,pubtest247of100,1,323,5546,-5,40,5581
subtest26of10,pubtest247of100,1,323,5546,0,74,5620
subtest22of10,pubtest247of100,1,323,5546,2,112,5660
subtest21of10,pubtest247of100,1,323,5546,2,192,5740
subtest23of10,pubtest247of100,1,323,5546,2,231,5779
subtest29of10,pubtest247of100,1,323,5546,4,270,5820
subtest25of10,pubtest247of100,1,323,5546,11,303,5860
subtest28of10,pubtest247of100,1,323,5546,11,342,5899
subtest210of10,pubtest247of100,1,323,5546,13,379,5938
subtest24of10,pubtest247of100,1,323,5546,16,418,5980
subtest29of10,pubtest248of100,1,323,5704,-1,41,5744
subtest25of10,pubtest248of100,1,323,5704,6,73,5783
subtest23of10,pubtest248of100,1,323,5704,9,110,5823
subtest26of10,pubtest248of100,1,323,5704,19,140,5863
subtest27of10,pubtest248of100,1,323,5704,22,177,5903
subtest21of10,pubtest248of100,1,323,5704,26,213,5943
subtest28of10,pubtest248of100,1,323,5704,30,249,5983
subtest24of10,pubtest248of100,1,323,5704,33,286,6023
subtest22of10,pubtest248of100,1,323,5704,36,323,6063
subtest210of10,pubtest248of100,1,323,5704,39,360,6103
subtest27of10,pubtest249of100,1,323,5801,0,39,5840
subtest28of10,pubtest249of100,1,323,5801,5,73,5879
subtest25of10,pubtest249of100,1,323,5801,6,112,5919
subtest24of10,pubtest249of100,1,323,5801,7,153,5961
subtest21of10,pubtest249of100,1,323,5801,8,191,6000
subtest26of10,pubtest249of100,1,323,5801,11,227,6039
subtest22of10,pubtest249of100,1,323,5801,13,265,6079
subtest210of10,pubtest249of100,1,323,5801,95,223,6119
subtest29of10,pubtest249of100,1,323,5801,95,262,6158
subtest23of10,pubtest249of100,1,323,5801,97,301,6199
subtest27of10,pubtest250of100,1,323,5286,-6,41,5321
subtest23of10,pubtest250of100,1,323,5286,-3,77,5360
subtest28of10,pubtest250of100,1,323,5286,1,113,5400
subtest29of10,pubtest250of100,1,323,5286,3,151,5440
subtest21of10,pubtest250of100,1,323,5286,6,188,5480
subtest24of10,pubtest250of100,1,323,5286,8,226,5520
subtest25of10,pubtest250of100,1,323,5286,10,264,5560
subtest210of10,pubtest250of100,1,323,5286,12,302,5600
subtest26of10,pubtest250of100,1,323,5286,13,341,5640
subtest22of10,pubtest250of100,1,323,5286,15,379,5680
subtest22of10,pubtest251of100,1,323,5228,-2,40,5266
subtest23of10,pubtest251of100,1,323,5228,0,77,5305
subtest27of10,pubtest251of100,1,323,5228,7,111,5346
subtest24of10,pubtest251of100,1,323,5228,11,146,5385
subtest25of10,pubtest251of100,1,323,5228,13,184,5425
subtest21of10,pubtest251of100,1,323,5228,17,220,5465
subtest29of10,pubtest251of100,1,323,5228,22,255,5505
subtest28of10,pubtest251of100,1,323,5228,25,292,5545
subtest210of10,pubtest251of100,1,323,5228,30,327,5585
subtest26of10,pubtest251of100,1,323,5228,34,363,5625
subtest28of10,pubtest252of100,1,323,5339,-6,42,5375
subtest29of10,pubtest252of100,1,323,5339,-4,79,5414
subtest27of10,pubtest252of100,1,323,5339,0,114,5453
subtest21of10,pubtest252of100,1,323,5339,0,154,5493
subtest25of10,pubtest252of100,1,323,5339,5,190,5534
subtest26of10,pubtest252of100,1,323,5339,5,229,5573
subtest23of10,pubtest252of100,1,323,5339,19,255,5613
subtest22of10,pubtest252of100,1,323,5339,20,294,5653
subtest24of10,pubtest252of100,1,323,5339,22,332,5693
subtest210of10,pubtest252of100,1,323,5339,53,341,5733
subtest28of10,pubtest253of100,1,322,5143,-2,41,5182
subtest23of10,pubtest253of100,1,322,5143,5,73,5221
subtest25of10,pubtest253of100,1,322,5143,7,111,5261
subtest24of10,pubtest253of100,1,322,5143,10,199,5352
subtest29of10,pubtest253of100,1,322,5143,13,233,5389
subtest27of10,pubtest253of100,1,322,5143,17,269,5429
subtest21of10,pubtest253of100,1,322,5143,23,303,5469
subtest22of10,pubtest253of100,1,322,5143,26,340,5509
subtest210of10,pubtest253of100,1,322,5143,29,377,5549
subtest26of10,pubtest253of100,1,322,5143,31,415,5589
subtest210of10,pubtest254of100,1,323,5195,-4,56,5247
subtest27of10,pubtest254of100,1,323,5195,0,78,5273
subtest26of10,pubtest254of100,1,323,5195,13,118,5326
subtest29of10,pubtest254of100,1,323,5195,13,157,5365
subtest22of10,pubtest254of100,1,323,5195,15,195,5405
subtest23of10,pubtest254of100,1,323,5195,16,235,5446
subtest24of10,pubtest254of100,1,323,5195,17,274,5486
subtest25of10,pubtest254of100,1,323,5195,17,314,5526
subtest21of10,pubtest254of100,1,323,5195,18,353,5566
subtest28of10,pubtest254of100,1,323,5195,12,393,5600
subtest22of10,pubtest255of100,1,322,5292,7,38,5337
subtest23of10,pubtest255of100,1,322,5292,7,77,5376
subtest28of10,pubtest255of100,1,322,5292,11,113,5416
subtest27of10,pubtest255of100,1,322,5292,11,153,5456
subtest25of10,pubtest255of100,1,322,5292,13,191,5496
subtest24of10,pubtest255of100,1,322,5292,13,231,5536
subtest29of10,pubtest255of100,1,322,5292,14,270,5576
subtest21of10,pubtest255of100,1,322,5292,13,310,5615
subtest210of10,pubtest255of100,1,322,5292,22,342,5656
subtest26of10,pubtest255of100,1,322,5292,22,382,5696
subtest29of10,pubtest256of100,1,323,5224,-7,40,5257
subtest21of10,pubtest256of100,1,323,5224,-1,73,5296
subtest26of10,pubtest256of100,1,323,5224,0,111,5335
subtest23of10,pubtest256of100,1,323,5224,3,149,5376
subtest25of10,pubtest256of100,1,323,5224,3,189,5416
subtest210of10,pubtest256of100,1,323,5224,3,228,5455
subtest27of10,pubtest256of100,1,323,5224,7,266,5497
subtest28of10,pubtest256of100,1,323,5224,11,301,5536
subtest22of10,pubtest256of100,1,323,5224,12,340,5576
subtest24of10,pubtest256of100,1,323,5224,15,377,5616
subtest24of10,pubtest257of100,1,323,5191,5,38,5234
subtest21of10,pubtest257of100,1,323,5191,6,76,5273
subtest27of10,pubtest257of100,1,323,5191,7,115,5313
subtest29of10,pubtest257of100,1,323,5191,8,154,5353
subtest23of10,pubtest257of100,1,323,5191,9,194,5394
subtest28of10,pubtest257of100,1,323,5191,10,232,5433
subtest25of10,pubtest257of100,1,323,5191,10,272,5473
subtest22of10,pubtest257of100,1,323,5191,13,309,5513
subtest210of10,pubtest257of100,1,323,5191,19,343,5553
subtest26of10,pubtest257of100,1,323,5191,29,373,5593
subtest28of10,pubtest258of100,1,323,5619,-4,41,5656
subtest23of10,pubtest258of100,1,323,5619,-2,78,5695
subtest26of10,pubtest258of100,1,323,5619,1,115,5735
subtest25of10,pubtest258of100,1,323,5619,2,154,5775
subtest210of10,pubtest258of100,1,323,5619,5,191,5815
subtest21of10,pubtest258of100,1,323,5619,3,231,5853
subtest29of10,pubtest258of100,1,323,5619,13,264,5896
subtest22of10,pubtest258of100,1,323,5619,14,302,5935
subtest27of10,pubtest258of100,1,323,5619,17,339,5975
subtest24of10,pubtest258of100,1,323,5619,19,377,6015
subtest28of10,pubtest259of100,1,323,5549,-1,45,5593
subtest21of10,pubtest259of100,1,323,5549,-1,84,5632
subtest24of10,pubtest259of100,1,323,5549,1,122,5672
subtest25of10,pubtest259of100,1,323,5549,1,162,5712
subtest27of10,pubtest259of100,1,323,5549,3,200,5752
subtest26of10,pubtest259of100,1,323,5549,3,240,5792
subtest23of10,pubtest259of100,1,323,5549,6,277,5832
subtest22of10,pubtest259of100,1,323,5549,6,317,5872
subtest29of10,pubtest259of100,1,323,5549,10,353,5912
subtest210of10,pubtest259of100,1,323,5549,14,415,5978
subtest210of10,pubtest260of100,1,323,5815,0,40,5855
subtest23of10,pubtest260of100,1,323,5815,3,76,5894
subtest21of10,pubtest260of100,1,323,5815,4,115,5934
subtest26of10,pubtest260of100,1,323,5815,19,140,5974
subtest27of10,pubtest260of100,1,323,5815,20,179,6014
subtest28of10,pubtest260of100,1,323,5815,23,216,6054
subtest22of10,pubtest260of100,1,323,5815,21,256,6092
subtest24of10,pubtest260of100,1,323,5815,25,294,6134
subtest25of10,pubtest260of100,1,323,5815,25,334,6174
subtest29of10,pubtest260of100,1,323,5815,27,373,6215
subtest25of10,pubtest261of100,1,323,5579,-3,40,5616
subtest28of10,pubtest261of100,1,323,5579,0,76,5655
subtest29of10,pubtest261of100,1,323,5579,3,113,5695
subtest210of10,pubtest261of100,1,323,5579,6,150,5735
subtest22of10,pubtest261of100,1,323,5579,8,188,5775
subtest23of10,pubtest261of100,1,323,5579,7,228,5814
subtest24of10,pubtest261of100,1,323,5579,9,268,5856
subtest27of10,pubtest261of100,1,323,5579,9,307,5895
subtest26of10,pubtest261of100,1,323,5579,11,345,5935
subtest21of10,pubtest261of100,1,323,5579,11,385,5975
subtest21of10,pubtest262of100,1,323,5830,-6,41,5865
subtest22of10,pubtest262of100,1,323,5830,-5,80,5905
subtest23of10,pubtest262of100,1,323,5830,-2,117,5945
subtest26of10,pubtest262of100,1,323,5830,1,154,5985
subtest27of10,pubtest262of100,1,323,5830,5,189,6024
subtest25of10,pubtest262of100,1,323,5830,8,227,6065
subtest29of10,pubtest262of100,1,323,5830,6,267,6103
subtest24of10,pubtest262of100,1,323,5830,13,302,6145
subtest28of10,pubtest262of100,1,323,5830,14,341,6185
subtest210of10,pubtest262of100,1,323,5830,13,381,6224
subtest22of10,pubtest263of100,1,322,5978,-2,39,6015
subtest29of10,pubtest263of100,1,322,5978,-1,78,6055
subtest24of10,pubtest263of100,1,322,5978,1,116,6095
subtest23of10,pubtest263of100,1,322,5978,7,151,6136
subtest25of10,pubtest263of100,1,322,5978,8,189,6175
subtest26of10,pubtest263of100,1,322,5978,9,228,6215
subtest27of10,pubtest263of100,1,322,5978,14,263,6255
subtest210of10,pubtest263of100,1,322,5978,15,303,6296
subtest21of10,pubtest263of100,1,322,5978,20,337,6335
subtest28of10,pubtest263of100,1,322,5978,20,377,6375
subtest22of10,pubtest264of100,1,322,5986,36,42,6064
subtest29of10,pubtest264of100,1,322,5986,37,80,6103
subtest24of10,pubtest264of100,1,322,5986,39,118,6143
subtest23of10,pubtest264of100,1,322,5986,39,158,6183
subtest27of10,pubtest264of100,1,322,5986,40,197,6223
subtest21of10,pubtest264of100,1,322,5986,43,234,6263
subtest28of10,pubtest264of100,1,322,5986,49,268,6303
subtest25of10,pubtest264of100,1,322,5986,53,304,6343
subtest26of10,pubtest264of100,1,322,5986,56,342,6384
subtest210of10,pubtest264of100,1,322,5986,59,378,6423
subtest26of10,pubtest265of100,1,323,5980,-4,38,6014
subtest210of10,pubtest265of100,1,323,5980,4,70,6054
subtest27of10,pubtest265of100,1,323,5980,13,100,6093
subtest21of10,pubtest265of100,1,323,5980,18,135,6133
subtest25of10,pubtest265of100,1,323,5980,19,174,6173
subtest29of10,pubtest265of100,1,323,5980,20,214,6214
subtest22of10,pubtest265of100,1,323,5980,21,252,6253
subtest23of10,pubtest265of100,1,323,5980,21,292,6293
subtest24of10,pubtest265of100,1,323,5980,23,330,6333
subtest28of10,pubtest265of100,1,323,5980,23,370,6373
subtest29of10,pubtest266of100,1,321,5526,-5,41,5562
subtest210of10,pubtest266of100,1,321,5526,17,58,5601
subtest25of10,pubtest266of100,1,321,5526,17,98,5641
subtest27of10,pubtest266of100,1,321,5526,18,137,5681
subtest26of10,pubtest266of100,1,321,5526,23,173,5722
subtest22of10,pubtest266of100,1,321,5526,26,209,5761
subtest24of10,pubtest266of100,1,321,5526,27,249,5802
subtest21of10,pubtest266of100,1,321,5526,26,287,5839
subtest28of10,pubtest266of100,1,321,5526,28,327,5881
subtest23of10,pubtest266of100,1,321,5526,23,367,5916
subtest23of10,pubtest267of100,1,323,5376,-5,39,5410
subtest25of10,pubtest267of100,1,323,5376,-4,77,5449
subtest27of10,pubtest267of100,1,323,5376,1,112,5489
subtest29of10,pubtest267of100,1,323,5376,4,149,5529
subtest21of10,pubtest267of100,1,323,5376,8,186,5570
subtest26of10,pubtest267of100,1,323,5376,12,221,5609
subtest28of10,pubtest267of100,1,323,5376,16,257,5649
subtest24of10,pubtest267of100,1,323,5376,18,295,5689
subtest22of10,pubtest267of100,1,323,5376,31,322,5729
subtest210of10,pubtest267of100,1,323,5376,32,361,5769
subtest23of10,pubtest268of100,1,323,5544,-5,41,5580
subtest24of10,pubtest268of100,1,323,5544,-3,78,5619
subtest25of10,pubtest268of100,1,323,5544,-2,117,5659
subtest29of10,pubtest268of100,1,323,5544,-1,156,5699
subtest28of10,pubtest268of100,1,323,5544,-1,196,5739
subtest27of10,pubtest268of100,1,323,5544,3,232,5779
subtest21of10,pubtest268of100,1,323,5544,14,261,5819
subtest210of10,pubtest268of100,1,323,5544,20,295,5859
subtest22of10,pubtest268of100,1,323,5544,20,335,5899
subtest26of10,pubtest268of100,1,323,5544,21,374,5939
subtest24of10,pubtest269of100,1,323,5608,-6,41,5643
subtest210of10,pubtest269of100,1,323,5608,-1,75,5682
subtest27of10,pubtest269of100,1,323,5608,-1,114,5721
subtest26of10,pubtest269of100,1,323,5608,13,141,5762
subtest25of10,pubtest269of100,1,323,5608,15,179,5802
subtest22of10,pubtest269of100,1,323,5608,17,217,5842
subtest21of10,pubtest269of100,1,323,5608,20,254,5882
subtest28of10,pubtest269of100,1,323,5608,22,292,5922
subtest29of10,pubtest269of100,1,323,5608,22,332,5962
subtest23of10,pubtest269of100,1,323,5608,23,371,6002
subtest23of10,pubtest270of100,1,323,5171,5,41,5217
subtest27of10,pubtest270of100,1,323,5171,6,79,5256
subtest26of10,pubtest270of100,1,323,5171,10,115,5296
subtest29of10,pubtest270of100,1,323,5171,11,153,5335
subtest25of10,pubtest270of100,1,323,5171,13,192,5376
subtest210of10,pubtest270of100,1,323,5171,35,210,5416
subtest21of10,pubtest270of100,1,323,5171,35,250,5456
subtest28of10,pubtest270of100,1,323,5171,37,288,5496
subtest22of10,pubtest270of100,1,323,5171,37,328,5536
subtest24of10,pubtest270of100,1,323,5171,38,367,5576
subtest24of10,pubtest271of100,1,323,5310,-3,41,5348
subtest27of10,pubtest271of100,1,323,5310,-1,78,5387
subtest25of10,pubtest271of100,1,323,5310,-1,118,5427
subtest22of10,pubtest271of100,1,323,5310,6,151,5467
subtest210of10,pubtest271of100,1,323,5310,13,184,5507
subtest21of10,pubtest271of100,1,323,5310,18,219,5547
subtest26of10,pubtest271of100,1,323,5310,19,259,5588
subtest23of10,pubtest271of100,1,323,5310,20,297,5627
subtest28of10,pubtest271of100,1,323,5310,20,337,5667
subtest29of10,pubtest271of100,1,323,5310,21,376,5707
subtest25of10,pubtest272of100,1,323,5232,-2,40,5270
subtest26of10,pubtest272of100,1,323,5232,2,77,5311
subtest21of10,pubtest272of100,1,323,5232,3,114,5349
subtest29of10,pubtest272of100,1,323,5232,9,149,5390
subtest23of10,pubtest272of100,1,323,5232,10,188,5430
subtest27of10,pubtest272of100,1,323,5232,12,226,5470
subtest24of10,pubtest272of100,1,323,5232,13,265,5510
subtest210of10,pubtest272of100,1,323,5232,14,304,5550
subtest22of10,pubtest272of100,1,323,5232,75,283,5590
subtest28of10,pubtest272of100,1,323,5232,77,321,5630
subtest22of10,pubtest273of100,1,321,5339,1,41,5381
subtest29of10,pubtest273of100,1,321,5339,11,74,5424
subtest26of10,pubtest273of100,1,321,5339,14,111,5464
subtest28of10,pubtest273of100,1,321,5339,18,146,5503
subtest25of10,pubtest273of100,1,321,5339,21,184,5544
subtest27of10,pubtest273of100,1,321,5339,33,211,5583
subtest210of10,pubtest273of100,1,321,5339,38,246,5623
subtest23of10,pubtest273of100,1,321,5339,42,282,5663
subtest24of10,pubtest273of100,1,321,5339,44,320,5703
subtest21of10,pubtest273of100,1,321,5339,47,357,5743
subtest26of10,pubtest274of100,1,323,5492,2,43,5537
subtest21of10,pubtest274of100,1,323,5492,3,80,5575
subtest23of10,pubtest274of100,1,323,5492,6,118,5616
subtest29of10,pubtest274of100,1,323,5492,6,158,5656
subtest22of10,pubtest274of100,1,323,5492,8,197,5697
subtest28of10,pubtest274of100,1,323,5492,10,235,5737
subtest27of10,pubtest274of100,1,323,5492,13,271,5776
subtest25of10,pubtest274of100,1,323,5492,12,311,5815
subtest24of10,pubtest274of100,1,323,5492,14,349,5855
subtest210of10,pubtest274of100,1,323,5492,14,389,5895
subtest27of10,pubtest275of100,1,323,5833,-4,41,5870
subtest24of10,pubtest275of100,1,323,5833,5,71,5909
subtest29of10,pubtest275of100,1,323,5833,5,111,5949
subtest25of10,pubtest275of100,1,323,5833,12,144,5989
subtest210of10,pubtest275of100,1,323,5833,15,181,6029
subtest22of10,pubtest275of100,1,323,5833,14,221,6068
subtest23of10,pubtest275of100,1,323,5833,17,259,6109
subtest21of10,pubtest275of100,1,323,5833,17,299,6149
subtest26of10,pubtest275of100,1,323,5833,28,330,6191
subtest28of10,pubtest275of100,1,323,5833,29,368,6230
subtest28of10,pubtest276of100,1,323,5607,-6,41,5642
subtest21of10,pubtest276of100,1,323,5607,3,72,5682
subtest25of10,pubtest276of100,1,323,5607,11,103,5721
subtest24of10,pubtest276of100,1,323,5607,13,141,5761
subtest26of10,pubtest276of100,1,323,5607,16,178,5801
subtest27of10,pubtest276of100,1,323,5607,19,215,5841
subtest29of10,pubtest276of100,1,323,5607,21,253,5881
subtest23of10,pubtest276of100,1,323,5607,24,290,5921
subtest210of10,pubtest276of100,1,323,5607,26,328,5961
subtest22of10,pubtest276of100,1,323,5607,28,366,6001
subtest22of10,pubtest277of100,1,323,5828,-6,41,5863
subtest29of10,pubtest277of100,1,323,5828,-4,78,5902
subtest28of10,pubtest277of100,1,323,5828,-3,117,5942
subtest21of10,pubtest277of100,1,323,5828,1,154,5983
subtest24of10,pubtest277of100,1,323,5828,0,194,6022
subtest27of10,pubtest277of100,1,323,5828,3,233,6064
subtest210of10,pubtest277of100,1,323,5828,8,267,6103
subtest25of10,pubtest277of100,1,323,5828,20,294,6142
subtest23of10,pubtest277of100,1,323,5828,20,334,6182
subtest26of10,pubtest277of100,1,323,5828,21,373,6222
subtest22of10,pubtest278of100,1,323,5428,-5,40,5463
subtest29of10,pubtest278of100,1,323,5428,2,72,5502
subtest23of10,pubtest278of100,1,323,5428,3,111,5542
subtest21of10,pubtest278of100,1,323,5428,4,150,5582
subtest27of10,pubtest278of100,1,323,5428,9,185,5622
subtest26of10,pubtest278of100,1,323,5428,10,223,5661
subtest24of10,pubtest278of100,1,323,5428,11,263,5702
subtest25of10,pubtest278of100,1,323,5428,9,302,5739
subtest210of10,pubtest278of100,1,323,5428,12,342,5782
subtest28of10,pubtest278of100,1,323,5428,10,381,5819
subtest28of10,pubtest279of100,1,323,5288,-5,43,5326
subtest25of10,pubtest279of100,1,323,5288,-5,82,5365
subtest21of10,pubtest279of100,1,323,5288,-2,120,5406
subtest24of10,pubtest279of100,1,323,5288,12,146,5446
subtest29of10,pubtest279of100,1,323,5288,12,186,5486
subtest27of10,pubtest279of100,1,323,5288,14,224,5526
subtest26of10,pubtest279of100,1,323,5288,23,255,5566
subtest22of10,pubtest279of100,1,323,5288,28,290,5606
subtest23of10,pubtest279of100,1,323,5288,28,330,5646
subtest210of10,pubtest279of100,1,323,5288,31,367,5686
subtest27of10,pubtest280of100,1,323,5763,-5,39,5797
subtest29of10,pubtest280of100,1,323,5763,2,72,5837
subtest24of10,pubtest280of100,1,323,5763,4,110,5877
subtest21of10,pubtest280of100,1,323,5763,4,150,5917
subtest23of10,pubtest280of100,1,323,5763,6,188,5957
subtest25of10,pubtest280of100,1,323,5763,11,223,5997
subtest26of10,pubtest280of100,1,323,5763,12,262,6037
subtest210of10,pubtest280of100,1,323,5763,13,301,6077
subtest28of10,pubtest280of100,1,323,5763,21,333,6117
subtest22of10,pubtest280of100,1,323,5763,22,373,6158
subtest24of10,pubtest281of100,1,323,5672,-5,41,5708
subtest23of10,pubtest281of100,1,323,5672,-3,78,5747
subtest28of10,pubtest281of100,1,323,5672,-2,117,5787
subtest27of10,pubtest281of100,1,323,5672,4,151,5827
subtest22of10,pubtest281of100,1,323,5672,4,191,5867
subtest210of10,pubtest281of100,1,323,5672,12,221,5905
subtest21of10,pubtest281of100,1,323,5672,15,260,5947
subtest25of10,pubtest281of100,1,323,5672,16,299,5987
subtest26of10,pubtest281of100,1,323,5672,17,338,6027
subtest29of10,pubtest281of100,1,323,5672,17,378,6067
subtest24of10,pubtest282of100,1,323,5397,-3,38,5432
subtest23of10,pubtest282of100,1,323,5397,-3,77,5471
subtest21of10,pubtest282of100,1,323,5397,-1,115,5511
subtest25of10,pubtest282of100,1,323,5397,-1,156,5552
subtest29of10,pubtest282of100,1,323,5397,1,193,5591
subtest22of10,pubtest282of100,1,323,5397,1,233,5631
subtest27of10,pubtest282of100,1,323,5397,6,268,5671
subtest26of10,pubtest282of100,1,323,5397,11,304,5712
subtest210of10,pubtest282of100,1,323,5397,121,233,5751
subtest28of10,pubtest282of100,1,323,5397,121,273,5791
subtest24of10,pubtest283of100,1,323,5224,3,39,5266
subtest27of10,pubtest283of100,1,323,5224,5,76,5305
subtest23of10,pubtest283of100,1,323,5224,5,116,5345
subtest22of10,pubtest283of100,1,323,5224,12,149,5385
subtest25of10,pubtest283of100,1,323,5224,13,187,5424
subtest21of10,pubtest283of100,1,323,5224,14,227,5465
subtest29of10,pubtest283of100,1,323,5224,18,263,5505
subtest28of10,pubtest283of100,1,323,5224,19,302,5545
subtest210of10,pubtest283of100,1,323,5224,20,341,5585
subtest26of10,pubtest283of100,1,323,5224,21,380,5625
subtest22of10,pubtest284of100,1,323,5303,-2,41,5342
subtest25of10,pubtest284of100,1,323,5303,-1,80,5382
subtest210of10,pubtest284of100,1,323,5303,9,110,5422
subtest29of10,pubtest284of100,1,323,5303,9,151,5463
subtest23of10,pubtest284of100,1,323,5303,10,189,5502
subtest27of10,pubtest284of100,1,323,5303,10,228,5541
subtest24of10,pubtest284of100,1,323,5303,12,267,5582
subtest21of10,pubtest284of100,1,323,5303,15,304,5622
subtest28of10,pubtest284of100,1,323,5303,23,336,5662
subtest26of10,pubtest284of100,1,323,5303,32,367,5702
subtest23of10,pubtest285of100,1,323,5456,7,43,5506
subtest24of10,pubtest285of100,1,323,5456,9,80,5545
subtest27of10,pubtest285of100,1,323,5456,10,119,5585
subtest25of10,pubtest285of100,1,323,5456,8,158,5622
subtest28of10,pubtest285of100,1,323,5456,12,197,5665
subtest21of10,pubtest285of100,1,323,5456,11,237,5704
subtest22of10,pubtest285of100,1,323,5456,9,277,5742
subtest29of10,pubtest285of100,1,323,5456,13,316,5785
subtest210of10,pubtest285of100,1,323,5456,16,353,5825
subtest26of10,pubtest285of100,1,323,5456,17,392,5865
subtest23of10,pubtest286of100,1,323,5538,-5,42,5575
subtest25of10,pubtest286of100,1,323,5538,-1,77,5614
subtest210of10,pubtest286of100,1,323,5538,1,115,5654
subtest24of10,pubtest286of100,1,323,5538,2,155,5695
subtest29of10,pubtest286of100,1,323,5538,10,186,5734
subtest26of10,pubtest286of100,1,323,5538,11,225,5774
subtest21of10,pubtest286of100,1,323,5538,10,264,5812
subtest27of10,pubtest286of100,1,323,5538,13,303,5854
subtest28of10,pubtest286of100,1,323,5538,15,339,5892
subtest22of10,pubtest286of100,1,323,5538,15,379,5932
subtest26of10,pubtest287of100,1,323,5573,9,40,5622
subtest29of10,pubtest287of100,1,323,5573,10,78,5661
subtest28of10,pubtest287of100,1,323,5573,18,110,5701
subtest27of10,pubtest287of100,1,323,5573,21,147,5741
subtest210of10,pubtest287of100,1,323,5573,21,187,5781
subtest21of10,pubtest287of100,1,323,5573,26,222,5821
subtest23of10,pubtest287of100,1,323,5573,26,262,5861
subtest24of10,pubtest287of100,1,323,5573,28,300,5901
subtest25of10,pubtest287of100,1,323,5573,26,340,5939
subtest22of10,pubtest287of100,1,323,5573,32,376,5981
subtest29of10,pubtest288of100,1,323,5502,-1,39,5540
subtest25of10,pubtest288of100,1,323,5502,-1,79,5580
subtest27of10,pubtest288of100,1,323,5502,1,117,5620
subtest21of10,pubtest288of100,1,323,5502,1,155,5658
subtest23of10,pubtest288of100,1,323,5502,1,192,5695
subtest26of10,pubtest288of100,1,323,5502,1,231,5734
subtest210of10,pubtest288of100,1,323,5502,3,270,5775
subtest24of10,pubtest288of100,1,323,5502,7,310,5819
subtest28of10,pubtest288of100,1,323,5502,6,349,5857
subtest22of10,pubtest288of100,1,323,5502,4,389,5895
subtest29of10,pubtest289of100,1,323,5652,0,40,5692
subtest210of10,pubtest289of100,1,323,5652,1,78,5731
subtest23of10,pubtest289of100,1,323,5652,6,113,5771
subtest24of10,pubtest289of100,1,323,5652,7,152,5811
subtest27of10,pubtest289of100,1,323,5652,9,190,5851
subtest25of10,pubtest289of100,1,323,5652,8,230,5890
subtest22of10,pubtest289of100,1,323,5652,11,268,5931
subtest26of10,pubtest289of100,1,323,5652,8,308,5968
subtest28of10,pubtest289of100,1,323,5652,11,348,6011
subtest21of10,pubtest289of100,1,323,5652,11,387,6050
subtest29of10,pubtest290of100,1,323,5611,5,39,5655
subtest23of10,pubtest290of100,1,323,5611,7,78,5696
subtest25of10,pubtest290of100,1,323,5611,11,114,5736
subtest27of10,pubtest290of100,1,323,5611,14,151,5776
subtest21of10,pubtest290of100,1,323,5611,14,191,5816
subtest22of10,pubtest290of100,1,323,5611,15,230,5856
subtest26of10,pubtest290of100,1,323,5611,16,269,5896
subtest28of10,pubtest290of100,1,323,5611,17,308,5936
subtest210of10,pubtest290of100,1,323,5611,18,347,5976
subtest24of10,pubtest290of100,1,323,5611,21,384,6016
subtest24of10,pubtest291of100,1,323,5637,-6,38,5669
subtest23of10,pubtest291of100,1,323,5637,-3,74,5708
subtest28of10,pubtest291of100,1,323,5637,0,111,5748
subtest27of10,pubtest291of100,1,323,5637,1,150,5788
subtest210of10,pubtest291of100,1,323,5637,2,189,5828
subtest21of10,pubtest291of100,1,323,5637,2,229,5868
subtest25of10,pubtest291of100,1,323,5637,4,267,5908
subtest29of10,pubtest291of100,1,323,5637,4,307,5948
subtest26of10,pubtest291of100,1,323,5637,10,339,5986
subtest22of10,pubtest291of100,1,323,5637,10,379,6026
subtest29of10,pubtest292of100,1,323,5748,2,43,5793
subtest21of10,pubtest292of100,1,323,5748,4,80,5832
subtest25of10,pubtest292of100,1,323,5748,4,120,5872
subtest23of10,pubtest292of100,1,323,5748,6,158,5912
subtest27of10,pubtest292of100,1,323,5748,6,197,5951
subtest28of10,pubtest292of100,1,323,5748,16,228,5992
subtest26of10,pubtest292of100,1,323,5748,17,267,6032
subtest22of10,pubtest292of100,1,323,5748,17,307,6072
subtest24of10,pubtest292of100,1,323,5748,20,344,6112
subtest210of10,pubtest292of100,1,323,5748,22,382,6152
subtest24of10,pubtest293of100,1,323,5336,11,38,5385
subtest25of10,pubtest293of100,1,323,5336,11,78,5425
subtest23of10,pubtest293of100,1,323,5336,15,113,5464
subtest28of10,pubtest293of100,1,323,5336,16,153,5505
subtest210of10,pubtest293of100,1,323,5336,64,144,5544
subtest27of10,pubtest293of100,1,323,5336,64,184,5584
subtest21of10,pubtest293of100,1,323,5336,69,219,5624
subtest29of10,pubtest293of100,1,323,5336,69,259,5664
subtest26of10,pubtest293of100,1,323,5336,71,297,5704
subtest22of10,pubtest293of100,1,323,5336,72,336,5744
subtest21of10,pubtest294of100,1,323,5162,-4,44,5202
subtest25of10,pubtest294of100,1,323,5162,-2,81,5241
subtest26of10,pubtest294of100,1,323,5162,1,117,5280
subtest29of10,pubtest294of100,1,323,5162,2,156,5320
subtest210of10,pubtest294of100,1,323,5162,0,197,5359
subtest27of10,pubtest294of100,1,323,5162,4,235,5401
subtest23of10,pubtest294of100,1,323,5162,14,265,5441
subtest24of10,pubtest294of100,1,323,5162,18,301,5481
subtest22of10,pubtest294of100,1,323,5162,23,336,5521
subtest28of10,pubtest294of100,1,323,5162,24,375,5561
subtest25of10,pubtest295of100,1,323,5467,-3,45,5509
subtest23of10,pubtest295of100,1,323,5467,-2,84,5549
subtest24of10,pubtest295of100,1,323,5467,-2,122,5587
subtest27of10,pubtest295of100,1,323,5467,9,152,5628
subtest22of10,pubtest295of100,1,323,5467,9,192,5668
subtest210of10,pubtest295of100,1,323,5467,11,230,5708
subtest29of10,pubtest295of100,1,323,5467,11,270,5748
subtest21of10,pubtest295of100,1,323,5467,53,268,5788
subtest28of10,pubtest295of100,1,323,5467,53,308,5828
subtest26of10,pubtest295of100,1,323,5467,56,345,5868
subtest25of10,pubtest296of100,1,322,5493,-1,38,5530
subtest24of10,pubtest296of100,1,322,5493,0,77,5570
subtest27of10,pubtest296of100,1,322,5493,1,115,5609
subtest26of10,pubtest296of100,1,322,5493,2,154,5649
subtest23of10,pubtest296of100,1,322,5493,3,192,5688
subtest29of10,pubtest296of100,1,322,5493,4,232,5729
subtest21of10,pubtest296of100,1,322,5493,10,267,5770
subtest28of10,pubtest296of100,1,322,5493,14,302,5809
subtest22of10,pubtest296of100,1,322,5493,14,342,5849
subtest210of10,pubtest296of100,1,322,5493,16,380,5889
subtest29of10,pubtest297of100,1,323,5634,0,41,5675
subtest25of10,pubtest297of100,1,323,5634,-1,82,5715
subtest210of10,pubtest297of100,1,323,5634,-1,120,5753
subtest23of10,pubtest297of100,1,323,5634,2,159,5795
subtest22of10,pubtest297of100,1,323,5634,4,197,5835
subtest27of10,pubtest297of100,1,323,5634,6,235,5875
subtest26of10,pubtest297of100,1,323,5634,52,229,5915
subtest28of10,pubtest297of100,1,323,5634,53,268,5955
subtest21of10,pubtest297of100,1,323,5634,55,306,5995
subtest24of10,pubtest297of100,1,323,5634,57,344,6035
subtest25of10,pubtest298of100,1,323,5543,-1,39,5581
subtest22of10,pubtest298of100,1,323,5543,-1,78,5620
subtest29of10,pubtest298of100,1,323,5543,0,117,5660
subtest24of10,pubtest298of100,1,323,5543,10,146,5699
subtest23of10,pubtest298of100,1,323,5543,11,186,5740
subtest21of10,pubtest298of100,1,323,5543,12,224,5779
subtest28of10,pubtest298of100,1,323,5543,13,264,5820
subtest210of10,pubtest298of100,1,323,5543,12,303,5858
subtest27of10,pubtest298of100,1,323,5543,14,343,5900
subtest26of10,pubtest298of100,1,323,5543,15,382,5940
subtest22of10,pubtest299of100,1,323,5699,-5,41,5735
subtest210of10,pubtest299of100,1,323,5699,0,75,5774
subtest29of10,pubtest299of100,1,323,5699,0,114,5813
subtest27of10,pubtest299of100,1,323,5699,12,143,5854
subtest23of10,pubtest299of100,1,323,5699,14,181,5894
subtest24of10,pubtest299of100,1,323,5699,14,221,5934
subtest25of10,pubtest299of100,1,323,5699,16,259,5974
subtest21of10,pubtest299of100,1,323,5699,16,297,6012
subtest26of10,pubtest299of100,1,323,5699,19,336,6054
subtest28of10,pubtest299of100,1,323,5699,19,375,6093
subtest24of10,pubtest2100of100,1,325,5288,2,47,5337
subtest21of10,pubtest2100of100,1,325,5288,3,85,5376
subtest23of10,pubtest2100of100,1,325,5288,4,124,5416
subtest27of10,pubtest2100of100,1,325,5288,6,162,5456
subtest25of10,pubtest2100of100,1,325,5288,8,200,5496
subtest29of10,pubtest2100of100,1,325,5288,8,240,5536
subtest26of10,pubtest2100of100,1,325,5288,10,278,5576
subtest210of10,pubtest2100of100,1,325,5288,10,318,5616
subtest22of10,pubtest2100of100,1,325,5288,11,357,5656
subtest28of10,pubtest2100of100,1,325,5288,10,397,5695
subtest29of10,pubtest21of100,1,322,10471,12,41,10524
subtest27of10,pubtest21of100,1,322,10471,10,82,10563
subtest26of10,pubtest21of100,1,322,10471,12,121,10604
subtest23of10,pubtest21of100,1,322,10471,15,159,10645
subtest21of10,pubtest21of100,1,322,10471,12,199,10682
subtest24of10,pubtest21of100,1,322,10471,12,238,10721
subtest22of10,pubtest21of100,1,322,10471,16,278,10765
subtest25of10,pubtest21of100,1,322,10471,12,317,10800
subtest210of10,pubtest21of100,1,322,10471,13,357,10841
subtest28of10,pubtest21of100,1,322,10471,19,395,10885
subtest29of10,pubtest22of100,1,321,5275,-6,42,5311
subtest27of10,pubtest22of100,1,321,5275,-2,77,5350
subtest24of10,pubtest22of100,1,321,5275,-1,115,5389
subtest28of10,pubtest22of100,1,321,5275,-1,155,5429
subtest23of10,pubtest22of100,1,321,5275,6,189,5470
subtest25of10,pubtest22of100,1,321,5275,7,228,5510
subtest26of10,pubtest22of100,1,321,5275,8,267,5550
subtest21of10,pubtest22of100,1,321,5275,9,307,5591
subtest210of10,pubtest22of100,1,321,5275,9,343,5627
subtest22of10,pubtest22of100,1,321,5275,12,383,5670
subtest23of10,pubtest23of100,1,321,5349,39,41,5429
subtest28of10,pubtest23of100,1,321,5349,72,48,5469
subtest29of10,pubtest23of100,1,321,5349,96,63,5508
subtest26of10,pubtest23of100,1,321,5349,96,103,5548
subtest27of10,pubtest23of100,1,321,5349,98,142,5589
subtest24of10,pubtest23of100,1,321,5349,96,182,5627
subtest22of10,pubtest23of100,1,321,5349,99,220,5668
subtest25of10,pubtest23of100,1,321,5349,99,260,5708
subtest210of10,pubtest23of100,1,321,5349,101,298,5748
subtest21of10,pubtest23of100,1,321,5349,101,338,5788
subtest24of10,pubtest24of100,1,321,6051,5,40,6096
subtest23of10,pubtest24of100,1,321,6051,6,78,6135
subtest25of10,pubtest24of100,1,321,6051,8,116,6175
subtest21of10,pubtest24of100,1,321,6051,9,155,6215
subtest29of10,pubtest24of100,1,321,6051,10,194,6255
subtest27of10,pubtest24of100,1,321,6051,11,233,6295
subtest28of10,pubtest24of100,1,321,6051,11,273,6335
subtest22of10,pubtest24of100,1,321,6051,13,311,6375
subtest210of10,pubtest24of100,1,321,6051,14,350,6415
subtest26of10,pubtest24of100,1,321,6051,15,389,6455
subtest28of10,pubtest25of100,1,321,5405,-1,39,5443
subtest21of10,pubtest25of100,1,321,5405,3,74,5482
subtest27of10,pubtest25of100,1,321,5405,4,113,5522
subtest210of10,pubtest25of100,1,321,5405,5,152,5562
subtest25of10,pubtest25of100,1,321,5405,6,191,5602
subtest23of10,pubtest25of100,1,321,5405,7,230,5642
subtest26of10,pubtest25of100,1,321,5405,8,268,5681
subtest22of10,pubtest25of100,1,321,5405,8,308,5721
subtest24of10,pubtest25of100,1,321,5405,11,346,5762
subtest29of10,pubtest25of100,1,321,5405,11,386,5802
subtest21of10,pubtest26of100,1,321,5491,0,39,5530
subtest22of10,pubtest26of100,1,321,5491,6,72,5569
subtest29of10,pubtest26of100,1,321,5491,6,112,5609
subtest23of10,pubtest26of100,1,321,5491,7,151,5649
subtest27of10,pubtest26of100,1,321,5491,8,190,5689
subtest26of10,pubtest26of100,1,321,5491,13,225,5729
subtest25of10,pubtest26of100,1,321,5491,13,265,5769
subtest210of10,pubtest26of100,1,321,5491,14,304,5809
subtest28of10,pubtest26of100,1,321,5491,15,343,5849
subtest24of10,pubtest26of100,1,321,5491,20,379,5890
subtest28of10,pubtest27of100,1,320,5733,14,39,5786
subtest27of10,pubtest27of100,1,320,5733,14,78,5825
subtest24of10,pubtest27of100,1,320,5733,16,116,5865
subtest23of10,pubtest27of100,1,320,5733,16,157,5906
subtest29of10,pubtest27of100,1,320,5733,17,195,5945
subtest210of10,pubtest27of100,1,320,5733,22,230,5985
subtest25of10,pubtest27of100,1,320,5733,23,269,6025
subtest22of10,pubtest27of100,1,320,5733,25,307,6065
subtest21of10,pubtest27of100,1,320,5733,26,347,6106
subtest26of10,pubtest27of100,1,320,5733,29,383,6145
subtest28of10,pubtest28of100,1,321,5504,0,47,5551
subtest21of10,pubtest28of100,1,321,5504,1,85,5590
subtest27of10,pubtest28of100,1,321,5504,0,122,5626
subtest29of10,pubtest28of100,1,321,5504,2,162,5668
subtest25of10,pubtest28of100,1,321,5504,3,201,5708
subtest210of10,pubtest28of100,1,321,5504,7,238,5749
subtest26of10,pubtest28of100,1,321,5504,9,276,5789
subtest23of10,pubtest28of100,1,321,5504,6,315,5825
subtest24of10,pubtest28of100,1,321,5504,11,354,5869
subtest22of10,pubtest28of100,1,321,5504,13,393,5910
subtest23of10,pubtest29of100,1,321,5317,-5,42,5354
subtest25of10,pubtest29of100,1,321,5317,-3,80,5394
subtest29of10,pubtest29of100,1,321,5317,-3,118,5432
subtest210of10,pubtest29of100,1,321,5317,1,155,5473
subtest22of10,pubtest29of100,1,321,5317,2,195,5514
subtest21of10,pubtest29of100,1,321,5317,10,229,5556
subtest24of10,pubtest29of100,1,321,5317,11,267,5595
subtest28of10,pubtest29of100,1,321,5317,11,306,5634
subtest26of10,pubtest29of100,1,321,5317,13,343,5673
subtest27of10,pubtest29of100,1,321,5317,10,382,5709
subtest29of10,pubtest210of100,1,323,5860,-4,42,5898
subtest21of10,pubtest210of100,1,323,5860,4,73,5937
subtest210of10,pubtest210of100,1,323,5860,5,112,5977
subtest27of10,pubtest210of100,1,323,5860,6,151,6017
subtest23of10,pubtest210of100,1,323,5860,11,186,6057
subtest28of10,pubtest210of100,1,323,5860,11,226,6097
subtest22of10,pubtest210of100,1,323,5860,15,262,6137
subtest24of10,pubtest210of100,1,323,5860,14,301,6175
subtest26of10,pubtest210of100,1,323,5860,16,341,6217
subtest25of10,pubtest210of100,1,323,5860,14,382,6256
subtest210of10,pubtest211of100,1,323,5784,62,40,5886
subtest24of10,pubtest211of100,1,323,5784,67,74,5925
subtest29of10,pubtest211of100,1,323,5784,67,114,5965
subtest25of10,pubtest211of100,1,323,5784,69,152,6005
subtest26of10,pubtest211of100,1,323,5784,69,192,6045
subtest21of10,pubtest211of100,1,323,5784,69,231,6084
subtest23of10,pubtest211of100,1,323,5784,71,268,6123
subtest28of10,pubtest211of100,1,323,5784,74,307,6165
subtest27of10,pubtest211of100,1,323,5784,74,347,6205
subtest22of10,pubtest211of100,1,323,5784,69,386,6239
subtest25of10,pubtest212of100,1,323,5589,8,42,5639
subtest29of10,pubtest212of100,1,323,5589,9,81,5679
subtest28of10,pubtest212of100,1,323,5589,10,119,5718
subtest24of10,pubtest212of100,1,323,5589,11,159,5759
subtest21of10,pubtest212of100,1,323,5589,13,197,5799
subtest23of10,pubtest212of100,1,323,5589,12,237,5838
subtest27of10,pubtest212of100,1,323,5589,12,277,5878
subtest22of10,pubtest212of100,1,323,5589,26,303,5918
subtest26of10,pubtest212of100,1,323,5589,27,342,5958
subtest210of10,pubtest212of100,1,323,5589,28,381,5998
subtest23of10,pubtest213of100,1,322,5551,18,41,5610
subtest26of10,pubtest213of100,1,322,5551,20,79,5650
subtest29of10,pubtest213of100,1,322,5551,26,112,5689
subtest27of10,pubtest213of100,1,322,5551,26,152,5729
subtest22of10,pubtest213of100,1,322,5551,28,190,5769
subtest21of10,pubtest213of100,1,322,5551,78,180,5809
subtest24of10,pubtest213of100,1,322,5551,80,218,5849
subtest25of10,pubtest213of100,1,322,5551,82,256,5889
subtest210of10,pubtest213of100,1,322,5551,83,295,5929
subtest28of10,pubtest213of100,1,322,5551,85,333,5969
subtest21of10,pubtest214of100,1,323,5745,0,40,5785
subtest26of10,pubtest214of100,1,323,5745,7,71,5823
subtest23of10,pubtest214of100,1,323,5745,11,107,5863
subtest29of10,pubtest214of100,1,323,5745,23,135,5903
subtest22of10,pubtest214of100,1,323,5745,23,175,5943
subtest25of10,pubtest214of100,1,323,5745,20,218,5983
subtest27of10,pubtest214of100,1,323,5745,25,253,6023
subtest24of10,pubtest214of100,1,323,5745,26,292,6063
subtest210of10,pubtest214of100,1,323,5745,25,332,6102
subtest28of10,pubtest214of100,1,323,5745,27,371,6143
subtest27of10,pubtest215of100,1,323,5454,-2,41,5493
subtest24of10,pubtest215of100,1,323,5454,0,78,5532
subtest29of10,pubtest215of100,1,323,5454,4,116,5574
subtest26of10,pubtest215of100,1,323,5454,6,153,5613
subtest210of10,pubtest215of100,1,323,5454,11,187,5652
subtest25of10,pubtest215of100,1,323,5454,10,227,5691
subtest21of10,pubtest215of100,1,323,5454,12,266,5732
subtest23of10,pubtest215of100,1,323,5454,15,302,5771
subtest22of10,pubtest215of100,1,323,5454,15,342,5811
subtest28of10,pubtest215of100,1,323,5454,23,376,5853
subtest21of10,pubtest216of100,1,323,5813,7,40,5860
subtest24of10,pubtest216of100,1,323,5813,8,79,5900
subtest23of10,pubtest216of100,1,323,5813,9,117,5939
subtest28of10,pubtest216of100,1,323,5813,12,154,5979
subtest27of10,pubtest216of100,1,323,5813,13,194,6020
subtest25of10,pubtest216of100,1,323,5813,25,221,6059
subtest22of10,pubtest216of100,1,323,5813,26,260,6099
subtest29of10,pubtest216of100,1,323,5813,26,300,6139
subtest26of10,pubtest216of100,1,323,5813,27,339,6179
subtest210of10,pubtest216of100,1,323,5813,28,379,6220
subtest27of10,pubtest217of100,1,322,5518,2,39,5559
subtest22of10,pubtest217of100,1,322,5518,2,79,5599
subtest21of10,pubtest217of100,1,322,5518,4,117,5639
subtest23of10,pubtest217of100,1,322,5518,17,142,5677
subtest29of10,pubtest217of100,1,322,5518,19,182,5719
subtest26of10,pubtest217of100,1,322,5518,22,220,5760
subtest25of10,pubtest217of100,1,322,5518,28,253,5799
subtest24of10,pubtest217of100,1,322,5518,56,265,5839
subtest28of10,pubtest217of100,1,322,5518,57,304,5879
subtest210of10,pubtest217of100,1,322,5518,67,334,5919
subtest29of10,pubtest218of100,1,323,5324,2,41,5367
subtest21of10,pubtest218of100,1,323,5324,3,80,5407
subtest22of10,pubtest218of100,1,323,5324,3,119,5446
subtest28of10,pubtest218of100,1,323,5324,5,157,5486
subtest27of10,pubtest218of100,1,323,5324,5,196,5525
subtest23of10,pubtest218of100,1,323,5324,7,236,5567
subtest24of10,pubtest218of100,1,323,5324,7,275,5606
subtest25of10,pubtest218of100,1,323,5324,10,312,5646
subtest210of10,pubtest218of100,1,323,5324,57,305,5686
subtest26of10,pubtest218of100,1,323,5324,63,339,5726
subtest210of10,pubtest219of100,1,323,5671,-2,43,5712
subtest25of10,pubtest219of100,1,323,5671,-1,81,5751
subtest21of10,pubtest219of100,1,323,5671,17,104,5792
subtest26of10,pubtest219of100,1,323,5671,18,142,5831
subtest22of10,pubtest219of100,1,323,5671,22,179,5872
subtest29of10,pubtest219of100,1,323,5671,25,215,5911
subtest24of10,pubtest219of100,1,323,5671,25,255,5951
subtest23of10,pubtest219of100,1,323,5671,27,293,5991
subtest27of10,pubtest219of100,1,323,5671,27,333,6031
subtest28of10,pubtest219of100,1,323,5671,27,372,6070
subtest25of10,pubtest220of100,1,323,5405,-2,41,5444
subtest210of10,pubtest220of100,1,323,5405,-2,80,5483
subtest23of10,pubtest220of100,1,323,5405,-1,119,5523
subtest24of10,pubtest220of100,1,323,5405,7,151,5563
subtest21of10,pubtest220of100,1,323,5405,7,191,5603
subtest27of10,pubtest220of100,1,323,5405,8,230,5643
subtest29of10,pubtest220of100,1,323,5405,9,269,5683
subtest26of10,pubtest220of100,1,323,5405,10,309,5724
subtest28of10,pubtest220of100,1,323,5405,10,348,5763
subtest22of10,pubtest220of100,1,323,5405,11,387,5803
subtest21of10,pubtest221of100,1,323,5384,-3,43,5424
subtest24of10,pubtest221of100,1,323,5384,-2,83,5465
subtest28of10,pubtest221of100,1,323,5384,-1,121,5504
subtest23of10,pubtest221of100,1,323,5384,0,160,5544
subtest22of10,pubtest221of100,1,323,5384,1,199,5584
subtest210of10,pubtest221of100,1,323,5384,2,238,5624
subtest26of10,pubtest221of100,1,323,5384,2,278,5664
subtest25of10,pubtest221of100,1,323,5384,6,314,5704
subtest29of10,pubtest221of100,1,323,5384,12,348,5744
subtest27of10,pubtest221of100,1,323,5384,13,385,5782
subtest21of10,pubtest222of100,1,323,5338,2,41,5381
subtest29of10,pubtest222of100,1,323,5338,3,79,5420
subtest27of10,pubtest222of100,1,323,5338,4,119,5461
subtest22of10,pubtest222of100,1,323,5338,2,158,5498
subtest23of10,pubtest222of100,1,323,5338,10,192,5540
subtest28of10,pubtest222of100,1,323,5338,11,231,5580
subtest210of10,pubtest222of100,1,323,5338,12,270,5620
subtest26of10,pubtest222of100,1,323,5338,12,310,5660
subtest25of10,pubtest222of100,1,323,5338,13,349,5700
subtest24of10,pubtest222of100,1,323,5338,14,388,5740
subtest21of10,pubtest223of100,1,323,5349,4,40,5393
subtest23of10,pubtest223of100,1,323,5349,5,78,5432
subtest28of10,pubtest223of100,1,323,5349,8,115,5472
subtest210of10,pubtest223of100,1,323,5349,11,153,5513
subtest29of10,pubtest223of100,1,323,5349,10,193,5552
subtest24of10,pubtest223of100,1,323,5349,10,231,5590
subtest27of10,pubtest223of100,1,323,5349,10,271,5630
subtest25of10,pubtest223of100,1,323,5349,25,298,5672
subtest26of10,pubtest223of100,1,323,5349,25,338,5712
subtest22of10,pubtest223of100,1,323,5349,25,377,5751
subtest21of10,pubtest224of100,1,323,5891,-5,41,5927
subtest27of10,pubtest224of100,1,323,5891,2,73,5966
subtest28of10,pubtest224of100,1,323,5891,3,112,6006
subtest23of10,pubtest224of100,1,323,5891,4,151,6046
subtest26of10,pubtest224of100,1,323,5891,11,184,6086
subtest29of10,pubtest224of100,1,323,5891,11,224,6126
subtest25of10,pubtest224of100,1,323,5891,12,263,6166
subtest22of10,pubtest224of100,1,323,5891,12,303,6206
subtest24of10,pubtest224of100,1,323,5891,17,338,6246
subtest210of10,pubtest224of100,1,323,5891,17,378,6286
subtest27of10,pubtest225of100,1,323,6152,-4,38,6186
subtest22of10,pubtest225of100,1,323,6152,-3,76,6225
subtest21of10,pubtest225of100,1,323,6152,0,113,6265
subtest26of10,pubtest225of100,1,323,6152,4,149,6305
subtest25of10,pubtest225of100,1,323,6152,4,189,6345
subtest23of10,pubtest225of100,1,323,6152,9,224,6385
subtest29of10,pubtest225of100,1,323,6152,10,263,6425
subtest24of10,pubtest225of100,1,323,6152,11,302,6465
subtest28of10,pubtest225of100,1,323,6152,14,339,6505
subtest210of10,pubtest225of100,1,323,6152,15,378,6545
subtest25of10,pubtest226of100,1,323,5554,-4,39,5589
subtest22of10,pubtest226of100,1,323,5554,-3,78,5629
subtest23of10,pubtest226of100,1,323,5554,2,113,5669
subtest210of10,pubtest226of100,1,323,5554,5,150,5709
subtest27of10,pubtest226of100,1,323,5554,6,189,5749
subtest28of10,pubtest226of100,1,323,5554,12,223,5789
subtest21of10,pubtest226of100,1,323,5554,12,263,5829
subtest29of10,pubtest226of100,1,323,5554,14,301,5869
subtest26of10,pubtest226of100,1,323,5554,20,335,5909
subtest24of10,pubtest226of100,1,323,5554,26,370,5950
subtest29of10,pubtest227of100,1,323,5291,-1,49,5339
subtest210of10,pubtest227of100,1,323,5291,0,87,5378
subtest25of10,pubtest227of100,1,323,5291,1,127,5419
subtest23of10,pubtest227of100,1,323,5291,4,163,5458
subtest24of10,pubtest227of100,1,323,5291,6,201,5498
subtest27of10,pubtest227of100,1,323,5291,7,240,5538
subtest26of10,pubtest227of100,1,323,5291,10,277,5578
subtest21of10,pubtest227of100,1,323,5291,11,316,5618
subtest28of10,pubtest227of100,1,323,5291,12,352,5655
subtest22of10,pubtest227of100,1,323,5291,16,391,5698
subtest21of10,pubtest228of100,1,323,5308,-2,40,5346
subtest25of10,pubtest228of100,1,323,5308,7,71,5386
subtest23of10,pubtest228of100,1,323,5308,11,107,5426
subtest27of10,pubtest228of100,1,323,5308,12,147,5467
subtest26of10,pubtest228of100,1,323,5308,11,186,5505
subtest29of10,pubtest228of100,1,323,5308,19,219,5546
subtest24of10,pubtest228of100,1,323,5308,19,259,5586
subtest210of10,pubtest228of100,1,323,5308,24,294,5626
subtest22of10,pubtest228of100,1,323,5308,28,330,5666
subtest28of10,pubtest228of100,1,323,5308,29,369,5706
subtest24of10,pubtest229of100,1,321,5459,2,45,5506
subtest28of10,pubtest229of100,1,321,5459,4,84,5547
subtest21of10,pubtest229of100,1,321,5459,20,107,5586
subtest22of10,pubtest229of100,1,321,5459,33,134,5626
subtest27of10,pubtest229of100,1,321,5459,33,174,5666
subtest23of10,pubtest229of100,1,321,5459,49,198,5706
subtest210of10,pubtest229of100,1,321,5459,52,235,5746
subtest25of10,pubtest229of100,1,321,5459,54,273,5786
subtest29of10,pubtest229of100,1,321,5459,58,309,5826
subtest26of10,pubtest229of100,1,321,5459,58,349,5866
subtest22of10,pubtest230of100,1,323,5289,2,38,5329
subtest21of10,pubtest230of100,1,323,5289,2,78,5369
subtest27of10,pubtest230of100,1,323,5289,4,115,5408
subtest29of10,pubtest230of100,1,323,5289,5,154,5448
subtest25of10,pubtest230of100,1,323,5289,6,193,5488
subtest28of10,pubtest230of100,1,323,5289,22,217,5528
subtest23of10,pubtest230of100,1,323,5289,25,254,5568
subtest210of10,pubtest230of100,1,323,5289,25,292,5606
subtest26of10,pubtest230of100,1,323,5289,28,331,5648
subtest24of10,pubtest230of100,1,323,5289,29,370,5688
subtest28of10,pubtest231of100,1,323,7416,7,38,7461
subtest23of10,pubtest231of100,1,323,7416,8,77,7501
subtest25of10,pubtest231of100,1,323,7416,10,115,7541
subtest29of10,pubtest231of100,1,323,7416,10,155,7581
subtest24of10,pubtest231of100,1,323,7416,12,193,7621
subtest210of10,pubtest231of100,1,323,7416,12,233,7661
subtest26of10,pubtest231of100,1,323,7416,13,272,7701
subtest21of10,pubtest231of100,1,323,7416,13,312,7741
subtest27of10,pubtest231of100,1,323,7416,12,350,7778
subtest22of10,pubtest231of100,1,323,7416,16,389,7821
subtest27of10,pubtest232of100,1,323,5773,-1,41,5813
subtest21of10,pubtest232of100,1,323,5773,-1,80,5852
subtest23of10,pubtest232of100,1,323,5773,1,118,5892
subtest29of10,pubtest232of100,1,323,5773,10,149,5932
subtest22of10,pubtest232of100,1,323,5773,10,188,5971
subtest28of10,pubtest232of100,1,323,5773,12,227,6012
subtest25of10,pubtest232of100,1,323,5773,15,264,6052
subtest210of10,pubtest232of100,1,323,5773,16,303,6092
subtest24of10,pubtest232of100,1,323,5773,17,342,6132
subtest26of10,pubtest232of100,1,323,5773,21,378,6172
subtest29of10,pubtest233of100,1,323,5722,-2,41,5761
subtest24of10,pubtest233of100,1,323,5722,0,78,5800
subtest25of10,pubtest233of100,1,323,5722,0,118,5840
subtest27of10,pubtest233of100,1,323,5722,5,153,5880
subtest210of10,pubtest233of100,1,323,5722,6,192,5920
subtest26of10,pubtest233of100,1,323,5722,7,231,5960
subtest22of10,pubtest233of100,1,323,5722,12,265,5999
subtest23of10,pubtest233of100,1,323,5722,14,304,6040
subtest28of10,pubtest233of100,1,323,5722,21,337,6080
subtest21of10,pubtest233of100,1,323,5722,21,377,6120
subtest25of10,pubtest234of100,1,323,5734,-3,41,5772
subtest26of10,pubtest234of100,1,323,5734,1,76,5811
subtest27of10,pubtest234of100,1,323,5734,1,115,5850
subtest21of10,pubtest234of100,1,323,5734,3,154,5891
subtest29of10,pubtest234of100,1,323,5734,4,192,5930
subtest22of10,pubtest234of100,1,323,5734,8,228,5970
subtest23of10,pubtest234of100,1,323,5734,17,259,6010
subtest210of10,pubtest234of100,1,323,5734,18,298,6050
subtest24of10,pubtest234of100,1,323,5734,27,329,6090
subtest28of10,pubtest234of100,1,323,5734,28,368,6130
subtest21of10,pubtest235of100,1,321,6662,-4,39,6697
subtest23of10,pubtest235of100,1,321,6662,1,73,6736
subtest210of10,pubtest235of100,1,321,6662,1,113,6776
subtest27of10,pubtest235of100,1,321,6662,7,146,6815
subtest24of10,pubtest235of100,1,321,6662,9,186,6857
subtest29of10,pubtest235of100,1,321,6662,8,225,6895
subtest22of10,pubtest235of100,1,321,6662,7,265,6934
subtest25of10,pubtest235of100,1,321,6662,10,304,6976
subtest26of10,pubtest235of100,1,321,6662,13,341,7016
subtest28of10,pubtest235of100,1,321,6662,13,381,7056
subtest210of10,pubtest236of100,1,323,5867,-3,40,5904
subtest23of10,pubtest236of100,1,323,5867,-2,78,5943
subtest27of10,pubtest236of100,1,323,5867,1,115,5983
subtest28of10,pubtest236of100,1,323,5867,1,155,6023
subtest25of10,pubtest236of100,1,323,5867,2,194,6063
subtest21of10,pubtest236of100,1,323,5867,6,230,6103
subtest29of10,pubtest236of100,1,323,5867,7,267,6141
subtest22of10,pubtest236of100,1,323,5867,10,306,6183
subtest26of10,pubtest236of100,1,323,5867,10,346,6223
subtest24of10,pubtest236of100,1,323,5867,11,385,6263
subtest24of10,pubtest237of100,1,323,5928,-3,38,5963
subtest23of10,pubtest237of100,1,323,5928,-2,77,6003
subtest28of10,pubtest237of100,1,323,5928,-1,115,6042
subtest26of10,pubtest237of100,1,323,5928,1,153,6082
subtest25of10,pubtest237of100,1,323,5928,6,188,6122
subtest27of10,pubtest237of100,1,323,5928,9,225,6162
subtest22of10,pubtest237of100,1,323,5928,12,262,6202
subtest21of10,pubtest237of100,1,323,5928,13,302,6243
subtest210of10,pubtest237of100,1,323,5928,33,321,6282
subtest29of10,pubtest237of100,1,323,5928,35,359,6322
subtest29of10,pubtest238of100,1,323,8408,-1,41,8448
subtest22of10,pubtest238of100,1,323,8408,6,74,8488
subtest27of10,pubtest238of100,1,323,8408,7,113,8528
subtest28of10,pubtest238of100,1,323,8408,9,149,8566
subtest25of10,pubtest238of100,1,323,8408,10,189,8607
subtest23of10,pubtest238of100,1,323,8408,11,228,8647
subtest21of10,pubtest238of100,1,323,8408,11,268,8687
subtest210of10,pubtest238of100,1,323,8408,45,274,8727
subtest26of10,pubtest238of100,1,323,8408,45,313,8766
subtest24of10,pubtest238of100,1,323,8408,46,353,8807
subtest21of10,pubtest239of100,1,323,6725,-3,39,6761
subtest28of10,pubtest239of100,1,323,6725,1,74,6800
subtest27of10,pubtest239of100,1,323,6725,1,114,6840
subtest26of10,pubtest239of100,1,323,6725,3,152,6880
subtest25of10,pubtest239of100,1,323,6725,3,192,6920
subtest23of10,pubtest239of100,1,323,6725,6,229,6960
subtest29of10,pubtest239of100,1,323,6725,6,269,7000
subtest24of10,pubtest239of100,1,323,6725,8,307,7040
subtest22of10,pubtest239of100,1,323,6725,8,347,7080
subtest210of10,pubtest239of100,1,323,6725,9,386,7120
subtest25of10,pubtest240of100,1,323,5416,-4,38,5450
subtest21of10,pubtest240of100,1,323,5416,2,71,5489
subtest29of10,pubtest240of100,1,323,5416,3,110,5529
subtest210of10,pubtest240of100,1,323,5416,2,149,5567
subtest23of10,pubtest240of100,1,323,5416,4,189,5609
subtest27of10,pubtest240of100,1,323,5416,5,229,5650
subtest28of10,pubtest240of100,1,323,5416,7,266,5689
subtest24of10,pubtest240of100,1,323,5416,8,305,5729
subtest22of10,pubtest240of100,1,323,5416,9,344,5769
subtest26of10,pubtest240of100,1,323,5416,10,383,5809
subtest23of10,pubtest241of100,1,323,5425,0,108,5533
subtest24of10,pubtest241of100,1,323,5425,0,146,5571
subtest27of10,pubtest241of100,1,323,5425,4,182,5611
subtest210of10,pubtest241of100,1,323,5425,5,221,5651
subtest21of10,pubtest241of100,1,323,5425,6,260,5691
subtest28of10,pubtest241of100,1,323,5425,8,298,5731
subtest29of10,pubtest241of100,1,323,5425,14,332,5771
subtest25of10,pubtest241of100,1,323,5425,15,370,5810
subtest22of10,pubtest241of100,1,323,5425,16,410,5851
subtest26of10,pubtest241of100,1,323,5425,15,449,5889
subtest27of10,pubtest242of100,1,323,5374,22,40,5436
subtest26of10,pubtest242of100,1,323,5374,23,78,5475
subtest23of10,pubtest242of100,1,323,5374,29,112,5515
subtest25of10,pubtest242of100,1,323,5374,32,149,5555
subtest29of10,pubtest242of100,1,323,5374,32,188,5594
subtest21of10,pubtest242of100,1,323,5374,34,226,5634
subtest22of10,pubtest242of100,1,323,5374,37,264,5675
subtest28of10,pubtest242of100,1,323,5374,37,304,5715
subtest24of10,pubtest242of100,1,323,5374,36,343,5753
subtest210of10,pubtest242of100,1,323,5374,39,382,5795
subtest29of10,pubtest243of100,1,323,5441,7,39,5487
subtest28of10,pubtest243of100,1,323,5441,9,76,5526
subtest23of10,pubtest243of100,1,323,5441,11,114,5566
subtest27of10,pubtest243of100,1,323,5441,18,147,5606
subtest25of10,pubtest243of100,1,323,5441,17,188,5646
subtest22of10,pubtest243of100,1,323,5441,18,226,5685
subtest26of10,pubtest243of100,1,323,5441,20,265,5726
subtest210of10,pubtest243of100,1,323,5441,20,305,5766
subtest21of10,pubtest243of100,1,323,5441,21,344,5806
subtest24of10,pubtest243of100,1,323,5441,22,383,5846
subtest26of10,pubtest244of100,1,323,6212,1,41,6254
subtest27of10,pubtest244of100,1,323,6212,1,80,6293
subtest25of10,pubtest244of100,1,323,6212,3,118,6333
subtest28of10,pubtest244of100,1,323,6212,4,157,6373
subtest21of10,pubtest244of100,1,323,6212,5,196,6413
subtest23of10,pubtest244of100,1,323,6212,6,235,6453
subtest29of10,pubtest244of100,1,323,6212,6,274,6492
subtest22of10,pubtest244of100,1,323,6212,7,314,6533
subtest24of10,pubtest244of100,1,323,6212,9,352,6573
subtest210of10,pubtest244of100,1,323,6212,6,391,6609
subtest29of10,pubtest245of100,1,322,5383,3,39,5425
subtest26of10,pubtest245of100,1,322,5383,4,79,5466
subtest23of10,pubtest245of100,1,322,5383,5,116,5504
subtest25of10,pubtest245of100,1,322,5383,7,151,5541
subtest21of10,pubtest245of100,1,322,5383,10,191,5584
subtest24of10,pubtest245of100,1,322,5383,10,231,5624
subtest28of10,pubtest245of100,1,322,5383,12,269,5664
subtest210of10,pubtest245of100,1,322,5383,12,309,5704
subtest22of10,pubtest245of100,1,322,5383,7,348,5738
subtest27of10,pubtest245of100,1,322,5383,14,387,5784
subtest26of10,pubtest246of100,1,323,5667,83,40,5790
subtest27of10,pubtest246of100,1,323,5667,84,78,5829
subtest28of10,pubtest246of100,1,323,5667,86,118,5871
subtest23of10,pubtest246of100,1,323,5667,86,157,5910
subtest25of10,pubtest246of100,1,323,5667,87,195,5949
subtest24of10,pubtest246of100,1,323,5667,88,234,5989
subtest22of10,pubtest246of100,1,323,5667,89,273,6029
subtest21of10,pubtest246of100,1,323,5667,86,313,6066
subtest29of10,pubtest246of100,1,323,5667,86,352,6105
subtest210of10,pubtest246of100,1,323,5667,91,391,6149
subtest23of10,pubtest247of100,1,323,5529,-4,41,5566
subtest27of10,pubtest247of100,1,323,5529,-4,80,5605
subtest26of10,pubtest247of100,1,323,5529,0,116,5645
subtest21of10,pubtest247of100,1,323,5529,4,152,5685
subtest29of10,pubtest247of100,1,323,5529,5,191,5725
subtest22of10,pubtest247of100,1,323,5529,7,229,5765
subtest28of10,pubtest247of100,1,323,5529,7,269,5805
subtest210of10,pubtest247of100,1,323,5529,10,306,5845
subtest24of10,pubtest247of100,1,323,5529,11,344,5884
subtest25of10,pubtest247of100,1,323,5529,12,384,5925
subtest29of10,pubtest248of100,1,323,5444,0,38,5482
subtest25of10,pubtest248of100,1,323,5444,9,68,5521
subtest23of10,pubtest248of100,1,323,5444,9,107,5560
subtest26of10,pubtest248of100,1,323,5444,9,145,5598
subtest21of10,pubtest248of100,1,323,5444,13,184,5641
subtest28of10,pubtest248of100,1,323,5444,14,224,5682
subtest27of10,pubtest248of100,1,323,5444,12,263,5719
subtest22of10,pubtest248of100,1,323,5444,15,301,5760
subtest210of10,pubtest248of100,1,323,5444,16,341,5801
subtest24of10,pubtest248of100,1,323,5444,16,380,5840
subtest27of10,pubtest249of100,1,323,5381,5,38,5424
subtest28of10,pubtest249of100,1,323,5381,5,77,5463
subtest29of10,pubtest249of100,1,323,5381,7,115,5503
subtest25of10,pubtest249of100,1,323,5381,7,155,5543
subtest21of10,pubtest249of100,1,323,5381,8,194,5583
subtest24of10,pubtest249of100,1,323,5381,9,234,5624
subtest23of10,pubtest249of100,1,323,5381,10,272,5663
subtest22of10,pubtest249of100,1,323,5381,12,310,5703
subtest210of10,pubtest249of100,1,323,5381,12,348,5741
subtest26of10,pubtest249of100,1,323,5381,11,387,5779
subtest28of10,pubtest250of100,1,323,6634,31,43,6708
subtest27of10,pubtest250of100,1,323,6634,31,82,6747
subtest23of10,pubtest250of100,1,323,6634,35,119,6788
subtest29of10,pubtest250of100,1,323,6634,37,157,6828
subtest24of10,pubtest250of100,1,323,6634,40,194,6868
subtest21of10,pubtest250of100,1,323,6634,41,233,6908
subtest25of10,pubtest250of100,1,323,6634,45,269,6948
subtest210of10,pubtest250of100,1,323,6634,46,308,6988
subtest22of10,pubtest250of100,1,323,6634,49,345,7028
subtest26of10,pubtest250of100,1,323,6634,48,385,7067
subtest23of10,pubtest251of100,1,323,6567,34,40,6641
subtest22of10,pubtest251of100,1,323,6567,34,77,6678
subtest21of10,pubtest251of100,1,323,6567,37,116,6720
subtest24of10,pubtest251of100,1,323,6567,38,156,6761
subtest28of10,pubtest251of100,1,323,6567,39,194,6800
subtest210of10,pubtest251of100,1,323,6567,39,233,6839
subtest25of10,pubtest251of100,1,323,6567,39,272,6878
subtest27of10,pubtest251of100,1,323,6567,39,312,6918
subtest29of10,pubtest251of100,1,323,6567,50,343,6960
subtest26of10,pubtest251of100,1,323,6567,50,383,7000
subtest29of10,pubtest252of100,1,323,6982,-1,39,7020
subtest21of10,pubtest252of100,1,323,6982,6,71,7059
subtest28of10,pubtest252of100,1,323,6982,6,111,7099
subtest26of10,pubtest252of100,1,323,6982,31,126,7139
subtest27of10,pubtest252of100,1,323,6982,31,165,7178
subtest25of10,pubtest252of100,1,323,6982,32,205,7219
subtest22of10,pubtest252of100,1,323,6982,34,243,7259
subtest23of10,pubtest252of100,1,323,6982,33,283,7298
subtest24of10,pubtest252of100,1,323,6982,37,320,7339
subtest210of10,pubtest252of100,1,323,6982,38,359,7379
subtest28of10,pubtest253of100,1,322,6641,-7,39,6673
subtest23of10,pubtest253of100,1,322,6641,-5,77,6713
subtest24of10,pubtest253of100,1,322,6641,-3,114,6752
subtest25of10,pubtest253of100,1,322,6641,7,144,6792
subtest29of10,pubtest253of100,1,322,6641,8,183,6832
subtest27of10,pubtest253of100,1,322,6641,8,223,6872
subtest22of10,pubtest253of100,1,322,6641,10,261,6912
subtest21of10,pubtest253of100,1,322,6641,15,296,6952
subtest210of10,pubtest253of100,1,322,6641,15,336,6992
subtest26of10,pubtest253of100,1,322,6641,17,376,7034
subtest210of10,pubtest254of100,1,323,5688,-3,41,5726
subtest27of10,pubtest254of100,1,323,5688,-1,79,5766
subtest28of10,pubtest254of100,1,323,5688,-1,118,5805
subtest21of10,pubtest254of100,1,323,5688,1,156,5845
subtest25of10,pubtest254of100,1,323,5688,2,195,5885
subtest24of10,pubtest254of100,1,323,5688,2,235,5925
subtest23of10,pubtest254of100,1,323,5688,4,273,5965
subtest22of10,pubtest254of100,1,323,5688,4,313,6005
subtest26of10,pubtest254of100,1,323,5688,6,351,6045
subtest29of10,pubtest254of100,1,323,5688,6,391,6085
subtest23of10,pubtest255of100,1,322,5880,4,40,5924
subtest22of10,pubtest255of100,1,322,5880,4,79,5963
subtest28of10,pubtest255of100,1,322,5880,12,111,6003
subtest24of10,pubtest255of100,1,322,5880,12,151,6043
subtest210of10,pubtest255of100,1,322,5880,14,189,6083
subtest21of10,pubtest255of100,1,322,5880,19,224,6123
subtest26of10,pubtest255of100,1,322,5880,19,264,6163
subtest25of10,pubtest255of100,1,322,5880,20,303,6203
subtest27of10,pubtest255of100,1,322,5880,17,343,6240
subtest29of10,pubtest255of100,1,322,5880,22,381,6283
subtest29of10,pubtest256of100,1,323,6131,-2,39,6168
subtest21of10,pubtest256of100,1,323,6131,4,72,6207
subtest26of10,pubtest256of100,1,323,6131,5,111,6247
subtest25of10,pubtest256of100,1,323,6131,6,150,6287
subtest210of10,pubtest256of100,1,323,6131,6,190,6327
subtest23of10,pubtest256of100,1,323,6131,7,230,6368
subtest27of10,pubtest256of100,1,323,6131,8,268,6407
subtest28of10,pubtest256of100,1,323,6131,9,307,6447
subtest24of10,pubtest256of100,1,323,6131,11,345,6487
subtest22of10,pubtest256of100,1,323,6131,11,385,6527
subtest21of10,pubtest257of100,1,323,6315,-5,40,6350
subtest24of10,pubtest257of100,1,323,6315,-4,79,6390
subtest27of10,pubtest257of100,1,323,6315,-2,117,6430
subtest23of10,pubtest257of100,1,323,6315,-1,156,6470
subtest28of10,pubtest257of100,1,323,6315,-1,196,6510
subtest29of10,pubtest257of100,1,323,6315,1,235,6551
subtest22of10,pubtest257of100,1,323,6315,2,273,6590
subtest25of10,pubtest257of100,1,323,6315,7,308,6630
subtest210of10,pubtest257of100,1,323,6315,8,347,6670
subtest26of10,pubtest257of100,1,323,6315,11,384,6710
subtest28of10,pubtest258of100,1,323,5410,1,45,5456
subtest25of10,pubtest258of100,1,323,5410,10,77,5497
subtest23of10,pubtest258of100,1,323,5410,9,116,5535
subtest21of10,pubtest258of100,1,323,5410,80,84,5574
subtest27of10,pubtest258of100,1,323,5410,82,123,5615
subtest29of10,pubtest258of100,1,323,5410,82,162,5654
subtest22of10,pubtest258of100,1,323,5410,84,200,5694
subtest24of10,pubtest258of100,1,323,5410,85,240,5735
subtest210of10,pubtest258of100,1,323,5410,84,279,5773
subtest26of10,pubtest258of100,1,323,5410,84,319,5813
subtest21of10,pubtest259of100,1,323,5384,3,41,5428
subtest28of10,pubtest259of100,1,323,5384,4,79,5467
subtest25of10,pubtest259of100,1,323,5384,6,117,5507
subtest27of10,pubtest259of100,1,323,5384,14,148,5546
subtest23of10,pubtest259of100,1,323,5384,15,188,5587
subtest26of10,pubtest259of100,1,323,5384,15,227,5626
subtest24of10,pubtest259of100,1,323,5384,14,267,5665
subtest29of10,pubtest259of100,1,323,5384,17,306,5707
subtest22of10,pubtest259of100,1,323,5384,25,337,5746
subtest210of10,pubtest259of100,1,323,5384,26,377,5787
subtest210of10,pubtest260of100,1,323,5471,-3,39,5507
subtest23of10,pubtest260of100,1,323,5471,1,75,5547
subtest21of10,pubtest260of100,1,323,5471,2,113,5586
subtest27of10,pubtest260of100,1,323,5471,9,146,5626
subtest26of10,pubtest260of100,1,323,5471,9,186,5666
subtest29of10,pubtest260of100,1,323,5471,10,225,5706
subtest22of10,pubtest260of100,1,323,5471,42,233,5746
subtest28of10,pubtest260of100,1,323,5471,44,271,5786
subtest25of10,pubtest260of100,1,323,5471,44,311,5826
subtest24of10,pubtest260of100,1,323,5471,46,349,5866
subtest25of10,pubtest261of100,1,323,5358,17,40,5415
subtest28of10,pubtest261of100,1,323,5358,19,76,5453
subtest29of10,pubtest261of100,1,323,5358,21,115,5494
subtest210of10,pubtest261of100,1,323,5358,23,153,5534
subtest23of10,pubtest261of100,1,323,5358,23,192,5573
subtest22of10,pubtest261of100,1,323,5358,25,231,5614
subtest27of10,pubtest261of100,1,323,5358,25,271,5654
subtest21of10,pubtest261of100,1,323,5358,26,310,5694
subtest24of10,pubtest261of100,1,323,5358,27,350,5735
subtest26of10,pubtest261of100,1,323,5358,28,388,5774
subtest21of10,pubtest262of100,1,323,5494,-2,39,5531
subtest22of10,pubtest262of100,1,323,5494,-1,77,5570
subtest23of10,pubtest262of100,1,323,5494,1,115,5610
subtest27of10,pubtest262of100,1,323,5494,4,152,5650
subtest26of10,pubtest262of100,1,323,5494,6,190,5690
subtest29of10,pubtest262of100,1,323,5494,6,230,5730
subtest25of10,pubtest262of100,1,323,5494,9,267,5770
subtest210of10,pubtest262of100,1,323,5494,12,303,5809
subtest28of10,pubtest262of100,1,323,5494,13,343,5850
subtest24of10,pubtest262of100,1,323,5494,13,382,5889
subtest22of10,pubtest263of100,1,322,5388,-3,41,5426
subtest29of10,pubtest263of100,1,322,5388,-1,78,5465
subtest24of10,pubtest263of100,1,322,5388,2,115,5505
subtest23of10,pubtest263of100,1,322,5388,3,154,5545
subtest25of10,pubtest263of100,1,322,5388,5,192,5585
subtest26of10,pubtest263of100,1,322,5388,5,232,5625
subtest27of10,pubtest263of100,1,322,5388,6,271,5665
subtest21of10,pubtest263of100,1,322,5388,7,310,5705
subtest28of10,pubtest263of100,1,322,5388,8,349,5745
subtest210of10,pubtest263of100,1,322,5388,8,389,5785
subtest22of10,pubtest264of100,1,322,5302,4,39,5345
subtest29of10,pubtest264of100,1,322,5302,5,77,5384
subtest23of10,pubtest264of100,1,322,5302,10,112,5424
subtest24of10,pubtest264of100,1,322,5302,10,152,5464
subtest27of10,pubtest264of100,1,322,5302,12,190,5504
subtest28of10,pubtest264of100,1,322,5302,12,230,5544
subtest21of10,pubtest264of100,1,322,5302,12,269,5583
subtest25of10,pubtest264of100,1,322,5302,15,307,5624
subtest210of10,pubtest264of100,1,322,5302,15,347,5664
subtest26of10,pubtest264of100,1,322,5302,14,386,5702
subtest26of10,pubtest265of100,1,323,5222,-4,41,5259
subtest27of10,pubtest265of100,1,323,5222,17,59,5298
subtest210of10,pubtest265of100,1,323,5222,17,99,5338
subtest22of10,pubtest265of100,1,323,5222,21,134,5377
subtest21of10,pubtest265of100,1,323,5222,25,170,5417
subtest29of10,pubtest265of100,1,323,5222,27,208,5457
subtest28of10,pubtest265of100,1,323,5222,28,246,5496
subtest25of10,pubtest265of100,1,323,5222,30,285,5537
subtest24of10,pubtest265of100,1,323,5222,32,323,5577
subtest23of10,pubtest265of100,1,323,5222,32,362,5616
subtest29of10,pubtest266of100,1,321,5388,-5,48,5431
subtest210of10,pubtest266of100,1,321,5388,-1,82,5469
subtest27of10,pubtest266of100,1,321,5388,1,120,5509
subtest26of10,pubtest266of100,1,321,5388,2,160,5550
subtest23of10,pubtest266of100,1,321,5388,3,198,5589
subtest21of10,pubtest266of100,1,321,5388,6,236,5630
subtest25of10,pubtest266of100,1,321,5388,4,276,5668
subtest28of10,pubtest266of100,1,321,5388,7,315,5710
subtest24of10,pubtest266of100,1,321,5388,11,353,5752
subtest22of10,pubtest266of100,1,321,5388,13,390,5791
subtest23of10,pubtest267of100,1,323,5406,2,43,5451
subtest26of10,pubtest267of100,1,323,5406,3,81,5490
subtest28of10,pubtest267of100,1,323,5406,7,117,5530
subtest25of10,pubtest267of100,1,323,5406,8,156,5570
subtest27of10,pubtest267of100,1,323,5406,35,169,5610
subtest24of10,pubtest267of100,1,323,5406,36,207,5649
subtest22of10,pubtest267of100,1,323,5406,37,247,5690
subtest29of10,pubtest267of100,1,323,5406,37,286,5729
subtest21of10,pubtest267of100,1,323,5406,39,325,5770
subtest210of10,pubtest267of100,1,323,5406,40,364,5810
subtest23of10,pubtest268of100,1,323,5298,2,39,5339
subtest25of10,pubtest268of100,1,323,5298,3,77,5378
subtest24of10,pubtest268of100,1,323,5298,16,104,5418
subtest29of10,pubtest268of100,1,323,5298,17,141,5456
subtest27of10,pubtest268of100,1,323,5298,19,181,5498
subtest28of10,pubtest268of100,1,323,5298,20,220,5538
subtest21of10,pubtest268of100,1,323,5298,30,250,5578
subtest22of10,pubtest268of100,1,323,5298,30,290,5618
subtest210of10,pubtest268of100,1,323,5298,32,328,5658
subtest26of10,pubtest268of100,1,323,5298,31,368,5697
subtest24of10,pubtest269of100,1,323,5295,0,39,5334
subtest27of10,pubtest269of100,1,323,5295,-1,79,5373
subtest25of10,pubtest269of100,1,323,5295,3,116,5414
subtest210of10,pubtest269of100,1,323,5295,4,154,5453
subtest21of10,pubtest269of100,1,323,5295,5,193,5493
subtest26of10,pubtest269of100,1,323,5295,6,232,5533
subtest29of10,pubtest269of100,1,323,5295,6,271,5572
subtest23of10,pubtest269of100,1,323,5295,8,310,5613
subtest22of10,pubtest269of100,1,323,5295,8,350,5653
subtest28of10,pubtest269of100,1,323,5295,12,386,5693
subtest23of10,pubtest270of100,1,323,6001,2,41,6044
subtest26of10,pubtest270of100,1,323,6001,4,78,6083
subtest27of10,pubtest270of100,1,323,6001,3,119,6123
subtest29of10,pubtest270of100,1,323,6001,8,154,6163
subtest210of10,pubtest270of100,1,323,6001,12,190,6203
subtest25of10,pubtest270of100,1,323,6001,13,228,6242
subtest28of10,pubtest270of100,1,323,6001,14,268,6283
subtest21of10,pubtest270of100,1,323,6001,16,306,6323
subtest24of10,pubtest270of100,1,323,6001,17,346,6364
subtest22of10,pubtest270of100,1,323,6001,18,384,6403
subtest24of10,pubtest271of100,1,323,5609,-1,45,5653
subtest25of10,pubtest271of100,1,323,5609,-1,84,5692
subtest27of10,pubtest271of100,1,323,5609,3,120,5732
subtest22of10,pubtest271of100,1,323,5609,2,160,5771
subtest21of10,pubtest271of100,1,323,5609,5,198,5812
subtest23of10,pubtest271of100,1,323,5609,5,238,5852
subtest210of10,pubtest271of100,1,323,5609,6,277,5892
subtest29of10,pubtest271of100,1,323,5609,8,315,5932
subtest26of10,pubtest271of100,1,323,5609,8,355,5972
subtest28of10,pubtest271of100,1,323,5609,16,387,6012
subtest25of10,pubtest272of100,1,323,5246,3,95,5344
subtest21of10,pubtest272of100,1,323,5246,7,131,5384
subtest26of10,pubtest272of100,1,323,5246,7,169,5422
subtest24of10,pubtest272of100,1,323,5246,9,208,5463
subtest29of10,pubtest272of100,1,323,5246,9,248,5503
subtest23of10,pubtest272of100,1,323,5246,11,286,5543
subtest27of10,pubtest272of100,1,323,5246,12,238,5496
subtest210of10,pubtest272of100,1,323,5246,11,278,5535
subtest22of10,pubtest272of100,1,323,5246,99,318,5663
subtest28of10,pubtest272of100,1,323,5246,101,356,5703
subtest22of10,pubtest273of100,1,321,5345,-4,46,5387
subtest29of10,pubtest273of100,1,321,5345,-2,82,5425
subtest26of10,pubtest273of100,1,321,5345,0,120,5465
subtest28of10,pubtest273of100,1,321,5345,1,159,5505
subtest25of10,pubtest273of100,1,321,5345,4,196,5545
subtest27of10,pubtest273of100,1,321,5345,6,234,5585
subtest210of10,pubtest273of100,1,321,5345,6,274,5625
subtest24of10,pubtest273of100,1,321,5345,7,313,5665
subtest23of10,pubtest273of100,1,321,5345,7,353,5705
subtest21of10,pubtest273of100,1,321,5345,9,391,5745
subtest21of10,pubtest274of100,1,323,5330,11,40,5381
subtest26of10,pubtest274of100,1,323,5330,12,78,5420
subtest23of10,pubtest274of100,1,323,5330,13,117,5460
subtest22of10,pubtest274of100,1,323,5330,14,156,5500
subtest29of10,pubtest274of100,1,323,5330,15,195,5540
subtest25of10,pubtest274of100,1,323,5330,18,233,5581
subtest27of10,pubtest274of100,1,323,5330,20,270,5620
subtest28of10,pubtest274of100,1,323,5330,22,308,5660
subtest24of10,pubtest274of100,1,323,5330,25,345,5700
subtest210of10,pubtest274of100,1,323,5330,26,384,5740
subtest27of10,pubtest275of100,1,323,5296,3,42,5341
subtest29of10,pubtest275of100,1,323,5296,3,81,5380
subtest24of10,pubtest275of100,1,323,5296,5,119,5420
subtest25of10,pubtest275of100,1,323,5296,5,158,5459
subtest21of10,pubtest275of100,1,323,5296,14,188,5498
subtest210of10,pubtest275of100,1,323,5296,17,227,5540
subtest22of10,pubtest275of100,1,323,5296,15,267,5578
subtest28of10,pubtest275of100,1,323,5296,19,305,5620
subtest23of10,pubtest275of100,1,323,5296,19,345,5660
subtest26of10,pubtest275of100,1,323,5296,19,384,5699
subtest28of10,pubtest276of100,1,323,5433,0,38,5471
subtest24of10,pubtest276of100,1,323,5433,11,67,5511
subtest21of10,pubtest276of100,1,323,5433,10,108,5551
subtest27of10,pubtest276of100,1,323,5433,13,147,5593
subtest23of10,pubtest276of100,1,323,5433,14,185,5632
subtest25of10,pubtest276of100,1,323,5433,11,225,5669
subtest29of10,pubtest276of100,1,323,5433,13,264,5710
subtest210of10,pubtest276of100,1,323,5433,17,301,5751
subtest26of10,pubtest276of100,1,323,5433,17,340,5790
subtest22of10,pubtest276of100,1,323,5433,19,379,5831
subtest22of10,pubtest277of100,1,323,5407,-1,39,5445
subtest29of10,pubtest277of100,1,323,5407,0,77,5484
subtest28of10,pubtest277of100,1,323,5407,2,464,5873
subtest21of10,pubtest277of100,1,323,5407,7,498,5912
subtest24of10,pubtest277of100,1,323,5407,11,535,5953
subtest210of10,pubtest277of100,1,323,5407,14,571,5992
subtest27of10,pubtest277of100,1,323,5407,14,611,6032
subtest25of10,pubtest277of100,1,323,5407,18,647,6072
subtest26of10,pubtest277of100,1,323,5407,18,688,6113
subtest23of10,pubtest277of100,1,323,5407,19,726,6152
subtest22of10,pubtest278of100,1,323,5515,14,41,5570
subtest29of10,pubtest278of100,1,323,5515,14,81,5610
subtest21of10,pubtest278of100,1,323,5515,16,116,5647
subtest28of10,pubtest278of100,1,323,5515,18,156,5689
subtest23of10,pubtest278of100,1,323,5515,16,196,5727
subtest25of10,pubtest278of100,1,323,5515,20,234,5769
subtest27of10,pubtest278of100,1,323,5515,20,274,5809
subtest26of10,pubtest278of100,1,323,5515,25,309,5849
subtest24of10,pubtest278of100,1,323,5515,32,342,5889
subtest210of10,pubtest278of100,1,323,5515,42,372,5929
subtest28of10,pubtest279of100,1,323,5520,3,42,5565
subtest21of10,pubtest279of100,1,323,5520,4,78,5602
subtest26of10,pubtest279of100,1,323,5520,6,118,5644
subtest24of10,pubtest279of100,1,323,5520,4,158,5682
subtest29of10,pubtest279of100,1,323,5520,5,197,5722
subtest22of10,pubtest279of100,1,323,5520,8,236,5764
subtest210of10,pubtest279of100,1,323,5520,8,274,5802
subtest23of10,pubtest279of100,1,323,5520,10,314,5844
subtest27of10,pubtest279of100,1,323,5520,9,350,5879
subtest25of10,pubtest279of100,1,323,5520,3,391,5914
subtest27of10,pubtest280of100,1,323,5289,14,42,5345
subtest29of10,pubtest280of100,1,323,5289,15,80,5384
subtest24of10,pubtest280of100,1,323,5289,17,118,5424
subtest23of10,pubtest280of100,1,323,5289,33,142,5464
subtest21of10,pubtest280of100,1,323,5289,33,182,5504
subtest26of10,pubtest280of100,1,323,5289,35,220,5544
subtest25of10,pubtest280of100,1,323,5289,35,260,5584
subtest28of10,pubtest280of100,1,323,5289,37,298,5624
subtest22of10,pubtest280of100,1,323,5289,38,337,5664
subtest210of10,pubtest280of100,1,323,5289,37,377,5703
subtest24of10,pubtest281of100,1,323,5450,-4,42,5488
subtest23of10,pubtest281of100,1,323,5450,-1,79,5528
subtest28of10,pubtest281of100,1,323,5450,2,115,5567
subtest27of10,pubtest281of100,1,323,5450,2,155,5607
subtest22of10,pubtest281of100,1,323,5450,4,193,5647
subtest21of10,pubtest281of100,1,323,5450,6,231,5687
subtest29of10,pubtest281of100,1,323,5450,6,271,5727
subtest25of10,pubtest281of100,1,323,5450,6,310,5766
subtest210of10,pubtest281of100,1,323,5450,9,348,5807
subtest26of10,pubtest281of100,1,323,5450,9,388,5847
subtest23of10,pubtest282of100,1,323,5415,45,41,5501
subtest24of10,pubtest282of100,1,323,5415,49,76,5540
subtest22of10,pubtest282of100,1,323,5415,50,115,5580
subtest26of10,pubtest282of100,1,323,5415,51,154,5620
subtest29of10,pubtest282of100,1,323,5415,52,193,5660
subtest21of10,pubtest282of100,1,323,5415,53,233,5701
subtest27of10,pubtest282of100,1,323,5415,52,272,5739
subtest28of10,pubtest282of100,1,323,5415,54,311,5780
subtest25of10,pubtest282of100,1,323,5415,55,349,5819
subtest210of10,pubtest282of100,1,323,5415,55,389,5859
subtest24of10,pubtest283of100,1,323,5396,-1,41,5436
subtest27of10,pubtest283of100,1,323,5396,-2,80,5474
subtest23of10,pubtest283of100,1,323,5396,8,111,5515
subtest25of10,pubtest283of100,1,323,5396,10,149,5555
subtest21of10,pubtest283of100,1,323,5396,11,189,5596
subtest22of10,pubtest283of100,1,323,5396,9,228,5633
subtest29of10,pubtest283of100,1,323,5396,16,263,5675
subtest28of10,pubtest283of100,1,323,5396,16,305,5717
subtest26of10,pubtest283of100,1,323,5396,17,342,5755
subtest210of10,pubtest283of100,1,323,5396,18,382,5796
subtest22of10,pubtest284of100,1,323,5441,4,41,5486
subtest25of10,pubtest284of100,1,323,5441,6,78,5525
subtest29of10,pubtest284of100,1,323,5441,10,114,5565
subtest27of10,pubtest284of100,1,323,5441,10,154,5605
subtest210of10,pubtest284of100,1,323,5441,10,194,5645
subtest23of10,pubtest284of100,1,323,5441,13,231,5685
subtest21of10,pubtest284of100,1,323,5441,16,268,5725
subtest24of10,pubtest284of100,1,323,5441,16,308,5765
subtest28of10,pubtest284of100,1,323,5441,18,346,5805
subtest26of10,pubtest284of100,1,323,5441,18,387,5846
subtest27of10,pubtest285of100,1,323,5549,-5,250,5794
subtest25of10,pubtest285of100,1,323,5549,-6,286,5829
subtest24of10,pubtest285of100,1,323,5549,-1,322,5870
subtest23of10,pubtest285of100,1,323,5549,-7,368,5910
subtest22of10,pubtest285of100,1,323,5549,246,155,5950
subtest21of10,pubtest285of100,1,323,5549,2,195,5746
subtest210of10,pubtest285of100,1,323,5549,247,234,6030
subtest29of10,pubtest285of100,1,323,5549,247,272,6068
subtest28of10,pubtest285of100,1,323,5549,247,312,6108
subtest26of10,pubtest285of100,1,323,5549,250,351,6150
subtest23of10,pubtest286of100,1,323,5312,-4,41,5349
subtest25of10,pubtest286of100,1,323,5312,-2,79,5389
subtest210of10,pubtest286of100,1,323,5312,1,115,5428
subtest24of10,pubtest286of100,1,323,5312,5,151,5468
subtest29of10,pubtest286of100,1,323,5312,8,188,5508
subtest21of10,pubtest286of100,1,323,5312,10,226,5548
subtest26of10,pubtest286of100,1,323,5312,10,266,5588
subtest27of10,pubtest286of100,1,323,5312,12,304,5628
subtest22of10,pubtest286of100,1,323,5312,13,343,5668
subtest28of10,pubtest286of100,1,323,5312,16,380,5708
subtest26of10,pubtest287of100,1,323,5507,0,40,5547
subtest28of10,pubtest287of100,1,323,5507,2,77,5586
subtest29of10,pubtest287of100,1,323,5507,3,116,5626
subtest210of10,pubtest287of100,1,323,5507,9,150,5666
subtest24of10,pubtest287of100,1,323,5507,9,190,5706
subtest27of10,pubtest287of100,1,323,5507,15,224,5746
subtest22of10,pubtest287of100,1,323,5507,24,255,5786
subtest25of10,pubtest287of100,1,323,5507,28,291,5826
subtest21of10,pubtest287of100,1,323,5507,28,330,5865
subtest23of10,pubtest287of100,1,323,5507,28,370,5905
subtest29of10,pubtest288of100,1,323,5410,1,41,5452
subtest25of10,pubtest288of100,1,323,5410,1,81,5492
subtest27of10,pubtest288of100,1,323,5410,3,118,5531
subtest21of10,pubtest288of100,1,323,5410,5,156,5571
subtest23of10,pubtest288of100,1,323,5410,9,192,5611
subtest26of10,pubtest288of100,1,323,5410,11,230,5651
subtest22of10,pubtest288of100,1,323,5410,11,270,5691
subtest28of10,pubtest288of100,1,323,5410,13,308,5731
subtest210of10,pubtest288of100,1,323,5410,13,348,5771
subtest24of10,pubtest288of100,1,323,5410,13,387,5810
subtest210of10,pubtest289of100,1,323,5315,6,39,5360
subtest29of10,pubtest289of100,1,323,5315,6,77,5398
subtest23of10,pubtest289of100,1,323,5315,8,115,5438
subtest24of10,pubtest289of100,1,323,5315,11,152,5478
subtest25of10,pubtest289of100,1,323,5315,11,192,5518
subtest26of10,pubtest289of100,1,323,5315,13,231,5559
subtest27of10,pubtest289of100,1,323,5315,25,259,5599
subtest21of10,pubtest289of100,1,323,5315,26,296,5637
subtest28of10,pubtest289of100,1,323,5315,35,328,5678
subtest22of10,pubtest289of100,1,323,5315,36,368,5719
subtest23of10,pubtest290of100,1,323,5399,-1,38,5436
subtest29of10,pubtest290of100,1,323,5399,-1,77,5475
subtest22of10,pubtest290of100,1,323,5399,1,115,5515
subtest25of10,pubtest290of100,1,323,5399,1,155,5555
subtest26of10,pubtest290of100,1,323,5399,5,191,5595
subtest27of10,pubtest290of100,1,323,5399,5,231,5635
subtest21of10,pubtest290of100,1,323,5399,9,267,5675
subtest210of10,pubtest290of100,1,323,5399,13,303,5715
subtest28of10,pubtest290of100,1,323,5399,14,342,5755
subtest24of10,pubtest290of100,1,323,5399,15,382,5796
subtest24of10,pubtest291of100,1,323,5323,-4,39,5358
subtest27of10,pubtest291of100,1,323,5323,5,70,5398
subtest23of10,pubtest291of100,1,323,5323,4,110,5437
subtest28of10,pubtest291of100,1,323,5323,9,145,5477
subtest21of10,pubtest291of100,1,323,5323,10,184,5517
subtest25of10,pubtest291of100,1,323,5323,11,223,5557
subtest210of10,pubtest291of100,1,323,5323,14,260,5597
subtest29of10,pubtest291of100,1,323,5323,14,300,5637
subtest22of10,pubtest291of100,1,323,5323,15,339,5677
subtest26of10,pubtest291of100,1,323,5323,16,378,5717
subtest28of10,pubtest292of100,1,323,5534,3,38,5575
subtest21of10,pubtest292of100,1,323,5534,5,75,5614
subtest25of10,pubtest292of100,1,323,5534,5,115,5654
subtest29of10,pubtest292of100,1,323,5534,4,154,5692
subtest23of10,pubtest292of100,1,323,5534,13,185,5732
subtest26of10,pubtest292of100,1,323,5534,16,224,5774
subtest27of10,pubtest292of100,1,323,5534,13,263,5810
subtest22of10,pubtest292of100,1,323,5534,22,298,5854
subtest210of10,pubtest292of100,1,323,5534,25,335,5894
subtest24of10,pubtest292of100,1,323,5534,24,375,5933
subtest25of10,pubtest293of100,1,323,5428,2,42,5472
subtest24of10,pubtest293of100,1,323,5428,4,79,5511
subtest28of10,pubtest293of100,1,323,5428,8,115,5551
subtest210of10,pubtest293of100,1,323,5428,9,154,5591
subtest23of10,pubtest293of100,1,323,5428,8,193,5629
subtest27of10,pubtest293of100,1,323,5428,11,232,5671
subtest21of10,pubtest293of100,1,323,5428,17,266,5711
subtest26of10,pubtest293of100,1,323,5428,18,305,5751
subtest29of10,pubtest293of100,1,323,5428,19,344,5791
subtest22of10,pubtest293of100,1,323,5428,20,383,5831
subtest21of10,pubtest294of100,1,323,5310,7,40,5357
subtest25of10,pubtest294of100,1,323,5310,20,67,5397
subtest210of10,pubtest294of100,1,323,5310,19,107,5436
subtest29of10,pubtest294of100,1,323,5310,21,145,5476
subtest27of10,pubtest294of100,1,323,5310,21,184,5515
subtest24of10,pubtest294of100,1,323,5310,23,223,5556
subtest26of10,pubtest294of100,1,323,5310,23,263,5596
subtest23of10,pubtest294of100,1,323,5310,23,302,5635
subtest22of10,pubtest294of100,1,323,5310,25,341,5676
subtest28of10,pubtest294of100,1,323,5310,27,379,5716
subtest25of10,pubtest295of100,1,323,5339,-7,44,5376
subtest24of10,pubtest295of100,1,323,5339,-6,80,5413
subtest23of10,pubtest295of100,1,323,5339,-2,118,5455
subtest22of10,pubtest295of100,1,323,5339,-1,157,5495
subtest27of10,pubtest295of100,1,323,5339,1,195,5535
subtest29of10,pubtest295of100,1,323,5339,5,231,5575
subtest210of10,pubtest295of100,1,323,5339,5,271,5615
subtest21of10,pubtest295of100,1,323,5339,7,309,5655
subtest28of10,pubtest295of100,1,323,5339,7,349,5695
subtest26of10,pubtest295of100,1,323,5339,9,387,5735
subtest25of10,pubtest296of100,1,322,5315,-1,193,5507
subtest24of10,pubtest296of100,1,322,5315,0,230,5545
subtest27of10,pubtest296of100,1,322,5315,0,269,5584
subtest26of10,pubtest296of100,1,322,5315,4,307,5626
subtest21of10,pubtest296of100,1,322,5315,7,343,5665
subtest29of10,pubtest296of100,1,322,5315,7,383,5705
subtest28of10,pubtest296of100,1,322,5315,12,419,5746
subtest22of10,pubtest296of100,1,322,5315,12,460,5787
subtest23of10,pubtest296of100,1,322,5315,6,499,5820
subtest210of10,pubtest296of100,1,322,5315,14,537,5866
subtest25of10,pubtest297of100,1,323,5363,0,40,5403
subtest210of10,pubtest297of100,1,323,5363,1,77,5441
subtest29of10,pubtest297of100,1,323,5363,2,116,5481
subtest22of10,pubtest297of100,1,323,5363,5,153,5521
subtest23of10,pubtest297of100,1,323,5363,6,192,5561
subtest27of10,pubtest297of100,1,323,5363,7,231,5601
subtest26of10,pubtest297of100,1,323,5363,9,270,5642
subtest21of10,pubtest297of100,1,323,5363,8,310,5681
subtest28of10,pubtest297of100,1,323,5363,10,348,5721
subtest24of10,pubtest297of100,1,323,5363,17,381,5761
subtest29of10,pubtest298of100,1,323,5279,-3,45,5321
subtest25of10,pubtest298of100,1,323,5279,-1,82,5360
subtest22of10,pubtest298of100,1,323,5279,0,121,5400
subtest23of10,pubtest298of100,1,323,5279,2,159,5440
subtest24of10,pubtest298of100,1,323,5279,8,193,5480
subtest21of10,pubtest298of100,1,323,5279,8,233,5520
subtest27of10,pubtest298of100,1,323,5279,11,270,5560
subtest210of10,pubtest298of100,1,323,5279,12,309,5600
subtest28of10,pubtest298of100,1,323,5279,19,342,5640
subtest26of10,pubtest298of100,1,323,5279,21,380,5680
subtest22of10,pubtest299of100,1,323,5301,3,38,5342
subtest210of10,pubtest299of100,1,323,5301,6,74,5381
subtest29of10,pubtest299of100,1,323,5301,7,113,5421
subtest24of10,pubtest299of100,1,323,5301,8,150,5459
subtest27of10,pubtest299of100,1,323,5301,10,190,5501
subtest23of10,pubtest299of100,1,323,5301,12,228,5541
subtest25of10,pubtest299of100,1,323,5301,12,268,5581
subtest28of10,pubtest299of100,1,323,5301,14,307,5622
subtest21of10,pubtest299of100,1,323,5301,15,345,5661
subtest26of10,pubtest299of100,1,323,5301,16,384,5701
subtest21of10,pubtest2100of100,1,325,5333,-2,41,5372
subtest24of10,pubtest2100of100,1,325,5333,5,73,5411
subtest29of10,pubtest2100of100,1,325,5333,6,111,5450
subtest23of10,pubtest2100of100,1,325,5333,8,150,5491
subtest22of10,pubtest2100of100,1,325,5333,16,182,5531
subtest25of10,pubtest2100of100,1,325,5333,17,220,5570
subtest210of10,pubtest2100of100,1,325,5333,18,261,5612
subtest28of10,pubtest2100of100,1,325,5333,19,298,5650
subtest27of10,pubtest2100of100,1,325,5333,16,337,5686
subtest26of10,pubtest2100of100,1,325,5333,27,371,5731
subtest26of10,pubtest21of100,1,322,10508,-3,45,10550
subtest29of10,pubtest21of100,1,322,10508,-1,82,10589
subtest27of10,pubtest21of100,1,322,10508,-2,122,10628
subtest24of10,pubtest21of100,1,322,10508,2,159,10669
subtest25of10,pubtest21of100,1,322,10508,7,194,10709
subtest210of10,pubtest21of100,1,322,10508,10,231,10749
subtest21of10,pubtest21of100,1,322,10508,10,270,10788
subtest28of10,pubtest21of100,1,322,10508,11,310,10829
subtest22of10,pubtest21of100,1,322,10508,15,348,10871
subtest23of10,pubtest21of100,1,322,10508,18,384,10910
subtest29of10,pubtest22of100,1,321,5697,-4,41,5734
subtest24of10,pubtest22of100,1,321,5697,3,73,5773
subtest23of10,pubtest22of100,1,321,5697,3,113,5813
subtest27of10,pubtest22of100,1,321,5697,3,152,5852
subtest28of10,pubtest22of100,1,321,5697,5,191,5893
subtest21of10,pubtest22of100,1,321,5697,7,228,5932
subtest25of10,pubtest22of100,1,321,5697,7,268,5972
subtest26of10,pubtest22of100,1,321,5697,9,307,6013
subtest210of10,pubtest22of100,1,321,5697,10,346,6053
subtest22of10,pubtest22of100,1,321,5697,11,385,6093
subtest29of10,pubtest23of100,1,321,5458,-6,39,5491
subtest23of10,pubtest23of100,1,321,5458,-6,79,5531
subtest28of10,pubtest23of100,1,321,5458,-4,115,5569
subtest24of10,pubtest23of100,1,321,5458,1,151,5610
subtest27of10,pubtest23of100,1,321,5458,3,187,5648
subtest25of10,pubtest23of100,1,321,5458,6,226,5690
subtest21of10,pubtest23of100,1,321,5458,9,263,5730
subtest26of10,pubtest23of100,1,321,5458,9,303,5770
subtest22of10,pubtest23of100,1,321,5458,14,338,5810
subtest210of10,pubtest23of100,1,321,5458,15,377,5850
subtest24of10,pubtest24of100,1,321,5324,6,41,5371
subtest23of10,pubtest24of100,1,321,5324,7,80,5411
subtest29of10,pubtest24of100,1,321,5324,9,116,5449
subtest25of10,pubtest24of100,1,321,5324,8,156,5488
subtest21of10,pubtest24of100,1,321,5324,8,195,5527
subtest27of10,pubtest24of100,1,321,5324,10,234,5568
subtest28of10,pubtest24of100,1,321,5324,11,274,5609
subtest22of10,pubtest24of100,1,321,5324,12,313,5649
subtest26of10,pubtest24of100,1,321,5324,12,353,5689
subtest210of10,pubtest24of100,1,321,5324,13,391,5728
subtest28of10,pubtest25of100,1,321,5355,0,40,5395
subtest21of10,pubtest25of100,1,321,5355,0,80,5435
subtest27of10,pubtest25of100,1,321,5355,7,112,5474
subtest210of10,pubtest25of100,1,321,5355,9,150,5514
subtest25of10,pubtest25of100,1,321,5355,11,188,5554
subtest26of10,pubtest25of100,1,321,5355,15,224,5594
subtest23of10,pubtest25of100,1,321,5355,16,263,5634
subtest29of10,pubtest25of100,1,321,5355,18,301,5674
subtest22of10,pubtest25of100,1,321,5355,23,336,5714
subtest24of10,pubtest25of100,1,321,5355,23,376,5754
subtest21of10,pubtest26of100,1,321,5275,-5,39,5309
subtest29of10,pubtest26of100,1,321,5275,-3,75,5347
subtest22of10,pubtest26of100,1,321,5275,-1,114,5388
subtest23of10,pubtest26of100,1,321,5275,0,154,5429
subtest26of10,pubtest26of100,1,321,5275,2,191,5468
subtest27of10,pubtest26of100,1,321,5275,15,218,5508
subtest25of10,pubtest26of100,1,321,5275,18,256,5549
subtest28of10,pubtest26of100,1,321,5275,20,293,5588
subtest210of10,pubtest26of100,1,321,5275,20,333,5628
subtest24of10,pubtest26of100,1,321,5275,23,370,5668
subtest27of10,pubtest27of100,1,320,5363,4,39,5406
subtest28of10,pubtest27of100,1,320,5363,4,78,5445
subtest23of10,pubtest27of100,1,320,5363,6,116,5485
subtest24of10,pubtest27of100,1,320,5363,7,155,5525
subtest29of10,pubtest27of100,1,320,5363,7,193,5563
subtest26of10,pubtest27of100,1,320,5363,15,228,5606
subtest25of10,pubtest27of100,1,320,5363,12,267,5642
subtest22of10,pubtest27of100,1,320,5363,13,306,5682
subtest210of10,pubtest27of100,1,320,5363,16,346,5725
subtest21of10,pubtest27of100,1,320,5363,12,386,5761
subtest27of10,pubtest28of100,1,321,5421,-3,41,5459
subtest21of10,pubtest28of100,1,321,5421,4,72,5497
subtest29of10,pubtest28of100,1,321,5421,5,112,5538
subtest28of10,pubtest28of100,1,321,5421,4,151,5576
subtest23of10,pubtest28of100,1,321,5421,7,191,5619
subtest25of10,pubtest28of100,1,321,5421,12,227,5660
subtest210of10,pubtest28of100,1,321,5421,16,261,5698
subtest26of10,pubtest28of100,1,321,5421,16,301,5738
subtest22of10,pubtest28of100,1,321,5421,19,338,5778
subtest24of10,pubtest28of100,1,321,5421,19,378,5818
subtest23of10,pubtest29of100,1,321,5310,-6,42,5346
subtest29of10,pubtest29of100,1,321,5310,-1,76,5385
subtest210of10,pubtest29of100,1,321,5310,1,113,5424
subtest22of10,pubtest29of100,1,321,5310,2,152,5464
subtest25of10,pubtest29of100,1,321,5310,3,192,5505
subtest21of10,pubtest29of100,1,321,5310,6,228,5544
subtest28of10,pubtest29of100,1,321,5310,9,265,5584
subtest24of10,pubtest29of100,1,321,5310,9,305,5624
subtest27of10,pubtest29of100,1,321,5310,10,343,5663
subtest26of10,pubtest29of100,1,321,5310,10,382,5702
subtest29of10,pubtest210of100,1,323,5304,5,52,5361
subtest27of10,pubtest210of100,1,323,5304,6,90,5400
subtest21of10,pubtest210of100,1,323,5304,5,129,5438
subtest28of10,pubtest210of100,1,323,5304,11,166,5481
subtest25of10,pubtest210of100,1,323,5304,13,203,5520
subtest22of10,pubtest210of100,1,323,5304,13,243,5560
subtest26of10,pubtest210of100,1,323,5304,14,282,5600
subtest23of10,pubtest210of100,1,323,5304,15,321,5640
subtest24of10,pubtest210of100,1,323,5304,15,361,5680
subtest210of10,pubtest210of100,1,323,5304,16,400,5720
subtest210of10,pubtest211of100,1,323,5436,-4,41,5473
subtest24of10,pubtest211of100,1,323,5436,-1,77,5512
subtest29of10,pubtest211of100,1,323,5436,0,116,5552
subtest22of10,pubtest211of100,1,323,5436,2,154,5592
subtest21of10,pubtest211of100,1,323,5436,8,188,5632
subtest25of10,pubtest211of100,1,323,5436,8,228,5672
subtest23of10,pubtest211of100,1,323,5436,11,266,5713
subtest26of10,pubtest211of100,1,323,5436,14,302,5752
subtest27of10,pubtest211of100,1,323,5436,17,339,5792
subtest28of10,pubtest211of100,1,323,5436,25,371,5832
subtest25of10,pubtest212of100,1,323,5498,-1,40,5537
subtest29of10,pubtest212of100,1,323,5498,5,72,5575
subtest23of10,pubtest212of100,1,323,5498,6,111,5615
subtest28of10,pubtest212of100,1,323,5498,6,151,5655
subtest27of10,pubtest212of100,1,323,5498,8,189,5695
subtest22of10,pubtest212of100,1,323,5498,8,229,5735
subtest21of10,pubtest212of100,1,323,5498,9,268,5775
subtest24of10,pubtest212of100,1,323,5498,9,308,5815
subtest26of10,pubtest212of100,1,323,5498,11,347,5856
subtest210of10,pubtest212of100,1,323,5498,16,381,5895
subtest23of10,pubtest213of100,1,322,5362,-5,39,5396
subtest29of10,pubtest213of100,1,322,5362,-2,76,5436
subtest27of10,pubtest213of100,1,322,5362,0,113,5475
subtest21of10,pubtest213of100,1,322,5362,5,148,5515
subtest25of10,pubtest213of100,1,322,5362,6,188,5556
subtest26of10,pubtest213of100,1,322,5362,7,227,5596
subtest22of10,pubtest213of100,1,322,5362,8,265,5635
subtest24of10,pubtest213of100,1,322,5362,11,302,5675
subtest210of10,pubtest213of100,1,322,5362,14,339,5715
subtest28of10,pubtest213of100,1,322,5362,28,365,5755
subtest21of10,pubtest214of100,1,323,5589,-3,42,5628
subtest23of10,pubtest214of100,1,323,5589,-1,78,5666
subtest26of10,pubtest214of100,1,323,5589,-1,119,5707
subtest27of10,pubtest214of100,1,323,5589,4,152,5745
subtest25of10,pubtest214of100,1,323,5589,4,192,5785
subtest210of10,pubtest214of100,1,323,5589,23,214,5826
subtest22of10,pubtest214of100,1,323,5589,24,253,5866
subtest29of10,pubtest214of100,1,323,5589,23,293,5905
subtest24of10,pubtest214of100,1,323,5589,25,332,5946
subtest28of10,pubtest214of100,1,323,5589,26,371,5986
subtest27of10,pubtest215of100,1,323,5463,-2,40,5501
subtest24of10,pubtest215of100,1,323,5463,6,71,5540
subtest29of10,pubtest215of100,1,323,5463,12,105,5580
subtest21of10,pubtest215of100,1,323,5463,12,145,5620
subtest25of10,pubtest215of100,1,323,5463,20,177,5660
subtest210of10,pubtest215of100,1,323,5463,21,216,5700
subtest23of10,pubtest215of100,1,323,5463,21,256,5740
subtest26of10,pubtest215of100,1,323,5463,21,294,5778
subtest22of10,pubtest215of100,1,323,5463,23,334,5820
subtest28of10,pubtest215of100,1,323,5463,24,371,5858
subtest24of10,pubtest216of100,1,323,5260,16,38,5314
subtest21of10,pubtest216of100,1,323,5260,17,76,5353
subtest23of10,pubtest216of100,1,323,5260,25,108,5393
subtest28of10,pubtest216of100,1,323,5260,26,147,5433
subtest27of10,pubtest216of100,1,323,5260,27,186,5473
subtest22of10,pubtest216of100,1,323,5260,28,225,5513
subtest26of10,pubtest216of100,1,323,5260,29,264,5553
subtest29of10,pubtest216of100,1,323,5260,29,304,5593
subtest25of10,pubtest216of100,1,323,5260,30,343,5633
subtest210of10,pubtest216of100,1,323,5260,31,382,5673
subtest27of10,pubtest217of100,1,322,5473,-3,42,5512
subtest22of10,pubtest217of100,1,322,5473,-3,82,5552
subtest21of10,pubtest217of100,1,322,5473,-1,120,5592
subtest23of10,pubtest217of100,1,322,5473,-1,160,5632
subtest26of10,pubtest217of100,1,322,5473,0,199,5672
subtest29of10,pubtest217of100,1,322,5473,1,238,5712
subtest25of10,pubtest217of100,1,322,5473,4,275,5752
subtest24of10,pubtest217of100,1,322,5473,9,310,5792
subtest28of10,pubtest217of100,1,322,5473,11,348,5832
subtest210of10,pubtest217of100,1,322,5473,14,385,5872
subtest29of10,pubtest218of100,1,323,5417,4,38,5459
subtest21of10,pubtest218of100,1,323,5417,10,71,5498
subtest22of10,pubtest218of100,1,323,5417,26,96,5539
subtest27of10,pubtest218of100,1,323,5417,29,132,5578
subtest23of10,pubtest218of100,1,323,5417,31,168,5616
subtest26of10,pubtest218of100,1,323,5417,33,208,5658
subtest25of10,pubtest218of100,1,323,5417,35,246,5698
subtest24of10,pubtest218of100,1,323,5417,35,286,5738
subtest28of10,pubtest218of100,1,323,5417,30,326,5773
subtest210of10,pubtest218of100,1,323,5417,36,365,5818
subtest210of10,pubtest219of100,1,323,5358,-1,41,5398
subtest26of10,pubtest219of100,1,323,5358,0,78,5436
subtest25of10,pubtest219of100,1,323,5358,3,115,5476
subtest21of10,pubtest219of100,1,323,5358,7,151,5516
subtest22of10,pubtest219of100,1,323,5358,8,190,5556
subtest29of10,pubtest219of100,1,323,5358,9,229,5596
subtest24of10,pubtest219of100,1,323,5358,10,269,5637
subtest23of10,pubtest219of100,1,323,5358,11,307,5676
subtest27of10,pubtest219of100,1,323,5358,11,347,5716
subtest28of10,pubtest219of100,1,323,5358,22,376,5756
subtest25of10,pubtest220of100,1,323,5277,1,57,5335
subtest210of10,pubtest220of100,1,323,5277,2,96,5375
subtest23of10,pubtest220of100,1,323,5277,3,135,5415
subtest24of10,pubtest220of100,1,323,5277,5,173,5455
subtest29of10,pubtest220of100,1,323,5277,4,213,5494
subtest21of10,pubtest220of100,1,323,5277,11,247,5535
subtest28of10,pubtest220of100,1,323,5277,20,278,5575
subtest27of10,pubtest220of100,1,323,5277,20,318,5615
subtest22of10,pubtest220of100,1,323,5277,22,356,5655
subtest26of10,pubtest220of100,1,323,5277,22,396,5695
subtest24of10,pubtest221of100,1,323,5350,0,42,5392
subtest21of10,pubtest221of100,1,323,5350,2,81,5433
subtest23of10,pubtest221of100,1,323,5350,3,118,5471
subtest28of10,pubtest221of100,1,323,5350,3,158,5511
subtest25of10,pubtest221of100,1,323,5350,7,194,5551
subtest22of10,pubtest221of100,1,323,5350,7,234,5591
subtest210of10,pubtest221of100,1,323,5350,8,273,5631
subtest26of10,pubtest221of100,1,323,5350,10,311,5671
subtest29of10,pubtest221of100,1,323,5350,10,351,5711
subtest27of10,pubtest221of100,1,323,5350,12,389,5751
subtest21of10,pubtest222of100,1,323,5456,2,208,5666
subtest22of10,pubtest222of100,1,323,5456,3,245,5704
subtest29of10,pubtest222of100,1,323,5456,9,279,5744
subtest27of10,pubtest222of100,1,323,5456,14,314,5784
subtest28of10,pubtest222of100,1,323,5456,36,332,5824
subtest24of10,pubtest222of100,1,323,5456,210,197,5863
subtest26of10,pubtest222of100,1,323,5456,212,236,5904
subtest210of10,pubtest222of100,1,323,5456,212,276,5944
subtest23of10,pubtest222of100,1,323,5456,37,315,5808
subtest25of10,pubtest222of100,1,323,5456,214,354,6024
subtest21of10,pubtest223of100,1,323,5447,11,40,5498
subtest28of10,pubtest223of100,1,323,5447,13,76,5536
subtest23of10,pubtest223of100,1,323,5447,14,115,5576
subtest29of10,pubtest223of100,1,323,5447,15,154,5616
subtest24of10,pubtest223of100,1,323,5447,15,194,5656
subtest210of10,pubtest223of100,1,323,5447,25,224,5696
subtest27of10,pubtest223of100,1,323,5447,33,256,5736
subtest26of10,pubtest223of100,1,323,5447,35,294,5776
subtest25of10,pubtest223of100,1,323,5447,35,335,5817
subtest22of10,pubtest223of100,1,323,5447,34,371,5852
subtest21of10,pubtest224of100,1,323,5384,2,40,5426
subtest28of10,pubtest224of100,1,323,5384,6,76,5466
subtest23of10,pubtest224of100,1,323,5384,8,114,5506
subtest26of10,pubtest224of100,1,323,5384,8,154,5546
subtest27of10,pubtest224of100,1,323,5384,7,194,5585
subtest29of10,pubtest224of100,1,323,5384,12,230,5626
subtest22of10,pubtest224of100,1,323,5384,14,268,5666
subtest25of10,pubtest224of100,1,323,5384,14,308,5706
subtest24of10,pubtest224of100,1,323,5384,19,343,5746
subtest210of10,pubtest224of100,1,323,5384,26,376,5786
subtest27of10,pubtest225of100,1,323,5538,64,40,5642
subtest26of10,pubtest225of100,1,323,5538,66,77,5681
subtest22of10,pubtest225of100,1,323,5538,67,117,5722
subtest23of10,pubtest225of100,1,323,5538,66,156,5760
subtest24of10,pubtest225of100,1,323,5538,67,196,5801
subtest25of10,pubtest225of100,1,323,5538,67,235,5840
subtest21of10,pubtest225of100,1,323,5538,67,273,5878
subtest29of10,pubtest225of100,1,323,5538,71,313,5922
subtest28of10,pubtest225of100,1,323,5538,71,352,5961
subtest210of10,pubtest225of100,1,323,5538,75,389,6002
subtest25of10,pubtest226of100,1,323,5395,-2,112,5505
subtest22of10,pubtest226of100,1,323,5395,2,108,5505
subtest23of10,pubtest226of100,1,323,5395,3,146,5544
subtest27of10,pubtest226of100,1,323,5395,5,184,5584
subtest210of10,pubtest226of100,1,323,5395,6,223,5624
subtest21of10,pubtest226of100,1,323,5395,9,258,5662
subtest29of10,pubtest226of100,1,323,5395,12,297,5704
subtest28of10,pubtest226of100,1,323,5395,12,338,5745
subtest26of10,pubtest226of100,1,323,5395,25,364,5784
subtest24of10,pubtest226of100,1,323,5395,26,403,5824
subtest29of10,pubtest227of100,1,323,5339,-2,39,5376
subtest210of10,pubtest227of100,1,323,5339,0,77,5416
subtest25of10,pubtest227of100,1,323,5339,1,116,5456
subtest23of10,pubtest227of100,1,323,5339,2,155,5496
subtest24of10,pubtest227of100,1,323,5339,8,189,5536
subtest26of10,pubtest227of100,1,323,5339,9,228,5576
subtest27of10,pubtest227of100,1,323,5339,10,267,5616
subtest21of10,pubtest227of100,1,323,5339,12,305,5656
subtest22of10,pubtest227of100,1,323,5339,13,344,5696
subtest28of10,pubtest227of100,1,323,5339,14,381,5734
subtest21of10,pubtest228of100,1,323,5406,11,38,5455
subtest26of10,pubtest228of100,1,323,5406,20,69,5495
subtest25of10,pubtest228of100,1,323,5406,23,105,5534
subtest23of10,pubtest228of100,1,323,5406,28,140,5574
subtest27of10,pubtest228of100,1,323,5406,35,173,5614
subtest24of10,pubtest228of100,1,323,5406,45,203,5654
subtest29of10,pubtest228of100,1,323,5406,52,236,5694
subtest210of10,pubtest228of100,1,323,5406,57,271,5734
subtest22of10,pubtest228of100,1,323,5406,68,300,5774
subtest28of10,pubtest228of100,1,323,5406,69,341,5816
subtest24of10,pubtest229of100,1,321,5327,6,43,5376
subtest28of10,pubtest229of100,1,321,5327,9,80,5416
subtest21of10,pubtest229of100,1,321,5327,13,115,5455
subtest22of10,pubtest229of100,1,321,5327,13,155,5495
subtest27of10,pubtest229of100,1,321,5327,16,192,5535
subtest23of10,pubtest229of100,1,321,5327,17,232,5576
subtest25of10,pubtest229of100,1,321,5327,21,268,5616
subtest210of10,pubtest229of100,1,321,5327,20,308,5655
subtest29of10,pubtest229of100,1,321,5327,22,346,5695
subtest26of10,pubtest229of100,1,321,5327,22,386,5735
subtest22of10,pubtest230of100,1,323,5422,1,41,5464
subtest21of10,pubtest230of100,1,323,5422,4,78,5504
subtest28of10,pubtest230of100,1,323,5422,7,114,5543
subtest27of10,pubtest230of100,1,323,5422,20,141,5583
subtest29of10,pubtest230of100,1,323,5422,25,176,5623
subtest25of10,pubtest230of100,1,323,5422,28,213,5663
subtest23of10,pubtest230of100,1,323,5422,29,252,5703
subtest24of10,pubtest230of100,1,323,5422,42,279,5743
subtest210of10,pubtest230of100,1,323,5422,42,319,5783
subtest26of10,pubtest230of100,1,323,5422,43,358,5823
subtest28of10,pubtest231of100,1,323,5520,-3,42,5559
subtest23of10,pubtest231of100,1,323,5520,-3,81,5598
subtest25of10,pubtest231of100,1,323,5520,-1,119,5638
subtest29of10,pubtest231of100,1,323,5520,-1,159,5678
subtest24of10,pubtest231of100,1,323,5520,1,197,5718
subtest27of10,pubtest231of100,1,323,5520,2,235,5757
subtest21of10,pubtest231of100,1,323,5520,2,276,5798
subtest210of10,pubtest231of100,1,323,5520,4,314,5838
subtest26of10,pubtest231of100,1,323,5520,7,349,5876
subtest22of10,pubtest231of100,1,323,5520,9,389,5918
subtest21of10,pubtest232of100,1,323,5295,0,40,5335
subtest22of10,pubtest232of100,1,323,5295,6,74,5375
subtest27of10,pubtest232of100,1,323,5295,12,107,5414
subtest23of10,pubtest232of100,1,323,5295,13,146,5454
subtest29of10,pubtest232of100,1,323,5295,14,185,5494
subtest28of10,pubtest232of100,1,323,5295,16,223,5534
subtest25of10,pubtest232of100,1,323,5295,18,262,5575
subtest210of10,pubtest232of100,1,323,5295,20,300,5615
subtest24of10,pubtest232of100,1,323,5295,21,338,5654
subtest26of10,pubtest232of100,1,323,5295,23,376,5694
subtest24of10,pubtest233of100,1,323,5314,29,41,5384
subtest29of10,pubtest233of100,1,323,5314,29,79,5422
subtest210of10,pubtest233of100,1,323,5314,31,117,5462
subtest25of10,pubtest233of100,1,323,5314,31,157,5502
subtest27of10,pubtest233of100,1,323,5314,33,195,5542
subtest26of10,pubtest233of100,1,323,5314,35,233,5582
subtest22of10,pubtest233of100,1,323,5314,37,271,5622
subtest21of10,pubtest233of100,1,323,5314,38,310,5662
subtest23of10,pubtest233of100,1,323,5314,37,349,5700
subtest28of10,pubtest233of100,1,323,5314,39,389,5742
subtest25of10,pubtest234of100,1,323,5334,-3,40,5371
subtest26of10,pubtest234of100,1,323,5334,-2,77,5409
subtest27of10,pubtest234of100,1,323,5334,0,114,5448
subtest21of10,pubtest234of100,1,323,5334,2,153,5489
subtest22of10,pubtest234of100,1,323,5334,5,191,5530
subtest29of10,pubtest234of100,1,323,5334,6,229,5569
subtest23of10,pubtest234of100,1,323,5334,8,267,5609
subtest210of10,pubtest234of100,1,323,5334,9,306,5649
subtest24of10,pubtest234of100,1,323,5334,14,342,5690
subtest28of10,pubtest234of100,1,323,5334,16,381,5731
subtest21of10,pubtest235of100,1,321,5642,2,38,5682
subtest23of10,pubtest235of100,1,321,5642,3,77,5722
subtest210of10,pubtest235of100,1,321,5642,8,112,5762
subtest22of10,pubtest235of100,1,321,5642,9,151,5802
subtest27of10,pubtest235of100,1,321,5642,11,189,5842
subtest29of10,pubtest235of100,1,321,5642,12,228,5882
subtest26of10,pubtest235of100,1,321,5642,16,264,5922
subtest25of10,pubtest235of100,1,321,5642,13,304,5959
subtest24of10,pubtest235of100,1,321,5642,13,343,5998
subtest28of10,pubtest235of100,1,321,5642,17,383,6042
subtest210of10,pubtest236of100,1,323,5499,7,39,5545
subtest28of10,pubtest236of100,1,323,5499,8,78,5585
subtest23of10,pubtest236of100,1,323,5499,9,117,5625
subtest27of10,pubtest236of100,1,323,5499,10,157,5666
subtest25of10,pubtest236of100,1,323,5499,11,196,5706
subtest21of10,pubtest236of100,1,323,5499,15,232,5746
subtest24of10,pubtest236of100,1,323,5499,15,271,5785
subtest29of10,pubtest236of100,1,323,5499,18,308,5825
subtest26of10,pubtest236of100,1,323,5499,19,347,5865
subtest22of10,pubtest236of100,1,323,5499,27,379,5905
subtest23of10,pubtest237of100,1,323,5334,17,44,5395
subtest25of10,pubtest237of100,1,323,5334,18,82,5434
subtest21of10,pubtest237of100,1,323,5334,19,120,5473
subtest29of10,pubtest237of100,1,323,5334,21,159,5514
subtest28of10,pubtest237of100,1,323,5334,22,197,5553
subtest27of10,pubtest237of100,1,323,5334,23,237,5594
subtest26of10,pubtest237of100,1,323,5334,25,275,5634
subtest22of10,pubtest237of100,1,323,5334,26,314,5674
subtest24of10,pubtest237of100,1,323,5334,24,354,5712
subtest210of10,pubtest237of100,1,323,5334,27,393,5754
subtest25of10,pubtest238of100,1,323,5473,25,43,5541
subtest22of10,pubtest238of100,1,323,5473,21,86,5580
subtest28of10,pubtest238of100,1,323,5473,26,121,5620
subtest27of10,pubtest238of100,1,323,5473,22,161,5656
subtest29of10,pubtest238of100,1,323,5473,28,199,5700
subtest23of10,pubtest238of100,1,323,5473,28,239,5740
subtest21of10,pubtest238of100,1,323,5473,31,276,5780
subtest210of10,pubtest238of100,1,323,5473,31,316,5820
subtest26of10,pubtest238of100,1,323,5473,49,338,5860
subtest24of10,pubtest238of100,1,323,5473,49,378,5900
subtest21of10,pubtest239of100,1,323,5313,-6,41,5348
subtest28of10,pubtest239of100,1,323,5313,-6,80,5387
subtest27of10,pubtest239of100,1,323,5313,-3,118,5428
subtest25of10,pubtest239of100,1,323,5313,-1,155,5467
subtest29of10,pubtest239of100,1,323,5313,-1,195,5507
subtest26of10,pubtest239of100,1,323,5313,-2,236,5547
subtest24of10,pubtest239of100,1,323,5313,0,272,5585
subtest22of10,pubtest239of100,1,323,5313,5,309,5627
subtest23of10,pubtest239of100,1,323,5313,5,349,5667
subtest210of10,pubtest239of100,1,323,5313,11,383,5707
subtest25of10,pubtest240of100,1,323,5306,-4,40,5342
subtest210of10,pubtest240of100,1,323,5306,4,71,5381
subtest21of10,pubtest240of100,1,323,5306,4,111,5421
subtest29of10,pubtest240of100,1,323,5306,6,149,5461
subtest27of10,pubtest240of100,1,323,5306,6,189,5501
subtest28of10,pubtest240of100,1,323,5306,7,229,5542
subtest23of10,pubtest240of100,1,323,5306,8,267,5581
subtest22of10,pubtest240of100,1,323,5306,8,307,5621
subtest24of10,pubtest240of100,1,323,5306,10,345,5661
subtest26of10,pubtest240of100,1,323,5306,10,385,5701
subtest21of10,pubtest241of100,1,323,5422,-2,47,5467
subtest29of10,pubtest241of100,1,323,5422,0,83,5505
subtest25of10,pubtest241of100,1,323,5422,2,122,5546
subtest26of10,pubtest241of100,1,323,5422,3,162,5587
subtest22of10,pubtest241of100,1,323,5422,4,200,5626
subtest23of10,pubtest241of100,1,323,5422,-2,246,5666
subtest27of10,pubtest241of100,1,323,5422,-2,280,5700
subtest210of10,pubtest241of100,1,323,5422,-1,325,5746
subtest28of10,pubtest241of100,1,323,5422,0,363,5785
subtest24of10,pubtest241of100,1,323,5422,2,402,5826
subtest27of10,pubtest242of100,1,323,5506,1,41,5548
subtest23of10,pubtest242of100,1,323,5506,1,81,5588
subtest26of10,pubtest242of100,1,323,5506,3,118,5627
subtest25of10,pubtest242of100,1,323,5506,4,157,5667
subtest22of10,pubtest242of100,1,323,5506,6,195,5707
subtest29of10,pubtest242of100,1,323,5506,6,235,5747
subtest210of10,pubtest242of100,1,323,5506,5,274,5785
subtest24of10,pubtest242of100,1,323,5506,19,302,5827
subtest21of10,pubtest242of100,1,323,5506,19,342,5867
subtest28of10,pubtest242of100,1,323,5506,21,380,5907
subtest29of10,pubtest243of100,1,323,5503,-3,248,5748
subtest28of10,pubtest243of100,1,323,5503,-1,283,5785
subtest23of10,pubtest243of100,1,323,5503,0,322,5825
subtest22of10,pubtest243of100,1,323,5503,4,357,5864
subtest26of10,pubtest243of100,1,323,5503,5,397,5905
subtest25of10,pubtest243of100,1,323,5503,7,435,5945
subtest27of10,pubtest243of100,1,323,5503,9,474,5986
subtest24of10,pubtest243of100,1,323,5503,12,510,6025
subtest21of10,pubtest243of100,1,323,5503,12,550,6065
subtest210of10,pubtest243of100,1,323,5503,13,589,6105
subtest26of10,pubtest244of100,1,323,5354,-3,39,5390
subtest27of10,pubtest244of100,1,323,5354,-2,78,5430
subtest25of10,pubtest244of100,1,323,5354,3,113,5470
subtest29of10,pubtest244of100,1,323,5354,7,148,5509
subtest21of10,pubtest244of100,1,323,5354,11,184,5549
subtest28of10,pubtest244of100,1,323,5354,11,224,5589
subtest22of10,pubtest244of100,1,323,5354,13,261,5628
subtest210of10,pubtest244of100,1,323,5354,13,300,5667
subtest23of10,pubtest244of100,1,323,5354,13,339,5706
subtest24of10,pubtest244of100,1,323,5354,19,376,5749
subtest29of10,pubtest245of100,1,322,5371,-2,39,5408
subtest26of10,pubtest245of100,1,322,5371,0,76,5447
subtest23of10,pubtest245of100,1,322,5371,0,116,5487
subtest25of10,pubtest245of100,1,322,5371,4,152,5527
subtest22of10,pubtest245of100,1,322,5371,4,193,5568
subtest28of10,pubtest245of100,1,322,5371,12,224,5607
subtest24of10,pubtest245of100,1,322,5371,12,263,5646
subtest21of10,pubtest245of100,1,322,5371,14,302,5687
subtest27of10,pubtest245of100,1,322,5371,19,379,5769
subtest210of10,pubtest245of100,1,322,5371,19,337,5727
subtest27of10,pubtest246of100,1,323,5310,0,38,5348
subtest21of10,pubtest246of100,1,323,5310,0,77,5387
subtest26of10,pubtest246of100,1,323,5310,7,109,5426
subtest29of10,pubtest246of100,1,323,5310,8,149,5467
subtest28of10,pubtest246of100,1,323,5310,9,188,5507
subtest23of10,pubtest246of100,1,323,5310,12,226,5548
subtest25of10,pubtest246of100,1,323,5310,12,264,5586
subtest24of10,pubtest246of100,1,323,5310,14,303,5627
subtest210of10,pubtest246of100,1,323,5310,12,342,5664
subtest22of10,pubtest246of100,1,323,5310,15,382,5707
subtest27of10,pubtest247of100,1,323,5307,0,39,5346
subtest21of10,pubtest247of100,1,323,5307,7,69,5383
subtest29of10,pubtest247of100,1,323,5307,9,109,5425
subtest23of10,pubtest247of100,1,323,5307,7,148,5462
subtest26of10,pubtest247of100,1,323,5307,9,188,5504
subtest22of10,pubtest247of100,1,323,5307,9,227,5543
subtest210of10,pubtest247of100,1,323,5307,12,266,5585
subtest28of10,pubtest247of100,1,323,5307,9,306,5622
subtest25of10,pubtest247of100,1,323,5307,14,344,5665
subtest24of10,pubtest247of100,1,323,5307,15,383,5705
subtest29of10,pubtest248of100,1,323,5442,-4,41,5479
subtest25of10,pubtest248of100,1,323,5442,-2,78,5518
subtest26of10,pubtest248of100,1,323,5442,-1,117,5558
subtest23of10,pubtest248of100,1,323,5442,0,156,5598
subtest28of10,pubtest248of100,1,323,5442,1,195,5638
subtest27of10,pubtest248of100,1,323,5442,2,233,5677
subtest21of10,pubtest248of100,1,323,5442,8,268,5718
subtest22of10,pubtest248of100,1,323,5442,14,303,5759
subtest24of10,pubtest248of100,1,323,5442,14,342,5798
subtest210of10,pubtest248of100,1,323,5442,21,375,5838
subtest27of10,pubtest249of100,1,323,5983,-4,41,6020
subtest28of10,pubtest249of100,1,323,5983,6,70,6059
subtest21of10,pubtest249of100,1,323,5983,8,109,6100
subtest29of10,pubtest249of100,1,323,5983,8,148,6139
subtest26of10,pubtest249of100,1,323,5983,9,187,6179
subtest210of10,pubtest249of100,1,323,5983,10,226,6219
subtest22of10,pubtest249of100,1,323,5983,10,266,6259
subtest24of10,pubtest249of100,1,323,5983,12,304,6299
subtest25of10,pubtest249of100,1,323,5983,7,344,6334
subtest23of10,pubtest249of100,1,323,5983,12,383,6378
subtest27of10,pubtest250of100,1,323,5366,0,40,5406
subtest23of10,pubtest250of100,1,323,5366,3,76,5445
subtest29of10,pubtest250of100,1,323,5366,5,114,5485
subtest24of10,pubtest250of100,1,323,5366,6,153,5525
subtest28of10,pubtest250of100,1,323,5366,5,192,5563
subtest21of10,pubtest250of100,1,323,5366,9,230,5605
subtest25of10,pubtest250of100,1,323,5366,10,270,5646
subtest210of10,pubtest250of100,1,323,5366,11,308,5685
subtest26of10,pubtest250of100,1,323,5366,12,348,5726
subtest22of10,pubtest250of100,1,323,5366,15,384,5765
subtest23of10,pubtest251of100,1,323,5346,-3,39,5382
subtest22of10,pubtest251of100,1,323,5346,-1,76,5421
subtest24of10,pubtest251of100,1,323,5346,1,114,5461
subtest27of10,pubtest251of100,1,323,5346,7,148,5501
subtest25of10,pubtest251of100,1,323,5346,8,187,5541
subtest29of10,pubtest251of100,1,323,5346,9,226,5581
subtest21of10,pubtest251of100,1,323,5346,9,266,5621
subtest28of10,pubtest251of100,1,323,5346,9,304,5659
subtest26of10,pubtest251of100,1,323,5346,11,344,5701
subtest210of10,pubtest251of100,1,323,5346,12,383,5741
subtest29of10,pubtest252of100,1,323,5288,0,44,5332
subtest28of10,pubtest252of100,1,323,5288,7,76,5371
subtest21of10,pubtest252of100,1,323,5288,9,114,5411
subtest23of10,pubtest252of100,1,323,5288,12,151,5451
subtest22of10,pubtest252of100,1,323,5288,12,191,5491
subtest27of10,pubtest252of100,1,323,5288,9,234,5531
subtest25of10,pubtest252of100,1,323,5288,14,270,5572
subtest210of10,pubtest252of100,1,323,5288,14,308,5610
subtest26of10,pubtest252of100,1,323,5288,14,347,5649
subtest24of10,pubtest252of100,1,323,5288,14,387,5689
subtest28of10,pubtest253of100,1,322,5317,-2,297,5612
subtest23of10,pubtest253of100,1,322,5317,5,329,5651
subtest24of10,pubtest253of100,1,322,5317,6,368,5691
subtest29of10,pubtest253of100,1,322,5317,7,407,5731
subtest22of10,pubtest253of100,1,322,5317,8,446,5771
subtest25of10,pubtest253of100,1,322,5317,8,486,5811
subtest21of10,pubtest253of100,1,322,5317,10,525,5852
subtest27of10,pubtest253of100,1,322,5317,10,564,5891
subtest210of10,pubtest253of100,1,322,5317,10,601,5928
subtest26of10,pubtest253of100,1,322,5317,13,641,5971
subtest210of10,pubtest254of100,1,323,5311,-3,40,5348
subtest27of10,pubtest254of100,1,323,5311,2,76,5389
subtest21of10,pubtest254of100,1,323,5311,4,113,5428
subtest28of10,pubtest254of100,1,323,5311,5,151,5467
subtest24of10,pubtest254of100,1,323,5311,5,191,5507
subtest25of10,pubtest254of100,1,323,5311,6,229,5546
subtest23of10,pubtest254of100,1,323,5311,7,269,5587
subtest29of10,pubtest254of100,1,323,5311,14,302,5627
subtest22of10,pubtest254of100,1,323,5311,15,341,5667
subtest26of10,pubtest254of100,1,323,5311,16,381,5708
subtest22of10,pubtest255of100,1,322,5474,0,38,5512
subtest23of10,pubtest255of100,1,322,5474,10,68,5552
subtest28of10,pubtest255of100,1,322,5474,17,101,5592
subtest27of10,pubtest255of100,1,322,5474,29,129,5632
subtest29of10,pubtest255of100,1,322,5474,42,155,5671
subtest24of10,pubtest255of100,1,322,5474,43,194,5711
subtest25of10,pubtest255of100,1,322,5474,53,224,5751
subtest21of10,pubtest255of100,1,322,5474,53,264,5791
subtest210of10,pubtest255of100,1,322,5474,54,303,5831
subtest26of10,pubtest255of100,1,322,5474,54,343,5871
subtest29of10,pubtest256of100,1,323,5333,-1,42,5374
subtest21of10,pubtest256of100,1,323,5333,3,77,5413
subtest26of10,pubtest256of100,1,323,5333,4,117,5454
subtest23of10,pubtest256of100,1,323,5333,7,153,5493
subtest210of10,pubtest256of100,1,323,5333,7,194,5534
subtest28of10,pubtest256of100,1,323,5333,13,228,5574
subtest25of10,pubtest256of100,1,323,5333,12,268,5613
subtest27of10,pubtest256of100,1,323,5333,14,306,5653
subtest22of10,pubtest256of100,1,323,5333,19,341,5693
subtest24of10,pubtest256of100,1,323,5333,19,381,5733
subtest21of10,pubtest257of100,1,323,5299,-3,43,5339
subtest24of10,pubtest257of100,1,323,5299,-2,80,5377
subtest27of10,pubtest257of100,1,323,5299,-1,119,5417
subtest28of10,pubtest257of100,1,323,5299,1,157,5457
subtest22of10,pubtest257of100,1,323,5299,5,193,5497
subtest23of10,pubtest257of100,1,323,5299,10,227,5536
subtest29of10,pubtest257of100,1,323,5299,12,267,5578
subtest25of10,pubtest257of100,1,323,5299,14,304,5617
subtest210of10,pubtest257of100,1,323,5299,14,344,5657
subtest26of10,pubtest257of100,1,323,5299,20,378,5697
subtest23of10,pubtest258of100,1,323,5296,1,42,5339
subtest28of10,pubtest258of100,1,323,5296,1,82,5379
subtest25of10,pubtest258of100,1,323,5296,6,116,5418
subtest21of10,pubtest258of100,1,323,5296,15,147,5458
subtest29of10,pubtest258of100,1,323,5296,18,184,5498
subtest26of10,pubtest258of100,1,323,5296,18,223,5537
subtest22of10,pubtest258of100,1,323,5296,20,262,5578
subtest210of10,pubtest258of100,1,323,5296,20,301,5617
subtest27of10,pubtest258of100,1,323,5296,20,341,5657
subtest24of10,pubtest258of100,1,323,5296,22,378,5696
subtest21of10,pubtest259of100,1,323,5431,-1,38,5468
subtest28of10,pubtest259of100,1,323,5431,2,74,5507
subtest25of10,pubtest259of100,1,323,5431,4,114,5549
subtest24of10,pubtest259of100,1,323,5431,9,147,5587
subtest26of10,pubtest259of100,1,323,5431,11,185,5627
subtest29of10,pubtest259of100,1,323,5431,12,226,5669
subtest27of10,pubtest259of100,1,323,5431,10,265,5706
subtest23of10,pubtest259of100,1,323,5431,11,303,5745
subtest22of10,pubtest259of100,1,323,5431,15,341,5787
subtest210of10,pubtest259of100,1,323,5431,15,381,5827
subtest23of10,pubtest260of100,1,323,5432,3,40,5475
subtest210of10,pubtest260of100,1,323,5432,3,77,5512
subtest26of10,pubtest260of100,1,323,5432,10,112,5554
subtest21of10,pubtest260of100,1,323,5432,11,150,5593
subtest27of10,pubtest260of100,1,323,5432,12,190,5634
subtest29of10,pubtest260of100,1,323,5432,13,228,5673
subtest22of10,pubtest260of100,1,323,5432,15,265,5712
subtest28of10,pubtest260of100,1,323,5432,16,305,5753
subtest25of10,pubtest260of100,1,323,5432,15,344,5791
subtest24of10,pubtest260of100,1,323,5432,17,384,5833
subtest29of10,pubtest261of100,1,323,5344,2,42,5388
subtest28of10,pubtest261of100,1,323,5344,1,81,5426
subtest25of10,pubtest261of100,1,323,5344,1,118,5463
subtest210of10,pubtest261of100,1,323,5344,5,158,5507
subtest23of10,pubtest261of100,1,323,5344,5,197,5546
subtest21of10,pubtest261of100,1,323,5344,10,234,5588
subtest27of10,pubtest261of100,1,323,5344,10,275,5629
subtest24of10,pubtest261of100,1,323,5344,12,312,5668
subtest22of10,pubtest261of100,1,323,5344,12,352,5708
subtest26of10,pubtest261of100,1,323,5344,19,385,5748
subtest21of10,pubtest262of100,1,323,5620,-1,163,5782
subtest22of10,pubtest262of100,1,323,5620,4,159,5783
subtest23of10,pubtest262of100,1,323,5620,5,198,5823
subtest29of10,pubtest262of100,1,323,5620,6,237,5863
subtest26of10,pubtest262of100,1,323,5620,7,276,5903
subtest27of10,pubtest262of100,1,323,5620,7,313,5940
subtest210of10,pubtest262of100,1,323,5620,11,352,5983
subtest28of10,pubtest262of100,1,323,5620,13,390,6023
subtest25of10,pubtest262of100,1,323,5620,13,431,6064
subtest24of10,pubtest262of100,1,323,5620,12,471,6103
subtest22of10,pubtest263of100,1,322,5371,5,40,5416
subtest29of10,pubtest263of100,1,322,5371,7,77,5455
subtest23of10,pubtest263of100,1,322,5371,11,113,5495
subtest24of10,pubtest263of100,1,322,5371,23,142,5536
subtest25of10,pubtest263of100,1,322,5371,26,178,5575
subtest26of10,pubtest263of100,1,322,5371,27,217,5615
subtest27of10,pubtest263of100,1,322,5371,33,251,5655
subtest21of10,pubtest263of100,1,322,5371,34,290,5695
subtest210of10,pubtest263of100,1,322,5371,34,330,5735
subtest28of10,pubtest263of100,1,322,5371,38,366,5775
subtest29of10,pubtest264of100,1,322,5305,-2,38,5341
subtest22of10,pubtest264of100,1,322,5305,-3,77,5379
subtest24of10,pubtest264of100,1,322,5305,1,114,5420
subtest23of10,pubtest264of100,1,322,5305,1,153,5459
subtest27of10,pubtest264of100,1,322,5305,9,186,5500
subtest28of10,pubtest264of100,1,322,5305,13,224,5542
subtest21of10,pubtest264of100,1,322,5305,15,261,5581
subtest25of10,pubtest264of100,1,322,5305,17,299,5621
subtest210of10,pubtest264of100,1,322,5305,21,334,5660
subtest26of10,pubtest264of100,1,322,5305,21,374,5700
subtest26of10,pubtest265of100,1,323,5298,-3,40,5335
subtest27of10,pubtest265of100,1,323,5298,-2,77,5373
subtest210of10,pubtest265of100,1,323,5298,0,116,5414
subtest21of10,pubtest265of100,1,323,5298,2,155,5455
subtest22of10,pubtest265of100,1,323,5298,5,191,5494
subtest29of10,pubtest265of100,1,323,5298,7,229,5534
subtest25of10,pubtest265of100,1,323,5298,8,268,5574
subtest23of10,pubtest265of100,1,323,5298,9,307,5614
subtest28of10,pubtest265of100,1,323,5298,13,343,5654
subtest24of10,pubtest265of100,1,323,5298,14,382,5694
subtest29of10,pubtest266of100,1,321,5262,-3,38,5297
subtest25of10,pubtest266of100,1,321,5262,-1,75,5336
subtest210of10,pubtest266of100,1,321,5262,5,109,5376
subtest27of10,pubtest266of100,1,321,5262,6,148,5416
subtest23of10,pubtest266of100,1,321,5262,7,187,5456
subtest21of10,pubtest266of100,1,321,5262,8,226,5496
subtest26of10,pubtest266of100,1,321,5262,8,266,5536
subtest28of10,pubtest266of100,1,321,5262,10,304,5576
subtest24of10,pubtest266of100,1,321,5262,11,343,5616
subtest22of10,pubtest266of100,1,321,5262,11,382,5655
subtest23of10,pubtest267of100,1,323,5308,7,40,5355
subtest26of10,pubtest267of100,1,323,5308,16,70,5394
subtest27of10,pubtest267of100,1,323,5308,17,108,5433
subtest25of10,pubtest267of100,1,323,5308,18,148,5474
subtest28of10,pubtest267of100,1,323,5308,19,185,5512
subtest29of10,pubtest267of100,1,323,5308,19,225,5552
subtest210of10,pubtest267of100,1,323,5308,23,263,5594
subtest24of10,pubtest267of100,1,323,5308,23,304,5635
subtest21of10,pubtest267of100,1,323,5308,24,342,5674
subtest22of10,pubtest267of100,1,323,5308,24,381,5713
subtest23of10,pubtest268of100,1,323,5335,-4,40,5371
subtest25of10,pubtest268of100,1,323,5335,-2,77,5410
subtest24of10,pubtest268of100,1,323,5335,2,114,5451
subtest29of10,pubtest268of100,1,323,5335,4,151,5490
subtest28of10,pubtest268of100,1,323,5335,10,185,5530
subtest27of10,pubtest268of100,1,323,5335,11,224,5570
subtest21of10,pubtest268of100,1,323,5335,12,263,5610
subtest22of10,pubtest268of100,1,323,5335,16,298,5649
subtest210of10,pubtest268of100,1,323,5335,18,336,5689
subtest26of10,pubtest268of100,1,323,5335,20,375,5730
subtest24of10,pubtest269of100,1,323,5652,-5,38,5685
subtest27of10,pubtest269of100,1,323,5652,-4,79,5727
subtest25of10,pubtest269of100,1,323,5652,-2,116,5766
subtest210of10,pubtest269of100,1,323,5652,-1,154,5805
subtest21of10,pubtest269of100,1,323,5652,0,193,5845
subtest29of10,pubtest269of100,1,323,5652,6,227,5885
subtest23of10,pubtest269of100,1,323,5652,7,266,5925
subtest26of10,pubtest269of100,1,323,5652,8,306,5966
subtest22of10,pubtest269of100,1,323,5652,9,343,6004
subtest28of10,pubtest269of100,1,323,5652,11,382,6045
subtest23of10,pubtest270of100,1,323,5370,-2,41,5409
subtest26of10,pubtest270of100,1,323,5370,4,74,5448
subtest27of10,pubtest270of100,1,323,5370,4,113,5487
subtest29of10,pubtest270of100,1,323,5370,6,151,5527
subtest210of10,pubtest270of100,1,323,5370,10,187,5567
subtest25of10,pubtest270of100,1,323,5370,10,227,5607
subtest21of10,pubtest270of100,1,323,5370,12,266,5648
subtest28of10,pubtest270of100,1,323,5370,12,306,5688
subtest24of10,pubtest270of100,1,323,5370,13,344,5727
subtest22of10,pubtest270of100,1,323,5370,13,384,5767
subtest24of10,pubtest271of100,1,323,5431,-2,43,5472
subtest25of10,pubtest271of100,1,323,5431,0,81,5512
subtest22of10,pubtest271of100,1,323,5431,1,120,5552
subtest27of10,pubtest271of100,1,323,5431,5,156,5592
subtest210of10,pubtest271of100,1,323,5431,6,195,5632
subtest26of10,pubtest271of100,1,323,5431,7,234,5672
subtest21of10,pubtest271of100,1,323,5431,8,274,5713
subtest23of10,pubtest271of100,1,323,5431,8,313,5752
subtest28of10,pubtest271of100,1,323,5431,9,352,5792
subtest29of10,pubtest271of100,1,323,5431,9,392,5832
subtest25of10,pubtest272of100,1,323,5351,-4,42,5389
subtest21of10,pubtest272of100,1,323,5351,-1,78,5428
subtest26of10,pubtest272of100,1,323,5351,1,117,5469
subtest29of10,pubtest272of100,1,323,5351,3,153,5507
subtest24of10,pubtest272of100,1,323,5351,9,188,5548
subtest23of10,pubtest272of100,1,323,5351,12,225,5588
subtest27of10,pubtest272of100,1,323,5351,13,264,5628
subtest210of10,pubtest272of100,1,323,5351,14,303,5668
subtest22of10,pubtest272of100,1,323,5351,15,343,5709
subtest28of10,pubtest272of100,1,323,5351,17,381,5749
subtest22of10,pubtest273of100,1,321,5358,15,41,5414
subtest26of10,pubtest273of100,1,321,5358,16,77,5451
subtest29of10,pubtest273of100,1,321,5358,16,117,5491
subtest28of10,pubtest273of100,1,321,5358,23,151,5532
subtest210of10,pubtest273of100,1,321,5358,24,190,5572
subtest27of10,pubtest273of100,1,321,5358,25,229,5612
subtest23of10,pubtest273of100,1,321,5358,26,266,5650
subtest24of10,pubtest273of100,1,321,5358,26,306,5690
subtest21of10,pubtest273of100,1,321,5358,29,345,5732
subtest25of10,pubtest273of100,1,321,5358,24,385,5767
subtest26of10,pubtest274of100,1,323,5457,-1,80,5536
subtest21of10,pubtest274of100,1,323,5457,-2,121,5576
subtest23of10,pubtest274of100,1,323,5457,0,158,5615
subtest22of10,pubtest274of100,1,323,5457,6,192,5655
subtest29of10,pubtest274of100,1,323,5457,6,232,5695
subtest25of10,pubtest274of100,1,323,5457,9,269,5735
subtest28of10,pubtest274of100,1,323,5457,12,306,5775
subtest27of10,pubtest274of100,1,323,5457,13,346,5816
subtest210of10,pubtest274of100,1,323,5457,17,381,5855
subtest24of10,pubtest274of100,1,323,5457,17,421,5895
subtest27of10,pubtest275of100,1,323,5320,-3,45,5362
subtest29of10,pubtest275of100,1,323,5320,-2,83,5401
subtest25of10,pubtest275of100,1,323,5320,0,121,5441
subtest24of10,pubtest275of100,1,323,5320,0,160,5480
subtest22of10,pubtest275of100,1,323,5320,5,196,5521
subtest23of10,pubtest275of100,1,323,5320,6,235,5561
subtest210of10,pubtest275of100,1,323,5320,7,274,5601
subtest21of10,pubtest275of100,1,323,5320,6,313,5639
subtest28of10,pubtest275of100,1,323,5320,13,349,5682
subtest26of10,pubtest275of100,1,323,5320,12,388,5720
subtest21of10,pubtest276of100,1,323,5294,9,41,5344
subtest28of10,pubtest276of100,1,323,5294,9,80,5383
subtest25of10,pubtest276of100,1,323,5294,11,118,5423
subtest24of10,pubtest276of100,1,323,5294,21,148,5463
subtest27of10,pubtest276of100,1,323,5294,21,188,5503
subtest23of10,pubtest276of100,1,323,5294,30,219,5543
subtest29of10,pubtest276of100,1,323,5294,30,258,5582
subtest210of10,pubtest276of100,1,323,5294,31,299,5624
subtest26of10,pubtest276of100,1,323,5294,33,336,5663
subtest22of10,pubtest276of100,1,323,5294,33,376,5703
subtest22of10,pubtest277of100,1,323,5307,-3,41,5345
subtest29of10,pubtest277of100,1,323,5307,0,77,5384
subtest28of10,pubtest277of100,1,323,5307,5,111,5423
subtest27of10,pubtest277of100,1,323,5307,7,150,5464
subtest21of10,pubtest277of100,1,323,5307,6,189,5502
subtest24of10,pubtest277of100,1,323,5307,6,229,5542
subtest25of10,pubtest277of100,1,323,5307,13,263,5583
subtest210of10,pubtest277of100,1,323,5307,13,303,5623
subtest23of10,pubtest277of100,1,323,5307,19,338,5664
subtest26of10,pubtest277of100,1,323,5307,19,378,5704
subtest22of10,pubtest278of100,1,323,5286,4,38,5328
subtest23of10,pubtest278of100,1,323,5286,5,77,5368
subtest29of10,pubtest278of100,1,323,5286,4,111,5401
subtest210of10,pubtest278of100,1,323,5286,9,150,5445
subtest24of10,pubtest278of100,1,323,5286,12,190,5488
subtest25of10,pubtest278of100,1,323,5286,9,230,5525
subtest26of10,pubtest278of100,1,323,5286,7,269,5562
subtest28of10,pubtest278of100,1,323,5286,13,308,5607
subtest27of10,pubtest278of100,1,323,5286,8,348,5642
subtest21of10,pubtest278of100,1,323,5286,7,388,5681
subtest25of10,pubtest279of100,1,323,5263,19,41,5323
subtest21of10,pubtest279of100,1,323,5263,20,79,5362
subtest27of10,pubtest279of100,1,323,5263,21,117,5401
subtest23of10,pubtest279of100,1,323,5263,22,156,5441
subtest26of10,pubtest279of100,1,323,5263,24,195,5482
subtest24of10,pubtest279of100,1,323,5263,24,236,5523
subtest210of10,pubtest279of100,1,323,5263,25,274,5562
subtest29of10,pubtest279of100,1,323,5263,21,314,5598
subtest22of10,pubtest279of100,1,323,5263,27,351,5641
subtest28of10,pubtest279of100,1,323,5263,27,390,5680
subtest27of10,pubtest280of100,1,323,5561,7,41,5609
subtest26of10,pubtest280of100,1,323,5561,12,76,5649
subtest21of10,pubtest280of100,1,323,5561,12,115,5688
subtest24of10,pubtest280of100,1,323,5561,11,154,5726
subtest23of10,pubtest280of100,1,323,5561,14,193,5768
subtest29of10,pubtest280of100,1,323,5561,11,232,5804
subtest210of10,pubtest280of100,1,323,5561,18,270,5849
subtest25of10,pubtest280of100,1,323,5561,19,308,5888
subtest28of10,pubtest280of100,1,323,5561,22,345,5928
subtest22of10,pubtest280of100,1,323,5561,23,383,5967
subtest24of10,pubtest281of100,1,323,5330,0,43,5373
subtest23of10,pubtest281of100,1,323,5330,1,81,5412
subtest27of10,pubtest281of100,1,323,5330,2,120,5452
subtest28of10,pubtest281of100,1,323,5330,3,159,5492
subtest25of10,pubtest281of100,1,323,5330,11,190,5531
subtest210of10,pubtest281of100,1,323,5330,14,229,5573
subtest29of10,pubtest281of100,1,323,5330,14,268,5612
subtest21of10,pubtest281of100,1,323,5330,13,308,5651
subtest22of10,pubtest281of100,1,323,5330,12,347,5689
subtest26of10,pubtest281of100,1,323,5330,15,387,5732
subtest23of10,pubtest282of100,1,323,5392,-2,50,5440
subtest24of10,pubtest282of100,1,323,5392,0,86,5478
subtest21of10,pubtest282of100,1,323,5392,0,125,5517
subtest22of10,pubtest282of100,1,323,5392,7,159,5558
subtest25of10,pubtest282of100,1,323,5392,14,193,5599
subtest29of10,pubtest282of100,1,323,5392,14,233,5639
subtest26of10,pubtest282of100,1,323,5392,16,271,5679
subtest27of10,pubtest282of100,1,323,5392,16,311,5719
subtest28of10,pubtest282of100,1,323,5392,18,349,5759
subtest210of10,pubtest282of100,1,323,5392,18,388,5798
subtest27of10,pubtest283of100,1,323,5387,-2,40,5425
subtest24of10,pubtest283of100,1,323,5387,1,77,5465
subtest22of10,pubtest283of100,1,323,5387,1,116,5504
subtest23of10,pubtest283of100,1,323,5387,3,154,5544
subtest28of10,pubtest283of100,1,323,5387,17,179,5583
subtest25of10,pubtest283of100,1,323,5387,23,214,5624
subtest21of10,pubtest283of100,1,323,5387,23,254,5664
subtest26of10,pubtest283of100,1,323,5387,24,293,5704
subtest210of10,pubtest283of100,1,323,5387,24,332,5743
subtest29of10,pubtest283of100,1,323,5387,26,372,5785
subtest25of10,pubtest284of100,1,323,5266,-1,41,5306
subtest22of10,pubtest284of100,1,323,5266,2,77,5345
subtest210of10,pubtest284of100,1,323,5266,2,117,5385
subtest29of10,pubtest284of100,1,323,5266,5,154,5425
subtest27of10,pubtest284of100,1,323,5266,8,191,5465
subtest24of10,pubtest284of100,1,323,5266,11,228,5505
subtest23of10,pubtest284of100,1,323,5266,17,262,5545
subtest21of10,pubtest284of100,1,323,5266,20,299,5585
subtest28of10,pubtest284of100,1,323,5266,20,337,5623
subtest26of10,pubtest284of100,1,323,5266,23,376,5665
subtest23of10,pubtest285of100,1,323,5275,-3,240,5512
subtest25of10,pubtest285of100,1,323,5275,5,271,5551
subtest24of10,pubtest285of100,1,323,5275,5,311,5591
subtest27of10,pubtest285of100,1,323,5275,6,350,5631
subtest22of10,pubtest285of100,1,323,5275,13,384,5672
subtest21of10,pubtest285of100,1,323,5275,14,422,5711
subtest29of10,pubtest285of100,1,323,5275,15,461,5751
subtest28of10,pubtest285of100,1,323,5275,16,500,5791
subtest26of10,pubtest285of100,1,323,5275,21,535,5831
subtest210of10,pubtest285of100,1,323,5275,21,575,5871
subtest23of10,pubtest286of100,1,323,5389,-1,42,5430
subtest25of10,pubtest286of100,1,323,5389,7,74,5470
subtest24of10,pubtest286of100,1,323,5389,7,113,5509
subtest210of10,pubtest286of100,1,323,5389,7,152,5548
subtest29of10,pubtest286of100,1,323,5389,11,189,5589
subtest26of10,pubtest286of100,1,323,5389,12,228,5629
subtest27of10,pubtest286of100,1,323,5389,13,267,5669
subtest22of10,pubtest286of100,1,323,5389,13,307,5709
subtest28of10,pubtest286of100,1,323,5389,15,345,5749
subtest21of10,pubtest286of100,1,323,5389,15,385,5789
subtest29of10,pubtest287of100,1,323,5459,10,38,5507
subtest26of10,pubtest287of100,1,323,5459,7,79,5545
subtest27of10,pubtest287of100,1,323,5459,10,117,5586
subtest28of10,pubtest287of100,1,323,5459,11,156,5626
subtest210of10,pubtest287of100,1,323,5459,19,188,5666
subtest25of10,pubtest287of100,1,323,5459,19,228,5706
subtest23of10,pubtest287of100,1,323,5459,21,266,5746
subtest22of10,pubtest287of100,1,323,5459,21,305,5785
subtest24of10,pubtest287of100,1,323,5459,21,345,5825
subtest21of10,pubtest287of100,1,323,5459,21,384,5864
subtest29of10,pubtest288of100,1,323,5217,-2,42,5257
subtest25of10,pubtest288of100,1,323,5217,2,77,5296
subtest26of10,pubtest288of100,1,323,5217,3,116,5336
subtest27of10,pubtest288of100,1,323,5217,7,449,5673
subtest21of10,pubtest288of100,1,323,5217,11,447,5675
subtest22of10,pubtest288of100,1,323,5217,16,479,5712
subtest23of10,pubtest288of100,1,323,5217,19,516,5752
subtest210of10,pubtest288of100,1,323,5217,20,554,5791
subtest24of10,pubtest288of100,1,323,5217,21,594,5832
subtest28of10,pubtest288of100,1,323,5217,26,629,5872
subtest29of10,pubtest289of100,1,323,5514,6,41,5561
subtest210of10,pubtest289of100,1,323,5514,6,80,5600
subtest23of10,pubtest289of100,1,323,5514,8,118,5640
subtest25of10,pubtest289of100,1,323,5514,8,157,5679
subtest26of10,pubtest289of100,1,323,5514,10,196,5720
subtest24of10,pubtest289of100,1,323,5514,10,236,5760
subtest27of10,pubtest289of100,1,323,5514,12,272,5798
subtest22of10,pubtest289of100,1,323,5514,14,311,5839
subtest28of10,pubtest289of100,1,323,5514,15,351,5880
subtest21of10,pubtest289of100,1,323,5514,14,390,5918
subtest29of10,pubtest290of100,1,323,5274,17,40,5331
subtest22of10,pubtest290of100,1,323,5274,18,78,5370
subtest23of10,pubtest290of100,1,323,5274,19,116,5409
subtest25of10,pubtest290of100,1,323,5274,23,152,5449
subtest27of10,pubtest290of100,1,323,5274,24,191,5489
subtest21of10,pubtest290of100,1,323,5274,25,230,5529
subtest26of10,pubtest290of100,1,323,5274,26,269,5569
subtest210of10,pubtest290of100,1,323,5274,27,308,5609
subtest28of10,pubtest290of100,1,323,5274,28,347,5649
subtest24of10,pubtest290of100,1,323,5274,31,384,5689
subtest23of10,pubtest291of100,1,323,5457,-6,42,5493
subtest24of10,pubtest291of100,1,323,5457,-4,79,5532
subtest27of10,pubtest291of100,1,323,5457,-2,117,5572
subtest28of10,pubtest291of100,1,323,5457,-2,156,5611
subtest21of10,pubtest291of100,1,323,5457,-1,196,5652
subtest25of10,pubtest291of100,1,323,5457,1,234,5692
subtest29of10,pubtest291of100,1,323,5457,1,274,5732
subtest210of10,pubtest291of100,1,323,5457,5,310,5772
subtest22of10,pubtest291of100,1,323,5457,5,350,5812
subtest26of10,pubtest291of100,1,323,5457,8,388,5853
subtest29of10,pubtest292of100,1,323,5384,-3,41,5422
subtest28of10,pubtest292of100,1,323,5384,-1,78,5461
subtest21of10,pubtest292of100,1,323,5384,-1,119,5502
subtest25of10,pubtest292of100,1,323,5384,2,155,5541
subtest26of10,pubtest292of100,1,323,5384,3,194,5581
subtest27of10,pubtest292of100,1,323,5384,4,234,5622
subtest23of10,pubtest292of100,1,323,5384,4,273,5661
subtest22of10,pubtest292of100,1,323,5384,12,305,5701
subtest24of10,pubtest292of100,1,323,5384,16,341,5741
subtest210of10,pubtest292of100,1,323,5384,20,377,5781
subtest24of10,pubtest293of100,1,323,5258,-6,40,5292
subtest28of10,pubtest293of100,1,323,5258,-5,76,5329
subtest210of10,pubtest293of100,1,323,5258,-3,117,5372
subtest25of10,pubtest293of100,1,323,5258,-6,155,5407
subtest23of10,pubtest293of100,1,323,5258,2,191,5451
subtest26of10,pubtest293of100,1,323,5258,6,227,5491
subtest27of10,pubtest293of100,1,323,5258,9,264,5531
subtest21of10,pubtest293of100,1,323,5258,10,303,5571
subtest22of10,pubtest293of100,1,323,5258,11,342,5611
subtest29of10,pubtest293of100,1,323,5258,12,381,5651
subtest21of10,pubtest294of100,1,323,5446,1,41,5488
subtest25of10,pubtest294of100,1,323,5446,4,77,5527
subtest210of10,pubtest294of100,1,323,5446,7,114,5567
subtest29of10,pubtest294of100,1,323,5446,11,150,5607
subtest27of10,pubtest294of100,1,323,5446,11,188,5645
subtest23of10,pubtest294of100,1,323,5446,14,227,5687
subtest24of10,pubtest294of100,1,323,5446,15,266,5727
subtest26of10,pubtest294of100,1,323,5446,16,305,5767
subtest28of10,pubtest294of100,1,323,5446,19,342,5807
subtest22of10,pubtest294of100,1,323,5446,19,382,5847
subtest25of10,pubtest295of100,1,323,5281,7,41,5329
subtest23of10,pubtest295of100,1,323,5281,23,64,5368
subtest24of10,pubtest295of100,1,323,5281,22,104,5407
subtest22of10,pubtest295of100,1,323,5281,24,143,5448
subtest27of10,pubtest295of100,1,323,5281,25,182,5488
subtest28of10,pubtest295of100,1,323,5281,26,221,5528
subtest21of10,pubtest295of100,1,323,5281,27,260,5568
subtest26of10,pubtest295of100,1,323,5281,27,300,5608
subtest210of10,pubtest295of100,1,323,5281,28,337,5646
subtest29of10,pubtest295of100,1,323,5281,29,377,5687
subtest25of10,pubtest296of100,1,322,5301,-4,43,5340
subtest27of10,pubtest296of100,1,322,5301,-2,80,5379
subtest26of10,pubtest296of100,1,322,5301,-1,119,5419
subtest24of10,pubtest296of100,1,322,5301,-4,159,5456
subtest23of10,pubtest296of100,1,322,5301,7,191,5499
subtest29of10,pubtest296of100,1,322,5301,7,231,5539
subtest21of10,pubtest296of100,1,322,5301,8,269,5578
subtest28of10,pubtest296of100,1,322,5301,8,309,5618
subtest210of10,pubtest296of100,1,322,5301,17,340,5658
subtest22of10,pubtest296of100,1,322,5301,17,380,5698
subtest25of10,pubtest297of100,1,323,5351,2,39,5392
subtest210of10,pubtest297of100,1,323,5351,5,74,5430
subtest29of10,pubtest297of100,1,323,5351,5,114,5470
subtest23of10,pubtest297of100,1,323,5351,7,152,5510
subtest22of10,pubtest297of100,1,323,5351,8,191,5550
subtest27of10,pubtest297of100,1,323,5351,10,229,5590
subtest21of10,pubtest297of100,1,323,5351,13,266,5630
subtest26of10,pubtest297of100,1,323,5351,13,306,5670
subtest28of10,pubtest297of100,1,323,5351,14,345,5710
subtest24of10,pubtest297of100,1,323,5351,17,382,5750
subtest29of10,pubtest298of100,1,323,5392,1,40,5433
subtest22of10,pubtest298of100,1,323,5392,1,81,5474
subtest24of10,pubtest298of100,1,323,5392,3,118,5513
subtest25of10,pubtest298of100,1,323,5392,3,158,5553
subtest23of10,pubtest298of100,1,323,5392,8,193,5593
subtest21of10,pubtest298of100,1,323,5392,9,231,5632
subtest210of10,pubtest298of100,1,323,5392,9,271,5672
subtest27of10,pubtest298of100,1,323,5392,12,309,5713
subtest28of10,pubtest298of100,1,323,5392,21,340,5753
subtest26of10,pubtest298of100,1,323,5392,22,379,5793
subtest22of10,pubtest299of100,1,323,5265,-4,39,5300
subtest29of10,pubtest299of100,1,323,5265,0,75,5340
subtest210of10,pubtest299of100,1,323,5265,1,113,5379
subtest27of10,pubtest299of100,1,323,5265,3,151,5419
subtest28of10,pubtest299of100,1,323,5265,8,187,5460
subtest24of10,pubtest299of100,1,323,5265,8,227,5500
subtest23of10,pubtest299of100,1,323,5265,10,265,5540
subtest25of10,pubtest299of100,1,323,5265,10,305,5580
subtest21of10,pubtest299of100,1,323,5265,15,340,5620
subtest26of10,pubtest299of100,1,323,5265,17,379,5661
subtest21of10,pubtest2100of100,1,325,5517,0,53,5570
subtest24of10,pubtest2100of100,1,325,5517,4,88,5609
subtest23of10,pubtest2100of100,1,325,5517,6,126,5649
subtest29of10,pubtest2100of100,1,325,5517,7,165,5689
subtest25of10,pubtest2100of100,1,325,5517,9,203,5729
subtest28of10,pubtest2100of100,1,325,5517,10,240,5767
subtest210of10,pubtest2100of100,1,325,5517,12,278,5807
subtest26of10,pubtest2100of100,1,325,5517,15,317,5849
subtest27of10,pubtest2100of100,1,325,5517,9,363,5889
subtest22of10,pubtest2100of100,1,325,5517,17,395,5929
subtest26of10,pubtest21of100,1,322,10648,5,39,10692
subtest27of10,pubtest21of100,1,322,10648,9,75,10732
subtest24of10,pubtest21of100,1,322,10648,30,93,10771
subtest25of10,pubtest21of100,1,322,10648,31,132,10811
subtest210of10,pubtest21of100,1,322,10648,32,171,10851
subtest23of10,pubtest21of100,1,322,10648,33,210,10891
subtest29of10,pubtest21of100,1,322,10648,31,251,10930
subtest21of10,pubtest21of100,1,322,10648,33,288,10969
subtest28of10,pubtest21of100,1,322,10648,53,310,11011
subtest22of10,pubtest21of100,1,322,10648,54,349,11051
subtest29of10,pubtest22of100,1,321,5277,-4,39,5312
subtest27of10,pubtest22of100,1,321,5277,-3,76,5350
subtest24of10,pubtest22of100,1,321,5277,8,106,5391
subtest23of10,pubtest22of100,1,321,5277,11,145,5433
subtest25of10,pubtest22of100,1,321,5277,11,184,5472
subtest28of10,pubtest22of100,1,321,5277,13,221,5511
subtest26of10,pubtest22of100,1,321,5277,13,261,5551
subtest21of10,pubtest22of100,1,321,5277,13,300,5590
subtest210of10,pubtest22of100,1,321,5277,15,339,5631
subtest22of10,pubtest22of100,1,321,5277,15,379,5671
subtest23of10,pubtest23of100,1,321,5307,1,41,5349
subtest29of10,pubtest23of100,1,321,5307,2,79,5388
subtest28of10,pubtest23of100,1,321,5307,3,118,5428
subtest25of10,pubtest23of100,1,321,5307,10,151,5468
subtest27of10,pubtest23of100,1,321,5307,10,191,5508
subtest24of10,pubtest23of100,1,321,5307,12,229,5548
subtest26of10,pubtest23of100,1,321,5307,18,263,5588
subtest21of10,pubtest23of100,1,321,5307,19,302,5628
subtest22of10,pubtest23of100,1,321,5307,20,341,5668
subtest210of10,pubtest23of100,1,321,5307,20,383,5710
subtest24of10,pubtest24of100,1,321,5254,1,39,5294
subtest23of10,pubtest24of100,1,321,5254,1,77,5332
subtest25of10,pubtest24of100,1,321,5254,3,115,5372
subtest21of10,pubtest24of100,1,321,5254,7,152,5413
subtest28of10,pubtest24of100,1,321,5254,8,190,5452
subtest29of10,pubtest24of100,1,321,5254,8,230,5492
subtest22of10,pubtest24of100,1,321,5254,10,268,5532
subtest27of10,pubtest24of100,1,321,5254,10,307,5571
subtest210of10,pubtest24of100,1,321,5254,11,347,5612
subtest26of10,pubtest24of100,1,321,5254,18,380,5652
subtest21of10,pubtest25of100,1,321,5294,4,43,5341
subtest28of10,pubtest25of100,1,321,5294,3,82,5379
subtest25of10,pubtest25of100,1,321,5294,8,118,5420
subtest27of10,pubtest25of100,1,321,5294,6,158,5458
subtest210of10,pubtest25of100,1,321,5294,5,197,5496
subtest26of10,pubtest25of100,1,321,5294,13,233,5540
subtest23of10,pubtest25of100,1,321,5294,15,271,5580
subtest22of10,pubtest25of100,1,321,5294,18,308,5620
subtest29of10,pubtest25of100,1,321,5294,20,346,5660
subtest24of10,pubtest25of100,1,321,5294,20,386,5700
subtest21of10,pubtest26of100,1,321,5316,-6,178,5488
subtest29of10,pubtest26of100,1,321,5316,-4,214,5526
subtest23of10,pubtest26of100,1,321,5316,4,246,5566
subtest27of10,pubtest26of100,1,321,5316,9,280,5605
subtest24of10,pubtest26of100,1,321,5316,13,317,5646
subtest22of10,pubtest26of100,1,321,5316,9,357,5682
subtest26of10,pubtest26of100,1,321,5316,14,396,5726
subtest28of10,pubtest26of100,1,321,5316,13,436,5765
subtest25of10,pubtest26of100,1,321,5316,10,475,5801
subtest210of10,pubtest26of100,1,321,5316,14,514,5844
subtest27of10,pubtest27of100,1,320,5270,-2,39,5307
subtest28of10,pubtest27of100,1,320,5270,-2,78,5346
subtest23of10,pubtest27of100,1,320,5270,0,116,5386
subtest29of10,pubtest27of100,1,320,5270,1,156,5427
subtest24of10,pubtest27of100,1,320,5270,2,194,5466
subtest25of10,pubtest27of100,1,320,5270,3,232,5505
subtest210of10,pubtest27of100,1,320,5270,3,273,5546
subtest22of10,pubtest27of100,1,320,5270,5,309,5584
subtest21of10,pubtest27of100,1,320,5270,7,348,5625
subtest26of10,pubtest27of100,1,320,5270,5,388,5663
subtest27of10,pubtest28of100,1,321,5367,-7,43,5403
subtest28of10,pubtest28of100,1,321,5367,2,73,5442
subtest21of10,pubtest28of100,1,321,5367,4,110,5481
subtest23of10,pubtest28of100,1,321,5367,6,149,5522
subtest29of10,pubtest28of100,1,321,5367,5,188,5560
subtest25of10,pubtest28of100,1,321,5367,7,228,5602
subtest210of10,pubtest28of100,1,321,5367,13,262,5642
subtest24of10,pubtest28of100,1,321,5367,14,301,5682
subtest26of10,pubtest28of100,1,321,5367,15,340,5722
subtest22of10,pubtest28of100,1,321,5367,16,377,5760
subtest23of10,pubtest29of100,1,321,5331,-4,39,5366
subtest29of10,pubtest29of100,1,321,5331,-1,75,5405
subtest210of10,pubtest29of100,1,321,5331,7,107,5445
subtest25of10,pubtest29of100,1,321,5331,13,141,5485
subtest22of10,pubtest29of100,1,321,5331,13,181,5525
subtest28of10,pubtest29of100,1,321,5331,15,219,5565
subtest21of10,pubtest29of100,1,321,5331,15,258,5604
subtest27of10,pubtest29of100,1,321,5331,16,298,5645
subtest24of10,pubtest29of100,1,321,5331,19,335,5685
subtest26of10,pubtest29of100,1,321,5331,21,373,5725
subtest29of10,pubtest210of100,1,323,5266,-2,340,5604
subtest21of10,pubtest210of100,1,323,5266,5,373,5644
subtest210of10,pubtest210of100,1,323,5266,6,412,5684
subtest27of10,pubtest210of100,1,323,5266,7,451,5724
subtest25of10,pubtest210of100,1,323,5266,12,486,5764
subtest28of10,pubtest210of100,1,323,5266,13,525,5804
subtest23of10,pubtest210of100,1,323,5266,12,564,5842
subtest24of10,pubtest210of100,1,323,5266,18,600,5884
subtest22of10,pubtest210of100,1,323,5266,19,639,5924
subtest26of10,pubtest210of100,1,323,5266,20,678,5964
subtest29of10,pubtest211of100,1,323,5570,12,40,5622
subtest21of10,pubtest211of100,1,323,5570,15,78,5663
subtest25of10,pubtest211of100,1,323,5570,15,118,5703
subtest22of10,pubtest211of100,1,323,5570,17,156,5743
subtest23of10,pubtest211of100,1,323,5570,17,196,5783
subtest26of10,pubtest211of100,1,323,5570,18,235,5823
subtest27of10,pubtest211of100,1,323,5570,19,274,5863
subtest24of10,pubtest211of100,1,323,5570,19,314,5903
subtest210of10,pubtest211of100,1,323,5570,12,353,5935
subtest28of10,pubtest211of100,1,323,5570,20,393,5983
subtest25of10,pubtest212of100,1,323,5321,-3,42,5360
subtest29of10,pubtest212of100,1,323,5321,-2,80,5399
subtest28of10,pubtest212of100,1,323,5321,13,105,5439
subtest23of10,pubtest212of100,1,323,5321,14,145,5480
subtest27of10,pubtest212of100,1,323,5321,17,181,5519
subtest21of10,pubtest212of100,1,323,5321,18,220,5559
subtest24of10,pubtest212of100,1,323,5321,18,260,5599
subtest22of10,pubtest212of100,1,323,5321,20,298,5639
subtest26of10,pubtest212of100,1,323,5321,22,336,5679
subtest210of10,pubtest212of100,1,323,5321,29,369,5719
subtest23of10,pubtest213of100,1,322,5271,41,40,5352
subtest29of10,pubtest213of100,1,322,5271,43,78,5392
subtest22of10,pubtest213of100,1,322,5271,51,110,5432
subtest26of10,pubtest213of100,1,322,5271,51,150,5472
subtest27of10,pubtest213of100,1,322,5271,53,188,5512
subtest21of10,pubtest213of100,1,322,5271,59,222,5552
subtest24of10,pubtest213of100,1,322,5271,66,253,5590
subtest210of10,pubtest213of100,1,322,5271,66,293,5630
subtest25of10,pubtest213of100,1,322,5271,72,329,5672
subtest28of10,pubtest213of100,1,322,5271,72,369,5712
subtest21of10,pubtest214of100,1,323,5291,-4,42,5329
subtest23of10,pubtest214of100,1,323,5291,-1,78,5368
subtest25of10,pubtest214of100,1,323,5291,0,117,5408
subtest26of10,pubtest214of100,1,323,5291,3,154,5448
subtest27of10,pubtest214of100,1,323,5291,11,186,5488
subtest210of10,pubtest214of100,1,323,5291,13,224,5528
subtest22of10,pubtest214of100,1,323,5291,13,264,5568
subtest29of10,pubtest214of100,1,323,5291,12,303,5606
subtest24of10,pubtest214of100,1,323,5291,15,342,5648
subtest28of10,pubtest214of100,1,323,5291,18,379,5688
subtest29of10,pubtest215of100,1,323,5296,-1,42,5337
subtest24of10,pubtest215of100,1,323,5296,1,79,5376
subtest21of10,pubtest215of100,1,323,5296,2,120,5418
subtest27of10,pubtest215of100,1,323,5296,-1,162,5457
subtest26of10,pubtest215of100,1,323,5296,5,195,5496
subtest25of10,pubtest215of100,1,323,5296,5,235,5536
subtest210of10,pubtest215of100,1,323,5296,7,273,5576
subtest23of10,pubtest215of100,1,323,5296,8,312,5616
subtest22of10,pubtest215of100,1,323,5296,9,351,5656
subtest28of10,pubtest215of100,1,323,5296,10,390,5696
subtest24of10,pubtest216of100,1,323,5267,57,414,5738
subtest21of10,pubtest216of100,1,323,5267,57,453,5777
subtest23of10,pubtest216of100,1,323,5267,65,485,5817
subtest27of10,pubtest216of100,1,323,5267,65,525,5857
subtest28of10,pubtest216of100,1,323,5267,66,564,5897
subtest25of10,pubtest216of100,1,323,5267,73,596,5936
subtest29of10,pubtest216of100,1,323,5267,74,636,5977
subtest22of10,pubtest216of100,1,323,5267,75,675,6017
subtest26of10,pubtest216of100,1,323,5267,76,716,6059
subtest210of10,pubtest216of100,1,323,5267,77,753,6097
subtest27of10,pubtest217of100,1,322,5258,7,41,5306
subtest22of10,pubtest217of100,1,322,5258,7,80,5345
subtest21of10,pubtest217of100,1,322,5258,9,118,5385
subtest26of10,pubtest217of100,1,322,5258,10,157,5425
subtest23of10,pubtest217of100,1,322,5258,11,196,5465
subtest25of10,pubtest217of100,1,322,5258,12,235,5505
subtest24of10,pubtest217of100,1,322,5258,12,276,5546
subtest29of10,pubtest217of100,1,322,5258,14,313,5585
subtest28of10,pubtest217of100,1,322,5258,14,353,5625
subtest210of10,pubtest217of100,1,322,5258,17,390,5665
subtest29of10,pubtest218of100,1,323,5275,794,41,6110
subtest21of10,pubtest218of100,1,323,5275,795,78,6148
subtest27of10,pubtest218of100,1,323,5275,797,117,6189
subtest22of10,pubtest218of100,1,323,5275,800,154,6229
subtest23of10,pubtest218of100,1,323,5275,801,193,6269
subtest28of10,pubtest218of100,1,323,5275,805,229,6309
subtest25of10,pubtest218of100,1,323,5275,805,269,6349
subtest24of10,pubtest218of100,1,323,5275,806,308,6389
subtest210of10,pubtest218of100,1,323,5275,807,347,6429
subtest26of10,pubtest218of100,1,323,5275,808,386,6469
subtest210of10,pubtest219of100,1,323,5279,0,38,5317
subtest26of10,pubtest219of100,1,323,5279,3,73,5355
subtest25of10,pubtest219of100,1,323,5279,3,113,5395
subtest21of10,pubtest219of100,1,323,5279,5,150,5434
subtest29of10,pubtest219of100,1,323,5279,6,189,5474
subtest27of10,pubtest219of100,1,323,5279,10,227,5516
subtest23of10,pubtest219of100,1,323,5279,10,267,5556
subtest22of10,pubtest219of100,1,323,5279,13,304,5596
subtest24of10,pubtest219of100,1,323,5279,16,341,5636
subtest28of10,pubtest219of100,1,323,5279,20,377,5676
subtest25of10,pubtest220of100,1,323,5256,-4,41,5293
subtest23of10,pubtest220of100,1,323,5256,4,72,5332
subtest210of10,pubtest220of100,1,323,5256,4,112,5372
subtest29of10,pubtest220of100,1,323,5256,8,148,5412
subtest24of10,pubtest220of100,1,323,5256,9,186,5451
subtest21of10,pubtest220of100,1,323,5256,10,226,5492
subtest28of10,pubtest220of100,1,323,5256,13,263,5532
subtest27of10,pubtest220of100,1,323,5256,13,303,5572
subtest26of10,pubtest220of100,1,323,5256,15,341,5612
subtest22of10,pubtest220of100,1,323,5256,16,380,5652
subtest24of10,pubtest221of100,1,323,5323,1,45,5369
subtest21of10,pubtest221of100,1,323,5323,3,83,5409
subtest28of10,pubtest221of100,1,323,5323,4,122,5449
subtest23of10,pubtest221of100,1,323,5323,6,159,5488
subtest22of10,pubtest221of100,1,323,5323,14,191,5528
subtest210of10,pubtest221of100,1,323,5323,15,230,5568
subtest25of10,pubtest221of100,1,323,5323,16,269,5608
subtest26of10,pubtest221of100,1,323,5323,21,304,5648
subtest29of10,pubtest221of100,1,323,5323,32,332,5687
subtest27of10,pubtest221of100,1,323,5323,33,372,5728
subtest22of10,pubtest222of100,1,323,5265,-3,39,5301
subtest21of10,pubtest222of100,1,323,5265,-2,77,5340
subtest29of10,pubtest222of100,1,323,5265,-1,116,5380
subtest27of10,pubtest222of100,1,323,5265,1,155,5421
subtest23of10,pubtest222of100,1,323,5265,2,193,5460
subtest25of10,pubtest222of100,1,323,5265,7,228,5500
subtest28of10,pubtest222of100,1,323,5265,13,262,5540
subtest210of10,pubtest222of100,1,323,5265,23,292,5580
subtest26of10,pubtest222of100,1,323,5265,25,330,5620
subtest24of10,pubtest222of100,1,323,5265,25,369,5659
subtest21of10,pubtest223of100,1,323,5347,38,41,5426
subtest23of10,pubtest223of100,1,323,5347,42,75,5464
subtest29of10,pubtest223of100,1,323,5347,46,111,5504
subtest28of10,pubtest223of100,1,323,5347,53,144,5544
subtest27of10,pubtest223of100,1,323,5347,53,184,5584
subtest24of10,pubtest223of100,1,323,5347,54,223,5624
subtest210of10,pubtest223of100,1,323,5347,55,264,5666
subtest22of10,pubtest223of100,1,323,5347,58,299,5704
subtest26of10,pubtest223of100,1,323,5347,64,333,5744
subtest25of10,pubtest223of100,1,323,5347,64,373,5784
subtest21of10,pubtest224of100,1,323,5306,-3,41,5344
subtest28of10,pubtest224of100,1,323,5306,-3,81,5384
subtest26of10,pubtest224of100,1,323,5306,5,112,5423
subtest27of10,pubtest224of100,1,323,5306,7,150,5463
subtest23of10,pubtest224of100,1,323,5306,8,190,5504
subtest29of10,pubtest224of100,1,323,5306,12,225,5543
subtest25of10,pubtest224of100,1,323,5306,13,264,5583
subtest22of10,pubtest224of100,1,323,5306,12,303,5621
subtest24of10,pubtest224of100,1,323,5306,17,340,5663
subtest210of10,pubtest224of100,1,323,5306,25,372,5703
subtest27of10,pubtest225of100,1,323,5276,449,43,5768
subtest25of10,pubtest225of100,1,323,5276,450,81,5807
subtest21of10,pubtest225of100,1,323,5276,452,120,5848
subtest23of10,pubtest225of100,1,323,5276,451,160,5887
subtest24of10,pubtest225of100,1,323,5276,453,198,5927
subtest22of10,pubtest225of100,1,323,5276,-1,692,5967
subtest210of10,pubtest225of100,1,323,5276,449,282,6007
subtest29of10,pubtest225of100,1,323,5276,450,321,6047
subtest26of10,pubtest225of100,1,323,5276,453,358,6087
subtest28of10,pubtest225of100,1,323,5276,455,396,6127
subtest25of10,pubtest226of100,1,323,5354,11,40,5405
subtest22of10,pubtest226of100,1,323,5354,11,79,5444
subtest23of10,pubtest226of100,1,323,5354,31,100,5485
subtest210of10,pubtest226of100,1,323,5354,31,140,5525
subtest28of10,pubtest226of100,1,323,5354,34,176,5564
subtest27of10,pubtest226of100,1,323,5354,34,215,5603
subtest21of10,pubtest226of100,1,323,5354,35,255,5644
subtest24of10,pubtest226of100,1,323,5354,37,293,5684
subtest29of10,pubtest226of100,1,323,5354,37,333,5724
subtest26of10,pubtest226of100,1,323,5354,37,372,5763
subtest210of10,pubtest227of100,1,323,5313,445,251,6009
subtest23of10,pubtest227of100,1,323,5313,446,290,6049
subtest29of10,pubtest227of100,1,323,5313,445,329,6087
subtest25of10,pubtest227of100,1,323,5313,445,368,6126
subtest21of10,pubtest227of100,1,323,5313,684,172,6169
subtest22of10,pubtest227of100,1,323,5313,685,208,6206
subtest24of10,pubtest227of100,1,323,5313,689,247,6249
subtest27of10,pubtest227of100,1,323,5313,688,287,6288
subtest26of10,pubtest227of100,1,323,5313,688,327,6328
subtest28of10,pubtest227of100,1,323,5313,1194,38,6545
subtest21of10,pubtest228of100,1,323,5316,2,40,5358
subtest26of10,pubtest228of100,1,323,5316,6,76,5398
subtest25of10,pubtest228of100,1,323,5316,16,106,5438
subtest23of10,pubtest228of100,1,323,5316,16,146,5478
subtest27of10,pubtest228of100,1,323,5316,18,184,5518
subtest24of10,pubtest228of100,1,323,5316,18,224,5558
subtest210of10,pubtest228of100,1,323,5316,28,254,5598
subtest29of10,pubtest228of100,1,323,5316,27,294,5637
subtest22of10,pubtest228of100,1,323,5316,33,329,5678
subtest28of10,pubtest228of100,1,323,5316,33,369,5718
subtest24of10,pubtest229of100,1,321,5364,1,41,5406
subtest28of10,pubtest229of100,1,321,5364,4,76,5444
subtest21of10,pubtest229of100,1,321,5364,17,103,5484
subtest22of10,pubtest229of100,1,321,5364,18,142,5524
subtest27of10,pubtest229of100,1,321,5364,22,178,5564
subtest210of10,pubtest229of100,1,321,5364,24,216,5604
subtest23of10,pubtest229of100,1,321,5364,25,255,5644
subtest26of10,pubtest229of100,1,321,5364,26,294,5684
subtest25of10,pubtest229of100,1,321,5364,27,331,5722
subtest29of10,pubtest229of100,1,321,5364,27,371,5762
subtest22of10,pubtest230of100,1,323,5313,189,39,5541
subtest21of10,pubtest230of100,1,323,5313,190,77,5580
subtest27of10,pubtest230of100,1,323,5313,191,116,5620
subtest29of10,pubtest230of100,1,323,5313,192,156,5661
subtest28of10,pubtest230of100,1,323,5313,401,39,5753
subtest25of10,pubtest230of100,1,323,5313,402,78,5793
subtest24of10,pubtest230of100,1,323,5313,404,115,5832
subtest23of10,pubtest230of100,1,323,5313,404,155,5872
subtest210of10,pubtest230of100,1,323,5313,405,194,5912
subtest26of10,pubtest230of100,1,323,5313,405,234,5952
subtest23of10,pubtest231of100,1,323,5266,139,38,5443
subtest28of10,pubtest231of100,1,323,5266,147,69,5482
subtest25of10,pubtest231of100,1,323,5266,148,108,5522
subtest24of10,pubtest231of100,1,323,5266,149,147,5562
subtest210of10,pubtest231of100,1,323,5266,150,186,5602
subtest27of10,pubtest231of100,1,323,5266,151,225,5642
subtest29of10,pubtest231of100,1,323,5266,151,264,5681
subtest26of10,pubtest231of100,1,323,5266,153,303,5722
subtest21of10,pubtest231of100,1,323,5266,153,343,5762
subtest22of10,pubtest231of100,1,323,5266,154,382,5802
subtest21of10,pubtest232of100,1,323,5237,363,51,5651
subtest27of10,pubtest232of100,1,323,5237,364,89,5690
subtest22of10,pubtest232of100,1,323,5237,365,127,5729
subtest25of10,pubtest232of100,1,323,5237,367,166,5770
subtest23of10,pubtest232of100,1,323,5237,369,204,5810
subtest24of10,pubtest232of100,1,323,5237,370,243,5850
subtest26of10,pubtest232of100,1,323,5237,372,281,5890
subtest28of10,pubtest232of100,1,323,5237,373,321,5931
subtest29of10,pubtest232of100,1,323,5237,367,359,5963
subtest210of10,pubtest232of100,1,323,5237,368,404,6009
subtest29of10,pubtest233of100,1,323,5250,124,41,5415
subtest24of10,pubtest233of100,1,323,5250,124,80,5454
subtest25of10,pubtest233of100,1,323,5250,140,101,5491
subtest26of10,pubtest233of100,1,323,5250,142,141,5533
subtest27of10,pubtest233of100,1,323,5250,143,180,5573
subtest23of10,pubtest233of100,1,323,5250,144,219,5613
subtest22of10,pubtest233of100,1,323,5250,144,259,5653
subtest21of10,pubtest233of100,1,323,5250,145,298,5693
subtest28of10,pubtest233of100,1,323,5250,146,337,5733
subtest210of10,pubtest233of100,1,323,5250,147,376,5773
subtest25of10,pubtest234of100,1,323,5245,332,39,5616
subtest27of10,pubtest234of100,1,323,5245,333,77,5655
subtest26of10,pubtest234of100,1,323,5245,333,116,5694
subtest21of10,pubtest234of100,1,323,5245,335,155,5735
subtest22of10,pubtest234of100,1,323,5245,335,193,5773
subtest210of10,pubtest234of100,1,323,5245,338,232,5815
subtest23of10,pubtest234of100,1,323,5245,339,271,5855
subtest28of10,pubtest234of100,1,323,5245,340,310,5895
subtest24of10,pubtest234of100,1,323,5245,341,349,5935
subtest29of10,pubtest234of100,1,323,5245,339,389,5973
subtest21of10,pubtest235of100,1,321,5556,745,38,6339
subtest210of10,pubtest235of100,1,321,5556,1338,40,6934
subtest22of10,pubtest235of100,1,321,5556,1442,38,7036
subtest23of10,pubtest235of100,1,321,5556,1444,75,7075
subtest27of10,pubtest235of100,1,321,5556,1446,113,7115
subtest29of10,pubtest235of100,1,321,5556,1448,149,7153
subtest24of10,pubtest235of100,1,321,5556,1451,188,7195
subtest25of10,pubtest235of100,1,321,5556,1451,228,7235
subtest28of10,pubtest235of100,1,321,5556,1453,266,7275
subtest26of10,pubtest235of100,1,321,5556,1453,306,7315
subtest210of10,pubtest236of100,1,323,5252,11,41,5304
subtest28of10,pubtest236of100,1,323,5252,12,79,5343
subtest23of10,pubtest236of100,1,323,5252,13,118,5383
subtest27of10,pubtest236of100,1,323,5252,15,156,5423
subtest25of10,pubtest236of100,1,323,5252,16,195,5463
subtest21of10,pubtest236of100,1,323,5252,17,234,5503
subtest29of10,pubtest236of100,1,323,5252,18,272,5542
subtest26of10,pubtest236of100,1,323,5252,18,312,5582
subtest24of10,pubtest236of100,1,323,5252,19,351,5622
subtest22of10,pubtest236of100,1,323,5252,29,382,5663
subtest24of10,pubtest237of100,1,323,5557,3,37,5597
subtest28of10,pubtest237of100,1,323,5557,4,76,5637
subtest23of10,pubtest237of100,1,323,5557,10,110,5677
subtest25of10,pubtest237of100,1,323,5557,16,145,5718
subtest21of10,pubtest237of100,1,323,5557,17,184,5758
subtest27of10,pubtest237of100,1,323,5557,18,222,5797
subtest29of10,pubtest237of100,1,323,5557,20,260,5837
subtest22of10,pubtest237of100,1,323,5557,20,300,5877
subtest26of10,pubtest237of100,1,323,5557,19,339,5915
subtest210of10,pubtest237of100,1,323,5557,24,376,5957
subtest22of10,pubtest238of100,1,323,5350,3,41,5394
subtest29of10,pubtest238of100,1,323,5350,3,80,5433
subtest27of10,pubtest238of100,1,323,5350,5,118,5473
subtest28of10,pubtest238of100,1,323,5350,6,157,5513
subtest25of10,pubtest238of100,1,323,5350,7,196,5553
subtest23of10,pubtest238of100,1,323,5350,11,232,5593
subtest21of10,pubtest238of100,1,323,5350,15,268,5633
subtest210of10,pubtest238of100,1,323,5350,20,303,5673
subtest26of10,pubtest238of100,1,323,5350,20,344,5714
subtest24of10,pubtest238of100,1,323,5350,28,375,5753
subtest28of10,pubtest239of100,1,323,5285,1,42,5328
subtest21of10,pubtest239of100,1,323,5285,3,78,5366
subtest27of10,pubtest239of100,1,323,5285,4,117,5406
subtest26of10,pubtest239of100,1,323,5285,5,156,5446
subtest24of10,pubtest239of100,1,323,5285,19,182,5486
subtest25of10,pubtest239of100,1,323,5285,20,221,5526
subtest29of10,pubtest239of100,1,323,5285,22,259,5566
subtest22of10,pubtest239of100,1,323,5285,26,296,5607
subtest23of10,pubtest239of100,1,323,5285,27,335,5647
subtest210of10,pubtest239of100,1,323,5285,29,373,5687
subtest21of10,pubtest240of100,1,323,5202,207,39,5448
subtest25of10,pubtest240of100,1,323,5202,205,78,5485
subtest210of10,pubtest240of100,1,323,5202,209,116,5527
subtest29of10,pubtest240of100,1,323,5202,368,45,5615
subtest23of10,pubtest240of100,1,323,5202,451,39,5692
subtest27of10,pubtest240of100,1,323,5202,450,79,5731
subtest28of10,pubtest240of100,1,323,5202,531,39,5772
subtest24of10,pubtest240of100,1,323,5202,531,78,5811
subtest22of10,pubtest240of100,1,323,5202,534,115,5851
subtest26of10,pubtest240of100,1,323,5202,537,152,5891
subtest23of10,pubtest241of100,1,323,5208,188,40,5436
subtest27of10,pubtest241of100,1,323,5208,260,40,5508
subtest24of10,pubtest241of100,1,323,5208,261,76,5545
subtest21of10,pubtest241of100,1,323,5208,263,116,5587
subtest210of10,pubtest241of100,1,323,5208,265,154,5627
subtest25of10,pubtest241of100,1,323,5208,265,194,5667
subtest29of10,pubtest241of100,1,323,5208,266,233,5707
subtest26of10,pubtest241of100,1,323,5208,266,273,5747
subtest22of10,pubtest241of100,1,323,5208,268,311,5787
subtest28of10,pubtest241of100,1,323,5208,268,351,5827
subtest27of10,pubtest242of100,1,323,5293,1,42,5336
subtest23of10,pubtest242of100,1,323,5293,10,73,5376
subtest25of10,pubtest242of100,1,323,5293,12,110,5415
subtest210of10,pubtest242of100,1,323,5293,13,149,5455
subtest26of10,pubtest242of100,1,323,5293,13,189,5495
subtest21of10,pubtest242of100,1,323,5293,15,226,5534
subtest28of10,pubtest242of100,1,323,5293,17,265,5575
subtest22of10,pubtest242of100,1,323,5293,18,303,5614
subtest24of10,pubtest242of100,1,323,5293,19,343,5655
subtest29of10,pubtest242of100,1,323,5293,14,383,5690
subtest29of10,pubtest243of100,1,323,5301,3,39,5343
subtest28of10,pubtest243of100,1,323,5301,3,79,5383
subtest23of10,pubtest243of100,1,323,5301,5,116,5422
subtest22of10,pubtest243of100,1,323,5301,6,155,5462
subtest26of10,pubtest243of100,1,323,5301,7,194,5502
subtest25of10,pubtest243of100,1,323,5301,8,233,5542
subtest24of10,pubtest243of100,1,323,5301,12,269,5582
subtest27of10,pubtest243of100,1,323,5301,13,308,5622
subtest21of10,pubtest243of100,1,323,5301,64,297,5662
subtest210of10,pubtest243of100,1,323,5301,64,337,5702
subtest26of10,pubtest244of100,1,323,5298,8,41,5347
subtest27of10,pubtest244of100,1,323,5298,10,78,5386
subtest25of10,pubtest244of100,1,323,5298,13,115,5426
subtest29of10,pubtest244of100,1,323,5298,23,145,5466
subtest28of10,pubtest244of100,1,323,5298,23,185,5506
subtest21of10,pubtest244of100,1,323,5298,24,224,5546
subtest23of10,pubtest244of100,1,323,5298,25,262,5585
subtest210of10,pubtest244of100,1,323,5298,26,302,5626
subtest24of10,pubtest244of100,1,323,5298,27,339,5664
subtest22of10,pubtest244of100,1,323,5298,29,379,5706
subtest29of10,pubtest245of100,1,322,5194,1,40,5235
subtest26of10,pubtest245of100,1,322,5194,3,77,5274
subtest23of10,pubtest245of100,1,322,5194,5,115,5314
subtest22of10,pubtest245of100,1,322,5194,6,154,5354
subtest25of10,pubtest245of100,1,322,5194,7,193,5394
subtest24of10,pubtest245of100,1,322,5194,17,223,5434
subtest21of10,pubtest245of100,1,322,5194,21,259,5474
subtest28of10,pubtest245of100,1,322,5194,21,298,5513
subtest210of10,pubtest245of100,1,322,5194,22,338,5554
subtest27of10,pubtest245of100,1,322,5194,23,377,5594
subtest26of10,pubtest246of100,1,323,5225,0,43,5268
subtest27of10,pubtest246of100,1,323,5225,1,80,5306
subtest21of10,pubtest246of100,1,323,5225,10,112,5347
subtest29of10,pubtest246of100,1,323,5225,11,153,5389
subtest28of10,pubtest246of100,1,323,5225,20,183,5428
subtest23of10,pubtest246of100,1,323,5225,24,218,5467
subtest25of10,pubtest246of100,1,323,5225,24,256,5505
subtest22of10,pubtest246of100,1,323,5225,26,296,5547
subtest24of10,pubtest246of100,1,323,5225,25,335,5585
subtest210of10,pubtest246of100,1,323,5225,25,375,5625
subtest27of10,pubtest247of100,1,323,5179,4,40,5223
subtest23of10,pubtest247of100,1,323,5179,7,77,5263
subtest26of10,pubtest247of100,1,323,5179,15,108,5302
subtest21of10,pubtest247of100,1,323,5179,15,148,5342
subtest22of10,pubtest247of100,1,323,5179,19,184,5382
subtest29of10,pubtest247of100,1,323,5179,21,222,5422
subtest28of10,pubtest247of100,1,323,5179,21,264,5464
subtest25of10,pubtest247of100,1,323,5179,23,302,5504
subtest210of10,pubtest247of100,1,323,5179,22,340,5541
subtest24of10,pubtest247of100,1,323,5179,24,379,5582
subtest29of10,pubtest248of100,1,323,5237,-1,40,5276
subtest26of10,pubtest248of100,1,323,5237,1,77,5315
subtest25of10,pubtest248of100,1,323,5237,6,112,5355
subtest28of10,pubtest248of100,1,323,5237,7,151,5395
subtest23of10,pubtest248of100,1,323,5237,18,180,5435
subtest27of10,pubtest248of100,1,323,5237,19,220,5476
subtest24of10,pubtest248of100,1,323,5237,27,251,5515
subtest22of10,pubtest248of100,1,323,5237,27,292,5556
subtest210of10,pubtest248of100,1,323,5237,29,329,5595
subtest21of10,pubtest248of100,1,323,5237,27,369,5633
subtest25of10,pubtest249of100,1,323,5370,26,42,5438
subtest27of10,pubtest249of100,1,323,5370,26,80,5476
subtest28of10,pubtest249of100,1,323,5370,28,120,5518
subtest24of10,pubtest249of100,1,323,5370,27,161,5558
subtest26of10,pubtest249of100,1,323,5370,34,194,5598
subtest21of10,pubtest249of100,1,323,5370,36,233,5639
subtest29of10,pubtest249of100,1,323,5370,36,272,5678
subtest22of10,pubtest249of100,1,323,5370,35,311,5716
subtest210of10,pubtest249of100,1,323,5370,37,350,5757
subtest23of10,pubtest249of100,1,323,5370,37,390,5797
subtest27of10,pubtest250of100,1,323,5289,642,41,5972
subtest23of10,pubtest250of100,1,323,5289,642,80,6011
subtest21of10,pubtest250of100,1,323,5289,646,117,6052
subtest28of10,pubtest250of100,1,323,5289,645,157,6091
subtest29of10,pubtest250of100,1,323,5289,647,196,6132
subtest25of10,pubtest250of100,1,323,5289,838,43,6170
subtest210of10,pubtest250of100,1,323,5289,839,83,6211
subtest24of10,pubtest250of100,1,323,5289,838,122,6249
subtest26of10,pubtest250of100,1,323,5289,841,161,6291
subtest22of10,pubtest250of100,1,323,5289,842,201,6332
subtest23of10,pubtest251of100,1,323,5237,313,38,5588
subtest22of10,pubtest251of100,1,323,5237,385,37,5659
subtest24of10,pubtest251of100,1,323,5237,440,41,5718
subtest27of10,pubtest251of100,1,323,5237,440,82,5759
subtest25of10,pubtest251of100,1,323,5237,510,53,5800
subtest28of10,pubtest251of100,1,323,5237,511,91,5839
subtest21of10,pubtest251of100,1,323,5237,527,115,5879
subtest29of10,pubtest251of100,1,323,5237,529,153,5919
subtest210of10,pubtest251of100,1,323,5237,528,193,5958
subtest26of10,pubtest251of100,1,323,5237,530,232,5999
subtest29of10,pubtest252of100,1,323,5337,10,155,5502
subtest28of10,pubtest252of100,1,323,5337,10,192,5539
subtest26of10,pubtest252of100,1,323,5337,12,230,5579
subtest21of10,pubtest252of100,1,323,5337,17,266,5620
subtest27of10,pubtest252of100,1,323,5337,20,302,5659
subtest22of10,pubtest252of100,1,323,5337,24,338,5699
subtest25of10,pubtest252of100,1,323,5337,25,376,5738
subtest23of10,pubtest252of100,1,323,5337,26,416,5779
subtest24of10,pubtest252of100,1,323,5337,28,454,5819
subtest210of10,pubtest252of100,1,323,5337,28,493,5858
subtest28of10,pubtest253of100,1,322,5208,1,38,5247
subtest23of10,pubtest253of100,1,322,5208,3,75,5286
subtest24of10,pubtest253of100,1,322,5208,4,114,5326
subtest22of10,pubtest253of100,1,322,5208,10,148,5366
subtest25of10,pubtest253of100,1,322,5208,10,188,5406
subtest29of10,pubtest253of100,1,322,5208,12,226,5446
subtest210of10,pubtest253of100,1,322,5208,12,263,5483
subtest21of10,pubtest253of100,1,322,5208,15,303,5526
subtest27of10,pubtest253of100,1,322,5208,12,342,5562
subtest26of10,pubtest253of100,1,322,5208,17,381,5606
subtest210of10,pubtest254of100,1,323,5265,-1,41,5305
subtest27of10,pubtest254of100,1,323,5265,0,80,5345
subtest28of10,pubtest254of100,1,323,5265,2,117,5384
subtest21of10,pubtest254of100,1,323,5265,6,153,5424
subtest25of10,pubtest254of100,1,323,5265,12,187,5464
subtest23of10,pubtest254of100,1,323,5265,16,223,5504
subtest29of10,pubtest254of100,1,323,5265,16,263,5544
subtest24of10,pubtest254of100,1,323,5265,17,300,5582
subtest26of10,pubtest254of100,1,323,5265,21,338,5624
subtest22of10,pubtest254of100,1,323,5265,21,378,5664
subtest22of10,pubtest255of100,1,322,5339,97,40,5476
subtest23of10,pubtest255of100,1,322,5339,99,77,5515
subtest28of10,pubtest255of100,1,322,5339,100,116,5555
subtest27of10,pubtest255of100,1,322,5339,101,154,5594
subtest24of10,pubtest255of100,1,322,5339,102,194,5635
subtest210of10,pubtest255of100,1,322,5339,105,230,5674
subtest29of10,pubtest255of100,1,322,5339,106,270,5715
subtest26of10,pubtest255of100,1,322,5339,107,309,5755
subtest21of10,pubtest255of100,1,322,5339,110,346,5795
subtest25of10,pubtest255of100,1,322,5339,113,383,5835
subtest29of10,pubtest256of100,1,323,5273,7,38,5318
subtest21of10,pubtest256of100,1,323,5273,11,73,5357
subtest26of10,pubtest256of100,1,323,5273,13,111,5397
subtest210of10,pubtest256of100,1,323,5273,13,152,5438
subtest23of10,pubtest256of100,1,323,5273,12,190,5475
subtest27of10,pubtest256of100,1,323,5273,23,221,5517
subtest25of10,pubtest256of100,1,323,5273,23,261,5557
subtest28of10,pubtest256of100,1,323,5273,24,300,5597
subtest22of10,pubtest256of100,1,323,5273,26,338,5637
subtest24of10,pubtest256of100,1,323,5273,26,378,5677
subtest21of10,pubtest257of100,1,323,5298,5,48,5351
subtest24of10,pubtest257of100,1,323,5298,5,87,5390
subtest27of10,pubtest257of100,1,323,5298,7,125,5430
subtest23of10,pubtest257of100,1,323,5298,9,163,5470
subtest29of10,pubtest257of100,1,323,5298,10,202,5510
subtest28of10,pubtest257of100,1,323,5298,11,242,5551
subtest210of10,pubtest257of100,1,323,5298,11,281,5590
subtest22of10,pubtest257of100,1,323,5298,12,320,5630
subtest26of10,pubtest257of100,1,323,5298,13,359,5670
subtest25of10,pubtest257of100,1,323,5298,13,399,5710
subtest28of10,pubtest258of100,1,323,5208,-1,45,5252
subtest23of10,pubtest258of100,1,323,5208,1,82,5291
subtest25of10,pubtest258of100,1,323,5208,2,121,5331
subtest26of10,pubtest258of100,1,323,5208,3,160,5371
subtest21of10,pubtest258of100,1,323,5208,14,189,5411
subtest210of10,pubtest258of100,1,323,5208,14,229,5451
subtest29of10,pubtest258of100,1,323,5208,16,267,5491
subtest27of10,pubtest258of100,1,323,5208,16,307,5531
subtest22of10,pubtest258of100,1,323,5208,26,339,5573
subtest24of10,pubtest258of100,1,323,5208,27,376,5611
subtest21of10,pubtest259of100,1,323,5330,-2,40,5368
subtest28of10,pubtest259of100,1,323,5330,-2,79,5407
subtest25of10,pubtest259of100,1,323,5330,1,116,5447
subtest24of10,pubtest259of100,1,323,5330,6,151,5487
subtest27of10,pubtest259of100,1,323,5330,9,188,5527
subtest26of10,pubtest259of100,1,323,5330,10,227,5567
subtest23of10,pubtest259of100,1,323,5330,13,264,5607
subtest22of10,pubtest259of100,1,323,5330,14,303,5647
subtest29of10,pubtest259of100,1,323,5330,14,343,5687
subtest210of10,pubtest259of100,1,323,5330,16,381,5727
subtest210of10,pubtest260of100,1,323,5289,8,38,5335
subtest23of10,pubtest260of100,1,323,5289,12,74,5375
subtest21of10,pubtest260of100,1,323,5289,12,113,5414
subtest26of10,pubtest260of100,1,323,5289,14,152,5455
subtest27of10,pubtest260of100,1,323,5289,14,191,5494
subtest22of10,pubtest260of100,1,323,5289,16,229,5534
subtest29of10,pubtest260of100,1,323,5289,16,269,5574
subtest25of10,pubtest260of100,1,323,5289,16,307,5612
subtest28of10,pubtest260of100,1,323,5289,18,347,5654
subtest24of10,pubtest260of100,1,323,5289,17,387,5693
subtest210of10,pubtest261of100,1,323,5446,5,39,5490
subtest28of10,pubtest261of100,1,323,5446,3,78,5527
subtest29of10,pubtest261of100,1,323,5446,5,117,5568
subtest25of10,pubtest261of100,1,323,5446,3,157,5606
subtest22of10,pubtest261of100,1,323,5446,11,192,5649
subtest23of10,pubtest261of100,1,323,5446,11,232,5689
subtest24of10,pubtest261of100,1,323,5446,12,271,5729
subtest27of10,pubtest261of100,1,323,5446,14,310,5770
subtest21of10,pubtest261of100,1,323,5446,17,347,5810
subtest26of10,pubtest261of100,1,323,5446,18,385,5849
subtest22of10,pubtest262of100,1,323,5229,0,45,5274
subtest21of10,pubtest262of100,1,323,5229,0,84,5313
subtest23of10,pubtest262of100,1,323,5229,2,120,5351
subtest29of10,pubtest262of100,1,323,5229,5,159,5393
subtest27of10,pubtest262of100,1,323,5229,7,198,5434
subtest26of10,pubtest262of100,1,323,5229,16,228,5473
subtest210of10,pubtest262of100,1,323,5229,17,267,5513
subtest25of10,pubtest262of100,1,323,5229,17,307,5553
subtest24of10,pubtest262of100,1,323,5229,39,325,5593
subtest28of10,pubtest262of100,1,323,5229,41,363,5633
subtest22of10,pubtest263of100,1,322,5370,0,41,5411
subtest24of10,pubtest263of100,1,322,5370,16,65,5451
subtest26of10,pubtest263of100,1,322,5370,23,97,5490
subtest23of10,pubtest263of100,1,322,5370,24,134,5528
subtest210of10,pubtest263of100,1,322,5370,26,175,5571
subtest29of10,pubtest263of100,1,322,5370,24,213,5607
subtest28of10,pubtest263of100,1,322,5370,29,251,5650
subtest25of10,pubtest263of100,1,322,5370,28,291,5689
subtest27of10,pubtest263of100,1,322,5370,28,330,5728
subtest21of10,pubtest263of100,1,322,5370,30,370,5770
subtest22of10,pubtest264of100,1,322,5426,-3,41,5464
subtest29of10,pubtest264of100,1,322,5426,1,76,5503
subtest24of10,pubtest264of100,1,322,5426,3,114,5543
subtest23of10,pubtest264of100,1,322,5426,4,153,5583
subtest27of10,pubtest264of100,1,322,5426,6,191,5623
subtest25of10,pubtest264of100,1,322,5426,7,228,5661
subtest28of10,pubtest264of100,1,322,5426,9,267,5702
subtest26of10,pubtest264of100,1,322,5426,10,306,5742
subtest21of10,pubtest264of100,1,322,5426,12,345,5783
subtest210of10,pubtest264of100,1,322,5426,12,385,5823
subtest26of10,pubtest265of100,1,323,5215,4,44,5263
subtest27of10,pubtest265of100,1,323,5215,8,80,5303
subtest210of10,pubtest265of100,1,323,5215,8,120,5343
subtest22of10,pubtest265of100,1,323,5215,10,158,5383
subtest21of10,pubtest265of100,1,323,5215,15,193,5423
subtest25of10,pubtest265of100,1,323,5215,16,232,5463
subtest29of10,pubtest265of100,1,323,5215,17,271,5503
subtest28of10,pubtest265of100,1,323,5215,17,308,5540
subtest24of10,pubtest265of100,1,323,5215,20,348,5583
subtest23of10,pubtest265of100,1,323,5215,20,387,5622
subtest210of10,pubtest266of100,1,321,5255,4,236,5495
subtest29of10,pubtest266of100,1,321,5255,4,274,5533
subtest25of10,pubtest266of100,1,321,5255,6,312,5573
subtest26of10,pubtest266of100,1,321,5255,7,351,5613
subtest23of10,pubtest266of100,1,321,5255,9,390,5654
subtest27of10,pubtest266of100,1,321,5255,8,429,5692
subtest28of10,pubtest266of100,1,321,5255,10,468,5733
subtest21of10,pubtest266of100,1,321,5255,10,507,5772
subtest24of10,pubtest266of100,1,321,5255,14,544,5813
subtest22of10,pubtest266of100,1,321,5255,14,584,5853
subtest23of10,pubtest267of100,1,323,5239,-3,454,5690
subtest26of10,pubtest267of100,1,323,5239,2,488,5729
subtest28of10,pubtest267of100,1,323,5239,10,520,5769
subtest25of10,pubtest267of100,1,323,5239,10,559,5808
subtest27of10,pubtest267of100,1,323,5239,13,597,5849
subtest24of10,pubtest267of100,1,323,5239,16,634,5889
subtest29of10,pubtest267of100,1,323,5239,16,673,5928
subtest21of10,pubtest267of100,1,323,5239,18,713,5970
subtest22of10,pubtest267of100,1,323,5239,21,749,6009
subtest210of10,pubtest267of100,1,323,5239,23,787,6049
subtest23of10,pubtest268of100,1,323,5711,5,39,5755
subtest25of10,pubtest268of100,1,323,5711,8,75,5794
subtest24of10,pubtest268of100,1,323,5711,9,114,5834
subtest28of10,pubtest268of100,1,323,5711,10,153,5874
subtest27of10,pubtest268of100,1,323,5711,11,192,5914
subtest29of10,pubtest268of100,1,323,5711,12,231,5954
subtest21of10,pubtest268of100,1,323,5711,12,271,5994
subtest22of10,pubtest268of100,1,323,5711,13,310,6034
subtest26of10,pubtest268of100,1,323,5711,14,349,6074
subtest210of10,pubtest268of100,1,323,5711,15,386,6112
subtest24of10,pubtest269of100,1,323,5220,-3,38,5255
subtest27of10,pubtest269of100,1,323,5220,1,73,5294
subtest210of10,pubtest269of100,1,323,5220,3,111,5334
subtest26of10,pubtest269of100,1,323,5220,12,142,5374
subtest25of10,pubtest269of100,1,323,5220,14,180,5414
subtest22of10,pubtest269of100,1,323,5220,15,219,5454
subtest21of10,pubtest269of100,1,323,5220,17,257,5494
subtest28of10,pubtest269of100,1,323,5220,17,297,5534
subtest29of10,pubtest269of100,1,323,5220,18,336,5574
subtest23of10,pubtest269of100,1,323,5220,19,375,5614
subtest23of10,pubtest270of100,1,323,5249,1,40,5290
subtest27of10,pubtest270of100,1,323,5249,4,77,5330
subtest26of10,pubtest270of100,1,323,5249,5,115,5369
subtest210of10,pubtest270of100,1,323,5249,8,152,5409
subtest29of10,pubtest270of100,1,323,5249,9,191,5449
subtest25of10,pubtest270of100,1,323,5249,10,232,5491
subtest28of10,pubtest270of100,1,323,5249,13,268,5530
subtest21of10,pubtest270of100,1,323,5249,14,306,5569
subtest22of10,pubtest270of100,1,323,5249,14,346,5609
subtest24of10,pubtest270of100,1,323,5249,15,385,5649
subtest24of10,pubtest271of100,1,323,5315,1,39,5355
subtest22of10,pubtest271of100,1,323,5315,2,77,5394
subtest25of10,pubtest271of100,1,323,5315,3,116,5434
subtest27of10,pubtest271of100,1,323,5315,5,154,5474
subtest210of10,pubtest271of100,1,323,5315,12,187,5514
subtest26of10,pubtest271of100,1,323,5315,12,228,5555
subtest28of10,pubtest271of100,1,323,5315,14,265,5594
subtest21of10,pubtest271of100,1,323,5315,14,305,5634
subtest29of10,pubtest271of100,1,323,5315,18,341,5674
subtest23of10,pubtest271of100,1,323,5315,18,381,5714
subtest25of10,pubtest272of100,1,323,5280,0,40,5320
subtest26of10,pubtest272of100,1,323,5280,3,76,5359
subtest29of10,pubtest272of100,1,323,5280,5,114,5399
subtest21of10,pubtest272of100,1,323,5280,4,154,5438
subtest23of10,pubtest272of100,1,323,5280,5,193,5478
subtest27of10,pubtest272of100,1,323,5280,7,232,5519
subtest210of10,pubtest272of100,1,323,5280,13,266,5559
subtest24of10,pubtest272of100,1,323,5280,13,306,5599
subtest22of10,pubtest272of100,1,323,5280,15,343,5638
subtest28of10,pubtest272of100,1,323,5280,21,379,5680
subtest22of10,pubtest273of100,1,321,5250,-3,43,5290
subtest29of10,pubtest273of100,1,321,5250,-2,82,5330
subtest26of10,pubtest273of100,1,321,5250,0,121,5371
subtest28of10,pubtest273of100,1,321,5250,1,160,5411
subtest210of10,pubtest273of100,1,321,5250,7,193,5450
subtest25of10,pubtest273of100,1,321,5250,10,229,5489
subtest27of10,pubtest273of100,1,321,5250,11,269,5530
subtest23of10,pubtest273of100,1,321,5250,12,308,5570
subtest21of10,pubtest273of100,1,321,5250,15,345,5610
subtest24of10,pubtest273of100,1,321,5250,16,384,5650
subtest21of10,pubtest274of100,1,323,5388,-4,43,5427
subtest23of10,pubtest274of100,1,323,5388,1,78,5467
subtest26of10,pubtest274of100,1,323,5388,-4,120,5504
subtest29of10,pubtest274of100,1,323,5388,2,157,5547
subtest22of10,pubtest274of100,1,323,5388,2,196,5586
subtest25of10,pubtest274of100,1,323,5388,3,236,5627
subtest27of10,pubtest274of100,1,323,5388,8,271,5667
subtest28of10,pubtest274of100,1,323,5388,9,310,5707
subtest24of10,pubtest274of100,1,323,5388,10,349,5747
subtest210of10,pubtest274of100,1,323,5388,12,387,5787
subtest27of10,pubtest275of100,1,323,5197,6,85,5288
subtest29of10,pubtest275of100,1,323,5197,11,118,5326
subtest24of10,pubtest275of100,1,323,5197,11,157,5365
subtest25of10,pubtest275of100,1,323,5197,14,196,5407
subtest22of10,pubtest275of100,1,323,5197,13,235,5445
subtest21of10,pubtest275of100,1,323,5197,15,275,5487
subtest210of10,pubtest275of100,1,323,5197,17,313,5527
subtest23of10,pubtest275of100,1,323,5197,17,353,5567
subtest28of10,pubtest275of100,1,323,5197,21,388,5606
subtest26of10,pubtest275of100,1,323,5197,21,428,5646
subtest28of10,pubtest276of100,1,323,5243,0,41,5284
subtest21of10,pubtest276of100,1,323,5243,1,80,5324
subtest25of10,pubtest276of100,1,323,5243,3,117,5363
subtest24of10,pubtest276of100,1,323,5243,7,153,5403
subtest27of10,pubtest276of100,1,323,5243,10,190,5443
subtest26of10,pubtest276of100,1,323,5243,11,229,5483
subtest29of10,pubtest276of100,1,323,5243,13,267,5523
subtest23of10,pubtest276of100,1,323,5243,17,303,5563
subtest210of10,pubtest276of100,1,323,5243,24,336,5603
subtest22of10,pubtest276of100,1,323,5243,27,373,5643
subtest22of10,pubtest277of100,1,323,5328,-1,40,5367
subtest28of10,pubtest277of100,1,323,5328,0,78,5406
subtest29of10,pubtest277of100,1,323,5328,2,116,5446
subtest24of10,pubtest277of100,1,323,5328,9,149,5486
subtest27of10,pubtest277of100,1,323,5328,10,186,5524
subtest23of10,pubtest277of100,1,323,5328,12,226,5566
subtest210of10,pubtest277of100,1,323,5328,10,265,5603
subtest26of10,pubtest277of100,1,323,5328,13,305,5646
subtest21of10,pubtest277of100,1,323,5328,13,344,5685
subtest25of10,pubtest277of100,1,323,5328,13,384,5725
subtest29of10,pubtest278of100,1,323,5260,-2,46,5304
subtest22of10,pubtest278of100,1,323,5260,-2,85,5343
subtest23of10,pubtest278of100,1,323,5260,1,122,5383
subtest28of10,pubtest278of100,1,323,5260,3,160,5423
subtest21of10,pubtest278of100,1,323,5260,3,200,5463
subtest27of10,pubtest278of100,1,323,5260,5,238,5503
subtest25of10,pubtest278of100,1,323,5260,18,265,5543
subtest26of10,pubtest278of100,1,323,5260,26,297,5583
subtest24of10,pubtest278of100,1,323,5260,27,338,5625
subtest210of10,pubtest278of100,1,323,5260,28,375,5663
subtest28of10,pubtest279of100,1,323,5308,-4,42,5346
subtest25of10,pubtest279of100,1,323,5308,0,76,5384
subtest21of10,pubtest279of100,1,323,5308,0,115,5423
subtest29of10,pubtest279of100,1,323,5308,1,155,5464
subtest24of10,pubtest279of100,1,323,5308,1,194,5503
subtest27of10,pubtest279of100,1,323,5308,2,234,5544
subtest26of10,pubtest279of100,1,323,5308,7,269,5584
subtest22of10,pubtest279of100,1,323,5308,20,297,5625
subtest23of10,pubtest279of100,1,323,5308,18,337,5663
subtest210of10,pubtest279of100,1,323,5308,25,371,5704
subtest27of10,pubtest280of100,1,323,5247,-6,40,5281
subtest24of10,pubtest280of100,1,323,5247,-5,78,5320
subtest29of10,pubtest280of100,1,323,5247,-4,117,5360
subtest21of10,pubtest280of100,1,323,5247,2,151,5400
subtest26of10,pubtest280of100,1,323,5247,2,190,5439
subtest25of10,pubtest280of100,1,323,5247,4,229,5480
subtest23of10,pubtest280of100,1,323,5247,3,268,5518
subtest210of10,pubtest280of100,1,323,5247,7,306,5560
subtest28of10,pubtest280of100,1,323,5247,7,346,5600
subtest22of10,pubtest280of100,1,323,5247,10,383,5640
subtest24of10,pubtest281of100,1,323,5222,-2,39,5259
subtest23of10,pubtest281of100,1,323,5222,4,72,5298
subtest28of10,pubtest281of100,1,323,5222,5,111,5338
subtest27of10,pubtest281of100,1,323,5222,7,149,5378
subtest22of10,pubtest281of100,1,323,5222,9,187,5418
subtest210of10,pubtest281of100,1,323,5222,9,228,5459
subtest21of10,pubtest281of100,1,323,5222,11,265,5498
subtest26of10,pubtest281of100,1,323,5222,11,303,5536
subtest29of10,pubtest281of100,1,323,5222,11,343,5576
subtest25of10,pubtest281of100,1,323,5222,11,380,5613
subtest23of10,pubtest282of100,1,323,5264,4,46,5314
subtest24of10,pubtest282of100,1,323,5264,5,84,5353
subtest21of10,pubtest282of100,1,323,5264,7,122,5393
subtest27of10,pubtest282of100,1,323,5264,10,160,5434
subtest26of10,pubtest282of100,1,323,5264,12,197,5473
subtest210of10,pubtest282of100,1,323,5264,12,236,5512
subtest28of10,pubtest282of100,1,323,5264,13,276,5553
subtest22of10,pubtest282of100,1,323,5264,13,315,5592
subtest29of10,pubtest282of100,1,323,5264,10,359,5633
subtest25of10,pubtest282of100,1,323,5264,10,394,5668
subtest27of10,pubtest283of100,1,323,5677,1,39,5717
subtest24of10,pubtest283of100,1,323,5677,3,76,5756
subtest23of10,pubtest283of100,1,323,5677,3,116,5796
subtest22of10,pubtest283of100,1,323,5677,9,150,5836
subtest25of10,pubtest283of100,1,323,5677,11,189,5877
subtest28of10,pubtest283of100,1,323,5677,19,221,5917
subtest21of10,pubtest283of100,1,323,5677,21,258,5956
subtest29of10,pubtest283of100,1,323,5677,24,295,5996
subtest210of10,pubtest283of100,1,323,5677,26,333,6036
subtest26of10,pubtest283of100,1,323,5677,26,373,6076
subtest25of10,pubtest284of100,1,323,5278,7,38,5323
subtest22of10,pubtest284of100,1,323,5278,7,77,5362
subtest29of10,pubtest284of100,1,323,5278,9,115,5402
subtest27of10,pubtest284of100,1,323,5278,10,154,5442
subtest24of10,pubtest284of100,1,323,5278,11,193,5482
subtest23of10,pubtest284of100,1,323,5278,11,233,5522
subtest28of10,pubtest284of100,1,323,5278,12,272,5562
subtest21of10,pubtest284of100,1,323,5278,13,312,5603
subtest210of10,pubtest284of100,1,323,5278,9,350,5637
subtest26of10,pubtest284of100,1,323,5278,13,389,5680
subtest23of10,pubtest285of100,1,323,5271,-2,40,5309
subtest25of10,pubtest285of100,1,323,5271,0,79,5350
subtest27of10,pubtest285of100,1,323,5271,2,117,5390
subtest24of10,pubtest285of100,1,323,5271,1,157,5429
subtest22of10,pubtest285of100,1,323,5271,12,185,5468
subtest21of10,pubtest285of100,1,323,5271,13,225,5509
subtest28of10,pubtest285of100,1,323,5271,14,264,5549
subtest210of10,pubtest285of100,1,323,5271,22,298,5591
subtest26of10,pubtest285of100,1,323,5271,22,337,5630
subtest29of10,pubtest285of100,1,323,5271,22,375,5668
subtest23of10,pubtest286of100,1,323,5332,-2,39,5369
subtest210of10,pubtest286of100,1,323,5332,7,69,5408
subtest25of10,pubtest286of100,1,323,5332,8,108,5448
subtest29of10,pubtest286of100,1,323,5332,12,144,5488
subtest24of10,pubtest286of100,1,323,5332,15,181,5528
subtest21of10,pubtest286of100,1,323,5332,17,219,5568
subtest27of10,pubtest286of100,1,323,5332,19,257,5608
subtest26of10,pubtest286of100,1,323,5332,19,297,5648
subtest22of10,pubtest286of100,1,323,5332,22,334,5688
subtest28of10,pubtest286of100,1,323,5332,22,376,5730
subtest26of10,pubtest287of100,1,323,5291,2,40,5333
subtest29of10,pubtest287of100,1,323,5291,3,78,5372
subtest28of10,pubtest287of100,1,323,5291,5,116,5412
subtest27of10,pubtest287of100,1,323,5291,4,156,5451
subtest25of10,pubtest287of100,1,323,5291,6,195,5492
subtest210of10,pubtest287of100,1,323,5291,6,235,5532
subtest24of10,pubtest287of100,1,323,5291,8,273,5572
subtest21of10,pubtest287of100,1,323,5291,8,313,5612
subtest23of10,pubtest287of100,1,323,5291,9,352,5652
subtest22of10,pubtest287of100,1,323,5291,10,391,5692
subtest25of10,pubtest288of100,1,323,5470,4,42,5516
subtest26of10,pubtest288of100,1,323,5470,3,82,5555
subtest29of10,pubtest288of100,1,323,5470,3,120,5593
subtest27of10,pubtest288of100,1,323,5470,10,155,5635
subtest22of10,pubtest288of100,1,323,5470,13,192,5675
subtest21of10,pubtest288of100,1,323,5470,20,225,5715
subtest23of10,pubtest288of100,1,323,5470,21,264,5755
subtest210of10,pubtest288of100,1,323,5470,24,301,5795
subtest24of10,pubtest288of100,1,323,5470,26,339,5835
subtest28of10,pubtest288of100,1,323,5470,26,379,5875
subtest29of10,pubtest289of100,1,323,5344,0,44,5388
subtest210of10,pubtest289of100,1,323,5344,1,80,5425
subtest23of10,pubtest289of100,1,323,5344,4,118,5466
subtest26of10,pubtest289of100,1,323,5344,7,155,5506
subtest24of10,pubtest289of100,1,323,5344,7,195,5546
subtest25of10,pubtest289of100,1,323,5344,10,232,5586
subtest28of10,pubtest289of100,1,323,5344,13,269,5626
subtest21of10,pubtest289of100,1,323,5344,16,306,5666
subtest22of10,pubtest289of100,1,323,5344,17,346,5707
subtest27of10,pubtest289of100,1,323,5344,16,385,5745
subtest22of10,pubtest290of100,1,323,5306,-1,89,5394
subtest29of10,pubtest290of100,1,323,5306,-4,131,5433
subtest23of10,pubtest290of100,1,323,5306,3,79,5388
subtest25of10,pubtest290of100,1,323,5306,88,118,5512
subtest28of10,pubtest290of100,1,323,5306,90,156,5552
subtest27of10,pubtest290of100,1,323,5306,90,196,5592
subtest24of10,pubtest290of100,1,323,5306,91,235,5632
subtest21of10,pubtest290of100,1,323,5306,90,275,5671
subtest210of10,pubtest290of100,1,323,5306,92,314,5712
subtest26of10,pubtest290of100,1,323,5306,94,352,5752
subtest23of10,pubtest291of100,1,323,5585,-1,39,5623
subtest24of10,pubtest291of100,1,323,5585,9,68,5662
subtest27of10,pubtest291of100,1,323,5585,12,105,5702
subtest210of10,pubtest291of100,1,323,5585,17,140,5742
subtest28of10,pubtest291of100,1,323,5585,17,180,5782
subtest25of10,pubtest291of100,1,323,5585,19,219,5823
subtest21of10,pubtest291of100,1,323,5585,19,257,5861
subtest26of10,pubtest291of100,1,323,5585,20,297,5902
subtest22of10,pubtest291of100,1,323,5585,19,336,5940
subtest29of10,pubtest291of100,1,323,5585,21,375,5981
subtest29of10,pubtest292of100,1,323,5410,7,43,5460
subtest28of10,pubtest292of100,1,323,5410,7,83,5500
subtest25of10,pubtest292of100,1,323,5410,9,120,5539
subtest23of10,pubtest292of100,1,323,5410,12,155,5577
subtest27of10,pubtest292of100,1,323,5410,10,195,5615
subtest22of10,pubtest292of100,1,323,5410,14,234,5658
subtest24of10,pubtest292of100,1,323,5410,16,274,5700
subtest26of10,pubtest292of100,1,323,5410,10,313,5733
subtest21of10,pubtest292of100,1,323,5410,10,353,5773
subtest210of10,pubtest292of100,1,323,5410,20,389,5819
subtest24of10,pubtest293of100,1,323,5477,1,39,5517
subtest25of10,pubtest293of100,1,323,5477,4,75,5556
subtest28of10,pubtest293of100,1,323,5477,6,113,5596
subtest23of10,pubtest293of100,1,323,5477,7,151,5635
subtest27of10,pubtest293of100,1,323,5477,8,191,5676
subtest21of10,pubtest293of100,1,323,5477,11,228,5716
subtest29of10,pubtest293of100,1,323,5477,11,268,5756
subtest26of10,pubtest293of100,1,323,5477,13,306,5796
subtest210of10,pubtest293of100,1,323,5477,11,346,5834
subtest22of10,pubtest293of100,1,323,5477,15,385,5877
subtest21of10,pubtest294of100,1,323,5271,-5,40,5306
subtest210of10,pubtest294of100,1,323,5271,-4,77,5344
subtest25of10,pubtest294of100,1,323,5271,9,105,5385
subtest29of10,pubtest294of100,1,323,5271,9,145,5425
subtest26of10,pubtest294of100,1,323,5271,12,182,5465
subtest27of10,pubtest294of100,1,323,5271,16,218,5505
subtest24of10,pubtest294of100,1,323,5271,19,255,5545
subtest23of10,pubtest294of100,1,323,5271,20,294,5585
subtest22of10,pubtest294of100,1,323,5271,24,330,5625
subtest28of10,pubtest294of100,1,323,5271,24,370,5665
subtest25of10,pubtest295of100,1,323,5313,25,41,5379
subtest24of10,pubtest295of100,1,323,5313,83,39,5435
subtest23of10,pubtest295of100,1,323,5313,88,73,5474
subtest22of10,pubtest295of100,1,323,5313,95,106,5514
subtest27of10,pubtest295of100,1,323,5313,95,145,5553
subtest29of10,pubtest295of100,1,323,5313,109,172,5594
subtest210of10,pubtest295of100,1,323,5313,117,202,5632
subtest21of10,pubtest295of100,1,323,5313,119,243,5675
subtest28of10,pubtest295of100,1,323,5313,120,281,5714
subtest26of10,pubtest295of100,1,323,5313,131,310,5754
subtest24of10,pubtest296of100,1,322,5298,-3,43,5338
subtest25of10,pubtest296of100,1,322,5298,-3,83,5378
subtest27of10,pubtest296of100,1,322,5298,-1,120,5417
subtest26of10,pubtest296of100,1,322,5298,-1,160,5457
subtest23of10,pubtest296of100,1,322,5298,3,196,5497
subtest29of10,pubtest296of100,1,322,5298,5,234,5537
subtest21of10,pubtest296of100,1,322,5298,7,272,5577
subtest28of10,pubtest296of100,1,322,5298,13,304,5615
subtest22of10,pubtest296of100,1,322,5298,16,343,5657
subtest210of10,pubtest296of100,1,322,5298,13,383,5694
subtest25of10,pubtest297of100,1,323,5245,6,41,5292
subtest210of10,pubtest297of100,1,323,5245,6,80,5331
subtest29of10,pubtest297of100,1,323,5245,7,119,5371
subtest22of10,pubtest297of100,1,323,5245,11,156,5412
subtest23of10,pubtest297of100,1,323,5245,11,195,5451
subtest26of10,pubtest297of100,1,323,5245,13,233,5491
subtest27of10,pubtest297of100,1,323,5245,14,273,5532
subtest24of10,pubtest297of100,1,323,5245,15,311,5571
subtest21of10,pubtest297of100,1,323,5245,15,351,5611
subtest28of10,pubtest297of100,1,323,5245,16,388,5649
subtest29of10,pubtest298of100,1,323,5352,-3,39,5388
subtest22of10,pubtest298of100,1,323,5352,-2,78,5428
subtest24of10,pubtest298of100,1,323,5352,4,194,5550
subtest25of10,pubtest298of100,1,323,5352,2,114,5468
subtest23of10,pubtest298of100,1,323,5352,2,154,5508
subtest21of10,pubtest298of100,1,323,5352,9,227,5588
subtest210of10,pubtest298of100,1,323,5352,9,267,5628
subtest27of10,pubtest298of100,1,323,5352,11,305,5668
subtest28of10,pubtest298of100,1,323,5352,12,342,5706
subtest26of10,pubtest298of100,1,323,5352,12,382,5746
subtest22of10,pubtest299of100,1,323,5408,-3,40,5445
subtest29of10,pubtest299of100,1,323,5408,0,76,5484
subtest210of10,pubtest299of100,1,323,5408,0,115,5523
subtest27of10,pubtest299of100,1,323,5408,7,148,5563
subtest24of10,pubtest299of100,1,323,5408,7,188,5603
subtest28of10,pubtest299of100,1,323,5408,16,219,5643
subtest23of10,pubtest299of100,1,323,5408,18,257,5683
subtest25of10,pubtest299of100,1,323,5408,19,296,5723
subtest21of10,pubtest299of100,1,323,5408,21,334,5763
subtest26of10,pubtest299of100,1,323,5408,23,372,5803
subtest21of10,pubtest2100of100,1,325,5304,1,41,5346
subtest24of10,pubtest2100of100,1,325,5304,1,80,5385
subtest29of10,pubtest2100of100,1,325,5304,4,118,5426
subtest22of10,pubtest2100of100,1,325,5304,6,155,5465
subtest23of10,pubtest2100of100,1,325,5304,16,185,5505
subtest28of10,pubtest2100of100,1,325,5304,16,225,5545
subtest27of10,pubtest2100of100,1,325,5304,20,261,5585
subtest25of10,pubtest2100of100,1,325,5304,21,300,5625
subtest210of10,pubtest2100of100,1,325,5304,24,337,5665
subtest26of10,pubtest2100of100,1,325,5304,27,374,5705
subtest26of10,pubtest21of100,1,322,10534,12,39,10585
subtest27of10,pubtest21of100,1,322,10534,14,76,10624
subtest24of10,pubtest21of100,1,322,10534,14,116,10664
subtest210of10,pubtest21of100,1,322,10534,20,150,10704
subtest29of10,pubtest21of100,1,322,10534,21,190,10745
subtest28of10,pubtest21of100,1,322,10534,22,228,10784
subtest25of10,pubtest21of100,1,322,10534,26,264,10824
subtest21of10,pubtest21of100,1,322,10534,26,304,10864
subtest23of10,pubtest21of100,1,322,10534,28,342,10904
subtest22of10,pubtest21of100,1,322,10534,28,382,10944
subtest29of10,pubtest22of100,1,321,5247,-5,42,5284
subtest27of10,pubtest22of100,1,321,5247,1,75,5323
subtest24of10,pubtest22of100,1,321,5247,1,115,5363
subtest28of10,pubtest22of100,1,321,5247,3,153,5403
subtest23of10,pubtest22of100,1,321,5247,6,190,5443
subtest26of10,pubtest22of100,1,321,5247,7,230,5484
subtest25of10,pubtest22of100,1,321,5247,8,270,5525
subtest21of10,pubtest22of100,1,321,5247,10,307,5564
subtest210of10,pubtest22of100,1,321,5247,13,343,5603
subtest22of10,pubtest22of100,1,321,5247,13,383,5643
subtest23of10,pubtest23of100,1,321,5341,-1,41,5381
subtest28of10,pubtest23of100,1,321,5341,2,77,5420
subtest29of10,pubtest23of100,1,321,5341,2,117,5460
subtest27of10,pubtest23of100,1,321,5341,3,155,5499
subtest24of10,pubtest23of100,1,321,5341,4,195,5540
subtest26of10,pubtest23of100,1,321,5341,5,234,5580
subtest25of10,pubtest23of100,1,321,5341,6,274,5621
subtest22of10,pubtest23of100,1,321,5341,10,309,5660
subtest21of10,pubtest23of100,1,321,5341,10,351,5702
subtest210of10,pubtest23of100,1,321,5341,12,387,5740
subtest23of10,pubtest24of100,1,321,5277,0,43,5320
subtest24of10,pubtest24of100,1,321,5277,0,81,5358
subtest25of10,pubtest24of100,1,321,5277,2,119,5398
subtest28of10,pubtest24of100,1,321,5277,5,157,5439
subtest29of10,pubtest24of100,1,321,5277,7,194,5478
subtest21of10,pubtest24of100,1,321,5277,6,234,5517
subtest210of10,pubtest24of100,1,321,5277,8,273,5558
subtest27of10,pubtest24of100,1,321,5277,8,313,5598
subtest22of10,pubtest24of100,1,321,5277,10,351,5638
subtest26of10,pubtest24of100,1,321,5277,10,391,5678
subtest28of10,pubtest25of100,1,321,5286,-2,40,5324
subtest21of10,pubtest25of100,1,321,5286,4,72,5362
subtest27of10,pubtest25of100,1,321,5286,5,111,5402
subtest210of10,pubtest25of100,1,321,5286,8,148,5442
subtest23of10,pubtest25of100,1,321,5286,16,180,5482
subtest26of10,pubtest25of100,1,321,5286,15,219,5520
subtest22of10,pubtest25of100,1,321,5286,17,259,5562
subtest25of10,pubtest25of100,1,321,5286,15,300,5601
subtest29of10,pubtest25of100,1,321,5286,18,338,5642
subtest24of10,pubtest25of100,1,321,5286,19,377,5682
subtest21of10,pubtest26of100,1,321,5318,-3,42,5357
subtest22of10,pubtest26of100,1,321,5318,0,78,5396
subtest26of10,pubtest26of100,1,321,5318,2,116,5436
subtest29of10,pubtest26of100,1,321,5318,2,157,5477
subtest27of10,pubtest26of100,1,321,5318,3,195,5516
subtest25of10,pubtest26of100,1,321,5318,4,234,5556
subtest210of10,pubtest26of100,1,321,5318,5,273,5596
subtest24of10,pubtest26of100,1,321,5318,6,312,5636
subtest28of10,pubtest26of100,1,321,5318,6,351,5675
subtest23of10,pubtest26of100,1,321,5318,1,391,5710
subtest27of10,pubtest27of100,1,320,5315,-3,47,5359
subtest28of10,pubtest27of100,1,320,5315,-3,86,5398
subtest23of10,pubtest27of100,1,320,5315,1,122,5438
subtest24of10,pubtest27of100,1,320,5315,2,160,5477
subtest25of10,pubtest27of100,1,320,5315,6,197,5518
subtest29of10,pubtest27of100,1,320,5315,5,236,5556
subtest210of10,pubtest27of100,1,320,5315,6,277,5598
subtest21of10,pubtest27of100,1,320,5315,9,314,5638
subtest22of10,pubtest27of100,1,320,5315,10,353,5678
subtest26of10,pubtest27of100,1,320,5315,11,392,5718
subtest27of10,pubtest28of100,1,321,5354,-7,41,5388
subtest21of10,pubtest28of100,1,321,5354,9,63,5426
subtest28of10,pubtest28of100,1,321,5354,10,101,5465
subtest29of10,pubtest28of100,1,321,5354,12,139,5505
subtest23of10,pubtest28of100,1,321,5354,13,179,5546
subtest210of10,pubtest28of100,1,321,5354,15,217,5586
subtest25of10,pubtest28of100,1,321,5354,17,255,5626
subtest26of10,pubtest28of100,1,321,5354,19,293,5666
subtest24of10,pubtest28of100,1,321,5354,19,334,5707
subtest22of10,pubtest28of100,1,321,5354,21,371,5746
subtest23of10,pubtest29of100,1,321,5262,-1,47,5308
subtest29of10,pubtest29of100,1,321,5262,0,84,5346
subtest22of10,pubtest29of100,1,321,5262,3,122,5387
subtest210of10,pubtest29of100,1,321,5262,0,160,5422
subtest25of10,pubtest29of100,1,321,5262,8,197,5467
subtest28of10,pubtest29of100,1,321,5262,8,237,5507
subtest24of10,pubtest29of100,1,321,5262,10,275,5547
subtest21of10,pubtest29of100,1,321,5262,15,310,5587
subtest27of10,pubtest29of100,1,321,5262,15,350,5627
subtest26of10,pubtest29of100,1,321,5262,16,389,5667
subtest29of10,pubtest210of100,1,323,5396,-4,45,5437
subtest21of10,pubtest210of100,1,323,5396,-3,82,5475
subtest23of10,pubtest210of100,1,323,5396,9,110,5515
subtest27of10,pubtest210of100,1,323,5396,9,149,5554
subtest25of10,pubtest210of100,1,323,5396,12,186,5594
subtest210of10,pubtest210of100,1,323,5396,13,225,5634
subtest28of10,pubtest210of100,1,323,5396,14,264,5674
subtest24of10,pubtest210of100,1,323,5396,17,301,5714
subtest22of10,pubtest210of100,1,323,5396,17,341,5754
subtest26of10,pubtest210of100,1,323,5396,58,341,5795
subtest210of10,pubtest211of100,1,323,5665,-2,39,5702
subtest29of10,pubtest211of100,1,323,5665,0,76,5741
subtest24of10,pubtest211of100,1,323,5665,1,115,5781
subtest21of10,pubtest211of100,1,323,5665,12,144,5821
subtest22of10,pubtest211of100,1,323,5665,12,184,5861
subtest23of10,pubtest211of100,1,323,5665,18,216,5899
subtest26of10,pubtest211of100,1,323,5665,21,255,5941
subtest25of10,pubtest211of100,1,323,5665,18,295,5978
subtest27of10,pubtest211of100,1,323,5665,23,334,6022
subtest28of10,pubtest211of100,1,323,5665,22,374,6061
subtest25of10,pubtest212of100,1,323,5275,0,39,5314
subtest28of10,pubtest212of100,1,323,5275,2,77,5354
subtest29of10,pubtest212of100,1,323,5275,3,115,5393
subtest23of10,pubtest212of100,1,323,5275,3,155,5433
subtest24of10,pubtest212of100,1,323,5275,5,193,5473
subtest27of10,pubtest212of100,1,323,5275,5,233,5513
subtest21of10,pubtest212of100,1,323,5275,11,267,5553
subtest22of10,pubtest212of100,1,323,5275,14,304,5593
subtest26of10,pubtest212of100,1,323,5275,15,343,5633
subtest210of10,pubtest212of100,1,323,5275,27,371,5673
subtest23of10,pubtest213of100,1,322,5274,-1,43,5316
subtest26of10,pubtest213of100,1,322,5274,0,82,5356
subtest29of10,pubtest213of100,1,322,5274,1,120,5395
subtest22of10,pubtest213of100,1,322,5274,5,156,5435
subtest27of10,pubtest213of100,1,322,5274,5,196,5475
subtest21of10,pubtest213of100,1,322,5274,9,233,5516
subtest24of10,pubtest213of100,1,322,5274,11,270,5555
subtest210of10,pubtest213of100,1,322,5274,13,307,5594
subtest25of10,pubtest213of100,1,322,5274,24,337,5635
subtest28of10,pubtest213of100,1,322,5274,28,374,5676
subtest21of10,pubtest214of100,1,323,5288,-2,41,5327
subtest23of10,pubtest214of100,1,323,5288,4,74,5366
subtest25of10,pubtest214of100,1,323,5288,4,113,5405
subtest26of10,pubtest214of100,1,323,5288,7,150,5445
subtest27of10,pubtest214of100,1,323,5288,8,189,5485
subtest22of10,pubtest214of100,1,323,5288,13,224,5525
subtest29of10,pubtest214of100,1,323,5288,13,264,5565
subtest28of10,pubtest214of100,1,323,5288,17,300,5605
subtest210of10,pubtest214of100,1,323,5288,15,340,5643
subtest24of10,pubtest214of100,1,323,5288,17,378,5683
subtest27of10,pubtest215of100,1,323,5363,0,42,5405
subtest24of10,pubtest215of100,1,323,5363,1,81,5445
subtest29of10,pubtest215of100,1,323,5363,2,120,5485
subtest21of10,pubtest215of100,1,323,5363,3,159,5525
subtest26of10,pubtest215of100,1,323,5363,4,198,5565
subtest25of10,pubtest215of100,1,323,5363,5,237,5605
subtest210of10,pubtest215of100,1,323,5363,6,276,5645
subtest22of10,pubtest215of100,1,323,5363,8,312,5683
subtest23of10,pubtest215of100,1,323,5363,13,349,5725
subtest28of10,pubtest215of100,1,323,5363,13,389,5765
subtest24of10,pubtest216of100,1,323,5219,-4,42,5257
subtest21of10,pubtest216of100,1,323,5219,-4,83,5298
subtest23of10,pubtest216of100,1,323,5219,-1,119,5337
subtest27of10,pubtest216of100,1,323,5219,2,156,5377
subtest28of10,pubtest216of100,1,323,5219,2,196,5417
subtest25of10,pubtest216of100,1,323,5219,4,234,5457
subtest29of10,pubtest216of100,1,323,5219,5,273,5497
subtest22of10,pubtest216of100,1,323,5219,5,313,5537
subtest26of10,pubtest216of100,1,323,5219,6,350,5575
subtest210of10,pubtest216of100,1,323,5219,7,390,5616
subtest27of10,pubtest217of100,1,322,5331,0,40,5371
subtest21of10,pubtest217of100,1,322,5331,2,78,5411
subtest22of10,pubtest217of100,1,322,5331,10,109,5450
subtest23of10,pubtest217of100,1,322,5331,13,146,5490
subtest29of10,pubtest217of100,1,322,5331,15,184,5530
subtest26of10,pubtest217of100,1,322,5331,22,221,5574
subtest24of10,pubtest217of100,1,322,5331,25,258,5614
subtest25of10,pubtest217of100,1,322,5331,25,298,5654
subtest28of10,pubtest217of100,1,322,5331,26,337,5694
subtest210of10,pubtest217of100,1,322,5331,57,346,5734
subtest29of10,pubtest218of100,1,323,5431,-5,39,5465
subtest22of10,pubtest218of100,1,323,5431,2,71,5504
subtest21of10,pubtest218of100,1,323,5431,2,111,5544
subtest27of10,pubtest218of100,1,323,5431,3,150,5584
subtest28of10,pubtest218of100,1,323,5431,6,187,5624
subtest23of10,pubtest218of100,1,323,5431,6,227,5664
subtest25of10,pubtest218of100,1,323,5431,10,263,5704
subtest24of10,pubtest218of100,1,323,5431,15,298,5744
subtest26of10,pubtest218of100,1,323,5431,19,332,5782
subtest210of10,pubtest218of100,1,323,5431,19,372,5822
subtest25of10,pubtest219of100,1,323,5507,0,44,5551
subtest210of10,pubtest219of100,1,323,5507,0,83,5590
subtest26of10,pubtest219of100,1,323,5507,1,121,5629
subtest21of10,pubtest219of100,1,323,5507,34,129,5670
subtest22of10,pubtest219of100,1,323,5507,35,168,5710
subtest29of10,pubtest219of100,1,323,5507,39,203,5749
subtest24of10,pubtest219of100,1,323,5507,39,243,5789
subtest23of10,pubtest219of100,1,323,5507,41,281,5829
subtest28of10,pubtest219of100,1,323,5507,46,317,5870
subtest27of10,pubtest219of100,1,323,5507,50,352,5909
subtest25of10,pubtest220of100,1,323,5349,-1,40,5388
subtest210of10,pubtest220of100,1,323,5349,3,76,5428
subtest23of10,pubtest220of100,1,323,5349,5,114,5468
subtest24of10,pubtest220of100,1,323,5349,6,153,5508
subtest29of10,pubtest220of100,1,323,5349,8,191,5548
subtest21of10,pubtest220of100,1,323,5349,13,226,5588
subtest28of10,pubtest220of100,1,323,5349,13,265,5627
subtest26of10,pubtest220of100,1,323,5349,14,305,5668
subtest27of10,pubtest220of100,1,323,5349,15,339,5703
subtest22of10,pubtest220of100,1,323,5349,16,379,5744
subtest24of10,pubtest221of100,1,323,5351,0,43,5394
subtest28of10,pubtest221of100,1,323,5351,4,77,5432
subtest21of10,pubtest221of100,1,323,5351,12,108,5471
subtest23of10,pubtest221of100,1,323,5351,21,139,5511
subtest22of10,pubtest221of100,1,323,5351,30,170,5551
subtest210of10,pubtest221of100,1,323,5351,33,207,5591
subtest25of10,pubtest221of100,1,323,5351,37,244,5632
subtest26of10,pubtest221of100,1,323,5351,39,281,5671
subtest29of10,pubtest221of100,1,323,5351,38,321,5710
subtest27of10,pubtest221of100,1,323,5351,44,356,5751
subtest21of10,pubtest222of100,1,323,5377,1,40,5418
subtest22of10,pubtest222of100,1,323,5377,3,77,5457
subtest29of10,pubtest222of100,1,323,5377,3,117,5497
subtest27of10,pubtest222of100,1,323,5377,9,151,5537
subtest23of10,pubtest222of100,1,323,5377,14,186,5577
subtest28of10,pubtest222of100,1,323,5377,14,225,5616
subtest210of10,pubtest222of100,1,323,5377,15,264,5656
subtest26of10,pubtest222of100,1,323,5377,16,304,5697
subtest25of10,pubtest222of100,1,323,5377,17,343,5737
subtest24of10,pubtest222of100,1,323,5377,21,379,5777
subtest21of10,pubtest223of100,1,323,5277,0,39,5316
subtest23of10,pubtest223of100,1,323,5277,2,76,5355
subtest28of10,pubtest223of100,1,323,5277,2,114,5393
subtest27of10,pubtest223of100,1,323,5277,4,153,5434
subtest29of10,pubtest223of100,1,323,5277,4,192,5473
subtest24of10,pubtest223of100,1,323,5277,4,231,5512
subtest26of10,pubtest223of100,1,323,5277,7,270,5554
subtest210of10,pubtest223of100,1,323,5277,4,310,5591
subtest22of10,pubtest223of100,1,323,5277,5,349,5631
subtest25of10,pubtest223of100,1,323,5277,6,387,5670
subtest21of10,pubtest224of100,1,323,5332,1,41,5374
subtest28of10,pubtest224of100,1,323,5332,3,79,5414
subtest27of10,pubtest224of100,1,323,5332,4,117,5453
subtest23of10,pubtest224of100,1,323,5332,10,151,5493
subtest26of10,pubtest224of100,1,323,5332,11,190,5533
subtest25of10,pubtest224of100,1,323,5332,11,229,5572
subtest22of10,pubtest224of100,1,323,5332,13,269,5614
subtest29of10,pubtest224of100,1,323,5332,10,309,5651
subtest24of10,pubtest224of100,1,323,5332,17,344,5693
subtest210of10,pubtest224of100,1,323,5332,26,373,5731
subtest27of10,pubtest225of100,1,323,5250,0,43,5293
subtest22of10,pubtest225of100,1,323,5250,1,81,5332
subtest26of10,pubtest225of100,1,323,5250,3,120,5373
subtest21of10,pubtest225of100,1,323,5250,7,155,5412
subtest24of10,pubtest225of100,1,323,5250,9,193,5452
subtest25of10,pubtest225of100,1,323,5250,12,230,5492
subtest210of10,pubtest225of100,1,323,5250,14,268,5532
subtest29of10,pubtest225of100,1,323,5250,13,308,5571
subtest28of10,pubtest225of100,1,323,5250,13,347,5610
subtest23of10,pubtest225of100,1,323,5250,13,387,5650
subtest25of10,pubtest226of100,1,323,5268,-5,44,5307
subtest22of10,pubtest226of100,1,323,5268,-1,79,5346
subtest23of10,pubtest226of100,1,323,5268,4,114,5386
subtest210of10,pubtest226of100,1,323,5268,5,153,5426
subtest21of10,pubtest226of100,1,323,5268,6,192,5466
subtest27of10,pubtest226of100,1,323,5268,6,231,5505
subtest29of10,pubtest226of100,1,323,5268,13,265,5546
subtest28of10,pubtest226of100,1,323,5268,15,303,5586
subtest26of10,pubtest226of100,1,323,5268,15,343,5626
subtest24of10,pubtest226of100,1,323,5268,21,377,5666
subtest25of10,pubtest227of100,1,323,5317,0,47,5364
subtest29of10,pubtest227of100,1,323,5317,0,86,5403
subtest210of10,pubtest227of100,1,323,5317,2,123,5442
subtest24of10,pubtest227of100,1,323,5317,4,162,5483
subtest23of10,pubtest227of100,1,323,5317,5,201,5523
subtest26of10,pubtest227of100,1,323,5317,6,240,5563
subtest27of10,pubtest227of100,1,323,5317,6,281,5604
subtest21of10,pubtest227of100,1,323,5317,11,314,5642
subtest22of10,pubtest227of100,1,323,5317,11,353,5681
subtest28of10,pubtest227of100,1,323,5317,18,388,5723
subtest21of10,pubtest228of100,1,323,5307,-2,38,5343
subtest25of10,pubtest228of100,1,323,5307,4,71,5382
subtest23of10,pubtest228of100,1,323,5307,5,109,5421
subtest26of10,pubtest228of100,1,323,5307,6,149,5462
subtest27of10,pubtest228of100,1,323,5307,8,187,5502
subtest29of10,pubtest228of100,1,323,5307,18,217,5542
subtest24of10,pubtest228of100,1,323,5307,18,257,5582
subtest210of10,pubtest228of100,1,323,5307,26,290,5623
subtest28of10,pubtest228of100,1,323,5307,34,321,5662
subtest22of10,pubtest228of100,1,323,5307,33,361,5701
subtest24of10,pubtest229of100,1,321,5242,1,41,5284
subtest28of10,pubtest229of100,1,321,5242,2,80,5324
subtest21of10,pubtest229of100,1,321,5242,4,118,5364
subtest22of10,pubtest229of100,1,321,5242,5,157,5404
subtest27of10,pubtest229of100,1,321,5242,20,182,5444
subtest210of10,pubtest229of100,1,321,5242,20,222,5484
subtest23of10,pubtest229of100,1,321,5242,20,261,5523
subtest25of10,pubtest229of100,1,321,5242,22,298,5562
subtest26of10,pubtest229of100,1,321,5242,22,338,5602
subtest29of10,pubtest229of100,1,321,5242,32,371,5645
subtest22of10,pubtest230of100,1,323,5210,-2,39,5247
subtest21of10,pubtest230of100,1,323,5210,-1,77,5286
subtest27of10,pubtest230of100,1,323,5210,0,116,5326
subtest29of10,pubtest230of100,1,323,5210,4,152,5366
subtest25of10,pubtest230of100,1,323,5210,5,191,5406
subtest23of10,pubtest230of100,1,323,5210,6,230,5446
subtest28of10,pubtest230of100,1,323,5210,7,269,5486
subtest210of10,pubtest230of100,1,323,5210,8,308,5526
subtest24of10,pubtest230of100,1,323,5210,14,342,5566
subtest26of10,pubtest230of100,1,323,5210,14,382,5606
subtest23of10,pubtest231of100,1,323,5295,0,38,5333
subtest28of10,pubtest231of100,1,323,5295,0,78,5373
subtest25of10,pubtest231of100,1,323,5295,2,115,5412
subtest24of10,pubtest231of100,1,323,5295,7,150,5452
subtest210of10,pubtest231of100,1,323,5295,10,187,5492
subtest29of10,pubtest231of100,1,323,5295,11,226,5532
subtest27of10,pubtest231of100,1,323,5295,11,266,5572
subtest22of10,pubtest231of100,1,323,5295,15,302,5612
subtest26of10,pubtest231of100,1,323,5295,13,342,5650
subtest21of10,pubtest231of100,1,323,5295,16,381,5692
subtest21of10,pubtest232of100,1,323,5231,-3,39,5267
subtest27of10,pubtest232of100,1,323,5231,4,71,5306
subtest22of10,pubtest232of100,1,323,5231,7,108,5346
subtest23of10,pubtest232of100,1,323,5231,7,148,5386
subtest28of10,pubtest232of100,1,323,5231,9,186,5426
subtest29of10,pubtest232of100,1,323,5231,10,225,5466
subtest210of10,pubtest232of100,1,323,5231,10,264,5505
subtest24of10,pubtest232of100,1,323,5231,14,301,5546
subtest26of10,pubtest232of100,1,323,5231,14,341,5586
subtest25of10,pubtest232of100,1,323,5231,10,380,5621
subtest29of10,pubtest233of100,1,323,5343,0,40,5383
subtest24of10,pubtest233of100,1,323,5343,5,74,5422
subtest210of10,pubtest233of100,1,323,5343,6,113,5462
subtest27of10,pubtest233of100,1,323,5343,7,152,5502
subtest25of10,pubtest233of100,1,323,5343,7,192,5542
subtest26of10,pubtest233of100,1,323,5343,9,230,5582
subtest22of10,pubtest233of100,1,323,5343,12,266,5621
subtest28of10,pubtest233of100,1,323,5343,12,305,5660
subtest23of10,pubtest233of100,1,323,5343,16,343,5702
subtest21of10,pubtest233of100,1,323,5343,16,383,5742
subtest25of10,pubtest234of100,1,323,5353,16,39,5408
subtest26of10,pubtest234of100,1,323,5353,16,77,5446
subtest27of10,pubtest234of100,1,323,5353,18,116,5487
subtest22of10,pubtest234of100,1,323,5353,18,155,5526
subtest21of10,pubtest234of100,1,323,5353,20,193,5566
subtest29of10,pubtest234of100,1,323,5353,20,233,5606
subtest23of10,pubtest234of100,1,323,5353,21,269,5643
subtest210of10,pubtest234of100,1,323,5353,24,309,5686
subtest24of10,pubtest234of100,1,323,5353,24,348,5725
subtest28of10,pubtest234of100,1,323,5353,26,387,5766
subtest21of10,pubtest235of100,1,321,5427,1,39,5467
subtest210of10,pubtest235of100,1,321,5427,2,78,5507
subtest23of10,pubtest235of100,1,321,5427,5,114,5546
subtest22of10,pubtest235of100,1,321,5427,5,155,5587
subtest27of10,pubtest235of100,1,321,5427,8,190,5625
subtest29of10,pubtest235of100,1,321,5427,9,230,5666
subtest24of10,pubtest235of100,1,321,5427,9,267,5703
subtest25of10,pubtest235of100,1,321,5427,13,306,5746
subtest26of10,pubtest235of100,1,321,5427,14,345,5786
subtest28of10,pubtest235of100,1,321,5427,25,375,5827
subtest210of10,pubtest236of100,1,323,5286,40,41,5367
subtest23of10,pubtest236of100,1,323,5286,43,77,5406
subtest27of10,pubtest236of100,1,323,5286,46,114,5446
subtest28of10,pubtest236of100,1,323,5286,48,152,5486
subtest29of10,pubtest236of100,1,323,5286,63,177,5526
subtest24of10,pubtest236of100,1,323,5286,63,217,5566
subtest21of10,pubtest236of100,1,323,5286,63,256,5605
subtest25of10,pubtest236of100,1,323,5286,63,296,5645
subtest22of10,pubtest236of100,1,323,5286,77,322,5685
subtest26of10,pubtest236of100,1,323,5286,77,362,5725
subtest24of10,pubtest237of100,1,323,5336,-3,41,5374
subtest28of10,pubtest237of100,1,323,5336,-2,80,5414
subtest27of10,pubtest237of100,1,323,5336,37,79,5452
subtest25of10,pubtest237of100,1,323,5336,37,119,5492
subtest26of10,pubtest237of100,1,323,5336,37,158,5531
subtest23of10,pubtest237of100,1,323,5336,36,198,5570
subtest22of10,pubtest237of100,1,323,5336,49,228,5613
subtest21of10,pubtest237of100,1,323,5336,52,265,5653
subtest29of10,pubtest237of100,1,323,5336,53,304,5693
subtest210of10,pubtest237of100,1,323,5336,54,343,5733
subtest22of10,pubtest238of100,1,323,5335,-1,213,5547
subtest29of10,pubtest238of100,1,323,5335,-2,253,5586
subtest27of10,pubtest238of100,1,323,5335,4,286,5625
subtest28of10,pubtest238of100,1,323,5335,7,323,5665
subtest25of10,pubtest238of100,1,323,5335,11,359,5705
subtest21of10,pubtest238of100,1,323,5335,12,396,5743
subtest23of10,pubtest238of100,1,323,5335,12,436,5783
subtest210of10,pubtest238of100,1,323,5335,16,474,5825
subtest26of10,pubtest238of100,1,323,5335,17,513,5865
subtest24of10,pubtest238of100,1,323,5335,19,551,5905
subtest28of10,pubtest239of100,1,323,5343,5,43,5391
subtest26of10,pubtest239of100,1,323,5343,5,82,5430
subtest27of10,pubtest239of100,1,323,5343,7,119,5469
subtest21of10,pubtest239of100,1,323,5343,7,159,5509
subtest24of10,pubtest239of100,1,323,5343,13,193,5549
subtest25of10,pubtest239of100,1,323,5343,14,232,5589
subtest29of10,pubtest239of100,1,323,5343,17,270,5630
subtest22of10,pubtest239of100,1,323,5343,17,309,5669
subtest23of10,pubtest239of100,1,323,5343,21,345,5709
subtest210of10,pubtest239of100,1,323,5343,29,377,5749
subtest25of10,pubtest240of100,1,323,5299,11,71,5381
subtest29of10,pubtest240of100,1,323,5299,13,106,5418
subtest27of10,pubtest240of100,1,323,5299,14,145,5458
subtest22of10,pubtest240of100,1,323,5299,15,184,5498
subtest28of10,pubtest240of100,1,323,5299,16,223,5538
subtest210of10,pubtest240of100,1,323,5299,12,263,5574
subtest21of10,pubtest240of100,1,323,5299,17,302,5618
subtest23of10,pubtest240of100,1,323,5299,21,339,5659
subtest24of10,pubtest240of100,1,323,5299,20,378,5697
subtest26of10,pubtest240of100,1,323,5299,43,396,5738
subtest23of10,pubtest241of100,1,323,5271,1,42,5314
subtest27of10,pubtest241of100,1,323,5271,4,78,5353
subtest21of10,pubtest241of100,1,323,5271,7,115,5393
subtest24of10,pubtest241of100,1,323,5271,10,152,5433
subtest210of10,pubtest241of100,1,323,5271,14,188,5473
subtest29of10,pubtest241of100,1,323,5271,15,228,5514
subtest25of10,pubtest241of100,1,323,5271,18,262,5551
subtest26of10,pubtest241of100,1,323,5271,22,300,5593
subtest28of10,pubtest241of100,1,323,5271,21,339,5631
subtest22of10,pubtest241of100,1,323,5271,26,376,5673
subtest27of10,pubtest242of100,1,323,5247,16,41,5304
subtest23of10,pubtest242of100,1,323,5247,18,79,5344
subtest26of10,pubtest242of100,1,323,5247,19,118,5384
subtest25of10,pubtest242of100,1,323,5247,21,156,5424
subtest29of10,pubtest242of100,1,323,5247,24,193,5464
subtest21of10,pubtest242of100,1,323,5247,25,232,5504
subtest210of10,pubtest242of100,1,323,5247,26,270,5543
subtest22of10,pubtest242of100,1,323,5247,28,309,5584
subtest24of10,pubtest242of100,1,323,5247,30,347,5624
subtest28of10,pubtest242of100,1,323,5247,30,387,5664
subtest29of10,pubtest243of100,1,323,5276,-1,47,5322
subtest28of10,pubtest243of100,1,323,5276,0,85,5361
subtest27of10,pubtest243of100,1,323,5276,3,122,5401
subtest25of10,pubtest243of100,1,323,5276,3,162,5441
subtest23of10,pubtest243of100,1,323,5276,4,201,5481
subtest21of10,pubtest243of100,1,323,5276,5,240,5521
subtest22of10,pubtest243of100,1,323,5276,2,283,5561
subtest26of10,pubtest243of100,1,323,5276,10,315,5601
subtest24of10,pubtest243of100,1,323,5276,22,343,5641
subtest210of10,pubtest243of100,1,323,5276,24,381,5681
subtest27of10,pubtest244of100,1,323,5348,-1,41,5388
subtest26of10,pubtest244of100,1,323,5348,-1,80,5427
subtest25of10,pubtest244of100,1,323,5348,4,114,5466
subtest29of10,pubtest244of100,1,323,5348,4,154,5506
subtest28of10,pubtest244of100,1,323,5348,9,189,5546
subtest23of10,pubtest244of100,1,323,5348,43,195,5586
subtest21of10,pubtest244of100,1,323,5348,42,235,5625
subtest210of10,pubtest244of100,1,323,5348,44,274,5666
subtest24of10,pubtest244of100,1,323,5348,46,313,5707
subtest22of10,pubtest244of100,1,323,5348,47,351,5746
subtest29of10,pubtest245of100,1,322,5271,9,40,5320
subtest26of10,pubtest245of100,1,322,5271,9,79,5359
subtest23of10,pubtest245of100,1,322,5271,11,117,5399
subtest22of10,pubtest245of100,1,322,5271,12,155,5438
subtest25of10,pubtest245of100,1,322,5271,13,195,5479
subtest24of10,pubtest245of100,1,322,5271,16,232,5519
subtest27of10,pubtest245of100,1,322,5271,17,271,5559
subtest28of10,pubtest245of100,1,322,5271,18,310,5599
subtest21of10,pubtest245of100,1,322,5271,18,350,5639
subtest210of10,pubtest245of100,1,322,5271,22,386,5679
subtest26of10,pubtest246of100,1,323,5228,0,46,5274
subtest27of10,pubtest246of100,1,323,5228,0,84,5312
subtest21of10,pubtest246of100,1,323,5228,0,123,5351
subtest29of10,pubtest246of100,1,323,5228,3,162,5393
subtest23of10,pubtest246of100,1,323,5228,10,195,5433
subtest25of10,pubtest246of100,1,323,5228,13,232,5473
subtest28of10,pubtest246of100,1,323,5228,13,272,5513
subtest210of10,pubtest246of100,1,323,5228,18,307,5553
subtest24of10,pubtest246of100,1,323,5228,18,347,5593
subtest22of10,pubtest246of100,1,323,5228,19,386,5633
subtest23of10,pubtest247of100,1,323,5556,2,61,5619
subtest27of10,pubtest247of100,1,323,5556,2,98,5656
subtest26of10,pubtest247of100,1,323,5556,4,136,5696
subtest22of10,pubtest247of100,1,323,5556,4,177,5737
subtest21of10,pubtest247of100,1,323,5556,5,213,5774
subtest29of10,pubtest247of100,1,323,5556,5,253,5814
subtest24of10,pubtest247of100,1,323,5556,9,291,5856
subtest25of10,pubtest247of100,1,323,5556,10,330,5896
subtest28of10,pubtest247of100,1,323,5556,10,370,5936
subtest210of10,pubtest247of100,1,323,5556,9,409,5974
subtest29of10,pubtest248of100,1,323,5235,-4,40,5271
subtest25of10,pubtest248of100,1,323,5235,2,73,5310
subtest26of10,pubtest248of100,1,323,5235,3,112,5350
subtest23of10,pubtest248of100,1,323,5235,4,152,5391
subtest27of10,pubtest248of100,1,323,5235,7,188,5430
subtest28of10,pubtest248of100,1,323,5235,7,228,5470
subtest21of10,pubtest248of100,1,323,5235,9,266,5510
subtest24of10,pubtest248of100,1,323,5235,20,296,5551
subtest22of10,pubtest248of100,1,323,5235,21,334,5590
subtest210of10,pubtest248of100,1,323,5235,22,373,5630
subtest27of10,pubtest249of100,1,323,5403,0,40,5443
subtest28of10,pubtest249of100,1,323,5403,18,60,5481
subtest25of10,pubtest249of100,1,323,5403,19,100,5522
subtest21of10,pubtest249of100,1,323,5403,27,131,5561
subtest24of10,pubtest249of100,1,323,5403,27,171,5601
subtest29of10,pubtest249of100,1,323,5403,30,209,5642
subtest23of10,pubtest249of100,1,323,5403,30,250,5683
subtest26of10,pubtest249of100,1,323,5403,31,288,5722
subtest22of10,pubtest249of100,1,323,5403,32,327,5762
subtest210of10,pubtest249of100,1,323,5403,33,366,5802
subtest27of10,pubtest250of100,1,323,5264,10,47,5321
subtest21of10,pubtest250of100,1,323,5264,14,82,5360
subtest23of10,pubtest250of100,1,323,5264,11,120,5395
subtest29of10,pubtest250of100,1,323,5264,12,158,5434
subtest28of10,pubtest250of100,1,323,5264,12,198,5474
subtest22of10,pubtest250of100,1,323,5264,21,237,5522
subtest24of10,pubtest250of100,1,323,5264,22,277,5563
subtest26of10,pubtest250of100,1,323,5264,20,316,5600
subtest25of10,pubtest250of100,1,323,5264,20,356,5640
subtest210of10,pubtest250of100,1,323,5264,19,395,5678
subtest23of10,pubtest251of100,1,323,5249,-4,40,5285
subtest22of10,pubtest251of100,1,323,5249,2,72,5323
subtest27of10,pubtest251of100,1,323,5249,2,112,5363
subtest24of10,pubtest251of100,1,323,5249,7,146,5402
subtest25of10,pubtest251of100,1,323,5249,10,185,5444
subtest28of10,pubtest251of100,1,323,5249,10,224,5483
subtest21of10,pubtest251of100,1,323,5249,12,263,5524
subtest210of10,pubtest251of100,1,323,5249,12,303,5564
subtest29of10,pubtest251of100,1,323,5249,30,329,5608
subtest26of10,pubtest251of100,1,323,5249,31,364,5644
subtest29of10,pubtest252of100,1,323,5341,11,41,5393
subtest28of10,pubtest252of100,1,323,5341,11,79,5431
subtest21of10,pubtest252of100,1,323,5341,13,117,5471
subtest27of10,pubtest252of100,1,323,5341,15,154,5510
subtest26of10,pubtest252of100,1,323,5341,31,179,5551
subtest25of10,pubtest252of100,1,323,5341,31,219,5591
subtest23of10,pubtest252of100,1,323,5341,33,257,5631
subtest22of10,pubtest252of100,1,323,5341,37,294,5672
subtest24of10,pubtest252of100,1,323,5341,41,329,5711
subtest210of10,pubtest252of100,1,323,5341,42,368,5751
subtest28of10,pubtest253of100,1,322,5356,-2,39,5393
subtest29of10,pubtest253of100,1,322,5356,11,66,5433
subtest27of10,pubtest253of100,1,322,5356,13,103,5472
subtest21of10,pubtest253of100,1,322,5356,12,143,5511
subtest22of10,pubtest253of100,1,322,5356,14,182,5552
subtest210of10,pubtest253of100,1,322,5356,14,222,5592
subtest23of10,pubtest253of100,1,322,5356,9,261,5626
subtest26of10,pubtest253of100,1,322,5356,16,301,5673
subtest25of10,pubtest253of100,1,322,5356,11,339,5706
subtest24of10,pubtest253of100,1,322,5356,17,378,5751
subtest210of10,pubtest254of100,1,323,5254,-2,39,5291
subtest27of10,pubtest254of100,1,323,5254,-1,75,5328
subtest28of10,pubtest254of100,1,323,5254,1,115,5370
subtest21of10,pubtest254of100,1,323,5254,6,150,5410
subtest25of10,pubtest254of100,1,323,5254,6,189,5449
subtest23of10,pubtest254of100,1,323,5254,7,229,5490
subtest29of10,pubtest254of100,1,323,5254,9,267,5530
subtest24of10,pubtest254of100,1,323,5254,21,295,5570
subtest22of10,pubtest254of100,1,323,5254,24,331,5609
subtest26of10,pubtest254of100,1,323,5254,25,371,5650
subtest23of10,pubtest255of100,1,322,5304,-2,452,5754
subtest22of10,pubtest255of100,1,322,5304,3,448,5755
subtest28of10,pubtest255of100,1,322,5304,4,484,5792
subtest27of10,pubtest255of100,1,322,5304,5,522,5831
subtest24of10,pubtest255of100,1,322,5304,9,558,5871
subtest29of10,pubtest255of100,1,322,5304,9,598,5911
subtest21of10,pubtest255of100,1,322,5304,11,636,5951
subtest25of10,pubtest255of100,1,322,5304,11,676,5991
subtest26of10,pubtest255of100,1,322,5304,13,714,6031
subtest210of10,pubtest255of100,1,322,5304,12,754,6070
subtest21of10,pubtest256of100,1,323,5340,7,41,5388
subtest23of10,pubtest256of100,1,323,5340,8,78,5426
subtest29of10,pubtest256of100,1,323,5340,5,121,5466
subtest26of10,pubtest256of100,1,323,5340,8,158,5506
subtest210of10,pubtest256of100,1,323,5340,12,194,5546
subtest25of10,pubtest256of100,1,323,5340,13,234,5587
subtest28of10,pubtest256of100,1,323,5340,14,272,5626
subtest27of10,pubtest256of100,1,323,5340,14,312,5666
subtest22of10,pubtest256of100,1,323,5340,18,349,5707
subtest24of10,pubtest256of100,1,323,5340,18,388,5746
subtest24of10,pubtest257of100,1,323,5282,-2,43,5323
subtest27of10,pubtest257of100,1,323,5282,0,80,5362
subtest21of10,pubtest257of100,1,323,5282,0,120,5402
subtest23of10,pubtest257of100,1,323,5282,3,157,5442
subtest29of10,pubtest257of100,1,323,5282,5,195,5482
subtest28of10,pubtest257of100,1,323,5282,7,233,5522
subtest25of10,pubtest257of100,1,323,5282,8,272,5562
subtest22of10,pubtest257of100,1,323,5282,7,312,5601
subtest210of10,pubtest257of100,1,323,5282,12,347,5641
subtest26of10,pubtest257of100,1,323,5282,13,387,5682
subtest28of10,pubtest258of100,1,323,5279,4,42,5325
subtest23of10,pubtest258of100,1,323,5279,6,81,5366
subtest26of10,pubtest258of100,1,323,5279,7,119,5405
subtest25of10,pubtest258of100,1,323,5279,8,158,5445
subtest21of10,pubtest258of100,1,323,5279,10,196,5485
subtest210of10,pubtest258of100,1,323,5279,13,233,5525
subtest29of10,pubtest258of100,1,323,5279,13,273,5565
subtest22of10,pubtest258of100,1,323,5279,15,311,5605
subtest27of10,pubtest258of100,1,323,5279,15,352,5646
subtest24of10,pubtest258of100,1,323,5279,20,386,5685
subtest21of10,pubtest259of100,1,323,5215,3,41,5259
subtest24of10,pubtest259of100,1,323,5215,6,78,5299
subtest28of10,pubtest259of100,1,323,5215,6,117,5338
subtest25of10,pubtest259of100,1,323,5215,17,147,5379
subtest26of10,pubtest259of100,1,323,5215,20,183,5418
subtest22of10,pubtest259of100,1,323,5215,34,210,5459
subtest27of10,pubtest259of100,1,323,5215,34,249,5498
subtest210of10,pubtest259of100,1,323,5215,39,285,5539
subtest23of10,pubtest259of100,1,323,5215,48,315,5578
subtest29of10,pubtest259of100,1,323,5215,49,354,5618
subtest210of10,pubtest260of100,1,323,5240,-1,41,5280
subtest23of10,pubtest260of100,1,323,5240,6,74,5320
subtest26of10,pubtest260of100,1,323,5240,7,114,5361
subtest21of10,pubtest260of100,1,323,5240,15,146,5401
subtest27of10,pubtest260of100,1,323,5240,16,185,5441
subtest22of10,pubtest260of100,1,323,5240,19,221,5480
subtest29of10,pubtest260of100,1,323,5240,19,261,5520
subtest28of10,pubtest260of100,1,323,5240,20,300,5560
subtest25of10,pubtest260of100,1,323,5240,27,334,5601
subtest24of10,pubtest260of100,1,323,5240,27,373,5640
subtest25of10,pubtest261of100,1,323,5293,17,40,5350
subtest28of10,pubtest261of100,1,323,5293,18,78,5389
subtest210of10,pubtest261of100,1,323,5293,19,117,5429
subtest29of10,pubtest261of100,1,323,5293,23,153,5469
subtest23of10,pubtest261of100,1,323,5293,23,195,5511
subtest22of10,pubtest261of100,1,323,5293,25,231,5549
subtest27of10,pubtest261of100,1,323,5293,25,271,5589
subtest24of10,pubtest261of100,1,323,5293,27,309,5629
subtest21of10,pubtest261of100,1,323,5293,30,346,5669
subtest26of10,pubtest261of100,1,323,5293,31,385,5709
subtest22of10,pubtest262of100,1,323,5249,-1,41,5289
subtest23of10,pubtest262of100,1,323,5249,2,78,5329
subtest21of10,pubtest262of100,1,323,5249,2,117,5368
subtest26of10,pubtest262of100,1,323,5249,5,159,5413
subtest27of10,pubtest262of100,1,323,5249,11,192,5452
subtest29of10,pubtest262of100,1,323,5249,11,232,5492
subtest25of10,pubtest262of100,1,323,5249,13,270,5532
subtest210of10,pubtest262of100,1,323,5249,13,310,5572
subtest24of10,pubtest262of100,1,323,5249,25,338,5612
subtest28of10,pubtest262of100,1,323,5249,25,378,5652
subtest22of10,pubtest263of100,1,322,5247,7,40,5294
subtest24of10,pubtest263of100,1,322,5247,7,78,5332
subtest26of10,pubtest263of100,1,322,5247,10,115,5372
subtest29of10,pubtest263of100,1,322,5247,11,154,5412
subtest23of10,pubtest263of100,1,322,5247,11,194,5452
subtest210of10,pubtest263of100,1,322,5247,13,232,5492
subtest25of10,pubtest263of100,1,322,5247,13,272,5532
subtest28of10,pubtest263of100,1,322,5247,15,311,5573
subtest27of10,pubtest263of100,1,322,5247,15,350,5612
subtest21of10,pubtest263of100,1,322,5247,21,385,5653
subtest22of10,pubtest264of100,1,322,5344,-1,64,5407
subtest29of10,pubtest264of100,1,322,5344,0,102,5446
subtest23of10,pubtest264of100,1,322,5344,1,141,5486
subtest24of10,pubtest264of100,1,322,5344,7,175,5526
subtest27of10,pubtest264of100,1,322,5344,7,215,5566
subtest28of10,pubtest264of100,1,322,5344,10,251,5605
subtest21of10,pubtest264of100,1,322,5344,10,291,5645
subtest25of10,pubtest264of100,1,322,5344,12,330,5686
subtest26of10,pubtest264of100,1,322,5344,15,366,5725
subtest210of10,pubtest264of100,1,322,5344,15,405,5764
subtest26of10,pubtest265of100,1,323,5263,2,46,5311
subtest27of10,pubtest265of100,1,323,5263,4,83,5350
subtest210of10,pubtest265of100,1,323,5263,5,121,5389
subtest21of10,pubtest265of100,1,323,5263,17,149,5429
subtest22of10,pubtest265of100,1,323,5263,21,185,5469
subtest29of10,pubtest265of100,1,323,5263,21,225,5509
subtest25of10,pubtest265of100,1,323,5263,23,264,5550
subtest23of10,pubtest265of100,1,323,5263,23,302,5588
subtest24of10,pubtest265of100,1,323,5263,25,338,5626
subtest28of10,pubtest265of100,1,323,5263,28,378,5669
subtest29of10,pubtest266of100,1,321,5230,2,41,5273
subtest210of10,pubtest266of100,1,321,5230,7,75,5312
subtest25of10,pubtest266of100,1,321,5230,7,115,5352
subtest27of10,pubtest266of100,1,321,5230,13,149,5392
subtest26of10,pubtest266of100,1,321,5230,17,185,5432
subtest28of10,pubtest266of100,1,321,5230,18,224,5472
subtest21of10,pubtest266of100,1,321,5230,18,264,5512
subtest23of10,pubtest266of100,1,321,5230,17,301,5548
subtest24of10,pubtest266of100,1,321,5230,25,337,5592
subtest22of10,pubtest266of100,1,321,5230,25,377,5632
subtest26of10,pubtest267of100,1,323,7536,4,39,7579
subtest28of10,pubtest267of100,1,323,7536,6,77,7619
subtest23of10,pubtest267of100,1,323,7536,8,114,7658
subtest25of10,pubtest267of100,1,323,7536,16,146,7698
subtest24of10,pubtest267of100,1,323,7536,17,183,7736
subtest27of10,pubtest267of100,1,323,7536,18,222,7776
subtest29of10,pubtest267of100,1,323,7536,44,237,7817
subtest22of10,pubtest267of100,1,323,7536,49,273,7858
subtest21of10,pubtest267of100,1,323,7536,49,313,7898
subtest210of10,pubtest267of100,1,323,7536,53,349,7938
subtest23of10,pubtest268of100,1,323,7679,5,41,7725
subtest24of10,pubtest268of100,1,323,7679,15,70,7764
subtest25of10,pubtest268of100,1,323,7679,16,109,7804
subtest28of10,pubtest268of100,1,323,7679,21,142,7842
subtest27of10,pubtest268of100,1,323,7679,24,181,7884
subtest29of10,pubtest268of100,1,323,7679,21,221,7921
subtest21of10,pubtest268of100,1,323,7679,30,255,7964
subtest22of10,pubtest268of100,1,323,7679,32,293,8004
subtest210of10,pubtest268of100,1,323,7679,33,332,8044
subtest26of10,pubtest268of100,1,323,7679,35,371,8085
subtest24of10,pubtest269of100,1,323,5364,0,39,5403
subtest27of10,pubtest269of100,1,323,5364,4,75,5443
subtest210of10,pubtest269of100,1,323,5364,5,112,5481
subtest25of10,pubtest269of100,1,323,5364,10,148,5522
subtest26of10,pubtest269of100,1,323,5364,11,187,5562
subtest21of10,pubtest269of100,1,323,5364,14,224,5602
subtest22of10,pubtest269of100,1,323,5364,15,263,5642
subtest28of10,pubtest269of100,1,323,5364,16,302,5682
subtest29of10,pubtest269of100,1,323,5364,17,341,5722
subtest23of10,pubtest269of100,1,323,5364,20,378,5762
subtest23of10,pubtest270of100,1,323,5531,0,39,5570
subtest27of10,pubtest270of100,1,323,5531,8,68,5607
subtest26of10,pubtest270of100,1,323,5531,10,107,5648
subtest210of10,pubtest270of100,1,323,5531,11,147,5689
subtest29of10,pubtest270of100,1,323,5531,12,185,5728
subtest28of10,pubtest270of100,1,323,5531,13,224,5768
subtest21of10,pubtest270of100,1,323,5531,14,263,5808
subtest25of10,pubtest270of100,1,323,5531,15,302,5848
subtest22of10,pubtest270of100,1,323,5531,15,342,5888
subtest24of10,pubtest270of100,1,323,5531,16,381,5928
subtest27of10,pubtest271of100,1,323,5418,2,217,5637
subtest25of10,pubtest271of100,1,323,5418,1,253,5672
subtest24of10,pubtest271of100,1,323,5418,-1,295,5712
subtest22of10,pubtest271of100,1,323,5418,2,331,5751
subtest210of10,pubtest271of100,1,323,5418,7,368,5793
subtest26of10,pubtest271of100,1,323,5418,18,397,5833
subtest21of10,pubtest271of100,1,323,5418,18,436,5872
subtest29of10,pubtest271of100,1,323,5418,20,475,5913
subtest23of10,pubtest271of100,1,323,5418,20,517,5955
subtest28of10,pubtest271of100,1,323,5418,27,548,5993
subtest25of10,pubtest272of100,1,323,5268,6,39,5313
subtest26of10,pubtest272of100,1,323,5268,9,75,5352
subtest21of10,pubtest272of100,1,323,5268,9,115,5392
subtest29of10,pubtest272of100,1,323,5268,11,154,5433
subtest23of10,pubtest272of100,1,323,5268,11,193,5472
subtest24of10,pubtest272of100,1,323,5268,13,231,5512
subtest27of10,pubtest272of100,1,323,5268,19,265,5552
subtest210of10,pubtest272of100,1,323,5268,19,305,5592
subtest22of10,pubtest272of100,1,323,5268,21,343,5632
subtest28of10,pubtest272of100,1,323,5268,27,378,5673
subtest22of10,pubtest273of100,1,321,5211,5,41,5257
subtest26of10,pubtest273of100,1,321,5211,10,75,5296
subtest29of10,pubtest273of100,1,321,5211,10,116,5337
subtest28of10,pubtest273of100,1,321,5211,15,150,5376
subtest25of10,pubtest273of100,1,321,5211,17,189,5417
subtest210of10,pubtest273of100,1,321,5211,19,226,5456
subtest27of10,pubtest273of100,1,321,5211,20,265,5496
subtest24of10,pubtest273of100,1,321,5211,21,304,5536
subtest23of10,pubtest273of100,1,321,5211,22,343,5576
subtest21of10,pubtest273of100,1,321,5211,28,377,5616
subtest21of10,pubtest274of100,1,323,5248,2,40,5290
subtest26of10,pubtest274of100,1,323,5248,13,70,5331
subtest22of10,pubtest274of100,1,323,5248,16,105,5369
subtest23of10,pubtest274of100,1,323,5248,17,144,5409
subtest28of10,pubtest274of100,1,323,5248,19,182,5449
subtest29of10,pubtest274of100,1,323,5248,29,212,5489
subtest25of10,pubtest274of100,1,323,5248,29,252,5529
subtest24of10,pubtest274of100,1,323,5248,50,271,5569
subtest27of10,pubtest274of100,1,323,5248,51,310,5609
subtest210of10,pubtest274of100,1,323,5248,56,345,5649
subtest27of10,pubtest275of100,1,323,5458,4,39,5501
subtest29of10,pubtest275of100,1,323,5458,9,73,5540
subtest24of10,pubtest275of100,1,323,5458,15,107,5580
subtest25of10,pubtest275of100,1,323,5458,16,146,5620
subtest21of10,pubtest275of100,1,323,5458,24,178,5660
subtest22of10,pubtest275of100,1,323,5458,35,207,5700
subtest23of10,pubtest275of100,1,323,5458,36,246,5740
subtest210of10,pubtest275of100,1,323,5458,37,284,5779
subtest26of10,pubtest275of100,1,323,5458,40,321,5819
subtest28of10,pubtest275of100,1,323,5458,41,361,5860
subtest28of10,pubtest276of100,1,323,5321,3,38,5362
subtest21of10,pubtest276of100,1,323,5321,6,74,5401
subtest25of10,pubtest276of100,1,323,5321,8,113,5442
subtest24of10,pubtest276of100,1,323,5321,9,152,5482
subtest27of10,pubtest276of100,1,323,5321,9,191,5521
subtest29of10,pubtest276of100,1,323,5321,11,228,5560
subtest23of10,pubtest276of100,1,323,5321,14,266,5601
subtest210of10,pubtest276of100,1,323,5321,16,305,5642
subtest26of10,pubtest276of100,1,323,5321,15,345,5681
subtest22of10,pubtest276of100,1,323,5321,21,379,5721
subtest22of10,pubtest277of100,1,323,5224,0,40,5264
subtest29of10,pubtest277of100,1,323,5224,13,67,5304
subtest28of10,pubtest277of100,1,323,5224,15,104,5343
subtest21of10,pubtest277of100,1,323,5224,16,141,5381
subtest24of10,pubtest277of100,1,323,5224,19,180,5423
subtest27of10,pubtest277of100,1,323,5224,32,207,5463
subtest25of10,pubtest277of100,1,323,5224,55,224,5503
subtest210of10,pubtest277of100,1,323,5224,65,254,5543
subtest23of10,pubtest277of100,1,323,5224,67,292,5583
subtest26of10,pubtest277of100,1,323,5224,73,327,5624
subtest29of10,pubtest278of100,1,323,5233,-1,38,5270
subtest23of10,pubtest278of100,1,323,5233,6,70,5309
subtest28of10,pubtest278of100,1,323,5233,6,110,5349
subtest22of10,pubtest278of100,1,323,5233,4,149,5386
subtest21of10,pubtest278of100,1,323,5233,10,186,5429
subtest27of10,pubtest278of100,1,323,5233,16,220,5469
subtest25of10,pubtest278of100,1,323,5233,16,260,5509
subtest26of10,pubtest278of100,1,323,5233,17,298,5548
subtest24of10,pubtest278of100,1,323,5233,18,338,5589
subtest210of10,pubtest278of100,1,323,5233,25,371,5629
subtest28of10,pubtest279of100,1,323,5231,-4,41,5268
subtest25of10,pubtest279of100,1,323,5231,-1,77,5307
subtest21of10,pubtest279of100,1,323,5231,0,115,5346
subtest24of10,pubtest279of100,1,323,5231,8,147,5386
subtest26of10,pubtest279of100,1,323,5231,13,182,5426
subtest29of10,pubtest279of100,1,323,5231,14,221,5466
subtest27of10,pubtest279of100,1,323,5231,14,261,5506
subtest22of10,pubtest279of100,1,323,5231,16,299,5546
subtest210of10,pubtest279of100,1,323,5231,17,338,5586
subtest23of10,pubtest279of100,1,323,5231,16,378,5625
subtest27of10,pubtest280of100,1,323,5196,-3,40,5233
subtest24of10,pubtest280of100,1,323,5196,-1,79,5274
subtest29of10,pubtest280of100,1,323,5196,7,110,5313
subtest23of10,pubtest280of100,1,323,5196,10,146,5352
subtest26of10,pubtest280of100,1,323,5196,10,186,5392
subtest21of10,pubtest280of100,1,323,5196,9,225,5430
subtest25of10,pubtest280of100,1,323,5196,12,264,5472
subtest210of10,pubtest280of100,1,323,5196,14,302,5512
subtest28of10,pubtest280of100,1,323,5196,16,340,5552
subtest22of10,pubtest280of100,1,323,5196,17,379,5592
subtest24of10,pubtest281of100,1,323,5247,2,38,5287
subtest23of10,pubtest281of100,1,323,5247,3,77,5327
subtest27of10,pubtest281of100,1,323,5247,4,117,5368
subtest28of10,pubtest281of100,1,323,5247,7,153,5407
subtest22of10,pubtest281of100,1,323,5247,13,187,5447
subtest25of10,pubtest281of100,1,323,5247,18,222,5487
subtest21of10,pubtest281of100,1,323,5247,19,261,5527
subtest210of10,pubtest281of100,1,323,5247,19,301,5567
subtest29of10,pubtest281of100,1,323,5247,28,332,5607
subtest26of10,pubtest281of100,1,323,5247,34,366,5647
subtest24of10,pubtest282of100,1,323,5349,4,42,5395
subtest23of10,pubtest282of100,1,323,5349,4,80,5433
subtest21of10,pubtest282of100,1,323,5349,6,119,5474
subtest22of10,pubtest282of100,1,323,5349,8,158,5515
subtest25of10,pubtest282of100,1,323,5349,7,197,5553
subtest26of10,pubtest282of100,1,323,5349,9,236,5594
subtest29of10,pubtest282of100,1,323,5349,9,276,5634
subtest210of10,pubtest282of100,1,323,5349,16,309,5674
subtest28of10,pubtest282of100,1,323,5349,17,348,5714
subtest27of10,pubtest282of100,1,323,5349,16,387,5752
subtest24of10,pubtest283of100,1,323,5239,-2,40,5277
subtest27of10,pubtest283of100,1,323,5239,-2,78,5315
subtest22of10,pubtest283of100,1,323,5239,9,105,5353
subtest25of10,pubtest283of100,1,323,5239,10,144,5393
subtest23of10,pubtest283of100,1,323,5239,9,184,5432
subtest28of10,pubtest283of100,1,323,5239,14,222,5475
subtest21of10,pubtest283of100,1,323,5239,14,263,5516
subtest210of10,pubtest283of100,1,323,5239,16,300,5555
subtest29of10,pubtest283of100,1,323,5239,16,340,5595
subtest26of10,pubtest283of100,1,323,5239,18,378,5635
subtest25of10,pubtest284of100,1,323,5299,5,41,5345
subtest29of10,pubtest284of100,1,323,5299,14,71,5384
subtest22of10,pubtest284of100,1,323,5299,12,111,5422
subtest210of10,pubtest284of100,1,323,5299,16,149,5464
subtest24of10,pubtest284of100,1,323,5299,16,189,5504
subtest27of10,pubtest284of100,1,323,5299,17,228,5544
subtest21of10,pubtest284of100,1,323,5299,17,268,5584
subtest23of10,pubtest284of100,1,323,5299,18,307,5624
subtest28of10,pubtest284of100,1,323,5299,21,343,5663
subtest26of10,pubtest284of100,1,323,5299,22,384,5705
subtest23of10,pubtest285of100,1,323,5215,-1,39,5253
subtest25of10,pubtest285of100,1,323,5215,3,74,5292
subtest24of10,pubtest285of100,1,323,5215,4,113,5332
subtest27of10,pubtest285of100,1,323,5215,4,154,5373
subtest22of10,pubtest285of100,1,323,5215,16,181,5412
subtest21of10,pubtest285of100,1,323,5215,20,217,5452
subtest29of10,pubtest285of100,1,323,5215,22,255,5492
subtest28of10,pubtest285of100,1,323,5215,22,295,5532
subtest210of10,pubtest285of100,1,323,5215,24,333,5572
subtest26of10,pubtest285of100,1,323,5215,24,373,5612
subtest23of10,pubtest286of100,1,323,5440,5,39,5484
subtest25of10,pubtest286of100,1,323,5440,10,74,5524
subtest210of10,pubtest286of100,1,323,5440,12,112,5564
subtest24of10,pubtest286of100,1,323,5440,13,151,5604
subtest29of10,pubtest286of100,1,323,5440,15,189,5644
subtest21of10,pubtest286of100,1,323,5440,15,229,5684
subtest27of10,pubtest286of100,1,323,5440,16,268,5724
subtest26of10,pubtest286of100,1,323,5440,21,303,5764
subtest22of10,pubtest286of100,1,323,5440,25,339,5804
subtest28of10,pubtest286of100,1,323,5440,30,374,5844
subtest26of10,pubtest287of100,1,323,5361,-2,44,5403
subtest29of10,pubtest287of100,1,323,5361,-1,82,5442
subtest28of10,pubtest287of100,1,323,5361,4,118,5483
subtest210of10,pubtest287of100,1,323,5361,6,155,5522
subtest27of10,pubtest287of100,1,323,5361,13,189,5563
subtest24of10,pubtest287of100,1,323,5361,14,224,5599
subtest25of10,pubtest287of100,1,323,5361,17,264,5642
subtest22of10,pubtest287of100,1,323,5361,17,304,5682
subtest23of10,pubtest287of100,1,323,5361,19,343,5723
subtest21of10,pubtest287of100,1,323,5361,19,381,5761
subtest29of10,pubtest288of100,1,323,5249,40,39,5328
subtest25of10,pubtest288of100,1,323,5249,41,77,5367
subtest26of10,pubtest288of100,1,323,5249,41,113,5403
subtest27of10,pubtest288of100,1,323,5249,43,153,5445
subtest22of10,pubtest288of100,1,323,5249,46,192,5487
subtest21of10,pubtest288of100,1,323,5249,47,231,5527
subtest210of10,pubtest288of100,1,323,5249,48,270,5567
subtest23of10,pubtest288of100,1,323,5249,47,309,5605
subtest28of10,pubtest288of100,1,323,5249,49,348,5646
subtest24of10,pubtest288of100,1,323,5249,49,387,5685
subtest210of10,pubtest289of100,1,323,5308,8,39,5355
subtest23of10,pubtest289of100,1,323,5308,6,79,5393
subtest29of10,pubtest289of100,1,323,5308,6,117,5431
subtest24of10,pubtest289of100,1,323,5308,10,156,5474
subtest25of10,pubtest289of100,1,323,5308,11,196,5515
subtest27of10,pubtest289of100,1,323,5308,12,234,5554
subtest26of10,pubtest289of100,1,323,5308,13,274,5595
subtest28of10,pubtest289of100,1,323,5308,16,310,5634
subtest21of10,pubtest289of100,1,323,5308,16,351,5675
subtest22of10,pubtest289of100,1,323,5308,21,386,5715
subtest29of10,pubtest290of100,1,323,5249,5,41,5295
subtest22of10,pubtest290of100,1,323,5249,7,79,5335
subtest23of10,pubtest290of100,1,323,5249,8,118,5375
subtest26of10,pubtest290of100,1,323,5249,9,156,5414
subtest25of10,pubtest290of100,1,323,5249,9,195,5453
subtest210of10,pubtest290of100,1,323,5249,12,233,5494
subtest27of10,pubtest290of100,1,323,5249,9,273,5531
subtest21of10,pubtest290of100,1,323,5249,16,309,5574
subtest28of10,pubtest290of100,1,323,5249,19,346,5614
subtest24of10,pubtest290of100,1,323,5249,21,383,5653
subtest23of10,pubtest291of100,1,323,5266,7,40,5313
subtest24of10,pubtest291of100,1,323,5266,7,80,5353
subtest28of10,pubtest291of100,1,323,5266,18,108,5392
subtest27of10,pubtest291of100,1,323,5266,18,149,5433
subtest210of10,pubtest291of100,1,323,5266,26,180,5472
subtest21of10,pubtest291of100,1,323,5266,26,220,5512
subtest22of10,pubtest291of100,1,323,5266,35,249,5550
subtest25of10,pubtest291of100,1,323,5266,57,269,5592
subtest29of10,pubtest291of100,1,323,5266,65,300,5631
subtest26of10,pubtest291of100,1,323,5266,66,340,5672
subtest29of10,pubtest292of100,1,323,5306,6,45,5357
subtest28of10,pubtest292of100,1,323,5306,6,85,5397
subtest25of10,pubtest292of100,1,323,5306,8,122,5436
subtest21of10,pubtest292of100,1,323,5306,10,160,5476
subtest26of10,pubtest292of100,1,323,5306,11,197,5514
subtest27of10,pubtest292of100,1,323,5306,15,235,5556
subtest23of10,pubtest292of100,1,323,5306,14,275,5595
subtest24of10,pubtest292of100,1,323,5306,17,313,5636
subtest22of10,pubtest292of100,1,323,5306,17,353,5676
subtest210of10,pubtest292of100,1,323,5306,24,386,5716
subtest24of10,pubtest293of100,1,323,5292,8,43,5343
subtest25of10,pubtest293of100,1,323,5292,8,81,5381
subtest28of10,pubtest293of100,1,323,5292,11,120,5423
subtest23of10,pubtest293of100,1,323,5292,40,131,5463
subtest27of10,pubtest293of100,1,323,5292,44,167,5503
subtest210of10,pubtest293of100,1,323,5292,44,207,5543
subtest29of10,pubtest293of100,1,323,5292,46,246,5584
subtest26of10,pubtest293of100,1,323,5292,46,285,5623
subtest21of10,pubtest293of100,1,323,5292,46,324,5662
subtest22of10,pubtest293of100,1,323,5292,48,363,5703
subtest21of10,pubtest294of100,1,323,5262,-3,40,5299
subtest210of10,pubtest294of100,1,323,5262,-2,79,5339
subtest25of10,pubtest294of100,1,323,5262,3,113,5378
subtest24of10,pubtest294of100,1,323,5262,6,150,5418
subtest26of10,pubtest294of100,1,323,5262,6,190,5458
subtest29of10,pubtest294of100,1,323,5262,8,228,5498
subtest27of10,pubtest294of100,1,323,5262,8,268,5538
subtest22of10,pubtest294of100,1,323,5262,9,307,5578
subtest23of10,pubtest294of100,1,323,5262,9,347,5618
subtest28of10,pubtest294of100,1,323,5262,13,383,5658
subtest25of10,pubtest295of100,1,323,5206,-3,41,5244
subtest24of10,pubtest295of100,1,323,5206,-1,78,5283
subtest23of10,pubtest295of100,1,323,5206,0,117,5323
subtest22of10,pubtest295of100,1,323,5206,2,155,5363
subtest27of10,pubtest295of100,1,323,5206,10,187,5403
subtest210of10,pubtest295of100,1,323,5206,11,226,5443
subtest28of10,pubtest295of100,1,323,5206,18,259,5483
subtest26of10,pubtest295of100,1,323,5206,22,294,5522
subtest29of10,pubtest295of100,1,323,5206,22,334,5562
subtest21of10,pubtest295of100,1,323,5206,24,373,5603
subtest24of10,pubtest296of100,1,322,5218,-1,41,5258
subtest25of10,pubtest296of100,1,322,5218,-1,80,5297
subtest27of10,pubtest296of100,1,322,5218,8,111,5337
subtest26of10,pubtest296of100,1,322,5218,11,146,5375
subtest29of10,pubtest296of100,1,322,5218,13,185,5416
subtest23of10,pubtest296of100,1,322,5218,11,225,5454
subtest28of10,pubtest296of100,1,322,5218,15,264,5497
subtest21of10,pubtest296of100,1,322,5218,20,299,5537
subtest210of10,pubtest296of100,1,322,5218,25,334,5577
subtest22of10,pubtest296of100,1,322,5218,25,374,5617
subtest210of10,pubtest297of100,1,323,5285,11,41,5337
subtest25of10,pubtest297of100,1,323,5285,11,80,5376
subtest29of10,pubtest297of100,1,323,5285,15,116,5416
subtest23of10,pubtest297of100,1,323,5285,16,156,5457
subtest22of10,pubtest297of100,1,323,5285,17,196,5498
subtest27of10,pubtest297of100,1,323,5285,18,234,5537
subtest26of10,pubtest297of100,1,323,5285,21,271,5577
subtest21of10,pubtest297of100,1,323,5285,22,310,5617
subtest28of10,pubtest297of100,1,323,5285,23,349,5657
subtest24of10,pubtest297of100,1,323,5285,23,389,5697
subtest29of10,pubtest298of100,1,323,5242,5,40,5287
subtest25of10,pubtest298of100,1,323,5242,7,77,5326
subtest22of10,pubtest298of100,1,323,5242,7,116,5365
subtest24of10,pubtest298of100,1,323,5242,18,146,5406
subtest23of10,pubtest298of100,1,323,5242,19,185,5446
subtest21of10,pubtest298of100,1,323,5242,24,220,5486
subtest27of10,pubtest298of100,1,323,5242,24,259,5525
subtest210of10,pubtest298of100,1,323,5242,26,298,5566
subtest28of10,pubtest298of100,1,323,5242,26,338,5606
subtest26of10,pubtest298of100,1,323,5242,29,375,5646
subtest22of10,pubtest299of100,1,323,5267,9,40,5316
subtest29of10,pubtest299of100,1,323,5267,9,79,5355
subtest27of10,pubtest299of100,1,323,5267,11,118,5396
subtest25of10,pubtest299of100,1,323,5267,11,157,5435
subtest210of10,pubtest299of100,1,323,5267,13,195,5475
subtest23of10,pubtest299of100,1,323,5267,13,235,5515
subtest24of10,pubtest299of100,1,323,5267,14,272,5553
subtest28of10,pubtest299of100,1,323,5267,14,312,5593
subtest21of10,pubtest299of100,1,323,5267,18,350,5635
subtest26of10,pubtest299of100,1,323,5267,18,390,5675
subtest21of10,pubtest2100of100,1,325,5313,-3,44,5354
subtest24of10,pubtest2100of100,1,325,5313,-2,84,5395
subtest29of10,pubtest2100of100,1,325,5313,2,118,5433
subtest22of10,pubtest2100of100,1,325,5313,11,150,5474
subtest23of10,pubtest2100of100,1,325,5313,12,189,5514
subtest25of10,pubtest2100of100,1,325,5313,14,227,5554
subtest28of10,pubtest2100of100,1,325,5313,14,267,5594
subtest27of10,pubtest2100of100,1,325,5313,13,308,5634
subtest210of10,pubtest2100of100,1,325,5313,25,336,5674
subtest26of10,pubtest2100of100,1,325,5313,32,369,5714
subtest27of10,pubtest21of100,1,322,10707,0,39,10746
subtest26of10,pubtest21of100,1,322,10707,2,76,10785
subtest29of10,pubtest21of100,1,322,10707,14,104,10825
subtest24of10,pubtest21of100,1,322,10707,15,143,10865
subtest25of10,pubtest21of100,1,322,10707,18,180,10905
subtest210of10,pubtest21of100,1,322,10707,23,215,10945
subtest21of10,pubtest21of100,1,322,10707,23,255,10985
subtest28of10,pubtest21of100,1,322,10707,29,290,11026
subtest22of10,pubtest21of100,1,322,10707,34,323,11064
subtest23of10,pubtest21of100,1,322,10707,34,361,11102
subtest29of10,pubtest22of100,1,321,5305,-7,41,5339
subtest27of10,pubtest22of100,1,321,5305,-4,79,5380
subtest24of10,pubtest22of100,1,321,5305,-3,117,5419
subtest23of10,pubtest22of100,1,321,5305,-2,156,5459
subtest25of10,pubtest22of100,1,321,5305,3,191,5499
subtest28of10,pubtest22of100,1,321,5305,4,230,5539
subtest21of10,pubtest22of100,1,321,5305,9,263,5577
subtest26of10,pubtest22of100,1,321,5305,13,301,5619
subtest210of10,pubtest22of100,1,321,5305,30,324,5659
subtest22of10,pubtest22of100,1,321,5305,39,354,5698
subtest23of10,pubtest23of100,1,321,5484,11,41,5536
subtest29of10,pubtest23of100,1,321,5484,12,79,5575
subtest28of10,pubtest23of100,1,321,5484,13,116,5613
subtest27of10,pubtest23of100,1,321,5484,15,156,5655
subtest24of10,pubtest23of100,1,321,5484,14,194,5692
subtest25of10,pubtest23of100,1,321,5484,18,233,5735
subtest26of10,pubtest23of100,1,321,5484,19,272,5775
subtest21of10,pubtest23of100,1,321,5484,24,307,5815
subtest22of10,pubtest23of100,1,321,5484,30,342,5856
subtest210of10,pubtest23of100,1,321,5484,36,375,5895
subtest23of10,pubtest24of100,1,321,5327,-4,43,5366
subtest24of10,pubtest24of100,1,321,5327,3,75,5405
subtest25of10,pubtest24of100,1,321,5327,4,113,5444
subtest21of10,pubtest24of100,1,321,5327,5,151,5483
subtest28of10,pubtest24of100,1,321,5327,5,191,5523
subtest29of10,pubtest24of100,1,321,5327,7,230,5564
subtest22of10,pubtest24of100,1,321,5327,8,270,5605
subtest27of10,pubtest24of100,1,321,5327,7,308,5642
subtest210of10,pubtest24of100,1,321,5327,9,348,5684
subtest26of10,pubtest24of100,1,321,5327,11,387,5725
subtest28of10,pubtest25of100,1,321,5404,3,39,5446
subtest21of10,pubtest25of100,1,321,5404,4,77,5485
subtest210of10,pubtest25of100,1,321,5404,6,115,5525
subtest27of10,pubtest25of100,1,321,5404,6,155,5565
subtest22of10,pubtest25of100,1,321,5404,8,191,5603
subtest25of10,pubtest25of100,1,321,5404,6,231,5641
subtest26of10,pubtest25of100,1,321,5404,8,270,5682
subtest29of10,pubtest25of100,1,321,5404,8,310,5722
subtest23of10,pubtest25of100,1,321,5404,8,349,5761
subtest24of10,pubtest25of100,1,321,5404,12,388,5804
subtest21of10,pubtest26of100,1,321,5314,11,40,5365
subtest29of10,pubtest26of100,1,321,5314,11,79,5404
subtest25of10,pubtest26of100,1,321,5314,14,116,5444
subtest22of10,pubtest26of100,1,321,5314,14,156,5484
subtest26of10,pubtest26of100,1,321,5314,16,194,5524
subtest28of10,pubtest26of100,1,321,5314,16,234,5564
subtest210of10,pubtest26of100,1,321,5314,17,274,5605
subtest24of10,pubtest26of100,1,321,5314,17,313,5644
subtest23of10,pubtest26of100,1,321,5314,18,352,5684
subtest27of10,pubtest26of100,1,321,5314,19,391,5724
subtest27of10,pubtest27of100,1,320,5297,-3,54,5348
subtest23of10,pubtest27of100,1,320,5297,-2,93,5388
subtest28of10,pubtest27of100,1,320,5297,7,124,5428
subtest24of10,pubtest27of100,1,320,5297,12,159,5468
subtest25of10,pubtest27of100,1,320,5297,14,197,5508
subtest29of10,pubtest27of100,1,320,5297,14,237,5548
subtest210of10,pubtest27of100,1,320,5297,16,275,5588
subtest22of10,pubtest27of100,1,320,5297,17,313,5627
subtest21of10,pubtest27of100,1,320,5297,16,351,5664
subtest26of10,pubtest27of100,1,320,5297,20,391,5708
subtest27of10,pubtest28of100,1,321,5261,-3,44,5302
subtest21of10,pubtest28of100,1,321,5261,4,77,5342
subtest28of10,pubtest28of100,1,321,5261,5,116,5382
subtest29of10,pubtest28of100,1,321,5261,6,155,5422
subtest210of10,pubtest28of100,1,321,5261,13,189,5463
subtest23of10,pubtest28of100,1,321,5261,12,229,5502
subtest25of10,pubtest28of100,1,321,5261,12,267,5540
subtest26of10,pubtest28of100,1,321,5261,14,307,5582
subtest24of10,pubtest28of100,1,321,5261,15,348,5624
subtest22of10,pubtest28of100,1,321,5261,16,385,5662
subtest23of10,pubtest29of100,1,321,5235,-2,41,5274
subtest29of10,pubtest29of100,1,321,5235,-1,80,5314
subtest210of10,pubtest29of100,1,321,5235,9,110,5354
subtest22of10,pubtest29of100,1,321,5235,10,149,5394
subtest25of10,pubtest29of100,1,321,5235,15,184,5434
subtest28of10,pubtest29of100,1,321,5235,23,216,5474
subtest21of10,pubtest29of100,1,321,5235,23,256,5514
subtest24of10,pubtest29of100,1,321,5235,24,295,5554
subtest27of10,pubtest29of100,1,321,5235,26,333,5594
subtest26of10,pubtest29of100,1,321,5235,31,366,5632
subtest21of10,pubtest210of100,1,323,5231,7,39,5277
subtest29of10,pubtest210of100,1,323,5231,6,77,5314
subtest27of10,pubtest210of100,1,323,5231,8,116,5355
subtest23of10,pubtest210of100,1,323,5231,11,153,5395
subtest25of10,pubtest210of100,1,323,5231,12,190,5433
subtest210of10,pubtest210of100,1,323,5231,15,229,5475
subtest24of10,pubtest210of100,1,323,5231,16,268,5515
subtest28of10,pubtest210of100,1,323,5231,15,308,5554
subtest22of10,pubtest210of100,1,323,5231,18,346,5595
subtest26of10,pubtest210of100,1,323,5231,24,381,5636
subtest210of10,pubtest211of100,1,323,5196,-3,42,5235
subtest29of10,pubtest211of100,1,323,5196,0,78,5274
subtest24of10,pubtest211of100,1,323,5196,1,117,5314
subtest21of10,pubtest211of100,1,323,5196,4,154,5354
subtest25of10,pubtest211of100,1,323,5196,5,192,5393
subtest23of10,pubtest211of100,1,323,5196,8,229,5433
subtest26of10,pubtest211of100,1,323,5196,11,268,5475
subtest27of10,pubtest211of100,1,323,5196,10,307,5513
subtest22of10,pubtest211of100,1,323,5196,9,346,5551
subtest28of10,pubtest211of100,1,323,5196,12,385,5593
subtest25of10,pubtest212of100,1,323,5226,4,40,5270
subtest29of10,pubtest212of100,1,323,5226,8,75,5309
subtest28of10,pubtest212of100,1,323,5226,10,114,5350
subtest23of10,pubtest212of100,1,323,5226,12,151,5389
subtest24of10,pubtest212of100,1,323,5226,15,188,5429
subtest27of10,pubtest212of100,1,323,5226,17,226,5469
subtest21of10,pubtest212of100,1,323,5226,18,263,5507
subtest26of10,pubtest212of100,1,323,5226,20,302,5548
subtest22of10,pubtest212of100,1,323,5226,22,341,5589
subtest210of10,pubtest212of100,1,323,5226,24,379,5629
subtest23of10,pubtest213of100,1,322,5412,1,101,5514
subtest26of10,pubtest213of100,1,322,5412,2,138,5552
subtest29of10,pubtest213of100,1,322,5412,6,174,5592
subtest22of10,pubtest213of100,1,322,5412,8,212,5632
subtest21of10,pubtest213of100,1,322,5412,11,249,5672
subtest27of10,pubtest213of100,1,322,5412,11,289,5712
subtest24of10,pubtest213of100,1,322,5412,11,329,5752
subtest210of10,pubtest213of100,1,322,5412,13,367,5792
subtest28of10,pubtest213of100,1,322,5412,14,406,5832
subtest25of10,pubtest213of100,1,322,5412,14,446,5872
subtest21of10,pubtest214of100,1,323,5235,-3,42,5274
subtest23of10,pubtest214of100,1,323,5235,1,75,5311
subtest25of10,pubtest214of100,1,323,5235,11,105,5351
subtest27of10,pubtest214of100,1,323,5235,13,143,5391
subtest26of10,pubtest214of100,1,323,5235,13,182,5430
subtest22of10,pubtest214of100,1,323,5235,14,222,5471
subtest210of10,pubtest214of100,1,323,5235,16,260,5511
subtest29of10,pubtest214of100,1,323,5235,15,298,5548
subtest24of10,pubtest214of100,1,323,5235,22,334,5591
subtest28of10,pubtest214of100,1,323,5235,26,370,5631
subtest24of10,pubtest215of100,1,323,5199,-1,42,5240
subtest27of10,pubtest215of100,1,323,5199,0,80,5279
subtest26of10,pubtest215of100,1,323,5199,2,118,5319
subtest29of10,pubtest215of100,1,323,5199,9,151,5359
subtest210of10,pubtest215of100,1,323,5199,10,190,5399
subtest22of10,pubtest215of100,1,323,5199,11,229,5439
subtest21of10,pubtest215of100,1,323,5199,12,268,5479
subtest25of10,pubtest215of100,1,323,5199,15,306,5520
subtest23of10,pubtest215of100,1,323,5199,33,328,5560
subtest28of10,pubtest215of100,1,323,5199,34,366,5599
subtest24of10,pubtest216of100,1,323,5207,7,41,5255
subtest21of10,pubtest216of100,1,323,5207,8,79,5294
subtest23of10,pubtest216of100,1,323,5207,9,117,5333
subtest28of10,pubtest216of100,1,323,5207,11,156,5374
subtest25of10,pubtest216of100,1,323,5207,11,195,5413
subtest27of10,pubtest216of100,1,323,5207,10,234,5451
subtest22of10,pubtest216of100,1,323,5207,13,274,5494
subtest29of10,pubtest216of100,1,323,5207,14,313,5534
subtest26of10,pubtest216of100,1,323,5207,15,349,5571
subtest210of10,pubtest216of100,1,323,5207,21,385,5613
subtest27of10,pubtest217of100,1,322,5226,6,41,5273
subtest22of10,pubtest217of100,1,322,5226,9,77,5312
subtest23of10,pubtest217of100,1,322,5226,11,115,5352
subtest29of10,pubtest217of100,1,322,5226,11,155,5392
subtest26of10,pubtest217of100,1,322,5226,12,192,5430
subtest25of10,pubtest217of100,1,322,5226,15,231,5472
subtest21of10,pubtest217of100,1,322,5226,10,270,5506
subtest24of10,pubtest217of100,1,322,5226,16,309,5551
subtest28of10,pubtest217of100,1,322,5226,16,349,5591
subtest210of10,pubtest217of100,1,322,5226,18,388,5632
subtest29of10,pubtest218of100,1,323,5289,-2,38,5325
subtest22of10,pubtest218of100,1,323,5289,0,78,5367
subtest21of10,pubtest218of100,1,323,5289,7,110,5406
subtest27of10,pubtest218of100,1,323,5289,14,142,5445
subtest28of10,pubtest218of100,1,323,5289,17,179,5485
subtest23of10,pubtest218of100,1,323,5289,18,218,5525
subtest25of10,pubtest218of100,1,323,5289,19,257,5565
subtest24of10,pubtest218of100,1,323,5289,26,290,5605
subtest210of10,pubtest218of100,1,323,5289,29,327,5645
subtest26of10,pubtest218of100,1,323,5289,33,363,5685
subtest210of10,pubtest219of100,1,323,5384,0,40,5424
subtest25of10,pubtest219of100,1,323,5384,4,75,5463
subtest22of10,pubtest219of100,1,323,5384,6,113,5503
subtest21of10,pubtest219of100,1,323,5384,6,153,5543
subtest26of10,pubtest219of100,1,323,5384,5,195,5584
subtest29of10,pubtest219of100,1,323,5384,17,223,5624
subtest24of10,pubtest219of100,1,323,5384,15,261,5660
subtest28of10,pubtest219of100,1,323,5384,18,301,5703
subtest23of10,pubtest219of100,1,323,5384,18,341,5743
subtest27of10,pubtest219of100,1,323,5384,23,376,5783
subtest210of10,pubtest220of100,1,323,5200,-1,41,5240
subtest25of10,pubtest220of100,1,323,5200,-3,80,5277
subtest29of10,pubtest220of100,1,323,5200,4,115,5319
subtest23of10,pubtest220of100,1,323,5200,4,155,5359
subtest24of10,pubtest220of100,1,323,5200,7,192,5399
subtest21of10,pubtest220of100,1,323,5200,12,227,5439
subtest27of10,pubtest220of100,1,323,5200,12,267,5479
subtest28of10,pubtest220of100,1,323,5200,14,305,5519
subtest26of10,pubtest220of100,1,323,5200,17,342,5559
subtest22of10,pubtest220of100,1,323,5200,17,377,5594
subtest24of10,pubtest221of100,1,323,5195,1,47,5243
subtest23of10,pubtest221of100,1,323,5195,3,84,5282
subtest21of10,pubtest221of100,1,323,5195,4,123,5322
subtest28of10,pubtest221of100,1,323,5195,2,162,5359
subtest22of10,pubtest221of100,1,323,5195,7,198,5400
subtest210of10,pubtest221of100,1,323,5195,12,235,5442
subtest25of10,pubtest221of100,1,323,5195,12,275,5482
subtest26of10,pubtest221of100,1,323,5195,20,307,5522
subtest29of10,pubtest221of100,1,323,5195,21,346,5562
subtest27of10,pubtest221of100,1,323,5195,28,379,5602
subtest22of10,pubtest222of100,1,323,5200,3,46,5249
subtest21of10,pubtest222of100,1,323,5200,4,112,5316
subtest29of10,pubtest222of100,1,323,5200,7,149,5356
subtest27of10,pubtest222of100,1,323,5200,7,189,5396
subtest23of10,pubtest222of100,1,323,5200,14,222,5436
subtest25of10,pubtest222of100,1,323,5200,23,253,5476
subtest28of10,pubtest222of100,1,323,5200,23,293,5516
subtest26of10,pubtest222of100,1,323,5200,26,331,5557
subtest210of10,pubtest222of100,1,323,5200,26,369,5595
subtest24of10,pubtest222of100,1,323,5200,27,409,5636
subtest21of10,pubtest223of100,1,323,5240,5,43,5288
subtest28of10,pubtest223of100,1,323,5240,6,79,5325
subtest24of10,pubtest223of100,1,323,5240,7,118,5365
subtest23of10,pubtest223of100,1,323,5240,7,158,5405
subtest210of10,pubtest223of100,1,323,5240,11,194,5445
subtest27of10,pubtest223of100,1,323,5240,11,234,5485
subtest29of10,pubtest223of100,1,323,5240,11,273,5524
subtest22of10,pubtest223of100,1,323,5240,13,312,5565
subtest25of10,pubtest223of100,1,323,5240,13,351,5604
subtest26of10,pubtest223of100,1,323,5240,14,391,5645
subtest21of10,pubtest224of100,1,323,5194,5,38,5237
subtest27of10,pubtest224of100,1,323,5194,9,74,5277
subtest29of10,pubtest224of100,1,323,5194,11,111,5316
subtest23of10,pubtest224of100,1,323,5194,11,151,5356
subtest28of10,pubtest224of100,1,323,5194,10,190,5394
subtest25of10,pubtest224of100,1,323,5194,45,197,5436
subtest26of10,pubtest224of100,1,323,5194,45,236,5475
subtest22of10,pubtest224of100,1,323,5194,47,274,5515
subtest210of10,pubtest224of100,1,323,5194,49,313,5556
subtest24of10,pubtest224of100,1,323,5194,47,352,5593
subtest27of10,pubtest225of100,1,323,5289,3,38,5330
subtest22of10,pubtest225of100,1,323,5289,4,76,5369
subtest21of10,pubtest225of100,1,323,5289,5,115,5409
subtest26of10,pubtest225of100,1,323,5289,7,153,5449
subtest25of10,pubtest225of100,1,323,5289,14,185,5488
subtest24of10,pubtest225of100,1,323,5289,14,225,5528
subtest23of10,pubtest225of100,1,323,5289,17,263,5569
subtest28of10,pubtest225of100,1,323,5289,20,300,5609
subtest29of10,pubtest225of100,1,323,5289,26,334,5649
subtest210of10,pubtest225of100,1,323,5289,27,372,5688
subtest22of10,pubtest226of100,1,323,5320,3,38,5361
subtest25of10,pubtest226of100,1,323,5320,3,79,5402
subtest26of10,pubtest226of100,1,323,5320,6,117,5443
subtest29of10,pubtest226of100,1,323,5320,8,155,5483
subtest27of10,pubtest226of100,1,323,5320,6,195,5521
subtest21of10,pubtest226of100,1,323,5320,6,234,5560
subtest210of10,pubtest226of100,1,323,5320,6,273,5599
subtest23of10,pubtest226of100,1,323,5320,9,312,5641
subtest24of10,pubtest226of100,1,323,5320,11,351,5682
subtest28of10,pubtest226of100,1,323,5320,6,391,5717
subtest29of10,pubtest227of100,1,323,5190,4,41,5235
subtest210of10,pubtest227of100,1,323,5190,11,72,5273
subtest25of10,pubtest227of100,1,323,5190,12,111,5313
subtest23of10,pubtest227of100,1,323,5190,16,148,5354
subtest24of10,pubtest227of100,1,323,5190,17,186,5393
subtest27of10,pubtest227of100,1,323,5190,22,221,5433
subtest26of10,pubtest227of100,1,323,5190,25,258,5473
subtest21of10,pubtest227of100,1,323,5190,28,295,5513
subtest22of10,pubtest227of100,1,323,5190,31,330,5551
subtest28of10,pubtest227of100,1,323,5190,32,369,5591
subtest21of10,pubtest228of100,1,323,5246,-4,41,5283
subtest25of10,pubtest228of100,1,323,5246,0,76,5322
subtest26of10,pubtest228of100,1,323,5246,1,115,5362
subtest23of10,pubtest228of100,1,323,5246,5,151,5402
subtest24of10,pubtest228of100,1,323,5246,6,190,5442
subtest27of10,pubtest228of100,1,323,5246,16,220,5482
subtest29of10,pubtest228of100,1,323,5246,17,258,5521
subtest210of10,pubtest228of100,1,323,5246,23,293,5562
subtest22of10,pubtest228of100,1,323,5246,26,330,5602
subtest28of10,pubtest228of100,1,323,5246,27,369,5642
subtest24of10,pubtest229of100,1,321,5240,-6,43,5277
subtest21of10,pubtest229of100,1,321,5240,-3,80,5317
subtest28of10,pubtest229of100,1,321,5240,-1,117,5356
subtest27of10,pubtest229of100,1,321,5240,4,152,5396
subtest23of10,pubtest229of100,1,321,5240,10,186,5436
subtest22of10,pubtest229of100,1,321,5240,12,224,5476
subtest25of10,pubtest229of100,1,321,5240,15,261,5516
subtest29of10,pubtest229of100,1,321,5240,22,294,5556
subtest210of10,pubtest229of100,1,321,5240,25,331,5596
subtest26of10,pubtest229of100,1,321,5240,28,368,5636
subtest22of10,pubtest230of100,1,323,5210,3,41,5254
subtest27of10,pubtest230of100,1,323,5210,9,76,5295
subtest21of10,pubtest230of100,1,323,5210,9,115,5334
subtest29of10,pubtest230of100,1,323,5210,13,152,5375
subtest28of10,pubtest230of100,1,323,5210,13,191,5414
subtest25of10,pubtest230of100,1,323,5210,15,231,5456
subtest23of10,pubtest230of100,1,323,5210,15,271,5496
subtest210of10,pubtest230of100,1,323,5210,19,306,5535
subtest24of10,pubtest230of100,1,323,5210,19,346,5575
subtest26of10,pubtest230of100,1,323,5210,21,384,5615
subtest23of10,pubtest231of100,1,323,5313,3,39,5355
subtest28of10,pubtest231of100,1,323,5313,3,77,5393
subtest25of10,pubtest231of100,1,323,5313,5,116,5434
subtest24of10,pubtest231of100,1,323,5313,5,155,5473
subtest29of10,pubtest231of100,1,323,5313,7,194,5514
subtest22of10,pubtest231of100,1,323,5313,8,233,5554
subtest21of10,pubtest231of100,1,323,5313,8,273,5594
subtest26of10,pubtest231of100,1,323,5313,8,313,5634
subtest210of10,pubtest231of100,1,323,5313,9,352,5674
subtest27of10,pubtest231of100,1,323,5313,8,389,5710
subtest27of10,pubtest232of100,1,323,5247,5,183,5435
subtest23of10,pubtest232of100,1,323,5247,18,205,5470
subtest22of10,pubtest232of100,1,323,5247,18,244,5509
subtest21of10,pubtest232of100,1,323,5247,1,301,5549
subtest29of10,pubtest232of100,1,323,5247,22,320,5589
subtest25of10,pubtest232of100,1,323,5247,24,358,5629
subtest26of10,pubtest232of100,1,323,5247,186,237,5670
subtest210of10,pubtest232of100,1,323,5247,186,276,5709
subtest28of10,pubtest232of100,1,323,5247,187,314,5748
subtest24of10,pubtest232of100,1,323,5247,189,353,5789
subtest29of10,pubtest233of100,1,323,5220,13,43,5276
subtest24of10,pubtest233of100,1,323,5220,14,80,5314
subtest25of10,pubtest233of100,1,323,5220,18,115,5353
subtest21of10,pubtest233of100,1,323,5220,19,155,5394
subtest26of10,pubtest233of100,1,323,5220,20,194,5434
subtest22of10,pubtest233of100,1,323,5220,20,234,5474
subtest210of10,pubtest233of100,1,323,5220,15,273,5508
subtest28of10,pubtest233of100,1,323,5220,18,313,5551
subtest23of10,pubtest233of100,1,323,5220,22,351,5593
subtest27of10,pubtest233of100,1,323,5220,16,393,5629
subtest25of10,pubtest234of100,1,323,5413,-1,425,5837
subtest26of10,pubtest234of100,1,323,5413,0,460,5873
subtest27of10,pubtest234of100,1,323,5413,0,501,5914
subtest22of10,pubtest234of100,1,323,5413,3,537,5953
subtest21of10,pubtest234of100,1,323,5413,6,574,5993
subtest210of10,pubtest234of100,1,323,5413,11,609,6033
subtest29of10,pubtest234of100,1,323,5413,12,648,6073
subtest23of10,pubtest234of100,1,323,5413,17,683,6113
subtest24of10,pubtest234of100,1,323,5413,20,720,6153
subtest28of10,pubtest234of100,1,323,5413,21,759,6193
subtest21of10,pubtest235of100,1,321,5540,-3,40,5577
subtest210of10,pubtest235of100,1,321,5540,-3,80,5617
subtest22of10,pubtest235of100,1,321,5540,-1,117,5656
subtest23of10,pubtest235of100,1,321,5540,0,157,5697
subtest27of10,pubtest235of100,1,321,5540,1,195,5736
subtest29of10,pubtest235of100,1,321,5540,7,229,5776
subtest24of10,pubtest235of100,1,321,5540,10,266,5816
subtest26of10,pubtest235of100,1,321,5540,11,305,5856
subtest25of10,pubtest235of100,1,321,5540,10,345,5895
subtest28of10,pubtest235of100,1,321,5540,14,382,5936
subtest210of10,pubtest236of100,1,323,5315,-2,41,5354
subtest23of10,pubtest236of100,1,323,5315,-2,80,5393
subtest27of10,pubtest236of100,1,323,5315,5,112,5432
subtest28of10,pubtest236of100,1,323,5315,5,152,5472
subtest25of10,pubtest236of100,1,323,5315,9,190,5514
subtest21of10,pubtest236of100,1,323,5315,11,225,5551
subtest26of10,pubtest236of100,1,323,5315,13,265,5593
subtest24of10,pubtest236of100,1,323,5315,14,304,5633
subtest29of10,pubtest236of100,1,323,5315,14,344,5673
subtest22of10,pubtest236of100,1,323,5315,16,382,5713
subtest24of10,pubtest237of100,1,323,5209,7,39,5255
subtest28of10,pubtest237of100,1,323,5209,8,78,5295
subtest23of10,pubtest237of100,1,323,5209,8,114,5331
subtest25of10,pubtest237of100,1,323,5209,12,153,5374
subtest26of10,pubtest237of100,1,323,5209,13,192,5414
subtest29of10,pubtest237of100,1,323,5209,14,230,5453
subtest27of10,pubtest237of100,1,323,5209,13,270,5492
subtest210of10,pubtest237of100,1,323,5209,16,309,5534
subtest22of10,pubtest237of100,1,323,5209,16,349,5574
subtest21of10,pubtest237of100,1,323,5209,18,387,5614
subtest22of10,pubtest238of100,1,323,5285,13,134,5432
subtest29of10,pubtest238of100,1,323,5285,12,177,5474
subtest27of10,pubtest238of100,1,323,5285,14,214,5513
subtest25of10,pubtest238of100,1,323,5285,16,251,5552
subtest28of10,pubtest238of100,1,323,5285,17,290,5592
subtest21of10,pubtest238of100,1,323,5285,17,330,5632
subtest23of10,pubtest238of100,1,323,5285,16,369,5670
subtest210of10,pubtest238of100,1,323,5285,52,375,5712
subtest26of10,pubtest238of100,1,323,5285,54,413,5752
subtest24of10,pubtest238of100,1,323,5285,54,453,5792
subtest21of10,pubtest239of100,1,323,5188,10,40,5238
subtest28of10,pubtest239of100,1,323,5188,11,77,5276
subtest27of10,pubtest239of100,1,323,5188,13,115,5316
subtest26of10,pubtest239of100,1,323,5188,22,146,5356
subtest24of10,pubtest239of100,1,323,5188,25,183,5396
subtest29of10,pubtest239of100,1,323,5188,30,218,5436
subtest25of10,pubtest239of100,1,323,5188,30,258,5476
subtest23of10,pubtest239of100,1,323,5188,34,294,5516
subtest210of10,pubtest239of100,1,323,5188,39,329,5556
subtest22of10,pubtest239of100,1,323,5188,39,369,5596
subtest25of10,pubtest240of100,1,323,5239,8,41,5288
subtest21of10,pubtest240of100,1,323,5239,16,72,5327
subtest210of10,pubtest240of100,1,323,5239,18,111,5368
subtest29of10,pubtest240of100,1,323,5239,16,151,5406
subtest27of10,pubtest240of100,1,323,5239,21,187,5447
subtest28of10,pubtest240of100,1,323,5239,25,223,5487
subtest23of10,pubtest240of100,1,323,5239,29,259,5527
subtest24of10,pubtest240of100,1,323,5239,30,298,5567
subtest22of10,pubtest240of100,1,323,5239,33,335,5607
subtest26of10,pubtest240of100,1,323,5239,34,375,5648
subtest23of10,pubtest241of100,1,323,5170,6,41,5217
subtest27of10,pubtest241of100,1,323,5170,9,77,5256
subtest210of10,pubtest241of100,1,323,5170,11,115,5296
subtest21of10,pubtest241of100,1,323,5170,11,155,5336
subtest28of10,pubtest241of100,1,323,5170,13,193,5376
subtest26of10,pubtest241of100,1,323,5170,14,233,5417
subtest25of10,pubtest241of100,1,323,5170,13,272,5455
subtest24of10,pubtest241of100,1,323,5170,9,314,5493
subtest29of10,pubtest241of100,1,323,5170,12,351,5533
subtest22of10,pubtest241of100,1,323,5170,20,386,5576
subtest27of10,pubtest242of100,1,323,5304,-5,39,5338
subtest26of10,pubtest242of100,1,323,5304,0,73,5377
subtest23of10,pubtest242of100,1,323,5304,1,112,5417
subtest25of10,pubtest242of100,1,323,5304,11,142,5457
subtest210of10,pubtest242of100,1,323,5304,12,181,5497
subtest29of10,pubtest242of100,1,323,5304,13,220,5537
subtest21of10,pubtest242of100,1,323,5304,24,249,5577
subtest22of10,pubtest242of100,1,323,5304,24,289,5617
subtest24of10,pubtest242of100,1,323,5304,24,326,5654
subtest28of10,pubtest242of100,1,323,5304,30,363,5697
subtest28of10,pubtest243of100,1,323,5170,6,40,5216
subtest29of10,pubtest243of100,1,323,5170,6,79,5255
subtest22of10,pubtest243of100,1,323,5170,7,118,5295
subtest23of10,pubtest243of100,1,323,5170,30,135,5335
subtest26of10,pubtest243of100,1,323,5170,39,165,5374
subtest25of10,pubtest243of100,1,323,5170,42,203,5415
subtest210of10,pubtest243of100,1,323,5170,42,243,5455
subtest24of10,pubtest243of100,1,323,5170,43,282,5495
subtest21of10,pubtest243of100,1,323,5170,45,320,5535
subtest27of10,pubtest243of100,1,323,5170,43,362,5575
subtest27of10,pubtest244of100,1,323,5203,10,44,5257
subtest26of10,pubtest244of100,1,323,5203,10,83,5296
subtest29of10,pubtest244of100,1,323,5203,13,119,5335
subtest21of10,pubtest244of100,1,323,5203,15,158,5376
subtest25of10,pubtest244of100,1,323,5203,15,198,5416
subtest28of10,pubtest244of100,1,323,5203,14,239,5456
subtest23of10,pubtest244of100,1,323,5203,24,269,5496
subtest210of10,pubtest244of100,1,323,5203,26,308,5537
subtest22of10,pubtest244of100,1,323,5203,29,344,5576
subtest24of10,pubtest244of100,1,323,5203,40,373,5616
subtest22of10,pubtest245of100,1,322,5156,8,38,5202
subtest29of10,pubtest245of100,1,322,5156,7,77,5240
subtest26of10,pubtest245of100,1,322,5156,7,117,5280
subtest23of10,pubtest245of100,1,322,5156,21,144,5321
subtest25of10,pubtest245of100,1,322,5156,24,181,5361
subtest21of10,pubtest245of100,1,322,5156,28,217,5401
subtest27of10,pubtest245of100,1,322,5156,33,252,5441
subtest24of10,pubtest245of100,1,322,5156,33,292,5481
subtest28of10,pubtest245of100,1,322,5156,37,326,5519
subtest210of10,pubtest245of100,1,322,5156,37,366,5559
subtest27of10,pubtest246of100,1,323,5203,-1,43,5245
subtest26of10,pubtest246of100,1,323,5203,0,81,5284
subtest21of10,pubtest246of100,1,323,5203,2,120,5325
subtest29of10,pubtest246of100,1,323,5203,2,159,5364
subtest28of10,pubtest246of100,1,323,5203,12,189,5404
subtest23of10,pubtest246of100,1,323,5203,13,229,5445
subtest25of10,pubtest246of100,1,323,5203,17,262,5482
subtest210of10,pubtest246of100,1,323,5203,19,302,5524
subtest22of10,pubtest246of100,1,323,5203,19,341,5563
subtest24of10,pubtest246of100,1,323,5203,19,381,5603
subtest27of10,pubtest247of100,1,323,5194,5,38,5237
subtest23of10,pubtest247of100,1,323,5194,6,76,5276
subtest22of10,pubtest247of100,1,323,5194,10,112,5316
subtest21of10,pubtest247of100,1,323,5194,11,152,5357
subtest26of10,pubtest247of100,1,323,5194,8,191,5393
subtest29of10,pubtest247of100,1,323,5194,23,219,5436
subtest28of10,pubtest247of100,1,323,5194,25,257,5476
subtest210of10,pubtest247of100,1,323,5194,25,297,5516
subtest25of10,pubtest247of100,1,323,5194,35,327,5556
subtest24of10,pubtest247of100,1,323,5194,36,368,5598
subtest29of10,pubtest248of100,1,323,5208,-4,42,5246
subtest25of10,pubtest248of100,1,323,5208,-1,81,5288
subtest26of10,pubtest248of100,1,323,5208,0,119,5327
subtest23of10,pubtest248of100,1,323,5208,1,157,5366
subtest28of10,pubtest248of100,1,323,5208,9,188,5405
subtest27of10,pubtest248of100,1,323,5208,9,228,5445
subtest24of10,pubtest248of100,1,323,5208,11,267,5486
subtest21of10,pubtest248of100,1,323,5208,12,306,5526
subtest210of10,pubtest248of100,1,323,5208,13,345,5566
subtest22of10,pubtest248of100,1,323,5208,13,385,5606
subtest27of10,pubtest249of100,1,323,5289,1,42,5332
subtest28of10,pubtest249of100,1,323,5289,2,80,5371
subtest25of10,pubtest249of100,1,323,5289,3,120,5412
subtest21of10,pubtest249of100,1,323,5289,4,158,5451
subtest24of10,pubtest249of100,1,323,5289,4,197,5490
subtest29of10,pubtest249of100,1,323,5289,12,230,5531
subtest26of10,pubtest249of100,1,323,5289,13,269,5571
subtest22of10,pubtest249of100,1,323,5289,17,305,5611
subtest23of10,pubtest249of100,1,323,5289,17,345,5651
subtest210of10,pubtest249of100,1,323,5289,24,378,5691
subtest27of10,pubtest250of100,1,323,5218,-4,42,5256
subtest21of10,pubtest250of100,1,323,5218,9,67,5294
subtest29of10,pubtest250of100,1,323,5218,9,106,5333
subtest210of10,pubtest250of100,1,323,5218,13,144,5375
subtest22of10,pubtest250of100,1,323,5218,14,182,5414
subtest26of10,pubtest250of100,1,323,5218,15,221,5454
subtest24of10,pubtest250of100,1,323,5218,15,261,5494
subtest23of10,pubtest250of100,1,323,5218,8,300,5526
subtest25of10,pubtest250of100,1,323,5218,16,340,5574
subtest28of10,pubtest250of100,1,323,5218,8,380,5606
subtest29of10,pubtest251of100,1,323,5208,164,42,5414
subtest23of10,pubtest251of100,1,323,5208,-1,247,5454
subtest22of10,pubtest251of100,1,323,5208,164,121,5493
subtest24of10,pubtest251of100,1,323,5208,164,160,5532
subtest25of10,pubtest251of100,1,323,5208,165,199,5572
subtest210of10,pubtest251of100,1,323,5208,167,240,5615
subtest21of10,pubtest251of100,1,323,5208,164,278,5650
subtest27of10,pubtest251of100,1,323,5208,169,317,5694
subtest26of10,pubtest251of100,1,323,5208,165,357,5730
subtest28of10,pubtest251of100,1,323,5208,170,396,5774
subtest29of10,pubtest252of100,1,323,5342,2,46,5390
subtest28of10,pubtest252of100,1,323,5342,2,85,5429
subtest21of10,pubtest252of100,1,323,5342,7,119,5468
subtest26of10,pubtest252of100,1,323,5342,9,157,5508
subtest27of10,pubtest252of100,1,323,5342,12,194,5548
subtest25of10,pubtest252of100,1,323,5342,13,233,5588
subtest22of10,pubtest252of100,1,323,5342,14,271,5627
subtest24of10,pubtest252of100,1,323,5342,26,299,5667
subtest210of10,pubtest252of100,1,323,5342,27,337,5706
subtest23of10,pubtest252of100,1,323,5342,30,376,5748
subtest28of10,pubtest253of100,1,322,5227,-1,40,5266
subtest23of10,pubtest253of100,1,322,5227,-1,80,5306
subtest29of10,pubtest253of100,1,322,5227,11,106,5344
subtest24of10,pubtest253of100,1,322,5227,12,146,5385
subtest25of10,pubtest253of100,1,322,5227,12,185,5424
subtest21of10,pubtest253of100,1,322,5227,16,227,5470
subtest22of10,pubtest253of100,1,322,5227,16,266,5509
subtest27of10,pubtest253of100,1,322,5227,16,305,5548
subtest210of10,pubtest253of100,1,322,5227,21,341,5589
subtest26of10,pubtest253of100,1,322,5227,72,330,5629
subtest28of10,pubtest254of100,1,323,5236,14,39,5289
subtest210of10,pubtest254of100,1,323,5236,11,82,5329
subtest25of10,pubtest254of100,1,323,5236,15,117,5368
subtest27of10,pubtest254of100,1,323,5236,12,157,5405
subtest21of10,pubtest254of100,1,323,5236,15,195,5446
subtest29of10,pubtest254of100,1,323,5236,18,234,5488
subtest24of10,pubtest254of100,1,323,5236,19,275,5530
subtest23of10,pubtest254of100,1,323,5236,17,314,5567
subtest22of10,pubtest254of100,1,323,5236,23,349,5608
subtest26of10,pubtest254of100,1,323,5236,23,389,5648
subtest23of10,pubtest255of100,1,322,5216,6,40,5262
subtest22of10,pubtest255of100,1,322,5216,7,78,5301
subtest28of10,pubtest255of100,1,322,5216,9,117,5342
subtest27of10,pubtest255of100,1,322,5216,10,155,5381
subtest29of10,pubtest255of100,1,322,5216,12,193,5421
subtest24of10,pubtest255of100,1,322,5216,14,232,5462
subtest210of10,pubtest255of100,1,322,5216,22,264,5502
subtest26of10,pubtest255of100,1,322,5216,24,299,5539
subtest21of10,pubtest255of100,1,322,5216,29,336,5581
subtest25of10,pubtest255of100,1,322,5216,30,376,5622
subtest29of10,pubtest256of100,1,323,5190,-1,40,5229
subtest21of10,pubtest256of100,1,323,5190,1,77,5268
subtest26of10,pubtest256of100,1,323,5190,6,112,5308
subtest23of10,pubtest256of100,1,323,5190,7,151,5348
subtest25of10,pubtest256of100,1,323,5190,8,188,5386
subtest210of10,pubtest256of100,1,323,5190,10,228,5428
subtest28of10,pubtest256of100,1,323,5190,26,252,5468
subtest27of10,pubtest256of100,1,323,5190,26,292,5508
subtest22of10,pubtest256of100,1,323,5190,31,326,5547
subtest24of10,pubtest256of100,1,323,5190,32,367,5589
subtest24of10,pubtest257of100,1,323,5269,-2,48,5315
subtest21of10,pubtest257of100,1,323,5269,1,82,5352
subtest27of10,pubtest257of100,1,323,5269,5,118,5392
subtest22of10,pubtest257of100,1,323,5269,5,158,5432
subtest28of10,pubtest257of100,1,323,5269,4,198,5471
subtest210of10,pubtest257of100,1,323,5269,14,230,5513
subtest23of10,pubtest257of100,1,323,5269,14,267,5550
subtest25of10,pubtest257of100,1,323,5269,16,309,5594
subtest26of10,pubtest257of100,1,323,5269,16,348,5633
subtest29of10,pubtest257of100,1,323,5269,16,386,5671
subtest28of10,pubtest258of100,1,323,5198,1,39,5238
subtest23of10,pubtest258of100,1,323,5198,2,79,5279
subtest25of10,pubtest258of100,1,323,5198,4,116,5318
subtest21of10,pubtest258of100,1,323,5198,5,155,5358
subtest26of10,pubtest258of100,1,323,5198,5,195,5398
subtest29of10,pubtest258of100,1,323,5198,7,233,5438
subtest210of10,pubtest258of100,1,323,5198,16,264,5478
subtest27of10,pubtest258of100,1,323,5198,20,298,5516
subtest22of10,pubtest258of100,1,323,5198,22,338,5558
subtest24of10,pubtest258of100,1,323,5198,23,377,5598
subtest21of10,pubtest259of100,1,323,5227,-2,39,5264
subtest28of10,pubtest259of100,1,323,5227,5,71,5303
subtest25of10,pubtest259of100,1,323,5227,6,109,5342
subtest24of10,pubtest259of100,1,323,5227,8,148,5383
subtest27of10,pubtest259of100,1,323,5227,11,185,5423
subtest23of10,pubtest259of100,1,323,5227,11,225,5463
subtest26of10,pubtest259of100,1,323,5227,28,248,5503
subtest29of10,pubtest259of100,1,323,5227,28,288,5543
subtest22of10,pubtest259of100,1,323,5227,32,324,5583
subtest210of10,pubtest259of100,1,323,5227,34,362,5623
subtest210of10,pubtest260of100,1,323,5172,3,42,5217
subtest23of10,pubtest260of100,1,323,5172,4,79,5255
subtest21of10,pubtest260of100,1,323,5172,6,117,5295
subtest26of10,pubtest260of100,1,323,5172,6,157,5335
subtest27of10,pubtest260of100,1,323,5172,7,196,5375
subtest29of10,pubtest260of100,1,323,5172,9,234,5415
subtest22of10,pubtest260of100,1,323,5172,9,506,5687
subtest28of10,pubtest260of100,1,323,5172,9,545,5726
subtest25of10,pubtest260of100,1,323,5172,9,584,5765
subtest24of10,pubtest260of100,1,323,5172,13,622,5807
subtest25of10,pubtest261of100,1,323,5174,5,42,5221
subtest28of10,pubtest261of100,1,323,5174,7,533,5714
subtest23of10,pubtest261of100,1,323,5174,13,565,5752
subtest29of10,pubtest261of100,1,323,5174,13,604,5791
subtest210of10,pubtest261of100,1,323,5174,23,635,5832
subtest27of10,pubtest261of100,1,323,5174,22,675,5871
subtest22of10,pubtest261of100,1,323,5174,26,712,5912
subtest24of10,pubtest261of100,1,323,5174,26,752,5952
subtest21of10,pubtest261of100,1,323,5174,23,790,5987
subtest26of10,pubtest261of100,1,323,5174,29,829,6032
subtest21of10,pubtest262of100,1,323,5264,6,228,5498
subtest22of10,pubtest262of100,1,323,5264,7,228,5499
subtest210of10,pubtest262of100,1,323,5264,10,264,5538
subtest25of10,pubtest262of100,1,323,5264,12,303,5579
subtest27of10,pubtest262of100,1,323,5264,11,343,5618
subtest23of10,pubtest262of100,1,323,5264,10,384,5658
subtest29of10,pubtest262of100,1,323,5264,13,422,5699
subtest28of10,pubtest262of100,1,323,5264,14,460,5738
subtest26of10,pubtest262of100,1,323,5264,15,500,5779
subtest24of10,pubtest262of100,1,323,5264,14,538,5816
subtest22of10,pubtest263of100,1,322,5245,-1,43,5287
subtest29of10,pubtest263of100,1,322,5245,1,80,5326
subtest23of10,pubtest263of100,1,322,5245,2,118,5365
subtest25of10,pubtest263of100,1,322,5245,3,157,5405
subtest27of10,pubtest263of100,1,322,5245,4,196,5445
subtest24of10,pubtest263of100,1,322,5245,8,232,5485
subtest21of10,pubtest263of100,1,322,5245,10,270,5525
subtest26of10,pubtest263of100,1,322,5245,11,309,5565
subtest210of10,pubtest263of100,1,322,5245,13,345,5603
subtest28of10,pubtest263of100,1,322,5245,20,380,5645
subtest27of10,pubtest264of100,1,322,5161,6,39,5206
subtest22of10,pubtest264of100,1,322,5161,3,82,5246
subtest29of10,pubtest264of100,1,322,5161,4,120,5285
subtest24of10,pubtest264of100,1,322,5161,5,159,5325
subtest23of10,pubtest264of100,1,322,5161,6,198,5365
subtest28of10,pubtest264of100,1,322,5161,8,234,5403
subtest26of10,pubtest264of100,1,322,5161,11,273,5445
subtest21of10,pubtest264of100,1,322,5161,8,313,5482
subtest210of10,pubtest264of100,1,322,5161,12,352,5525
subtest25of10,pubtest264of100,1,322,5161,13,391,5565
subtest27of10,pubtest265of100,1,323,5232,9,41,5282
subtest26of10,pubtest265of100,1,323,5232,9,79,5320
subtest210of10,pubtest265of100,1,323,5232,12,117,5361
subtest21of10,pubtest265of100,1,323,5232,12,157,5401
subtest22of10,pubtest265of100,1,323,5232,14,195,5441
subtest28of10,pubtest265of100,1,323,5232,16,233,5481
subtest23of10,pubtest265of100,1,323,5232,16,275,5523
subtest25of10,pubtest265of100,1,323,5232,17,313,5562
subtest24of10,pubtest265of100,1,323,5232,18,352,5602
subtest29of10,pubtest265of100,1,323,5232,15,391,5638
subtest29of10,pubtest266of100,1,321,5419,1,38,5458
subtest25of10,pubtest266of100,1,321,5419,2,76,5497
subtest210of10,pubtest266of100,1,321,5419,1,115,5535
subtest27of10,pubtest266of100,1,321,5419,7,151,5577
subtest26of10,pubtest266of100,1,321,5419,10,188,5617
subtest23of10,pubtest266of100,1,321,5419,10,228,5657
subtest21of10,pubtest266of100,1,321,5419,12,264,5695
subtest28of10,pubtest266of100,1,321,5419,12,304,5735
subtest24of10,pubtest266of100,1,321,5419,35,323,5777
subtest22of10,pubtest266of100,1,321,5419,36,362,5817
subtest23of10,pubtest267of100,1,323,5744,-2,45,5787
subtest26of10,pubtest267of100,1,323,5744,-2,84,5826
subtest25of10,pubtest267of100,1,323,5744,0,122,5866
subtest27of10,pubtest267of100,1,323,5744,3,159,5906
subtest28of10,pubtest267of100,1,323,5744,5,197,5946
subtest29of10,pubtest267of100,1,323,5744,6,236,5986
subtest21of10,pubtest267of100,1,323,5744,12,270,6026
subtest22of10,pubtest267of100,1,323,5744,14,308,6066
subtest24of10,pubtest267of100,1,323,5744,14,350,6108
subtest210of10,pubtest267of100,1,323,5744,17,386,6147
subtest23of10,pubtest268of100,1,323,5176,-1,44,5219
subtest24of10,pubtest268of100,1,323,5176,0,81,5257
subtest29of10,pubtest268of100,1,323,5176,2,119,5297
subtest25of10,pubtest268of100,1,323,5176,1,158,5335
subtest28of10,pubtest268of100,1,323,5176,9,193,5378
subtest27of10,pubtest268of100,1,323,5176,11,231,5418
subtest21of10,pubtest268of100,1,323,5176,11,271,5458
subtest22of10,pubtest268of100,1,323,5176,12,310,5498
subtest210of10,pubtest268of100,1,323,5176,13,349,5538
subtest26of10,pubtest268of100,1,323,5176,18,384,5578
subtest24of10,pubtest269of100,1,323,5472,-5,41,5508
subtest27of10,pubtest269of100,1,323,5472,-3,79,5548
subtest210of10,pubtest269of100,1,323,5472,-2,118,5588
subtest25of10,pubtest269of100,1,323,5472,-1,157,5628
subtest21of10,pubtest269of100,1,323,5472,0,195,5667
subtest23of10,pubtest269of100,1,323,5472,12,225,5709
subtest29of10,pubtest269of100,1,323,5472,11,265,5748
subtest22of10,pubtest269of100,1,323,5472,13,303,5788
subtest26of10,pubtest269of100,1,323,5472,13,343,5828
subtest28of10,pubtest269of100,1,323,5472,18,378,5868
subtest23of10,pubtest270of100,1,323,5208,1,42,5251
subtest26of10,pubtest270of100,1,323,5208,3,78,5289
subtest210of10,pubtest270of100,1,323,5208,4,116,5328
subtest28of10,pubtest270of100,1,323,5208,5,156,5369
subtest25of10,pubtest270of100,1,323,5208,6,195,5409
subtest29of10,pubtest270of100,1,323,5208,6,235,5449
subtest27of10,pubtest270of100,1,323,5208,7,274,5489
subtest21of10,pubtest270of100,1,323,5208,12,309,5529
subtest22of10,pubtest270of100,1,323,5208,13,349,5570
subtest24of10,pubtest270of100,1,323,5208,14,388,5610
subtest24of10,pubtest271of100,1,323,5205,-3,40,5242
subtest27of10,pubtest271of100,1,323,5205,6,71,5282
subtest210of10,pubtest271of100,1,323,5205,5,111,5321
subtest22of10,pubtest271of100,1,323,5205,5,150,5360
subtest23of10,pubtest271of100,1,323,5205,8,189,5402
subtest21of10,pubtest271of100,1,323,5205,11,226,5442
subtest25of10,pubtest271of100,1,323,5205,5,266,5476
subtest26of10,pubtest271of100,1,323,5205,6,305,5516
subtest28of10,pubtest271of100,1,323,5205,14,343,5562
subtest29of10,pubtest271of100,1,323,5205,14,384,5603
subtest25of10,pubtest272of100,1,323,5167,-3,38,5202
subtest26of10,pubtest272of100,1,323,5167,5,67,5239
subtest29of10,pubtest272of100,1,323,5167,6,106,5279
subtest21of10,pubtest272of100,1,323,5167,5,146,5318
subtest23of10,pubtest272of100,1,323,5167,9,184,5360
subtest24of10,pubtest272of100,1,323,5167,9,224,5400
subtest210of10,pubtest272of100,1,323,5167,12,262,5441
subtest27of10,pubtest272of100,1,323,5167,12,302,5481
subtest22of10,pubtest272of100,1,323,5167,13,341,5521
subtest28of10,pubtest272of100,1,323,5167,15,379,5561
subtest29of10,pubtest273of100,1,321,5346,0,42,5388
subtest22of10,pubtest273of100,1,321,5346,0,81,5427
subtest26of10,pubtest273of100,1,321,5346,2,119,5467
subtest28of10,pubtest273of100,1,321,5346,5,156,5507
subtest25of10,pubtest273of100,1,321,5346,6,195,5547
subtest210of10,pubtest273of100,1,321,5346,10,231,5587
subtest27of10,pubtest273of100,1,321,5346,15,267,5628
subtest23of10,pubtest273of100,1,321,5346,16,305,5667
subtest21of10,pubtest273of100,1,321,5346,18,343,5707
subtest24of10,pubtest273of100,1,321,5346,22,379,5747
subtest21of10,pubtest274of100,1,323,5234,0,39,5273
subtest26of10,pubtest274of100,1,323,5234,2,75,5311
subtest23of10,pubtest274of100,1,323,5234,5,112,5351
subtest22of10,pubtest274of100,1,323,5234,6,152,5392
subtest29of10,pubtest274of100,1,323,5234,8,189,5431
subtest28of10,pubtest274of100,1,323,5234,11,226,5471
subtest25of10,pubtest274of100,1,323,5234,15,262,5511
subtest27of10,pubtest274of100,1,323,5234,18,299,5551
subtest24of10,pubtest274of100,1,323,5234,18,339,5591
subtest210of10,pubtest274of100,1,323,5234,21,374,5629
subtest27of10,pubtest275of100,1,323,5193,-2,41,5232
subtest29of10,pubtest275of100,1,323,5193,2,76,5271
subtest25of10,pubtest275of100,1,323,5193,2,116,5311
subtest24of10,pubtest275of100,1,323,5193,10,148,5351
subtest21of10,pubtest275of100,1,323,5193,10,188,5391
subtest23of10,pubtest275of100,1,323,5193,12,226,5431
subtest210of10,pubtest275of100,1,323,5193,17,261,5471
subtest22of10,pubtest275of100,1,323,5193,15,301,5509
subtest26of10,pubtest275of100,1,323,5193,19,339,5551
subtest28of10,pubtest275of100,1,323,5193,22,376,5591
subtest28of10,pubtest276of100,1,323,5205,-1,38,5242
subtest21of10,pubtest276of100,1,323,5205,1,75,5281
subtest25of10,pubtest276of100,1,323,5205,7,109,5321
subtest29of10,pubtest276of100,1,323,5205,12,144,5361
subtest24of10,pubtest276of100,1,323,5205,12,184,5401
subtest210of10,pubtest276of100,1,323,5205,14,223,5442
subtest26of10,pubtest276of100,1,323,5205,14,261,5480
subtest23of10,pubtest276of100,1,323,5205,14,301,5520
subtest27of10,pubtest276of100,1,323,5205,14,341,5560
subtest22of10,pubtest276of100,1,323,5205,17,379,5601
subtest29of10,pubtest277of100,1,323,5201,8,173,5382
subtest22of10,pubtest277of100,1,323,5201,6,213,5420
subtest21of10,pubtest277of100,1,323,5201,10,251,5462
subtest28of10,pubtest277of100,1,323,5201,13,288,5502
subtest27of10,pubtest277of100,1,323,5201,13,328,5542
subtest24of10,pubtest277of100,1,323,5201,15,368,5584
subtest210of10,pubtest277of100,1,323,5201,19,403,5623
subtest25of10,pubtest277of100,1,323,5201,23,438,5662
subtest23of10,pubtest277of100,1,323,5201,26,475,5702
subtest26of10,pubtest277of100,1,323,5201,33,508,5742
subtest29of10,pubtest278of100,1,323,5199,0,39,5238
subtest22of10,pubtest278of100,1,323,5199,0,78,5277
subtest28of10,pubtest278of100,1,323,5199,4,114,5317
subtest23of10,pubtest278of100,1,323,5199,5,153,5357
subtest21of10,pubtest278of100,1,323,5199,6,192,5397
subtest27of10,pubtest278of100,1,323,5199,25,213,5437
subtest26of10,pubtest278of100,1,323,5199,25,253,5477
subtest210of10,pubtest278of100,1,323,5199,31,287,5517
subtest24of10,pubtest278of100,1,323,5199,28,327,5554
subtest25of10,pubtest278of100,1,323,5199,28,367,5594
subtest28of10,pubtest279of100,1,323,5186,5,40,5231
subtest25of10,pubtest279of100,1,323,5186,6,79,5271
subtest21of10,pubtest279of100,1,323,5186,9,116,5311
subtest24of10,pubtest279of100,1,323,5186,12,153,5351
subtest26of10,pubtest279of100,1,323,5186,16,189,5391
subtest29of10,pubtest279of100,1,323,5186,17,228,5431
subtest27of10,pubtest279of100,1,323,5186,21,265,5472
subtest22of10,pubtest279of100,1,323,5186,22,303,5511
subtest210of10,pubtest279of100,1,323,5186,25,340,5551
subtest23of10,pubtest279of100,1,323,5186,25,379,5590
subtest27of10,pubtest280of100,1,323,5311,4,46,5361
subtest24of10,pubtest280of100,1,323,5311,5,84,5400
subtest26of10,pubtest280of100,1,323,5311,7,123,5441
subtest21of10,pubtest280of100,1,323,5311,8,157,5476
subtest23of10,pubtest280of100,1,323,5311,11,197,5519
subtest29of10,pubtest280of100,1,323,5311,11,236,5558
subtest210of10,pubtest280of100,1,323,5311,11,275,5597
subtest25of10,pubtest280of100,1,323,5311,15,315,5641
subtest28of10,pubtest280of100,1,323,5311,16,353,5680
subtest22of10,pubtest280of100,1,323,5311,17,393,5721
subtest24of10,pubtest281of100,1,323,5214,-3,49,5260
subtest23of10,pubtest281of100,1,323,5214,-3,88,5299
subtest27of10,pubtest281of100,1,323,5214,0,126,5340
subtest28of10,pubtest281of100,1,323,5214,1,166,5381
subtest25of10,pubtest281of100,1,323,5214,12,194,5420
subtest21of10,pubtest281of100,1,323,5214,19,226,5459
subtest29of10,pubtest281of100,1,323,5214,20,265,5499
subtest26of10,pubtest281of100,1,323,5214,21,305,5540
subtest22of10,pubtest281of100,1,323,5214,19,344,5577
subtest210of10,pubtest281of100,1,323,5214,22,384,5620
subtest23of10,pubtest282of100,1,323,5236,8,42,5286
subtest21of10,pubtest282of100,1,323,5236,21,69,5326
subtest24of10,pubtest282of100,1,323,5236,21,108,5365
subtest25of10,pubtest282of100,1,323,5236,23,146,5405
subtest27of10,pubtest282of100,1,323,5236,29,180,5445
subtest29of10,pubtest282of100,1,323,5236,29,218,5483
subtest26of10,pubtest282of100,1,323,5236,31,258,5525
subtest22of10,pubtest282of100,1,323,5236,30,298,5564
subtest210of10,pubtest282of100,1,323,5236,37,332,5605
subtest28of10,pubtest282of100,1,323,5236,40,369,5645
subtest24of10,pubtest283of100,1,323,5244,2,43,5289
subtest27of10,pubtest283of100,1,323,5244,5,79,5328
subtest22of10,pubtest283of100,1,323,5244,8,116,5368
subtest23of10,pubtest283of100,1,323,5244,16,148,5408
subtest28of10,pubtest283of100,1,323,5244,17,185,5446
subtest210of10,pubtest283of100,1,323,5244,22,222,5488
subtest25of10,pubtest283of100,1,323,5244,22,262,5528
subtest29of10,pubtest283of100,1,323,5244,24,300,5568
subtest21of10,pubtest283of100,1,323,5244,24,340,5608
subtest26of10,pubtest283of100,1,323,5244,27,377,5648
subtest25of10,pubtest284of100,1,323,5258,2,42,5302
subtest22of10,pubtest284of100,1,323,5258,3,80,5341
subtest210of10,pubtest284of100,1,323,5258,4,117,5379
subtest24of10,pubtest284of100,1,323,5258,6,157,5421
subtest27of10,pubtest284of100,1,323,5258,8,195,5461
subtest29of10,pubtest284of100,1,323,5258,8,235,5501
subtest28of10,pubtest284of100,1,323,5258,11,272,5541
subtest23of10,pubtest284of100,1,323,5258,12,313,5583
subtest21of10,pubtest284of100,1,323,5258,13,351,5622
subtest26of10,pubtest284of100,1,323,5258,17,386,5661
subtest23of10,pubtest285of100,1,323,5199,2,39,5240
subtest25of10,pubtest285of100,1,323,5199,4,76,5279
subtest27of10,pubtest285of100,1,323,5199,17,104,5320
subtest24of10,pubtest285of100,1,323,5199,17,143,5359
subtest21of10,pubtest285of100,1,323,5199,21,179,5399
subtest22of10,pubtest285of100,1,323,5199,24,216,5439
subtest29of10,pubtest285of100,1,323,5199,24,256,5479
subtest28of10,pubtest285of100,1,323,5199,26,294,5519
subtest210of10,pubtest285of100,1,323,5199,26,334,5559
subtest26of10,pubtest285of100,1,323,5199,27,371,5597
subtest23of10,pubtest286of100,1,323,5224,2,38,5264
subtest210of10,pubtest286of100,1,323,5224,7,72,5303
subtest25of10,pubtest286of100,1,323,5224,9,110,5343
subtest21of10,pubtest286of100,1,323,5224,12,147,5383
subtest24of10,pubtest286of100,1,323,5224,12,187,5423
subtest29of10,pubtest286of100,1,323,5224,12,224,5460
subtest26of10,pubtest286of100,1,323,5224,14,264,5502
subtest27of10,pubtest286of100,1,323,5224,14,302,5540
subtest22of10,pubtest286of100,1,323,5224,18,341,5583
subtest28of10,pubtest286of100,1,323,5224,24,375,5623
subtest26of10,pubtest287of100,1,323,5414,14,51,5479
subtest28of10,pubtest287of100,1,323,5414,16,89,5519
subtest210of10,pubtest287of100,1,323,5414,18,127,5559
subtest29of10,pubtest287of100,1,323,5414,21,164,5599
subtest25of10,pubtest287of100,1,323,5414,23,202,5639
subtest21of10,pubtest287of100,1,323,5414,24,241,5679
subtest24of10,pubtest287of100,1,323,5414,25,280,5719
subtest23of10,pubtest287of100,1,323,5414,25,320,5759
subtest22of10,pubtest287of100,1,323,5414,27,358,5799
subtest27of10,pubtest287of100,1,323,5414,27,398,5839
subtest29of10,pubtest288of100,1,323,5223,5,283,5511
subtest27of10,pubtest288of100,1,323,5223,8,316,5547
subtest25of10,pubtest288of100,1,323,5223,7,354,5584
subtest21of10,pubtest288of100,1,323,5223,10,393,5626
subtest26of10,pubtest288of100,1,323,5223,12,431,5666
subtest23of10,pubtest288of100,1,323,5223,13,470,5706
subtest22of10,pubtest288of100,1,323,5223,18,505,5746
subtest24of10,pubtest288of100,1,323,5223,21,542,5786
subtest210of10,pubtest288of100,1,323,5223,21,582,5826
subtest28of10,pubtest288of100,1,323,5223,25,618,5866
subtest210of10,pubtest289of100,1,323,5268,1,94,5363
subtest29of10,pubtest289of100,1,323,5268,1,131,5400
subtest24of10,pubtest289of100,1,323,5268,3,169,5440
subtest23of10,pubtest289of100,1,323,5268,3,209,5480
subtest25of10,pubtest289of100,1,323,5268,10,242,5520
subtest27of10,pubtest289of100,1,323,5268,19,272,5559
subtest21of10,pubtest289of100,1,323,5268,23,309,5600
subtest28of10,pubtest289of100,1,323,5268,23,349,5640
subtest26of10,pubtest289of100,1,323,5268,19,389,5676
subtest22of10,pubtest289of100,1,323,5268,24,428,5720
subtest29of10,pubtest290of100,1,323,5183,0,51,5234
subtest25of10,pubtest290of100,1,323,5183,2,88,5273
subtest21of10,pubtest290of100,1,323,5183,4,122,5309
subtest28of10,pubtest290of100,1,323,5183,9,161,5353
subtest26of10,pubtest290of100,1,323,5183,9,201,5393
subtest210of10,pubtest290of100,1,323,5183,11,239,5433
subtest24of10,pubtest290of100,1,323,5183,11,279,5473
subtest27of10,pubtest290of100,1,323,5183,12,318,5513
subtest22of10,pubtest290of100,1,323,5183,12,358,5553
subtest23of10,pubtest290of100,1,323,5183,1,397,5581
subtest24of10,pubtest291of100,1,323,5198,4,40,5242
subtest23of10,pubtest291of100,1,323,5198,4,79,5281
subtest28of10,pubtest291of100,1,323,5198,7,116,5321
subtest27of10,pubtest291of100,1,323,5198,8,156,5362
subtest210of10,pubtest291of100,1,323,5198,20,183,5401
subtest21of10,pubtest291of100,1,323,5198,20,223,5441
subtest22of10,pubtest291of100,1,323,5198,22,261,5481
subtest25of10,pubtest291of100,1,323,5198,22,301,5521
subtest29of10,pubtest291of100,1,323,5198,23,340,5561
subtest26of10,pubtest291of100,1,323,5198,24,377,5599
subtest28of10,pubtest292of100,1,323,5209,13,39,5261
subtest29of10,pubtest292of100,1,323,5209,14,77,5300
subtest26of10,pubtest292of100,1,323,5209,17,114,5340
subtest21of10,pubtest292of100,1,323,5209,20,151,5380
subtest24of10,pubtest292of100,1,323,5209,20,191,5420
subtest22of10,pubtest292of100,1,323,5209,18,232,5459
subtest25of10,pubtest292of100,1,323,5209,22,267,5498
subtest210of10,pubtest292of100,1,323,5209,26,305,5540
subtest27of10,pubtest292of100,1,323,5209,28,343,5580
subtest23of10,pubtest292of100,1,323,5209,33,378,5620
subtest24of10,pubtest293of100,1,323,5296,14,348,5658
subtest25of10,pubtest293of100,1,323,5296,15,387,5698
subtest27of10,pubtest293of100,1,323,5296,18,424,5738
subtest26of10,pubtest293of100,1,323,5296,19,463,5778
subtest21of10,pubtest293of100,1,323,5296,19,503,5818
subtest28of10,pubtest293of100,1,323,5296,18,542,5856
subtest22of10,pubtest293of100,1,323,5296,21,582,5899
subtest29of10,pubtest293of100,1,323,5296,22,620,5938
subtest23of10,pubtest293of100,1,323,5296,23,660,5979
subtest210of10,pubtest293of100,1,323,5296,23,699,6018
subtest21of10,pubtest294of100,1,323,5249,4,39,5292
subtest210of10,pubtest294of100,1,323,5249,6,75,5330
subtest25of10,pubtest294of100,1,323,5249,7,115,5371
subtest26of10,pubtest294of100,1,323,5249,14,149,5412
subtest29of10,pubtest294of100,1,323,5249,14,188,5451
subtest27of10,pubtest294of100,1,323,5249,17,225,5491
subtest23of10,pubtest294of100,1,323,5249,18,264,5531
subtest24of10,pubtest294of100,1,323,5249,19,301,5569
subtest22of10,pubtest294of100,1,323,5249,19,340,5608
subtest28of10,pubtest294of100,1,323,5249,23,379,5651
subtest25of10,pubtest295of100,1,323,5249,7,41,5297
subtest24of10,pubtest295of100,1,323,5249,9,78,5336
subtest23of10,pubtest295of100,1,323,5249,16,112,5377
subtest22of10,pubtest295of100,1,323,5249,17,150,5416
subtest210of10,pubtest295of100,1,323,5249,18,188,5455
subtest28of10,pubtest295of100,1,323,5249,22,225,5496
subtest27of10,pubtest295of100,1,323,5249,22,266,5537
subtest29of10,pubtest295of100,1,323,5249,26,301,5576
subtest21of10,pubtest295of100,1,323,5249,26,342,5617
subtest26of10,pubtest295of100,1,323,5249,27,380,5656
subtest24of10,pubtest296of100,1,322,5193,4,41,5238
subtest25of10,pubtest296of100,1,322,5193,8,77,5278
subtest27of10,pubtest296of100,1,322,5193,10,116,5319
subtest26of10,pubtest296of100,1,322,5193,16,149,5358
subtest23of10,pubtest296of100,1,322,5193,17,190,5400
subtest29of10,pubtest296of100,1,322,5193,18,228,5439
subtest21of10,pubtest296of100,1,322,5193,20,265,5478
subtest28of10,pubtest296of100,1,322,5193,21,303,5517
subtest210of10,pubtest296of100,1,322,5193,22,343,5558
subtest22of10,pubtest296of100,1,322,5193,24,381,5598
subtest25of10,pubtest297of100,1,323,5276,-3,45,5318
subtest210of10,pubtest297of100,1,323,5276,-1,82,5357
subtest29of10,pubtest297of100,1,323,5276,5,117,5398
subtest22of10,pubtest297of100,1,323,5276,4,157,5437
subtest23of10,pubtest297of100,1,323,5276,6,195,5477
subtest27of10,pubtest297of100,1,323,5276,9,233,5518
subtest21of10,pubtest297of100,1,323,5276,12,269,5557
subtest24of10,pubtest297of100,1,323,5276,18,304,5598
subtest28of10,pubtest297of100,1,323,5276,17,344,5637
subtest26of10,pubtest297of100,1,323,5276,16,383,5675
subtest22of10,pubtest298of100,1,323,5470,2,50,5522
subtest29of10,pubtest298of100,1,323,5470,7,85,5562
subtest23of10,pubtest298of100,1,323,5470,8,122,5600
subtest24of10,pubtest298of100,1,323,5470,9,163,5642
subtest21of10,pubtest298of100,1,323,5470,11,201,5682
subtest25of10,pubtest298of100,1,323,5470,12,240,5722
subtest210of10,pubtest298of100,1,323,5470,14,278,5762
subtest27of10,pubtest298of100,1,323,5470,14,317,5801
subtest28of10,pubtest298of100,1,323,5470,15,358,5843
subtest26of10,pubtest298of100,1,323,5470,19,393,5882
subtest22of10,pubtest299of100,1,323,5242,16,41,5299
subtest29of10,pubtest299of100,1,323,5242,16,80,5338
subtest27of10,pubtest299of100,1,323,5242,18,118,5378
subtest210of10,pubtest299of100,1,323,5242,19,158,5419
subtest24of10,pubtest299of100,1,323,5242,21,196,5459
subtest23of10,pubtest299of100,1,323,5242,25,231,5498
subtest25of10,pubtest299of100,1,323,5242,31,265,5538
subtest28of10,pubtest299of100,1,323,5242,34,303,5579
subtest21of10,pubtest299of100,1,323,5242,36,340,5618
subtest26of10,pubtest299of100,1,323,5242,39,377,5658
subtest24of10,pubtest2100of100,1,325,5200,0,42,5242
subtest21of10,pubtest2100of100,1,325,5200,1,80,5281
subtest29of10,pubtest2100of100,1,325,5200,3,118,5321
subtest23of10,pubtest2100of100,1,325,5200,4,157,5361
subtest22of10,pubtest2100of100,1,325,5200,4,197,5401
subtest210of10,pubtest2100of100,1,325,5200,7,234,5441
subtest27of10,pubtest2100of100,1,325,5200,7,274,5481
subtest28of10,pubtest2100of100,1,325,5200,8,313,5521
subtest25of10,pubtest2100of100,1,325,5200,42,319,5561
subtest26of10,pubtest2100of100,1,325,5200,44,358,5602
subtest27of10,pubtest21of100,1,322,10226,0,44,10270
subtest26of10,pubtest21of100,1,322,10226,3,81,10310
subtest29of10,pubtest21of100,1,322,10226,3,123,10352
subtest24of10,pubtest21of100,1,322,10226,5,160,10391
subtest25of10,pubtest21of100,1,322,10226,19,185,10430
subtest21of10,pubtest21of100,1,322,10226,22,222,10470
subtest210of10,pubtest21of100,1,322,10226,23,261,10510
subtest28of10,pubtest21of100,1,322,10226,24,300,10550
subtest22of10,pubtest21of100,1,322,10226,26,338,10590
subtest23of10,pubtest21of100,1,322,10226,27,378,10631
subtest29of10,pubtest22of100,1,321,5501,-5,42,5538
subtest23of10,pubtest22of100,1,321,5501,10,66,5577
subtest24of10,pubtest22of100,1,321,5501,11,105,5617
subtest27of10,pubtest22of100,1,321,5501,10,145,5656
subtest21of10,pubtest22of100,1,321,5501,12,184,5697
subtest25of10,pubtest22of100,1,321,5501,13,224,5738
subtest28of10,pubtest22of100,1,321,5501,16,260,5777
subtest26of10,pubtest22of100,1,321,5501,17,298,5816
subtest210of10,pubtest22of100,1,321,5501,19,337,5857
subtest22of10,pubtest22of100,1,321,5501,19,376,5896
subtest23of10,pubtest23of100,1,321,5220,-4,47,5263
subtest28of10,pubtest23of100,1,321,5220,-3,86,5303
subtest24of10,pubtest23of100,1,321,5220,5,117,5342
subtest29of10,pubtest23of100,1,321,5220,2,156,5378
subtest27of10,pubtest23of100,1,321,5220,9,193,5422
subtest25of10,pubtest23of100,1,321,5220,10,232,5462
subtest21of10,pubtest23of100,1,321,5220,13,271,5504
subtest26of10,pubtest23of100,1,321,5220,13,309,5542
subtest22of10,pubtest23of100,1,321,5220,15,347,5582
subtest210of10,pubtest23of100,1,321,5220,43,359,5622
subtest23of10,pubtest24of100,1,321,5336,-3,42,5375
subtest24of10,pubtest24of100,1,321,5336,-3,82,5415
subtest25of10,pubtest24of100,1,321,5336,0,119,5455
subtest28of10,pubtest24of100,1,321,5336,0,159,5495
subtest21of10,pubtest24of100,1,321,5336,1,198,5535
subtest22of10,pubtest24of100,1,321,5336,17,222,5575
subtest29of10,pubtest24of100,1,321,5336,17,262,5615
subtest27of10,pubtest24of100,1,321,5336,19,300,5655
subtest26of10,pubtest24of100,1,321,5336,27,332,5695
subtest210of10,pubtest24of100,1,321,5336,26,371,5733
subtest28of10,pubtest25of100,1,321,5232,-5,46,5273
subtest21of10,pubtest25of100,1,321,5232,-4,84,5312
subtest210of10,pubtest25of100,1,321,5232,-1,121,5352
subtest27of10,pubtest25of100,1,321,5232,1,159,5392
subtest26of10,pubtest25of100,1,321,5232,3,196,5431
subtest25of10,pubtest25of100,1,321,5232,4,236,5472
subtest22of10,pubtest25of100,1,321,5232,5,274,5511
subtest23of10,pubtest25of100,1,321,5232,5,314,5551
subtest24of10,pubtest25of100,1,321,5232,14,346,5592
subtest29of10,pubtest25of100,1,321,5232,14,386,5632
subtest21of10,pubtest26of100,1,321,5357,-1,42,5398
subtest22of10,pubtest26of100,1,321,5357,0,80,5437
subtest29of10,pubtest26of100,1,321,5357,4,115,5476
subtest23of10,pubtest26of100,1,321,5357,5,155,5517
subtest26of10,pubtest26of100,1,321,5357,7,195,5559
subtest27of10,pubtest26of100,1,321,5357,11,229,5597
subtest25of10,pubtest26of100,1,321,5357,12,268,5637
subtest210of10,pubtest26of100,1,321,5357,23,298,5678
subtest24of10,pubtest26of100,1,321,5357,26,333,5716
subtest28of10,pubtest26of100,1,321,5357,26,373,5756
subtest27of10,pubtest27of100,1,320,5197,2,40,5239
subtest28of10,pubtest27of100,1,320,5197,2,78,5277
subtest25of10,pubtest27of100,1,320,5197,5,116,5318
subtest23of10,pubtest27of100,1,320,5197,4,155,5356
subtest210of10,pubtest27of100,1,320,5197,5,193,5395
subtest26of10,pubtest27of100,1,320,5197,9,232,5438
subtest22of10,pubtest27of100,1,320,5197,10,271,5478
subtest29of10,pubtest27of100,1,320,5197,10,311,5518
subtest24of10,pubtest27of100,1,320,5197,4,350,5551
subtest21of10,pubtest27of100,1,320,5197,12,389,5598
subtest27of10,pubtest28of100,1,321,5303,-4,44,5343
subtest21of10,pubtest28of100,1,321,5303,3,76,5382
subtest28of10,pubtest28of100,1,321,5303,3,115,5421
subtest29of10,pubtest28of100,1,321,5303,6,151,5460
subtest23of10,pubtest28of100,1,321,5303,6,191,5500
subtest25of10,pubtest28of100,1,321,5303,12,225,5540
subtest26of10,pubtest28of100,1,321,5303,13,264,5580
subtest24of10,pubtest28of100,1,321,5303,15,303,5621
subtest22of10,pubtest28of100,1,321,5303,15,342,5660
subtest210of10,pubtest28of100,1,321,5303,12,381,5696
subtest29of10,pubtest29of100,1,321,5222,0,43,5265
subtest23of10,pubtest29of100,1,321,5222,0,82,5304
subtest210of10,pubtest29of100,1,321,5222,3,119,5344
subtest25of10,pubtest29of100,1,321,5222,6,156,5384
subtest21of10,pubtest29of100,1,321,5222,8,194,5424
subtest27of10,pubtest29of100,1,321,5222,19,223,5464
subtest22of10,pubtest29of100,1,321,5222,19,261,5502
subtest28of10,pubtest29of100,1,321,5222,30,292,5544
subtest24of10,pubtest29of100,1,321,5222,33,329,5584
subtest26of10,pubtest29of100,1,321,5222,33,369,5624
subtest29of10,pubtest210of100,1,323,5306,-4,187,5489
subtest21of10,pubtest210of100,1,323,5306,0,223,5529
subtest210of10,pubtest210of100,1,323,5306,11,254,5571
subtest27of10,pubtest210of100,1,323,5306,14,290,5610
subtest23of10,pubtest210of100,1,323,5306,17,327,5650
subtest25of10,pubtest210of100,1,323,5306,20,364,5690
subtest28of10,pubtest210of100,1,323,5306,22,402,5730
subtest24of10,pubtest210of100,1,323,5306,25,439,5770
subtest22of10,pubtest210of100,1,323,5306,28,476,5810
subtest26of10,pubtest210of100,1,323,5306,30,514,5850
subtest210of10,pubtest211of100,1,323,5334,-2,39,5371
subtest24of10,pubtest211of100,1,323,5334,8,67,5409
subtest29of10,pubtest211of100,1,323,5334,14,102,5450
subtest21of10,pubtest211of100,1,323,5334,15,140,5489
subtest22of10,pubtest211of100,1,323,5334,19,176,5529
subtest25of10,pubtest211of100,1,323,5334,19,217,5570
subtest26of10,pubtest211of100,1,323,5334,21,252,5607
subtest23of10,pubtest211of100,1,323,5334,21,291,5646
subtest28of10,pubtest211of100,1,323,5334,24,331,5689
subtest27of10,pubtest211of100,1,323,5334,25,370,5729
subtest25of10,pubtest212of100,1,323,5206,-4,39,5241
subtest29of10,pubtest212of100,1,323,5206,-1,73,5278
subtest28of10,pubtest212of100,1,323,5206,1,112,5319
subtest23of10,pubtest212of100,1,323,5206,3,150,5359
subtest27of10,pubtest212of100,1,323,5206,5,188,5399
subtest24of10,pubtest212of100,1,323,5206,6,228,5440
subtest21of10,pubtest212of100,1,323,5206,7,266,5479
subtest26of10,pubtest212of100,1,323,5206,11,302,5519
subtest22of10,pubtest212of100,1,323,5206,11,343,5560
subtest210of10,pubtest212of100,1,323,5206,12,382,5600
subtest23of10,pubtest213of100,1,322,5275,2,40,5317
subtest26of10,pubtest213of100,1,322,5275,7,74,5356
subtest22of10,pubtest213of100,1,322,5275,8,113,5396
subtest27of10,pubtest213of100,1,322,5275,10,151,5436
subtest29of10,pubtest213of100,1,322,5275,9,190,5474
subtest21of10,pubtest213of100,1,322,5275,12,229,5516
subtest25of10,pubtest213of100,1,322,5275,13,266,5554
subtest24of10,pubtest213of100,1,322,5275,10,305,5590
subtest28of10,pubtest213of100,1,322,5275,17,345,5637
subtest210of10,pubtest213of100,1,322,5275,13,384,5672
subtest21of10,pubtest214of100,1,323,5170,17,356,5543
subtest23of10,pubtest214of100,1,323,5170,17,393,5580
subtest22of10,pubtest214of100,1,323,5170,20,429,5619
subtest25of10,pubtest214of100,1,323,5170,20,469,5659
subtest26of10,pubtest214of100,1,323,5170,21,509,5700
subtest210of10,pubtest214of100,1,323,5170,22,548,5740
subtest28of10,pubtest214of100,1,323,5170,24,586,5780
subtest24of10,pubtest214of100,1,323,5170,24,626,5820
subtest27of10,pubtest214of100,1,323,5170,25,666,5861
subtest29of10,pubtest214of100,1,323,5170,24,704,5898
subtest27of10,pubtest215of100,1,323,5236,2,41,5279
subtest24of10,pubtest215of100,1,323,5236,3,79,5318
subtest29of10,pubtest215of100,1,323,5236,5,117,5358
subtest25of10,pubtest215of100,1,323,5236,5,157,5398
subtest26of10,pubtest215of100,1,323,5236,7,195,5438
subtest21of10,pubtest215of100,1,323,5236,5,235,5476
subtest210of10,pubtest215of100,1,323,5236,7,274,5517
subtest23of10,pubtest215of100,1,323,5236,12,310,5558
subtest22of10,pubtest215of100,1,323,5236,13,350,5599
subtest28of10,pubtest215of100,1,323,5236,14,388,5638
subtest23of10,pubtest216of100,1,323,5275,2,39,5316
subtest24of10,pubtest216of100,1,323,5275,1,81,5357
subtest28of10,pubtest216of100,1,323,5275,3,116,5394
subtest25of10,pubtest216of100,1,323,5275,6,157,5438
subtest21of10,pubtest216of100,1,323,5275,2,197,5474
subtest27of10,pubtest216of100,1,323,5275,6,236,5517
subtest26of10,pubtest216of100,1,323,5275,6,273,5554
subtest210of10,pubtest216of100,1,323,5275,5,313,5593
subtest29of10,pubtest216of100,1,323,5275,5,352,5632
subtest22of10,pubtest216of100,1,323,5275,6,392,5673
subtest27of10,pubtest217of100,1,322,5299,5,39,5343
subtest22of10,pubtest217of100,1,322,5299,9,75,5383
subtest21of10,pubtest217of100,1,322,5299,9,114,5422
subtest26of10,pubtest217of100,1,322,5299,11,152,5462
subtest29of10,pubtest217of100,1,322,5299,11,192,5502
subtest23of10,pubtest217of100,1,322,5299,12,231,5542
subtest24of10,pubtest217of100,1,322,5299,19,262,5580
subtest25of10,pubtest217of100,1,322,5299,19,302,5620
subtest28of10,pubtest217of100,1,322,5299,20,341,5660
subtest210of10,pubtest217of100,1,322,5299,29,374,5702
subtest29of10,pubtest218of100,1,323,5254,8,220,5482
subtest22of10,pubtest218of100,1,323,5254,8,258,5520
subtest21of10,pubtest218of100,1,323,5254,13,291,5558
subtest23of10,pubtest218of100,1,323,5254,16,330,5600
subtest28of10,pubtest218of100,1,323,5254,17,369,5640
subtest25of10,pubtest218of100,1,323,5254,17,408,5679
subtest24of10,pubtest218of100,1,323,5254,18,449,5721
subtest27of10,pubtest218of100,1,323,5254,13,487,5754
subtest26of10,pubtest218of100,1,323,5254,19,527,5800
subtest210of10,pubtest218of100,1,323,5254,20,566,5840
subtest210of10,pubtest219of100,1,323,5217,8,111,5336
subtest25of10,pubtest219of100,1,323,5217,9,150,5376
subtest22of10,pubtest219of100,1,323,5217,11,187,5415
subtest26of10,pubtest219of100,1,323,5217,11,227,5455
subtest21of10,pubtest219of100,1,323,5217,13,265,5495
subtest24of10,pubtest219of100,1,323,5217,13,305,5535
subtest27of10,pubtest219of100,1,323,5217,15,342,5574
subtest23of10,pubtest219of100,1,323,5217,15,383,5615
subtest29of10,pubtest219of100,1,323,5217,17,420,5654
subtest28of10,pubtest219of100,1,323,5217,14,460,5691
subtest25of10,pubtest220of100,1,323,5253,-1,39,5291
subtest23of10,pubtest220of100,1,323,5253,1,76,5330
subtest210of10,pubtest220of100,1,323,5253,3,114,5370
subtest29of10,pubtest220of100,1,323,5253,4,152,5409
subtest21of10,pubtest220of100,1,323,5253,6,191,5450
subtest24of10,pubtest220of100,1,323,5253,16,221,5490
subtest28of10,pubtest220of100,1,323,5253,22,255,5530
subtest27of10,pubtest220of100,1,323,5253,22,295,5570
subtest26of10,pubtest220of100,1,323,5253,23,334,5610
subtest22of10,pubtest220of100,1,323,5253,23,374,5650
subtest21of10,pubtest221of100,1,323,5289,3,42,5334
subtest24of10,pubtest221of100,1,323,5289,3,83,5375
subtest28of10,pubtest221of100,1,323,5289,5,120,5414
subtest22of10,pubtest221of100,1,323,5289,8,157,5454
subtest210of10,pubtest221of100,1,323,5289,12,193,5494
subtest29of10,pubtest221of100,1,323,5289,13,233,5535
subtest25of10,pubtest221of100,1,323,5289,12,269,5570
subtest27of10,pubtest221of100,1,323,5289,14,309,5612
subtest23of10,pubtest221of100,1,323,5289,12,348,5649
subtest26of10,pubtest221of100,1,323,5289,17,388,5694
subtest21of10,pubtest222of100,1,323,5274,2,40,5316
subtest22of10,pubtest222of100,1,323,5274,3,78,5355
subtest29of10,pubtest222of100,1,323,5274,4,115,5393
subtest27of10,pubtest222of100,1,323,5274,4,155,5433
subtest28of10,pubtest222of100,1,323,5274,8,193,5475
subtest23of10,pubtest222of100,1,323,5274,12,230,5516
subtest210of10,pubtest222of100,1,323,5274,14,267,5555
subtest25of10,pubtest222of100,1,323,5274,17,305,5596
subtest26of10,pubtest222of100,1,323,5274,19,342,5635
subtest24of10,pubtest222of100,1,323,5274,21,381,5676
subtest21of10,pubtest223of100,1,323,5333,0,43,5376
subtest23of10,pubtest223of100,1,323,5333,0,82,5415
subtest29of10,pubtest223of100,1,323,5333,2,120,5455
subtest28of10,pubtest223of100,1,323,5333,4,158,5495
subtest27of10,pubtest223of100,1,323,5333,9,193,5535
subtest24of10,pubtest223of100,1,323,5333,11,231,5575
subtest210of10,pubtest223of100,1,323,5333,11,271,5615
subtest22of10,pubtest223of100,1,323,5333,13,308,5654
subtest26of10,pubtest223of100,1,323,5333,13,347,5693
subtest25of10,pubtest223of100,1,323,5333,16,386,5735
subtest21of10,pubtest224of100,1,323,5256,-3,39,5292
subtest27of10,pubtest224of100,1,323,5256,7,67,5330
subtest28of10,pubtest224of100,1,323,5256,8,107,5371
subtest23of10,pubtest224of100,1,323,5256,11,142,5409
subtest22of10,pubtest224of100,1,323,5256,14,181,5451
subtest26of10,pubtest224of100,1,323,5256,15,220,5491
subtest29of10,pubtest224of100,1,323,5256,15,260,5531
subtest25of10,pubtest224of100,1,323,5256,16,301,5573
subtest24of10,pubtest224of100,1,323,5256,17,339,5612
subtest210of10,pubtest224of100,1,323,5256,17,377,5650
subtest27of10,pubtest225of100,1,323,5321,13,40,5374
subtest22of10,pubtest225of100,1,323,5321,14,78,5413
subtest26of10,pubtest225of100,1,323,5321,16,117,5454
subtest21of10,pubtest225of100,1,323,5321,16,157,5494
subtest25of10,pubtest225of100,1,323,5321,18,195,5534
subtest23of10,pubtest225of100,1,323,5321,19,234,5574
subtest24of10,pubtest225of100,1,323,5321,20,274,5615
subtest29of10,pubtest225of100,1,323,5321,29,305,5655
subtest28of10,pubtest225of100,1,323,5321,30,341,5692
subtest210of10,pubtest225of100,1,323,5321,31,382,5734
subtest25of10,pubtest226of100,1,323,5211,4,41,5256
subtest22of10,pubtest226of100,1,323,5211,5,80,5296
subtest23of10,pubtest226of100,1,323,5211,7,117,5335
subtest210of10,pubtest226of100,1,323,5211,6,155,5372
subtest27of10,pubtest226of100,1,323,5211,7,195,5413
subtest21of10,pubtest226of100,1,323,5211,10,234,5455
subtest29of10,pubtest226of100,1,323,5211,11,274,5496
subtest26of10,pubtest226of100,1,323,5211,12,312,5535
subtest28of10,pubtest226of100,1,323,5211,13,350,5574
subtest24of10,pubtest226of100,1,323,5211,14,390,5615
subtest29of10,pubtest227of100,1,323,5244,2,40,5286
subtest210of10,pubtest227of100,1,323,5244,2,78,5324
subtest25of10,pubtest227of100,1,323,5244,4,116,5364
subtest24of10,pubtest227of100,1,323,5244,4,156,5404
subtest27of10,pubtest227of100,1,323,5244,6,194,5444
subtest23of10,pubtest227of100,1,323,5244,5,234,5483
subtest21of10,pubtest227of100,1,323,5244,8,272,5524
subtest26of10,pubtest227of100,1,323,5244,9,311,5564
subtest22of10,pubtest227of100,1,323,5244,9,351,5604
subtest28of10,pubtest227of100,1,323,5244,12,389,5645
subtest21of10,pubtest228of100,1,323,5262,-1,40,5301
subtest26of10,pubtest228of100,1,323,5262,5,74,5341
subtest25of10,pubtest228of100,1,323,5262,5,114,5381
subtest23of10,pubtest228of100,1,323,5262,8,149,5419
subtest27of10,pubtest228of100,1,323,5262,10,188,5460
subtest24of10,pubtest228of100,1,323,5262,12,227,5501
subtest29of10,pubtest228of100,1,323,5262,14,266,5542
subtest210of10,pubtest228of100,1,323,5262,14,305,5581
subtest22of10,pubtest228of100,1,323,5262,15,344,5621
subtest28of10,pubtest228of100,1,323,5262,16,383,5661
subtest24of10,pubtest229of100,1,321,5567,1,42,5610
subtest27of10,pubtest229of100,1,321,5567,4,78,5649
subtest28of10,pubtest229of100,1,321,5567,5,117,5689
subtest21of10,pubtest229of100,1,321,5567,4,157,5728
subtest23of10,pubtest229of100,1,321,5567,7,195,5769
subtest25of10,pubtest229of100,1,321,5567,9,233,5809
subtest22of10,pubtest229of100,1,321,5567,8,273,5848
subtest29of10,pubtest229of100,1,321,5567,12,310,5889
subtest210of10,pubtest229of100,1,321,5567,13,349,5929
subtest26of10,pubtest229of100,1,321,5567,14,388,5969
subtest22of10,pubtest230of100,1,323,5211,1,38,5250
subtest21of10,pubtest230of100,1,323,5211,2,77,5290
subtest29of10,pubtest230of100,1,323,5211,6,113,5330
subtest25of10,pubtest230of100,1,323,5211,6,153,5370
subtest28of10,pubtest230of100,1,323,5211,6,192,5409
subtest23of10,pubtest230of100,1,323,5211,7,232,5450
subtest27of10,pubtest230of100,1,323,5211,3,272,5486
subtest210of10,pubtest230of100,1,323,5211,10,309,5530
subtest24of10,pubtest230of100,1,323,5211,12,347,5570
subtest26of10,pubtest230of100,1,323,5211,13,386,5610
subtest23of10,pubtest231of100,1,323,5231,0,41,5272
subtest28of10,pubtest231of100,1,323,5231,1,79,5311
subtest25of10,pubtest231of100,1,323,5231,3,117,5351
subtest29of10,pubtest231of100,1,323,5231,5,155,5391
subtest24of10,pubtest231of100,1,323,5231,6,194,5431
subtest27of10,pubtest231of100,1,323,5231,8,232,5471
subtest210of10,pubtest231of100,1,323,5231,11,267,5509
subtest22of10,pubtest231of100,1,323,5231,18,384,5633
subtest21of10,pubtest231of100,1,323,5231,11,307,5549
subtest26of10,pubtest231of100,1,323,5231,15,345,5591
subtest21of10,pubtest232of100,1,323,5241,30,60,5331
subtest22of10,pubtest232of100,1,323,5241,32,96,5369
subtest210of10,pubtest232of100,1,323,5241,41,127,5409
subtest24of10,pubtest232of100,1,323,5241,42,166,5449
subtest26of10,pubtest232of100,1,323,5241,43,206,5490
subtest25of10,pubtest232of100,1,323,5241,39,245,5525
subtest28of10,pubtest232of100,1,323,5241,46,283,5570
subtest23of10,pubtest232of100,1,323,5241,47,321,5609
subtest29of10,pubtest232of100,1,323,5241,49,359,5649
subtest27of10,pubtest232of100,1,323,5241,50,398,5689
subtest24of10,pubtest233of100,1,323,5382,-2,41,5421
subtest29of10,pubtest233of100,1,323,5382,1,76,5459
subtest210of10,pubtest233of100,1,323,5382,2,114,5498
subtest25of10,pubtest233of100,1,323,5382,5,151,5538
subtest26of10,pubtest233of100,1,323,5382,6,190,5578
subtest27of10,pubtest233of100,1,323,5382,11,225,5618
subtest22of10,pubtest233of100,1,323,5382,20,255,5657
subtest28of10,pubtest233of100,1,323,5382,22,295,5699
subtest21of10,pubtest233of100,1,323,5382,23,333,5738
subtest23of10,pubtest233of100,1,323,5382,21,373,5776
subtest25of10,pubtest234of100,1,323,5218,2,49,5269
subtest26of10,pubtest234of100,1,323,5218,3,86,5307
subtest21of10,pubtest234of100,1,323,5218,11,119,5348
subtest27of10,pubtest234of100,1,323,5218,11,158,5387
subtest22of10,pubtest234of100,1,323,5218,13,197,5428
subtest23of10,pubtest234of100,1,323,5218,13,235,5466
subtest210of10,pubtest234of100,1,323,5218,14,274,5506
subtest29of10,pubtest234of100,1,323,5218,16,313,5547
subtest24of10,pubtest234of100,1,323,5218,15,353,5586
subtest28of10,pubtest234of100,1,323,5218,21,388,5627
subtest21of10,pubtest235of100,1,321,5230,0,43,5273
subtest23of10,pubtest235of100,1,321,5230,2,80,5312
subtest210of10,pubtest235of100,1,321,5230,1,118,5349
subtest22of10,pubtest235of100,1,321,5230,6,156,5392
subtest27of10,pubtest235of100,1,321,5230,12,190,5432
subtest24of10,pubtest235of100,1,321,5230,15,226,5471
subtest26of10,pubtest235of100,1,321,5230,17,266,5513
subtest29of10,pubtest235of100,1,321,5230,18,304,5552
subtest25of10,pubtest235of100,1,321,5230,18,344,5592
subtest28of10,pubtest235of100,1,321,5230,20,382,5632
subtest210of10,pubtest236of100,1,323,5593,0,38,5631
subtest23of10,pubtest236of100,1,323,5593,2,77,5672
subtest28of10,pubtest236of100,1,323,5593,7,113,5713
subtest27of10,pubtest236of100,1,323,5593,7,152,5752
subtest24of10,pubtest236of100,1,323,5593,11,188,5792
subtest21of10,pubtest236of100,1,323,5593,11,229,5833
subtest25of10,pubtest236of100,1,323,5593,11,267,5871
subtest26of10,pubtest236of100,1,323,5593,13,307,5913
subtest29of10,pubtest236of100,1,323,5593,14,345,5952
subtest22of10,pubtest236of100,1,323,5593,14,385,5992
subtest24of10,pubtest237of100,1,323,5287,0,344,5631
subtest23of10,pubtest237of100,1,323,5287,2,379,5668
subtest28of10,pubtest237of100,1,323,5287,3,418,5708
subtest25of10,pubtest237of100,1,323,5287,8,453,5748
subtest27of10,pubtest237of100,1,323,5287,9,490,5786
subtest26of10,pubtest237of100,1,323,5287,11,530,5828
subtest21of10,pubtest237of100,1,323,5287,11,569,5867
subtest29of10,pubtest237of100,1,323,5287,12,609,5908
subtest22of10,pubtest237of100,1,323,5287,14,649,5950
subtest210of10,pubtest237of100,1,323,5287,14,688,5989
subtest29of10,pubtest238of100,1,323,5258,-2,44,5300
subtest22of10,pubtest238of100,1,323,5258,0,81,5339
subtest28of10,pubtest238of100,1,323,5258,7,114,5379
subtest27of10,pubtest238of100,1,323,5258,6,154,5418
subtest25of10,pubtest238of100,1,323,5258,8,193,5459
subtest210of10,pubtest238of100,1,323,5258,10,231,5499
subtest23of10,pubtest238of100,1,323,5258,11,269,5538
subtest21of10,pubtest238of100,1,323,5258,12,309,5579
subtest26of10,pubtest238of100,1,323,5258,14,347,5619
subtest24of10,pubtest238of100,1,323,5258,14,387,5659
subtest21of10,pubtest239of100,1,323,5245,0,41,5286
subtest28of10,pubtest239of100,1,323,5245,2,77,5324
subtest27of10,pubtest239of100,1,323,5245,10,110,5365
subtest24of10,pubtest239of100,1,323,5245,11,148,5404
subtest26of10,pubtest239of100,1,323,5245,10,188,5443
subtest23of10,pubtest239of100,1,323,5245,17,220,5482
subtest22of10,pubtest239of100,1,323,5245,19,261,5525
subtest29of10,pubtest239of100,1,323,5245,16,300,5561
subtest25of10,pubtest239of100,1,323,5245,16,340,5601
subtest210of10,pubtest239of100,1,323,5245,21,378,5644
subtest25of10,pubtest240of100,1,323,5306,2,238,5546
subtest21of10,pubtest240of100,1,323,5306,8,270,5584
subtest210of10,pubtest240of100,1,323,5306,8,310,5624
subtest29of10,pubtest240of100,1,323,5306,9,347,5662
subtest27of10,pubtest240of100,1,323,5306,13,385,5704
subtest23of10,pubtest240of100,1,323,5306,14,424,5744
subtest28of10,pubtest240of100,1,323,5306,15,464,5785
subtest24of10,pubtest240of100,1,323,5306,17,501,5824
subtest22of10,pubtest240of100,1,323,5306,18,540,5864
subtest26of10,pubtest240of100,1,323,5306,23,575,5904
subtest23of10,pubtest241of100,1,323,5282,0,50,5332
subtest27of10,pubtest241of100,1,323,5282,2,87,5371
subtest24of10,pubtest241of100,1,323,5282,4,124,5410
subtest21of10,pubtest241of100,1,323,5282,6,163,5451
subtest29of10,pubtest241of100,1,323,5282,9,200,5491
subtest26of10,pubtest241of100,1,323,5282,10,239,5531
subtest28of10,pubtest241of100,1,323,5282,11,278,5571
subtest210of10,pubtest241of100,1,323,5282,8,317,5607
subtest25of10,pubtest241of100,1,323,5282,12,357,5651
subtest22of10,pubtest241of100,1,323,5282,12,395,5689
subtest27of10,pubtest242of100,1,323,5252,-2,38,5288
subtest26of10,pubtest242of100,1,323,5252,3,72,5327
subtest23of10,pubtest242of100,1,323,5252,3,112,5367
subtest25of10,pubtest242of100,1,323,5252,4,152,5408
subtest21of10,pubtest242of100,1,323,5252,14,181,5447
subtest29of10,pubtest242of100,1,323,5252,14,221,5487
subtest210of10,pubtest242of100,1,323,5252,16,259,5527
subtest22of10,pubtest242of100,1,323,5252,27,286,5565
subtest24of10,pubtest242of100,1,323,5252,27,326,5605
subtest28of10,pubtest242of100,1,323,5252,30,365,5647
subtest29of10,pubtest243of100,1,323,5305,321,41,5667
subtest28of10,pubtest243of100,1,323,5305,323,77,5705
subtest23of10,pubtest243of100,1,323,5305,325,116,5746
subtest25of10,pubtest243of100,1,323,5305,325,156,5786
subtest24of10,pubtest243of100,1,323,5305,329,192,5826
subtest22of10,pubtest243of100,1,323,5305,323,232,5860
subtest26of10,pubtest243of100,1,323,5305,328,272,5905
subtest21of10,pubtest243of100,1,323,5305,328,312,5945
subtest210of10,pubtest243of100,1,323,5305,329,350,5984
subtest27of10,pubtest243of100,1,323,5305,326,390,6021
subtest26of10,pubtest244of100,1,323,5216,2,43,5261
subtest25of10,pubtest244of100,1,323,5216,5,78,5299
subtest27of10,pubtest244of100,1,323,5216,5,118,5339
subtest29of10,pubtest244of100,1,323,5216,7,157,5380
subtest28of10,pubtest244of100,1,323,5216,12,191,5419
subtest21of10,pubtest244of100,1,323,5216,13,231,5460
subtest23of10,pubtest244of100,1,323,5216,14,270,5500
subtest22of10,pubtest244of100,1,323,5216,20,305,5541
subtest210of10,pubtest244of100,1,323,5216,19,347,5582
subtest24of10,pubtest244of100,1,323,5216,21,384,5621
subtest29of10,pubtest245of100,1,322,5229,-1,38,5266
subtest26of10,pubtest245of100,1,322,5229,2,75,5306
subtest23of10,pubtest245of100,1,322,5229,9,106,5344
subtest24of10,pubtest245of100,1,322,5229,10,146,5385
subtest22of10,pubtest245of100,1,322,5229,11,186,5426
subtest25of10,pubtest245of100,1,322,5229,14,222,5465
subtest28of10,pubtest245of100,1,322,5229,18,258,5505
subtest21of10,pubtest245of100,1,322,5229,19,297,5545
subtest210of10,pubtest245of100,1,322,5229,22,332,5583
subtest27of10,pubtest245of100,1,322,5229,23,372,5624
subtest27of10,pubtest246of100,1,323,5187,-6,40,5221
subtest21of10,pubtest246of100,1,323,5187,-5,78,5260
subtest29of10,pubtest246of100,1,323,5187,-2,114,5299
subtest23of10,pubtest246of100,1,323,5187,-2,154,5339
subtest25of10,pubtest246of100,1,323,5187,-1,193,5379
subtest26of10,pubtest246of100,1,323,5187,1,229,5417
subtest28of10,pubtest246of100,1,323,5187,8,264,5459
subtest210of10,pubtest246of100,1,323,5187,11,301,5499
subtest24of10,pubtest246of100,1,323,5187,12,341,5540
subtest22of10,pubtest246of100,1,323,5187,13,379,5579
subtest27of10,pubtest247of100,1,323,5240,-2,41,5279
subtest23of10,pubtest247of100,1,323,5240,0,78,5318
subtest26of10,pubtest247of100,1,323,5240,-1,117,5356
subtest22of10,pubtest247of100,1,323,5240,8,151,5399
subtest21of10,pubtest247of100,1,323,5240,9,190,5439
subtest29of10,pubtest247of100,1,323,5240,11,228,5479
subtest28of10,pubtest247of100,1,323,5240,15,264,5519
subtest210of10,pubtest247of100,1,323,5240,16,305,5561
subtest25of10,pubtest247of100,1,323,5240,15,343,5598
subtest24of10,pubtest247of100,1,323,5240,17,382,5639
subtest29of10,pubtest248of100,1,323,5285,8,45,5338
subtest26of10,pubtest248of100,1,323,5285,9,83,5377
subtest25of10,pubtest248of100,1,323,5285,10,122,5417
subtest23of10,pubtest248of100,1,323,5285,15,157,5457
subtest28of10,pubtest248of100,1,323,5285,15,197,5497
subtest21of10,pubtest248of100,1,323,5285,18,234,5537
subtest27of10,pubtest248of100,1,323,5285,18,274,5577
subtest24of10,pubtest248of100,1,323,5285,20,312,5617
subtest210of10,pubtest248of100,1,323,5285,21,351,5657
subtest22of10,pubtest248of100,1,323,5285,21,388,5694
subtest27of10,pubtest249of100,1,323,5210,2,39,5251
subtest28of10,pubtest249of100,1,323,5210,4,77,5291
subtest24of10,pubtest249of100,1,323,5210,5,115,5330
subtest21of10,pubtest249of100,1,323,5210,6,154,5370
subtest25of10,pubtest249of100,1,323,5210,6,194,5410
subtest29of10,pubtest249of100,1,323,5210,9,231,5450
subtest26of10,pubtest249of100,1,323,5210,10,269,5489
subtest210of10,pubtest249of100,1,323,5210,13,307,5530
subtest23of10,pubtest249of100,1,323,5210,13,347,5570
subtest22of10,pubtest249of100,1,323,5210,14,386,5610
subtest27of10,pubtest250of100,1,323,5176,2,42,5220
subtest28of10,pubtest250of100,1,323,5176,4,78,5258
subtest23of10,pubtest250of100,1,323,5176,7,115,5298
subtest29of10,pubtest250of100,1,323,5176,8,152,5336
subtest24of10,pubtest250of100,1,323,5176,10,192,5378
subtest21of10,pubtest250of100,1,323,5176,12,230,5418
subtest26of10,pubtest250of100,1,323,5176,15,267,5458
subtest25of10,pubtest250of100,1,323,5176,16,307,5499
subtest210of10,pubtest250of100,1,323,5176,15,346,5537
subtest22of10,pubtest250of100,1,323,5176,17,385,5578
subtest23of10,pubtest251of100,1,323,5321,8,40,5369
subtest22of10,pubtest251of100,1,323,5321,8,79,5408
subtest27of10,pubtest251of100,1,323,5321,10,117,5448
subtest24of10,pubtest251of100,1,323,5321,24,144,5489
subtest25of10,pubtest251of100,1,323,5321,24,183,5528
subtest29of10,pubtest251of100,1,323,5321,26,222,5569
subtest21of10,pubtest251of100,1,323,5321,26,262,5609
subtest28of10,pubtest251of100,1,323,5321,27,300,5648
subtest210of10,pubtest251of100,1,323,5321,27,339,5687
subtest26of10,pubtest251of100,1,323,5321,28,378,5727
subtest29of10,pubtest252of100,1,323,5273,3,41,5317
subtest28of10,pubtest252of100,1,323,5273,10,73,5356
subtest21of10,pubtest252of100,1,323,5273,10,113,5396
subtest27of10,pubtest252of100,1,323,5273,12,151,5436
subtest26of10,pubtest252of100,1,323,5273,12,191,5476
subtest25of10,pubtest252of100,1,323,5273,13,229,5515
subtest23of10,pubtest252of100,1,323,5273,14,269,5556
subtest24of10,pubtest252of100,1,323,5273,17,306,5596
subtest22of10,pubtest252of100,1,323,5273,17,346,5636
subtest210of10,pubtest252of100,1,323,5273,19,384,5676
subtest28of10,pubtest253of100,1,322,5228,1,41,5270
subtest23of10,pubtest253of100,1,322,5228,2,78,5308
subtest24of10,pubtest253of100,1,322,5228,7,114,5349
subtest22of10,pubtest253of100,1,322,5228,8,151,5387
subtest25of10,pubtest253of100,1,322,5228,8,190,5426
subtest27of10,pubtest253of100,1,322,5228,10,230,5468
subtest26of10,pubtest253of100,1,322,5228,12,269,5509
subtest210of10,pubtest253of100,1,322,5228,12,309,5549
subtest21of10,pubtest253of100,1,322,5228,14,347,5589
subtest29of10,pubtest253of100,1,322,5228,14,387,5629
subtest210of10,pubtest254of100,1,323,5217,2,46,5265
subtest28of10,pubtest254of100,1,323,5217,4,84,5305
subtest21of10,pubtest254of100,1,323,5217,5,123,5345
subtest27of10,pubtest254of100,1,323,5217,2,164,5383
subtest25of10,pubtest254of100,1,323,5217,9,200,5426
subtest24of10,pubtest254of100,1,323,5217,9,239,5465
subtest23of10,pubtest254of100,1,323,5217,10,278,5505
subtest29of10,pubtest254of100,1,323,5217,11,318,5546
subtest22of10,pubtest254of100,1,323,5217,12,356,5585
subtest26of10,pubtest254of100,1,323,5217,12,396,5625
subtest22of10,pubtest255of100,1,322,5315,-2,40,5353
subtest23of10,pubtest255of100,1,322,5315,1,76,5392
subtest28of10,pubtest255of100,1,322,5315,5,112,5432
subtest27of10,pubtest255of100,1,322,5315,6,151,5472
subtest24of10,pubtest255of100,1,322,5315,7,190,5512
subtest29of10,pubtest255of100,1,322,5315,8,229,5552
subtest21of10,pubtest255of100,1,322,5315,9,268,5592
subtest25of10,pubtest255of100,1,322,5315,10,304,5629
subtest210of10,pubtest255of100,1,322,5315,10,344,5669
subtest26of10,pubtest255of100,1,322,5315,10,384,5709
subtest29of10,pubtest256of100,1,323,5351,3,41,5395
subtest26of10,pubtest256of100,1,323,5351,4,79,5434
subtest21of10,pubtest256of100,1,323,5351,6,121,5478
subtest23of10,pubtest256of100,1,323,5351,6,161,5518
subtest25of10,pubtest256of100,1,323,5351,7,199,5557
subtest24of10,pubtest256of100,1,323,5351,11,236,5598
subtest28of10,pubtest256of100,1,323,5351,12,276,5639
subtest22of10,pubtest256of100,1,323,5351,13,314,5678
subtest27of10,pubtest256of100,1,323,5351,13,354,5718
subtest210of10,pubtest256of100,1,323,5351,8,394,5753
subtest24of10,pubtest257of100,1,323,5253,8,50,5311
subtest21of10,pubtest257of100,1,323,5253,9,87,5349
subtest29of10,pubtest257of100,1,323,5253,13,123,5389
subtest28of10,pubtest257of100,1,323,5253,14,162,5429
subtest22of10,pubtest257of100,1,323,5253,16,200,5469
subtest27of10,pubtest257of100,1,323,5253,13,241,5507
subtest210of10,pubtest257of100,1,323,5253,15,280,5548
subtest23of10,pubtest257of100,1,323,5253,16,319,5588
subtest25of10,pubtest257of100,1,323,5253,15,358,5626
subtest26of10,pubtest257of100,1,323,5253,19,397,5669
subtest28of10,pubtest258of100,1,323,5297,2,39,5338
subtest23of10,pubtest258of100,1,323,5297,3,77,5377
subtest25of10,pubtest258of100,1,323,5297,4,116,5417
subtest21of10,pubtest258of100,1,323,5297,5,155,5457
subtest26of10,pubtest258of100,1,323,5297,6,194,5497
subtest210of10,pubtest258of100,1,323,5297,13,227,5537
subtest29of10,pubtest258of100,1,323,5297,13,267,5577
subtest27of10,pubtest258of100,1,323,5297,15,305,5617
subtest22of10,pubtest258of100,1,323,5297,16,344,5657
subtest24of10,pubtest258of100,1,323,5297,19,381,5697
subtest21of10,pubtest259of100,1,323,5314,1,41,5356
subtest28of10,pubtest259of100,1,323,5314,10,72,5396
subtest25of10,pubtest259of100,1,323,5314,11,110,5435
subtest24of10,pubtest259of100,1,323,5314,12,149,5475
subtest26of10,pubtest259of100,1,323,5314,15,186,5515
subtest27of10,pubtest259of100,1,323,5314,16,230,5560
subtest22of10,pubtest259of100,1,323,5314,22,264,5600
subtest23of10,pubtest259of100,1,323,5314,20,303,5637
subtest29of10,pubtest259of100,1,323,5314,23,342,5679
subtest210of10,pubtest259of100,1,323,5314,26,379,5719
subtest210of10,pubtest260of100,1,323,5265,5,43,5313
subtest23of10,pubtest260of100,1,323,5265,5,81,5351
subtest27of10,pubtest260of100,1,323,5265,7,119,5391
subtest21of10,pubtest260of100,1,323,5265,7,160,5432
subtest26of10,pubtest260of100,1,323,5265,15,191,5471
subtest29of10,pubtest260of100,1,323,5265,18,229,5512
subtest25of10,pubtest260of100,1,323,5265,21,266,5552
subtest22of10,pubtest260of100,1,323,5265,42,284,5591
subtest28of10,pubtest260of100,1,323,5265,43,325,5633
subtest24of10,pubtest260of100,1,323,5265,44,362,5671
subtest29of10,pubtest261of100,1,323,5241,2,40,5283
subtest25of10,pubtest261of100,1,323,5241,2,79,5322
subtest28of10,pubtest261of100,1,323,5241,4,117,5362
subtest210of10,pubtest261of100,1,323,5241,8,154,5403
subtest23of10,pubtest261of100,1,323,5241,9,192,5442
subtest22of10,pubtest261of100,1,323,5241,11,230,5482
subtest27of10,pubtest261of100,1,323,5241,12,269,5522
subtest24of10,pubtest261of100,1,323,5241,19,302,5562
subtest26of10,pubtest261of100,1,323,5241,21,340,5602
subtest21of10,pubtest261of100,1,323,5241,21,380,5642
subtest21of10,pubtest262of100,1,323,5413,4,40,5457
subtest22of10,pubtest262of100,1,323,5413,4,78,5495
subtest23of10,pubtest262of100,1,323,5413,6,117,5536
subtest210of10,pubtest262of100,1,323,5413,7,157,5577
subtest26of10,pubtest262of100,1,323,5413,8,196,5617
subtest27of10,pubtest262of100,1,323,5413,9,234,5656
subtest29of10,pubtest262of100,1,323,5413,9,274,5696
subtest25of10,pubtest262of100,1,323,5413,10,313,5736
subtest28of10,pubtest262of100,1,323,5413,13,350,5776
subtest24of10,pubtest262of100,1,323,5413,13,390,5816
subtest22of10,pubtest263of100,1,322,5200,2,42,5244
subtest24of10,pubtest263of100,1,322,5200,4,78,5282
subtest29of10,pubtest263of100,1,322,5200,4,118,5322
subtest26of10,pubtest263of100,1,322,5200,6,156,5362
subtest23of10,pubtest263of100,1,322,5200,11,190,5401
subtest210of10,pubtest263of100,1,322,5200,12,230,5442
subtest27of10,pubtest263of100,1,322,5200,19,263,5482
subtest25of10,pubtest263of100,1,322,5200,19,303,5522
subtest28of10,pubtest263of100,1,322,5200,20,342,5562
subtest21of10,pubtest263of100,1,322,5200,22,380,5602
subtest22of10,pubtest264of100,1,322,5301,-5,42,5338
subtest29of10,pubtest264of100,1,322,5301,-4,79,5376
subtest23of10,pubtest264of100,1,322,5301,-1,117,5417
subtest27of10,pubtest264of100,1,322,5301,1,155,5457
subtest25of10,pubtest264of100,1,322,5301,1,195,5497
subtest21of10,pubtest264of100,1,322,5301,1,234,5536
subtest28of10,pubtest264of100,1,322,5301,3,273,5577
subtest24of10,pubtest264of100,1,322,5301,-2,317,5616
subtest26of10,pubtest264of100,1,322,5301,8,348,5657
subtest210of10,pubtest264of100,1,322,5301,9,387,5697
subtest26of10,pubtest265of100,1,323,5262,-1,39,5300
subtest27of10,pubtest265of100,1,323,5262,0,77,5339
subtest210of10,pubtest265of100,1,323,5262,2,115,5379
subtest29of10,pubtest265of100,1,323,5262,9,146,5417
subtest22of10,pubtest265of100,1,323,5262,10,186,5458
subtest21of10,pubtest265of100,1,323,5262,9,225,5496
subtest25of10,pubtest265of100,1,323,5262,12,264,5538
subtest23of10,pubtest265of100,1,323,5262,14,302,5578
subtest28of10,pubtest265of100,1,323,5262,15,341,5618
subtest24of10,pubtest265of100,1,323,5262,16,377,5655
subtest29of10,pubtest266of100,1,321,5263,2,38,5303
subtest25of10,pubtest266of100,1,321,5263,3,75,5341
subtest27of10,pubtest266of100,1,321,5263,4,115,5382
subtest26of10,pubtest266of100,1,321,5263,5,154,5422
subtest210of10,pubtest266of100,1,321,5263,2,190,5455
subtest21of10,pubtest266of100,1,321,5263,6,230,5499
subtest24of10,pubtest266of100,1,321,5263,9,269,5541
subtest28of10,pubtest266of100,1,321,5263,9,309,5581
subtest23of10,pubtest266of100,1,321,5263,10,348,5621
subtest22of10,pubtest266of100,1,321,5263,16,383,5662
subtest23of10,pubtest267of100,1,323,5233,-3,41,5271
subtest26of10,pubtest267of100,1,323,5233,-2,78,5309
subtest25of10,pubtest267of100,1,323,5233,2,115,5350
subtest29of10,pubtest267of100,1,323,5233,3,155,5391
subtest28of10,pubtest267of100,1,323,5233,1,193,5427
subtest22of10,pubtest267of100,1,323,5233,5,232,5470
subtest24of10,pubtest267of100,1,323,5233,5,273,5511
subtest21of10,pubtest267of100,1,323,5233,6,311,5550
subtest27of10,pubtest267of100,1,323,5233,3,350,5586
subtest210of10,pubtest267of100,1,323,5233,10,387,5630
subtest23of10,pubtest268of100,1,323,5171,-1,40,5210
subtest24of10,pubtest268of100,1,323,5171,6,72,5249
subtest29of10,pubtest268of100,1,323,5171,6,112,5289
subtest25of10,pubtest268of100,1,323,5171,6,151,5328
subtest28of10,pubtest268of100,1,323,5171,9,189,5369
subtest27of10,pubtest268of100,1,323,5171,10,228,5409
subtest22of10,pubtest268of100,1,323,5171,11,267,5449
subtest210of10,pubtest268of100,1,323,5171,12,304,5487
subtest21of10,pubtest268of100,1,323,5171,11,344,5526
subtest26of10,pubtest268of100,1,323,5171,16,382,5569
subtest24of10,pubtest269of100,1,323,5223,-2,40,5261
subtest27of10,pubtest269of100,1,323,5223,0,77,5300
subtest26of10,pubtest269of100,1,323,5223,9,108,5340
subtest25of10,pubtest269of100,1,323,5223,10,146,5379
subtest210of10,pubtest269of100,1,323,5223,9,185,5417
subtest22of10,pubtest269of100,1,323,5223,14,223,5460
subtest21of10,pubtest269of100,1,323,5223,14,263,5500
subtest29of10,pubtest269of100,1,323,5223,16,301,5540
subtest28of10,pubtest269of100,1,323,5223,17,340,5580
subtest23of10,pubtest269of100,1,323,5223,18,379,5620
subtest27of10,pubtest270of100,1,323,5485,17,52,5554
subtest23of10,pubtest270of100,1,323,5485,17,91,5593
subtest29of10,pubtest270of100,1,323,5485,21,127,5633
subtest25of10,pubtest270of100,1,323,5485,22,167,5674
subtest21of10,pubtest270of100,1,323,5485,24,203,5712
subtest22of10,pubtest270of100,1,323,5485,25,242,5752
subtest24of10,pubtest270of100,1,323,5485,26,281,5792
subtest210of10,pubtest270of100,1,323,5485,19,320,5824
subtest26of10,pubtest270of100,1,323,5485,19,360,5864
subtest28of10,pubtest270of100,1,323,5485,23,400,5908
subtest24of10,pubtest271of100,1,323,5237,1,40,5278
subtest25of10,pubtest271of100,1,323,5237,2,79,5318
subtest22of10,pubtest271of100,1,323,5237,4,116,5357
subtest27of10,pubtest271of100,1,323,5237,4,156,5397
subtest210of10,pubtest271of100,1,323,5237,7,193,5437
subtest26of10,pubtest271of100,1,323,5237,9,231,5477
subtest21of10,pubtest271of100,1,323,5237,9,271,5517
subtest28of10,pubtest271of100,1,323,5237,13,307,5557
subtest23of10,pubtest271of100,1,323,5237,14,346,5597
subtest29of10,pubtest271of100,1,323,5237,17,383,5637
subtest25of10,pubtest272of100,1,323,5229,0,44,5273
subtest26of10,pubtest272of100,1,323,5229,5,78,5312
subtest29of10,pubtest272of100,1,323,5229,8,114,5351
subtest21of10,pubtest272of100,1,323,5229,7,154,5390
subtest23of10,pubtest272of100,1,323,5229,10,193,5432
subtest210of10,pubtest272of100,1,323,5229,14,229,5472
subtest24of10,pubtest272of100,1,323,5229,14,269,5512
subtest27of10,pubtest272of100,1,323,5229,14,309,5552
subtest22of10,pubtest272of100,1,323,5229,22,341,5592
subtest28of10,pubtest272of100,1,323,5229,22,381,5632
subtest22of10,pubtest273of100,1,321,5231,2,41,5274
subtest29of10,pubtest273of100,1,321,5231,3,79,5313
subtest28of10,pubtest273of100,1,321,5231,5,117,5353
subtest26of10,pubtest273of100,1,321,5231,4,156,5391
subtest210of10,pubtest273of100,1,321,5231,6,195,5432
subtest25of10,pubtest273of100,1,321,5231,7,234,5472
subtest27of10,pubtest273of100,1,321,5231,8,273,5512
subtest23of10,pubtest273of100,1,321,5231,9,312,5552
subtest21of10,pubtest273of100,1,321,5231,10,351,5592
subtest24of10,pubtest273of100,1,321,5231,11,389,5631
subtest21of10,pubtest274of100,1,323,5219,-2,40,5257
subtest26of10,pubtest274of100,1,323,5219,-1,80,5298
subtest23of10,pubtest274of100,1,323,5219,5,113,5337
subtest29of10,pubtest274of100,1,323,5219,9,149,5377
subtest22of10,pubtest274of100,1,323,5219,10,188,5417
subtest25of10,pubtest274of100,1,323,5219,11,226,5456
subtest24of10,pubtest274of100,1,323,5219,17,261,5497
subtest28of10,pubtest274of100,1,323,5219,17,301,5537
subtest27of10,pubtest274of100,1,323,5219,18,340,5577
subtest210of10,pubtest274of100,1,323,5219,22,376,5617
subtest27of10,pubtest275of100,1,323,5179,29,44,5252
subtest24of10,pubtest275of100,1,323,5179,31,83,5293
subtest29of10,pubtest275of100,1,323,5179,29,122,5330
subtest25of10,pubtest275of100,1,323,5179,34,160,5373
subtest210of10,pubtest275of100,1,323,5179,36,200,5415
subtest22of10,pubtest275of100,1,323,5179,36,239,5454
subtest21of10,pubtest275of100,1,323,5179,37,277,5493
subtest23of10,pubtest275of100,1,323,5179,38,316,5533
subtest28of10,pubtest275of100,1,323,5179,47,347,5573
subtest26of10,pubtest275of100,1,323,5179,47,387,5613
subtest28of10,pubtest276of100,1,323,5225,2,40,5267
subtest21of10,pubtest276of100,1,323,5225,3,79,5307
subtest25of10,pubtest276of100,1,323,5225,6,115,5346
subtest27of10,pubtest276of100,1,323,5225,7,154,5386
subtest29of10,pubtest276of100,1,323,5225,12,189,5426
subtest24of10,pubtest276of100,1,323,5225,11,228,5464
subtest26of10,pubtest276of100,1,323,5225,12,268,5505
subtest23of10,pubtest276of100,1,323,5225,14,305,5544
subtest22of10,pubtest276of100,1,323,5225,16,346,5587
subtest210of10,pubtest276of100,1,323,5225,17,384,5626
subtest22of10,pubtest277of100,1,323,5187,7,42,5236
subtest24of10,pubtest277of100,1,323,5187,12,77,5276
subtest23of10,pubtest277of100,1,323,5187,12,116,5315
subtest28of10,pubtest277of100,1,323,5187,14,154,5355
subtest210of10,pubtest277of100,1,323,5187,13,194,5394
subtest29of10,pubtest277of100,1,323,5187,8,242,5437
subtest21of10,pubtest277of100,1,323,5187,9,274,5470
subtest25of10,pubtest277of100,1,323,5187,15,312,5514
subtest27of10,pubtest277of100,1,323,5187,10,352,5549
subtest26of10,pubtest277of100,1,323,5187,18,391,5596
subtest29of10,pubtest278of100,1,323,5275,6,42,5323
subtest22of10,pubtest278of100,1,323,5275,7,80,5362
subtest28of10,pubtest278of100,1,323,5275,9,118,5402
subtest23of10,pubtest278of100,1,323,5275,9,158,5442
subtest25of10,pubtest278of100,1,323,5275,11,196,5482
subtest27of10,pubtest278of100,1,323,5275,11,236,5522
subtest26of10,pubtest278of100,1,323,5275,13,273,5561
subtest24of10,pubtest278of100,1,323,5275,13,314,5602
subtest21of10,pubtest278of100,1,323,5275,13,354,5642
subtest210of10,pubtest278of100,1,323,5275,13,392,5680
subtest28of10,pubtest279of100,1,323,5215,15,42,5272
subtest25of10,pubtest279of100,1,323,5215,15,81,5311
subtest21of10,pubtest279of100,1,323,5215,20,116,5351
subtest26of10,pubtest279of100,1,323,5215,21,154,5390
subtest27of10,pubtest279of100,1,323,5215,23,190,5428
subtest210of10,pubtest279of100,1,323,5215,26,230,5471
subtest22of10,pubtest279of100,1,323,5215,25,269,5509
subtest24of10,pubtest279of100,1,323,5215,21,309,5545
subtest29of10,pubtest279of100,1,323,5215,22,349,5586
subtest23of10,pubtest279of100,1,323,5215,28,388,5631
subtest27of10,pubtest280of100,1,323,5183,4,215,5402
subtest29of10,pubtest280of100,1,323,5183,10,247,5440
subtest24of10,pubtest280of100,1,323,5183,10,286,5479
subtest26of10,pubtest280of100,1,323,5183,11,325,5519
subtest21of10,pubtest280of100,1,323,5183,11,363,5557
subtest23of10,pubtest280of100,1,323,5183,16,400,5599
subtest210of10,pubtest280of100,1,323,5183,18,438,5639
subtest28of10,pubtest280of100,1,323,5183,18,478,5679
subtest25of10,pubtest280of100,1,323,5183,16,517,5716
subtest22of10,pubtest280of100,1,323,5183,19,557,5759
subtest24of10,pubtest281of100,1,323,5279,0,39,5318
subtest23of10,pubtest281of100,1,323,5279,2,76,5357
subtest28of10,pubtest281of100,1,323,5279,3,115,5397
subtest22of10,pubtest281of100,1,323,5279,11,147,5437
subtest27of10,pubtest281of100,1,323,5279,12,186,5477
subtest25of10,pubtest281of100,1,323,5279,14,224,5517
subtest210of10,pubtest281of100,1,323,5279,14,261,5554
subtest26of10,pubtest281of100,1,323,5279,17,301,5597
subtest21of10,pubtest281of100,1,323,5279,18,340,5637
subtest29of10,pubtest281of100,1,323,5279,19,379,5677
subtest24of10,pubtest282of100,1,323,5215,-1,46,5260
subtest23of10,pubtest282of100,1,323,5215,-1,85,5299
subtest22of10,pubtest282of100,1,323,5215,5,120,5340
subtest21of10,pubtest282of100,1,323,5215,1,159,5375
subtest25of10,pubtest282of100,1,323,5215,13,193,5421
subtest26of10,pubtest282of100,1,323,5215,22,223,5460
subtest27of10,pubtest282of100,1,323,5215,24,261,5500
subtest29of10,pubtest282of100,1,323,5215,23,301,5539
subtest210of10,pubtest282of100,1,323,5215,25,340,5580
subtest28of10,pubtest282of100,1,323,5215,27,378,5620
subtest24of10,pubtest283of100,1,323,5268,6,40,5314
subtest27of10,pubtest283of100,1,323,5268,7,77,5352
subtest22of10,pubtest283of100,1,323,5268,9,116,5393
subtest23of10,pubtest283of100,1,323,5268,10,155,5433
subtest28of10,pubtest283of100,1,323,5268,10,195,5473
subtest25of10,pubtest283of100,1,323,5268,13,232,5513
subtest21of10,pubtest283of100,1,323,5268,14,272,5554
subtest26of10,pubtest283of100,1,323,5268,17,307,5592
subtest210of10,pubtest283of100,1,323,5268,17,347,5632
subtest29of10,pubtest283of100,1,323,5268,15,387,5670
subtest25of10,pubtest284of100,1,323,5305,0,38,5343
subtest22of10,pubtest284of100,1,323,5305,2,76,5383
subtest29of10,pubtest284of100,1,323,5305,4,113,5422
subtest210of10,pubtest284of100,1,323,5305,19,136,5460
subtest27of10,pubtest284of100,1,323,5305,22,175,5502
subtest23of10,pubtest284of100,1,323,5305,26,211,5542
subtest24of10,pubtest284of100,1,323,5305,33,244,5582
subtest28of10,pubtest284of100,1,323,5305,34,283,5622
subtest21of10,pubtest284of100,1,323,5305,33,322,5660
subtest26of10,pubtest284of100,1,323,5305,39,359,5703
subtest23of10,pubtest285of100,1,323,5278,0,42,5320
subtest24of10,pubtest285of100,1,323,5278,0,81,5359
subtest25of10,pubtest285of100,1,323,5278,2,119,5399
subtest27of10,pubtest285of100,1,323,5278,12,149,5439
subtest22of10,pubtest285of100,1,323,5278,13,188,5479
subtest21of10,pubtest285of100,1,323,5278,23,218,5519
subtest28of10,pubtest285of100,1,323,5278,23,257,5558
subtest29of10,pubtest285of100,1,323,5278,25,296,5599
subtest26of10,pubtest285of100,1,323,5278,25,333,5636
subtest210of10,pubtest285of100,1,323,5278,25,376,5679
subtest23of10,pubtest286of100,1,323,5210,0,283,5493
subtest210of10,pubtest286of100,1,323,5210,3,280,5493
subtest25of10,pubtest286of100,1,323,5210,4,317,5531
subtest29of10,pubtest286of100,1,323,5210,10,351,5571
subtest21of10,pubtest286of100,1,323,5210,14,387,5611
subtest27of10,pubtest286of100,1,323,5210,14,427,5651
subtest26of10,pubtest286of100,1,323,5210,15,466,5691
subtest28of10,pubtest286of100,1,323,5210,16,505,5731
subtest22of10,pubtest286of100,1,323,5210,16,545,5771
subtest24of10,pubtest286of100,1,323,5210,11,584,5805
subtest26of10,pubtest287of100,1,323,5146,3,120,5269
subtest29of10,pubtest287of100,1,323,5146,4,159,5309
subtest27of10,pubtest287of100,1,323,5146,5,198,5349
subtest25of10,pubtest287of100,1,323,5146,6,237,5389
subtest28of10,pubtest287of100,1,323,5146,5,277,5428
subtest210of10,pubtest287of100,1,323,5146,7,316,5469
subtest23of10,pubtest287of100,1,323,5146,9,354,5509
subtest21of10,pubtest287of100,1,323,5146,9,394,5549
subtest24of10,pubtest287of100,1,323,5146,10,432,5588
subtest22of10,pubtest287of100,1,323,5146,11,470,5627
subtest29of10,pubtest288of100,1,323,5216,0,39,5255
subtest26of10,pubtest288of100,1,323,5216,10,67,5293
subtest23of10,pubtest288of100,1,323,5216,12,106,5334
subtest27of10,pubtest288of100,1,323,5216,12,146,5374
subtest25of10,pubtest288of100,1,323,5216,10,185,5411
subtest28of10,pubtest288of100,1,323,5216,16,222,5454
subtest210of10,pubtest288of100,1,323,5216,16,262,5494
subtest21of10,pubtest288of100,1,323,5216,14,301,5531
subtest24of10,pubtest288of100,1,323,5216,18,340,5574
subtest22of10,pubtest288of100,1,323,5216,19,379,5614
subtest25of10,pubtest289of100,1,323,5156,4,45,5205
subtest29of10,pubtest289of100,1,323,5156,4,86,5246
subtest23of10,pubtest289of100,1,323,5156,5,124,5285
subtest210of10,pubtest289of100,1,323,5156,6,163,5325
subtest24of10,pubtest289of100,1,323,5156,10,199,5365
subtest27of10,pubtest289of100,1,323,5156,12,237,5405
subtest26of10,pubtest289of100,1,323,5156,15,274,5445
subtest21of10,pubtest289of100,1,323,5156,15,314,5485
subtest28of10,pubtest289of100,1,323,5156,17,352,5525
subtest22of10,pubtest289of100,1,323,5156,21,387,5564
subtest29of10,pubtest290of100,1,323,5225,-2,42,5265
subtest23of10,pubtest290of100,1,323,5225,6,72,5303
subtest22of10,pubtest290of100,1,323,5225,12,106,5343
subtest26of10,pubtest290of100,1,323,5225,12,145,5382
subtest27of10,pubtest290of100,1,323,5225,13,184,5422
subtest28of10,pubtest290of100,1,323,5225,16,222,5463
subtest25of10,pubtest290of100,1,323,5225,11,262,5498
subtest21of10,pubtest290of100,1,323,5225,16,300,5541
subtest24of10,pubtest290of100,1,323,5225,16,340,5581
subtest210of10,pubtest290of100,1,323,5225,16,379,5620
subtest24of10,pubtest291of100,1,323,5367,5,40,5412
subtest28of10,pubtest291of100,1,323,5367,7,76,5450
subtest210of10,pubtest291of100,1,323,5367,9,115,5491
subtest27of10,pubtest291of100,1,323,5367,7,154,5528
subtest21of10,pubtest291of100,1,323,5367,11,193,5571
subtest22of10,pubtest291of100,1,323,5367,11,234,5612
subtest23of10,pubtest291of100,1,323,5367,7,273,5647
subtest25of10,pubtest291of100,1,323,5367,16,308,5691
subtest29of10,pubtest291of100,1,323,5367,21,344,5732
subtest26of10,pubtest291of100,1,323,5367,21,383,5771
subtest29of10,pubtest292of100,1,323,5192,7,39,5238
subtest21of10,pubtest292of100,1,323,5192,9,76,5277
subtest28of10,pubtest292of100,1,323,5192,7,116,5315
subtest27of10,pubtest292of100,1,323,5192,17,148,5357
subtest23of10,pubtest292of100,1,323,5192,17,188,5397
subtest25of10,pubtest292of100,1,323,5192,14,227,5433
subtest26of10,pubtest292of100,1,323,5192,19,266,5477
subtest22of10,pubtest292of100,1,323,5192,19,306,5517
subtest24of10,pubtest292of100,1,323,5192,21,345,5558
subtest210of10,pubtest292of100,1,323,5192,26,379,5597
subtest25of10,pubtest293of100,1,323,5325,6,42,5373
subtest24of10,pubtest293of100,1,323,5325,8,79,5412
subtest28of10,pubtest293of100,1,323,5325,10,117,5452
subtest23of10,pubtest293of100,1,323,5325,19,148,5492
subtest210of10,pubtest293of100,1,323,5325,21,186,5532
subtest27of10,pubtest293of100,1,323,5325,21,226,5572
subtest21of10,pubtest293of100,1,323,5325,24,263,5612
subtest26of10,pubtest293of100,1,323,5325,27,298,5650
subtest29of10,pubtest293of100,1,323,5325,28,337,5690
subtest22of10,pubtest293of100,1,323,5325,30,377,5732
subtest21of10,pubtest294of100,1,323,5233,5,41,5279
subtest25of10,pubtest294of100,1,323,5233,7,78,5318
subtest29of10,pubtest294of100,1,323,5233,12,112,5357
subtest27of10,pubtest294of100,1,323,5233,16,149,5398
subtest210of10,pubtest294of100,1,323,5233,16,190,5439
subtest23of10,pubtest294of100,1,323,5233,18,227,5478
subtest26of10,pubtest294of100,1,323,5233,19,266,5518
subtest24of10,pubtest294of100,1,323,5233,22,303,5558
subtest22of10,pubtest294of100,1,323,5233,23,342,5598
subtest28of10,pubtest294of100,1,323,5233,24,381,5638
subtest23of10,pubtest295of100,1,323,5489,6,38,5533
subtest24of10,pubtest295of100,1,323,5489,4,79,5572
subtest25of10,pubtest295of100,1,323,5489,4,119,5612
subtest22of10,pubtest295of100,1,323,5489,7,157,5653
subtest27of10,pubtest295of100,1,323,5489,8,195,5692
subtest210of10,pubtest295of100,1,323,5489,10,233,5732
subtest29of10,pubtest295of100,1,323,5489,10,271,5770
subtest21of10,pubtest295of100,1,323,5489,13,310,5812
subtest28of10,pubtest295of100,1,323,5489,13,350,5852
subtest26of10,pubtest295of100,1,323,5489,22,381,5892
subtest24of10,pubtest296of100,1,322,5284,4,41,5329
subtest25of10,pubtest296of100,1,322,5284,3,81,5368
subtest26of10,pubtest296of100,1,322,5284,8,118,5410
subtest27of10,pubtest296of100,1,322,5284,13,152,5449
subtest23of10,pubtest296of100,1,322,5284,16,189,5489
subtest29of10,pubtest296of100,1,322,5284,16,233,5533
subtest21of10,pubtest296of100,1,322,5284,18,271,5573
subtest28of10,pubtest296of100,1,322,5284,24,305,5613
subtest210of10,pubtest296of100,1,322,5284,25,343,5652
subtest22of10,pubtest296of100,1,322,5284,26,383,5693
subtest25of10,pubtest297of100,1,323,5247,8,50,5305
subtest210of10,pubtest297of100,1,323,5247,9,86,5342
subtest29of10,pubtest297of100,1,323,5247,10,124,5381
subtest22of10,pubtest297of100,1,323,5247,15,161,5423
subtest27of10,pubtest297of100,1,323,5247,16,200,5463
subtest23of10,pubtest297of100,1,323,5247,11,243,5501
subtest26of10,pubtest297of100,1,323,5247,21,275,5543
subtest28of10,pubtest297of100,1,323,5247,22,314,5583
subtest21of10,pubtest297of100,1,323,5247,23,352,5622
subtest24of10,pubtest297of100,1,323,5247,23,392,5662
subtest29of10,pubtest298of100,1,323,5212,8,43,5263
subtest22of10,pubtest298of100,1,323,5212,15,73,5300
subtest25of10,pubtest298of100,1,323,5212,26,102,5340
subtest23of10,pubtest298of100,1,323,5212,30,138,5380
subtest24of10,pubtest298of100,1,323,5212,30,178,5420
subtest21of10,pubtest298of100,1,323,5212,32,216,5460
subtest28of10,pubtest298of100,1,323,5212,33,255,5500
subtest27of10,pubtest298of100,1,323,5212,33,295,5540
subtest210of10,pubtest298of100,1,323,5212,32,332,5576
subtest26of10,pubtest298of100,1,323,5212,39,369,5620
subtest22of10,pubtest299of100,1,323,5276,0,39,5315
subtest29of10,pubtest299of100,1,323,5276,4,75,5355
subtest24of10,pubtest299of100,1,323,5276,4,112,5392
subtest27of10,pubtest299of100,1,323,5276,7,151,5434
subtest210of10,pubtest299of100,1,323,5276,8,190,5474
subtest28of10,pubtest299of100,1,323,5276,9,230,5515
subtest23of10,pubtest299of100,1,323,5276,11,267,5554
subtest25of10,pubtest299of100,1,323,5276,12,307,5595
subtest26of10,pubtest299of100,1,323,5276,14,344,5634
subtest21of10,pubtest299of100,1,323,5276,16,382,5674
subtest21of10,pubtest2100of100,1,325,5176,5,41,5222
subtest24of10,pubtest2100of100,1,325,5176,6,81,5263
subtest29of10,pubtest2100of100,1,325,5176,9,116,5301
subtest23of10,pubtest2100of100,1,325,5176,10,155,5341
subtest22of10,pubtest2100of100,1,325,5176,9,195,5380
subtest25of10,pubtest2100of100,1,325,5176,14,231,5421
subtest27of10,pubtest2100of100,1,325,5176,14,271,5461
subtest28of10,pubtest2100of100,1,325,5176,14,309,5499
subtest210of10,pubtest2100of100,1,325,5176,18,347,5541
subtest26of10,pubtest2100of100,1,325,5176,23,382,5581
subtest27of10,pubtest21of100,1,322,10255,0,41,10296
subtest26of10,pubtest21of100,1,322,10255,1,79,10335
subtest29of10,pubtest21of100,1,322,10255,3,117,10375
subtest25of10,pubtest21of100,1,322,10255,3,157,10415
subtest24of10,pubtest21of100,1,322,10255,5,195,10455
subtest21of10,pubtest21of100,1,322,10255,8,232,10495
subtest210of10,pubtest21of100,1,322,10255,12,268,10535
subtest23of10,pubtest21of100,1,322,10255,14,305,10574
subtest28of10,pubtest21of100,1,322,10255,14,345,10614
subtest22of10,pubtest21of100,1,322,10255,17,383,10655
subtest29of10,pubtest22of100,1,321,5199,-6,41,5234
subtest24of10,pubtest22of100,1,321,5199,-2,76,5273
subtest23of10,pubtest22of100,1,321,5199,0,112,5311
subtest25of10,pubtest22of100,1,321,5199,2,152,5353
subtest27of10,pubtest22of100,1,321,5199,0,191,5390
subtest26of10,pubtest22of100,1,321,5199,4,230,5433
subtest210of10,pubtest22of100,1,321,5199,4,272,5475
subtest21of10,pubtest22of100,1,321,5199,2,310,5511
subtest22of10,pubtest22of100,1,321,5199,6,348,5553
subtest28of10,pubtest22of100,1,321,5199,7,387,5593
subtest23of10,pubtest23of100,1,321,5655,-1,41,5695
subtest29of10,pubtest23of100,1,321,5655,1,79,5735
subtest28of10,pubtest23of100,1,321,5655,3,117,5775
subtest27of10,pubtest23of100,1,321,5655,9,150,5814
subtest25of10,pubtest23of100,1,321,5655,10,190,5855
subtest24of10,pubtest23of100,1,321,5655,11,228,5894
subtest26of10,pubtest23of100,1,321,5655,15,264,5934
subtest22of10,pubtest23of100,1,321,5655,15,304,5974
subtest210of10,pubtest23of100,1,321,5655,17,342,6014
subtest21of10,pubtest23of100,1,321,5655,17,382,6054
subtest23of10,pubtest24of100,1,321,5309,-2,41,5348
subtest24of10,pubtest24of100,1,321,5309,3,75,5387
subtest25of10,pubtest24of100,1,321,5309,3,114,5426
subtest21of10,pubtest24of100,1,321,5309,5,152,5466
subtest29of10,pubtest24of100,1,321,5309,5,192,5506
subtest27of10,pubtest24of100,1,321,5309,7,230,5546
subtest28of10,pubtest24of100,1,321,5309,9,268,5586
subtest22of10,pubtest24of100,1,321,5309,10,307,5626
subtest26of10,pubtest24of100,1,321,5309,12,344,5665
subtest210of10,pubtest24of100,1,321,5309,12,384,5705
subtest28of10,pubtest25of100,1,321,5213,0,38,5251
subtest21of10,pubtest25of100,1,321,5213,9,68,5290
subtest210of10,pubtest25of100,1,321,5213,10,106,5329
subtest26of10,pubtest25of100,1,321,5213,12,145,5370
subtest27of10,pubtest25of100,1,321,5213,12,184,5409
subtest23of10,pubtest25of100,1,321,5213,17,219,5449
subtest25of10,pubtest25of100,1,321,5213,17,259,5489
subtest22of10,pubtest25of100,1,321,5213,19,298,5530
subtest29of10,pubtest25of100,1,321,5213,20,338,5571
subtest24of10,pubtest25of100,1,321,5213,21,377,5611
subtest21of10,pubtest26of100,1,321,5229,0,40,5269
subtest29of10,pubtest26of100,1,321,5229,1,78,5308
subtest22of10,pubtest26of100,1,321,5229,4,115,5348
subtest23of10,pubtest26of100,1,321,5229,4,155,5388
subtest26of10,pubtest26of100,1,321,5229,5,193,5427
subtest27of10,pubtest26of100,1,321,5229,8,230,5467
subtest25of10,pubtest26of100,1,321,5229,8,270,5507
subtest28of10,pubtest26of100,1,321,5229,10,311,5550
subtest210of10,pubtest26of100,1,321,5229,11,350,5590
subtest24of10,pubtest26of100,1,321,5229,12,387,5628
subtest27of10,pubtest27of100,1,320,5239,6,40,5285
subtest28of10,pubtest27of100,1,320,5239,6,80,5325
subtest24of10,pubtest27of100,1,320,5239,8,117,5364
subtest23of10,pubtest27of100,1,320,5239,8,157,5404
subtest29of10,pubtest27of100,1,320,5239,9,196,5444
subtest25of10,pubtest27of100,1,320,5239,19,226,5484
subtest210of10,pubtest27of100,1,320,5239,19,264,5522
subtest26of10,pubtest27of100,1,320,5239,23,302,5564
subtest22of10,pubtest27of100,1,320,5239,23,342,5604
subtest21of10,pubtest27of100,1,320,5239,23,381,5643
subtest27of10,pubtest28of100,1,321,5303,-1,39,5341
subtest21of10,pubtest28of100,1,321,5303,2,75,5380
subtest28of10,pubtest28of100,1,321,5303,3,115,5421
subtest29of10,pubtest28of100,1,321,5303,5,152,5460
subtest23of10,pubtest28of100,1,321,5303,10,187,5500
subtest25of10,pubtest28of100,1,321,5303,14,223,5540
subtest210of10,pubtest28of100,1,321,5303,16,261,5580
subtest26of10,pubtest28of100,1,321,5303,17,300,5620
subtest24of10,pubtest28of100,1,321,5303,18,337,5658
subtest22of10,pubtest28of100,1,321,5303,21,376,5700
subtest23of10,pubtest29of100,1,321,5182,0,45,5227
subtest210of10,pubtest29of100,1,321,5182,2,84,5268
subtest29of10,pubtest29of100,1,321,5182,1,123,5306
subtest22of10,pubtest29of100,1,321,5182,3,159,5344
subtest25of10,pubtest29of100,1,321,5182,3,199,5384
subtest28of10,pubtest29of100,1,321,5182,37,207,5426
subtest24of10,pubtest29of100,1,321,5182,41,243,5466
subtest21of10,pubtest29of100,1,321,5182,41,283,5506
subtest27of10,pubtest29of100,1,321,5182,43,322,5547
subtest26of10,pubtest29of100,1,321,5182,43,361,5586
subtest21of10,pubtest210of100,1,323,5414,-1,45,5458
subtest29of10,pubtest210of100,1,323,5414,0,82,5496
subtest210of10,pubtest210of100,1,323,5414,2,121,5537
subtest27of10,pubtest210of100,1,323,5414,14,148,5576
subtest23of10,pubtest210of100,1,323,5414,14,188,5616
subtest28of10,pubtest210of100,1,323,5414,15,227,5656
subtest25of10,pubtest210of100,1,323,5414,20,263,5697
subtest22of10,pubtest210of100,1,323,5414,21,302,5737
subtest26of10,pubtest210of100,1,323,5414,24,339,5777
subtest24of10,pubtest210of100,1,323,5414,22,378,5814
subtest24of10,pubtest211of100,1,323,5241,4,46,5291
subtest210of10,pubtest211of100,1,323,5241,4,84,5329
subtest29of10,pubtest211of100,1,323,5241,10,118,5369
subtest22of10,pubtest211of100,1,323,5241,14,154,5409
subtest23of10,pubtest211of100,1,323,5241,20,187,5448
subtest28of10,pubtest211of100,1,323,5241,21,228,5490
subtest25of10,pubtest211of100,1,323,5241,18,266,5525
subtest27of10,pubtest211of100,1,323,5241,20,306,5567
subtest21of10,pubtest211of100,1,323,5241,18,347,5606
subtest26of10,pubtest211of100,1,323,5241,23,385,5649
subtest26of10,pubtest212of100,1,323,5277,12,39,5328
subtest27of10,pubtest212of100,1,323,5277,10,80,5367
subtest210of10,pubtest212of100,1,323,5277,13,119,5409
subtest28of10,pubtest212of100,1,323,5277,11,158,5446
subtest23of10,pubtest212of100,1,323,5277,9,199,5485
subtest29of10,pubtest212of100,1,323,5277,9,235,5521
subtest21of10,pubtest212of100,1,323,5277,15,275,5567
subtest24of10,pubtest212of100,1,323,5277,11,319,5607
subtest25of10,pubtest212of100,1,323,5277,9,354,5640
subtest22of10,pubtest212of100,1,323,5277,16,394,5687
subtest23of10,pubtest213of100,1,322,5218,-2,44,5260
subtest26of10,pubtest213of100,1,322,5218,5,73,5296
subtest22of10,pubtest213of100,1,322,5218,7,110,5335
subtest27of10,pubtest213of100,1,322,5218,6,150,5374
subtest29of10,pubtest213of100,1,322,5218,6,188,5412
subtest25of10,pubtest213of100,1,322,5218,43,194,5455
subtest210of10,pubtest213of100,1,322,5218,44,233,5495
subtest21of10,pubtest213of100,1,322,5218,10,273,5501
subtest24of10,pubtest213of100,1,322,5218,10,313,5541
subtest28of10,pubtest213of100,1,322,5218,43,352,5613
subtest21of10,pubtest214of100,1,323,5228,0,42,5270
subtest25of10,pubtest214of100,1,323,5228,6,74,5308
subtest22of10,pubtest214of100,1,323,5228,7,113,5348
subtest27of10,pubtest214of100,1,323,5228,8,152,5388
subtest23of10,pubtest214of100,1,323,5228,4,192,5424
subtest210of10,pubtest214of100,1,323,5228,9,233,5470
subtest24of10,pubtest214of100,1,323,5228,10,271,5509
subtest26of10,pubtest214of100,1,323,5228,10,310,5548
subtest28of10,pubtest214of100,1,323,5228,11,349,5588
subtest29of10,pubtest214of100,1,323,5228,12,388,5628
subtest27of10,pubtest215of100,1,323,5213,-1,39,5251
subtest23of10,pubtest215of100,1,323,5213,2,77,5292
subtest25of10,pubtest215of100,1,323,5213,1,117,5331
subtest21of10,pubtest215of100,1,323,5213,0,156,5369
subtest29of10,pubtest215of100,1,323,5213,0,196,5409
subtest24of10,pubtest215of100,1,323,5213,7,232,5452
subtest22of10,pubtest215of100,1,323,5213,15,264,5492
subtest210of10,pubtest215of100,1,323,5213,13,304,5530
subtest28of10,pubtest215of100,1,323,5213,15,343,5571
subtest26of10,pubtest215of100,1,323,5213,13,383,5609
subtest24of10,pubtest216of100,1,323,5250,0,42,5292
subtest21of10,pubtest216of100,1,323,5250,1,81,5332
subtest23of10,pubtest216of100,1,323,5250,2,118,5370
subtest27of10,pubtest216of100,1,323,5250,5,156,5411
subtest28of10,pubtest216of100,1,323,5250,5,196,5451
subtest22of10,pubtest216of100,1,323,5250,10,230,5490
subtest26of10,pubtest216of100,1,323,5250,11,271,5532
subtest25of10,pubtest216of100,1,323,5250,10,309,5569
subtest29of10,pubtest216of100,1,323,5250,16,345,5611
subtest210of10,pubtest216of100,1,323,5250,16,385,5651
subtest22of10,pubtest217of100,1,322,5207,2,39,5248
subtest27of10,pubtest217of100,1,322,5207,2,77,5286
subtest21of10,pubtest217of100,1,322,5207,11,109,5327
subtest23of10,pubtest217of100,1,322,5207,11,148,5366
subtest29of10,pubtest217of100,1,322,5207,12,188,5407
subtest26of10,pubtest217of100,1,322,5207,17,222,5446
subtest24of10,pubtest217of100,1,322,5207,17,263,5487
subtest28of10,pubtest217of100,1,322,5207,19,298,5524
subtest210of10,pubtest217of100,1,322,5207,20,338,5565
subtest25of10,pubtest217of100,1,322,5207,19,377,5603
subtest22of10,pubtest218of100,1,323,5245,3,40,5288
subtest29of10,pubtest218of100,1,323,5245,1,81,5327
subtest24of10,pubtest218of100,1,323,5245,4,115,5364
subtest28of10,pubtest218of100,1,323,5245,3,155,5403
subtest21of10,pubtest218of100,1,323,5245,2,199,5446
subtest23of10,pubtest218of100,1,323,5245,7,233,5485
subtest25of10,pubtest218of100,1,323,5245,8,273,5526
subtest210of10,pubtest218of100,1,323,5245,8,312,5565
subtest26of10,pubtest218of100,1,323,5245,10,351,5606
subtest27of10,pubtest218of100,1,323,5245,4,390,5639
subtest26of10,pubtest219of100,1,323,5273,2,40,5315
subtest210of10,pubtest219of100,1,323,5273,2,79,5354
subtest21of10,pubtest219of100,1,323,5273,5,115,5393
subtest25of10,pubtest219of100,1,323,5273,5,155,5433
subtest22of10,pubtest219of100,1,323,5273,6,194,5473
subtest24of10,pubtest219of100,1,323,5273,7,233,5513
subtest28of10,pubtest219of100,1,323,5273,9,271,5553
subtest23of10,pubtest219of100,1,323,5273,10,310,5593
subtest27of10,pubtest219of100,1,323,5273,13,347,5633
subtest29of10,pubtest219of100,1,323,5273,13,387,5673
subtest25of10,pubtest220of100,1,323,5219,-2,40,5257
subtest210of10,pubtest220of100,1,323,5219,0,77,5296
subtest23of10,pubtest220of100,1,323,5219,1,116,5336
subtest29of10,pubtest220of100,1,323,5219,3,154,5376
subtest21of10,pubtest220of100,1,323,5219,4,190,5413
subtest24of10,pubtest220of100,1,323,5219,8,230,5457
subtest27of10,pubtest220of100,1,323,5219,14,263,5496
subtest28of10,pubtest220of100,1,323,5219,15,301,5535
subtest26of10,pubtest220of100,1,323,5219,16,343,5578
subtest22of10,pubtest220of100,1,323,5219,17,380,5616
subtest24of10,pubtest221of100,1,323,5209,0,39,5248
subtest21of10,pubtest221of100,1,323,5209,1,77,5287
subtest28of10,pubtest221of100,1,323,5209,7,110,5326
subtest25of10,pubtest221of100,1,323,5209,9,149,5367
subtest22of10,pubtest221of100,1,323,5209,10,188,5407
subtest23of10,pubtest221of100,1,323,5209,8,230,5447
subtest29of10,pubtest221of100,1,323,5209,11,267,5487
subtest26of10,pubtest221of100,1,323,5209,13,305,5527
subtest27of10,pubtest221of100,1,323,5209,12,343,5564
subtest210of10,pubtest221of100,1,323,5209,15,383,5607
subtest21of10,pubtest222of100,1,323,5170,22,53,5245
subtest22of10,pubtest222of100,1,323,5170,23,91,5284
subtest23of10,pubtest222of100,1,323,5170,25,129,5324
subtest28of10,pubtest222of100,1,323,5170,26,168,5364
subtest26of10,pubtest222of100,1,323,5170,27,199,5396
subtest29of10,pubtest222of100,1,323,5170,27,239,5436
subtest24of10,pubtest222of100,1,323,5170,35,277,5482
subtest210of10,pubtest222of100,1,323,5170,37,317,5524
subtest25of10,pubtest222of100,1,323,5170,35,356,5561
subtest27of10,pubtest222of100,1,323,5170,35,395,5600
subtest21of10,pubtest223of100,1,323,5225,6,297,5528
subtest29of10,pubtest223of100,1,323,5225,9,331,5565
subtest27of10,pubtest223of100,1,323,5225,10,370,5605
subtest28of10,pubtest223of100,1,323,5225,8,410,5643
subtest24of10,pubtest223of100,1,323,5225,9,449,5683
subtest210of10,pubtest223of100,1,323,5225,13,487,5725
subtest22of10,pubtest223of100,1,323,5225,13,527,5765
subtest25of10,pubtest223of100,1,323,5225,12,566,5803
subtest26of10,pubtest223of100,1,323,5225,14,606,5845
subtest23of10,pubtest223of100,1,323,5225,8,643,5876
subtest21of10,pubtest224of100,1,323,5381,3,40,5424
subtest27of10,pubtest224of100,1,323,5381,11,71,5463
subtest28of10,pubtest224of100,1,323,5381,12,111,5504
subtest23of10,pubtest224of100,1,323,5381,13,149,5543
subtest26of10,pubtest224of100,1,323,5381,21,179,5581
subtest24of10,pubtest224of100,1,323,5381,24,218,5623
subtest22of10,pubtest224of100,1,323,5381,23,259,5663
subtest210of10,pubtest224of100,1,323,5381,26,296,5703
subtest25of10,pubtest224of100,1,323,5381,23,336,5740
subtest29of10,pubtest224of100,1,323,5381,21,376,5778
subtest22of10,pubtest225of100,1,323,5224,6,41,5271
subtest27of10,pubtest225of100,1,323,5224,5,82,5311
subtest26of10,pubtest225of100,1,323,5224,9,117,5350
subtest25of10,pubtest225of100,1,323,5224,9,158,5391
subtest21of10,pubtest225of100,1,323,5224,9,195,5428
subtest24of10,pubtest225of100,1,323,5224,12,234,5470
subtest23of10,pubtest225of100,1,323,5224,11,274,5509
subtest29of10,pubtest225of100,1,323,5224,11,314,5549
subtest28of10,pubtest225of100,1,323,5224,14,352,5590
subtest210of10,pubtest225of100,1,323,5224,15,391,5630
subtest25of10,pubtest226of100,1,323,5179,4,49,5232
subtest22of10,pubtest226of100,1,323,5179,6,86,5271
subtest27of10,pubtest226of100,1,323,5179,8,124,5311
subtest23of10,pubtest226of100,1,323,5179,9,163,5351
subtest210of10,pubtest226of100,1,323,5179,9,196,5384
subtest21of10,pubtest226of100,1,323,5179,10,235,5424
subtest28of10,pubtest226of100,1,323,5179,15,275,5469
subtest24of10,pubtest226of100,1,323,5179,16,314,5509
subtest26of10,pubtest226of100,1,323,5179,16,355,5550
subtest29of10,pubtest226of100,1,323,5179,11,393,5583
subtest210of10,pubtest227of100,1,323,5172,9,49,5230
subtest29of10,pubtest227of100,1,323,5172,9,89,5270
subtest25of10,pubtest227of100,1,323,5172,11,126,5309
subtest23of10,pubtest227of100,1,323,5172,12,166,5350
subtest26of10,pubtest227of100,1,323,5172,14,204,5390
subtest24of10,pubtest227of100,1,323,5172,15,241,5428
subtest27of10,pubtest227of100,1,323,5172,18,279,5469
subtest22of10,pubtest227of100,1,323,5172,19,315,5506
subtest28of10,pubtest227of100,1,323,5172,19,355,5546
subtest21of10,pubtest227of100,1,323,5172,18,394,5584
subtest21of10,pubtest228of100,1,323,5768,9,40,5817
subtest26of10,pubtest228of100,1,323,5768,14,74,5856
subtest25of10,pubtest228of100,1,323,5768,15,113,5896
subtest23of10,pubtest228of100,1,323,5768,19,147,5934
subtest27of10,pubtest228of100,1,323,5768,28,180,5976
subtest24of10,pubtest228of100,1,323,5768,28,220,6016
subtest22of10,pubtest228of100,1,323,5768,30,260,6058
subtest210of10,pubtest228of100,1,323,5768,31,298,6097
subtest29of10,pubtest228of100,1,323,5768,30,336,6134
subtest28of10,pubtest228of100,1,323,5768,32,376,6176
subtest24of10,pubtest229of100,1,321,5181,-2,43,5222
subtest28of10,pubtest229of100,1,321,5181,-1,80,5260
subtest22of10,pubtest229of100,1,321,5181,1,118,5300
subtest21of10,pubtest229of100,1,321,5181,6,153,5340
subtest27of10,pubtest229of100,1,321,5181,7,192,5380
subtest210of10,pubtest229of100,1,321,5181,10,229,5420
subtest23of10,pubtest229of100,1,321,5181,10,269,5460
subtest25of10,pubtest229of100,1,321,5181,11,306,5498
subtest29of10,pubtest229of100,1,321,5181,14,345,5540
subtest26of10,pubtest229of100,1,321,5181,15,384,5580
subtest21of10,pubtest230of100,1,323,5302,7,42,5351
subtest22of10,pubtest230of100,1,323,5302,6,82,5390
subtest27of10,pubtest230of100,1,323,5302,8,122,5432
subtest28of10,pubtest230of100,1,323,5302,10,157,5469
subtest29of10,pubtest230of100,1,323,5302,8,197,5507
subtest25of10,pubtest230of100,1,323,5302,12,237,5551
subtest23of10,pubtest230of100,1,323,5302,14,274,5590
subtest210of10,pubtest230of100,1,323,5302,14,314,5630
subtest24of10,pubtest230of100,1,323,5302,16,352,5670
subtest26of10,pubtest230of100,1,323,5302,25,383,5710
subtest23of10,pubtest231of100,1,323,5186,1,41,5228
subtest25of10,pubtest231of100,1,323,5186,2,79,5267
subtest28of10,pubtest231of100,1,323,5186,3,118,5307
subtest29of10,pubtest231of100,1,323,5186,8,153,5347
subtest24of10,pubtest231of100,1,323,5186,8,192,5386
subtest27of10,pubtest231of100,1,323,5186,11,230,5427
subtest210of10,pubtest231of100,1,323,5186,10,270,5466
subtest22of10,pubtest231of100,1,323,5186,14,307,5507
subtest26of10,pubtest231of100,1,323,5186,12,347,5545
subtest21of10,pubtest231of100,1,323,5186,14,386,5586
subtest21of10,pubtest232of100,1,323,5214,0,43,5257
subtest22of10,pubtest232of100,1,323,5214,2,77,5293
subtest29of10,pubtest232of100,1,323,5214,4,117,5335
subtest25of10,pubtest232of100,1,323,5214,5,155,5374
subtest27of10,pubtest232of100,1,323,5214,1,195,5410
subtest23of10,pubtest232of100,1,323,5214,6,235,5455
subtest28of10,pubtest232of100,1,323,5214,10,271,5495
subtest210of10,pubtest232of100,1,323,5214,12,308,5534
subtest24of10,pubtest232of100,1,323,5214,13,347,5574
subtest26of10,pubtest232of100,1,323,5214,14,386,5614
subtest24of10,pubtest233of100,1,323,5519,-3,42,5558
subtest29of10,pubtest233of100,1,323,5519,4,74,5597
subtest25of10,pubtest233of100,1,323,5519,4,114,5637
subtest27of10,pubtest233of100,1,323,5519,9,149,5677
subtest26of10,pubtest233of100,1,323,5519,10,188,5717
subtest210of10,pubtest233of100,1,323,5519,9,227,5755
subtest22of10,pubtest233of100,1,323,5519,15,263,5797
subtest23of10,pubtest233of100,1,323,5519,15,303,5837
subtest28of10,pubtest233of100,1,323,5519,17,342,5878
subtest21of10,pubtest233of100,1,323,5519,17,381,5917
subtest27of10,pubtest234of100,1,323,5314,4,43,5361
subtest25of10,pubtest234of100,1,323,5314,3,83,5400
subtest26of10,pubtest234of100,1,323,5314,3,121,5438
subtest22of10,pubtest234of100,1,323,5314,15,152,5481
subtest21of10,pubtest234of100,1,323,5314,16,192,5522
subtest29of10,pubtest234of100,1,323,5314,19,229,5562
subtest23of10,pubtest234of100,1,323,5314,19,269,5602
subtest210of10,pubtest234of100,1,323,5314,21,307,5642
subtest24of10,pubtest234of100,1,323,5314,27,341,5682
subtest28of10,pubtest234of100,1,323,5314,27,380,5721
subtest21of10,pubtest235of100,1,321,5210,0,41,5251
subtest210of10,pubtest235of100,1,321,5210,2,79,5291
subtest23of10,pubtest235of100,1,321,5210,6,114,5330
subtest27of10,pubtest235of100,1,321,5210,8,152,5370
subtest29of10,pubtest235of100,1,321,5210,14,185,5409
subtest25of10,pubtest235of100,1,321,5210,14,224,5448
subtest24of10,pubtest235of100,1,321,5210,18,263,5491
subtest22of10,pubtest235of100,1,321,5210,18,302,5530
subtest28of10,pubtest235of100,1,321,5210,24,336,5570
subtest26of10,pubtest235of100,1,321,5210,24,377,5611
subtest210of10,pubtest236of100,1,323,5218,1,39,5258
subtest23of10,pubtest236of100,1,323,5218,2,77,5297
subtest28of10,pubtest236of100,1,323,5218,4,115,5337
subtest27of10,pubtest236of100,1,323,5218,3,154,5375
subtest25of10,pubtest236of100,1,323,5218,4,194,5416
subtest21of10,pubtest236of100,1,323,5218,8,231,5457
subtest29of10,pubtest236of100,1,323,5218,11,268,5497
subtest24of10,pubtest236of100,1,323,5218,12,307,5537
subtest26of10,pubtest236of100,1,323,5218,13,346,5577
subtest22of10,pubtest236of100,1,323,5218,22,377,5617
subtest24of10,pubtest237of100,1,323,5527,0,42,5569
subtest23of10,pubtest237of100,1,323,5527,1,80,5608
subtest28of10,pubtest237of100,1,323,5527,3,118,5648
subtest21of10,pubtest237of100,1,323,5527,9,151,5687
subtest27of10,pubtest237of100,1,323,5527,9,192,5728
subtest25of10,pubtest237of100,1,323,5527,6,232,5765
subtest29of10,pubtest237of100,1,323,5527,12,269,5808
subtest22of10,pubtest237of100,1,323,5527,9,310,5846
subtest210of10,pubtest237of100,1,323,5527,13,348,5888
subtest26of10,pubtest237of100,1,323,5527,9,387,5923
subtest29of10,pubtest238of100,1,323,5216,260,230,5706
subtest22of10,pubtest238of100,1,323,5216,260,266,5742
subtest27of10,pubtest238of100,1,323,5216,262,304,5782
subtest28of10,pubtest238of100,1,323,5216,305,301,5822
subtest21of10,pubtest238of100,1,323,5216,308,338,5862
subtest23of10,pubtest238of100,1,323,5216,307,378,5901
subtest25of10,pubtest238of100,1,323,5216,307,416,5939
subtest210of10,pubtest238of100,1,323,5216,1634,41,6891
subtest26of10,pubtest238of100,1,323,5216,1635,78,6929
subtest24of10,pubtest238of100,1,323,5216,1636,118,6970
subtest21of10,pubtest239of100,1,323,5189,-5,38,5222
subtest28of10,pubtest239of100,1,323,5189,-5,77,5261
subtest27of10,pubtest239of100,1,323,5189,0,115,5304
subtest24of10,pubtest239of100,1,323,5189,3,151,5343
subtest25of10,pubtest239of100,1,323,5189,3,191,5383
subtest26of10,pubtest239of100,1,323,5189,2,230,5421
subtest29of10,pubtest239of100,1,323,5189,5,269,5463
subtest23of10,pubtest239of100,1,323,5189,6,308,5503
subtest22of10,pubtest239of100,1,323,5189,5,348,5542
subtest210of10,pubtest239of100,1,323,5189,7,387,5583
subtest25of10,pubtest240of100,1,323,5254,-1,41,5294
subtest21of10,pubtest240of100,1,323,5254,4,75,5333
subtest210of10,pubtest240of100,1,323,5254,4,115,5373
subtest29of10,pubtest240of100,1,323,5254,6,153,5413
subtest23of10,pubtest240of100,1,323,5254,9,189,5452
subtest24of10,pubtest240of100,1,323,5254,10,229,5493
subtest22of10,pubtest240of100,1,323,5254,11,268,5533
subtest28of10,pubtest240of100,1,323,5254,11,307,5572
subtest27of10,pubtest240of100,1,323,5254,7,347,5608
subtest26of10,pubtest240of100,1,323,5254,13,386,5653
subtest23of10,pubtest241of100,1,323,5185,-2,39,5222
subtest27of10,pubtest241of100,1,323,5185,4,72,5261
subtest21of10,pubtest241of100,1,323,5185,9,107,5301
subtest24of10,pubtest241of100,1,323,5185,11,145,5341
subtest29of10,pubtest241of100,1,323,5185,11,184,5380
subtest210of10,pubtest241of100,1,323,5185,13,223,5421
subtest28of10,pubtest241of100,1,323,5185,13,263,5461
subtest26of10,pubtest241of100,1,323,5185,14,302,5501
subtest22of10,pubtest241of100,1,323,5185,15,341,5541
subtest25of10,pubtest241of100,1,323,5185,16,378,5579
subtest27of10,pubtest242of100,1,323,5170,1,42,5213
subtest23of10,pubtest242of100,1,323,5170,2,80,5252
subtest26of10,pubtest242of100,1,323,5170,3,119,5292
subtest29of10,pubtest242of100,1,323,5170,5,156,5331
subtest210of10,pubtest242of100,1,323,5170,7,195,5372
subtest25of10,pubtest242of100,1,323,5170,5,236,5411
subtest21of10,pubtest242of100,1,323,5170,13,270,5453
subtest22of10,pubtest242of100,1,323,5170,13,309,5492
subtest24of10,pubtest242of100,1,323,5170,21,341,5532
subtest28of10,pubtest242of100,1,323,5170,21,381,5572
subtest29of10,pubtest243of100,1,323,5208,4,39,5251
subtest28of10,pubtest243of100,1,323,5208,4,78,5290
subtest23of10,pubtest243of100,1,323,5208,9,113,5330
subtest22of10,pubtest243of100,1,323,5208,9,153,5370
subtest25of10,pubtest243of100,1,323,5208,10,193,5411
subtest27of10,pubtest243of100,1,323,5208,13,229,5450
subtest26of10,pubtest243of100,1,323,5208,13,270,5491
subtest21of10,pubtest243of100,1,323,5208,16,306,5530
subtest210of10,pubtest243of100,1,323,5208,20,342,5570
subtest24of10,pubtest243of100,1,323,5208,20,382,5610
subtest27of10,pubtest244of100,1,323,5196,-2,42,5236
subtest26of10,pubtest244of100,1,323,5196,-1,81,5276
subtest29of10,pubtest244of100,1,323,5196,3,117,5316
subtest21of10,pubtest244of100,1,323,5196,3,156,5355
subtest25of10,pubtest244of100,1,323,5196,1,195,5392
subtest28of10,pubtest244of100,1,323,5196,2,235,5433
subtest210of10,pubtest244of100,1,323,5196,8,272,5476
subtest23of10,pubtest244of100,1,323,5196,8,311,5515
subtest22of10,pubtest244of100,1,323,5196,12,347,5555
subtest24of10,pubtest244of100,1,323,5196,12,388,5596
subtest29of10,pubtest245of100,1,322,5184,1,39,5224
subtest22of10,pubtest245of100,1,322,5184,2,77,5263
subtest23of10,pubtest245of100,1,322,5184,3,116,5303
subtest25of10,pubtest245of100,1,322,5184,4,155,5343
subtest24of10,pubtest245of100,1,322,5184,4,195,5383
subtest26of10,pubtest245of100,1,322,5184,1,232,5417
subtest27of10,pubtest245of100,1,322,5184,10,269,5463
subtest210of10,pubtest245of100,1,322,5184,11,308,5503
subtest28of10,pubtest245of100,1,322,5184,11,350,5545
subtest21of10,pubtest245of100,1,322,5184,10,388,5582
subtest26of10,pubtest246of100,1,323,5287,-3,40,5324
subtest27of10,pubtest246of100,1,323,5287,4,73,5364
subtest21of10,pubtest246of100,1,323,5287,9,108,5404
subtest29of10,pubtest246of100,1,323,5287,11,146,5444
subtest28of10,pubtest246of100,1,323,5287,12,185,5484
subtest23of10,pubtest246of100,1,323,5287,13,224,5524
subtest210of10,pubtest246of100,1,323,5287,13,264,5564
subtest25of10,pubtest246of100,1,323,5287,16,299,5602
subtest24of10,pubtest246of100,1,323,5287,20,337,5644
subtest22of10,pubtest246of100,1,323,5287,20,377,5684
subtest27of10,pubtest247of100,1,323,5179,-6,41,5214
subtest26of10,pubtest247of100,1,323,5179,-3,78,5254
subtest22of10,pubtest247of100,1,323,5179,1,112,5292
subtest23of10,pubtest247of100,1,323,5179,1,152,5332
subtest28of10,pubtest247of100,1,323,5179,3,191,5373
subtest21of10,pubtest247of100,1,323,5179,6,228,5413
subtest210of10,pubtest247of100,1,323,5179,10,264,5453
subtest29of10,pubtest247of100,1,323,5179,11,303,5493
subtest24of10,pubtest247of100,1,323,5179,12,342,5533
subtest25of10,pubtest247of100,1,323,5179,12,382,5573
subtest29of10,pubtest248of100,1,323,5221,6,43,5270
subtest25of10,pubtest248of100,1,323,5221,14,74,5309
subtest23of10,pubtest248of100,1,323,5221,14,114,5349
subtest27of10,pubtest248of100,1,323,5221,16,153,5390
subtest28of10,pubtest248of100,1,323,5221,16,192,5429
subtest26of10,pubtest248of100,1,323,5221,17,229,5467
subtest21of10,pubtest248of100,1,323,5221,20,268,5509
subtest22of10,pubtest248of100,1,323,5221,20,308,5549
subtest24of10,pubtest248of100,1,323,5221,21,347,5589
subtest210of10,pubtest248of100,1,323,5221,41,367,5629
subtest27of10,pubtest249of100,1,323,5204,-2,42,5244
subtest28of10,pubtest249of100,1,323,5204,1,79,5284
subtest25of10,pubtest249of100,1,323,5204,2,118,5324
subtest24of10,pubtest249of100,1,323,5204,5,156,5365
subtest26of10,pubtest249of100,1,323,5204,6,194,5404
subtest21of10,pubtest249of100,1,323,5204,10,230,5444
subtest29of10,pubtest249of100,1,323,5204,15,265,5484
subtest22of10,pubtest249of100,1,323,5204,15,305,5524
subtest23of10,pubtest249of100,1,323,5204,17,343,5564
subtest210of10,pubtest249of100,1,323,5204,18,382,5604
subtest27of10,pubtest250of100,1,323,5149,-3,43,5189
subtest23of10,pubtest250of100,1,323,5149,2,76,5227
subtest29of10,pubtest250of100,1,323,5149,3,116,5268
subtest28of10,pubtest250of100,1,323,5149,3,154,5306
subtest24of10,pubtest250of100,1,323,5149,5,193,5347
subtest21of10,pubtest250of100,1,323,5149,6,232,5387
subtest25of10,pubtest250of100,1,323,5149,12,266,5427
subtest210of10,pubtest250of100,1,323,5149,12,306,5467
subtest26of10,pubtest250of100,1,323,5149,16,340,5505
subtest22of10,pubtest250of100,1,323,5149,19,379,5547
subtest23of10,pubtest251of100,1,323,5217,-2,40,5255
subtest22of10,pubtest251of100,1,323,5217,-1,77,5293
subtest24of10,pubtest251of100,1,323,5217,0,117,5334
subtest27of10,pubtest251of100,1,323,5217,8,150,5375
subtest25of10,pubtest251of100,1,323,5217,9,188,5414
subtest28of10,pubtest251of100,1,323,5217,11,226,5454
subtest21of10,pubtest251of100,1,323,5217,14,264,5495
subtest26of10,pubtest251of100,1,323,5217,19,298,5534
subtest29of10,pubtest251of100,1,323,5217,18,338,5573
subtest210of10,pubtest251of100,1,323,5217,20,377,5614
subtest29of10,pubtest252of100,1,323,5180,-2,41,5219
subtest27of10,pubtest252of100,1,323,5180,3,74,5257
subtest28of10,pubtest252of100,1,323,5180,2,113,5295
subtest26of10,pubtest252of100,1,323,5180,4,154,5338
subtest23of10,pubtest252of100,1,323,5180,8,190,5378
subtest25of10,pubtest252of100,1,323,5180,8,229,5417
subtest21of10,pubtest252of100,1,323,5180,3,269,5452
subtest22of10,pubtest252of100,1,323,5180,11,306,5497
subtest24of10,pubtest252of100,1,323,5180,13,344,5537
subtest210of10,pubtest252of100,1,323,5180,13,384,5577
subtest28of10,pubtest253of100,1,322,5352,4,41,5397
subtest23of10,pubtest253of100,1,322,5352,9,72,5433
subtest24of10,pubtest253of100,1,322,5352,9,112,5473
subtest25of10,pubtest253of100,1,322,5352,13,151,5516
subtest22of10,pubtest253of100,1,322,5352,12,191,5555
subtest29of10,pubtest253of100,1,322,5352,18,226,5596
subtest27of10,pubtest253of100,1,322,5352,19,265,5636
subtest21of10,pubtest253of100,1,322,5352,21,303,5676
subtest26of10,pubtest253of100,1,322,5352,21,343,5716
subtest210of10,pubtest253of100,1,322,5352,20,383,5755
subtest210of10,pubtest254of100,1,323,5232,-2,43,5273
subtest27of10,pubtest254of100,1,323,5232,-1,80,5311
subtest28of10,pubtest254of100,1,323,5232,0,120,5352
subtest21of10,pubtest254of100,1,323,5232,3,156,5391
subtest25of10,pubtest254of100,1,323,5232,5,196,5433
subtest24of10,pubtest254of100,1,323,5232,5,235,5472
subtest23of10,pubtest254of100,1,323,5232,6,273,5511
subtest29of10,pubtest254of100,1,323,5232,7,313,5552
subtest26of10,pubtest254of100,1,323,5232,14,345,5591
subtest22of10,pubtest254of100,1,323,5232,15,384,5631
subtest22of10,pubtest255of100,1,322,5250,0,42,5292
subtest23of10,pubtest255of100,1,322,5250,1,80,5331
subtest27of10,pubtest255of100,1,322,5250,3,118,5371
subtest28of10,pubtest255of100,1,322,5250,5,157,5412
subtest29of10,pubtest255of100,1,322,5250,7,194,5451
subtest24of10,pubtest255of100,1,322,5250,7,234,5491
subtest21of10,pubtest255of100,1,322,5250,12,269,5531
subtest210of10,pubtest255of100,1,322,5250,13,308,5571
subtest25of10,pubtest255of100,1,322,5250,13,348,5611
subtest26of10,pubtest255of100,1,322,5250,21,380,5651
subtest29of10,pubtest256of100,1,323,5147,0,40,5187
subtest26of10,pubtest256of100,1,323,5147,2,78,5227
subtest21of10,pubtest256of100,1,323,5147,3,117,5267
subtest23of10,pubtest256of100,1,323,5147,5,156,5308
subtest25of10,pubtest256of100,1,323,5147,5,195,5347
subtest210of10,pubtest256of100,1,323,5147,7,233,5387
subtest27of10,pubtest256of100,1,323,5147,11,268,5426
subtest28of10,pubtest256of100,1,323,5147,11,306,5464
subtest24of10,pubtest256of100,1,323,5147,15,345,5507
subtest22of10,pubtest256of100,1,323,5147,11,385,5543
subtest24of10,pubtest257of100,1,323,5220,-2,39,5257
subtest21of10,pubtest257of100,1,323,5220,-2,79,5297
subtest27of10,pubtest257of100,1,323,5220,0,117,5337
subtest28of10,pubtest257of100,1,323,5220,1,155,5376
subtest23of10,pubtest257of100,1,323,5220,2,192,5414
subtest29of10,pubtest257of100,1,323,5220,3,231,5454
subtest25of10,pubtest257of100,1,323,5220,6,270,5496
subtest22of10,pubtest257of100,1,323,5220,7,309,5536
subtest210of10,pubtest257of100,1,323,5220,10,346,5576
subtest26of10,pubtest257of100,1,323,5220,15,381,5616
subtest23of10,pubtest258of100,1,323,5246,2,144,5392
subtest28of10,pubtest258of100,1,323,5246,3,183,5432
subtest25of10,pubtest258of100,1,323,5246,7,218,5471
subtest21of10,pubtest258of100,1,323,5246,15,251,5512
subtest29of10,pubtest258of100,1,323,5246,15,291,5552
subtest26of10,pubtest258of100,1,323,5246,44,302,5592
subtest210of10,pubtest258of100,1,323,5246,45,341,5632
subtest27of10,pubtest258of100,1,323,5246,46,380,5672
subtest22of10,pubtest258of100,1,323,5246,47,419,5712
subtest24of10,pubtest258of100,1,323,5246,49,457,5752
subtest28of10,pubtest259of100,1,323,5272,3,43,5318
subtest21of10,pubtest259of100,1,323,5272,1,82,5355
subtest25of10,pubtest259of100,1,323,5272,5,120,5397
subtest24of10,pubtest259of100,1,323,5272,5,160,5437
subtest27of10,pubtest259of100,1,323,5272,11,194,5477
subtest26of10,pubtest259of100,1,323,5272,14,232,5518
subtest22of10,pubtest259of100,1,323,5272,17,268,5557
subtest29of10,pubtest259of100,1,323,5272,21,304,5597
subtest23of10,pubtest259of100,1,323,5272,21,344,5637
subtest210of10,pubtest259of100,1,323,5272,22,383,5677
subtest210of10,pubtest260of100,1,323,5195,1,339,5535
subtest21of10,pubtest260of100,1,323,5195,6,433,5634
subtest23of10,pubtest260of100,1,323,5195,5,435,5635
subtest29of10,pubtest260of100,1,323,5195,7,451,5653
subtest27of10,pubtest260of100,1,323,5195,7,490,5692
subtest26of10,pubtest260of100,1,323,5195,7,529,5731
subtest28of10,pubtest260of100,1,323,5195,11,567,5773
subtest25of10,pubtest260of100,1,323,5195,10,607,5812
subtest24of10,pubtest260of100,1,323,5195,13,645,5853
subtest22of10,pubtest260of100,1,323,5195,8,685,5888
subtest25of10,pubtest261of100,1,323,5169,0,42,5211
subtest29of10,pubtest261of100,1,323,5169,8,73,5250
subtest210of10,pubtest261of100,1,323,5169,10,110,5289
subtest23of10,pubtest261of100,1,323,5169,11,149,5329
subtest28of10,pubtest261of100,1,323,5169,10,189,5368
subtest27of10,pubtest261of100,1,323,5169,13,227,5409
subtest22of10,pubtest261of100,1,323,5169,13,267,5449
subtest21of10,pubtest261of100,1,323,5169,13,306,5488
subtest24of10,pubtest261of100,1,323,5169,18,339,5526
subtest26of10,pubtest261of100,1,323,5169,21,379,5569
subtest26of10,pubtest262of100,1,323,5518,2,40,5560
subtest22of10,pubtest262of100,1,323,5518,1,80,5599
subtest21of10,pubtest262of100,1,323,5518,0,120,5638
subtest27of10,pubtest262of100,1,323,5518,3,159,5680
subtest29of10,pubtest262of100,1,323,5518,4,195,5717
subtest23of10,pubtest262of100,1,323,5518,2,235,5755
subtest210of10,pubtest262of100,1,323,5518,11,269,5798
subtest25of10,pubtest262of100,1,323,5518,12,308,5838
subtest28of10,pubtest262of100,1,323,5518,13,348,5879
subtest24of10,pubtest262of100,1,323,5518,14,387,5919
subtest22of10,pubtest263of100,1,322,5171,0,40,5211
subtest29of10,pubtest263of100,1,322,5171,3,76,5250
subtest24of10,pubtest263of100,1,322,5171,3,114,5288
subtest26of10,pubtest263of100,1,322,5171,4,153,5328
subtest23of10,pubtest263of100,1,322,5171,6,193,5370
subtest210of10,pubtest263of100,1,322,5171,13,226,5410
subtest25of10,pubtest263of100,1,322,5171,23,255,5449
subtest28of10,pubtest263of100,1,322,5171,24,295,5490
subtest27of10,pubtest263of100,1,322,5171,25,334,5530
subtest21of10,pubtest263of100,1,322,5171,25,374,5570
subtest29of10,pubtest264of100,1,322,5262,5,38,5305
subtest22of10,pubtest264of100,1,322,5262,3,77,5342
subtest23of10,pubtest264of100,1,322,5262,7,115,5384
subtest24of10,pubtest264of100,1,322,5262,7,155,5424
subtest27of10,pubtest264of100,1,322,5262,9,195,5466
subtest21of10,pubtest264of100,1,322,5262,10,233,5505
subtest28of10,pubtest264of100,1,322,5262,10,272,5544
subtest25of10,pubtest264of100,1,322,5262,12,310,5584
subtest26of10,pubtest264of100,1,322,5262,18,344,5624
subtest210of10,pubtest264of100,1,322,5262,19,383,5664
subtest26of10,pubtest265of100,1,323,5435,-6,40,5469
subtest27of10,pubtest265of100,1,323,5435,2,72,5509
subtest210of10,pubtest265of100,1,323,5435,2,111,5548
subtest21of10,pubtest265of100,1,323,5435,7,146,5588
subtest22of10,pubtest265of100,1,323,5435,7,186,5628
subtest23of10,pubtest265of100,1,323,5435,8,225,5668
subtest29of10,pubtest265of100,1,323,5435,8,265,5708
subtest28of10,pubtest265of100,1,323,5435,9,304,5748
subtest25of10,pubtest265of100,1,323,5435,10,343,5788
subtest24of10,pubtest265of100,1,323,5435,12,381,5828
subtest29of10,pubtest266of100,1,321,5238,3,40,5281
subtest25of10,pubtest266of100,1,321,5238,5,77,5320
subtest210of10,pubtest266of100,1,321,5238,5,117,5360
subtest27of10,pubtest266of100,1,321,5238,6,156,5400
subtest26of10,pubtest266of100,1,321,5238,33,169,5440
subtest23of10,pubtest266of100,1,321,5238,34,209,5481
subtest21of10,pubtest266of100,1,321,5238,36,245,5519
subtest24of10,pubtest266of100,1,321,5238,38,284,5560
subtest22of10,pubtest266of100,1,321,5238,39,323,5600
subtest28of10,pubtest266of100,1,321,5238,36,362,5636
subtest23of10,pubtest267of100,1,323,5241,3,40,5284
subtest26of10,pubtest267of100,1,323,5241,4,79,5324
subtest25of10,pubtest267of100,1,323,5241,11,111,5363
subtest28of10,pubtest267of100,1,323,5241,11,151,5403
subtest24of10,pubtest267of100,1,323,5241,13,188,5442
subtest27of10,pubtest267of100,1,323,5241,17,225,5483
subtest29of10,pubtest267of100,1,323,5241,21,261,5523
subtest22of10,pubtest267of100,1,323,5241,22,300,5563
subtest21of10,pubtest267of100,1,323,5241,29,333,5603
subtest210of10,pubtest267of100,1,323,5241,29,373,5643
subtest23of10,pubtest268of100,1,323,5160,-2,39,5197
subtest25of10,pubtest268of100,1,323,5160,5,70,5235
subtest24of10,pubtest268of100,1,323,5160,7,109,5276
subtest29of10,pubtest268of100,1,323,5160,8,148,5316
subtest28of10,pubtest268of100,1,323,5160,9,186,5355
subtest27of10,pubtest268of100,1,323,5160,10,226,5396
subtest21of10,pubtest268of100,1,323,5160,11,265,5436
subtest22of10,pubtest268of100,1,323,5160,12,304,5476
subtest210of10,pubtest268of100,1,323,5160,13,343,5516
subtest26of10,pubtest268of100,1,323,5160,13,384,5557
subtest24of10,pubtest269of100,1,323,5212,2,155,5369
subtest27of10,pubtest269of100,1,323,5212,4,193,5409
subtest210of10,pubtest269of100,1,323,5212,4,231,5447
subtest25of10,pubtest269of100,1,323,5212,4,272,5488
subtest26of10,pubtest269of100,1,323,5212,8,308,5528
subtest21of10,pubtest269of100,1,323,5212,9,347,5568
subtest23of10,pubtest269of100,1,323,5212,12,384,5608
subtest29of10,pubtest269of100,1,323,5212,11,424,5647
subtest22of10,pubtest269of100,1,323,5212,11,463,5686
subtest28of10,pubtest269of100,1,323,5212,17,498,5727
subtest23of10,pubtest270of100,1,323,5199,2,42,5243
subtest26of10,pubtest270of100,1,323,5199,3,79,5281
subtest27of10,pubtest270of100,1,323,5199,3,117,5319
subtest29of10,pubtest270of100,1,323,5199,8,154,5361
subtest210of10,pubtest270of100,1,323,5199,15,187,5401
subtest25of10,pubtest270of100,1,323,5199,15,227,5441
subtest21of10,pubtest270of100,1,323,5199,20,262,5481
subtest28of10,pubtest270of100,1,323,5199,21,299,5519
subtest24of10,pubtest270of100,1,323,5199,28,334,5561
subtest22of10,pubtest270of100,1,323,5199,28,374,5601
subtest24of10,pubtest271of100,1,323,5587,3,40,5630
subtest22of10,pubtest271of100,1,323,5587,3,79,5669
subtest25of10,pubtest271of100,1,323,5587,8,115,5710
subtest210of10,pubtest271of100,1,323,5587,9,153,5749
subtest26of10,pubtest271of100,1,323,5587,10,192,5789
subtest28of10,pubtest271of100,1,323,5587,12,230,5829
subtest27of10,pubtest271of100,1,323,5587,13,269,5869
subtest21of10,pubtest271of100,1,323,5587,56,266,5909
subtest23of10,pubtest271of100,1,323,5587,57,305,5949
subtest29of10,pubtest271of100,1,323,5587,58,344,5989
subtest25of10,pubtest272of100,1,323,5213,2,40,5255
subtest21of10,pubtest272of100,1,323,5213,8,72,5293
subtest29of10,pubtest272of100,1,323,5213,16,104,5333
subtest26of10,pubtest272of100,1,323,5213,16,144,5373
subtest24of10,pubtest272of100,1,323,5213,22,180,5415
subtest23of10,pubtest272of100,1,323,5213,21,219,5453
subtest22of10,pubtest272of100,1,323,5213,23,257,5493
subtest210of10,pubtest272of100,1,323,5213,23,299,5535
subtest27of10,pubtest272of100,1,323,5213,21,337,5571
subtest28of10,pubtest272of100,1,323,5213,24,376,5613
subtest22of10,pubtest273of100,1,321,5197,-1,41,5237
subtest29of10,pubtest273of100,1,321,5197,9,72,5278
subtest26of10,pubtest273of100,1,321,5197,14,106,5317
subtest25of10,pubtest273of100,1,321,5197,15,144,5356
subtest28of10,pubtest273of100,1,321,5197,16,183,5396
subtest27of10,pubtest273of100,1,321,5197,16,223,5436
subtest23of10,pubtest273of100,1,321,5197,18,262,5477
subtest210of10,pubtest273of100,1,321,5197,24,295,5516
subtest21of10,pubtest273of100,1,321,5197,25,334,5556
subtest24of10,pubtest273of100,1,321,5197,26,373,5596
subtest21of10,pubtest274of100,1,323,5202,-4,47,5245
subtest26of10,pubtest274of100,1,323,5202,-4,85,5283
subtest22of10,pubtest274of100,1,323,5202,-2,123,5323
subtest23of10,pubtest274of100,1,323,5202,15,146,5363
subtest29of10,pubtest274of100,1,323,5202,16,185,5403
subtest25of10,pubtest274of100,1,323,5202,17,225,5444
subtest210of10,pubtest274of100,1,323,5202,18,263,5483
subtest24of10,pubtest274of100,1,323,5202,19,301,5522
subtest27of10,pubtest274of100,1,323,5202,19,340,5561
subtest28of10,pubtest274of100,1,323,5202,21,379,5602
subtest27of10,pubtest275of100,1,323,5156,1,51,5208
subtest25of10,pubtest275of100,1,323,5156,3,89,5248
subtest29of10,pubtest275of100,1,323,5156,2,127,5285
subtest22of10,pubtest275of100,1,323,5156,7,162,5325
subtest21of10,pubtest275of100,1,323,5156,9,202,5367
subtest23of10,pubtest275of100,1,323,5156,11,240,5407
subtest24of10,pubtest275of100,1,323,5156,6,280,5442
subtest210of10,pubtest275of100,1,323,5156,14,317,5487
subtest26of10,pubtest275of100,1,323,5156,14,357,5527
subtest28of10,pubtest275of100,1,323,5156,16,395,5567
subtest21of10,pubtest276of100,1,323,5253,-2,43,5294
subtest24of10,pubtest276of100,1,323,5253,2,82,5337
subtest25of10,pubtest276of100,1,323,5253,1,121,5375
subtest28of10,pubtest276of100,1,323,5253,-2,164,5415
subtest27of10,pubtest276of100,1,323,5253,3,198,5454
subtest29of10,pubtest276of100,1,323,5253,8,235,5496
subtest23of10,pubtest276of100,1,323,5253,10,272,5535
subtest210of10,pubtest276of100,1,323,5253,12,310,5575
subtest26of10,pubtest276of100,1,323,5253,12,350,5615
subtest22of10,pubtest276of100,1,323,5253,13,389,5655
subtest22of10,pubtest277of100,1,323,5159,-3,39,5195
subtest29of10,pubtest277of100,1,323,5159,4,71,5234
subtest28of10,pubtest277of100,1,323,5159,4,110,5273
subtest24of10,pubtest277of100,1,323,5159,6,150,5315
subtest21of10,pubtest277of100,1,323,5159,11,184,5354
subtest27of10,pubtest277of100,1,323,5159,11,224,5394
subtest210of10,pubtest277of100,1,323,5159,12,263,5434
subtest25of10,pubtest277of100,1,323,5159,14,301,5474
subtest26of10,pubtest277of100,1,323,5159,17,338,5514
subtest23of10,pubtest277of100,1,323,5159,17,378,5554
subtest22of10,pubtest278of100,1,323,5318,1,54,5373
subtest29of10,pubtest278of100,1,323,5318,1,93,5412
subtest23of10,pubtest278of100,1,323,5318,3,131,5452
subtest21of10,pubtest278of100,1,323,5318,5,169,5492
subtest25of10,pubtest278of100,1,323,5318,7,207,5532
subtest28of10,pubtest278of100,1,323,5318,9,245,5572
subtest24of10,pubtest278of100,1,323,5318,13,281,5612
subtest26of10,pubtest278of100,1,323,5318,16,319,5653
subtest210of10,pubtest278of100,1,323,5318,15,359,5692
subtest27of10,pubtest278of100,1,323,5318,17,397,5732
subtest28of10,pubtest279of100,1,323,5179,1,43,5223
subtest25of10,pubtest279of100,1,323,5179,2,80,5261
subtest24of10,pubtest279of100,1,323,5179,3,120,5302
subtest21of10,pubtest279of100,1,323,5179,9,155,5343
subtest26of10,pubtest279of100,1,323,5179,12,192,5383
subtest29of10,pubtest279of100,1,323,5179,12,232,5423
subtest22of10,pubtest279of100,1,323,5179,15,269,5463
subtest27of10,pubtest279of100,1,323,5179,15,309,5503
subtest210of10,pubtest279of100,1,323,5179,17,347,5543
subtest23of10,pubtest279of100,1,323,5179,17,388,5584
subtest27of10,pubtest280of100,1,323,5200,3,47,5250
subtest29of10,pubtest280of100,1,323,5200,5,84,5289
subtest21of10,pubtest280of100,1,323,5200,7,123,5330
subtest28of10,pubtest280of100,1,323,5200,9,160,5369
subtest26of10,pubtest280of100,1,323,5200,9,200,5409
subtest210of10,pubtest280of100,1,323,5200,10,239,5449
subtest22of10,pubtest280of100,1,323,5200,10,279,5489
subtest24of10,pubtest280of100,1,323,5200,4,317,5521
subtest23of10,pubtest280of100,1,323,5200,12,356,5568
subtest25of10,pubtest280of100,1,323,5200,13,395,5608
subtest24of10,pubtest281of100,1,323,5150,2,42,5194
subtest23of10,pubtest281of100,1,323,5150,8,75,5233
subtest27of10,pubtest281of100,1,323,5150,9,115,5274
subtest28of10,pubtest281of100,1,323,5150,10,153,5313
subtest25of10,pubtest281of100,1,323,5150,14,189,5353
subtest21of10,pubtest281of100,1,323,5150,17,226,5393
subtest22of10,pubtest281of100,1,323,5150,17,265,5432
subtest29of10,pubtest281of100,1,323,5150,23,301,5474
subtest210of10,pubtest281of100,1,323,5150,31,332,5513
subtest26of10,pubtest281of100,1,323,5150,33,370,5553
subtest24of10,pubtest282of100,1,323,5177,0,40,5217
subtest23of10,pubtest282of100,1,323,5177,1,78,5256
subtest21of10,pubtest282of100,1,323,5177,7,111,5295
subtest25of10,pubtest282of100,1,323,5177,8,149,5334
subtest29of10,pubtest282of100,1,323,5177,10,189,5376
subtest27of10,pubtest282of100,1,323,5177,12,227,5416
subtest22of10,pubtest282of100,1,323,5177,15,264,5456
subtest26of10,pubtest282of100,1,323,5177,16,303,5496
subtest210of10,pubtest282of100,1,323,5177,16,343,5536
subtest28of10,pubtest282of100,1,323,5177,18,383,5578
subtest24of10,pubtest283of100,1,323,5208,-1,42,5249
subtest27of10,pubtest283of100,1,323,5208,0,78,5286
subtest22of10,pubtest283of100,1,323,5208,3,115,5326
subtest23of10,pubtest283of100,1,323,5208,3,155,5366
subtest28of10,pubtest283of100,1,323,5208,11,187,5406
subtest25of10,pubtest283of100,1,323,5208,28,210,5446
subtest210of10,pubtest283of100,1,323,5208,31,247,5486
subtest21of10,pubtest283of100,1,323,5208,32,286,5526
subtest26of10,pubtest283of100,1,323,5208,34,324,5566
subtest29of10,pubtest283of100,1,323,5208,34,364,5606
subtest25of10,pubtest284of100,1,323,5213,-4,41,5250
subtest22of10,pubtest284of100,1,323,5213,-3,79,5289
subtest210of10,pubtest284of100,1,323,5213,-2,118,5329
subtest29of10,pubtest284of100,1,323,5213,2,154,5369
subtest24of10,pubtest284of100,1,323,5213,4,191,5408
subtest27of10,pubtest284of100,1,323,5213,5,231,5449
subtest23of10,pubtest284of100,1,323,5213,11,265,5489
subtest26of10,pubtest284of100,1,323,5213,12,306,5531
subtest28of10,pubtest284of100,1,323,5213,13,343,5569
subtest21of10,pubtest284of100,1,323,5213,13,383,5609
subtest23of10,pubtest285of100,1,323,5307,3,78,5388
subtest27of10,pubtest285of100,1,323,5307,4,112,5423
subtest21of10,pubtest285of100,1,323,5307,7,151,5465
subtest22of10,pubtest285of100,1,323,5307,8,190,5505
subtest24of10,pubtest285of100,1,323,5307,8,230,5545
subtest25of10,pubtest285of100,1,323,5307,4,271,5582
subtest28of10,pubtest285of100,1,323,5307,9,309,5625
subtest29of10,pubtest285of100,1,323,5307,14,344,5665
subtest210of10,pubtest285of100,1,323,5307,16,382,5705
subtest26of10,pubtest285of100,1,323,5307,21,417,5745
subtest23of10,pubtest286of100,1,323,5175,0,39,5214
subtest210of10,pubtest286of100,1,323,5175,0,78,5253
subtest24of10,pubtest286of100,1,323,5175,3,115,5293
subtest25of10,pubtest286of100,1,323,5175,2,154,5331
subtest29of10,pubtest286of100,1,323,5175,5,193,5373
subtest21of10,pubtest286of100,1,323,5175,14,224,5413
subtest26of10,pubtest286of100,1,323,5175,22,256,5453
subtest27of10,pubtest286of100,1,323,5175,24,295,5494
subtest28of10,pubtest286of100,1,323,5175,29,329,5533
subtest22of10,pubtest286of100,1,323,5175,29,369,5573
subtest26of10,pubtest287of100,1,323,5212,-1,42,5253
subtest28of10,pubtest287of100,1,323,5212,1,79,5292
subtest29of10,pubtest287of100,1,323,5212,6,114,5332
subtest210of10,pubtest287of100,1,323,5212,10,150,5372
subtest27of10,pubtest287of100,1,323,5212,11,189,5412
subtest21of10,pubtest287of100,1,323,5212,13,227,5452
subtest24of10,pubtest287of100,1,323,5212,14,266,5492
subtest25of10,pubtest287of100,1,323,5212,14,305,5531
subtest23of10,pubtest287of100,1,323,5212,15,345,5572
subtest22of10,pubtest287of100,1,323,5212,17,383,5612
subtest29of10,pubtest288of100,1,323,5184,-2,41,5223
subtest27of10,pubtest288of100,1,323,5184,6,74,5264
subtest26of10,pubtest288of100,1,323,5184,6,113,5303
subtest22of10,pubtest288of100,1,323,5184,8,150,5342
subtest21of10,pubtest288of100,1,323,5184,9,189,5382
subtest25of10,pubtest288of100,1,323,5184,8,229,5421
subtest23of10,pubtest288of100,1,323,5184,14,264,5462
subtest210of10,pubtest288of100,1,323,5184,14,304,5502
subtest24of10,pubtest288of100,1,323,5184,16,342,5542
subtest28of10,pubtest288of100,1,323,5184,16,382,5582
subtest29of10,pubtest289of100,1,323,5284,1,43,5328
subtest23of10,pubtest289of100,1,323,5284,5,78,5367
subtest25of10,pubtest289of100,1,323,5284,7,116,5407
subtest210of10,pubtest289of100,1,323,5284,6,156,5446
subtest24of10,pubtest289of100,1,323,5284,6,195,5485
subtest26of10,pubtest289of100,1,323,5284,13,230,5527
subtest27of10,pubtest289of100,1,323,5284,13,266,5563
subtest22of10,pubtest289of100,1,323,5284,17,306,5607
subtest21of10,pubtest289of100,1,323,5284,17,345,5646
subtest28of10,pubtest289of100,1,323,5284,17,385,5686
subtest29of10,pubtest290of100,1,323,5225,-3,39,5261
subtest22of10,pubtest290of100,1,323,5225,-1,76,5300
subtest23of10,pubtest290of100,1,323,5225,-1,115,5339
subtest25of10,pubtest290of100,1,323,5225,5,150,5380
subtest26of10,pubtest290of100,1,323,5225,5,190,5420
subtest27of10,pubtest290of100,1,323,5225,11,224,5460
subtest210of10,pubtest290of100,1,323,5225,24,251,5500
subtest21of10,pubtest290of100,1,323,5225,28,289,5542
subtest24of10,pubtest290of100,1,323,5225,29,327,5581
subtest28of10,pubtest290of100,1,323,5225,29,366,5620
subtest23of10,pubtest291of100,1,323,5258,2,40,5300
subtest24of10,pubtest291of100,1,323,5258,2,78,5338
subtest210of10,pubtest291of100,1,323,5258,4,117,5379
subtest28of10,pubtest291of100,1,323,5258,5,156,5419
subtest27of10,pubtest291of100,1,323,5258,4,195,5457
subtest21of10,pubtest291of100,1,323,5258,5,234,5497
subtest22of10,pubtest291of100,1,323,5258,9,272,5539
subtest25of10,pubtest291of100,1,323,5258,9,312,5579
subtest26of10,pubtest291of100,1,323,5258,12,349,5619
subtest29of10,pubtest291of100,1,323,5258,12,389,5659
subtest28of10,pubtest292of100,1,323,5254,2,38,5294
subtest29of10,pubtest292of100,1,323,5254,2,78,5334
subtest21of10,pubtest292of100,1,323,5254,4,115,5373
subtest25of10,pubtest292of100,1,323,5254,5,154,5413
subtest27of10,pubtest292of100,1,323,5254,11,188,5453
subtest22of10,pubtest292of100,1,323,5254,35,203,5492
subtest23of10,pubtest292of100,1,323,5254,36,243,5533
subtest24of10,pubtest292of100,1,323,5254,37,282,5573
subtest26of10,pubtest292of100,1,323,5254,35,322,5611
subtest210of10,pubtest292of100,1,323,5254,37,360,5651
subtest27of10,pubtest293of100,1,323,5305,7,41,5353
subtest23of10,pubtest293of100,1,323,5305,5,81,5391
subtest29of10,pubtest293of100,1,323,5305,8,119,5432
subtest21of10,pubtest293of100,1,323,5305,8,159,5472
subtest25of10,pubtest293of100,1,323,5305,4,198,5507
subtest24of10,pubtest293of100,1,323,5305,10,238,5553
subtest28of10,pubtest293of100,1,323,5305,14,275,5594
subtest210of10,pubtest293of100,1,323,5305,14,314,5633
subtest26of10,pubtest293of100,1,323,5305,16,351,5672
subtest22of10,pubtest293of100,1,323,5305,16,391,5712
subtest21of10,pubtest294of100,1,323,5210,18,39,5267
subtest25of10,pubtest294of100,1,323,5210,21,76,5307
subtest210of10,pubtest294of100,1,323,5210,22,114,5346
subtest29of10,pubtest294of100,1,323,5210,30,146,5386
subtest26of10,pubtest294of100,1,323,5210,34,182,5426
subtest27of10,pubtest294of100,1,323,5210,38,218,5466
subtest24of10,pubtest294of100,1,323,5210,41,255,5506
subtest28of10,pubtest294of100,1,323,5210,42,294,5546
subtest23of10,pubtest294of100,1,323,5210,40,333,5583
subtest22of10,pubtest294of100,1,323,5210,41,373,5624
subtest25of10,pubtest295of100,1,323,5249,6,42,5297
subtest24of10,pubtest295of100,1,323,5249,7,80,5336
subtest23of10,pubtest295of100,1,323,5249,9,118,5376
subtest22of10,pubtest295of100,1,323,5249,12,153,5414
subtest29of10,pubtest295of100,1,323,5249,14,193,5456
subtest27of10,pubtest295of100,1,323,5249,14,231,5494
subtest21of10,pubtest295of100,1,323,5249,14,272,5535
subtest210of10,pubtest295of100,1,323,5249,14,310,5573
subtest28of10,pubtest295of100,1,323,5249,22,345,5616
subtest26of10,pubtest295of100,1,323,5249,25,382,5656
subtest25of10,pubtest296of100,1,322,5205,1,40,5246
subtest27of10,pubtest296of100,1,322,5205,3,77,5285
subtest24of10,pubtest296of100,1,322,5205,3,116,5324
subtest26of10,pubtest296of100,1,322,5205,8,151,5364
subtest23of10,pubtest296of100,1,322,5205,9,191,5405
subtest28of10,pubtest296of100,1,322,5205,13,226,5444
subtest29of10,pubtest296of100,1,322,5205,13,266,5484
subtest21of10,pubtest296of100,1,322,5205,16,304,5525
subtest22of10,pubtest296of100,1,322,5205,17,343,5565
subtest210of10,pubtest296of100,1,322,5205,16,382,5603
subtest25of10,pubtest297of100,1,323,5410,3,40,5453
subtest23of10,pubtest297of100,1,323,5410,6,76,5492
subtest22of10,pubtest297of100,1,323,5410,6,116,5532
subtest28of10,pubtest297of100,1,323,5410,7,155,5572
subtest26of10,pubtest297of100,1,323,5410,8,194,5612
subtest24of10,pubtest297of100,1,323,5410,9,232,5651
subtest29of10,pubtest297of100,1,323,5410,11,271,5692
subtest210of10,pubtest297of100,1,323,5410,5,310,5725
subtest27of10,pubtest297of100,1,323,5410,12,350,5772
subtest21of10,pubtest297of100,1,323,5410,13,388,5811
subtest24of10,pubtest298of100,1,323,5303,7,44,5354
subtest22of10,pubtest298of100,1,323,5303,2,85,5390
subtest23of10,pubtest298of100,1,323,5303,4,124,5431
subtest21of10,pubtest298of100,1,323,5303,5,163,5471
subtest25of10,pubtest298of100,1,323,5303,6,204,5513
subtest210of10,pubtest298of100,1,323,5303,8,241,5552
subtest26of10,pubtest298of100,1,323,5303,8,281,5592
subtest27of10,pubtest298of100,1,323,5303,9,319,5631
subtest28of10,pubtest298of100,1,323,5303,9,359,5671
subtest29of10,pubtest298of100,1,323,5303,2,398,5703
subtest22of10,pubtest299of100,1,323,5233,1,39,5273
subtest29of10,pubtest299of100,1,323,5233,3,75,5311
subtest210of10,pubtest299of100,1,323,5233,4,115,5352
subtest24of10,pubtest299of100,1,323,5233,5,154,5392
subtest27of10,pubtest299of100,1,323,5233,11,188,5432
subtest28of10,pubtest299of100,1,323,5233,13,226,5472
subtest23of10,pubtest299of100,1,323,5233,14,263,5510
subtest21of10,pubtest299of100,1,323,5233,16,303,5552
subtest26of10,pubtest299of100,1,323,5233,16,342,5591
subtest25of10,pubtest299of100,1,323,5233,18,381,5632
subtest21of10,pubtest2100of100,1,325,5206,6,39,5251
subtest24of10,pubtest2100of100,1,325,5206,6,79,5291
subtest22of10,pubtest2100of100,1,325,5206,9,116,5331
subtest29of10,pubtest2100of100,1,325,5206,9,156,5371
subtest23of10,pubtest2100of100,1,325,5206,12,193,5411
subtest28of10,pubtest2100of100,1,325,5206,35,212,5453
subtest27of10,pubtest2100of100,1,325,5206,36,250,5492
subtest210of10,pubtest2100of100,1,325,5206,39,286,5531
subtest25of10,pubtest2100of100,1,325,5206,39,326,5571
subtest26of10,pubtest2100of100,1,325,5206,41,365,5612
subtest27of10,pubtest21of100,1,322,10235,5,43,10283
subtest26of10,pubtest21of100,1,322,10235,6,81,10322
subtest29of10,pubtest21of100,1,322,10235,7,120,10362
subtest25of10,pubtest21of100,1,322,10235,11,156,10402
subtest24of10,pubtest21of100,1,322,10235,12,195,10442
subtest21of10,pubtest21of100,1,322,10235,20,227,10482
subtest210of10,pubtest21of100,1,322,10235,21,266,10522
subtest28of10,pubtest21of100,1,322,10235,21,306,10562
subtest23of10,pubtest21of100,1,322,10235,27,340,10602
subtest22of10,pubtest21of100,1,322,10235,27,380,10642
subtest29of10,pubtest22of100,1,321,5369,-3,62,5428
subtest27of10,pubtest22of100,1,321,5369,8,88,5465
subtest24of10,pubtest22of100,1,321,5369,9,127,5505
subtest23of10,pubtest22of100,1,321,5369,14,159,5542
subtest210of10,pubtest22of100,1,321,5369,17,199,5585
subtest21of10,pubtest22of100,1,321,5369,17,238,5624
subtest22of10,pubtest22of100,1,321,5369,17,278,5664
subtest25of10,pubtest22of100,1,321,5369,16,316,5701
subtest28of10,pubtest22of100,1,321,5369,16,358,5743
subtest26of10,pubtest22of100,1,321,5369,16,396,5781
subtest23of10,pubtest23of100,1,321,6602,2,40,6644
subtest29of10,pubtest23of100,1,321,6602,3,79,6684
subtest28of10,pubtest23of100,1,321,6602,7,115,6724
subtest24of10,pubtest23of100,1,321,6602,8,155,6765
subtest27of10,pubtest23of100,1,321,6602,9,193,6804
subtest25of10,pubtest23of100,1,321,6602,12,230,6844
subtest21of10,pubtest23of100,1,321,6602,12,270,6884
subtest26of10,pubtest23of100,1,321,6602,16,306,6924
subtest22of10,pubtest23of100,1,321,6602,17,345,6964
subtest210of10,pubtest23of100,1,321,6602,20,381,7003
subtest24of10,pubtest24of100,1,321,7991,-2,41,8030
subtest23of10,pubtest24of100,1,321,7991,-1,80,8070
subtest25of10,pubtest24of100,1,321,7991,0,119,8110
subtest21of10,pubtest24of100,1,321,7991,3,155,8149
subtest28of10,pubtest24of100,1,321,7991,6,190,8187
subtest29of10,pubtest24of100,1,321,7991,45,193,8229
subtest27of10,pubtest24of100,1,321,7991,45,233,8269
subtest22of10,pubtest24of100,1,321,7991,46,272,8309
subtest210of10,pubtest24of100,1,321,7991,47,311,8349
subtest26of10,pubtest24of100,1,321,7991,48,350,8389
subtest28of10,pubtest25of100,1,321,6398,3,42,6443
subtest21of10,pubtest25of100,1,321,6398,3,81,6482
subtest210of10,pubtest25of100,1,321,6398,5,119,6522
subtest26of10,pubtest25of100,1,321,6398,6,159,6563
subtest22of10,pubtest25of100,1,321,6398,7,197,6602
subtest25of10,pubtest25of100,1,321,6398,7,237,6642
subtest29of10,pubtest25of100,1,321,6398,9,275,6682
subtest24of10,pubtest25of100,1,321,6398,10,314,6722
subtest23of10,pubtest25of100,1,321,6398,9,354,6761
subtest27of10,pubtest25of100,1,321,6398,9,391,6798
subtest22of10,pubtest26of100,1,321,6480,-1,40,6519
subtest21of10,pubtest26of100,1,321,6480,1,77,6558
subtest23of10,pubtest26of100,1,321,6480,2,116,6598
subtest29of10,pubtest26of100,1,321,6480,2,156,6638
subtest27of10,pubtest26of100,1,321,6480,10,186,6676
subtest25of10,pubtest26of100,1,321,6480,12,226,6718
subtest26of10,pubtest26of100,1,321,6480,10,265,6755
subtest28of10,pubtest26of100,1,321,6480,14,304,6798
subtest210of10,pubtest26of100,1,321,6480,12,343,6835
subtest24of10,pubtest26of100,1,321,6480,15,383,6878
subtest27of10,pubtest27of100,1,320,5239,0,42,5281
subtest28of10,pubtest27of100,1,320,5239,6,75,5320
subtest23of10,pubtest27of100,1,320,5239,7,115,5361
subtest24of10,pubtest27of100,1,320,5239,7,153,5399
subtest29of10,pubtest27of100,1,320,5239,12,189,5440
subtest25of10,pubtest27of100,1,320,5239,12,229,5480
subtest22of10,pubtest27of100,1,320,5239,14,267,5520
subtest21of10,pubtest27of100,1,320,5239,14,307,5560
subtest210of10,pubtest27of100,1,320,5239,12,346,5597
subtest26of10,pubtest27of100,1,320,5239,16,384,5639
subtest27of10,pubtest28of100,1,321,5383,-4,41,5420
subtest21of10,pubtest28of100,1,321,5383,0,74,5457
subtest29of10,pubtest28of100,1,321,5383,1,114,5498
subtest28of10,pubtest28of100,1,321,5383,2,152,5537
subtest23of10,pubtest28of100,1,321,5383,3,191,5577
subtest210of10,pubtest28of100,1,321,5383,6,228,5617
subtest25of10,pubtest28of100,1,321,5383,5,268,5656
subtest26of10,pubtest28of100,1,321,5383,10,304,5697
subtest24of10,pubtest28of100,1,321,5383,10,343,5736
subtest22of10,pubtest28of100,1,321,5383,14,380,5777
subtest23of10,pubtest29of100,1,321,5227,0,40,5267
subtest210of10,pubtest29of100,1,321,5227,1,77,5305
subtest29of10,pubtest29of100,1,321,5227,2,117,5346
subtest22of10,pubtest29of100,1,321,5227,7,152,5386
subtest25of10,pubtest29of100,1,321,5227,11,188,5426
subtest28of10,pubtest29of100,1,321,5227,18,221,5466
subtest21of10,pubtest29of100,1,321,5227,21,258,5506
subtest27of10,pubtest29of100,1,321,5227,22,297,5546
subtest24of10,pubtest29of100,1,321,5227,23,336,5586
subtest26of10,pubtest29of100,1,321,5227,29,370,5626
subtest29of10,pubtest210of100,1,323,5293,-1,43,5335
subtest21of10,pubtest210of100,1,323,5293,9,71,5373
subtest27of10,pubtest210of100,1,323,5293,9,111,5413
subtest210of10,pubtest210of100,1,323,5293,14,144,5451
subtest23of10,pubtest210of100,1,323,5293,16,184,5493
subtest28of10,pubtest210of100,1,323,5293,17,223,5533
subtest24of10,pubtest210of100,1,323,5293,18,262,5573
subtest25of10,pubtest210of100,1,323,5293,21,299,5613
subtest22of10,pubtest210of100,1,323,5293,23,337,5653
subtest26of10,pubtest210of100,1,323,5293,24,376,5693
subtest210of10,pubtest211of100,1,323,5228,0,39,5267
subtest24of10,pubtest211of100,1,323,5228,17,61,5306
subtest29of10,pubtest211of100,1,323,5228,17,99,5344
subtest22of10,pubtest211of100,1,323,5228,18,139,5385
subtest26of10,pubtest211of100,1,323,5228,20,177,5425
subtest25of10,pubtest211of100,1,323,5228,20,217,5465
subtest21of10,pubtest211of100,1,323,5228,21,256,5505
subtest23of10,pubtest211of100,1,323,5228,21,295,5544
subtest28of10,pubtest211of100,1,323,5228,23,334,5585
subtest27of10,pubtest211of100,1,323,5228,55,343,5626
subtest28of10,pubtest212of100,1,323,5218,-4,40,5254
subtest25of10,pubtest212of100,1,323,5218,-4,80,5294
subtest23of10,pubtest212of100,1,323,5218,2,111,5331
subtest29of10,pubtest212of100,1,323,5218,2,151,5371
subtest27of10,pubtest212of100,1,323,5218,4,191,5413
subtest21of10,pubtest212of100,1,323,5218,7,229,5454
subtest24of10,pubtest212of100,1,323,5218,9,266,5493
subtest22of10,pubtest212of100,1,323,5218,10,307,5535
subtest26of10,pubtest212of100,1,323,5218,11,344,5573
subtest210of10,pubtest212of100,1,323,5218,16,379,5613
subtest23of10,pubtest213of100,1,322,5199,-1,40,5238
subtest26of10,pubtest213of100,1,322,5199,1,77,5277
subtest29of10,pubtest213of100,1,322,5199,2,116,5317
subtest22of10,pubtest213of100,1,322,5199,6,152,5357
subtest27of10,pubtest213of100,1,322,5199,6,192,5397
subtest21of10,pubtest213of100,1,322,5199,11,227,5437
subtest25of10,pubtest213of100,1,322,5199,12,266,5477
subtest28of10,pubtest213of100,1,322,5199,14,303,5516
subtest210of10,pubtest213of100,1,322,5199,16,343,5558
subtest24of10,pubtest213of100,1,322,5199,13,385,5597
subtest21of10,pubtest214of100,1,323,5187,-2,41,5226
subtest23of10,pubtest214of100,1,323,5187,1,77,5265
subtest26of10,pubtest214of100,1,323,5187,5,112,5304
subtest25of10,pubtest214of100,1,323,5187,14,143,5344
subtest27of10,pubtest214of100,1,323,5187,14,183,5384
subtest22of10,pubtest214of100,1,323,5187,16,222,5425
subtest29of10,pubtest214of100,1,323,5187,17,260,5464
subtest210of10,pubtest214of100,1,323,5187,18,300,5505
subtest28of10,pubtest214of100,1,323,5187,19,339,5545
subtest24of10,pubtest214of100,1,323,5187,18,377,5582
subtest27of10,pubtest215of100,1,323,5302,1,103,5406
subtest24of10,pubtest215of100,1,323,5302,1,140,5443
subtest29of10,pubtest215of100,1,323,5302,2,179,5483
subtest25of10,pubtest215of100,1,323,5302,5,218,5525
subtest26of10,pubtest215of100,1,323,5302,6,256,5564
subtest21of10,pubtest215of100,1,323,5302,4,295,5601
subtest210of10,pubtest215of100,1,323,5302,31,311,5644
subtest22of10,pubtest215of100,1,323,5302,32,350,5684
subtest28of10,pubtest215of100,1,323,5302,33,389,5724
subtest23of10,pubtest215of100,1,323,5302,31,429,5762
subtest21of10,pubtest216of100,1,323,5355,4,41,5400
subtest24of10,pubtest216of100,1,323,5355,3,81,5439
subtest23of10,pubtest216of100,1,323,5355,7,117,5479
subtest27of10,pubtest216of100,1,323,5355,7,156,5518
subtest28of10,pubtest216of100,1,323,5355,9,194,5558
subtest29of10,pubtest216of100,1,323,5355,16,227,5598
subtest25of10,pubtest216of100,1,323,5355,16,267,5638
subtest22of10,pubtest216of100,1,323,5355,30,293,5678
subtest210of10,pubtest216of100,1,323,5355,33,330,5718
subtest26of10,pubtest216of100,1,323,5355,33,370,5758
subtest22of10,pubtest217of100,1,322,5223,4,48,5275
subtest26of10,pubtest217of100,1,322,5223,5,87,5315
subtest21of10,pubtest217of100,1,322,5223,6,126,5355
subtest27of10,pubtest217of100,1,322,5223,4,165,5392
subtest24of10,pubtest217of100,1,322,5223,9,203,5435
subtest23of10,pubtest217of100,1,322,5223,9,243,5475
subtest25of10,pubtest217of100,1,322,5223,14,278,5515
subtest28of10,pubtest217of100,1,322,5223,14,318,5555
subtest29of10,pubtest217of100,1,322,5223,12,358,5593
subtest210of10,pubtest217of100,1,322,5223,15,397,5635
subtest29of10,pubtest218of100,1,323,5263,0,40,5303
subtest21of10,pubtest218of100,1,323,5263,1,78,5342
subtest22of10,pubtest218of100,1,323,5263,3,116,5382
subtest28of10,pubtest218of100,1,323,5263,8,150,5421
subtest27of10,pubtest218of100,1,323,5263,8,190,5461
subtest23of10,pubtest218of100,1,323,5263,12,226,5501
subtest25of10,pubtest218of100,1,323,5263,12,265,5540
subtest24of10,pubtest218of100,1,323,5263,15,303,5581
subtest210of10,pubtest218of100,1,323,5263,37,319,5619
subtest26of10,pubtest218of100,1,323,5263,38,358,5659
subtest210of10,pubtest219of100,1,323,5280,0,40,5320
subtest25of10,pubtest219of100,1,323,5280,2,75,5357
subtest26of10,pubtest219of100,1,323,5280,3,115,5398
subtest21of10,pubtest219of100,1,323,5280,4,154,5438
subtest22of10,pubtest219of100,1,323,5280,9,189,5478
subtest29of10,pubtest219of100,1,323,5280,10,228,5518
subtest23of10,pubtest219of100,1,323,5280,11,267,5558
subtest24of10,pubtest219of100,1,323,5280,12,307,5599
subtest27of10,pubtest219of100,1,323,5280,13,345,5638
subtest28of10,pubtest219of100,1,323,5280,13,385,5678
subtest25of10,pubtest220of100,1,323,5340,-3,264,5601
subtest210of10,pubtest220of100,1,323,5340,4,296,5640
subtest29of10,pubtest220of100,1,323,5340,5,335,5680
subtest23of10,pubtest220of100,1,323,5340,4,375,5719
subtest24of10,pubtest220of100,1,323,5340,10,410,5760
subtest28of10,pubtest220of100,1,323,5340,12,446,5798
subtest27of10,pubtest220of100,1,323,5340,11,486,5837
subtest26of10,pubtest220of100,1,323,5340,13,525,5878
subtest22of10,pubtest220of100,1,323,5340,15,565,5920
subtest21of10,pubtest220of100,1,323,5340,11,604,5955
subtest24of10,pubtest221of100,1,323,5263,-3,44,5304
subtest28of10,pubtest221of100,1,323,5263,-3,85,5345
subtest21of10,pubtest221of100,1,323,5263,-1,125,5387
subtest23of10,pubtest221of100,1,323,5263,0,164,5427
subtest22of10,pubtest221of100,1,323,5263,2,202,5467
subtest25of10,pubtest221of100,1,323,5263,2,242,5507
subtest29of10,pubtest221of100,1,323,5263,8,276,5547
subtest27of10,pubtest221of100,1,323,5263,8,316,5587
subtest210of10,pubtest221of100,1,323,5263,12,352,5627
subtest26of10,pubtest221of100,1,323,5263,13,390,5666
subtest22of10,pubtest222of100,1,323,5264,3,40,5307
subtest21of10,pubtest222of100,1,323,5264,3,79,5346
subtest27of10,pubtest222of100,1,323,5264,11,110,5385
subtest29of10,pubtest222of100,1,323,5264,11,151,5426
subtest23of10,pubtest222of100,1,323,5264,13,188,5465
subtest28of10,pubtest222of100,1,323,5264,21,221,5506
subtest25of10,pubtest222of100,1,323,5264,21,261,5546
subtest26of10,pubtest222of100,1,323,5264,23,299,5586
subtest210of10,pubtest222of100,1,323,5264,23,338,5625
subtest24of10,pubtest222of100,1,323,5264,23,378,5665
subtest28of10,pubtest223of100,1,323,5212,4,40,5256
subtest24of10,pubtest223of100,1,323,5212,6,76,5294
subtest210of10,pubtest223of100,1,323,5212,8,114,5334
subtest23of10,pubtest223of100,1,323,5212,7,154,5373
subtest22of10,pubtest223of100,1,323,5212,10,192,5414
subtest27of10,pubtest223of100,1,323,5212,9,231,5452
subtest21of10,pubtest223of100,1,323,5212,6,271,5489
subtest29of10,pubtest223of100,1,323,5212,9,309,5530
subtest25of10,pubtest223of100,1,323,5212,14,348,5574
subtest26of10,pubtest223of100,1,323,5212,15,388,5615
subtest21of10,pubtest224of100,1,323,5231,1,41,5273
subtest27of10,pubtest224of100,1,323,5231,2,78,5311
subtest28of10,pubtest224of100,1,323,5231,4,117,5352
subtest23of10,pubtest224of100,1,323,5231,4,157,5392
subtest26of10,pubtest224of100,1,323,5231,7,194,5432
subtest22of10,pubtest224of100,1,323,5231,14,227,5472
subtest29of10,pubtest224of100,1,323,5231,14,267,5512
subtest25of10,pubtest224of100,1,323,5231,15,306,5552
subtest24of10,pubtest224of100,1,323,5231,23,339,5593
subtest210of10,pubtest224of100,1,323,5231,32,369,5632
subtest27of10,pubtest225of100,1,323,5343,3,41,5387
subtest22of10,pubtest225of100,1,323,5343,3,81,5427
subtest26of10,pubtest225of100,1,323,5343,7,117,5467
subtest21of10,pubtest225of100,1,323,5343,6,157,5506
subtest25of10,pubtest225of100,1,323,5343,12,191,5546
subtest24of10,pubtest225of100,1,323,5343,12,231,5586
subtest23of10,pubtest225of100,1,323,5343,13,270,5626
subtest28of10,pubtest225of100,1,323,5343,14,309,5666
subtest29of10,pubtest225of100,1,323,5343,15,347,5705
subtest210of10,pubtest225of100,1,323,5343,15,387,5745
subtest25of10,pubtest226of100,1,323,5347,-2,40,5385
subtest23of10,pubtest226of100,1,323,5347,3,74,5424
subtest27of10,pubtest226of100,1,323,5347,4,113,5464
subtest22of10,pubtest226of100,1,323,5347,4,151,5502
subtest21of10,pubtest226of100,1,323,5347,7,190,5544
subtest29of10,pubtest226of100,1,323,5347,13,224,5584
subtest28of10,pubtest226of100,1,323,5347,13,264,5624
subtest210of10,pubtest226of100,1,323,5347,15,302,5664
subtest26of10,pubtest226of100,1,323,5347,17,340,5704
subtest24of10,pubtest226of100,1,323,5347,18,379,5744
subtest29of10,pubtest227of100,1,323,5183,8,39,5230
subtest25of10,pubtest227of100,1,323,5183,20,65,5268
subtest210of10,pubtest227of100,1,323,5183,19,104,5306
subtest23of10,pubtest227of100,1,323,5183,22,142,5347
subtest27of10,pubtest227of100,1,323,5183,24,181,5388
subtest24of10,pubtest227of100,1,323,5183,21,220,5424
subtest26of10,pubtest227of100,1,323,5183,25,260,5468
subtest28of10,pubtest227of100,1,323,5183,29,297,5509
subtest21of10,pubtest227of100,1,323,5183,29,336,5548
subtest22of10,pubtest227of100,1,323,5183,28,374,5585
subtest21of10,pubtest228of100,1,323,5462,7,38,5507
subtest26of10,pubtest228of100,1,323,5462,9,75,5546
subtest25of10,pubtest228of100,1,323,5462,10,113,5585
subtest27of10,pubtest228of100,1,323,5462,11,153,5626
subtest23of10,pubtest228of100,1,323,5462,11,190,5663
subtest24of10,pubtest228of100,1,323,5462,12,230,5704
subtest29of10,pubtest228of100,1,323,5462,28,256,5746
subtest210of10,pubtest228of100,1,323,5462,28,296,5786
subtest22of10,pubtest228of100,1,323,5462,29,334,5825
subtest28of10,pubtest228of100,1,323,5462,30,374,5866
subtest24of10,pubtest229of100,1,321,5234,1,298,5533
subtest21of10,pubtest229of100,1,321,5234,2,335,5571
subtest28of10,pubtest229of100,1,321,5234,3,374,5611
subtest22of10,pubtest229of100,1,321,5234,4,413,5651
subtest210of10,pubtest229of100,1,321,5234,7,450,5691
subtest27of10,pubtest229of100,1,321,5234,9,488,5731
subtest23of10,pubtest229of100,1,321,5234,9,528,5771
subtest25of10,pubtest229of100,1,321,5234,11,566,5811
subtest26of10,pubtest229of100,1,321,5234,23,592,5849
subtest29of10,pubtest229of100,1,321,5234,24,632,5890
subtest27of10,pubtest230of100,1,323,5544,1,39,5584
subtest21of10,pubtest230of100,1,323,5544,1,78,5623
subtest22of10,pubtest230of100,1,323,5544,1,117,5662
subtest28of10,pubtest230of100,1,323,5544,8,150,5702
subtest29of10,pubtest230of100,1,323,5544,9,190,5743
subtest25of10,pubtest230of100,1,323,5544,13,224,5781
subtest210of10,pubtest230of100,1,323,5544,15,263,5822
subtest23of10,pubtest230of100,1,323,5544,15,301,5860
subtest24of10,pubtest230of100,1,323,5544,18,341,5903
subtest26of10,pubtest230of100,1,323,5544,19,380,5943
subtest23of10,pubtest231of100,1,323,5248,0,42,5290
subtest25of10,pubtest231of100,1,323,5248,5,77,5330
subtest28of10,pubtest231of100,1,323,5248,15,107,5370
subtest24of10,pubtest231of100,1,323,5248,15,147,5410
subtest29of10,pubtest231of100,1,323,5248,17,185,5450
subtest27of10,pubtest231of100,1,323,5248,17,225,5490
subtest21of10,pubtest231of100,1,323,5248,22,260,5530
subtest210of10,pubtest231of100,1,323,5248,22,300,5570
subtest26of10,pubtest231of100,1,323,5248,23,338,5609
subtest22of10,pubtest231of100,1,323,5248,23,378,5649
subtest27of10,pubtest232of100,1,323,5335,23,40,5398
subtest21of10,pubtest232of100,1,323,5335,23,78,5436
subtest22of10,pubtest232of100,1,323,5335,27,114,5476
subtest23of10,pubtest232of100,1,323,5335,30,151,5516
subtest29of10,pubtest232of100,1,323,5335,31,190,5556
subtest28of10,pubtest232of100,1,323,5335,34,227,5596
subtest25of10,pubtest232of100,1,323,5335,32,266,5633
subtest210of10,pubtest232of100,1,323,5335,37,304,5676
subtest24of10,pubtest232of100,1,323,5335,38,343,5716
subtest26of10,pubtest232of100,1,323,5335,41,380,5756
subtest24of10,pubtest233of100,1,323,5242,2,38,5282
subtest29of10,pubtest233of100,1,323,5242,3,77,5322
subtest25of10,pubtest233of100,1,323,5242,5,113,5360
subtest27of10,pubtest233of100,1,323,5242,6,152,5400
subtest26of10,pubtest233of100,1,323,5242,9,190,5441
subtest210of10,pubtest233of100,1,323,5242,9,230,5481
subtest23of10,pubtest233of100,1,323,5242,44,235,5521
subtest28of10,pubtest233of100,1,323,5242,45,274,5561
subtest22of10,pubtest233of100,1,323,5242,44,313,5599
subtest21of10,pubtest233of100,1,323,5242,47,352,5641
subtest25of10,pubtest234of100,1,323,5284,5,47,5336
subtest26of10,pubtest234of100,1,323,5284,5,86,5375
subtest22of10,pubtest234of100,1,323,5284,7,124,5415
subtest27of10,pubtest234of100,1,323,5284,7,166,5457
subtest21of10,pubtest234of100,1,323,5284,7,204,5495
subtest29of10,pubtest234of100,1,323,5284,9,242,5535
subtest23of10,pubtest234of100,1,323,5284,13,277,5574
subtest210of10,pubtest234of100,1,323,5284,13,317,5614
subtest24of10,pubtest234of100,1,323,5284,19,351,5654
subtest28of10,pubtest234of100,1,323,5284,19,391,5694
subtest21of10,pubtest235of100,1,321,5327,0,39,5366
subtest23of10,pubtest235of100,1,321,5327,1,77,5405
subtest210of10,pubtest235of100,1,321,5327,3,115,5445
subtest22of10,pubtest235of100,1,321,5327,7,151,5485
subtest27of10,pubtest235of100,1,321,5327,8,190,5525
subtest29of10,pubtest235of100,1,321,5327,9,229,5565
subtest25of10,pubtest235of100,1,321,5327,16,262,5605
subtest24of10,pubtest235of100,1,321,5327,16,302,5645
subtest26of10,pubtest235of100,1,321,5327,17,341,5685
subtest28of10,pubtest235of100,1,321,5327,19,378,5724
subtest23of10,pubtest236of100,1,323,5173,11,39,5223
subtest210of10,pubtest236of100,1,323,5173,11,78,5262
subtest27of10,pubtest236of100,1,323,5173,14,116,5303
subtest28of10,pubtest236of100,1,323,5173,15,153,5341
subtest25of10,pubtest236of100,1,323,5173,18,191,5382
subtest29of10,pubtest236of100,1,323,5173,25,222,5420
subtest21of10,pubtest236of100,1,323,5173,25,262,5460
subtest24of10,pubtest236of100,1,323,5173,28,301,5502
subtest22of10,pubtest236of100,1,323,5173,35,334,5542
subtest26of10,pubtest236of100,1,323,5173,35,375,5583
subtest24of10,pubtest237of100,1,323,5301,0,44,5345
subtest23of10,pubtest237of100,1,323,5301,2,81,5384
subtest28of10,pubtest237of100,1,323,5301,6,117,5424
subtest26of10,pubtest237of100,1,323,5301,15,148,5464
subtest25of10,pubtest237of100,1,323,5301,15,187,5503
subtest29of10,pubtest237of100,1,323,5301,17,226,5544
subtest27of10,pubtest237of100,1,323,5301,15,266,5582
subtest22of10,pubtest237of100,1,323,5301,19,304,5624
subtest210of10,pubtest237of100,1,323,5301,17,344,5662
subtest21of10,pubtest237of100,1,323,5301,19,383,5703
subtest29of10,pubtest238of100,1,323,5694,4,40,5738
subtest22of10,pubtest238of100,1,323,5694,38,46,5778
subtest27of10,pubtest238of100,1,323,5694,39,85,5818
subtest25of10,pubtest238of100,1,323,5694,76,87,5857
subtest28of10,pubtest238of100,1,323,5694,77,127,5898
subtest23of10,pubtest238of100,1,323,5694,78,166,5938
subtest210of10,pubtest238of100,1,323,5694,83,200,5977
subtest21of10,pubtest238of100,1,323,5694,83,241,6018
subtest26of10,pubtest238of100,1,323,5694,90,273,6057
subtest24of10,pubtest238of100,1,323,5694,90,313,6097
subtest21of10,pubtest239of100,1,323,5271,1,42,5314
subtest28of10,pubtest239of100,1,323,5271,2,80,5353
subtest27of10,pubtest239of100,1,323,5271,3,119,5393
subtest26of10,pubtest239of100,1,323,5271,4,158,5433
subtest25of10,pubtest239of100,1,323,5271,5,197,5473
subtest29of10,pubtest239of100,1,323,5271,8,234,5513
subtest23of10,pubtest239of100,1,323,5271,9,273,5553
subtest24of10,pubtest239of100,1,323,5271,14,308,5593
subtest22of10,pubtest239of100,1,323,5271,18,343,5632
subtest210of10,pubtest239of100,1,323,5271,21,381,5673
subtest25of10,pubtest240of100,1,323,5402,-1,38,5439
subtest21of10,pubtest240of100,1,323,5402,7,69,5478
subtest210of10,pubtest240of100,1,323,5402,8,109,5519
subtest29of10,pubtest240of100,1,323,5402,10,146,5558
subtest28of10,pubtest240of100,1,323,5402,13,182,5597
subtest24of10,pubtest240of100,1,323,5402,16,221,5639
subtest23of10,pubtest240of100,1,323,5402,13,260,5675
subtest27of10,pubtest240of100,1,323,5402,13,299,5714
subtest26of10,pubtest240of100,1,323,5402,19,338,5759
subtest22of10,pubtest240of100,1,323,5402,18,377,5797
subtest23of10,pubtest241of100,1,323,5239,5,38,5282
subtest27of10,pubtest241of100,1,323,5239,6,77,5322
subtest210of10,pubtest241of100,1,323,5239,7,115,5361
subtest24of10,pubtest241of100,1,323,5239,5,153,5397
subtest21of10,pubtest241of100,1,323,5239,15,187,5441
subtest28of10,pubtest241of100,1,323,5239,18,225,5482
subtest29of10,pubtest241of100,1,323,5239,21,261,5521
subtest26of10,pubtest241of100,1,323,5239,30,292,5561
subtest25of10,pubtest241of100,1,323,5239,30,332,5601
subtest22of10,pubtest241of100,1,323,5239,31,373,5643
subtest27of10,pubtest242of100,1,323,5316,10,41,5367
subtest26of10,pubtest242of100,1,323,5316,16,75,5407
subtest23of10,pubtest242of100,1,323,5316,23,108,5447
subtest25of10,pubtest242of100,1,323,5316,37,133,5486
subtest29of10,pubtest242of100,1,323,5316,44,166,5526
subtest210of10,pubtest242of100,1,323,5316,50,199,5565
subtest21of10,pubtest242of100,1,323,5316,64,226,5606
subtest22of10,pubtest242of100,1,323,5316,71,259,5646
subtest24of10,pubtest242of100,1,323,5316,77,293,5686
subtest28of10,pubtest242of100,1,323,5316,85,325,5726
subtest29of10,pubtest243of100,1,323,5165,1,41,5207
subtest28of10,pubtest243of100,1,323,5165,2,79,5246
subtest22of10,pubtest243of100,1,323,5165,4,118,5287
subtest23of10,pubtest243of100,1,323,5165,41,120,5326
subtest26of10,pubtest243of100,1,323,5165,42,159,5366
subtest27of10,pubtest243of100,1,323,5165,46,195,5406
subtest24of10,pubtest243of100,1,323,5165,46,235,5446
subtest25of10,pubtest243of100,1,323,5165,46,274,5485
subtest21of10,pubtest243of100,1,323,5165,48,311,5524
subtest210of10,pubtest243of100,1,323,5165,50,351,5566
subtest27of10,pubtest244of100,1,323,5255,-4,42,5293
subtest25of10,pubtest244of100,1,323,5255,-3,81,5333
subtest26of10,pubtest244of100,1,323,5255,-4,121,5372
subtest29of10,pubtest244of100,1,323,5255,6,152,5413
subtest21of10,pubtest244of100,1,323,5255,7,192,5454
subtest23of10,pubtest244of100,1,323,5255,11,229,5495
subtest28of10,pubtest244of100,1,323,5255,20,259,5534
subtest210of10,pubtest244of100,1,323,5255,23,297,5575
subtest22of10,pubtest244of100,1,323,5255,24,335,5614
subtest24of10,pubtest244of100,1,323,5255,25,374,5654
subtest29of10,pubtest245of100,1,322,5189,1,40,5230
subtest26of10,pubtest245of100,1,322,5189,2,79,5270
subtest22of10,pubtest245of100,1,322,5189,5,115,5309
subtest23of10,pubtest245of100,1,322,5189,5,155,5349
subtest25of10,pubtest245of100,1,322,5189,7,193,5389
subtest24of10,pubtest245of100,1,322,5189,43,197,5429
subtest21of10,pubtest245of100,1,322,5189,44,235,5468
subtest28of10,pubtest245of100,1,322,5189,45,275,5509
subtest27of10,pubtest245of100,1,322,5189,48,312,5549
subtest210of10,pubtest245of100,1,322,5189,48,351,5588
subtest26of10,pubtest246of100,1,323,5302,-1,282,5583
subtest27of10,pubtest246of100,1,323,5302,1,317,5620
subtest21of10,pubtest246of100,1,323,5302,6,351,5659
subtest28of10,pubtest246of100,1,323,5302,8,389,5699
subtest23of10,pubtest246of100,1,323,5302,10,427,5739
subtest29of10,pubtest246of100,1,323,5302,12,465,5779
subtest25of10,pubtest246of100,1,323,5302,15,502,5819
subtest24of10,pubtest246of100,1,323,5302,19,538,5859
subtest210of10,pubtest246of100,1,323,5302,19,577,5898
subtest22of10,pubtest246of100,1,323,5302,21,616,5939
subtest27of10,pubtest247of100,1,323,5208,-4,39,5243
subtest23of10,pubtest247of100,1,323,5208,-3,77,5282
subtest26of10,pubtest247of100,1,323,5208,0,114,5322
subtest21of10,pubtest247of100,1,323,5208,3,151,5362
subtest29of10,pubtest247of100,1,323,5208,8,186,5402
subtest22of10,pubtest247of100,1,323,5208,9,225,5442
subtest25of10,pubtest247of100,1,323,5208,15,257,5480
subtest28of10,pubtest247of100,1,323,5208,17,296,5521
subtest210of10,pubtest247of100,1,323,5208,17,335,5560
subtest24of10,pubtest247of100,1,323,5208,19,375,5602
subtest29of10,pubtest248of100,1,323,5198,14,41,5253
subtest26of10,pubtest248of100,1,323,5198,16,78,5292
subtest25of10,pubtest248of100,1,323,5198,16,117,5331
subtest23of10,pubtest248of100,1,323,5198,17,157,5372
subtest28of10,pubtest248of100,1,323,5198,29,185,5412
subtest27of10,pubtest248of100,1,323,5198,30,224,5452
subtest24of10,pubtest248of100,1,323,5198,31,263,5492
subtest21of10,pubtest248of100,1,323,5198,31,303,5532
subtest22of10,pubtest248of100,1,323,5198,33,341,5572
subtest210of10,pubtest248of100,1,323,5198,33,381,5612
subtest28of10,pubtest249of100,1,323,5344,2,48,5394
subtest27of10,pubtest249of100,1,323,5344,0,88,5432
subtest25of10,pubtest249of100,1,323,5344,8,121,5473
subtest24of10,pubtest249of100,1,323,5344,9,161,5514
subtest21of10,pubtest249of100,1,323,5344,12,198,5554
subtest26of10,pubtest249of100,1,323,5344,13,236,5593
subtest29of10,pubtest249of100,1,323,5344,15,274,5633
subtest23of10,pubtest249of100,1,323,5344,17,312,5673
subtest22of10,pubtest249of100,1,323,5344,18,351,5713
subtest210of10,pubtest249of100,1,323,5344,22,387,5753
subtest27of10,pubtest250of100,1,323,5308,7,51,5366
subtest23of10,pubtest250of100,1,323,5308,8,89,5405
subtest28of10,pubtest250of100,1,323,5308,10,127,5445
subtest24of10,pubtest250of100,1,323,5308,12,165,5485
subtest26of10,pubtest250of100,1,323,5308,12,204,5524
subtest29of10,pubtest250of100,1,323,5308,13,244,5565
subtest22of10,pubtest250of100,1,323,5308,14,283,5605
subtest25of10,pubtest250of100,1,323,5308,14,323,5645
subtest21of10,pubtest250of100,1,323,5308,15,358,5681
subtest210of10,pubtest250of100,1,323,5308,18,397,5723
subtest23of10,pubtest251of100,1,323,5252,-2,39,5289
subtest22of10,pubtest251of100,1,323,5252,-1,79,5330
subtest24of10,pubtest251of100,1,323,5252,4,112,5368
subtest27of10,pubtest251of100,1,323,5252,4,152,5408
subtest25of10,pubtest251of100,1,323,5252,8,188,5448
subtest29of10,pubtest251of100,1,323,5252,14,222,5488
subtest28of10,pubtest251of100,1,323,5252,14,262,5528
subtest26of10,pubtest251of100,1,323,5252,14,301,5567
subtest21of10,pubtest251of100,1,323,5252,16,340,5608
subtest210of10,pubtest251of100,1,323,5252,17,379,5648
subtest29of10,pubtest252of100,1,323,5420,3,43,5466
subtest25of10,pubtest252of100,1,323,5420,11,72,5503
subtest28of10,pubtest252of100,1,323,5420,8,113,5541
subtest21of10,pubtest252of100,1,323,5420,8,151,5579
subtest24of10,pubtest252of100,1,323,5420,11,190,5621
subtest27of10,pubtest252of100,1,323,5420,13,230,5663
subtest26of10,pubtest252of100,1,323,5420,11,269,5700
subtest22of10,pubtest252of100,1,323,5420,10,309,5739
subtest210of10,pubtest252of100,1,323,5420,14,349,5783
subtest23of10,pubtest252of100,1,323,5420,10,388,5818
subtest28of10,pubtest253of100,1,322,5211,-1,134,5344
subtest23of10,pubtest253of100,1,322,5211,2,168,5381
subtest29of10,pubtest253of100,1,322,5211,3,206,5420
subtest25of10,pubtest253of100,1,322,5211,4,244,5459
subtest24of10,pubtest253of100,1,322,5211,5,284,5500
subtest27of10,pubtest253of100,1,322,5211,6,322,5539
subtest22of10,pubtest253of100,1,322,5211,6,362,5579
subtest210of10,pubtest253of100,1,322,5211,13,395,5619
subtest21of10,pubtest253of100,1,322,5211,13,435,5659
subtest26of10,pubtest253of100,1,322,5211,19,470,5700
subtest27of10,pubtest254of100,1,323,5189,8,41,5238
subtest210of10,pubtest254of100,1,323,5189,8,80,5277
subtest21of10,pubtest254of100,1,323,5189,12,116,5317
subtest28of10,pubtest254of100,1,323,5189,12,156,5357
subtest25of10,pubtest254of100,1,323,5189,32,176,5397
subtest23of10,pubtest254of100,1,323,5189,33,215,5437
subtest24of10,pubtest254of100,1,323,5189,36,252,5477
subtest26of10,pubtest254of100,1,323,5189,37,291,5517
subtest22of10,pubtest254of100,1,323,5189,36,330,5555
subtest29of10,pubtest254of100,1,323,5189,38,370,5597
subtest28of10,pubtest255of100,1,322,5293,10,39,5342
subtest22of10,pubtest255of100,1,322,5293,6,81,5380
subtest23of10,pubtest255of100,1,322,5293,7,121,5421
subtest29of10,pubtest255of100,1,322,5293,10,158,5461
subtest27of10,pubtest255of100,1,322,5293,8,197,5498
subtest21of10,pubtest255of100,1,322,5293,12,236,5541
subtest25of10,pubtest255of100,1,322,5293,18,270,5581
subtest24of10,pubtest255of100,1,322,5293,18,310,5621
subtest210of10,pubtest255of100,1,322,5293,19,349,5661
subtest26of10,pubtest255of100,1,322,5293,22,386,5701
subtest29of10,pubtest256of100,1,323,5203,8,42,5253
subtest21of10,pubtest256of100,1,323,5203,13,77,5293
subtest23of10,pubtest256of100,1,323,5203,15,114,5332
subtest25of10,pubtest256of100,1,323,5203,15,152,5370
subtest27of10,pubtest256of100,1,323,5203,17,192,5412
subtest26of10,pubtest256of100,1,323,5203,14,231,5448
subtest24of10,pubtest256of100,1,323,5203,19,270,5492
subtest210of10,pubtest256of100,1,323,5203,16,311,5530
subtest28of10,pubtest256of100,1,323,5203,17,349,5569
subtest22of10,pubtest256of100,1,323,5203,17,390,5610
subtest21of10,pubtest257of100,1,323,5226,14,47,5287
subtest24of10,pubtest257of100,1,323,5226,15,85,5326
subtest27of10,pubtest257of100,1,323,5226,16,124,5366
subtest28of10,pubtest257of100,1,323,5226,18,162,5406
subtest25of10,pubtest257of100,1,323,5226,20,200,5446
subtest210of10,pubtest257of100,1,323,5226,21,239,5486
subtest29of10,pubtest257of100,1,323,5226,22,279,5527
subtest23of10,pubtest257of100,1,323,5226,23,315,5564
subtest22of10,pubtest257of100,1,323,5226,21,354,5601
subtest26of10,pubtest257of100,1,323,5226,33,387,5646
subtest28of10,pubtest258of100,1,323,5273,-1,42,5314
subtest23of10,pubtest258of100,1,323,5273,0,79,5352
subtest25of10,pubtest258of100,1,323,5273,1,118,5392
subtest21of10,pubtest258of100,1,323,5273,4,154,5431
subtest27of10,pubtest258of100,1,323,5273,6,193,5472
subtest22of10,pubtest258of100,1,323,5273,7,232,5512
subtest26of10,pubtest258of100,1,323,5273,8,271,5552
subtest29of10,pubtest258of100,1,323,5273,9,310,5592
subtest24of10,pubtest258of100,1,323,5273,9,350,5632
subtest210of10,pubtest258of100,1,323,5273,7,389,5669
subtest25of10,pubtest259of100,1,323,5257,1,42,5300
subtest21of10,pubtest259of100,1,323,5257,-1,80,5336
subtest28of10,pubtest259of100,1,323,5257,4,119,5380
subtest27of10,pubtest259of100,1,323,5257,11,151,5419
subtest24of10,pubtest259of100,1,323,5257,13,191,5461
subtest26of10,pubtest259of100,1,323,5257,16,227,5500
subtest23of10,pubtest259of100,1,323,5257,16,266,5539
subtest29of10,pubtest259of100,1,323,5257,18,304,5579
subtest22of10,pubtest259of100,1,323,5257,21,340,5618
subtest210of10,pubtest259of100,1,323,5257,22,381,5660
subtest210of10,pubtest260of100,1,323,5356,1,41,5398
subtest23of10,pubtest260of100,1,323,5356,1,80,5437
subtest21of10,pubtest260of100,1,323,5356,6,115,5477
subtest26of10,pubtest260of100,1,323,5356,7,154,5517
subtest27of10,pubtest260of100,1,323,5356,7,194,5557
subtest22of10,pubtest260of100,1,323,5356,9,232,5597
subtest28of10,pubtest260of100,1,323,5356,14,267,5637
subtest29of10,pubtest260of100,1,323,5356,14,307,5677
subtest25of10,pubtest260of100,1,323,5356,14,344,5714
subtest24of10,pubtest260of100,1,323,5356,18,383,5757
subtest25of10,pubtest261of100,1,323,5170,7,41,5218
subtest28of10,pubtest261of100,1,323,5170,8,78,5256
subtest29of10,pubtest261of100,1,323,5170,9,118,5297
subtest210of10,pubtest261of100,1,323,5170,11,155,5336
subtest22of10,pubtest261of100,1,323,5170,15,190,5375
subtest23of10,pubtest261of100,1,323,5170,91,155,5416
subtest24of10,pubtest261of100,1,323,5170,93,193,5456
subtest27of10,pubtest261of100,1,323,5170,96,230,5496
subtest26of10,pubtest261of100,1,323,5170,97,269,5536
subtest21of10,pubtest261of100,1,323,5170,97,309,5576
subtest21of10,pubtest262of100,1,323,5222,-1,446,5667
subtest23of10,pubtest262of100,1,323,5222,2,446,5670
subtest29of10,pubtest262of100,1,323,5222,4,479,5705
subtest25of10,pubtest262of100,1,323,5222,5,520,5747
subtest27of10,pubtest262of100,1,323,5222,5,558,5785
subtest22of10,pubtest262of100,1,323,5222,18,586,5826
subtest26of10,pubtest262of100,1,323,5222,18,626,5866
subtest210of10,pubtest262of100,1,323,5222,19,665,5906
subtest24of10,pubtest262of100,1,323,5222,22,702,5946
subtest28of10,pubtest262of100,1,323,5222,25,739,5986
subtest22of10,pubtest263of100,1,322,5188,22,38,5248
subtest29of10,pubtest263of100,1,322,5188,23,77,5288
subtest26of10,pubtest263of100,1,322,5188,25,114,5327
subtest28of10,pubtest263of100,1,322,5188,27,153,5368
subtest27of10,pubtest263of100,1,322,5188,26,193,5407
subtest23of10,pubtest263of100,1,322,5188,25,232,5445
subtest210of10,pubtest263of100,1,322,5188,26,272,5486
subtest24of10,pubtest263of100,1,322,5188,25,307,5520
subtest21of10,pubtest263of100,1,322,5188,30,347,5565
subtest25of10,pubtest263of100,1,322,5188,26,386,5600
subtest29of10,pubtest264of100,1,322,5414,8,39,5461
subtest22of10,pubtest264of100,1,322,5414,8,78,5500
subtest23of10,pubtest264of100,1,322,5414,12,114,5540
subtest24of10,pubtest264of100,1,322,5414,17,148,5579
subtest27of10,pubtest264of100,1,322,5414,17,188,5619
subtest21of10,pubtest264of100,1,322,5414,22,224,5660
subtest28of10,pubtest264of100,1,322,5414,21,264,5699
subtest25of10,pubtest264of100,1,322,5414,25,301,5740
subtest26of10,pubtest264of100,1,322,5414,27,338,5779
subtest210of10,pubtest264of100,1,322,5414,27,378,5819
subtest210of10,pubtest265of100,1,323,5462,18,38,5518
subtest21of10,pubtest265of100,1,323,5462,18,77,5557
subtest29of10,pubtest265of100,1,323,5462,20,116,5598
subtest25of10,pubtest265of100,1,323,5462,21,154,5637
subtest23of10,pubtest265of100,1,323,5462,21,194,5677
subtest24of10,pubtest265of100,1,323,5462,23,232,5717
subtest28of10,pubtest265of100,1,323,5462,23,272,5757
subtest26of10,pubtest265of100,1,323,5462,15,311,5788
subtest22of10,pubtest265of100,1,323,5462,23,351,5836
subtest27of10,pubtest265of100,1,323,5462,18,390,5870
subtest29of10,pubtest266of100,1,321,5202,-2,44,5244
subtest25of10,pubtest266of100,1,321,5202,-1,81,5282
subtest210of10,pubtest266of100,1,321,5202,1,119,5322
subtest27of10,pubtest266of100,1,321,5202,9,152,5363
subtest26of10,pubtest266of100,1,321,5202,10,190,5402
subtest23of10,pubtest266of100,1,321,5202,12,230,5444
subtest28of10,pubtest266of100,1,321,5202,14,267,5483
subtest21of10,pubtest266of100,1,321,5202,22,297,5521
subtest24of10,pubtest266of100,1,321,5202,26,335,5563
subtest22of10,pubtest266of100,1,321,5202,25,375,5602
subtest23of10,pubtest267of100,1,323,5223,3,42,5268
subtest26of10,pubtest267of100,1,323,5223,10,74,5307
subtest25of10,pubtest267of100,1,323,5223,11,113,5347
subtest28of10,pubtest267of100,1,323,5223,14,150,5387
subtest27of10,pubtest267of100,1,323,5223,12,190,5425
subtest29of10,pubtest267of100,1,323,5223,14,229,5466
subtest21of10,pubtest267of100,1,323,5223,16,267,5506
subtest24of10,pubtest267of100,1,323,5223,17,307,5547
subtest210of10,pubtest267of100,1,323,5223,18,346,5587
subtest22of10,pubtest267of100,1,323,5223,18,386,5627
subtest24of10,pubtest268of100,1,323,5356,19,41,5416
subtest23of10,pubtest268of100,1,323,5356,19,81,5456
subtest25of10,pubtest268of100,1,323,5356,21,120,5497
subtest29of10,pubtest268of100,1,323,5356,22,158,5536
subtest27of10,pubtest268of100,1,323,5356,22,197,5575
subtest28of10,pubtest268of100,1,323,5356,24,236,5616
subtest21of10,pubtest268of100,1,323,5356,24,275,5655
subtest22of10,pubtest268of100,1,323,5356,26,313,5695
subtest210of10,pubtest268of100,1,323,5356,27,352,5735
subtest26of10,pubtest268of100,1,323,5356,31,389,5776
subtest24of10,pubtest269of100,1,323,5273,4,41,5318
subtest27of10,pubtest269of100,1,323,5273,5,79,5357
subtest26of10,pubtest269of100,1,323,5273,11,114,5398
subtest210of10,pubtest269of100,1,323,5273,11,154,5438
subtest22of10,pubtest269of100,1,323,5273,18,187,5478
subtest25of10,pubtest269of100,1,323,5273,18,227,5518
subtest28of10,pubtest269of100,1,323,5273,20,264,5557
subtest23of10,pubtest269of100,1,323,5273,22,303,5598
subtest29of10,pubtest269of100,1,323,5273,23,342,5638
subtest21of10,pubtest269of100,1,323,5273,23,382,5678
subtest23of10,pubtest270of100,1,323,5383,-2,39,5420
subtest27of10,pubtest270of100,1,323,5383,7,69,5459
subtest29of10,pubtest270of100,1,323,5383,8,108,5499
subtest26of10,pubtest270of100,1,323,5383,9,146,5538
subtest25of10,pubtest270of100,1,323,5383,11,185,5579
subtest21of10,pubtest270of100,1,323,5383,12,224,5619
subtest210of10,pubtest270of100,1,323,5383,12,264,5659
subtest28of10,pubtest270of100,1,323,5383,18,298,5699
subtest24of10,pubtest270of100,1,323,5383,18,338,5739
subtest22of10,pubtest270of100,1,323,5383,19,377,5779
subtest24of10,pubtest271of100,1,323,5457,8,41,5506
subtest22of10,pubtest271of100,1,323,5457,8,80,5545
subtest27of10,pubtest271of100,1,323,5457,10,117,5584
subtest210of10,pubtest271of100,1,323,5457,11,156,5624
subtest25of10,pubtest271of100,1,323,5457,10,196,5663
subtest23of10,pubtest271of100,1,323,5457,12,234,5703
subtest26of10,pubtest271of100,1,323,5457,13,274,5744
subtest29of10,pubtest271of100,1,323,5457,14,313,5784
subtest28of10,pubtest271of100,1,323,5457,14,353,5824
subtest21of10,pubtest271of100,1,323,5457,16,391,5864
subtest26of10,pubtest272of100,1,323,5235,8,40,5283
subtest25of10,pubtest272of100,1,323,5235,7,80,5322
subtest21of10,pubtest272of100,1,323,5235,10,116,5361
subtest29of10,pubtest272of100,1,323,5235,10,155,5400
subtest23of10,pubtest272of100,1,323,5235,12,194,5441
subtest27of10,pubtest272of100,1,323,5235,12,234,5481
subtest24of10,pubtest272of100,1,323,5235,49,237,5521
subtest210of10,pubtest272of100,1,323,5235,50,276,5561
subtest22of10,pubtest272of100,1,323,5235,52,314,5601
subtest28of10,pubtest272of100,1,323,5235,52,354,5641
subtest22of10,pubtest273of100,1,321,5222,8,40,5270
subtest29of10,pubtest273of100,1,321,5222,9,78,5309
subtest26of10,pubtest273of100,1,321,5222,11,114,5347
subtest28of10,pubtest273of100,1,321,5222,11,154,5387
subtest25of10,pubtest273of100,1,321,5222,12,192,5426
subtest21of10,pubtest273of100,1,321,5222,14,232,5468
subtest23of10,pubtest273of100,1,321,5222,15,271,5508
subtest210of10,pubtest273of100,1,321,5222,15,310,5547
subtest24of10,pubtest273of100,1,321,5222,15,350,5587
subtest27of10,pubtest273of100,1,321,5222,15,391,5628
subtest26of10,pubtest274of100,1,323,5258,4,42,5304
subtest21of10,pubtest274of100,1,323,5258,3,84,5345
subtest23of10,pubtest274of100,1,323,5258,4,122,5384
subtest22of10,pubtest274of100,1,323,5258,7,159,5424
subtest25of10,pubtest274of100,1,323,5258,12,194,5464
subtest29of10,pubtest274of100,1,323,5258,12,234,5504
subtest28of10,pubtest274of100,1,323,5258,16,270,5544
subtest27of10,pubtest274of100,1,323,5258,16,310,5584
subtest24of10,pubtest274of100,1,323,5258,18,348,5624
subtest210of10,pubtest274of100,1,323,5258,21,385,5664
subtest27of10,pubtest275of100,1,323,5344,-2,41,5383
subtest25of10,pubtest275of100,1,323,5344,3,75,5422
subtest29of10,pubtest275of100,1,323,5344,3,115,5462
subtest21of10,pubtest275of100,1,323,5344,7,151,5502
subtest24of10,pubtest275of100,1,323,5344,7,191,5542
subtest23of10,pubtest275of100,1,323,5344,9,229,5582
subtest22of10,pubtest275of100,1,323,5344,9,267,5620
subtest210of10,pubtest275of100,1,323,5344,12,306,5662
subtest28of10,pubtest275of100,1,323,5344,16,342,5702
subtest26of10,pubtest275of100,1,323,5344,16,382,5742
subtest28of10,pubtest276of100,1,323,5379,4,355,5738
subtest21of10,pubtest276of100,1,323,5379,6,390,5775
subtest29of10,pubtest276of100,1,323,5379,13,423,5815
subtest23of10,pubtest276of100,1,323,5379,13,463,5855
subtest24of10,pubtest276of100,1,323,5379,10,502,5891
subtest25of10,pubtest276of100,1,323,5379,10,541,5930
subtest26of10,pubtest276of100,1,323,5379,14,581,5974
subtest27of10,pubtest276of100,1,323,5379,14,620,6013
subtest210of10,pubtest276of100,1,323,5379,17,659,6055
subtest22of10,pubtest276of100,1,323,5379,19,698,6096
subtest22of10,pubtest277of100,1,323,5196,17,42,5255
subtest28of10,pubtest277of100,1,323,5196,18,81,5295
subtest21of10,pubtest277of100,1,323,5196,20,118,5334
subtest29of10,pubtest277of100,1,323,5196,19,441,5656
subtest27of10,pubtest277of100,1,323,5196,21,477,5694
subtest24of10,pubtest277of100,1,323,5196,21,517,5734
subtest25of10,pubtest277of100,1,323,5196,23,555,5774
subtest23of10,pubtest277of100,1,323,5196,23,595,5814
subtest26of10,pubtest277of100,1,323,5196,24,634,5854
subtest210of10,pubtest277of100,1,323,5196,24,674,5894
subtest29of10,pubtest278of100,1,323,5326,17,41,5384
subtest22of10,pubtest278of100,1,323,5326,17,80,5423
subtest28of10,pubtest278of100,1,323,5326,19,118,5463
subtest23of10,pubtest278of100,1,323,5326,19,158,5503
subtest21of10,pubtest278of100,1,323,5326,21,196,5543
subtest27of10,pubtest278of100,1,323,5326,21,236,5583
subtest26of10,pubtest278of100,1,323,5326,25,272,5623
subtest24of10,pubtest278of100,1,323,5326,26,311,5663
subtest25of10,pubtest278of100,1,323,5326,25,350,5701
subtest210of10,pubtest278of100,1,323,5326,28,389,5743
subtest25of10,pubtest279of100,1,323,5216,10,42,5268
subtest28of10,pubtest279of100,1,323,5216,10,80,5306
subtest21of10,pubtest279of100,1,323,5216,14,116,5346
subtest29of10,pubtest279of100,1,323,5216,14,156,5386
subtest26of10,pubtest279of100,1,323,5216,14,194,5424
subtest22of10,pubtest279of100,1,323,5216,16,234,5466
subtest24of10,pubtest279of100,1,323,5216,12,272,5500
subtest210of10,pubtest279of100,1,323,5216,18,312,5546
subtest27of10,pubtest279of100,1,323,5216,18,352,5586
subtest23of10,pubtest279of100,1,323,5216,54,356,5626
subtest27of10,pubtest280of100,1,323,5184,3,40,5227
subtest24of10,pubtest280of100,1,323,5184,11,71,5266
subtest29of10,pubtest280of100,1,323,5184,14,109,5307
subtest21of10,pubtest280of100,1,323,5184,14,148,5346
subtest23of10,pubtest280of100,1,323,5184,18,183,5385
subtest25of10,pubtest280of100,1,323,5184,19,223,5426
subtest26of10,pubtest280of100,1,323,5184,21,261,5466
subtest210of10,pubtest280of100,1,323,5184,23,299,5506
subtest28of10,pubtest280of100,1,323,5184,23,339,5546
subtest22of10,pubtest280of100,1,323,5184,27,374,5585
subtest24of10,pubtest281of100,1,323,5264,8,46,5318
subtest22of10,pubtest281of100,1,323,5264,14,80,5358
subtest21of10,pubtest281of100,1,323,5264,16,117,5397
subtest210of10,pubtest281of100,1,323,5264,16,157,5437
subtest25of10,pubtest281of100,1,323,5264,13,196,5473
subtest27of10,pubtest281of100,1,323,5264,12,233,5509
subtest29of10,pubtest281of100,1,323,5264,17,272,5553
subtest26of10,pubtest281of100,1,323,5264,18,314,5596
subtest23of10,pubtest281of100,1,323,5264,11,351,5626
subtest28of10,pubtest281of100,1,323,5264,14,391,5669
subtest24of10,pubtest282of100,1,323,5182,29,41,5252
subtest21of10,pubtest282of100,1,323,5182,30,80,5292
subtest29of10,pubtest282of100,1,323,5182,33,117,5332
subtest26of10,pubtest282of100,1,323,5182,34,156,5372
subtest25of10,pubtest282of100,1,323,5182,35,195,5412
subtest22of10,pubtest282of100,1,323,5182,33,235,5450
subtest23of10,pubtest282of100,1,323,5182,29,273,5484
subtest27of10,pubtest282of100,1,323,5182,41,309,5532
subtest210of10,pubtest282of100,1,323,5182,41,350,5573
subtest28of10,pubtest282of100,1,323,5182,42,388,5612
subtest27of10,pubtest283of100,1,323,5306,-2,39,5343
subtest24of10,pubtest283of100,1,323,5306,2,76,5384
subtest22of10,pubtest283of100,1,323,5306,36,81,5423
subtest23of10,pubtest283of100,1,323,5306,38,120,5464
subtest28of10,pubtest283of100,1,323,5306,44,153,5503
subtest25of10,pubtest283of100,1,323,5306,44,193,5543
subtest21of10,pubtest283of100,1,323,5306,48,229,5583
subtest210of10,pubtest283of100,1,323,5306,52,265,5623
subtest29of10,pubtest283of100,1,323,5306,56,300,5662
subtest26of10,pubtest283of100,1,323,5306,56,340,5702
subtest22of10,pubtest284of100,1,323,5798,21,40,5859
subtest25of10,pubtest284of100,1,323,5798,22,78,5898
subtest29of10,pubtest284of100,1,323,5798,23,117,5938
subtest24of10,pubtest284of100,1,323,5798,24,156,5978
subtest210of10,pubtest284of100,1,323,5798,24,195,6017
subtest28of10,pubtest284of100,1,323,5798,26,234,6058
subtest21of10,pubtest284of100,1,323,5798,27,272,6097
subtest26of10,pubtest284of100,1,323,5798,29,311,6138
subtest23of10,pubtest284of100,1,323,5798,26,351,6175
subtest27of10,pubtest284of100,1,323,5798,30,390,6218
subtest23of10,pubtest285of100,1,323,5188,3,43,5234
subtest27of10,pubtest285of100,1,323,5188,4,79,5271
subtest25of10,pubtest285of100,1,323,5188,4,117,5309
subtest21of10,pubtest285of100,1,323,5188,11,155,5354
subtest24of10,pubtest285of100,1,323,5188,15,190,5393
subtest29of10,pubtest285of100,1,323,5188,15,230,5433
subtest22of10,pubtest285of100,1,323,5188,20,265,5473
subtest28of10,pubtest285of100,1,323,5188,21,304,5513
subtest210of10,pubtest285of100,1,323,5188,22,343,5553
subtest26of10,pubtest285of100,1,323,5188,22,384,5594
subtest23of10,pubtest286of100,1,323,5249,9,98,5356
subtest25of10,pubtest286of100,1,323,5249,11,136,5396
subtest210of10,pubtest286of100,1,323,5249,16,171,5436
subtest29of10,pubtest286of100,1,323,5249,16,212,5477
subtest24of10,pubtest286of100,1,323,5249,64,204,5517
subtest26of10,pubtest286of100,1,323,5249,66,241,5556
subtest22of10,pubtest286of100,1,323,5249,66,282,5597
subtest21of10,pubtest286of100,1,323,5249,65,318,5632
subtest28of10,pubtest286of100,1,323,5249,68,358,5675
subtest27of10,pubtest286of100,1,323,5249,66,396,5711
subtest26of10,pubtest287of100,1,323,5270,5,40,5315
subtest29of10,pubtest287of100,1,323,5270,5,80,5355
subtest28of10,pubtest287of100,1,323,5270,6,118,5394
subtest27of10,pubtest287of100,1,323,5270,8,156,5434
subtest210of10,pubtest287of100,1,323,5270,12,192,5474
subtest25of10,pubtest287of100,1,323,5270,18,226,5514
subtest24of10,pubtest287of100,1,323,5270,19,264,5553
subtest21of10,pubtest287of100,1,323,5270,20,304,5594
subtest23of10,pubtest287of100,1,323,5270,23,341,5634
subtest22of10,pubtest287of100,1,323,5270,24,380,5674
subtest29of10,pubtest288of100,1,323,5263,3,41,5307
subtest25of10,pubtest288of100,1,323,5263,12,71,5346
subtest26of10,pubtest288of100,1,323,5263,14,109,5386
subtest21of10,pubtest288of100,1,323,5263,15,149,5427
subtest27of10,pubtest288of100,1,323,5263,16,187,5466
subtest22of10,pubtest288of100,1,323,5263,66,177,5506
subtest210of10,pubtest288of100,1,323,5263,68,216,5547
subtest23of10,pubtest288of100,1,323,5263,68,255,5586
subtest24of10,pubtest288of100,1,323,5263,71,292,5626
subtest28of10,pubtest288of100,1,323,5263,74,329,5666
subtest210of10,pubtest289of100,1,323,5243,2,39,5284
subtest29of10,pubtest289of100,1,323,5243,2,78,5323
subtest23of10,pubtest289of100,1,323,5243,5,115,5363
subtest24of10,pubtest289of100,1,323,5243,6,154,5403
subtest26of10,pubtest289of100,1,323,5243,10,190,5443
subtest25of10,pubtest289of100,1,323,5243,10,230,5483
subtest27of10,pubtest289of100,1,323,5243,12,268,5523
subtest28of10,pubtest289of100,1,323,5243,12,309,5564
subtest22of10,pubtest289of100,1,323,5243,15,343,5601
subtest21of10,pubtest289of100,1,323,5243,22,378,5643
subtest29of10,pubtest290of100,1,323,5297,2,39,5338
subtest22of10,pubtest290of100,1,323,5297,3,78,5378
subtest23of10,pubtest290of100,1,323,5297,10,111,5418
subtest25of10,pubtest290of100,1,323,5297,10,150,5457
subtest27of10,pubtest290of100,1,323,5297,14,184,5495
subtest210of10,pubtest290of100,1,323,5297,16,225,5538
subtest26of10,pubtest290of100,1,323,5297,13,263,5573
subtest24of10,pubtest290of100,1,323,5297,18,302,5617
subtest28of10,pubtest290of100,1,323,5297,18,342,5657
subtest21of10,pubtest290of100,1,323,5297,18,381,5696
subtest23of10,pubtest291of100,1,323,5240,1,46,5287
subtest24of10,pubtest291of100,1,323,5240,1,84,5325
subtest28of10,pubtest291of100,1,323,5240,8,119,5367
subtest210of10,pubtest291of100,1,323,5240,11,156,5407
subtest27of10,pubtest291of100,1,323,5240,11,196,5447
subtest21of10,pubtest291of100,1,323,5240,14,235,5489
subtest25of10,pubtest291of100,1,323,5240,18,270,5528
subtest26of10,pubtest291of100,1,323,5240,19,308,5567
subtest22of10,pubtest291of100,1,323,5240,18,348,5606
subtest29of10,pubtest291of100,1,323,5240,21,386,5647
subtest29of10,pubtest292of100,1,323,5291,9,40,5340
subtest28of10,pubtest292of100,1,323,5291,9,79,5379
subtest25of10,pubtest292of100,1,323,5291,11,117,5419
subtest21of10,pubtest292of100,1,323,5291,11,157,5459
subtest26of10,pubtest292of100,1,323,5291,13,195,5499
subtest27of10,pubtest292of100,1,323,5291,13,236,5540
subtest23of10,pubtest292of100,1,323,5291,14,273,5578
subtest22of10,pubtest292of100,1,323,5291,14,313,5618
subtest24of10,pubtest292of100,1,323,5291,16,350,5657
subtest210of10,pubtest292of100,1,323,5291,18,390,5699
subtest24of10,pubtest293of100,1,323,5173,15,365,5553
subtest25of10,pubtest293of100,1,323,5173,20,400,5593
subtest28of10,pubtest293of100,1,323,5173,20,439,5632
subtest27of10,pubtest293of100,1,323,5173,22,478,5673
subtest23of10,pubtest293of100,1,323,5173,22,518,5713
subtest210of10,pubtest293of100,1,323,5173,25,555,5753
subtest21of10,pubtest293of100,1,323,5173,26,594,5793
subtest29of10,pubtest293of100,1,323,5173,27,633,5833
subtest22of10,pubtest293of100,1,323,5173,28,672,5873
subtest26of10,pubtest293of100,1,323,5173,28,712,5913
subtest21of10,pubtest294of100,1,323,5282,0,41,5323
subtest25of10,pubtest294of100,1,323,5282,1,79,5362
subtest29of10,pubtest294of100,1,323,5282,3,119,5404
subtest27of10,pubtest294of100,1,323,5282,4,157,5443
subtest23of10,pubtest294of100,1,323,5282,5,199,5486
subtest210of10,pubtest294of100,1,323,5282,12,231,5525
subtest26of10,pubtest294of100,1,323,5282,17,265,5564
subtest24of10,pubtest294of100,1,323,5282,22,300,5604
subtest22of10,pubtest294of100,1,323,5282,22,340,5644
subtest28of10,pubtest294of100,1,323,5282,24,378,5684
subtest25of10,pubtest295of100,1,323,5156,3,41,5200
subtest24of10,pubtest295of100,1,323,5156,9,75,5240
subtest23of10,pubtest295of100,1,323,5156,10,113,5279
subtest22of10,pubtest295of100,1,323,5156,11,152,5319
subtest210of10,pubtest295of100,1,323,5156,13,190,5359
subtest27of10,pubtest295of100,1,323,5156,12,229,5397
subtest29of10,pubtest295of100,1,323,5156,70,213,5439
subtest28of10,pubtest295of100,1,323,5156,71,252,5479
subtest21of10,pubtest295of100,1,323,5156,75,288,5519
subtest26of10,pubtest295of100,1,323,5156,75,333,5564
subtest25of10,pubtest296of100,1,322,5230,8,39,5277
subtest27of10,pubtest296of100,1,322,5230,9,75,5314
subtest29of10,pubtest296of100,1,322,5230,11,115,5356
subtest26of10,pubtest296of100,1,322,5230,11,156,5397
subtest21of10,pubtest296of100,1,322,5230,12,192,5434
subtest23of10,pubtest296of100,1,322,5230,10,231,5471
subtest24of10,pubtest296of100,1,322,5230,12,271,5513
subtest210of10,pubtest296of100,1,322,5230,21,305,5556
subtest28of10,pubtest296of100,1,322,5230,21,345,5596
subtest22of10,pubtest296of100,1,322,5230,24,382,5636
subtest210of10,pubtest297of100,1,323,5299,37,43,5379
subtest25of10,pubtest297of100,1,323,5299,37,83,5419
subtest29of10,pubtest297of100,1,323,5299,42,121,5462
subtest23of10,pubtest297of100,1,323,5299,40,161,5500
subtest21of10,pubtest297of100,1,323,5299,43,200,5542
subtest22of10,pubtest297of100,1,323,5299,40,239,5578
subtest27of10,pubtest297of100,1,323,5299,44,279,5622
subtest26of10,pubtest297of100,1,323,5299,41,323,5663
subtest24of10,pubtest297of100,1,323,5299,49,354,5702
subtest28of10,pubtest297of100,1,323,5299,49,394,5742
subtest29of10,pubtest298of100,1,323,5211,17,41,5269
subtest22of10,pubtest298of100,1,323,5211,19,78,5308
subtest25of10,pubtest298of100,1,323,5211,19,118,5348
subtest24of10,pubtest298of100,1,323,5211,20,157,5388
subtest23of10,pubtest298of100,1,323,5211,22,196,5429
subtest21of10,pubtest298of100,1,323,5211,21,236,5468
subtest210of10,pubtest298of100,1,323,5211,23,274,5508
subtest26of10,pubtest298of100,1,323,5211,24,313,5548
subtest27of10,pubtest298of100,1,323,5211,27,350,5588
subtest28of10,pubtest298of100,1,323,5211,27,389,5627
subtest22of10,pubtest299of100,1,323,5213,15,38,5266
subtest29of10,pubtest299of100,1,323,5213,17,75,5305
subtest210of10,pubtest299of100,1,323,5213,18,114,5345
subtest27of10,pubtest299of100,1,323,5213,19,153,5385
subtest24of10,pubtest299of100,1,323,5213,21,189,5423
subtest25of10,pubtest299of100,1,323,5213,23,229,5465
subtest23of10,pubtest299of100,1,323,5213,24,268,5505
subtest28of10,pubtest299of100,1,323,5213,26,306,5545
subtest21of10,pubtest299of100,1,323,5213,26,346,5585
subtest26of10,pubtest299of100,1,323,5213,28,384,5625
subtest21of10,pubtest2100of100,1,325,5243,3,42,5288
subtest29of10,pubtest2100of100,1,325,5243,6,79,5328
subtest24of10,pubtest2100of100,1,325,5243,5,120,5368
subtest23of10,pubtest2100of100,1,325,5243,7,157,5407
subtest22of10,pubtest2100of100,1,325,5243,39,165,5447
subtest28of10,pubtest2100of100,1,325,5243,39,205,5487
subtest27of10,pubtest2100of100,1,325,5243,41,243,5527
subtest25of10,pubtest2100of100,1,325,5243,41,283,5567
subtest210of10,pubtest2100of100,1,325,5243,45,319,5607
subtest26of10,pubtest2100of100,1,325,5243,56,348,5647
subtest26of10,pubtest21of100,1,322,10606,1,41,10648
subtest27of10,pubtest21of100,1,322,10606,2,79,10687
subtest29of10,pubtest21of100,1,322,10606,4,117,10727
subtest25of10,pubtest21of100,1,322,10606,5,156,10767
subtest24of10,pubtest21of100,1,322,10606,7,194,10807
subtest210of10,pubtest21of100,1,322,10606,7,234,10847
subtest21of10,pubtest21of100,1,322,10606,13,268,10887
subtest28of10,pubtest21of100,1,322,10606,21,300,10927
subtest22of10,pubtest21of100,1,322,10606,22,339,10967
subtest23of10,pubtest21of100,1,322,10606,21,379,11006
subtest29of10,pubtest22of100,1,321,5217,10,40,5267
subtest27of10,pubtest22of100,1,321,5217,15,73,5305
subtest24of10,pubtest22of100,1,321,5217,16,113,5346
subtest23of10,pubtest22of100,1,321,5217,19,154,5390
subtest28of10,pubtest22of100,1,321,5217,20,194,5431
subtest26of10,pubtest22of100,1,321,5217,21,232,5470
subtest210of10,pubtest22of100,1,321,5217,22,271,5510
subtest21of10,pubtest22of100,1,321,5217,23,310,5550
subtest25of10,pubtest22of100,1,321,5217,24,350,5591
subtest22of10,pubtest22of100,1,321,5217,29,384,5630
subtest23of10,pubtest23of100,1,321,5199,8,44,5251
subtest28of10,pubtest23of100,1,321,5199,7,84,5290
subtest24of10,pubtest23of100,1,321,5199,11,121,5331
subtest29of10,pubtest23of100,1,321,5199,11,162,5372
subtest22of10,pubtest23of100,1,321,5199,13,199,5411
subtest25of10,pubtest23of100,1,321,5199,13,239,5451
subtest27of10,pubtest23of100,1,321,5199,14,279,5492
subtest26of10,pubtest23of100,1,321,5199,13,318,5530
subtest21of10,pubtest23of100,1,321,5199,16,356,5571
subtest210of10,pubtest23of100,1,321,5199,16,396,5611
subtest24of10,pubtest24of100,1,321,5246,1,42,5289
subtest23of10,pubtest24of100,1,321,5246,0,81,5327
subtest25of10,pubtest24of100,1,321,5246,5,117,5368
subtest28of10,pubtest24of100,1,321,5246,6,155,5407
subtest27of10,pubtest24of100,1,321,5246,7,194,5447
subtest29of10,pubtest24of100,1,321,5246,10,231,5487
subtest21of10,pubtest24of100,1,321,5246,8,271,5525
subtest22of10,pubtest24of100,1,321,5246,12,309,5567
subtest26of10,pubtest24of100,1,321,5246,13,348,5607
subtest210of10,pubtest24of100,1,321,5246,14,387,5647
subtest21of10,pubtest25of100,1,321,5538,8,47,5593
subtest28of10,pubtest25of100,1,321,5538,8,85,5631
subtest27of10,pubtest25of100,1,321,5538,11,124,5673
subtest26of10,pubtest25of100,1,321,5538,13,164,5715
subtest22of10,pubtest25of100,1,321,5538,13,203,5754
subtest23of10,pubtest25of100,1,321,5538,14,241,5793
subtest29of10,pubtest25of100,1,321,5538,15,280,5833
subtest25of10,pubtest25of100,1,321,5538,13,320,5871
subtest210of10,pubtest25of100,1,321,5538,16,359,5913
subtest24of10,pubtest25of100,1,321,5538,25,390,5953
subtest21of10,pubtest26of100,1,321,5189,2,38,5229
subtest29of10,pubtest26of100,1,321,5189,3,76,5268
subtest22of10,pubtest26of100,1,321,5189,5,115,5309
subtest23of10,pubtest26of100,1,321,5189,11,149,5349
subtest26of10,pubtest26of100,1,321,5189,13,187,5389
subtest27of10,pubtest26of100,1,321,5189,13,227,5429
subtest25of10,pubtest26of100,1,321,5189,20,259,5468
subtest210of10,pubtest26of100,1,321,5189,19,299,5507
subtest28of10,pubtest26of100,1,321,5189,22,338,5549
subtest24of10,pubtest26of100,1,321,5189,25,375,5589
subtest27of10,pubtest27of100,1,320,5176,-1,40,5215
subtest28of10,pubtest27of100,1,320,5176,0,79,5255
subtest23of10,pubtest27of100,1,320,5176,3,116,5295
subtest24of10,pubtest27of100,1,320,5176,6,153,5335
subtest29of10,pubtest27of100,1,320,5176,7,192,5375
subtest25of10,pubtest27of100,1,320,5176,8,232,5416
subtest210of10,pubtest27of100,1,320,5176,11,269,5456
subtest21of10,pubtest27of100,1,320,5176,14,305,5495
subtest22of10,pubtest27of100,1,320,5176,14,345,5535
subtest26of10,pubtest27of100,1,320,5176,15,384,5575
subtest27of10,pubtest28of100,1,321,5209,1,49,5259
subtest21of10,pubtest28of100,1,321,5209,5,83,5297
subtest28of10,pubtest28of100,1,321,5209,7,122,5338
subtest29of10,pubtest28of100,1,321,5209,10,159,5378
subtest23of10,pubtest28of100,1,321,5209,9,200,5418
subtest25of10,pubtest28of100,1,321,5209,13,236,5458
subtest210of10,pubtest28of100,1,321,5209,14,276,5499
subtest26of10,pubtest28of100,1,321,5209,19,309,5537
subtest24of10,pubtest28of100,1,321,5209,21,348,5578
subtest22of10,pubtest28of100,1,321,5209,29,380,5618
subtest23of10,pubtest29of100,1,321,5222,-4,38,5256
subtest210of10,pubtest29of100,1,321,5222,4,70,5296
subtest29of10,pubtest29of100,1,321,5222,4,110,5336
subtest25of10,pubtest29of100,1,321,5222,9,143,5374
subtest21of10,pubtest29of100,1,321,5222,12,182,5416
subtest27of10,pubtest29of100,1,321,5222,12,222,5456
subtest22of10,pubtest29of100,1,321,5222,14,260,5496
subtest28of10,pubtest29of100,1,321,5222,14,300,5536
subtest24of10,pubtest29of100,1,321,5222,15,339,5576
subtest26of10,pubtest29of100,1,321,5222,17,377,5616
subtest29of10,pubtest210of100,1,323,5203,-2,40,5241
subtest21of10,pubtest210of100,1,323,5203,4,74,5281
subtest210of10,pubtest210of100,1,323,5203,7,110,5320
subtest27of10,pubtest210of100,1,323,5203,15,142,5360
subtest28of10,pubtest210of100,1,323,5203,15,181,5399
subtest23of10,pubtest210of100,1,323,5203,16,221,5440
subtest25of10,pubtest210of100,1,323,5203,16,260,5479
subtest24of10,pubtest210of100,1,323,5203,22,295,5520
subtest22of10,pubtest210of100,1,323,5203,23,333,5559
subtest26of10,pubtest210of100,1,323,5203,26,371,5600
subtest210of10,pubtest211of100,1,323,5313,44,39,5396
subtest29of10,pubtest211of100,1,323,5313,46,76,5435
subtest21of10,pubtest211of100,1,323,5313,46,116,5475
subtest24of10,pubtest211of100,1,323,5313,47,155,5515
subtest25of10,pubtest211of100,1,323,5313,54,188,5555
subtest22of10,pubtest211of100,1,323,5313,60,222,5595
subtest23of10,pubtest211of100,1,323,5313,64,258,5635
subtest27of10,pubtest211of100,1,323,5313,66,296,5675
subtest26of10,pubtest211of100,1,323,5313,66,336,5715
subtest28of10,pubtest211of100,1,323,5313,71,371,5755
subtest29of10,pubtest212of100,1,323,5226,5,43,5274
subtest25of10,pubtest212of100,1,323,5226,4,83,5313
subtest28of10,pubtest212of100,1,323,5226,10,116,5352
subtest23of10,pubtest212of100,1,323,5226,14,152,5392
subtest27of10,pubtest212of100,1,323,5226,14,192,5432
subtest21of10,pubtest212of100,1,323,5226,33,213,5472
subtest24of10,pubtest212of100,1,323,5226,33,253,5512
subtest22of10,pubtest212of100,1,323,5226,36,290,5552
subtest26of10,pubtest212of100,1,323,5226,36,330,5592
subtest210of10,pubtest212of100,1,323,5226,38,368,5632
subtest23of10,pubtest213of100,1,322,5179,2,40,5221
subtest26of10,pubtest213of100,1,322,5179,17,65,5261
subtest29of10,pubtest213of100,1,322,5179,18,104,5301
subtest22of10,pubtest213of100,1,322,5179,23,138,5340
subtest27of10,pubtest213of100,1,322,5179,23,178,5380
subtest24of10,pubtest213of100,1,322,5179,26,215,5420
subtest21of10,pubtest213of100,1,322,5179,33,247,5459
subtest210of10,pubtest213of100,1,322,5179,33,287,5499
subtest28of10,pubtest213of100,1,322,5179,35,326,5540
subtest25of10,pubtest213of100,1,322,5179,35,366,5580
subtest21of10,pubtest214of100,1,323,5351,-1,42,5392
subtest23of10,pubtest214of100,1,323,5351,3,75,5429
subtest25of10,pubtest214of100,1,323,5351,8,110,5469
subtest26of10,pubtest214of100,1,323,5351,9,149,5509
subtest29of10,pubtest214of100,1,323,5351,14,185,5550
subtest22of10,pubtest214of100,1,323,5351,15,223,5589
subtest27of10,pubtest214of100,1,323,5351,14,262,5627
subtest24of10,pubtest214of100,1,323,5351,21,296,5668
subtest210of10,pubtest214of100,1,323,5351,21,336,5708
subtest28of10,pubtest214of100,1,323,5351,23,373,5747
subtest27of10,pubtest215of100,1,323,5353,-2,39,5390
subtest24of10,pubtest215of100,1,323,5353,-1,76,5428
subtest29of10,pubtest215of100,1,323,5353,2,114,5469
subtest21of10,pubtest215of100,1,323,5353,7,147,5507
subtest25of10,pubtest215of100,1,323,5353,8,187,5548
subtest26of10,pubtest215of100,1,323,5353,7,226,5586
subtest23of10,pubtest215of100,1,323,5353,17,259,5629
subtest210of10,pubtest215of100,1,323,5353,17,298,5668
subtest22of10,pubtest215of100,1,323,5353,19,338,5710
subtest28of10,pubtest215of100,1,323,5353,20,377,5750
subtest24of10,pubtest216of100,1,323,5239,0,42,5281
subtest21of10,pubtest216of100,1,323,5239,1,81,5321
subtest23of10,pubtest216of100,1,323,5239,3,119,5361
subtest27of10,pubtest216of100,1,323,5239,11,151,5401
subtest28of10,pubtest216of100,1,323,5239,16,186,5441
subtest25of10,pubtest216of100,1,323,5239,17,225,5481
subtest29of10,pubtest216of100,1,323,5239,17,265,5521
subtest22of10,pubtest216of100,1,323,5239,18,304,5561
subtest26of10,pubtest216of100,1,323,5239,20,341,5600
subtest210of10,pubtest216of100,1,323,5239,22,380,5641
subtest27of10,pubtest217of100,1,322,5275,6,45,5326
subtest26of10,pubtest217of100,1,322,5275,10,81,5366
subtest21of10,pubtest217of100,1,322,5275,11,120,5406
subtest22of10,pubtest217of100,1,322,5275,10,160,5445
subtest23of10,pubtest217of100,1,322,5275,17,194,5486
subtest24of10,pubtest217of100,1,322,5275,22,228,5525
subtest29of10,pubtest217of100,1,322,5275,23,269,5567
subtest25of10,pubtest217of100,1,322,5275,28,304,5607
subtest28of10,pubtest217of100,1,322,5275,29,342,5646
subtest210of10,pubtest217of100,1,322,5275,36,375,5686
subtest29of10,pubtest218of100,1,323,5247,18,40,5305
subtest22of10,pubtest218of100,1,323,5247,21,77,5345
subtest21of10,pubtest218of100,1,323,5247,22,116,5385
subtest28of10,pubtest218of100,1,323,5247,21,156,5424
subtest23of10,pubtest218of100,1,323,5247,24,193,5464
subtest27of10,pubtest218of100,1,323,5247,24,233,5504
subtest24of10,pubtest218of100,1,323,5247,27,271,5545
subtest25of10,pubtest218of100,1,323,5247,28,309,5584
subtest26of10,pubtest218of100,1,323,5247,33,344,5624
subtest210of10,pubtest218of100,1,323,5247,33,384,5664
subtest26of10,pubtest219of100,1,323,5291,5,41,5337
subtest25of10,pubtest219of100,1,323,5291,4,80,5375
subtest21of10,pubtest219of100,1,323,5291,7,116,5414
subtest22of10,pubtest219of100,1,323,5291,9,154,5454
subtest28of10,pubtest219of100,1,323,5291,10,193,5494
subtest24of10,pubtest219of100,1,323,5291,10,235,5536
subtest210of10,pubtest219of100,1,323,5291,4,273,5568
subtest23of10,pubtest219of100,1,323,5291,12,311,5614
subtest27of10,pubtest219of100,1,323,5291,12,351,5654
subtest29of10,pubtest219of100,1,323,5291,14,389,5694
subtest25of10,pubtest220of100,1,323,5243,-1,40,5282
subtest210of10,pubtest220of100,1,323,5243,3,76,5322
subtest23of10,pubtest220of100,1,323,5243,3,116,5362
subtest29of10,pubtest220of100,1,323,5243,6,152,5401
subtest24of10,pubtest220of100,1,323,5243,11,187,5441
subtest21of10,pubtest220of100,1,323,5243,13,225,5481
subtest27of10,pubtest220of100,1,323,5243,13,263,5519
subtest26of10,pubtest220of100,1,323,5243,17,301,5561
subtest28of10,pubtest220of100,1,323,5243,17,341,5601
subtest22of10,pubtest220of100,1,323,5243,18,380,5641
subtest24of10,pubtest221of100,1,323,5211,5,41,5257
subtest28of10,pubtest221of100,1,323,5211,10,75,5296
subtest21of10,pubtest221of100,1,323,5211,10,114,5335
subtest23of10,pubtest221of100,1,323,5211,12,152,5375
subtest25of10,pubtest221of100,1,323,5211,12,192,5415
subtest22of10,pubtest221of100,1,323,5211,13,231,5455
subtest210of10,pubtest221of100,1,323,5211,48,237,5496
subtest29of10,pubtest221of100,1,323,5211,48,276,5535
subtest27of10,pubtest221of100,1,323,5211,51,311,5573
subtest26of10,pubtest221of100,1,323,5211,52,351,5614
subtest22of10,pubtest222of100,1,323,5212,9,112,5333
subtest27of10,pubtest222of100,1,323,5212,10,148,5370
subtest29of10,pubtest222of100,1,323,5212,9,187,5408
subtest21of10,pubtest222of100,1,323,5212,3,234,5449
subtest23of10,pubtest222of100,1,323,5212,13,156,5381
subtest28of10,pubtest222of100,1,323,5212,13,195,5420
subtest24of10,pubtest222of100,1,323,5212,123,234,5569
subtest25of10,pubtest222of100,1,323,5212,123,274,5609
subtest210of10,pubtest222of100,1,323,5212,124,314,5650
subtest26of10,pubtest222of100,1,323,5212,124,352,5688
subtest21of10,pubtest223of100,1,323,5303,8,49,5360
subtest23of10,pubtest223of100,1,323,5303,11,85,5399
subtest28of10,pubtest223of100,1,323,5303,13,123,5439
subtest29of10,pubtest223of100,1,323,5303,13,163,5479
subtest24of10,pubtest223of100,1,323,5303,14,202,5519
subtest210of10,pubtest223of100,1,323,5303,14,242,5559
subtest27of10,pubtest223of100,1,323,5303,16,280,5599
subtest22of10,pubtest223of100,1,323,5303,17,319,5639
subtest25of10,pubtest223of100,1,323,5303,17,359,5679
subtest26of10,pubtest223of100,1,323,5303,22,393,5718
subtest21of10,pubtest224of100,1,323,5287,-2,41,5326
subtest28of10,pubtest224of100,1,323,5287,3,75,5365
subtest26of10,pubtest224of100,1,323,5287,9,109,5405
subtest25of10,pubtest224of100,1,323,5287,10,149,5446
subtest29of10,pubtest224of100,1,323,5287,9,188,5484
subtest27of10,pubtest224of100,1,323,5287,7,228,5522
subtest23of10,pubtest224of100,1,323,5287,7,267,5561
subtest22of10,pubtest224of100,1,323,5287,16,302,5605
subtest24of10,pubtest224of100,1,323,5287,19,339,5645
subtest210of10,pubtest224of100,1,323,5287,19,379,5685
subtest27of10,pubtest225of100,1,323,5260,11,416,5687
subtest22of10,pubtest225of100,1,323,5260,11,455,5726
subtest21of10,pubtest225of100,1,323,5260,13,491,5764
subtest24of10,pubtest225of100,1,323,5260,14,531,5805
subtest25of10,pubtest225of100,1,323,5260,13,570,5843
subtest26of10,pubtest225of100,1,323,5260,14,609,5883
subtest29of10,pubtest225of100,1,323,5260,21,642,5923
subtest23of10,pubtest225of100,1,323,5260,21,682,5963
subtest28of10,pubtest225of100,1,323,5260,24,720,6004
subtest210of10,pubtest225of100,1,323,5260,26,759,6045
subtest25of10,pubtest226of100,1,323,5167,2,42,5211
subtest22of10,pubtest226of100,1,323,5167,3,78,5248
subtest210of10,pubtest226of100,1,323,5167,6,117,5290
subtest23of10,pubtest226of100,1,323,5167,12,151,5330
subtest21of10,pubtest226of100,1,323,5167,14,190,5371
subtest27of10,pubtest226of100,1,323,5167,14,229,5410
subtest28of10,pubtest226of100,1,323,5167,15,268,5450
subtest29of10,pubtest226of100,1,323,5167,18,305,5490
subtest26of10,pubtest226of100,1,323,5167,22,341,5530
subtest24of10,pubtest226of100,1,323,5167,22,381,5570
subtest29of10,pubtest227of100,1,323,5253,-1,42,5294
subtest210of10,pubtest227of100,1,323,5253,0,79,5332
subtest25of10,pubtest227of100,1,323,5253,4,115,5372
subtest24of10,pubtest227of100,1,323,5253,4,155,5412
subtest26of10,pubtest227of100,1,323,5253,6,192,5451
subtest22of10,pubtest227of100,1,323,5253,11,229,5493
subtest23of10,pubtest227of100,1,323,5253,14,265,5532
subtest27of10,pubtest227of100,1,323,5253,15,304,5572
subtest21of10,pubtest227of100,1,323,5253,18,341,5612
subtest28of10,pubtest227of100,1,323,5253,18,381,5652
subtest21of10,pubtest228of100,1,323,5168,3,42,5213
subtest25of10,pubtest228of100,1,323,5168,7,77,5252
subtest24of10,pubtest228of100,1,323,5168,8,116,5292
subtest23of10,pubtest228of100,1,323,5168,9,155,5332
subtest26of10,pubtest228of100,1,323,5168,4,195,5367
subtest27of10,pubtest228of100,1,323,5168,11,233,5412
subtest29of10,pubtest228of100,1,323,5168,24,260,5452
subtest22of10,pubtest228of100,1,323,5168,27,299,5494
subtest28of10,pubtest228of100,1,323,5168,28,337,5533
subtest210of10,pubtest228of100,1,323,5168,29,375,5572
subtest24of10,pubtest229of100,1,321,5228,4,40,5272
subtest28of10,pubtest229of100,1,321,5228,10,72,5310
subtest21of10,pubtest229of100,1,321,5228,10,113,5351
subtest22of10,pubtest229of100,1,321,5228,13,150,5391
subtest27of10,pubtest229of100,1,321,5228,13,190,5431
subtest23of10,pubtest229of100,1,321,5228,14,229,5471
subtest210of10,pubtest229of100,1,321,5228,15,267,5510
subtest25of10,pubtest229of100,1,321,5228,16,308,5552
subtest29of10,pubtest229of100,1,321,5228,20,343,5591
subtest26of10,pubtest229of100,1,321,5228,20,383,5631
subtest22of10,pubtest230of100,1,323,5255,2,44,5301
subtest21of10,pubtest230of100,1,323,5255,3,84,5342
subtest27of10,pubtest230of100,1,323,5255,9,117,5381
subtest29of10,pubtest230of100,1,323,5255,14,152,5421
subtest28of10,pubtest230of100,1,323,5255,17,190,5462
subtest25of10,pubtest230of100,1,323,5255,20,226,5501
subtest24of10,pubtest230of100,1,323,5255,34,253,5542
subtest210of10,pubtest230of100,1,323,5255,34,291,5580
subtest23of10,pubtest230of100,1,323,5255,33,332,5620
subtest26of10,pubtest230of100,1,323,5255,36,370,5661
subtest23of10,pubtest231of100,1,323,5220,0,40,5260
subtest28of10,pubtest231of100,1,323,5220,7,72,5299
subtest25of10,pubtest231of100,1,323,5220,10,109,5339
subtest29of10,pubtest231of100,1,323,5220,10,149,5379
subtest24of10,pubtest231of100,1,323,5220,14,185,5419
subtest27of10,pubtest231of100,1,323,5220,14,225,5459
subtest21of10,pubtest231of100,1,323,5220,16,263,5499
subtest210of10,pubtest231of100,1,323,5220,16,302,5538
subtest26of10,pubtest231of100,1,323,5220,19,341,5580
subtest22of10,pubtest231of100,1,323,5220,19,380,5619
subtest21of10,pubtest232of100,1,323,5236,-3,40,5273
subtest22of10,pubtest232of100,1,323,5236,-1,77,5312
subtest27of10,pubtest232of100,1,323,5236,0,115,5351
subtest23of10,pubtest232of100,1,323,5236,4,151,5391
subtest29of10,pubtest232of100,1,323,5236,9,186,5431
subtest28of10,pubtest232of100,1,323,5236,9,226,5471
subtest25of10,pubtest232of100,1,323,5236,10,265,5511
subtest24of10,pubtest232of100,1,323,5236,13,302,5551
subtest26of10,pubtest232of100,1,323,5236,14,341,5591
subtest210of10,pubtest232of100,1,323,5236,15,380,5631
subtest29of10,pubtest233of100,1,323,5249,0,42,5291
subtest24of10,pubtest233of100,1,323,5249,0,81,5330
subtest25of10,pubtest233of100,1,323,5249,3,117,5369
subtest27of10,pubtest233of100,1,323,5249,4,156,5409
subtest210of10,pubtest233of100,1,323,5249,10,190,5449
subtest23of10,pubtest233of100,1,323,5249,16,225,5490
subtest26of10,pubtest233of100,1,323,5249,19,259,5527
subtest21of10,pubtest233of100,1,323,5249,24,296,5569
subtest28of10,pubtest233of100,1,323,5249,25,335,5609
subtest22of10,pubtest233of100,1,323,5249,25,375,5649
subtest26of10,pubtest234of100,1,323,5228,6,41,5275
subtest25of10,pubtest234of100,1,323,5228,5,80,5313
subtest27of10,pubtest234of100,1,323,5228,11,115,5354
subtest22of10,pubtest234of100,1,323,5228,11,153,5392
subtest210of10,pubtest234of100,1,323,5228,14,191,5433
subtest21of10,pubtest234of100,1,323,5228,20,226,5474
subtest29of10,pubtest234of100,1,323,5228,21,265,5514
subtest24of10,pubtest234of100,1,323,5228,22,304,5554
subtest28of10,pubtest234of100,1,323,5228,23,343,5594
subtest23of10,pubtest234of100,1,323,5228,23,383,5634
subtest21of10,pubtest235of100,1,321,5191,3,40,5234
subtest23of10,pubtest235of100,1,321,5191,5,77,5273
subtest210of10,pubtest235of100,1,321,5191,5,117,5313
subtest22of10,pubtest235of100,1,321,5191,14,150,5355
subtest27of10,pubtest235of100,1,321,5191,13,189,5393
subtest24of10,pubtest235of100,1,321,5191,15,227,5433
subtest29of10,pubtest235of100,1,321,5191,16,266,5473
subtest26of10,pubtest235of100,1,321,5191,17,305,5513
subtest25of10,pubtest235of100,1,321,5191,17,345,5553
subtest28of10,pubtest235of100,1,321,5191,29,374,5594
subtest23of10,pubtest236of100,1,323,5359,26,39,5424
subtest210of10,pubtest236of100,1,323,5359,26,79,5464
subtest27of10,pubtest236of100,1,323,5359,28,116,5503
subtest25of10,pubtest236of100,1,323,5359,29,155,5543
subtest21of10,pubtest236of100,1,323,5359,30,193,5582
subtest28of10,pubtest236of100,1,323,5359,30,233,5622
subtest29of10,pubtest236of100,1,323,5359,33,271,5663
subtest24of10,pubtest236of100,1,323,5359,34,311,5704
subtest26of10,pubtest236of100,1,323,5359,45,339,5743
subtest22of10,pubtest236of100,1,323,5359,54,371,5784
subtest24of10,pubtest237of100,1,323,5439,4,41,5484
subtest23of10,pubtest237of100,1,323,5439,9,75,5523
subtest25of10,pubtest237of100,1,323,5439,10,114,5563
subtest27of10,pubtest237of100,1,323,5439,11,153,5603
subtest21of10,pubtest237of100,1,323,5439,16,189,5644
subtest28of10,pubtest237of100,1,323,5439,16,228,5683
subtest29of10,pubtest237of100,1,323,5439,23,261,5723
subtest26of10,pubtest237of100,1,323,5439,23,301,5763
subtest210of10,pubtest237of100,1,323,5439,28,336,5803
subtest22of10,pubtest237of100,1,323,5439,28,376,5843
subtest29of10,pubtest238of100,1,323,5185,2,46,5233
subtest27of10,pubtest238of100,1,323,5185,4,84,5273
subtest28of10,pubtest238of100,1,323,5185,6,123,5314
subtest210of10,pubtest238of100,1,323,5185,7,162,5354
subtest23of10,pubtest238of100,1,323,5185,8,200,5393
subtest21of10,pubtest238of100,1,323,5185,9,238,5432
subtest24of10,pubtest238of100,1,323,5185,10,278,5473
subtest22of10,pubtest238of100,1,323,5185,2,318,5505
subtest25of10,pubtest238of100,1,323,5185,9,357,5551
subtest26of10,pubtest238of100,1,323,5185,10,396,5591
subtest21of10,pubtest239of100,1,323,5471,4,44,5519
subtest28of10,pubtest239of100,1,323,5471,4,85,5560
subtest26of10,pubtest239of100,1,323,5471,6,122,5599
subtest27of10,pubtest239of100,1,323,5471,6,162,5639
subtest24of10,pubtest239of100,1,323,5471,8,200,5679
subtest29of10,pubtest239of100,1,323,5471,55,234,5760
subtest25of10,pubtest239of100,1,323,5471,54,195,5720
subtest23of10,pubtest239of100,1,323,5471,58,270,5799
subtest22of10,pubtest239of100,1,323,5471,56,310,5837
subtest210of10,pubtest239of100,1,323,5471,58,349,5878
subtest25of10,pubtest240of100,1,323,5169,-1,40,5208
subtest21of10,pubtest240of100,1,323,5169,8,70,5247
subtest210of10,pubtest240of100,1,323,5169,8,109,5286
subtest29of10,pubtest240of100,1,323,5169,10,146,5325
subtest27of10,pubtest240of100,1,323,5169,12,185,5366
subtest23of10,pubtest240of100,1,323,5169,12,225,5406
subtest28of10,pubtest240of100,1,323,5169,17,261,5447
subtest24of10,pubtest240of100,1,323,5169,18,300,5487
subtest22of10,pubtest240of100,1,323,5169,18,340,5527
subtest26of10,pubtest240of100,1,323,5169,20,378,5567
subtest27of10,pubtest241of100,1,323,5195,2,40,5237
subtest23of10,pubtest241of100,1,323,5195,2,79,5276
subtest21of10,pubtest241of100,1,323,5195,4,117,5316
subtest25of10,pubtest241of100,1,323,5195,4,159,5358
subtest210of10,pubtest241of100,1,323,5195,5,197,5397
subtest28of10,pubtest241of100,1,323,5195,6,235,5436
subtest26of10,pubtest241of100,1,323,5195,7,274,5476
subtest22of10,pubtest241of100,1,323,5195,7,314,5516
subtest24of10,pubtest241of100,1,323,5195,8,353,5556
subtest29of10,pubtest241of100,1,323,5195,8,393,5596
subtest27of10,pubtest242of100,1,323,5253,3,40,5296
subtest23of10,pubtest242of100,1,323,5253,3,79,5335
subtest26of10,pubtest242of100,1,323,5253,5,117,5375
subtest29of10,pubtest242of100,1,323,5253,8,154,5415
subtest25of10,pubtest242of100,1,323,5253,8,193,5454
subtest210of10,pubtest242of100,1,323,5253,23,219,5495
subtest21of10,pubtest242of100,1,323,5253,23,256,5532
subtest22of10,pubtest242of100,1,323,5253,24,295,5572
subtest24of10,pubtest242of100,1,323,5253,24,336,5613
subtest28of10,pubtest242of100,1,323,5253,28,374,5655
subtest29of10,pubtest243of100,1,323,5198,3,38,5239
subtest28of10,pubtest243of100,1,323,5198,4,76,5278
subtest23of10,pubtest243of100,1,323,5198,7,113,5318
subtest22of10,pubtest243of100,1,323,5198,10,150,5358
subtest25of10,pubtest243of100,1,323,5198,10,190,5398
subtest26of10,pubtest243of100,1,323,5198,12,228,5438
subtest24of10,pubtest243of100,1,323,5198,12,268,5478
subtest27of10,pubtest243of100,1,323,5198,13,307,5518
subtest210of10,pubtest243of100,1,323,5198,14,346,5558
subtest21of10,pubtest243of100,1,323,5198,15,385,5598
subtest26of10,pubtest244of100,1,323,5201,3,40,5244
subtest27of10,pubtest244of100,1,323,5201,4,78,5283
subtest29of10,pubtest244of100,1,323,5201,6,115,5322
subtest21of10,pubtest244of100,1,323,5201,7,154,5362
subtest25of10,pubtest244of100,1,323,5201,6,195,5402
subtest23of10,pubtest244of100,1,323,5201,13,228,5442
subtest28of10,pubtest244of100,1,323,5201,17,264,5482
subtest210of10,pubtest244of100,1,323,5201,20,301,5522
subtest22of10,pubtest244of100,1,323,5201,21,340,5562
subtest24of10,pubtest244of100,1,323,5201,21,380,5602
subtest29of10,pubtest245of100,1,322,5224,1,40,5265
subtest26of10,pubtest245of100,1,322,5224,3,76,5303
subtest23of10,pubtest245of100,1,322,5224,5,115,5344
subtest22of10,pubtest245of100,1,322,5224,6,154,5384
subtest24of10,pubtest245of100,1,322,5224,12,189,5425
subtest25of10,pubtest245of100,1,322,5224,12,228,5464
subtest27of10,pubtest245of100,1,322,5224,20,260,5504
subtest21of10,pubtest245of100,1,322,5224,18,301,5543
subtest28of10,pubtest245of100,1,322,5224,22,338,5584
subtest210of10,pubtest245of100,1,322,5224,30,370,5624
subtest26of10,pubtest246of100,1,323,5215,4,44,5263
subtest27of10,pubtest246of100,1,323,5215,5,82,5302
subtest21of10,pubtest246of100,1,323,5215,7,120,5342
subtest28of10,pubtest246of100,1,323,5215,13,154,5382
subtest29of10,pubtest246of100,1,323,5215,14,193,5422
subtest210of10,pubtest246of100,1,323,5215,15,232,5462
subtest23of10,pubtest246of100,1,323,5215,16,271,5502
subtest24of10,pubtest246of100,1,323,5215,45,281,5541
subtest25of10,pubtest246of100,1,323,5215,45,321,5581
subtest22of10,pubtest246of100,1,323,5215,47,361,5623
subtest27of10,pubtest247of100,1,323,5176,6,45,5227
subtest26of10,pubtest247of100,1,323,5176,8,82,5266
subtest23of10,pubtest247of100,1,323,5176,7,119,5302
subtest22of10,pubtest247of100,1,323,5176,11,158,5345
subtest28of10,pubtest247of100,1,323,5176,12,197,5385
subtest21of10,pubtest247of100,1,323,5176,11,237,5424
subtest29of10,pubtest247of100,1,323,5176,12,276,5464
subtest25of10,pubtest247of100,1,323,5176,17,313,5506
subtest210of10,pubtest247of100,1,323,5176,18,353,5547
subtest24of10,pubtest247of100,1,323,5176,21,389,5586
subtest29of10,pubtest248of100,1,323,5260,-3,39,5296
subtest25of10,pubtest248of100,1,323,5260,1,73,5334
subtest26of10,pubtest248of100,1,323,5260,1,113,5374
subtest27of10,pubtest248of100,1,323,5260,2,151,5413
subtest23of10,pubtest248of100,1,323,5260,3,192,5455
subtest21of10,pubtest248of100,1,323,5260,8,226,5494
subtest28of10,pubtest248of100,1,323,5260,11,263,5534
subtest210of10,pubtest248of100,1,323,5260,16,299,5575
subtest24of10,pubtest248of100,1,323,5260,15,338,5613
subtest22of10,pubtest248of100,1,323,5260,16,377,5653
subtest25of10,pubtest249of100,1,323,5250,7,38,5295
subtest28of10,pubtest249of100,1,323,5250,7,76,5333
subtest27of10,pubtest249of100,1,323,5250,7,116,5373
subtest26of10,pubtest249of100,1,323,5250,12,152,5414
subtest210of10,pubtest249of100,1,323,5250,12,192,5454
subtest23of10,pubtest249of100,1,323,5250,14,231,5495
subtest22of10,pubtest249of100,1,323,5250,12,270,5532
subtest21of10,pubtest249of100,1,323,5250,15,309,5574
subtest24of10,pubtest249of100,1,323,5250,16,350,5616
subtest29of10,pubtest249of100,1,323,5250,13,389,5652
subtest27of10,pubtest250of100,1,323,5228,-2,40,5266
subtest23of10,pubtest250of100,1,323,5228,-1,79,5306
subtest29of10,pubtest250of100,1,323,5228,3,114,5345
subtest28of10,pubtest250of100,1,323,5228,5,152,5385
subtest21of10,pubtest250of100,1,323,5228,6,191,5425
subtest25of10,pubtest250of100,1,323,5228,17,220,5465
subtest24of10,pubtest250of100,1,323,5228,19,258,5505
subtest210of10,pubtest250of100,1,323,5228,23,295,5546
subtest26of10,pubtest250of100,1,323,5228,24,333,5585
subtest22of10,pubtest250of100,1,323,5228,29,368,5625
subtest23of10,pubtest251of100,1,323,5228,2,38,5268
subtest22of10,pubtest251of100,1,323,5228,5,74,5307
subtest27of10,pubtest251of100,1,323,5228,13,106,5347
subtest25of10,pubtest251of100,1,323,5228,16,143,5387
subtest24of10,pubtest251of100,1,323,5228,17,182,5427
subtest28of10,pubtest251of100,1,323,5228,22,215,5465
subtest29of10,pubtest251of100,1,323,5228,21,255,5504
subtest21of10,pubtest251of100,1,323,5228,21,297,5546
subtest26of10,pubtest251of100,1,323,5228,25,334,5587
subtest210of10,pubtest251of100,1,323,5228,26,373,5627
subtest29of10,pubtest252of100,1,323,5298,4,39,5341
subtest28of10,pubtest252of100,1,323,5298,9,73,5380
subtest27of10,pubtest252of100,1,323,5298,15,107,5420
subtest21of10,pubtest252of100,1,323,5298,13,147,5458
subtest26of10,pubtest252of100,1,323,5298,17,185,5500
subtest25of10,pubtest252of100,1,323,5298,17,225,5540
subtest22of10,pubtest252of100,1,323,5298,19,265,5582
subtest23of10,pubtest252of100,1,323,5298,19,303,5620
subtest24of10,pubtest252of100,1,323,5298,20,342,5660
subtest210of10,pubtest252of100,1,323,5298,23,379,5700
subtest28of10,pubtest253of100,1,322,5311,3,40,5354
subtest23of10,pubtest253of100,1,322,5311,4,78,5393
subtest25of10,pubtest253of100,1,322,5311,8,114,5433
subtest24of10,pubtest253of100,1,322,5311,12,150,5473
subtest29of10,pubtest253of100,1,322,5311,15,186,5512
subtest22of10,pubtest253of100,1,322,5311,16,226,5553
subtest27of10,pubtest253of100,1,322,5311,15,265,5591
subtest21of10,pubtest253of100,1,322,5311,17,305,5633
subtest26of10,pubtest253of100,1,322,5311,18,344,5673
subtest210of10,pubtest253of100,1,322,5311,19,382,5712
subtest210of10,pubtest254of100,1,323,5234,0,42,5276
subtest27of10,pubtest254of100,1,323,5234,3,79,5316
subtest28of10,pubtest254of100,1,323,5234,7,114,5355
subtest21of10,pubtest254of100,1,323,5234,11,150,5395
subtest25of10,pubtest254of100,1,323,5234,12,189,5435
subtest24of10,pubtest254of100,1,323,5234,15,225,5474
subtest29of10,pubtest254of100,1,323,5234,17,264,5515
subtest23of10,pubtest254of100,1,323,5234,15,304,5553
subtest26of10,pubtest254of100,1,323,5234,19,342,5595
subtest22of10,pubtest254of100,1,323,5234,19,382,5635
subtest23of10,pubtest255of100,1,322,5328,3,42,5373
subtest22of10,pubtest255of100,1,322,5328,5,79,5412
subtest27of10,pubtest255of100,1,322,5328,11,113,5452
subtest24of10,pubtest255of100,1,322,5328,11,153,5492
subtest210of10,pubtest255of100,1,322,5328,12,192,5532
subtest29of10,pubtest255of100,1,322,5328,13,231,5572
subtest21of10,pubtest255of100,1,322,5328,11,273,5612
subtest28of10,pubtest255of100,1,322,5328,15,310,5653
subtest25of10,pubtest255of100,1,322,5328,27,337,5692
subtest26of10,pubtest255of100,1,322,5328,27,377,5732
subtest29of10,pubtest256of100,1,323,5204,2,38,5244
subtest21of10,pubtest256of100,1,323,5204,10,69,5283
subtest26of10,pubtest256of100,1,323,5204,11,108,5323
subtest23of10,pubtest256of100,1,323,5204,12,147,5363
subtest210of10,pubtest256of100,1,323,5204,13,187,5404
subtest25of10,pubtest256of100,1,323,5204,17,222,5443
subtest27of10,pubtest256of100,1,323,5204,18,261,5483
subtest28of10,pubtest256of100,1,323,5204,19,300,5523
subtest22of10,pubtest256of100,1,323,5204,19,339,5562
subtest24of10,pubtest256of100,1,323,5204,28,370,5602
subtest24of10,pubtest257of100,1,323,5183,0,40,5223
subtest21of10,pubtest257of100,1,323,5183,2,76,5261
subtest27of10,pubtest257of100,1,323,5183,3,115,5301
subtest28of10,pubtest257of100,1,323,5183,4,154,5341
subtest23of10,pubtest257of100,1,323,5183,6,192,5381
subtest22of10,pubtest257of100,1,323,5183,9,227,5419
subtest29of10,pubtest257of100,1,323,5183,12,266,5461
subtest210of10,pubtest257of100,1,323,5183,12,306,5501
subtest25of10,pubtest257of100,1,323,5183,14,345,5542
subtest26of10,pubtest257of100,1,323,5183,14,384,5581
subtest28of10,pubtest258of100,1,323,5278,0,51,5329
subtest25of10,pubtest258of100,1,323,5278,4,86,5368
subtest21of10,pubtest258of100,1,323,5278,6,164,5448
subtest26of10,pubtest258of100,1,323,5278,6,124,5408
subtest29of10,pubtest258of100,1,323,5278,8,202,5488
subtest22of10,pubtest258of100,1,323,5278,8,242,5528
subtest23of10,pubtest258of100,1,323,5278,1,282,5561
subtest27of10,pubtest258of100,1,323,5278,9,321,5608
subtest210of10,pubtest258of100,1,323,5278,10,360,5648
subtest24of10,pubtest258of100,1,323,5278,12,398,5688
subtest21of10,pubtest259of100,1,323,5248,0,42,5290
subtest28of10,pubtest259of100,1,323,5248,1,80,5329
subtest25of10,pubtest259of100,1,323,5248,3,118,5369
subtest24of10,pubtest259of100,1,323,5248,6,155,5409
subtest27of10,pubtest259of100,1,323,5248,10,191,5449
subtest26of10,pubtest259of100,1,323,5248,12,229,5489
subtest23of10,pubtest259of100,1,323,5248,16,265,5529
subtest22of10,pubtest259of100,1,323,5248,17,304,5569
subtest210of10,pubtest259of100,1,323,5248,21,338,5607
subtest29of10,pubtest259of100,1,323,5248,23,378,5649
subtest23of10,pubtest260of100,1,323,5180,2,43,5225
subtest210of10,pubtest260of100,1,323,5180,2,81,5263
subtest21of10,pubtest260of100,1,323,5180,6,117,5303
subtest27of10,pubtest260of100,1,323,5180,12,151,5343
subtest29of10,pubtest260of100,1,323,5180,13,190,5383
subtest28of10,pubtest260of100,1,323,5180,18,226,5424
subtest25of10,pubtest260of100,1,323,5180,15,266,5461
subtest26of10,pubtest260of100,1,323,5180,17,304,5501
subtest22of10,pubtest260of100,1,323,5180,19,344,5543
subtest24of10,pubtest260of100,1,323,5180,21,382,5583
subtest28of10,pubtest261of100,1,323,5170,1,45,5216
subtest25of10,pubtest261of100,1,323,5170,1,84,5255
subtest29of10,pubtest261of100,1,323,5170,4,121,5295
subtest22of10,pubtest261of100,1,323,5170,17,148,5335
subtest23of10,pubtest261of100,1,323,5170,16,187,5373
subtest27of10,pubtest261of100,1,323,5170,18,227,5415
subtest210of10,pubtest261of100,1,323,5170,16,268,5454
subtest21of10,pubtest261of100,1,323,5170,24,301,5495
subtest24of10,pubtest261of100,1,323,5170,25,341,5536
subtest26of10,pubtest261of100,1,323,5170,28,377,5575
subtest21of10,pubtest262of100,1,323,5258,1,42,5301
subtest22of10,pubtest262of100,1,323,5258,3,79,5340
subtest23of10,pubtest262of100,1,323,5258,4,119,5381
subtest27of10,pubtest262of100,1,323,5258,5,157,5420
subtest29of10,pubtest262of100,1,323,5258,6,196,5460
subtest26of10,pubtest262of100,1,323,5258,15,228,5501
subtest25of10,pubtest262of100,1,323,5258,23,259,5540
subtest210of10,pubtest262of100,1,323,5258,25,298,5581
subtest28of10,pubtest262of100,1,323,5258,30,333,5621
subtest24of10,pubtest262of100,1,323,5258,30,372,5660
subtest29of10,pubtest263of100,1,322,5208,2,44,5254
subtest22of10,pubtest263of100,1,322,5208,1,84,5293
subtest24of10,pubtest263of100,1,322,5208,10,115,5333
subtest23of10,pubtest263of100,1,322,5208,11,154,5373
subtest25of10,pubtest263of100,1,322,5208,15,188,5411
subtest28of10,pubtest263of100,1,322,5208,18,227,5453
subtest210of10,pubtest263of100,1,322,5208,18,267,5493
subtest26of10,pubtest263of100,1,322,5208,15,306,5529
subtest21of10,pubtest263of100,1,322,5208,19,346,5573
subtest27of10,pubtest263of100,1,322,5208,20,385,5613
subtest22of10,pubtest264of100,1,322,5170,-1,40,5209
subtest29of10,pubtest264of100,1,322,5170,0,76,5246
subtest24of10,pubtest264of100,1,322,5170,3,115,5288
subtest23of10,pubtest264of100,1,322,5170,5,153,5328
subtest28of10,pubtest264of100,1,322,5170,9,190,5369
subtest27of10,pubtest264of100,1,322,5170,9,228,5407
subtest21of10,pubtest264of100,1,322,5170,10,267,5447
subtest25of10,pubtest264of100,1,322,5170,12,306,5488
subtest26of10,pubtest264of100,1,322,5170,18,341,5529
subtest210of10,pubtest264of100,1,322,5170,18,380,5568
subtest26of10,pubtest265of100,1,323,5291,2,38,5331
subtest27of10,pubtest265of100,1,323,5291,8,71,5370
subtest210of10,pubtest265of100,1,323,5291,8,111,5410
subtest22of10,pubtest265of100,1,323,5291,11,148,5450
subtest21of10,pubtest265of100,1,323,5291,12,187,5490
subtest29of10,pubtest265of100,1,323,5291,13,226,5530
subtest28of10,pubtest265of100,1,323,5291,13,266,5570
subtest25of10,pubtest265of100,1,323,5291,16,303,5610
subtest23of10,pubtest265of100,1,323,5291,17,342,5650
subtest24of10,pubtest265of100,1,323,5291,18,380,5689
subtest29of10,pubtest266of100,1,321,5214,0,42,5256
subtest210of10,pubtest266of100,1,321,5214,2,79,5295
subtest25of10,pubtest266of100,1,321,5214,2,120,5336
subtest27of10,pubtest266of100,1,321,5214,5,157,5376
subtest26of10,pubtest266of100,1,321,5214,6,195,5415
subtest23of10,pubtest266of100,1,321,5214,9,232,5455
subtest21of10,pubtest266of100,1,321,5214,15,266,5495
subtest28of10,pubtest266of100,1,321,5214,15,306,5535
subtest22of10,pubtest266of100,1,321,5214,22,339,5575
subtest24of10,pubtest266of100,1,321,5214,22,379,5615
subtest23of10,pubtest267of100,1,323,5210,3,43,5256
subtest25of10,pubtest267of100,1,323,5210,5,82,5297
subtest26of10,pubtest267of100,1,323,5210,3,121,5334
subtest27of10,pubtest267of100,1,323,5210,12,154,5376
subtest28of10,pubtest267of100,1,323,5210,14,192,5416
subtest29of10,pubtest267of100,1,323,5210,17,229,5456
subtest24of10,pubtest267of100,1,323,5210,18,268,5496
subtest21of10,pubtest267of100,1,323,5210,57,269,5536
subtest22of10,pubtest267of100,1,323,5210,57,311,5578
subtest210of10,pubtest267of100,1,323,5210,59,347,5616
subtest23of10,pubtest268of100,1,323,5186,-2,39,5223
subtest24of10,pubtest268of100,1,323,5186,4,72,5262
subtest25of10,pubtest268of100,1,323,5186,4,112,5302
subtest29of10,pubtest268of100,1,323,5186,13,143,5342
subtest28of10,pubtest268of100,1,323,5186,14,182,5382
subtest27of10,pubtest268of100,1,323,5186,13,221,5420
subtest22of10,pubtest268of100,1,323,5186,16,259,5461
subtest21of10,pubtest268of100,1,323,5186,16,297,5499
subtest210of10,pubtest268of100,1,323,5186,20,336,5542
subtest26of10,pubtest268of100,1,323,5186,24,372,5582
subtest24of10,pubtest269of100,1,323,5375,5,40,5420
subtest27of10,pubtest269of100,1,323,5375,6,79,5460
subtest25of10,pubtest269of100,1,323,5375,8,116,5499
subtest210of10,pubtest269of100,1,323,5375,8,156,5539
subtest26of10,pubtest269of100,1,323,5375,11,193,5579
subtest21of10,pubtest269of100,1,323,5375,23,220,5618
subtest22of10,pubtest269of100,1,323,5375,23,261,5659
subtest28of10,pubtest269of100,1,323,5375,32,292,5699
subtest29of10,pubtest269of100,1,323,5375,37,328,5740
subtest23of10,pubtest269of100,1,323,5375,59,345,5779
subtest23of10,pubtest270of100,1,323,5251,1,41,5293
subtest26of10,pubtest270of100,1,323,5251,3,77,5331
subtest210of10,pubtest270of100,1,323,5251,4,117,5372
subtest27of10,pubtest270of100,1,323,5251,5,156,5412
subtest25of10,pubtest270of100,1,323,5251,7,194,5452
subtest21of10,pubtest270of100,1,323,5251,8,234,5493
subtest29of10,pubtest270of100,1,323,5251,7,275,5533
subtest28of10,pubtest270of100,1,323,5251,12,310,5573
subtest24of10,pubtest270of100,1,323,5251,12,350,5613
subtest22of10,pubtest270of100,1,323,5251,13,388,5652
subtest25of10,pubtest271of100,1,323,5240,9,40,5289
subtest27of10,pubtest271of100,1,323,5240,10,77,5327
subtest24of10,pubtest271of100,1,323,5240,11,116,5367
subtest21of10,pubtest271of100,1,323,5240,11,156,5407
subtest23of10,pubtest271of100,1,323,5240,12,195,5447
subtest29of10,pubtest271of100,1,323,5240,13,234,5487
subtest22of10,pubtest271of100,1,323,5240,14,273,5527
subtest210of10,pubtest271of100,1,323,5240,16,310,5566
subtest28of10,pubtest271of100,1,323,5240,18,349,5607
subtest26of10,pubtest271of100,1,323,5240,16,388,5644
subtest25of10,pubtest272of100,1,323,5293,2,39,5334
subtest26of10,pubtest272of100,1,323,5293,7,74,5374
subtest21of10,pubtest272of100,1,323,5293,7,113,5413
subtest24of10,pubtest272of100,1,323,5293,15,145,5453
subtest23of10,pubtest272of100,1,323,5293,15,185,5493
subtest29of10,pubtest272of100,1,323,5293,12,225,5530
subtest27of10,pubtest272of100,1,323,5293,17,263,5573
subtest22of10,pubtest272of100,1,323,5293,18,302,5613
subtest210of10,pubtest272of100,1,323,5293,17,342,5652
subtest28of10,pubtest272of100,1,323,5293,23,377,5693
subtest22of10,pubtest273of100,1,321,5591,2,43,5636
subtest27of10,pubtest273of100,1,321,5591,4,82,5677
subtest21of10,pubtest273of100,1,321,5591,5,120,5716
subtest28of10,pubtest273of100,1,321,5591,7,160,5758
subtest210of10,pubtest273of100,1,321,5591,8,197,5796
subtest25of10,pubtest273of100,1,321,5591,3,237,5831
subtest23of10,pubtest273of100,1,321,5591,9,276,5876
subtest26of10,pubtest273of100,1,321,5591,3,315,5909
subtest29of10,pubtest273of100,1,321,5591,3,355,5949
subtest24of10,pubtest273of100,1,321,5591,7,394,5992
subtest26of10,pubtest274of100,1,323,5354,2,43,5399
subtest23of10,pubtest274of100,1,323,5354,2,80,5436
subtest29of10,pubtest274of100,1,323,5354,4,119,5477
subtest22of10,pubtest274of100,1,323,5354,5,159,5518
subtest21of10,pubtest274of100,1,323,5354,2,198,5554
subtest25of10,pubtest274of100,1,323,5354,14,229,5597
subtest28of10,pubtest274of100,1,323,5354,16,267,5637
subtest24of10,pubtest274of100,1,323,5354,20,303,5677
subtest210of10,pubtest274of100,1,323,5354,19,343,5716
subtest27of10,pubtest274of100,1,323,5354,17,382,5753
subtest27of10,pubtest275of100,1,323,5213,5,41,5259
subtest29of10,pubtest275of100,1,323,5213,5,80,5298
subtest24of10,pubtest275of100,1,323,5213,12,113,5338
subtest25of10,pubtest275of100,1,323,5213,14,151,5378
subtest22of10,pubtest275of100,1,323,5213,15,191,5419
subtest210of10,pubtest275of100,1,323,5213,16,230,5459
subtest21of10,pubtest275of100,1,323,5213,17,270,5500
subtest23of10,pubtest275of100,1,323,5213,22,306,5541
subtest26of10,pubtest275of100,1,323,5213,27,340,5580
subtest28of10,pubtest275of100,1,323,5213,28,378,5619
subtest28of10,pubtest276of100,1,323,5255,0,41,5296
subtest21of10,pubtest276of100,1,323,5255,2,79,5336
subtest25of10,pubtest276of100,1,323,5255,5,115,5375
subtest27of10,pubtest276of100,1,323,5255,5,154,5414
subtest29of10,pubtest276of100,1,323,5255,7,193,5455
subtest23of10,pubtest276of100,1,323,5255,13,227,5495
subtest24of10,pubtest276of100,1,323,5255,14,265,5534
subtest26of10,pubtest276of100,1,323,5255,15,305,5575
subtest210of10,pubtest276of100,1,323,5255,22,337,5614
subtest22of10,pubtest276of100,1,323,5255,22,377,5654
subtest22of10,pubtest277of100,1,323,5332,-1,42,5373
subtest29of10,pubtest277of100,1,323,5332,2,78,5412
subtest28of10,pubtest277of100,1,323,5332,1,118,5451
subtest21of10,pubtest277of100,1,323,5332,3,157,5492
subtest24of10,pubtest277of100,1,323,5332,5,193,5530
subtest27of10,pubtest277of100,1,323,5332,7,233,5572
subtest210of10,pubtest277of100,1,323,5332,12,268,5612
subtest25of10,pubtest277of100,1,323,5332,12,308,5652
subtest26of10,pubtest277of100,1,323,5332,18,342,5692
subtest23of10,pubtest277of100,1,323,5332,18,382,5732
subtest22of10,pubtest278of100,1,323,5317,2,45,5364
subtest29of10,pubtest278of100,1,323,5317,1,85,5403
subtest23of10,pubtest278of100,1,323,5317,4,122,5443
subtest21of10,pubtest278of100,1,323,5317,6,160,5483
subtest25of10,pubtest278of100,1,323,5317,8,198,5523
subtest27of10,pubtest278of100,1,323,5317,8,238,5563
subtest28of10,pubtest278of100,1,323,5317,10,276,5603
subtest26of10,pubtest278of100,1,323,5317,11,314,5642
subtest24of10,pubtest278of100,1,323,5317,12,354,5683
subtest210of10,pubtest278of100,1,323,5317,14,391,5722
subtest28of10,pubtest279of100,1,323,5277,7,39,5323
subtest25of10,pubtest279of100,1,323,5277,7,77,5361
subtest21of10,pubtest279of100,1,323,5277,9,115,5401
subtest26of10,pubtest279of100,1,323,5277,10,155,5442
subtest27of10,pubtest279of100,1,323,5277,11,194,5482
subtest24of10,pubtest279of100,1,323,5277,9,231,5517
subtest29of10,pubtest279of100,1,323,5277,9,272,5558
subtest23of10,pubtest279of100,1,323,5277,14,309,5600
subtest22of10,pubtest279of100,1,323,5277,15,349,5641
subtest210of10,pubtest279of100,1,323,5277,16,388,5681
subtest27of10,pubtest280of100,1,323,5165,0,38,5203
subtest24of10,pubtest280of100,1,323,5165,1,76,5242
subtest29of10,pubtest280of100,1,323,5165,3,113,5281
subtest26of10,pubtest280of100,1,323,5165,5,152,5322
subtest21of10,pubtest280of100,1,323,5165,2,192,5359
subtest23of10,pubtest280of100,1,323,5165,6,235,5406
subtest25of10,pubtest280of100,1,323,5165,12,270,5447
subtest210of10,pubtest280of100,1,323,5165,13,308,5486
subtest28of10,pubtest280of100,1,323,5165,14,347,5526
subtest22of10,pubtest280of100,1,323,5165,15,386,5566
subtest24of10,pubtest281of100,1,323,5179,0,42,5221
subtest23of10,pubtest281of100,1,323,5179,0,81,5260
subtest28of10,pubtest281of100,1,323,5179,1,120,5300
subtest27of10,pubtest281of100,1,323,5179,3,158,5340
subtest22of10,pubtest281of100,1,323,5179,5,196,5380
subtest25of10,pubtest281of100,1,323,5179,10,231,5420
subtest21of10,pubtest281of100,1,323,5179,11,270,5460
subtest210of10,pubtest281of100,1,323,5179,20,300,5499
subtest29of10,pubtest281of100,1,323,5179,20,340,5539
subtest26of10,pubtest281of100,1,323,5179,22,381,5582
subtest24of10,pubtest282of100,1,323,5306,-1,41,5346
subtest23of10,pubtest282of100,1,323,5306,0,80,5386
subtest25of10,pubtest282of100,1,323,5306,2,117,5425
subtest29of10,pubtest282of100,1,323,5306,3,156,5465
subtest27of10,pubtest282of100,1,323,5306,4,196,5506
subtest21of10,pubtest282of100,1,323,5306,1,235,5542
subtest22of10,pubtest282of100,1,323,5306,9,270,5585
subtest26of10,pubtest282of100,1,323,5306,10,309,5625
subtest28of10,pubtest282of100,1,323,5306,12,347,5665
subtest210of10,pubtest282of100,1,323,5306,11,387,5704
subtest24of10,pubtest283of100,1,323,5243,1,42,5286
subtest27of10,pubtest283of100,1,323,5243,1,81,5325
subtest23of10,pubtest283of100,1,323,5243,3,118,5364
subtest22of10,pubtest283of100,1,323,5243,4,157,5404
subtest28of10,pubtest283of100,1,323,5243,6,195,5444
subtest25of10,pubtest283of100,1,323,5243,9,233,5485
subtest210of10,pubtest283of100,1,323,5243,11,269,5523
subtest21of10,pubtest283of100,1,323,5243,15,306,5564
subtest26of10,pubtest283of100,1,323,5243,16,345,5604
subtest29of10,pubtest283of100,1,323,5243,16,384,5643
subtest25of10,pubtest284of100,1,323,5351,3,38,5392
subtest22of10,pubtest284of100,1,323,5351,3,77,5431
subtest210of10,pubtest284of100,1,323,5351,5,115,5471
subtest29of10,pubtest284of100,1,323,5351,7,152,5510
subtest24of10,pubtest284of100,1,323,5351,10,190,5551
subtest23of10,pubtest284of100,1,323,5351,12,228,5591
subtest27of10,pubtest284of100,1,323,5351,12,268,5631
subtest21of10,pubtest284of100,1,323,5351,18,302,5671
subtest28of10,pubtest284of100,1,323,5351,50,310,5711
subtest26of10,pubtest284of100,1,323,5351,50,350,5751
subtest23of10,pubtest285of100,1,323,5296,2,39,5337
subtest25of10,pubtest285of100,1,323,5296,3,78,5377
subtest24of10,pubtest285of100,1,323,5296,6,114,5416
subtest27of10,pubtest285of100,1,323,5296,8,152,5456
subtest22of10,pubtest285of100,1,323,5296,11,189,5496
subtest21of10,pubtest285of100,1,323,5296,12,228,5536
subtest29of10,pubtest285of100,1,323,5296,14,266,5576
subtest210of10,pubtest285of100,1,323,5296,14,308,5618
subtest28of10,pubtest285of100,1,323,5296,15,345,5656
subtest26of10,pubtest285of100,1,323,5296,15,384,5695
subtest23of10,pubtest286of100,1,323,5216,2,40,5258
subtest25of10,pubtest286of100,1,323,5216,4,77,5297
subtest29of10,pubtest286of100,1,323,5216,7,114,5337
subtest21of10,pubtest286of100,1,323,5216,13,148,5377
subtest27of10,pubtest286of100,1,323,5216,15,186,5417
subtest210of10,pubtest286of100,1,323,5216,16,225,5457
subtest24of10,pubtest286of100,1,323,5216,24,257,5497
subtest26of10,pubtest286of100,1,323,5216,24,296,5536
subtest22of10,pubtest286of100,1,323,5216,30,331,5577
subtest28of10,pubtest286of100,1,323,5216,30,371,5617
subtest26of10,pubtest287of100,1,323,5251,3,42,5296
subtest28of10,pubtest287of100,1,323,5251,5,79,5335
subtest27of10,pubtest287of100,1,323,5251,6,118,5375
subtest29of10,pubtest287of100,1,323,5251,3,157,5411
subtest23of10,pubtest287of100,1,323,5251,14,190,5455
subtest21of10,pubtest287of100,1,323,5251,14,230,5495
subtest210of10,pubtest287of100,1,323,5251,11,269,5531
subtest25of10,pubtest287of100,1,323,5251,11,309,5571
subtest22of10,pubtest287of100,1,323,5251,16,348,5615
subtest24of10,pubtest287of100,1,323,5251,14,389,5654
subtest29of10,pubtest288of100,1,323,5261,5,39,5305
subtest26of10,pubtest288of100,1,323,5261,7,77,5345
subtest27of10,pubtest288of100,1,323,5261,11,112,5384
subtest22of10,pubtest288of100,1,323,5261,11,153,5425
subtest25of10,pubtest288of100,1,323,5261,8,195,5464
subtest21of10,pubtest288of100,1,323,5261,13,231,5505
subtest210of10,pubtest288of100,1,323,5261,20,263,5544
subtest23of10,pubtest288of100,1,323,5261,21,302,5584
subtest24of10,pubtest288of100,1,323,5261,23,340,5624
subtest28of10,pubtest288of100,1,323,5261,23,380,5664
subtest29of10,pubtest289of100,1,323,5280,0,41,5321
subtest210of10,pubtest289of100,1,323,5280,2,80,5362
subtest23of10,pubtest289of100,1,323,5280,7,114,5401
subtest25of10,pubtest289of100,1,323,5280,31,131,5442
subtest24of10,pubtest289of100,1,323,5280,32,169,5481
subtest26of10,pubtest289of100,1,323,5280,34,208,5522
subtest27of10,pubtest289of100,1,323,5280,47,233,5560
subtest22of10,pubtest289of100,1,323,5280,48,273,5601
subtest21of10,pubtest289of100,1,323,5280,47,314,5641
subtest28of10,pubtest289of100,1,323,5280,48,352,5680
subtest29of10,pubtest290of100,1,323,5366,6,44,5416
subtest23of10,pubtest290of100,1,323,5366,6,84,5456
subtest27of10,pubtest290of100,1,323,5366,12,199,5577
subtest22of10,pubtest290of100,1,323,5366,8,122,5496
subtest25of10,pubtest290of100,1,323,5366,10,160,5536
subtest28of10,pubtest290of100,1,323,5366,12,238,5616
subtest26of10,pubtest290of100,1,323,5366,10,274,5650
subtest210of10,pubtest290of100,1,323,5366,13,314,5693
subtest24of10,pubtest290of100,1,323,5366,14,353,5733
subtest21of10,pubtest290of100,1,323,5366,17,393,5776
subtest23of10,pubtest291of100,1,323,5272,5,41,5318
subtest28of10,pubtest291of100,1,323,5272,6,80,5358
subtest27of10,pubtest291of100,1,323,5272,8,119,5399
subtest210of10,pubtest291of100,1,323,5272,9,158,5439
subtest24of10,pubtest291of100,1,323,5272,5,197,5474
subtest21of10,pubtest291of100,1,323,5272,10,235,5517
subtest25of10,pubtest291of100,1,323,5272,12,274,5558
subtest22of10,pubtest291of100,1,323,5272,23,303,5598
subtest29of10,pubtest291of100,1,323,5272,23,343,5638
subtest26of10,pubtest291of100,1,323,5272,25,381,5678
subtest28of10,pubtest292of100,1,323,5419,1,42,5462
subtest29of10,pubtest292of100,1,323,5419,1,81,5501
subtest21of10,pubtest292of100,1,323,5419,3,117,5539
subtest26of10,pubtest292of100,1,323,5419,9,153,5581
subtest27of10,pubtest292of100,1,323,5419,11,192,5622
subtest25of10,pubtest292of100,1,323,5419,10,232,5661
subtest23of10,pubtest292of100,1,323,5419,16,266,5701
subtest22of10,pubtest292of100,1,323,5419,17,305,5741
subtest24of10,pubtest292of100,1,323,5419,17,344,5780
subtest210of10,pubtest292of100,1,323,5419,19,384,5822
subtest25of10,pubtest293of100,1,323,5320,1,40,5361
subtest24of10,pubtest293of100,1,323,5320,2,78,5400
subtest28of10,pubtest293of100,1,323,5320,3,118,5441
subtest23of10,pubtest293of100,1,323,5320,15,145,5480
subtest210of10,pubtest293of100,1,323,5320,15,185,5520
subtest26of10,pubtest293of100,1,323,5320,20,220,5560
subtest27of10,pubtest293of100,1,323,5320,20,260,5600
subtest22of10,pubtest293of100,1,323,5320,22,298,5640
subtest29of10,pubtest293of100,1,323,5320,22,338,5680
subtest21of10,pubtest293of100,1,323,5320,23,376,5719
subtest21of10,pubtest294of100,1,323,5258,1,44,5303
subtest210of10,pubtest294of100,1,323,5258,2,83,5343
subtest25of10,pubtest294of100,1,323,5258,5,119,5382
subtest29of10,pubtest294of100,1,323,5258,7,157,5422
subtest27of10,pubtest294of100,1,323,5258,8,196,5462
subtest26of10,pubtest294of100,1,323,5258,10,234,5502
subtest23of10,pubtest294of100,1,323,5258,14,269,5541
subtest24of10,pubtest294of100,1,323,5258,16,308,5582
subtest22of10,pubtest294of100,1,323,5258,20,344,5622
subtest28of10,pubtest294of100,1,323,5258,20,384,5662
subtest25of10,pubtest295of100,1,323,5260,-1,40,5299
subtest23of10,pubtest295of100,1,323,5260,3,75,5338
subtest24of10,pubtest295of100,1,323,5260,4,114,5378
subtest22of10,pubtest295of100,1,323,5260,10,148,5418
subtest21of10,pubtest295of100,1,323,5260,14,185,5459
subtest29of10,pubtest295of100,1,323,5260,13,224,5497
subtest210of10,pubtest295of100,1,323,5260,13,263,5536
subtest28of10,pubtest295of100,1,323,5260,15,304,5579
subtest27of10,pubtest295of100,1,323,5260,10,342,5612
subtest26of10,pubtest295of100,1,323,5260,17,382,5659
subtest24of10,pubtest296of100,1,322,5169,1,124,5294
subtest25of10,pubtest296of100,1,322,5169,1,164,5334
subtest26of10,pubtest296of100,1,322,5169,5,201,5375
subtest27of10,pubtest296of100,1,322,5169,4,241,5414
subtest23of10,pubtest296of100,1,322,5169,24,262,5455
subtest28of10,pubtest296of100,1,322,5169,26,301,5496
subtest210of10,pubtest296of100,1,322,5169,27,339,5535
subtest22of10,pubtest296of100,1,322,5169,28,378,5575
subtest21of10,pubtest296of100,1,322,5169,26,419,5614
subtest29of10,pubtest296of100,1,322,5169,26,459,5654
subtest25of10,pubtest297of100,1,323,5193,2,47,5242
subtest210of10,pubtest297of100,1,323,5193,4,84,5281
subtest22of10,pubtest297of100,1,323,5193,6,123,5322
subtest26of10,pubtest297of100,1,323,5193,8,159,5360
subtest29of10,pubtest297of100,1,323,5193,9,199,5401
subtest23of10,pubtest297of100,1,323,5193,22,227,5442
subtest28of10,pubtest297of100,1,323,5193,23,265,5481
subtest27of10,pubtest297of100,1,323,5193,24,304,5521
subtest21of10,pubtest297of100,1,323,5193,26,340,5559
subtest24of10,pubtest297of100,1,323,5193,26,380,5599
subtest25of10,pubtest298of100,1,323,5179,7,41,5227
subtest29of10,pubtest298of100,1,323,5179,5,81,5265
subtest22of10,pubtest298of100,1,323,5179,6,121,5306
subtest23of10,pubtest298of100,1,323,5179,7,159,5345
subtest27of10,pubtest298of100,1,323,5179,9,194,5382
subtest24of10,pubtest298of100,1,323,5179,9,233,5421
subtest210of10,pubtest298of100,1,323,5179,10,273,5462
subtest21of10,pubtest298of100,1,323,5179,12,312,5503
subtest28of10,pubtest298of100,1,323,5179,12,351,5542
subtest26of10,pubtest298of100,1,323,5179,16,390,5585
subtest22of10,pubtest299of100,1,323,5280,9,43,5332
subtest210of10,pubtest299of100,1,323,5280,10,80,5370
subtest29of10,pubtest299of100,1,323,5280,10,120,5410
subtest27of10,pubtest299of100,1,323,5280,16,156,5452
subtest24of10,pubtest299of100,1,323,5280,15,196,5491
subtest28of10,pubtest299of100,1,323,5280,19,233,5532
subtest25of10,pubtest299of100,1,323,5280,23,268,5571
subtest23of10,pubtest299of100,1,323,5280,23,307,5610
subtest21of10,pubtest299of100,1,323,5280,25,346,5651
subtest26of10,pubtest299of100,1,323,5280,26,385,5691
subtest21of10,pubtest2100of100,1,325,5231,-2,45,5274
subtest24of10,pubtest2100of100,1,325,5231,-1,83,5313
subtest23of10,pubtest2100of100,1,325,5231,1,122,5354
subtest22of10,pubtest2100of100,1,325,5231,1,161,5393
subtest29of10,pubtest2100of100,1,325,5231,2,200,5433
subtest27of10,pubtest2100of100,1,325,5231,11,231,5473
subtest28of10,pubtest2100of100,1,325,5231,11,271,5513
subtest25of10,pubtest2100of100,1,325,5231,14,308,5553
subtest210of10,pubtest2100of100,1,325,5231,16,344,5591
subtest26of10,pubtest2100of100,1,325,5231,16,384,5631
subtest27of10,pubtest21of100,1,322,10349,2,41,10392
subtest26of10,pubtest21of100,1,322,10349,3,80,10432
subtest24of10,pubtest21of100,1,322,10349,5,118,10472
subtest29of10,pubtest21of100,1,322,10349,5,158,10512
subtest25of10,pubtest21of100,1,322,10349,7,196,10552
subtest21of10,pubtest21of100,1,322,10349,12,231,10592
subtest28of10,pubtest21of100,1,322,10349,15,267,10631
subtest210of10,pubtest21of100,1,322,10349,15,307,10671
subtest22of10,pubtest21of100,1,322,10349,21,342,10712
subtest23of10,pubtest21of100,1,322,10349,22,381,10752
subtest29of10,pubtest22of100,1,321,5177,0,40,5217
subtest24of10,pubtest22of100,1,321,5177,7,72,5256
subtest27of10,pubtest22of100,1,321,5177,7,111,5295
subtest23of10,pubtest22of100,1,321,5177,11,147,5335
subtest25of10,pubtest22of100,1,321,5177,12,187,5376
subtest28of10,pubtest22of100,1,321,5177,12,226,5415
subtest26of10,pubtest22of100,1,321,5177,14,266,5457
subtest21of10,pubtest22of100,1,321,5177,14,305,5496
subtest210of10,pubtest22of100,1,321,5177,19,340,5536
subtest22of10,pubtest22of100,1,321,5177,21,381,5579
subtest29of10,pubtest23of100,1,321,5226,1,41,5268
subtest23of10,pubtest23of100,1,321,5226,0,79,5305
subtest28of10,pubtest23of100,1,321,5226,7,113,5346
subtest27of10,pubtest23of100,1,321,5226,8,154,5388
subtest25of10,pubtest23of100,1,321,5226,11,190,5427
subtest24of10,pubtest23of100,1,321,5226,11,229,5466
subtest21of10,pubtest23of100,1,321,5226,14,266,5506
subtest26of10,pubtest23of100,1,321,5226,21,299,5546
subtest22of10,pubtest23of100,1,321,5226,24,336,5586
subtest210of10,pubtest23of100,1,321,5226,24,376,5626
subtest23of10,pubtest24of100,1,321,5250,-2,39,5287
subtest25of10,pubtest24of100,1,321,5250,7,70,5327
subtest24of10,pubtest24of100,1,321,5250,18,98,5366
subtest21of10,pubtest24of100,1,321,5250,18,138,5406
subtest29of10,pubtest24of100,1,321,5250,23,173,5446
subtest27of10,pubtest24of100,1,321,5250,23,213,5486
subtest28of10,pubtest24of100,1,321,5250,25,252,5527
subtest26of10,pubtest24of100,1,321,5250,29,287,5566
subtest210of10,pubtest24of100,1,321,5250,26,327,5603
subtest22of10,pubtest24of100,1,321,5250,31,365,5646
subtest28of10,pubtest25of100,1,321,5179,0,39,5218
subtest21of10,pubtest25of100,1,321,5179,0,77,5256
subtest210of10,pubtest25of100,1,321,5179,5,112,5296
subtest27of10,pubtest25of100,1,321,5179,7,146,5332
subtest29of10,pubtest25of100,1,321,5179,11,186,5376
subtest22of10,pubtest25of100,1,321,5179,11,226,5416
subtest26of10,pubtest25of100,1,321,5179,10,265,5454
subtest24of10,pubtest25of100,1,321,5179,12,305,5496
subtest25of10,pubtest25of100,1,321,5179,9,344,5532
subtest23of10,pubtest25of100,1,321,5179,13,384,5576
subtest21of10,pubtest26of100,1,321,5639,0,38,5677
subtest29of10,pubtest26of100,1,321,5639,3,74,5716
subtest22of10,pubtest26of100,1,321,5639,4,114,5757
subtest23of10,pubtest26of100,1,321,5639,6,152,5797
subtest27of10,pubtest26of100,1,321,5639,7,190,5836
subtest26of10,pubtest26of100,1,321,5639,7,229,5875
subtest25of10,pubtest26of100,1,321,5639,9,268,5916
subtest210of10,pubtest26of100,1,321,5639,9,307,5955
subtest28of10,pubtest26of100,1,321,5639,10,348,5997
subtest24of10,pubtest26of100,1,321,5639,10,385,6034
subtest28of10,pubtest27of100,1,320,5164,0,40,5204
subtest27of10,pubtest27of100,1,320,5164,1,78,5243
subtest23of10,pubtest27of100,1,320,5164,3,117,5284
subtest24of10,pubtest27of100,1,320,5164,6,153,5323
subtest29of10,pubtest27of100,1,320,5164,7,192,5363
subtest25of10,pubtest27of100,1,320,5164,9,230,5403
subtest21of10,pubtest27of100,1,320,5164,9,271,5444
subtest22of10,pubtest27of100,1,320,5164,12,308,5484
subtest210of10,pubtest27of100,1,320,5164,12,347,5523
subtest26of10,pubtest27of100,1,320,5164,14,386,5564
subtest27of10,pubtest28of100,1,321,5283,-2,45,5326
subtest21of10,pubtest28of100,1,321,5283,3,80,5366
subtest28of10,pubtest28of100,1,321,5283,4,118,5405
subtest29of10,pubtest28of100,1,321,5283,7,155,5445
subtest23of10,pubtest28of100,1,321,5283,5,194,5482
subtest25of10,pubtest28of100,1,321,5283,8,234,5525
subtest210of10,pubtest28of100,1,321,5283,9,274,5566
subtest26of10,pubtest28of100,1,321,5283,10,312,5605
subtest24of10,pubtest28of100,1,321,5283,11,351,5645
subtest22of10,pubtest28of100,1,321,5283,13,391,5687
subtest23of10,pubtest29of100,1,321,5171,0,43,5214
subtest210of10,pubtest29of100,1,321,5171,15,69,5255
subtest29of10,pubtest29of100,1,321,5171,19,104,5294
subtest25of10,pubtest29of100,1,321,5171,20,144,5335
subtest22of10,pubtest29of100,1,321,5171,20,183,5374
subtest28of10,pubtest29of100,1,321,5171,24,219,5414
subtest21of10,pubtest29of100,1,321,5171,25,258,5454
subtest27of10,pubtest29of100,1,321,5171,26,297,5494
subtest26of10,pubtest29of100,1,321,5171,27,336,5534
subtest24of10,pubtest29of100,1,321,5171,28,375,5574
subtest29of10,pubtest210of100,1,323,5246,-1,40,5285
subtest21of10,pubtest210of100,1,323,5246,-1,78,5323
subtest27of10,pubtest210of100,1,323,5246,1,116,5363
subtest23of10,pubtest210of100,1,323,5246,2,155,5403
subtest25of10,pubtest210of100,1,323,5246,3,194,5443
subtest24of10,pubtest210of100,1,323,5246,8,226,5480
subtest210of10,pubtest210of100,1,323,5246,8,266,5520
subtest22of10,pubtest210of100,1,323,5246,12,304,5562
subtest28of10,pubtest210of100,1,323,5246,13,344,5603
subtest26of10,pubtest210of100,1,323,5246,18,379,5643
subtest210of10,pubtest211of100,1,323,5346,1,221,5568
subtest29of10,pubtest211of100,1,323,5346,3,256,5605
subtest24of10,pubtest211of100,1,323,5346,4,294,5644
subtest21of10,pubtest211of100,1,323,5346,29,308,5683
subtest22of10,pubtest211of100,1,323,5346,36,342,5724
subtest25of10,pubtest211of100,1,323,5346,38,380,5764
subtest26of10,pubtest211of100,1,323,5346,41,417,5804
subtest28of10,pubtest211of100,1,323,5346,42,456,5844
subtest27of10,pubtest211of100,1,323,5346,43,498,5887
subtest23of10,pubtest211of100,1,323,5346,41,535,5922
subtest25of10,pubtest212of100,1,323,5292,1,41,5334
subtest29of10,pubtest212of100,1,323,5292,19,63,5374
subtest28of10,pubtest212of100,1,323,5292,21,101,5414
subtest23of10,pubtest212of100,1,323,5292,31,130,5453
subtest27of10,pubtest212of100,1,323,5292,31,170,5493
subtest24of10,pubtest212of100,1,323,5292,33,208,5533
subtest22of10,pubtest212of100,1,323,5292,33,248,5573
subtest21of10,pubtest212of100,1,323,5292,33,286,5611
subtest26of10,pubtest212of100,1,323,5292,34,326,5652
subtest210of10,pubtest212of100,1,323,5292,36,365,5693
subtest23of10,pubtest213of100,1,322,5220,6,39,5265
subtest29of10,pubtest213of100,1,322,5220,13,71,5304
subtest26of10,pubtest213of100,1,322,5220,13,111,5344
subtest27of10,pubtest213of100,1,322,5220,15,149,5384
subtest22of10,pubtest213of100,1,322,5220,15,189,5424
subtest24of10,pubtest213of100,1,322,5220,17,227,5464
subtest21of10,pubtest213of100,1,322,5220,18,266,5504
subtest25of10,pubtest213of100,1,322,5220,21,303,5544
subtest210of10,pubtest213of100,1,322,5220,20,344,5584
subtest28of10,pubtest213of100,1,322,5220,23,381,5624
subtest21of10,pubtest214of100,1,323,5217,3,87,5307
subtest25of10,pubtest214of100,1,323,5217,6,120,5343
subtest23of10,pubtest214of100,1,323,5217,6,160,5383
subtest27of10,pubtest214of100,1,323,5217,11,197,5425
subtest26of10,pubtest214of100,1,323,5217,13,235,5465
subtest29of10,pubtest214of100,1,323,5217,13,275,5505
subtest22of10,pubtest214of100,1,323,5217,15,313,5545
subtest210of10,pubtest214of100,1,323,5217,19,348,5584
subtest24of10,pubtest214of100,1,323,5217,20,390,5627
subtest28of10,pubtest214of100,1,323,5217,21,427,5665
subtest27of10,pubtest215of100,1,323,5234,1,43,5278
subtest24of10,pubtest215of100,1,323,5234,1,82,5317
subtest29of10,pubtest215of100,1,323,5234,3,120,5357
subtest21of10,pubtest215of100,1,323,5234,3,160,5397
subtest26of10,pubtest215of100,1,323,5234,5,198,5437
subtest25of10,pubtest215of100,1,323,5234,8,235,5477
subtest210of10,pubtest215of100,1,323,5234,10,273,5517
subtest23of10,pubtest215of100,1,323,5234,11,312,5557
subtest22of10,pubtest215of100,1,323,5234,12,351,5597
subtest28of10,pubtest215of100,1,323,5234,17,386,5637
subtest24of10,pubtest216of100,1,323,5294,3,43,5340
subtest21of10,pubtest216of100,1,323,5294,4,81,5379
subtest23of10,pubtest216of100,1,323,5294,6,118,5418
subtest27of10,pubtest216of100,1,323,5294,6,158,5458
subtest25of10,pubtest216of100,1,323,5294,7,197,5498
subtest29of10,pubtest216of100,1,323,5294,13,230,5537
subtest28of10,pubtest216of100,1,323,5294,13,270,5577
subtest22of10,pubtest216of100,1,323,5294,15,308,5617
subtest26of10,pubtest216of100,1,323,5294,16,349,5659
subtest210of10,pubtest216of100,1,323,5294,18,386,5698
subtest27of10,pubtest217of100,1,322,5361,1,42,5404
subtest22of10,pubtest217of100,1,322,5361,2,79,5442
subtest21of10,pubtest217of100,1,322,5361,4,116,5481
subtest26of10,pubtest217of100,1,322,5361,9,152,5522
subtest23of10,pubtest217of100,1,322,5361,13,188,5562
subtest29of10,pubtest217of100,1,322,5361,14,227,5602
subtest25of10,pubtest217of100,1,322,5361,15,266,5642
subtest24of10,pubtest217of100,1,322,5361,16,305,5682
subtest28of10,pubtest217of100,1,322,5361,19,341,5721
subtest210of10,pubtest217of100,1,322,5361,19,382,5762
subtest29of10,pubtest218of100,1,323,5425,6,41,5472
subtest22of10,pubtest218of100,1,323,5425,6,80,5511
subtest21of10,pubtest218of100,1,323,5425,11,115,5551
subtest23of10,pubtest218of100,1,323,5425,12,154,5591
subtest28of10,pubtest218of100,1,323,5425,13,193,5631
subtest24of10,pubtest218of100,1,323,5425,15,231,5671
subtest25of10,pubtest218of100,1,323,5425,14,271,5710
subtest27of10,pubtest218of100,1,323,5425,11,311,5747
subtest210of10,pubtest218of100,1,323,5425,16,350,5791
subtest26of10,pubtest218of100,1,323,5425,20,384,5829
subtest25of10,pubtest219of100,1,323,5150,0,38,5188
subtest210of10,pubtest219of100,1,323,5150,0,77,5227
subtest26of10,pubtest219of100,1,323,5150,3,114,5267
subtest21of10,pubtest219of100,1,323,5150,5,153,5308
subtest29of10,pubtest219of100,1,323,5150,9,188,5347
subtest22of10,pubtest219of100,1,323,5150,9,228,5387
subtest23of10,pubtest219of100,1,323,5150,12,264,5426
subtest27of10,pubtest219of100,1,323,5150,13,304,5467
subtest24of10,pubtest219of100,1,323,5150,18,339,5507
subtest28of10,pubtest219of100,1,323,5150,18,379,5547
subtest25of10,pubtest220of100,1,323,5193,0,40,5233
subtest210of10,pubtest220of100,1,323,5193,8,71,5272
subtest29of10,pubtest220of100,1,323,5193,29,90,5312
subtest23of10,pubtest220of100,1,323,5193,28,130,5351
subtest24of10,pubtest220of100,1,323,5193,31,168,5392
subtest21of10,pubtest220of100,1,323,5193,31,207,5431
subtest27of10,pubtest220of100,1,323,5193,34,245,5472
subtest28of10,pubtest220of100,1,323,5193,37,282,5512
subtest22of10,pubtest220of100,1,323,5193,40,319,5552
subtest26of10,pubtest220of100,1,323,5193,39,359,5591
subtest24of10,pubtest221of100,1,323,5324,-3,41,5362
subtest21of10,pubtest221of100,1,323,5324,3,76,5403
subtest23of10,pubtest221of100,1,323,5324,3,115,5442
subtest25of10,pubtest221of100,1,323,5324,8,150,5482
subtest28of10,pubtest221of100,1,323,5324,7,190,5521
subtest22of10,pubtest221of100,1,323,5324,14,225,5563
subtest29of10,pubtest221of100,1,323,5324,14,264,5602
subtest210of10,pubtest221of100,1,323,5324,15,303,5642
subtest27of10,pubtest221of100,1,323,5324,16,342,5682
subtest26of10,pubtest221of100,1,323,5324,19,379,5722
subtest21of10,pubtest222of100,1,323,5231,2,40,5273
subtest22of10,pubtest222of100,1,323,5231,2,79,5312
subtest29of10,pubtest222of100,1,323,5231,6,115,5352
subtest27of10,pubtest222of100,1,323,5231,7,154,5392
subtest23of10,pubtest222of100,1,323,5231,7,194,5432
subtest25of10,pubtest222of100,1,323,5231,11,229,5471
subtest28of10,pubtest222of100,1,323,5231,11,269,5511
subtest26of10,pubtest222of100,1,323,5231,17,304,5552
subtest210of10,pubtest222of100,1,323,5231,17,344,5592
subtest24of10,pubtest222of100,1,323,5231,18,383,5632
subtest21of10,pubtest223of100,1,323,5195,-1,39,5233
subtest28of10,pubtest223of100,1,323,5195,10,66,5271
subtest29of10,pubtest223of100,1,323,5195,19,99,5313
subtest24of10,pubtest223of100,1,323,5195,20,137,5352
subtest210of10,pubtest223of100,1,323,5195,20,177,5392
subtest25of10,pubtest223of100,1,323,5195,22,215,5432
subtest22of10,pubtest223of100,1,323,5195,22,254,5471
subtest27of10,pubtest223of100,1,323,5195,22,294,5511
subtest23of10,pubtest223of100,1,323,5195,19,334,5548
subtest26of10,pubtest223of100,1,323,5195,24,374,5593
subtest21of10,pubtest224of100,1,323,5271,2,46,5319
subtest28of10,pubtest224of100,1,323,5271,2,85,5358
subtest23of10,pubtest224of100,1,323,5271,4,120,5395
subtest29of10,pubtest224of100,1,323,5271,7,159,5437
subtest27of10,pubtest224of100,1,323,5271,4,199,5474
subtest26of10,pubtest224of100,1,323,5271,5,239,5515
subtest25of10,pubtest224of100,1,323,5271,10,277,5558
subtest22of10,pubtest224of100,1,323,5271,11,316,5598
subtest24of10,pubtest224of100,1,323,5271,16,351,5638
subtest210of10,pubtest224of100,1,323,5271,19,386,5676
subtest27of10,pubtest225of100,1,323,5293,7,368,5668
subtest22of10,pubtest225of100,1,323,5293,11,404,5708
subtest21of10,pubtest225of100,1,323,5293,12,442,5747
subtest26of10,pubtest225of100,1,323,5293,16,478,5787
subtest25of10,pubtest225of100,1,323,5293,17,517,5827
subtest24of10,pubtest225of100,1,323,5293,18,554,5865
subtest29of10,pubtest225of100,1,323,5293,21,592,5906
subtest23of10,pubtest225of100,1,323,5293,20,632,5945
subtest28of10,pubtest225of100,1,323,5293,20,671,5984
subtest210of10,pubtest225of100,1,323,5293,25,709,6027
subtest25of10,pubtest226of100,1,323,5304,1,43,5348
subtest22of10,pubtest226of100,1,323,5304,0,82,5386
subtest23of10,pubtest226of100,1,323,5304,4,119,5427
subtest27of10,pubtest226of100,1,323,5304,4,157,5465
subtest210of10,pubtest226of100,1,323,5304,11,194,5509
subtest21of10,pubtest226of100,1,323,5304,12,232,5548
subtest29of10,pubtest226of100,1,323,5304,13,270,5587
subtest28of10,pubtest226of100,1,323,5304,13,310,5627
subtest26of10,pubtest226of100,1,323,5304,16,347,5667
subtest24of10,pubtest226of100,1,323,5304,17,386,5707
subtest29of10,pubtest227of100,1,323,5454,0,44,5498
subtest210of10,pubtest227of100,1,323,5454,2,82,5538
subtest25of10,pubtest227of100,1,323,5454,6,118,5578
subtest24of10,pubtest227of100,1,323,5454,10,154,5618
subtest27of10,pubtest227of100,1,323,5454,11,193,5658
subtest23of10,pubtest227of100,1,323,5454,11,232,5697
subtest21of10,pubtest227of100,1,323,5454,15,269,5738
subtest26of10,pubtest227of100,1,323,5454,16,308,5778
subtest22of10,pubtest227of100,1,323,5454,17,345,5816
subtest28of10,pubtest227of100,1,323,5454,20,384,5858
subtest21of10,pubtest228of100,1,323,5295,9,41,5345
subtest25of10,pubtest228of100,1,323,5295,11,78,5384
subtest26of10,pubtest228of100,1,323,5295,12,117,5424
subtest27of10,pubtest228of100,1,323,5295,13,156,5464
subtest23of10,pubtest228of100,1,323,5295,13,196,5504
subtest29of10,pubtest228of100,1,323,5295,15,232,5542
subtest210of10,pubtest228of100,1,323,5295,17,272,5584
subtest24of10,pubtest228of100,1,323,5295,17,311,5623
subtest22of10,pubtest228of100,1,323,5295,17,350,5662
subtest28of10,pubtest228of100,1,323,5295,17,389,5701
subtest24of10,pubtest229of100,1,321,5212,0,43,5255
subtest21of10,pubtest229of100,1,321,5212,3,78,5293
subtest28of10,pubtest229of100,1,321,5212,4,117,5333
subtest27of10,pubtest229of100,1,321,5212,6,155,5373
subtest23of10,pubtest229of100,1,321,5212,14,187,5413
subtest25of10,pubtest229of100,1,321,5212,16,227,5455
subtest210of10,pubtest229of100,1,321,5212,16,266,5494
subtest29of10,pubtest229of100,1,321,5212,16,304,5532
subtest26of10,pubtest229of100,1,321,5212,17,343,5572
subtest22of10,pubtest229of100,1,321,5212,15,383,5610
subtest21of10,pubtest230of100,1,323,5274,3,41,5318
subtest22of10,pubtest230of100,1,323,5274,3,80,5357
subtest27of10,pubtest230of100,1,323,5274,5,118,5397
subtest28of10,pubtest230of100,1,323,5274,8,155,5437
subtest29of10,pubtest230of100,1,323,5274,10,193,5477
subtest210of10,pubtest230of100,1,323,5274,12,231,5517
subtest25of10,pubtest230of100,1,323,5274,16,267,5557
subtest26of10,pubtest230of100,1,323,5274,21,301,5596
subtest23of10,pubtest230of100,1,323,5274,19,341,5634
subtest24of10,pubtest230of100,1,323,5274,19,380,5673
subtest23of10,pubtest231of100,1,323,5453,1,295,5749
subtest28of10,pubtest231of100,1,323,5453,7,327,5787
subtest24of10,pubtest231of100,1,323,5453,8,367,5828
subtest25of10,pubtest231of100,1,323,5453,7,406,5866
subtest26of10,pubtest231of100,1,323,5453,13,439,5905
subtest22of10,pubtest231of100,1,323,5453,15,479,5947
subtest29of10,pubtest231of100,1,323,5453,14,518,5985
subtest210of10,pubtest231of100,1,323,5453,13,558,6024
subtest27of10,pubtest231of100,1,323,5453,13,597,6063
subtest21of10,pubtest231of100,1,323,5453,17,637,6107
subtest21of10,pubtest232of100,1,323,5184,0,43,5227
subtest22of10,pubtest232of100,1,323,5184,3,78,5265
subtest27of10,pubtest232of100,1,323,5184,6,116,5306
subtest23of10,pubtest232of100,1,323,5184,10,151,5345
subtest29of10,pubtest232of100,1,323,5184,11,192,5387
subtest28of10,pubtest232of100,1,323,5184,12,230,5426
subtest25of10,pubtest232of100,1,323,5184,12,269,5465
subtest210of10,pubtest232of100,1,323,5184,15,307,5506
subtest26of10,pubtest232of100,1,323,5184,15,346,5545
subtest24of10,pubtest232of100,1,323,5184,15,385,5584
subtest29of10,pubtest233of100,1,323,5453,6,38,5497
subtest24of10,pubtest233of100,1,323,5453,13,70,5536
subtest25of10,pubtest233of100,1,323,5453,16,107,5576
subtest27of10,pubtest233of100,1,323,5453,18,145,5616
subtest23of10,pubtest233of100,1,323,5453,19,185,5657
subtest22of10,pubtest233of100,1,323,5453,17,224,5694
subtest26of10,pubtest233of100,1,323,5453,17,263,5733
subtest210of10,pubtest233of100,1,323,5453,16,300,5769
subtest28of10,pubtest233of100,1,323,5453,21,340,5814
subtest21of10,pubtest233of100,1,323,5453,23,379,5855
subtest25of10,pubtest234of100,1,323,5425,4,48,5477
subtest26of10,pubtest234of100,1,323,5425,5,86,5516
subtest27of10,pubtest234of100,1,323,5425,6,125,5556
subtest21of10,pubtest234of100,1,323,5425,8,163,5596
subtest210of10,pubtest234of100,1,323,5425,11,200,5636
subtest29of10,pubtest234of100,1,323,5425,10,239,5674
subtest23of10,pubtest234of100,1,323,5425,13,278,5716
subtest22of10,pubtest234of100,1,323,5425,14,317,5756
subtest24of10,pubtest234of100,1,323,5425,15,356,5796
subtest28of10,pubtest234of100,1,323,5425,16,395,5836
subtest21of10,pubtest235of100,1,321,5256,2,39,5297
subtest210of10,pubtest235of100,1,321,5256,4,77,5337
subtest23of10,pubtest235of100,1,321,5256,5,116,5377
subtest22of10,pubtest235of100,1,321,5256,6,155,5417
subtest27of10,pubtest235of100,1,321,5256,11,190,5457
subtest24of10,pubtest235of100,1,321,5256,11,230,5497
subtest29of10,pubtest235of100,1,321,5256,15,268,5539
subtest25of10,pubtest235of100,1,321,5256,15,307,5578
subtest26of10,pubtest235of100,1,321,5256,17,344,5617
subtest28of10,pubtest235of100,1,321,5256,18,383,5657
subtest23of10,pubtest236of100,1,323,5388,2,44,5434
subtest210of10,pubtest236of100,1,323,5388,2,86,5476
subtest27of10,pubtest236of100,1,323,5388,4,121,5513
subtest28of10,pubtest236of100,1,323,5388,7,158,5553
subtest25of10,pubtest236of100,1,323,5388,7,198,5593
subtest21of10,pubtest236of100,1,323,5388,15,230,5633
subtest29of10,pubtest236of100,1,323,5388,84,198,5670
subtest26of10,pubtest236of100,1,323,5388,88,237,5713
subtest24of10,pubtest236of100,1,323,5388,84,277,5749
subtest22of10,pubtest236of100,1,323,5388,89,316,5793
subtest24of10,pubtest237of100,1,323,5313,0,49,5362
subtest23of10,pubtest237of100,1,323,5313,1,87,5401
subtest25of10,pubtest237of100,1,323,5313,3,126,5442
subtest27of10,pubtest237of100,1,323,5313,8,160,5481
subtest26of10,pubtest237of100,1,323,5313,8,198,5519
subtest21of10,pubtest237of100,1,323,5313,10,238,5561
subtest28of10,pubtest237of100,1,323,5313,5,277,5595
subtest22of10,pubtest237of100,1,323,5313,11,316,5640
subtest210of10,pubtest237of100,1,323,5313,12,356,5681
subtest29of10,pubtest237of100,1,323,5313,14,394,5721
subtest29of10,pubtest238of100,1,323,5190,-2,42,5230
subtest22of10,pubtest238of100,1,323,5190,-2,518,5706
subtest27of10,pubtest238of100,1,323,5190,0,553,5743
subtest28of10,pubtest238of100,1,323,5190,0,593,5783
subtest25of10,pubtest238of100,1,323,5190,2,632,5824
subtest23of10,pubtest238of100,1,323,5190,4,670,5864
subtest26of10,pubtest238of100,1,323,5190,8,706,5904
subtest210of10,pubtest238of100,1,323,5190,8,744,5942
subtest21of10,pubtest238of100,1,323,5190,8,784,5982
subtest24of10,pubtest238of100,1,323,5190,12,822,6024
subtest21of10,pubtest239of100,1,323,5281,0,40,5321
subtest27of10,pubtest239of100,1,323,5281,1,78,5360
subtest28of10,pubtest239of100,1,323,5281,2,117,5400
subtest25of10,pubtest239of100,1,323,5281,13,146,5440
subtest26of10,pubtest239of100,1,323,5281,13,185,5479
subtest29of10,pubtest239of100,1,323,5281,17,221,5519
subtest24of10,pubtest239of100,1,323,5281,17,260,5558
subtest23of10,pubtest239of100,1,323,5281,25,294,5600
subtest210of10,pubtest239of100,1,323,5281,28,331,5640
subtest22of10,pubtest239of100,1,323,5281,28,371,5680
subtest25of10,pubtest240of100,1,323,5476,2,38,5516
subtest210of10,pubtest240of100,1,323,5476,7,71,5554
subtest21of10,pubtest240of100,1,323,5476,7,111,5594
subtest29of10,pubtest240of100,1,323,5476,15,144,5635
subtest28of10,pubtest240of100,1,323,5476,17,184,5677
subtest27of10,pubtest240of100,1,323,5476,16,223,5715
subtest23of10,pubtest240of100,1,323,5476,18,261,5755
subtest24of10,pubtest240of100,1,323,5476,20,299,5795
subtest22of10,pubtest240of100,1,323,5476,21,338,5835
subtest26of10,pubtest240of100,1,323,5476,22,377,5875
subtest23of10,pubtest241of100,1,323,5171,-3,40,5208
subtest27of10,pubtest241of100,1,323,5171,-2,78,5247
subtest24of10,pubtest241of100,1,323,5171,0,116,5287
subtest21of10,pubtest241of100,1,323,5171,0,156,5327
subtest210of10,pubtest241of100,1,323,5171,2,194,5367
subtest28of10,pubtest241of100,1,323,5171,7,229,5407
subtest29of10,pubtest241of100,1,323,5171,6,269,5446
subtest25of10,pubtest241of100,1,323,5171,8,308,5487
subtest26of10,pubtest241of100,1,323,5171,20,336,5527
subtest22of10,pubtest241of100,1,323,5171,20,376,5567
subtest27of10,pubtest242of100,1,323,5190,0,40,5230
subtest23of10,pubtest242of100,1,323,5190,1,77,5268
subtest25of10,pubtest242of100,1,323,5190,2,116,5308
subtest26of10,pubtest242of100,1,323,5190,9,149,5348
subtest21of10,pubtest242of100,1,323,5190,9,189,5388
subtest210of10,pubtest242of100,1,323,5190,11,227,5428
subtest29of10,pubtest242of100,1,323,5190,10,267,5467
subtest22of10,pubtest242of100,1,323,5190,14,304,5508
subtest24of10,pubtest242of100,1,323,5190,19,339,5548
subtest28of10,pubtest242of100,1,323,5190,20,378,5588
subtest29of10,pubtest243of100,1,323,5291,7,40,5338
subtest28of10,pubtest243of100,1,323,5291,8,79,5378
subtest25of10,pubtest243of100,1,323,5291,10,117,5418
subtest22of10,pubtest243of100,1,323,5291,10,156,5457
subtest27of10,pubtest243of100,1,323,5291,12,195,5498
subtest24of10,pubtest243of100,1,323,5291,13,234,5538
subtest23of10,pubtest243of100,1,323,5291,12,274,5577
subtest26of10,pubtest243of100,1,323,5291,14,313,5618
subtest21of10,pubtest243of100,1,323,5291,17,350,5658
subtest210of10,pubtest243of100,1,323,5291,17,390,5698
subtest26of10,pubtest244of100,1,323,5390,3,50,5443
subtest25of10,pubtest244of100,1,323,5390,5,88,5483
subtest27of10,pubtest244of100,1,323,5390,4,126,5520
subtest29of10,pubtest244of100,1,323,5390,10,162,5562
subtest210of10,pubtest244of100,1,323,5390,11,201,5602
subtest28of10,pubtest244of100,1,323,5390,10,242,5642
subtest21of10,pubtest244of100,1,323,5390,13,279,5682
subtest22of10,pubtest244of100,1,323,5390,15,318,5723
subtest24of10,pubtest244of100,1,323,5390,16,356,5762
subtest23of10,pubtest244of100,1,323,5390,14,398,5802
subtest22of10,pubtest245of100,1,322,5337,5,39,5381
subtest29of10,pubtest245of100,1,322,5337,3,80,5420
subtest25of10,pubtest245of100,1,322,5337,7,117,5461
subtest24of10,pubtest245of100,1,322,5337,7,156,5500
subtest26of10,pubtest245of100,1,322,5337,4,196,5537
subtest23of10,pubtest245of100,1,322,5337,5,235,5577
subtest28of10,pubtest245of100,1,322,5337,11,272,5620
subtest21of10,pubtest245of100,1,322,5337,12,311,5660
subtest210of10,pubtest245of100,1,322,5337,15,348,5700
subtest27of10,pubtest245of100,1,322,5337,20,383,5740
subtest26of10,pubtest246of100,1,323,5223,2,39,5264
subtest27of10,pubtest246of100,1,323,5223,5,75,5303
subtest21of10,pubtest246of100,1,323,5223,5,115,5343
subtest29of10,pubtest246of100,1,323,5223,7,150,5380
subtest25of10,pubtest246of100,1,323,5223,9,189,5421
subtest28of10,pubtest246of100,1,323,5223,10,229,5462
subtest23of10,pubtest246of100,1,323,5223,9,268,5500
subtest210of10,pubtest246of100,1,323,5223,9,308,5540
subtest24of10,pubtest246of100,1,323,5223,14,346,5583
subtest22of10,pubtest246of100,1,323,5223,14,386,5623
subtest27of10,pubtest247of100,1,323,5211,3,38,5252
subtest26of10,pubtest247of100,1,323,5211,3,78,5292
subtest23of10,pubtest247of100,1,323,5211,5,115,5331
subtest28of10,pubtest247of100,1,323,5211,5,154,5370
subtest22of10,pubtest247of100,1,323,5211,5,194,5410
subtest21of10,pubtest247of100,1,323,5211,44,196,5451
subtest29of10,pubtest247of100,1,323,5211,45,235,5491
subtest24of10,pubtest247of100,1,323,5211,45,273,5529
subtest210of10,pubtest247of100,1,323,5211,44,313,5568
subtest25of10,pubtest247of100,1,323,5211,49,351,5611
subtest29of10,pubtest248of100,1,323,5237,-2,43,5278
subtest25of10,pubtest248of100,1,323,5237,1,78,5316
subtest23of10,pubtest248of100,1,323,5237,2,117,5356
subtest26of10,pubtest248of100,1,323,5237,5,153,5395
subtest28of10,pubtest248of100,1,323,5237,8,191,5436
subtest24of10,pubtest248of100,1,323,5237,12,227,5476
subtest21of10,pubtest248of100,1,323,5237,13,267,5517
subtest27of10,pubtest248of100,1,323,5237,12,306,5555
subtest22of10,pubtest248of100,1,323,5237,14,347,5598
subtest210of10,pubtest248of100,1,323,5237,19,380,5636
subtest27of10,pubtest249of100,1,323,5619,2,42,5663
subtest28of10,pubtest249of100,1,323,5619,3,79,5701
subtest25of10,pubtest249of100,1,323,5619,4,119,5742
subtest24of10,pubtest249of100,1,323,5619,6,157,5782
subtest26of10,pubtest249of100,1,323,5619,13,190,5822
subtest21of10,pubtest249of100,1,323,5619,13,230,5862
subtest22of10,pubtest249of100,1,323,5619,16,267,5902
subtest23of10,pubtest249of100,1,323,5619,16,304,5939
subtest210of10,pubtest249of100,1,323,5619,17,343,5979
subtest29of10,pubtest249of100,1,323,5619,16,383,6018
subtest27of10,pubtest250of100,1,323,5206,-1,43,5248
subtest28of10,pubtest250of100,1,323,5206,1,78,5285
subtest23of10,pubtest250of100,1,323,5206,2,117,5325
subtest21of10,pubtest250of100,1,323,5206,7,152,5365
subtest29of10,pubtest250of100,1,323,5206,5,191,5402
subtest24of10,pubtest250of100,1,323,5206,10,229,5445
subtest210of10,pubtest250of100,1,323,5206,12,266,5484
subtest26of10,pubtest250of100,1,323,5206,13,306,5525
subtest25of10,pubtest250of100,1,323,5206,11,345,5562
subtest22of10,pubtest250of100,1,323,5206,14,385,5605
subtest22of10,pubtest251of100,1,323,5299,2,39,5340
subtest23of10,pubtest251of100,1,323,5299,2,79,5380
subtest24of10,pubtest251of100,1,323,5299,6,114,5419
subtest27of10,pubtest251of100,1,323,5299,15,146,5460
subtest25of10,pubtest251of100,1,323,5299,17,183,5499
subtest21of10,pubtest251of100,1,323,5299,18,222,5539
subtest28of10,pubtest251of100,1,323,5299,18,263,5580
subtest210of10,pubtest251of100,1,323,5299,44,274,5617
subtest26of10,pubtest251of100,1,323,5299,48,312,5659
subtest29of10,pubtest251of100,1,323,5299,47,352,5698
subtest28of10,pubtest252of100,1,323,5274,3,39,5316
subtest29of10,pubtest252of100,1,323,5274,4,78,5356
subtest21of10,pubtest252of100,1,323,5274,5,114,5393
subtest27of10,pubtest252of100,1,323,5274,6,154,5434
subtest26of10,pubtest252of100,1,323,5274,8,193,5475
subtest23of10,pubtest252of100,1,323,5274,10,232,5516
subtest25of10,pubtest252of100,1,323,5274,9,272,5555
subtest22of10,pubtest252of100,1,323,5274,14,309,5597
subtest24of10,pubtest252of100,1,323,5274,14,348,5636
subtest210of10,pubtest252of100,1,323,5274,19,382,5675
subtest28of10,pubtest253of100,1,322,5363,-1,39,5401
subtest23of10,pubtest253of100,1,322,5363,8,70,5441
subtest24of10,pubtest253of100,1,322,5363,9,108,5480
subtest25of10,pubtest253of100,1,322,5363,11,146,5520
subtest22of10,pubtest253of100,1,322,5363,11,186,5560
subtest210of10,pubtest253of100,1,322,5363,13,224,5600
subtest27of10,pubtest253of100,1,322,5363,13,264,5640
subtest26of10,pubtest253of100,1,322,5363,16,300,5679
subtest21of10,pubtest253of100,1,322,5363,16,340,5719
subtest29of10,pubtest253of100,1,322,5363,14,378,5755
subtest210of10,pubtest254of100,1,323,5324,2,44,5370
subtest27of10,pubtest254of100,1,323,5324,2,85,5411
subtest23of10,pubtest254of100,1,323,5324,7,119,5450
subtest25of10,pubtest254of100,1,323,5324,7,158,5489
subtest28of10,pubtest254of100,1,323,5324,9,195,5528
subtest21of10,pubtest254of100,1,323,5324,9,234,5567
subtest24of10,pubtest254of100,1,323,5324,16,269,5609
subtest29of10,pubtest254of100,1,323,5324,56,269,5649
subtest22of10,pubtest254of100,1,323,5324,56,309,5689
subtest26of10,pubtest254of100,1,323,5324,57,348,5729
subtest23of10,pubtest255of100,1,322,5324,-1,40,5363
subtest22of10,pubtest255of100,1,322,5324,-1,79,5402
subtest28of10,pubtest255of100,1,322,5324,1,118,5443
subtest27of10,pubtest255of100,1,322,5324,9,149,5482
subtest21of10,pubtest255of100,1,322,5324,10,185,5519
subtest26of10,pubtest255of100,1,322,5324,13,225,5562
subtest29of10,pubtest255of100,1,322,5324,9,265,5598
subtest210of10,pubtest255of100,1,322,5324,13,305,5642
subtest24of10,pubtest255of100,1,322,5324,11,343,5678
subtest25of10,pubtest255of100,1,322,5324,13,383,5720
subtest29of10,pubtest256of100,1,323,5288,0,40,5328
subtest21of10,pubtest256of100,1,323,5288,3,77,5368
subtest26of10,pubtest256of100,1,323,5288,7,113,5408
subtest23of10,pubtest256of100,1,323,5288,33,127,5448
subtest28of10,pubtest256of100,1,323,5288,35,165,5488
subtest210of10,pubtest256of100,1,323,5288,35,205,5528
subtest27of10,pubtest256of100,1,323,5288,37,243,5568
subtest25of10,pubtest256of100,1,323,5288,37,284,5609
subtest22of10,pubtest256of100,1,323,5288,39,321,5648
subtest24of10,pubtest256of100,1,323,5288,40,358,5686
subtest21of10,pubtest257of100,1,323,5353,1,38,5392
subtest24of10,pubtest257of100,1,323,5353,4,74,5431
subtest27of10,pubtest257of100,1,323,5353,6,112,5471
subtest23of10,pubtest257of100,1,323,5353,17,139,5509
subtest29of10,pubtest257of100,1,323,5353,18,178,5549
subtest28of10,pubtest257of100,1,323,5353,21,217,5591
subtest25of10,pubtest257of100,1,323,5353,21,258,5632
subtest22of10,pubtest257of100,1,323,5353,22,296,5671
subtest210of10,pubtest257of100,1,323,5353,26,333,5712
subtest26of10,pubtest257of100,1,323,5353,27,372,5752
subtest28of10,pubtest258of100,1,323,5212,0,42,5254
subtest23of10,pubtest258of100,1,323,5212,1,81,5294
subtest25of10,pubtest258of100,1,323,5212,5,116,5333
subtest21of10,pubtest258of100,1,323,5212,5,157,5374
subtest29of10,pubtest258of100,1,323,5212,9,192,5413
subtest27of10,pubtest258of100,1,323,5212,14,227,5453
subtest26of10,pubtest258of100,1,323,5212,14,267,5493
subtest210of10,pubtest258of100,1,323,5212,16,303,5531
subtest22of10,pubtest258of100,1,323,5212,19,342,5573
subtest24of10,pubtest258of100,1,323,5212,27,374,5613
subtest21of10,pubtest259of100,1,323,5210,-1,39,5248
subtest28of10,pubtest259of100,1,323,5210,2,72,5284
subtest25of10,pubtest259of100,1,323,5210,2,116,5328
subtest24of10,pubtest259of100,1,323,5210,8,150,5368
subtest27of10,pubtest259of100,1,323,5210,12,185,5407
subtest26of10,pubtest259of100,1,323,5210,12,224,5446
subtest23of10,pubtest259of100,1,323,5210,14,263,5487
subtest29of10,pubtest259of100,1,323,5210,14,302,5526
subtest22of10,pubtest259of100,1,323,5210,15,342,5567
subtest210of10,pubtest259of100,1,323,5210,16,381,5607
subtest23of10,pubtest260of100,1,323,5212,1,40,5253
subtest210of10,pubtest260of100,1,323,5212,1,80,5293
subtest21of10,pubtest260of100,1,323,5212,10,111,5333
subtest26of10,pubtest260of100,1,323,5212,10,150,5372
subtest29of10,pubtest260of100,1,323,5212,12,188,5412
subtest27of10,pubtest260of100,1,323,5212,12,227,5451
subtest22of10,pubtest260of100,1,323,5212,13,265,5490
subtest25of10,pubtest260of100,1,323,5212,18,302,5532
subtest28of10,pubtest260of100,1,323,5212,19,341,5572
subtest24of10,pubtest260of100,1,323,5212,20,382,5614
subtest25of10,pubtest261of100,1,323,5223,8,43,5274
subtest28of10,pubtest261of100,1,323,5223,10,81,5314
subtest29of10,pubtest261of100,1,323,5223,11,120,5354
subtest23of10,pubtest261of100,1,323,5223,12,159,5394
subtest210of10,pubtest261of100,1,323,5223,14,197,5434
subtest27of10,pubtest261of100,1,323,5223,18,233,5474
subtest22of10,pubtest261of100,1,323,5223,19,272,5514
subtest21of10,pubtest261of100,1,323,5223,24,307,5554
subtest24of10,pubtest261of100,1,323,5223,24,347,5594
subtest26of10,pubtest261of100,1,323,5223,28,383,5634
subtest22of10,pubtest262of100,1,323,5314,-1,39,5352
subtest21of10,pubtest262of100,1,323,5314,1,76,5391
subtest26of10,pubtest262of100,1,323,5314,7,112,5433
subtest27of10,pubtest262of100,1,323,5314,7,151,5472
subtest23of10,pubtest262of100,1,323,5314,5,189,5508
subtest29of10,pubtest262of100,1,323,5314,11,226,5551
subtest25of10,pubtest262of100,1,323,5314,15,262,5591
subtest210of10,pubtest262of100,1,323,5314,16,301,5631
subtest24of10,pubtest262of100,1,323,5314,17,340,5671
subtest28of10,pubtest262of100,1,323,5314,24,373,5711
subtest22of10,pubtest263of100,1,322,5220,7,44,5271
subtest29of10,pubtest263of100,1,322,5220,8,82,5310
subtest23of10,pubtest263of100,1,322,5220,10,119,5349
subtest24of10,pubtest263of100,1,322,5220,11,158,5389
subtest26of10,pubtest263of100,1,322,5220,30,180,5430
subtest210of10,pubtest263of100,1,322,5220,31,215,5466
subtest28of10,pubtest263of100,1,322,5220,34,254,5508
subtest25of10,pubtest263of100,1,322,5220,31,294,5545
subtest27of10,pubtest263of100,1,322,5220,34,333,5587
subtest21of10,pubtest263of100,1,322,5220,34,373,5627
subtest22of10,pubtest264of100,1,322,5190,-3,318,5505
subtest29of10,pubtest264of100,1,322,5190,-2,356,5544
subtest23of10,pubtest264of100,1,322,5190,0,393,5583
subtest27of10,pubtest264of100,1,322,5190,0,433,5623
subtest24of10,pubtest264of100,1,322,5190,2,471,5663
subtest28of10,pubtest264of100,1,322,5190,6,507,5703
subtest21of10,pubtest264of100,1,322,5190,7,546,5743
subtest25of10,pubtest264of100,1,322,5190,15,578,5783
subtest26of10,pubtest264of100,1,322,5190,18,613,5821
subtest210of10,pubtest264of100,1,322,5190,22,651,5863
subtest26of10,pubtest265of100,1,323,5200,1,40,5241
subtest27of10,pubtest265of100,1,323,5200,4,76,5280
subtest210of10,pubtest265of100,1,323,5200,6,113,5319
subtest21of10,pubtest265of100,1,323,5200,8,154,5362
subtest28of10,pubtest265of100,1,323,5200,9,192,5401
subtest22of10,pubtest265of100,1,323,5200,10,231,5441
subtest29of10,pubtest265of100,1,323,5200,11,269,5480
subtest25of10,pubtest265of100,1,323,5200,14,306,5520
subtest23of10,pubtest265of100,1,323,5200,15,345,5560
subtest24of10,pubtest265of100,1,323,5200,17,384,5601
subtest29of10,pubtest266of100,1,321,5445,0,38,5483
subtest210of10,pubtest266of100,1,321,5445,4,73,5522
subtest25of10,pubtest266of100,1,321,5445,5,112,5562
subtest27of10,pubtest266of100,1,321,5445,7,150,5602
subtest26of10,pubtest266of100,1,321,5445,9,188,5642
subtest23of10,pubtest266of100,1,321,5445,16,222,5683
subtest28of10,pubtest266of100,1,321,5445,17,262,5724
subtest21of10,pubtest266of100,1,321,5445,17,301,5763
subtest24of10,pubtest266of100,1,321,5445,19,338,5802
subtest22of10,pubtest266of100,1,321,5445,32,365,5842
subtest26of10,pubtest267of100,1,323,5257,56,40,5353
subtest23of10,pubtest267of100,1,323,5257,57,78,5392
subtest25of10,pubtest267of100,1,323,5257,58,117,5432
subtest29of10,pubtest267of100,1,323,5257,59,156,5472
subtest28of10,pubtest267of100,1,323,5257,60,195,5512
subtest24of10,pubtest267of100,1,323,5257,60,235,5552
subtest210of10,pubtest267of100,1,323,5257,64,271,5592
subtest21of10,pubtest267of100,1,323,5257,64,310,5631
subtest22of10,pubtest267of100,1,323,5257,64,349,5670
subtest27of10,pubtest267of100,1,323,5257,62,389,5708
subtest23of10,pubtest268of100,1,323,5429,-1,49,5477
subtest24of10,pubtest268of100,1,323,5429,2,88,5519
subtest25of10,pubtest268of100,1,323,5429,9,120,5558
subtest29of10,pubtest268of100,1,323,5429,12,157,5598
subtest27of10,pubtest268of100,1,323,5429,12,197,5638
subtest28of10,pubtest268of100,1,323,5429,14,235,5678
subtest21of10,pubtest268of100,1,323,5429,14,272,5715
subtest210of10,pubtest268of100,1,323,5429,16,312,5757
subtest22of10,pubtest268of100,1,323,5429,15,350,5794
subtest26of10,pubtest268of100,1,323,5429,16,389,5834
subtest24of10,pubtest269of100,1,323,5257,3,40,5300
subtest210of10,pubtest269of100,1,323,5257,4,80,5341
subtest27of10,pubtest269of100,1,323,5257,7,116,5380
subtest26of10,pubtest269of100,1,323,5257,12,151,5420
subtest25of10,pubtest269of100,1,323,5257,13,189,5459
subtest22of10,pubtest269of100,1,323,5257,15,228,5500
subtest21of10,pubtest269of100,1,323,5257,14,269,5540
subtest29of10,pubtest269of100,1,323,5257,16,306,5579
subtest28of10,pubtest269of100,1,323,5257,17,348,5622
subtest23of10,pubtest269of100,1,323,5257,18,385,5660
subtest23of10,pubtest270of100,1,323,5227,2,383,5612
subtest27of10,pubtest270of100,1,323,5227,7,417,5651
subtest26of10,pubtest270of100,1,323,5227,10,454,5691
subtest210of10,pubtest270of100,1,323,5227,16,488,5731
subtest28of10,pubtest270of100,1,323,5227,19,525,5771
subtest25of10,pubtest270of100,1,323,5227,22,562,5811
subtest29of10,pubtest270of100,1,323,5227,22,602,5851
subtest24of10,pubtest270of100,1,323,5227,33,631,5891
subtest21of10,pubtest270of100,1,323,5227,34,668,5929
subtest22of10,pubtest270of100,1,323,5227,36,707,5970
subtest24of10,pubtest271of100,1,323,5249,33,39,5321
subtest25of10,pubtest271of100,1,323,5249,39,71,5359
subtest22of10,pubtest271of100,1,323,5249,39,110,5398
subtest210of10,pubtest271of100,1,323,5249,40,148,5437
subtest27of10,pubtest271of100,1,323,5249,43,187,5479
subtest21of10,pubtest271of100,1,323,5249,43,227,5519
subtest26of10,pubtest271of100,1,323,5249,45,265,5559
subtest23of10,pubtest271of100,1,323,5249,45,305,5599
subtest28of10,pubtest271of100,1,323,5249,46,344,5639
subtest29of10,pubtest271of100,1,323,5249,47,383,5679
subtest25of10,pubtest272of100,1,323,5442,5,42,5489
subtest21of10,pubtest272of100,1,323,5442,7,80,5529
subtest26of10,pubtest272of100,1,323,5442,8,118,5568
subtest29of10,pubtest272of100,1,323,5442,9,156,5607
subtest23of10,pubtest272of100,1,323,5442,9,196,5647
subtest24of10,pubtest272of100,1,323,5442,11,235,5688
subtest22of10,pubtest272of100,1,323,5442,12,274,5728
subtest27of10,pubtest272of100,1,323,5442,13,313,5768
subtest210of10,pubtest272of100,1,323,5442,13,353,5808
subtest28of10,pubtest272of100,1,323,5442,20,386,5848
subtest22of10,pubtest273of100,1,321,5236,0,40,5276
subtest29of10,pubtest273of100,1,321,5236,3,76,5315
subtest26of10,pubtest273of100,1,321,5236,4,115,5355
subtest28of10,pubtest273of100,1,321,5236,11,148,5395
subtest27of10,pubtest273of100,1,321,5236,19,180,5435
subtest21of10,pubtest273of100,1,321,5236,19,221,5476
subtest23of10,pubtest273of100,1,321,5236,20,259,5515
subtest25of10,pubtest273of100,1,321,5236,19,298,5553
subtest24of10,pubtest273of100,1,321,5236,21,337,5594
subtest210of10,pubtest273of100,1,321,5236,21,377,5634
subtest21of10,pubtest274of100,1,323,5636,1,44,5681
subtest23of10,pubtest274of100,1,323,5636,1,80,5717
subtest26of10,pubtest274of100,1,323,5636,3,118,5757
subtest29of10,pubtest274of100,1,323,5636,2,159,5797
subtest25of10,pubtest274of100,1,323,5636,4,197,5837
subtest22of10,pubtest274of100,1,323,5636,5,236,5877
subtest27of10,pubtest274of100,1,323,5636,9,271,5916
subtest28of10,pubtest274of100,1,323,5636,10,311,5957
subtest24of10,pubtest274of100,1,323,5636,13,348,5997
subtest210of10,pubtest274of100,1,323,5636,16,385,6037
subtest27of10,pubtest275of100,1,323,5252,2,39,5293
subtest29of10,pubtest275of100,1,323,5252,3,77,5332
subtest24of10,pubtest275of100,1,323,5252,8,112,5372
subtest22of10,pubtest275of100,1,323,5252,9,150,5411
subtest25of10,pubtest275of100,1,323,5252,11,189,5452
subtest21of10,pubtest275of100,1,323,5252,15,225,5492
subtest23of10,pubtest275of100,1,323,5252,15,267,5534
subtest210of10,pubtest275of100,1,323,5252,16,305,5573
subtest26of10,pubtest275of100,1,323,5252,19,340,5611
subtest28of10,pubtest275of100,1,323,5252,20,380,5652
subtest28of10,pubtest276of100,1,323,5284,3,40,5327
subtest21of10,pubtest276of100,1,323,5284,4,78,5366
subtest25of10,pubtest276of100,1,323,5284,10,112,5406
subtest27of10,pubtest276of100,1,323,5284,12,150,5446
subtest29of10,pubtest276of100,1,323,5284,12,190,5486
subtest24of10,pubtest276of100,1,323,5284,16,226,5526
subtest23of10,pubtest276of100,1,323,5284,16,266,5566
subtest210of10,pubtest276of100,1,323,5284,19,301,5604
subtest26of10,pubtest276of100,1,323,5284,21,341,5646
subtest22of10,pubtest276of100,1,323,5284,22,380,5686
subtest22of10,pubtest277of100,1,323,5218,28,48,5294
subtest29of10,pubtest277of100,1,323,5218,28,87,5333
subtest24of10,pubtest277of100,1,323,5218,34,122,5374
subtest26of10,pubtest277of100,1,323,5218,36,159,5413
subtest28of10,pubtest277of100,1,323,5218,36,199,5453
subtest210of10,pubtest277of100,1,323,5218,37,238,5493
subtest23of10,pubtest277of100,1,323,5218,38,277,5533
subtest25of10,pubtest277of100,1,323,5218,39,316,5573
subtest27of10,pubtest277of100,1,323,5218,39,356,5613
subtest21of10,pubtest277of100,1,323,5218,30,395,5643
subtest22of10,pubtest278of100,1,323,5229,10,44,5283
subtest29of10,pubtest278of100,1,323,5229,11,82,5322
subtest23of10,pubtest278of100,1,323,5229,18,115,5362
subtest21of10,pubtest278of100,1,323,5229,18,155,5402
subtest27of10,pubtest278of100,1,323,5229,19,193,5441
subtest25of10,pubtest278of100,1,323,5229,20,233,5482
subtest28of10,pubtest278of100,1,323,5229,19,272,5520
subtest26of10,pubtest278of100,1,323,5229,24,309,5562
subtest210of10,pubtest278of100,1,323,5229,24,349,5602
subtest24of10,pubtest278of100,1,323,5229,25,387,5641
subtest28of10,pubtest279of100,1,323,5257,-1,231,5487
subtest25of10,pubtest279of100,1,323,5257,-2,271,5526
subtest21of10,pubtest279of100,1,323,5257,185,126,5568
subtest26of10,pubtest279of100,1,323,5257,186,164,5607
subtest29of10,pubtest279of100,1,323,5257,186,203,5646
subtest27of10,pubtest279of100,1,323,5257,188,241,5686
subtest23of10,pubtest279of100,1,323,5257,189,280,5726
subtest22of10,pubtest279of100,1,323,5257,190,319,5766
subtest210of10,pubtest279of100,1,323,5257,192,358,5807
subtest24of10,pubtest279of100,1,323,5257,193,396,5846
subtest27of10,pubtest280of100,1,323,5211,1,40,5252
subtest29of10,pubtest280of100,1,323,5211,5,75,5291
subtest24of10,pubtest280of100,1,323,5211,5,115,5331
subtest21of10,pubtest280of100,1,323,5211,13,147,5371
subtest23of10,pubtest280of100,1,323,5211,15,183,5409
subtest26of10,pubtest280of100,1,323,5211,15,222,5448
subtest22of10,pubtest280of100,1,323,5211,18,261,5490
subtest28of10,pubtest280of100,1,323,5211,18,301,5530
subtest25of10,pubtest280of100,1,323,5211,16,340,5567
subtest210of10,pubtest280of100,1,323,5211,18,380,5609
subtest24of10,pubtest281of100,1,323,5236,5,40,5281
subtest23of10,pubtest281of100,1,323,5236,5,79,5320
subtest27of10,pubtest281of100,1,323,5236,7,118,5361
subtest28of10,pubtest281of100,1,323,5236,16,148,5400
subtest22of10,pubtest281of100,1,323,5236,17,187,5440
subtest25of10,pubtest281of100,1,323,5236,18,226,5480
subtest210of10,pubtest281of100,1,323,5236,23,261,5520
subtest21of10,pubtest281of100,1,323,5236,103,221,5560
subtest26of10,pubtest281of100,1,323,5236,106,258,5600
subtest29of10,pubtest281of100,1,323,5236,104,298,5638
subtest24of10,pubtest282of100,1,323,5285,2,42,5329
subtest23of10,pubtest282of100,1,323,5285,2,81,5368
subtest21of10,pubtest282of100,1,323,5285,5,118,5408
subtest22of10,pubtest282of100,1,323,5285,5,158,5448
subtest25of10,pubtest282of100,1,323,5285,8,195,5488
subtest27of10,pubtest282of100,1,323,5285,10,233,5528
subtest26of10,pubtest282of100,1,323,5285,10,274,5569
subtest210of10,pubtest282of100,1,323,5285,12,312,5609
subtest29of10,pubtest282of100,1,323,5285,10,350,5645
subtest28of10,pubtest282of100,1,323,5285,14,391,5690
subtest24of10,pubtest283of100,1,323,5300,9,120,5429
subtest27of10,pubtest283of100,1,323,5300,10,159,5469
subtest23of10,pubtest283of100,1,323,5300,11,198,5509
subtest22of10,pubtest283of100,1,323,5300,13,236,5549
subtest25of10,pubtest283of100,1,323,5300,14,275,5589
subtest28of10,pubtest283of100,1,323,5300,15,311,5626
subtest21of10,pubtest283of100,1,323,5300,15,353,5668
subtest210of10,pubtest283of100,1,323,5300,18,391,5709
subtest29of10,pubtest283of100,1,323,5300,23,426,5749
subtest26of10,pubtest283of100,1,323,5300,25,464,5789
subtest25of10,pubtest284of100,1,323,5196,6,40,5242
subtest22of10,pubtest284of100,1,323,5196,7,77,5280
subtest210of10,pubtest284of100,1,323,5196,9,118,5323
subtest29of10,pubtest284of100,1,323,5196,11,155,5362
subtest27of10,pubtest284of100,1,323,5196,12,193,5401
subtest23of10,pubtest284of100,1,323,5196,19,226,5441
subtest21of10,pubtest284of100,1,323,5196,20,265,5481
subtest24of10,pubtest284of100,1,323,5196,21,305,5522
subtest28of10,pubtest284of100,1,323,5196,22,343,5561
subtest26of10,pubtest284of100,1,323,5196,23,382,5601
subtest23of10,pubtest285of100,1,323,5340,4,39,5383
subtest25of10,pubtest285of100,1,323,5340,4,78,5422
subtest24of10,pubtest285of100,1,323,5340,6,116,5462
subtest27of10,pubtest285of100,1,323,5340,6,156,5502
subtest22of10,pubtest285of100,1,323,5340,8,193,5541
subtest21of10,pubtest285of100,1,323,5340,8,232,5580
subtest28of10,pubtest285of100,1,323,5340,10,271,5621
subtest210of10,pubtest285of100,1,323,5340,18,304,5662
subtest29of10,pubtest285of100,1,323,5340,18,344,5702
subtest26of10,pubtest285of100,1,323,5340,20,382,5742
subtest23of10,pubtest286of100,1,323,5240,8,42,5290
subtest24of10,pubtest286of100,1,323,5240,10,81,5331
subtest210of10,pubtest286of100,1,323,5240,8,119,5367
subtest29of10,pubtest286of100,1,323,5240,9,160,5409
subtest25of10,pubtest286of100,1,323,5240,11,198,5449
subtest21of10,pubtest286of100,1,323,5240,13,235,5488
subtest27of10,pubtest286of100,1,323,5240,15,272,5527
subtest28of10,pubtest286of100,1,323,5240,17,312,5569
subtest26of10,pubtest286of100,1,323,5240,14,351,5605
subtest22of10,pubtest286of100,1,323,5240,15,391,5646
subtest26of10,pubtest287of100,1,323,5376,0,42,5418
subtest28of10,pubtest287of100,1,323,5376,2,79,5457
subtest29of10,pubtest287of100,1,323,5376,2,118,5496
subtest210of10,pubtest287of100,1,323,5376,5,156,5537
subtest27of10,pubtest287of100,1,323,5376,12,189,5577
subtest24of10,pubtest287of100,1,323,5376,13,227,5616
subtest22of10,pubtest287of100,1,323,5376,14,267,5657
subtest25of10,pubtest287of100,1,323,5376,21,300,5697
subtest21of10,pubtest287of100,1,323,5376,22,339,5737
subtest23of10,pubtest287of100,1,323,5376,38,363,5777
subtest29of10,pubtest288of100,1,323,5291,11,356,5658
subtest25of10,pubtest288of100,1,323,5291,12,356,5659
subtest26of10,pubtest288of100,1,323,5291,14,392,5697
subtest27of10,pubtest288of100,1,323,5291,15,431,5737
subtest21of10,pubtest288of100,1,323,5291,25,461,5777
subtest22of10,pubtest288of100,1,323,5291,37,488,5816
subtest210of10,pubtest288of100,1,323,5291,38,528,5857
subtest24of10,pubtest288of100,1,323,5291,39,567,5897
subtest23of10,pubtest288of100,1,323,5291,40,606,5937
subtest28of10,pubtest288of100,1,323,5291,39,646,5976
subtest210of10,pubtest289of100,1,323,5237,11,53,5301
subtest23of10,pubtest289of100,1,323,5237,12,90,5339
subtest29of10,pubtest289of100,1,323,5237,11,130,5378
subtest24of10,pubtest289of100,1,323,5237,15,167,5419
subtest25of10,pubtest289of100,1,323,5237,17,205,5459
subtest27of10,pubtest289of100,1,323,5237,17,244,5498
subtest22of10,pubtest289of100,1,323,5237,19,283,5539
subtest21of10,pubtest289of100,1,323,5237,19,323,5579
subtest26of10,pubtest289of100,1,323,5237,22,360,5619
subtest28of10,pubtest289of100,1,323,5237,24,398,5659
subtest29of10,pubtest290of100,1,323,5359,0,41,5400
subtest23of10,pubtest290of100,1,323,5359,24,56,5439
subtest22of10,pubtest290of100,1,323,5359,24,94,5477
subtest27of10,pubtest290of100,1,323,5359,26,133,5518
subtest25of10,pubtest290of100,1,323,5359,27,173,5559
subtest21of10,pubtest290of100,1,323,5359,30,210,5599
subtest210of10,pubtest290of100,1,323,5359,32,248,5639
subtest26of10,pubtest290of100,1,323,5359,30,288,5677
subtest28of10,pubtest290of100,1,323,5359,34,326,5719
subtest24of10,pubtest290of100,1,323,5359,35,365,5759
subtest23of10,pubtest291of100,1,323,5184,1,40,5225
subtest24of10,pubtest291of100,1,323,5184,1,79,5264
subtest27of10,pubtest291of100,1,323,5184,3,117,5304
subtest28of10,pubtest291of100,1,323,5184,10,150,5344
subtest210of10,pubtest291of100,1,323,5184,17,183,5384
subtest29of10,pubtest291of100,1,323,5184,17,223,5424
subtest25of10,pubtest291of100,1,323,5184,16,262,5462
subtest22of10,pubtest291of100,1,323,5184,16,301,5501
subtest21of10,pubtest291of100,1,323,5184,17,341,5542
subtest26of10,pubtest291of100,1,323,5184,20,382,5586
subtest28of10,pubtest292of100,1,323,5325,0,39,5364
subtest29of10,pubtest292of100,1,323,5325,0,78,5403
subtest21of10,pubtest292of100,1,323,5325,2,116,5443
subtest25of10,pubtest292of100,1,323,5325,3,155,5483
subtest27of10,pubtest292of100,1,323,5325,11,187,5523
subtest23of10,pubtest292of100,1,323,5325,12,226,5563
subtest26of10,pubtest292of100,1,323,5325,12,266,5603
subtest24of10,pubtest292of100,1,323,5325,16,302,5643
subtest22of10,pubtest292of100,1,323,5325,16,342,5683
subtest210of10,pubtest292of100,1,323,5325,19,379,5723
subtest25of10,pubtest293of100,1,323,5247,3,40,5290
subtest24of10,pubtest293of100,1,323,5247,5,78,5330
subtest28of10,pubtest293of100,1,323,5247,7,116,5370
subtest23of10,pubtest293of100,1,323,5247,7,156,5410
subtest210of10,pubtest293of100,1,323,5247,9,193,5449
subtest27of10,pubtest293of100,1,323,5247,12,231,5490
subtest26of10,pubtest293of100,1,323,5247,14,269,5530
subtest21of10,pubtest293of100,1,323,5247,14,310,5571
subtest29of10,pubtest293of100,1,323,5247,16,347,5610
subtest22of10,pubtest293of100,1,323,5247,17,388,5652
subtest21of10,pubtest294of100,1,323,5259,-1,38,5296
subtest25of10,pubtest294of100,1,323,5259,1,75,5335
subtest29of10,pubtest294of100,1,323,5259,2,114,5375
subtest27of10,pubtest294of100,1,323,5259,3,153,5415
subtest23of10,pubtest294of100,1,323,5259,4,192,5455
subtest210of10,pubtest294of100,1,323,5259,8,228,5495
subtest24of10,pubtest294of100,1,323,5259,10,266,5535
subtest26of10,pubtest294of100,1,323,5259,9,305,5573
subtest22of10,pubtest294of100,1,323,5259,16,338,5613
subtest28of10,pubtest294of100,1,323,5259,16,378,5653
subtest25of10,pubtest295of100,1,323,5194,4,42,5240
subtest23of10,pubtest295of100,1,323,5194,4,81,5279
subtest24of10,pubtest295of100,1,323,5194,6,119,5319
subtest27of10,pubtest295of100,1,323,5194,6,159,5359
subtest210of10,pubtest295of100,1,323,5194,10,193,5397
subtest28of10,pubtest295of100,1,323,5194,13,232,5439
subtest29of10,pubtest295of100,1,323,5194,13,271,5478
subtest21of10,pubtest295of100,1,323,5194,14,311,5519
subtest22of10,pubtest295of100,1,323,5194,10,350,5554
subtest26of10,pubtest295of100,1,323,5194,15,390,5599
subtest25of10,pubtest296of100,1,322,5311,0,42,5353
subtest24of10,pubtest296of100,1,322,5311,6,76,5393
subtest27of10,pubtest296of100,1,322,5311,6,115,5432
subtest23of10,pubtest296of100,1,322,5311,10,151,5472
subtest21of10,pubtest296of100,1,322,5311,12,189,5512
subtest26of10,pubtest296of100,1,322,5311,13,228,5552
subtest28of10,pubtest296of100,1,322,5311,14,267,5592
subtest29of10,pubtest296of100,1,322,5311,12,306,5629
subtest210of10,pubtest296of100,1,322,5311,14,346,5671
subtest22of10,pubtest296of100,1,322,5311,16,385,5712
subtest25of10,pubtest297of100,1,323,5230,14,41,5285
subtest210of10,pubtest297of100,1,323,5230,14,80,5324
subtest29of10,pubtest297of100,1,323,5230,16,118,5364
subtest22of10,pubtest297of100,1,323,5230,16,158,5404
subtest23of10,pubtest297of100,1,323,5230,17,197,5444
subtest27of10,pubtest297of100,1,323,5230,21,232,5483
subtest21of10,pubtest297of100,1,323,5230,23,271,5524
subtest26of10,pubtest297of100,1,323,5230,24,310,5564
subtest24of10,pubtest297of100,1,323,5230,26,348,5604
subtest28of10,pubtest297of100,1,323,5230,26,388,5644
subtest22of10,pubtest298of100,1,323,5215,16,41,5272
subtest24of10,pubtest298of100,1,323,5215,17,79,5311
subtest29of10,pubtest298of100,1,323,5215,13,121,5349
subtest25of10,pubtest298of100,1,323,5215,15,160,5390
subtest23of10,pubtest298of100,1,323,5215,17,199,5431
subtest21of10,pubtest298of100,1,323,5215,18,238,5471
subtest210of10,pubtest298of100,1,323,5215,21,274,5510
subtest27of10,pubtest298of100,1,323,5215,21,314,5550
subtest28of10,pubtest298of100,1,323,5215,23,352,5590
subtest26of10,pubtest298of100,1,323,5215,23,392,5630
subtest22of10,pubtest299of100,1,323,5246,20,41,5307
subtest29of10,pubtest299of100,1,323,5246,21,79,5346
subtest210of10,pubtest299of100,1,323,5246,23,117,5386
subtest24of10,pubtest299of100,1,323,5246,25,155,5426
subtest27of10,pubtest299of100,1,323,5246,23,197,5466
subtest21of10,pubtest299of100,1,323,5246,28,233,5507
subtest28of10,pubtest299of100,1,323,5246,29,272,5547
subtest23of10,pubtest299of100,1,323,5246,25,311,5582
subtest26of10,pubtest299of100,1,323,5246,28,350,5624
subtest25of10,pubtest299of100,1,323,5246,30,390,5666
subtest21of10,pubtest2100of100,1,325,5281,1,42,5324
subtest29of10,pubtest2100of100,1,325,5281,11,71,5363
subtest23of10,pubtest2100of100,1,325,5281,13,109,5403
subtest24of10,pubtest2100of100,1,325,5281,13,148,5442
subtest25of10,pubtest2100of100,1,325,5281,22,180,5483
subtest27of10,pubtest2100of100,1,325,5281,23,219,5523
subtest22of10,pubtest2100of100,1,325,5281,24,258,5563
subtest28of10,pubtest2100of100,1,325,5281,26,296,5603
subtest210of10,pubtest2100of100,1,325,5281,26,336,5643
subtest26of10,pubtest2100of100,1,325,5281,28,374,5683
subtest26of10,pubtest21of100,1,322,10289,5,41,10335
subtest27of10,pubtest21of100,1,322,10289,4,81,10374
subtest29of10,pubtest21of100,1,322,10289,8,116,10413
subtest24of10,pubtest21of100,1,322,10289,8,156,10453
subtest25of10,pubtest21of100,1,322,10289,12,192,10493
subtest21of10,pubtest21of100,1,322,10289,18,225,10532
subtest28of10,pubtest21of100,1,322,10289,20,264,10573
subtest210of10,pubtest21of100,1,322,10289,19,303,10611
subtest22of10,pubtest21of100,1,322,10289,24,340,10653
subtest23of10,pubtest21of100,1,322,10289,24,378,10691
subtest29of10,pubtest22of100,1,321,5384,7,39,5430
subtest24of10,pubtest22of100,1,321,5384,7,78,5469
subtest28of10,pubtest22of100,1,321,5384,13,112,5509
subtest21of10,pubtest22of100,1,321,5384,12,152,5548
subtest26of10,pubtest22of100,1,321,5384,14,191,5589
subtest25of10,pubtest22of100,1,321,5384,14,231,5629
subtest27of10,pubtest22of100,1,321,5384,9,271,5664
subtest210of10,pubtest22of100,1,321,5384,16,309,5709
subtest23of10,pubtest22of100,1,321,5384,9,349,5742
subtest22of10,pubtest22of100,1,321,5384,17,389,5790
subtest23of10,pubtest23of100,1,321,5377,0,41,5418
subtest29of10,pubtest23of100,1,321,5377,3,78,5458
subtest28of10,pubtest23of100,1,321,5377,8,113,5498
subtest27of10,pubtest23of100,1,321,5377,11,150,5538
subtest24of10,pubtest23of100,1,321,5377,12,189,5578
subtest26of10,pubtest23of100,1,321,5377,13,228,5618
subtest21of10,pubtest23of100,1,321,5377,13,268,5658
subtest25of10,pubtest23of100,1,321,5377,13,308,5698
subtest210of10,pubtest23of100,1,321,5377,27,335,5739
subtest22of10,pubtest23of100,1,321,5377,27,373,5777
subtest23of10,pubtest24of100,1,321,5266,-2,42,5306
subtest25of10,pubtest24of100,1,321,5266,0,80,5346
subtest24of10,pubtest24of100,1,321,5266,2,118,5386
subtest29of10,pubtest24of100,1,321,5266,11,149,5426
subtest21of10,pubtest24of100,1,321,5266,11,189,5466
subtest28of10,pubtest24of100,1,321,5266,14,226,5506
subtest22of10,pubtest24of100,1,321,5266,18,261,5545
subtest27of10,pubtest24of100,1,321,5266,18,301,5585
subtest210of10,pubtest24of100,1,321,5266,20,339,5625
subtest26of10,pubtest24of100,1,321,5266,20,379,5665
subtest28of10,pubtest25of100,1,321,5274,2,48,5324
subtest21of10,pubtest25of100,1,321,5274,5,84,5363
subtest210of10,pubtest25of100,1,321,5274,7,122,5403
subtest27of10,pubtest25of100,1,321,5274,8,161,5443
subtest26of10,pubtest25of100,1,321,5274,17,192,5483
subtest25of10,pubtest25of100,1,321,5274,21,228,5523
subtest22of10,pubtest25of100,1,321,5274,22,265,5561
subtest23of10,pubtest25of100,1,321,5274,26,303,5603
subtest29of10,pubtest25of100,1,321,5274,26,343,5643
subtest24of10,pubtest25of100,1,321,5274,27,382,5683
subtest22of10,pubtest26of100,1,321,5271,6,41,5318
subtest21of10,pubtest26of100,1,321,5271,6,81,5358
subtest29of10,pubtest26of100,1,321,5271,8,118,5397
subtest23of10,pubtest26of100,1,321,5271,8,158,5437
subtest27of10,pubtest26of100,1,321,5271,11,194,5476
subtest26of10,pubtest26of100,1,321,5271,12,234,5517
subtest25of10,pubtest26of100,1,321,5271,14,271,5556
subtest210of10,pubtest26of100,1,321,5271,14,311,5596
subtest28of10,pubtest26of100,1,321,5271,16,350,5637
subtest24of10,pubtest26of100,1,321,5271,17,389,5677
subtest27of10,pubtest27of100,1,320,5592,1,41,5634
subtest28of10,pubtest27of100,1,320,5592,1,79,5672
subtest23of10,pubtest27of100,1,320,5592,4,118,5714
subtest24of10,pubtest27of100,1,320,5592,4,158,5754
subtest210of10,pubtest27of100,1,320,5592,6,196,5794
subtest29of10,pubtest27of100,1,320,5592,8,235,5835
subtest25of10,pubtest27of100,1,320,5592,9,273,5874
subtest21of10,pubtest27of100,1,320,5592,10,312,5914
subtest22of10,pubtest27of100,1,320,5592,13,349,5954
subtest26of10,pubtest27of100,1,320,5592,18,384,5994
subtest27of10,pubtest28of100,1,321,5192,2,42,5236
subtest21of10,pubtest28of100,1,321,5192,8,76,5276
subtest28of10,pubtest28of100,1,321,5192,8,116,5316
subtest23of10,pubtest28of100,1,321,5192,10,154,5356
subtest29of10,pubtest28of100,1,321,5192,10,193,5395
subtest25of10,pubtest28of100,1,321,5192,15,229,5436
subtest210of10,pubtest28of100,1,321,5192,29,255,5476
subtest26of10,pubtest28of100,1,321,5192,30,294,5516
subtest24of10,pubtest28of100,1,321,5192,31,331,5554
subtest22of10,pubtest28of100,1,321,5192,34,370,5596
subtest23of10,pubtest29of100,1,321,5352,1,42,5395
subtest29of10,pubtest29of100,1,321,5352,7,77,5436
subtest25of10,pubtest29of100,1,321,5352,11,112,5475
subtest210of10,pubtest29of100,1,321,5352,12,151,5515
subtest22of10,pubtest29of100,1,321,5352,13,190,5555
subtest28of10,pubtest29of100,1,321,5352,14,226,5592
subtest21of10,pubtest29of100,1,321,5352,14,266,5632
subtest26of10,pubtest29of100,1,321,5352,18,305,5675
subtest27of10,pubtest29of100,1,321,5352,18,345,5715
subtest24of10,pubtest29of100,1,321,5352,15,384,5751
subtest29of10,pubtest210of100,1,323,5237,2,39,5278
subtest21of10,pubtest210of100,1,323,5237,3,78,5318
subtest210of10,pubtest210of100,1,323,5237,6,114,5357
subtest27of10,pubtest210of100,1,323,5237,8,153,5398
subtest23of10,pubtest210of100,1,323,5237,16,185,5438
subtest25of10,pubtest210of100,1,323,5237,18,223,5478
subtest28of10,pubtest210of100,1,323,5237,19,262,5518
subtest24of10,pubtest210of100,1,323,5237,23,298,5558
subtest22of10,pubtest210of100,1,323,5237,24,337,5598
subtest26of10,pubtest210of100,1,323,5237,24,377,5638
subtest29of10,pubtest211of100,1,323,5286,14,42,5342
subtest210of10,pubtest211of100,1,323,5286,13,83,5382
subtest21of10,pubtest211of100,1,323,5286,15,121,5422
subtest25of10,pubtest211of100,1,323,5286,17,158,5461
subtest23of10,pubtest211of100,1,323,5286,17,199,5502
subtest22of10,pubtest211of100,1,323,5286,18,237,5541
subtest27of10,pubtest211of100,1,323,5286,19,276,5581
subtest26of10,pubtest211of100,1,323,5286,21,314,5621
subtest28of10,pubtest211of100,1,323,5286,21,354,5661
subtest24of10,pubtest211of100,1,323,5286,15,395,5696
subtest25of10,pubtest212of100,1,323,5329,1,41,5371
subtest29of10,pubtest212of100,1,323,5329,2,78,5409
subtest28of10,pubtest212of100,1,323,5329,3,118,5450
subtest23of10,pubtest212of100,1,323,5329,9,152,5490
subtest24of10,pubtest212of100,1,323,5329,10,191,5530
subtest27of10,pubtest212of100,1,323,5329,16,226,5571
subtest22of10,pubtest212of100,1,323,5329,20,260,5609
subtest21of10,pubtest212of100,1,323,5329,20,300,5649
subtest210of10,pubtest212of100,1,323,5329,22,337,5688
subtest26of10,pubtest212of100,1,323,5329,22,377,5728
subtest23of10,pubtest213of100,1,322,5369,5,39,5413
subtest26of10,pubtest213of100,1,322,5369,5,77,5451
subtest29of10,pubtest213of100,1,322,5369,7,116,5492
subtest27of10,pubtest213of100,1,322,5369,7,155,5531
subtest22of10,pubtest213of100,1,322,5369,9,193,5571
subtest21of10,pubtest213of100,1,322,5369,11,236,5616
subtest25of10,pubtest213of100,1,322,5369,14,273,5656
subtest210of10,pubtest213of100,1,322,5369,14,313,5696
subtest24of10,pubtest213of100,1,322,5369,13,352,5734
subtest28of10,pubtest213of100,1,322,5369,15,392,5776
subtest21of10,pubtest214of100,1,323,5197,1,41,5239
subtest26of10,pubtest214of100,1,323,5197,6,74,5277
subtest25of10,pubtest214of100,1,323,5197,7,114,5318
subtest23of10,pubtest214of100,1,323,5197,4,153,5354
subtest27of10,pubtest214of100,1,323,5197,9,190,5396
subtest22of10,pubtest214of100,1,323,5197,10,230,5437
subtest29of10,pubtest214of100,1,323,5197,13,267,5477
subtest210of10,pubtest214of100,1,323,5197,15,305,5517
subtest24of10,pubtest214of100,1,323,5197,16,345,5558
subtest28of10,pubtest214of100,1,323,5197,17,383,5597
subtest27of10,pubtest215of100,1,323,5229,4,38,5271
subtest24of10,pubtest215of100,1,323,5229,6,75,5310
subtest29of10,pubtest215of100,1,323,5229,7,114,5350
subtest26of10,pubtest215of100,1,323,5229,8,153,5390
subtest21of10,pubtest215of100,1,323,5229,8,192,5429
subtest25of10,pubtest215of100,1,323,5229,10,231,5470
subtest23of10,pubtest215of100,1,323,5229,10,271,5510
subtest210of10,pubtest215of100,1,323,5229,11,309,5549
subtest22of10,pubtest215of100,1,323,5229,12,350,5591
subtest28of10,pubtest215of100,1,323,5229,16,385,5630
subtest24of10,pubtest216of100,1,323,5399,3,42,5444
subtest21of10,pubtest216of100,1,323,5399,3,82,5484
subtest23of10,pubtest216of100,1,323,5399,7,118,5524
subtest27of10,pubtest216of100,1,323,5399,7,158,5564
subtest25of10,pubtest216of100,1,323,5399,12,192,5603
subtest28of10,pubtest216of100,1,323,5399,12,230,5641
subtest29of10,pubtest216of100,1,323,5399,16,268,5683
subtest22of10,pubtest216of100,1,323,5399,15,309,5723
subtest26of10,pubtest216of100,1,323,5399,18,346,5763
subtest210of10,pubtest216of100,1,323,5399,23,381,5803
subtest27of10,pubtest217of100,1,322,5316,0,42,5358
subtest22of10,pubtest217of100,1,322,5316,3,78,5397
subtest21of10,pubtest217of100,1,322,5316,7,115,5438
subtest23of10,pubtest217of100,1,322,5316,7,154,5477
subtest29of10,pubtest217of100,1,322,5316,12,189,5517
subtest24of10,pubtest217of100,1,322,5316,15,226,5557
subtest26of10,pubtest217of100,1,322,5316,15,266,5597
subtest25of10,pubtest217of100,1,322,5316,18,303,5637
subtest28of10,pubtest217of100,1,322,5316,19,343,5678
subtest210of10,pubtest217of100,1,322,5316,20,381,5717
subtest29of10,pubtest218of100,1,323,5277,2,38,5317
subtest21of10,pubtest218of100,1,323,5277,3,76,5356
subtest27of10,pubtest218of100,1,323,5277,11,108,5396
subtest22of10,pubtest218of100,1,323,5277,10,148,5435
subtest23of10,pubtest218of100,1,323,5277,11,187,5475
subtest28of10,pubtest218of100,1,323,5277,13,226,5516
subtest25of10,pubtest218of100,1,323,5277,18,261,5556
subtest24of10,pubtest218of100,1,323,5277,18,301,5596
subtest26of10,pubtest218of100,1,323,5277,22,336,5635
subtest210of10,pubtest218of100,1,323,5277,21,376,5674
subtest210of10,pubtest219of100,1,323,5345,12,40,5397
subtest25of10,pubtest219of100,1,323,5345,13,78,5436
subtest26of10,pubtest219of100,1,323,5345,14,117,5476
subtest29of10,pubtest219of100,1,323,5345,16,155,5516
subtest23of10,pubtest219of100,1,323,5345,17,192,5554
subtest24of10,pubtest219of100,1,323,5345,22,229,5596
subtest27of10,pubtest219of100,1,323,5345,22,269,5636
subtest21of10,pubtest219of100,1,323,5345,15,308,5668
subtest22of10,pubtest219of100,1,323,5345,16,350,5711
subtest28of10,pubtest219of100,1,323,5345,24,388,5757
subtest25of10,pubtest220of100,1,323,5364,0,439,5803
subtest23of10,pubtest220of100,1,323,5364,2,475,5841
subtest210of10,pubtest220of100,1,323,5364,2,515,5881
subtest29of10,pubtest220of100,1,323,5364,5,556,5925
subtest21of10,pubtest220of100,1,323,5364,15,585,5964
subtest24of10,pubtest220of100,1,323,5364,15,624,6003
subtest28of10,pubtest220of100,1,323,5364,17,662,6043
subtest26of10,pubtest220of100,1,323,5364,18,701,6083
subtest22of10,pubtest220of100,1,323,5364,19,740,6123
subtest27of10,pubtest220of100,1,323,5364,19,780,6163
subtest24of10,pubtest221of100,1,323,5199,2,38,5239
subtest21of10,pubtest221of100,1,323,5199,4,75,5278
subtest28of10,pubtest221of100,1,323,5199,5,114,5318
subtest23of10,pubtest221of100,1,323,5199,5,154,5358
subtest22of10,pubtest221of100,1,323,5199,7,192,5398
subtest25of10,pubtest221of100,1,323,5199,11,228,5438
subtest210of10,pubtest221of100,1,323,5199,13,266,5478
subtest29of10,pubtest221of100,1,323,5199,24,294,5517
subtest26of10,pubtest221of100,1,323,5199,25,334,5558
subtest27of10,pubtest221of100,1,323,5199,28,371,5598
subtest21of10,pubtest222of100,1,323,5215,19,55,5289
subtest22of10,pubtest222of100,1,323,5215,22,89,5326
subtest29of10,pubtest222of100,1,323,5215,23,129,5367
subtest27of10,pubtest222of100,1,323,5215,24,165,5404
subtest210of10,pubtest222of100,1,323,5215,27,204,5446
subtest25of10,pubtest222of100,1,323,5215,26,244,5485
subtest28of10,pubtest222of100,1,323,5215,28,283,5526
subtest23of10,pubtest222of100,1,323,5215,24,323,5562
subtest26of10,pubtest222of100,1,323,5215,32,359,5606
subtest24of10,pubtest222of100,1,323,5215,34,397,5646
subtest21of10,pubtest223of100,1,323,5197,2,41,5240
subtest28of10,pubtest223of100,1,323,5197,3,80,5280
subtest23of10,pubtest223of100,1,323,5197,4,118,5319
subtest29of10,pubtest223of100,1,323,5197,5,159,5361
subtest24of10,pubtest223of100,1,323,5197,7,196,5400
subtest27of10,pubtest223of100,1,323,5197,20,223,5440
subtest210of10,pubtest223of100,1,323,5197,28,256,5481
subtest25of10,pubtest223of100,1,323,5197,30,293,5520
subtest22of10,pubtest223of100,1,323,5197,30,333,5560
subtest26of10,pubtest223of100,1,323,5197,31,370,5598
subtest21of10,pubtest224of100,1,323,5498,-2,39,5535
subtest27of10,pubtest224of100,1,323,5498,6,70,5574
subtest28of10,pubtest224of100,1,323,5498,5,110,5613
subtest23of10,pubtest224of100,1,323,5498,9,147,5654
subtest26of10,pubtest224of100,1,323,5498,10,186,5694
subtest29of10,pubtest224of100,1,323,5498,11,225,5734
subtest25of10,pubtest224of100,1,323,5498,12,264,5774
subtest22of10,pubtest224of100,1,323,5498,13,302,5813
subtest24of10,pubtest224of100,1,323,5498,17,339,5854
subtest210of10,pubtest224of100,1,323,5498,17,379,5894
subtest27of10,pubtest225of100,1,323,5235,2,39,5276
subtest22of10,pubtest225of100,1,323,5235,2,78,5315
subtest21of10,pubtest225of100,1,323,5235,11,109,5355
subtest26of10,pubtest225of100,1,323,5235,15,146,5396
subtest25of10,pubtest225of100,1,323,5235,18,182,5435
subtest24of10,pubtest225of100,1,323,5235,19,221,5475
subtest23of10,pubtest225of100,1,323,5235,20,261,5516
subtest29of10,pubtest225of100,1,323,5235,25,295,5555
subtest28of10,pubtest225of100,1,323,5235,26,334,5595
subtest210of10,pubtest225of100,1,323,5235,29,371,5635
subtest25of10,pubtest226of100,1,323,5230,6,40,5276
subtest22of10,pubtest226of100,1,323,5230,7,77,5314
subtest23of10,pubtest226of100,1,323,5230,8,117,5355
subtest21of10,pubtest226of100,1,323,5230,10,155,5395
subtest27of10,pubtest226of100,1,323,5230,10,195,5435
subtest28of10,pubtest226of100,1,323,5230,12,233,5475
subtest26of10,pubtest226of100,1,323,5230,12,273,5515
subtest210of10,pubtest226of100,1,323,5230,10,312,5552
subtest24of10,pubtest226of100,1,323,5230,13,349,5592
subtest29of10,pubtest226of100,1,323,5230,17,388,5635
subtest210of10,pubtest227of100,1,323,5253,4,41,5298
subtest29of10,pubtest227of100,1,323,5253,3,82,5338
subtest25of10,pubtest227of100,1,323,5253,9,117,5379
subtest24of10,pubtest227of100,1,323,5253,9,156,5418
subtest21of10,pubtest227of100,1,323,5253,14,191,5458
subtest26of10,pubtest227of100,1,323,5253,14,231,5498
subtest27of10,pubtest227of100,1,323,5253,14,270,5537
subtest23of10,pubtest227of100,1,323,5253,16,310,5579
subtest22of10,pubtest227of100,1,323,5253,22,343,5618
subtest28of10,pubtest227of100,1,323,5253,26,379,5658
subtest21of10,pubtest228of100,1,323,5146,-2,40,5184
subtest26of10,pubtest228of100,1,323,5146,0,80,5226
subtest25of10,pubtest228of100,1,323,5146,1,118,5265
subtest23of10,pubtest228of100,1,323,5146,2,157,5305
subtest24of10,pubtest228of100,1,323,5146,7,191,5344
subtest27of10,pubtest228of100,1,323,5146,8,231,5385
subtest29of10,pubtest228of100,1,323,5146,13,267,5426
subtest22of10,pubtest228of100,1,323,5146,15,304,5465
subtest210of10,pubtest228of100,1,323,5146,15,344,5505
subtest28of10,pubtest228of100,1,323,5146,16,383,5545
subtest24of10,pubtest229of100,1,321,5409,-3,44,5450
subtest21of10,pubtest229of100,1,321,5409,-2,82,5489
subtest28of10,pubtest229of100,1,321,5409,-1,121,5529
subtest27of10,pubtest229of100,1,321,5409,1,159,5569
subtest22of10,pubtest229of100,1,321,5409,1,199,5609
subtest23of10,pubtest229of100,1,321,5409,3,237,5649
subtest25of10,pubtest229of100,1,321,5409,7,273,5689
subtest29of10,pubtest229of100,1,321,5409,8,312,5729
subtest210of10,pubtest229of100,1,321,5409,9,351,5769
subtest26of10,pubtest229of100,1,321,5409,20,380,5809
subtest22of10,pubtest230of100,1,323,5227,3,41,5271
subtest21of10,pubtest230of100,1,323,5227,4,79,5310
subtest27of10,pubtest230of100,1,323,5227,6,117,5350
subtest28of10,pubtest230of100,1,323,5227,13,150,5390
subtest29of10,pubtest230of100,1,323,5227,13,192,5432
subtest23of10,pubtest230of100,1,323,5227,15,229,5471
subtest25of10,pubtest230of100,1,323,5227,15,268,5510
subtest210of10,pubtest230of100,1,323,5227,19,304,5550
subtest24of10,pubtest230of100,1,323,5227,53,310,5590
subtest26of10,pubtest230of100,1,323,5227,56,347,5630
subtest23of10,pubtest231of100,1,323,5197,0,40,5237
subtest25of10,pubtest231of100,1,323,5197,8,71,5276
subtest28of10,pubtest231of100,1,323,5197,8,111,5316
subtest210of10,pubtest231of100,1,323,5197,12,147,5356
subtest24of10,pubtest231of100,1,323,5197,11,187,5395
subtest29of10,pubtest231of100,1,323,5197,15,224,5436
subtest27of10,pubtest231of100,1,323,5197,15,263,5475
subtest26of10,pubtest231of100,1,323,5197,17,300,5514
subtest22of10,pubtest231of100,1,323,5197,19,340,5556
subtest21of10,pubtest231of100,1,323,5197,15,379,5591
subtest21of10,pubtest232of100,1,323,5411,0,42,5453
subtest27of10,pubtest232of100,1,323,5411,4,77,5492
subtest22of10,pubtest232of100,1,323,5411,7,113,5531
subtest29of10,pubtest232of100,1,323,5411,11,149,5571
subtest25of10,pubtest232of100,1,323,5411,11,190,5612
subtest23of10,pubtest232of100,1,323,5411,11,228,5650
subtest28of10,pubtest232of100,1,323,5411,14,266,5691
subtest210of10,pubtest232of100,1,323,5411,15,305,5731
subtest24of10,pubtest232of100,1,323,5411,16,344,5771
subtest26of10,pubtest232of100,1,323,5411,17,383,5811
subtest24of10,pubtest233of100,1,323,5166,2,41,5209
subtest25of10,pubtest233of100,1,323,5166,3,79,5248
subtest29of10,pubtest233of100,1,323,5166,2,118,5286
subtest210of10,pubtest233of100,1,323,5166,5,157,5328
subtest27of10,pubtest233of100,1,323,5166,6,196,5368
subtest26of10,pubtest233of100,1,323,5166,13,229,5408
subtest21of10,pubtest233of100,1,323,5166,19,263,5448
subtest22of10,pubtest233of100,1,323,5166,19,303,5488
subtest28of10,pubtest233of100,1,323,5166,22,340,5528
subtest23of10,pubtest233of100,1,323,5166,19,380,5565
subtest25of10,pubtest234of100,1,323,5304,3,45,5352
subtest26of10,pubtest234of100,1,323,5304,5,81,5390
subtest27of10,pubtest234of100,1,323,5304,10,114,5428
subtest22of10,pubtest234of100,1,323,5304,15,150,5469
subtest24of10,pubtest234of100,1,323,5304,15,191,5510
subtest210of10,pubtest234of100,1,323,5304,15,229,5548
subtest21of10,pubtest234of100,1,323,5304,11,268,5583
subtest23of10,pubtest234of100,1,323,5304,12,308,5624
subtest29of10,pubtest234of100,1,323,5304,12,348,5664
subtest28of10,pubtest234of100,1,323,5304,23,382,5709
subtest27of10,pubtest235of100,1,321,5365,7,44,5416
subtest22of10,pubtest235of100,1,321,5365,5,85,5455
subtest23of10,pubtest235of100,1,321,5365,5,121,5491
subtest21of10,pubtest235of100,1,321,5365,4,158,5527
subtest26of10,pubtest235of100,1,321,5365,9,197,5571
subtest28of10,pubtest235of100,1,321,5365,10,237,5612
subtest24of10,pubtest235of100,1,321,5365,8,275,5648
subtest210of10,pubtest235of100,1,321,5365,5,315,5685
subtest25of10,pubtest235of100,1,321,5365,8,354,5727
subtest29of10,pubtest235of100,1,321,5365,11,394,5770
subtest210of10,pubtest236of100,1,323,5239,7,40,5286
subtest23of10,pubtest236of100,1,323,5239,7,79,5325
subtest25of10,pubtest236of100,1,323,5239,17,109,5365
subtest27of10,pubtest236of100,1,323,5239,15,149,5403
subtest28of10,pubtest236of100,1,323,5239,15,188,5442
subtest21of10,pubtest236of100,1,323,5239,17,222,5478
subtest26of10,pubtest236of100,1,323,5239,25,261,5525
subtest22of10,pubtest236of100,1,323,5239,26,300,5565
subtest29of10,pubtest236of100,1,323,5239,17,339,5595
subtest24of10,pubtest236of100,1,323,5239,27,380,5646
subtest24of10,pubtest237of100,1,323,5301,5,38,5344
subtest23of10,pubtest237of100,1,323,5301,6,77,5384
subtest28of10,pubtest237of100,1,323,5301,8,115,5424
subtest25of10,pubtest237of100,1,323,5301,11,153,5465
subtest27of10,pubtest237of100,1,323,5301,22,182,5505
subtest26of10,pubtest237of100,1,323,5301,24,220,5545
subtest22of10,pubtest237of100,1,323,5301,23,260,5584
subtest210of10,pubtest237of100,1,323,5301,26,298,5625
subtest29of10,pubtest237of100,1,323,5301,26,338,5665
subtest21of10,pubtest237of100,1,323,5301,22,378,5701
subtest29of10,pubtest238of100,1,323,5285,3,429,5717
subtest22of10,pubtest238of100,1,323,5285,3,468,5756
subtest27of10,pubtest238of100,1,323,5285,4,506,5795
subtest28of10,pubtest238of100,1,323,5285,6,545,5836
subtest25of10,pubtest238of100,1,323,5285,15,576,5876
subtest210of10,pubtest238of100,1,323,5285,15,614,5914
subtest26of10,pubtest238of100,1,323,5285,18,652,5955
subtest23of10,pubtest238of100,1,323,5285,18,692,5995
subtest21of10,pubtest238of100,1,323,5285,20,731,6036
subtest24of10,pubtest238of100,1,323,5285,24,767,6076
subtest21of10,pubtest239of100,1,323,5932,1,38,5971
subtest28of10,pubtest239of100,1,323,5932,11,67,6010
subtest27of10,pubtest239of100,1,323,5932,18,99,6049
subtest25of10,pubtest239of100,1,323,5932,23,135,6090
subtest26of10,pubtest239of100,1,323,5932,23,175,6130
subtest24of10,pubtest239of100,1,323,5932,25,213,6170
subtest29of10,pubtest239of100,1,323,5932,26,252,6210
subtest23of10,pubtest239of100,1,323,5932,27,291,6250
subtest210of10,pubtest239of100,1,323,5932,28,330,6290
subtest22of10,pubtest239of100,1,323,5932,28,370,6330
subtest210of10,pubtest240of100,1,323,7850,2,42,7894
subtest25of10,pubtest240of100,1,323,7850,0,81,7931
subtest21of10,pubtest240of100,1,323,7850,4,119,7973
subtest29of10,pubtest240of100,1,323,7850,4,159,8013
subtest27of10,pubtest240of100,1,323,7850,7,196,8053
subtest23of10,pubtest240of100,1,323,7850,9,235,8094
subtest28of10,pubtest240of100,1,323,7850,15,268,8133
subtest24of10,pubtest240of100,1,323,7850,16,307,8173
subtest22of10,pubtest240of100,1,323,7850,17,346,8213
subtest26of10,pubtest240of100,1,323,7850,22,381,8253
subtest23of10,pubtest241of100,1,323,7102,3,41,7146
subtest27of10,pubtest241of100,1,323,7102,6,77,7185
subtest24of10,pubtest241of100,1,323,7102,7,116,7225
subtest21of10,pubtest241of100,1,323,7102,8,155,7265
subtest210of10,pubtest241of100,1,323,7102,9,195,7306
subtest29of10,pubtest241of100,1,323,7102,12,231,7345
subtest26of10,pubtest241of100,1,323,7102,14,269,7385
subtest28of10,pubtest241of100,1,323,7102,14,309,7425
subtest25of10,pubtest241of100,1,323,7102,15,348,7465
subtest22of10,pubtest241of100,1,323,7102,16,387,7505
subtest27of10,pubtest242of100,1,323,5349,0,41,5390
subtest23of10,pubtest242of100,1,323,5349,1,80,5430
subtest26of10,pubtest242of100,1,323,5349,2,119,5470
subtest25of10,pubtest242of100,1,323,5349,3,158,5510
subtest29of10,pubtest242of100,1,323,5349,9,192,5550
subtest210of10,pubtest242of100,1,323,5349,8,232,5589
subtest21of10,pubtest242of100,1,323,5349,10,271,5630
subtest22of10,pubtest242of100,1,323,5349,14,307,5670
subtest24of10,pubtest242of100,1,323,5349,18,343,5710
subtest28of10,pubtest242of100,1,323,5349,18,383,5750
subtest29of10,pubtest243of100,1,323,5418,4,40,5462
subtest28of10,pubtest243of100,1,323,5418,6,77,5501
subtest23of10,pubtest243of100,1,323,5418,7,116,5541
subtest25of10,pubtest243of100,1,323,5418,11,151,5580
subtest22of10,pubtest243of100,1,323,5418,14,189,5621
subtest27of10,pubtest243of100,1,323,5418,15,228,5661
subtest21of10,pubtest243of100,1,323,5418,18,265,5701
subtest24of10,pubtest243of100,1,323,5418,18,305,5741
subtest26of10,pubtest243of100,1,323,5418,18,344,5780
subtest210of10,pubtest243of100,1,323,5418,20,383,5821
subtest27of10,pubtest244of100,1,323,5377,3,38,5418
subtest25of10,pubtest244of100,1,323,5377,3,77,5457
subtest26of10,pubtest244of100,1,323,5377,0,118,5495
subtest29of10,pubtest244of100,1,323,5377,8,152,5537
subtest21of10,pubtest244of100,1,323,5377,13,187,5577
subtest23of10,pubtest244of100,1,323,5377,14,227,5618
subtest22of10,pubtest244of100,1,323,5377,15,265,5657
subtest210of10,pubtest244of100,1,323,5377,16,304,5697
subtest28of10,pubtest244of100,1,323,5377,17,343,5737
subtest24of10,pubtest244of100,1,323,5377,17,382,5776
subtest29of10,pubtest245of100,1,322,5339,2,38,5379
subtest26of10,pubtest245of100,1,322,5339,4,76,5419
subtest23of10,pubtest245of100,1,322,5339,4,115,5458
subtest25of10,pubtest245of100,1,322,5339,5,154,5498
subtest22of10,pubtest245of100,1,322,5339,8,191,5538
subtest24of10,pubtest245of100,1,322,5339,14,224,5577
subtest21of10,pubtest245of100,1,322,5339,14,264,5617
subtest28of10,pubtest245of100,1,322,5339,15,304,5658
subtest210of10,pubtest245of100,1,322,5339,55,304,5698
subtest27of10,pubtest245of100,1,322,5339,55,344,5738
subtest26of10,pubtest246of100,1,323,5177,1,115,5293
subtest27of10,pubtest246of100,1,323,5177,2,154,5333
subtest21of10,pubtest246of100,1,323,5177,6,189,5372
subtest29of10,pubtest246of100,1,323,5177,7,228,5412
subtest28of10,pubtest246of100,1,323,5177,9,266,5452
subtest23of10,pubtest246of100,1,323,5177,11,305,5493
subtest25of10,pubtest246of100,1,323,5177,18,337,5532
subtest210of10,pubtest246of100,1,323,5177,22,377,5576
subtest24of10,pubtest246of100,1,323,5177,26,413,5616
subtest22of10,pubtest246of100,1,323,5177,28,451,5656
subtest27of10,pubtest247of100,1,323,5306,-3,40,5343
subtest23of10,pubtest247of100,1,323,5306,0,76,5382
subtest26of10,pubtest247of100,1,323,5306,0,116,5422
subtest21of10,pubtest247of100,1,323,5306,4,152,5462
subtest22of10,pubtest247of100,1,323,5306,5,191,5502
subtest29of10,pubtest247of100,1,323,5306,6,230,5542
subtest28of10,pubtest247of100,1,323,5306,7,269,5582
subtest25of10,pubtest247of100,1,323,5306,8,308,5622
subtest210of10,pubtest247of100,1,323,5306,12,344,5662
subtest24of10,pubtest247of100,1,323,5306,13,383,5702
subtest29of10,pubtest248of100,1,323,5419,0,41,5460
subtest25of10,pubtest248of100,1,323,5419,2,78,5499
subtest26of10,pubtest248of100,1,323,5419,7,112,5538
subtest27of10,pubtest248of100,1,323,5419,9,150,5578
subtest23of10,pubtest248of100,1,323,5419,8,191,5618
subtest28of10,pubtest248of100,1,323,5419,12,228,5659
subtest21of10,pubtest248of100,1,323,5419,12,267,5698
subtest24of10,pubtest248of100,1,323,5419,14,306,5739
subtest22of10,pubtest248of100,1,323,5419,19,340,5778
subtest210of10,pubtest248of100,1,323,5419,19,381,5819
subtest28of10,pubtest249of100,1,323,5408,0,39,5447
subtest27of10,pubtest249of100,1,323,5408,0,78,5486
subtest25of10,pubtest249of100,1,323,5408,4,113,5525
subtest21of10,pubtest249of100,1,323,5408,8,151,5567
subtest24of10,pubtest249of100,1,323,5408,9,189,5606
subtest29of10,pubtest249of100,1,323,5408,13,225,5646
subtest26of10,pubtest249of100,1,323,5408,13,265,5686
subtest23of10,pubtest249of100,1,323,5408,15,303,5726
subtest22of10,pubtest249of100,1,323,5408,20,338,5766
subtest210of10,pubtest249of100,1,323,5408,20,378,5806
subtest27of10,pubtest250of100,1,323,5195,0,41,5236
subtest28of10,pubtest250of100,1,323,5195,2,79,5276
subtest23of10,pubtest250of100,1,323,5195,2,119,5316
subtest29of10,pubtest250of100,1,323,5195,4,156,5355
subtest21of10,pubtest250of100,1,323,5195,5,196,5396
subtest25of10,pubtest250of100,1,323,5195,9,232,5436
subtest24of10,pubtest250of100,1,323,5195,11,270,5476
subtest210of10,pubtest250of100,1,323,5195,23,298,5516
subtest26of10,pubtest250of100,1,323,5195,23,338,5556
subtest22of10,pubtest250of100,1,323,5195,28,373,5596
subtest23of10,pubtest251of100,1,323,5272,-2,40,5310
subtest22of10,pubtest251of100,1,323,5272,-2,80,5350
subtest27of10,pubtest251of100,1,323,5272,0,115,5387
subtest25of10,pubtest251of100,1,323,5272,2,155,5429
subtest24of10,pubtest251of100,1,323,5272,0,195,5467
subtest21of10,pubtest251of100,1,323,5272,5,232,5509
subtest28of10,pubtest251of100,1,323,5272,6,272,5550
subtest210of10,pubtest251of100,1,323,5272,14,303,5589
subtest29of10,pubtest251of100,1,323,5272,18,339,5629
subtest26of10,pubtest251of100,1,323,5272,18,379,5669
subtest29of10,pubtest252of100,1,323,5406,1,40,5447
subtest21of10,pubtest252of100,1,323,5406,4,79,5489
subtest28of10,pubtest252of100,1,323,5406,4,118,5528
subtest26of10,pubtest252of100,1,323,5406,6,156,5568
subtest27of10,pubtest252of100,1,323,5406,14,188,5608
subtest25of10,pubtest252of100,1,323,5406,19,223,5648
subtest22of10,pubtest252of100,1,323,5406,19,262,5687
subtest24of10,pubtest252of100,1,323,5406,20,302,5728
subtest210of10,pubtest252of100,1,323,5406,22,340,5768
subtest23of10,pubtest252of100,1,323,5406,21,381,5808
subtest28of10,pubtest253of100,1,322,5273,1,41,5315
subtest23of10,pubtest253of100,1,322,5273,8,73,5354
subtest25of10,pubtest253of100,1,322,5273,8,113,5394
subtest24of10,pubtest253of100,1,322,5273,12,149,5434
subtest29of10,pubtest253of100,1,322,5273,12,189,5474
subtest21of10,pubtest253of100,1,322,5273,13,228,5514
subtest27of10,pubtest253of100,1,322,5273,14,267,5554
subtest210of10,pubtest253of100,1,322,5273,15,304,5592
subtest26of10,pubtest253of100,1,322,5273,17,344,5634
subtest22of10,pubtest253of100,1,322,5273,13,383,5669
subtest27of10,pubtest254of100,1,323,5310,2,39,5351
subtest210of10,pubtest254of100,1,323,5310,2,78,5390
subtest29of10,pubtest254of100,1,323,5310,35,84,5429
subtest22of10,pubtest254of100,1,323,5310,35,124,5469
subtest25of10,pubtest254of100,1,323,5310,32,164,5506
subtest23of10,pubtest254of100,1,323,5310,34,204,5548
subtest28of10,pubtest254of100,1,323,5310,31,243,5584
subtest24of10,pubtest254of100,1,323,5310,32,284,5626
subtest21of10,pubtest254of100,1,323,5310,31,322,5663
subtest26of10,pubtest254of100,1,323,5310,46,353,5709
subtest23of10,pubtest255of100,1,322,5215,-1,41,5255
subtest27of10,pubtest255of100,1,322,5215,3,76,5294
subtest29of10,pubtest255of100,1,322,5215,4,116,5335
subtest21of10,pubtest255of100,1,322,5215,5,154,5374
subtest25of10,pubtest255of100,1,322,5215,6,194,5415
subtest22of10,pubtest255of100,1,322,5215,7,232,5454
subtest28of10,pubtest255of100,1,322,5215,10,269,5494
subtest210of10,pubtest255of100,1,322,5215,11,308,5534
subtest26of10,pubtest255of100,1,322,5215,11,348,5574
subtest24of10,pubtest255of100,1,322,5215,12,387,5614
subtest29of10,pubtest256of100,1,323,5352,8,40,5400
subtest21of10,pubtest256of100,1,323,5352,11,77,5440
subtest23of10,pubtest256of100,1,323,5352,11,117,5480
subtest27of10,pubtest256of100,1,323,5352,13,155,5520
subtest28of10,pubtest256of100,1,323,5352,13,195,5560
subtest25of10,pubtest256of100,1,323,5352,14,234,5600
subtest22of10,pubtest256of100,1,323,5352,14,274,5640
subtest210of10,pubtest256of100,1,323,5352,15,313,5680
subtest26of10,pubtest256of100,1,323,5352,9,359,5720
subtest24of10,pubtest256of100,1,323,5352,16,390,5758
subtest24of10,pubtest257of100,1,323,5350,3,42,5395
subtest21of10,pubtest257of100,1,323,5350,3,82,5435
subtest23of10,pubtest257of100,1,323,5350,5,120,5475
subtest27of10,pubtest257of100,1,323,5350,5,159,5514
subtest28of10,pubtest257of100,1,323,5350,6,199,5555
subtest29of10,pubtest257of100,1,323,5350,11,234,5595
subtest25of10,pubtest257of100,1,323,5350,11,274,5635
subtest22of10,pubtest257of100,1,323,5350,14,311,5675
subtest210of10,pubtest257of100,1,323,5350,15,350,5715
subtest26of10,pubtest257of100,1,323,5350,26,379,5755
subtest28of10,pubtest258of100,1,323,5264,2,41,5307
subtest23of10,pubtest258of100,1,323,5264,5,77,5346
subtest25of10,pubtest258of100,1,323,5264,11,111,5386
subtest26of10,pubtest258of100,1,323,5264,11,151,5426
subtest21of10,pubtest258of100,1,323,5264,19,183,5466
subtest29of10,pubtest258of100,1,323,5264,19,223,5506
subtest27of10,pubtest258of100,1,323,5264,22,260,5546
subtest210of10,pubtest258of100,1,323,5264,22,301,5587
subtest22of10,pubtest258of100,1,323,5264,23,340,5627
subtest24of10,pubtest258of100,1,323,5264,27,375,5666
subtest28of10,pubtest259of100,1,323,5174,4,39,5217
subtest21of10,pubtest259of100,1,323,5174,6,76,5256
subtest25of10,pubtest259of100,1,323,5174,8,118,5300
subtest27of10,pubtest259of100,1,323,5174,8,158,5340
subtest24of10,pubtest259of100,1,323,5174,12,194,5380
subtest26of10,pubtest259of100,1,323,5174,13,233,5420
subtest23of10,pubtest259of100,1,323,5174,12,272,5458
subtest29of10,pubtest259of100,1,323,5174,14,312,5500
subtest22of10,pubtest259of100,1,323,5174,16,350,5540
subtest210of10,pubtest259of100,1,323,5174,15,388,5577
subtest210of10,pubtest260of100,1,323,5218,-2,40,5256
subtest23of10,pubtest260of100,1,323,5218,-1,77,5294
subtest26of10,pubtest260of100,1,323,5218,2,115,5335
subtest21of10,pubtest260of100,1,323,5218,3,153,5374
subtest27of10,pubtest260of100,1,323,5218,7,189,5414
subtest22of10,pubtest260of100,1,323,5218,9,226,5453
subtest28of10,pubtest260of100,1,323,5218,9,265,5492
subtest29of10,pubtest260of100,1,323,5218,9,304,5531
subtest25of10,pubtest260of100,1,323,5218,17,339,5574
subtest24of10,pubtest260of100,1,323,5218,17,379,5614
subtest25of10,pubtest261of100,1,323,5282,0,43,5325
subtest28of10,pubtest261of100,1,323,5282,1,82,5365
subtest29of10,pubtest261of100,1,323,5282,5,118,5405
subtest22of10,pubtest261of100,1,323,5282,5,158,5445
subtest210of10,pubtest261of100,1,323,5282,3,198,5483
subtest23of10,pubtest261of100,1,323,5282,34,209,5525
subtest27of10,pubtest261of100,1,323,5282,35,248,5565
subtest24of10,pubtest261of100,1,323,5282,38,285,5605
subtest21of10,pubtest261of100,1,323,5282,38,325,5645
subtest26of10,pubtest261of100,1,323,5282,39,364,5685
subtest21of10,pubtest262of100,1,323,5448,1,39,5488
subtest22of10,pubtest262of100,1,323,5448,1,79,5528
subtest23of10,pubtest262of100,1,323,5448,3,116,5567
subtest26of10,pubtest262of100,1,323,5448,5,154,5607
subtest27of10,pubtest262of100,1,323,5448,9,190,5647
subtest29of10,pubtest262of100,1,323,5448,9,230,5687
subtest25of10,pubtest262of100,1,323,5448,11,268,5727
subtest210of10,pubtest262of100,1,323,5448,11,308,5767
subtest24of10,pubtest262of100,1,323,5448,13,346,5807
subtest28of10,pubtest262of100,1,323,5448,13,386,5847
subtest22of10,pubtest263of100,1,322,5266,0,257,5523
subtest29of10,pubtest263of100,1,322,5266,1,293,5560
subtest24of10,pubtest263of100,1,322,5266,5,328,5599
subtest23of10,pubtest263of100,1,322,5266,6,367,5639
subtest26of10,pubtest263of100,1,322,5266,9,404,5679
subtest25of10,pubtest263of100,1,322,5266,9,443,5718
subtest210of10,pubtest263of100,1,322,5266,11,239,5516
subtest27of10,pubtest263of100,1,322,5266,11,278,5555
subtest28of10,pubtest263of100,1,322,5266,256,317,5839
subtest21of10,pubtest263of100,1,322,5266,11,357,5634
subtest22of10,pubtest264of100,1,322,5184,13,41,5238
subtest29of10,pubtest264of100,1,322,5184,13,81,5278
subtest23of10,pubtest264of100,1,322,5184,15,118,5317
subtest24of10,pubtest264of100,1,322,5184,15,158,5357
subtest28of10,pubtest264of100,1,322,5184,17,195,5396
subtest27of10,pubtest264of100,1,322,5184,18,233,5435
subtest21of10,pubtest264of100,1,322,5184,32,260,5476
subtest26of10,pubtest264of100,1,322,5184,32,300,5516
subtest25of10,pubtest264of100,1,322,5184,35,338,5557
subtest210of10,pubtest264of100,1,322,5184,36,377,5597
subtest26of10,pubtest265of100,1,323,5352,1,39,5392
subtest27of10,pubtest265of100,1,323,5352,9,71,5432
subtest210of10,pubtest265of100,1,323,5352,11,109,5472
subtest29of10,pubtest265of100,1,323,5352,13,147,5512
subtest21of10,pubtest265of100,1,323,5352,12,188,5552
subtest22of10,pubtest265of100,1,323,5352,14,228,5594
subtest28of10,pubtest265of100,1,323,5352,18,263,5633
subtest24of10,pubtest265of100,1,323,5352,18,302,5672
subtest25of10,pubtest265of100,1,323,5352,18,341,5711
subtest23of10,pubtest265of100,1,323,5352,20,380,5752
subtest29of10,pubtest266of100,1,321,5251,2,40,5293
subtest25of10,pubtest266of100,1,321,5251,7,74,5332
subtest210of10,pubtest266of100,1,321,5251,8,113,5372
subtest27of10,pubtest266of100,1,321,5251,9,152,5412
subtest26of10,pubtest266of100,1,321,5251,9,191,5451
subtest23of10,pubtest266of100,1,321,5251,11,230,5492
subtest28of10,pubtest266of100,1,321,5251,11,271,5533
subtest21of10,pubtest266of100,1,321,5251,13,308,5572
subtest24of10,pubtest266of100,1,321,5251,13,346,5610
subtest22of10,pubtest266of100,1,321,5251,23,378,5652
subtest23of10,pubtest267of100,1,323,5247,7,44,5298
subtest26of10,pubtest267of100,1,323,5247,7,83,5337
subtest28of10,pubtest267of100,1,323,5247,11,119,5377
subtest24of10,pubtest267of100,1,323,5247,13,158,5418
subtest25of10,pubtest267of100,1,323,5247,13,197,5457
subtest27of10,pubtest267of100,1,323,5247,17,233,5497
subtest22of10,pubtest267of100,1,323,5247,19,271,5537
subtest29of10,pubtest267of100,1,323,5247,19,310,5576
subtest210of10,pubtest267of100,1,323,5247,19,350,5616
subtest21of10,pubtest267of100,1,323,5247,25,385,5657
subtest23of10,pubtest268of100,1,323,5264,0,41,5305
subtest24of10,pubtest268of100,1,323,5264,3,77,5344
subtest25of10,pubtest268of100,1,323,5264,5,115,5384
subtest29of10,pubtest268of100,1,323,5264,8,152,5424
subtest28of10,pubtest268of100,1,323,5264,11,191,5466
subtest27of10,pubtest268of100,1,323,5264,11,230,5505
subtest21of10,pubtest268of100,1,323,5264,14,266,5544
subtest22of10,pubtest268of100,1,323,5264,19,301,5584
subtest26of10,pubtest268of100,1,323,5264,22,338,5624
subtest210of10,pubtest268of100,1,323,5264,22,378,5664
subtest24of10,pubtest269of100,1,323,5263,4,41,5308
subtest210of10,pubtest269of100,1,323,5263,5,80,5348
subtest27of10,pubtest269of100,1,323,5263,7,117,5387
subtest26of10,pubtest269of100,1,323,5263,9,156,5428
subtest25of10,pubtest269of100,1,323,5263,10,194,5467
subtest22of10,pubtest269of100,1,323,5263,18,226,5507
subtest21of10,pubtest269of100,1,323,5263,24,260,5547
subtest23of10,pubtest269of100,1,323,5263,32,292,5587
subtest28of10,pubtest269of100,1,323,5263,32,332,5627
subtest29of10,pubtest269of100,1,323,5263,30,371,5664
subtest26of10,pubtest270of100,1,323,5365,20,40,5425
subtest23of10,pubtest270of100,1,323,5365,20,79,5464
subtest27of10,pubtest270of100,1,323,5365,24,115,5504
subtest29of10,pubtest270of100,1,323,5365,26,151,5542
subtest21of10,pubtest270of100,1,323,5365,29,190,5584
subtest28of10,pubtest270of100,1,323,5365,30,230,5625
subtest210of10,pubtest270of100,1,323,5365,26,269,5660
subtest25of10,pubtest270of100,1,323,5365,31,308,5704
subtest24of10,pubtest270of100,1,323,5365,32,347,5744
subtest22of10,pubtest270of100,1,323,5365,38,381,5784
subtest24of10,pubtest271of100,1,323,5304,0,41,5345
subtest25of10,pubtest271of100,1,323,5304,0,77,5381
subtest22of10,pubtest271of100,1,323,5304,3,117,5424
subtest27of10,pubtest271of100,1,323,5304,8,152,5464
subtest210of10,pubtest271of100,1,323,5304,9,191,5504
subtest21of10,pubtest271of100,1,323,5304,11,228,5543
subtest26of10,pubtest271of100,1,323,5304,13,268,5585
subtest29of10,pubtest271of100,1,323,5304,12,307,5623
subtest28of10,pubtest271of100,1,323,5304,13,348,5665
subtest23of10,pubtest271of100,1,323,5304,12,387,5703
subtest25of10,pubtest272of100,1,323,5209,2,42,5253
subtest29of10,pubtest272of100,1,323,5209,4,79,5292
subtest21of10,pubtest272of100,1,323,5209,3,119,5331
subtest26of10,pubtest272of100,1,323,5209,2,159,5370
subtest23of10,pubtest272of100,1,323,5209,6,198,5413
subtest24of10,pubtest272of100,1,323,5209,9,234,5452
subtest210of10,pubtest272of100,1,323,5209,9,274,5492
subtest22of10,pubtest272of100,1,323,5209,11,310,5530
subtest27of10,pubtest272of100,1,323,5209,13,350,5572
subtest28of10,pubtest272of100,1,323,5209,16,387,5612
subtest22of10,pubtest273of100,1,321,5290,6,41,5337
subtest26of10,pubtest273of100,1,321,5290,7,80,5377
subtest29of10,pubtest273of100,1,321,5290,12,115,5417
subtest28of10,pubtest273of100,1,321,5290,24,143,5457
subtest210of10,pubtest273of100,1,321,5290,24,181,5495
subtest25of10,pubtest273of100,1,321,5290,27,220,5537
subtest27of10,pubtest273of100,1,321,5290,28,259,5577
subtest24of10,pubtest273of100,1,321,5290,29,298,5617
subtest23of10,pubtest273of100,1,321,5290,29,338,5657
subtest21of10,pubtest273of100,1,321,5290,34,373,5697
subtest26of10,pubtest274of100,1,323,5557,3,42,5602
subtest21of10,pubtest274of100,1,323,5557,0,81,5638
subtest29of10,pubtest274of100,1,323,5557,4,119,5680
subtest23of10,pubtest274of100,1,323,5557,5,160,5722
subtest22of10,pubtest274of100,1,323,5557,10,194,5761
subtest27of10,pubtest274of100,1,323,5557,13,230,5800
subtest25of10,pubtest274of100,1,323,5557,13,268,5838
subtest28of10,pubtest274of100,1,323,5557,15,308,5880
subtest24of10,pubtest274of100,1,323,5557,22,341,5920
subtest210of10,pubtest274of100,1,323,5557,23,380,5960
subtest27of10,pubtest275of100,1,323,5243,1,39,5283
subtest24of10,pubtest275of100,1,323,5243,2,77,5322
subtest29of10,pubtest275of100,1,323,5243,6,113,5362
subtest22of10,pubtest275of100,1,323,5243,13,146,5402
subtest25of10,pubtest275of100,1,323,5243,16,183,5442
subtest210of10,pubtest275of100,1,323,5243,19,220,5482
subtest23of10,pubtest275of100,1,323,5243,20,258,5521
subtest26of10,pubtest275of100,1,323,5243,23,296,5562
subtest21of10,pubtest275of100,1,323,5243,19,336,5598
subtest28of10,pubtest275of100,1,323,5243,25,374,5642
subtest28of10,pubtest276of100,1,323,5234,1,40,5275
subtest21of10,pubtest276of100,1,323,5234,4,76,5314
subtest24of10,pubtest276of100,1,323,5234,8,112,5354
subtest27of10,pubtest276of100,1,323,5234,12,148,5394
subtest25of10,pubtest276of100,1,323,5234,12,188,5434
subtest29of10,pubtest276of100,1,323,5234,15,225,5474
subtest26of10,pubtest276of100,1,323,5234,16,264,5514
subtest23of10,pubtest276of100,1,323,5234,17,305,5556
subtest22of10,pubtest276of100,1,323,5234,18,343,5595
subtest210of10,pubtest276of100,1,323,5234,18,382,5634
subtest22of10,pubtest277of100,1,323,5190,12,42,5244
subtest29of10,pubtest277of100,1,323,5190,12,81,5283
subtest28of10,pubtest277of100,1,323,5190,14,119,5323
subtest21of10,pubtest277of100,1,323,5190,19,154,5363
subtest24of10,pubtest277of100,1,323,5190,19,194,5403
subtest27of10,pubtest277of100,1,323,5190,21,232,5443
subtest210of10,pubtest277of100,1,323,5190,21,272,5483
subtest23of10,pubtest277of100,1,323,5190,22,311,5523
subtest26of10,pubtest277of100,1,323,5190,23,350,5563
subtest25of10,pubtest277of100,1,323,5190,22,387,5599
subtest29of10,pubtest278of100,1,323,5300,0,45,5345
subtest22of10,pubtest278of100,1,323,5300,0,84,5384
subtest23of10,pubtest278of100,1,323,5300,2,123,5425
subtest21of10,pubtest278of100,1,323,5300,4,161,5465
subtest28of10,pubtest278of100,1,323,5300,5,199,5504
subtest27of10,pubtest278of100,1,323,5300,12,232,5544
subtest26of10,pubtest278of100,1,323,5300,12,272,5584
subtest24of10,pubtest278of100,1,323,5300,13,311,5624
subtest210of10,pubtest278of100,1,323,5300,13,351,5664
subtest25of10,pubtest278of100,1,323,5300,15,390,5705
subtest25of10,pubtest279of100,1,323,5212,0,207,5419
subtest28of10,pubtest279of100,1,323,5212,1,242,5455
subtest24of10,pubtest279of100,1,323,5212,3,282,5497
subtest21of10,pubtest279of100,1,323,5212,11,315,5538
subtest29of10,pubtest279of100,1,323,5212,12,354,5578
subtest26of10,pubtest279of100,1,323,5212,16,389,5617
subtest23of10,pubtest279of100,1,323,5212,17,428,5657
subtest27of10,pubtest279of100,1,323,5212,16,467,5695
subtest22of10,pubtest279of100,1,323,5212,21,504,5737
subtest210of10,pubtest279of100,1,323,5212,23,542,5777
subtest27of10,pubtest280of100,1,323,5184,1,40,5225
subtest24of10,pubtest280of100,1,323,5184,4,77,5265
subtest21of10,pubtest280of100,1,323,5184,5,116,5305
subtest29of10,pubtest280of100,1,323,5184,3,156,5343
subtest26of10,pubtest280of100,1,323,5184,13,188,5385
subtest23of10,pubtest280of100,1,323,5184,13,228,5425
subtest210of10,pubtest280of100,1,323,5184,15,266,5465
subtest25of10,pubtest280of100,1,323,5184,16,304,5504
subtest22of10,pubtest280of100,1,323,5184,16,344,5544
subtest28of10,pubtest280of100,1,323,5184,19,382,5585
subtest24of10,pubtest281of100,1,323,5178,1,41,5220
subtest23of10,pubtest281of100,1,323,5178,5,76,5259
subtest27of10,pubtest281of100,1,323,5178,7,116,5301
subtest28of10,pubtest281of100,1,323,5178,6,155,5339
subtest25of10,pubtest281of100,1,323,5178,12,188,5378
subtest22of10,pubtest281of100,1,323,5178,12,228,5418
subtest210of10,pubtest281of100,1,323,5178,14,267,5459
subtest26of10,pubtest281of100,1,323,5178,19,302,5499
subtest21of10,pubtest281of100,1,323,5178,19,342,5539
subtest29of10,pubtest281of100,1,323,5178,22,381,5581
subtest23of10,pubtest282of100,1,323,5292,1,40,5333
subtest21of10,pubtest282of100,1,323,5292,5,76,5373
subtest24of10,pubtest282of100,1,323,5292,5,116,5413
subtest25of10,pubtest282of100,1,323,5292,16,144,5452
subtest29of10,pubtest282of100,1,323,5292,18,182,5492
subtest27of10,pubtest282of100,1,323,5292,19,221,5532
subtest26of10,pubtest282of100,1,323,5292,22,258,5572
subtest22of10,pubtest282of100,1,323,5292,22,298,5612
subtest210of10,pubtest282of100,1,323,5292,24,336,5652
subtest28of10,pubtest282of100,1,323,5292,24,376,5692
subtest24of10,pubtest283of100,1,323,5289,1,40,5330
subtest23of10,pubtest283of100,1,323,5289,3,78,5370
subtest27of10,pubtest283of100,1,323,5289,4,118,5411
subtest22of10,pubtest283of100,1,323,5289,14,147,5450
subtest25of10,pubtest283of100,1,323,5289,18,183,5490
subtest28of10,pubtest283of100,1,323,5289,20,221,5530
subtest21of10,pubtest283of100,1,323,5289,22,259,5570
subtest210of10,pubtest283of100,1,323,5289,24,297,5610
subtest29of10,pubtest283of100,1,323,5289,24,336,5649
subtest26of10,pubtest283of100,1,323,5289,28,373,5690
subtest25of10,pubtest284of100,1,323,5258,5,42,5305
subtest22of10,pubtest284of100,1,323,5258,6,78,5342
subtest29of10,pubtest284of100,1,323,5258,8,117,5383
subtest210of10,pubtest284of100,1,323,5258,8,155,5421
subtest23of10,pubtest284of100,1,323,5258,10,195,5463
subtest27of10,pubtest284of100,1,323,5258,10,234,5502
subtest24of10,pubtest284of100,1,323,5258,15,273,5546
subtest28of10,pubtest284of100,1,323,5258,18,309,5585
subtest21of10,pubtest284of100,1,323,5258,18,348,5624
subtest26of10,pubtest284of100,1,323,5258,35,371,5664
subtest23of10,pubtest285of100,1,323,5419,2,39,5460
subtest25of10,pubtest285of100,1,323,5419,3,77,5499
subtest27of10,pubtest285of100,1,323,5419,5,115,5539
subtest24of10,pubtest285of100,1,323,5419,10,150,5579
subtest21of10,pubtest285of100,1,323,5419,12,188,5619
subtest22of10,pubtest285of100,1,323,5419,15,225,5659
subtest29of10,pubtest285of100,1,323,5419,16,263,5698
subtest210of10,pubtest285of100,1,323,5419,19,301,5739
subtest28of10,pubtest285of100,1,323,5419,19,341,5779
subtest26of10,pubtest285of100,1,323,5419,21,379,5819
subtest23of10,pubtest286of100,1,323,5276,-1,42,5317
subtest210of10,pubtest286of100,1,323,5276,2,78,5356
subtest25of10,pubtest286of100,1,323,5276,3,116,5395
subtest24of10,pubtest286of100,1,323,5276,7,153,5436
subtest26of10,pubtest286of100,1,323,5276,10,190,5476
subtest29of10,pubtest286of100,1,323,5276,11,230,5517
subtest21of10,pubtest286of100,1,323,5276,14,266,5556
subtest27of10,pubtest286of100,1,323,5276,14,306,5596
subtest22of10,pubtest286of100,1,323,5276,17,343,5636
subtest28of10,pubtest286of100,1,323,5276,20,380,5676
subtest26of10,pubtest287of100,1,323,5190,0,39,5229
subtest29of10,pubtest287of100,1,323,5190,1,77,5268
subtest28of10,pubtest287of100,1,323,5190,3,115,5308
subtest210of10,pubtest287of100,1,323,5190,12,146,5348
subtest25of10,pubtest287of100,1,323,5190,16,182,5388
subtest24of10,pubtest287of100,1,323,5190,17,221,5428
subtest27of10,pubtest287of100,1,323,5190,16,261,5467
subtest21of10,pubtest287of100,1,323,5190,19,297,5506
subtest22of10,pubtest287of100,1,323,5190,19,337,5546
subtest23of10,pubtest287of100,1,323,5190,19,377,5586
subtest29of10,pubtest288of100,1,323,5244,-3,42,5283
subtest25of10,pubtest288of100,1,323,5244,-1,80,5323
subtest27of10,pubtest288of100,1,323,5244,0,118,5362
subtest21of10,pubtest288of100,1,323,5244,1,156,5401
subtest23of10,pubtest288of100,1,323,5244,1,195,5440
subtest26of10,pubtest288of100,1,323,5244,45,193,5482
subtest210of10,pubtest288of100,1,323,5244,48,230,5522
subtest22of10,pubtest288of100,1,323,5244,48,269,5561
subtest24of10,pubtest288of100,1,323,5244,50,308,5602
subtest28of10,pubtest288of100,1,323,5244,53,346,5643
subtest29of10,pubtest289of100,1,323,5235,0,41,5276
subtest210of10,pubtest289of100,1,323,5235,4,76,5315
subtest23of10,pubtest289of100,1,323,5235,5,116,5356
subtest24of10,pubtest289of100,1,323,5235,6,155,5396
subtest25of10,pubtest289of100,1,323,5235,6,195,5436
subtest26of10,pubtest289of100,1,323,5235,11,230,5476
subtest27of10,pubtest289of100,1,323,5235,11,270,5516
subtest28of10,pubtest289of100,1,323,5235,14,307,5556
subtest22of10,pubtest289of100,1,323,5235,16,343,5594
subtest21of10,pubtest289of100,1,323,5235,16,383,5634
subtest29of10,pubtest290of100,1,323,5205,2,39,5246
subtest23of10,pubtest290of100,1,323,5205,4,76,5285
subtest22of10,pubtest290of100,1,323,5205,4,116,5325
subtest26of10,pubtest290of100,1,323,5205,9,151,5365
subtest25of10,pubtest290of100,1,323,5205,9,189,5403
subtest210of10,pubtest290of100,1,323,5205,16,224,5445
subtest21of10,pubtest290of100,1,323,5205,19,261,5485
subtest27of10,pubtest290of100,1,323,5205,19,301,5525
subtest24of10,pubtest290of100,1,323,5205,21,340,5566
subtest28of10,pubtest290of100,1,323,5205,21,378,5604
subtest24of10,pubtest291of100,1,323,5295,8,40,5343
subtest28of10,pubtest291of100,1,323,5295,8,81,5384
subtest210of10,pubtest291of100,1,323,5295,9,120,5424
subtest23of10,pubtest291of100,1,323,5295,8,159,5462
subtest27of10,pubtest291of100,1,323,5295,8,198,5501
subtest21of10,pubtest291of100,1,323,5295,13,236,5544
subtest22of10,pubtest291of100,1,323,5295,17,272,5584
subtest25of10,pubtest291of100,1,323,5295,26,304,5625
subtest26of10,pubtest291of100,1,323,5295,27,340,5662
subtest29of10,pubtest291of100,1,323,5295,27,380,5702
subtest28of10,pubtest292of100,1,323,5500,3,49,5552
subtest21of10,pubtest292of100,1,323,5500,5,86,5591
subtest27of10,pubtest292of100,1,323,5500,8,124,5632
subtest25of10,pubtest292of100,1,323,5500,10,161,5671
subtest29of10,pubtest292of100,1,323,5500,7,204,5711
subtest26of10,pubtest292of100,1,323,5500,15,236,5751
subtest23of10,pubtest292of100,1,323,5500,15,276,5791
subtest22of10,pubtest292of100,1,323,5500,16,315,5831
subtest24of10,pubtest292of100,1,323,5500,32,339,5871
subtest210of10,pubtest292of100,1,323,5500,32,379,5911
subtest24of10,pubtest293of100,1,323,5422,7,40,5469
subtest25of10,pubtest293of100,1,323,5422,8,78,5508
subtest28of10,pubtest293of100,1,323,5422,16,109,5547
subtest210of10,pubtest293of100,1,323,5422,19,148,5589
subtest23of10,pubtest293of100,1,323,5422,20,188,5630
subtest21of10,pubtest293of100,1,323,5422,21,226,5669
subtest22of10,pubtest293of100,1,323,5422,21,266,5709
subtest26of10,pubtest293of100,1,323,5422,22,305,5749
subtest27of10,pubtest293of100,1,323,5422,24,343,5789
subtest29of10,pubtest293of100,1,323,5422,22,385,5829
subtest21of10,pubtest294of100,1,323,5342,2,43,5387
subtest25of10,pubtest294of100,1,323,5342,3,81,5426
subtest210of10,pubtest294of100,1,323,5342,9,117,5468
subtest29of10,pubtest294of100,1,323,5342,13,152,5507
subtest27of10,pubtest294of100,1,323,5342,13,191,5546
subtest26of10,pubtest294of100,1,323,5342,18,225,5585
subtest23of10,pubtest294of100,1,323,5342,18,265,5625
subtest28of10,pubtest294of100,1,323,5342,23,301,5666
subtest24of10,pubtest294of100,1,323,5342,22,341,5705
subtest22of10,pubtest294of100,1,323,5342,22,380,5744
subtest25of10,pubtest295of100,1,323,5233,8,44,5285
subtest23of10,pubtest295of100,1,323,5233,9,82,5324
subtest24of10,pubtest295of100,1,323,5233,10,120,5363
subtest27of10,pubtest295of100,1,323,5233,12,159,5404
subtest22of10,pubtest295of100,1,323,5233,14,197,5444
subtest29of10,pubtest295of100,1,323,5233,17,234,5484
subtest210of10,pubtest295of100,1,323,5233,17,274,5524
subtest28of10,pubtest295of100,1,323,5233,19,312,5564
subtest21of10,pubtest295of100,1,323,5233,19,352,5604
subtest26of10,pubtest295of100,1,323,5233,19,389,5641
subtest25of10,pubtest296of100,1,322,5369,26,40,5435
subtest24of10,pubtest296of100,1,322,5369,27,77,5473
subtest27of10,pubtest296of100,1,322,5369,29,117,5515
subtest23of10,pubtest296of100,1,322,5369,30,155,5554
subtest26of10,pubtest296of100,1,322,5369,29,195,5593
subtest21of10,pubtest296of100,1,322,5369,33,230,5632
subtest28of10,pubtest296of100,1,322,5369,36,269,5674
subtest29of10,pubtest296of100,1,322,5369,32,309,5710
subtest210of10,pubtest296of100,1,322,5369,35,349,5753
subtest22of10,pubtest296of100,1,322,5369,35,388,5792
subtest25of10,pubtest297of100,1,323,5338,20,50,5408
subtest210of10,pubtest297of100,1,323,5338,20,91,5449
subtest29of10,pubtest297of100,1,323,5338,22,128,5488
subtest22of10,pubtest297of100,1,323,5338,23,164,5525
subtest23of10,pubtest297of100,1,323,5338,69,161,5568
subtest27of10,pubtest297of100,1,323,5338,69,201,5608
subtest26of10,pubtest297of100,1,323,5338,70,239,5647
subtest21of10,pubtest297of100,1,323,5338,73,277,5688
subtest28of10,pubtest297of100,1,323,5338,74,316,5728
subtest24of10,pubtest297of100,1,323,5338,76,354,5768
subtest29of10,pubtest298of100,1,323,5160,4,40,5204
subtest22of10,pubtest298of100,1,323,5160,5,77,5242
subtest25of10,pubtest298of100,1,323,5160,6,116,5282
subtest24of10,pubtest298of100,1,323,5160,9,153,5322
subtest23of10,pubtest298of100,1,323,5160,11,192,5363
subtest21of10,pubtest298of100,1,323,5160,17,225,5402
subtest28of10,pubtest298of100,1,323,5160,18,266,5444
subtest27of10,pubtest298of100,1,323,5160,18,305,5483
subtest26of10,pubtest298of100,1,323,5160,20,342,5522
subtest210of10,pubtest298of100,1,323,5160,20,382,5562
subtest22of10,pubtest299of100,1,323,5372,1,40,5413
subtest210of10,pubtest299of100,1,323,5372,3,77,5452
subtest29of10,pubtest299of100,1,323,5372,2,117,5491
subtest27of10,pubtest299of100,1,323,5372,6,154,5532
subtest24of10,pubtest299of100,1,323,5372,13,187,5572
subtest23of10,pubtest299of100,1,323,5372,16,224,5612
subtest25of10,pubtest299of100,1,323,5372,17,262,5651
subtest21of10,pubtest299of100,1,323,5372,18,302,5692
subtest28of10,pubtest299of100,1,323,5372,19,336,5727
subtest26of10,pubtest299of100,1,323,5372,24,375,5771
subtest21of10,pubtest2100of100,1,325,5322,2,41,5365
subtest24of10,pubtest2100of100,1,325,5322,3,79,5404
subtest29of10,pubtest2100of100,1,325,5322,5,117,5444
subtest22of10,pubtest2100of100,1,325,5322,7,155,5484
subtest23of10,pubtest2100of100,1,325,5322,7,196,5525
subtest27of10,pubtest2100of100,1,325,5322,10,232,5564
subtest25of10,pubtest2100of100,1,325,5322,14,269,5605
subtest28of10,pubtest2100of100,1,325,5322,15,308,5645
subtest210of10,pubtest2100of100,1,325,5322,16,346,5684
subtest26of10,pubtest2100of100,1,325,5322,20,383,5725
subtest27of10,pubtest21of100,1,322,10370,0,40,10410
subtest29of10,pubtest21of100,1,322,10370,3,75,10448
subtest24of10,pubtest21of100,1,322,10370,5,114,10489
subtest26of10,pubtest21of100,1,322,10370,2,153,10525
subtest210of10,pubtest21of100,1,322,10370,6,193,10569
subtest21of10,pubtest21of100,1,322,10370,13,226,10609
subtest25of10,pubtest21of100,1,322,10370,14,266,10650
subtest28of10,pubtest21of100,1,322,10370,13,304,10687
subtest22of10,pubtest21of100,1,322,10370,15,346,10731
subtest23of10,pubtest21of100,1,322,10370,16,384,10770
subtest29of10,pubtest22of100,1,321,5204,-2,38,5240
subtest27of10,pubtest22of100,1,321,5204,-2,77,5279
subtest23of10,pubtest22of100,1,321,5204,3,113,5320
subtest25of10,pubtest22of100,1,321,5204,5,152,5361
subtest21of10,pubtest22of100,1,321,5204,91,105,5400
subtest24of10,pubtest22of100,1,321,5204,93,142,5439
subtest28of10,pubtest22of100,1,321,5204,96,179,5479
subtest26of10,pubtest22of100,1,321,5204,101,214,5519
subtest210of10,pubtest22of100,1,321,5204,103,252,5559
subtest22of10,pubtest22of100,1,321,5204,104,292,5600
subtest23of10,pubtest23of100,1,321,5195,3,42,5240
subtest29of10,pubtest23of100,1,321,5195,6,78,5279
subtest28of10,pubtest23of100,1,321,5195,6,117,5318
subtest24of10,pubtest23of100,1,321,5195,9,154,5358
subtest27of10,pubtest23of100,1,321,5195,16,187,5398
subtest26of10,pubtest23of100,1,321,5195,17,226,5438
subtest25of10,pubtest23of100,1,321,5195,17,265,5477
subtest22of10,pubtest23of100,1,321,5195,72,251,5518
subtest21of10,pubtest23of100,1,321,5195,70,291,5556
subtest210of10,pubtest23of100,1,321,5195,73,330,5598
subtest23of10,pubtest24of100,1,321,5273,5,40,5318
subtest25of10,pubtest24of100,1,321,5273,13,71,5357
subtest27of10,pubtest24of100,1,321,5273,15,108,5396
subtest24of10,pubtest24of100,1,321,5273,14,146,5433
subtest22of10,pubtest24of100,1,321,5273,17,186,5476
subtest210of10,pubtest24of100,1,321,5273,16,225,5514
subtest28of10,pubtest24of100,1,321,5273,20,264,5557
subtest21of10,pubtest24of100,1,321,5273,16,304,5593
subtest26of10,pubtest24of100,1,321,5273,20,342,5635
subtest29of10,pubtest24of100,1,321,5273,20,382,5675
subtest21of10,pubtest25of100,1,321,5173,16,43,5232
subtest28of10,pubtest25of100,1,321,5173,16,83,5272
subtest27of10,pubtest25of100,1,321,5173,19,119,5311
subtest210of10,pubtest25of100,1,321,5173,18,158,5349
subtest25of10,pubtest25of100,1,321,5173,26,192,5391
subtest23of10,pubtest25of100,1,321,5173,49,209,5431
subtest26of10,pubtest25of100,1,321,5173,49,249,5471
subtest22of10,pubtest25of100,1,321,5173,51,287,5511
subtest29of10,pubtest25of100,1,321,5173,50,328,5551
subtest24of10,pubtest25of100,1,321,5173,55,363,5591
subtest22of10,pubtest26of100,1,321,5167,23,44,5234
subtest21of10,pubtest26of100,1,321,5167,25,81,5273
subtest29of10,pubtest26of100,1,321,5167,25,121,5313
subtest27of10,pubtest26of100,1,321,5167,26,160,5353
subtest23of10,pubtest26of100,1,321,5167,27,199,5393
subtest26of10,pubtest26of100,1,321,5167,27,239,5433
subtest25of10,pubtest26of100,1,321,5167,29,277,5473
subtest28of10,pubtest26of100,1,321,5167,30,316,5513
subtest210of10,pubtest26of100,1,321,5167,31,355,5553
subtest24of10,pubtest26of100,1,321,5167,32,394,5593
subtest27of10,pubtest27of100,1,320,5440,1,38,5479
subtest28of10,pubtest27of100,1,320,5440,2,77,5519
subtest24of10,pubtest27of100,1,320,5440,5,113,5558
subtest23of10,pubtest27of100,1,320,5440,6,153,5599
subtest29of10,pubtest27of100,1,320,5440,9,190,5639
subtest210of10,pubtest27of100,1,320,5440,10,226,5676
subtest25of10,pubtest27of100,1,320,5440,10,266,5716
subtest22of10,pubtest27of100,1,320,5440,14,305,5759
subtest21of10,pubtest27of100,1,320,5440,19,340,5799
subtest26of10,pubtest27of100,1,320,5440,21,378,5839
subtest27of10,pubtest28of100,1,321,5473,2,41,5516
subtest21of10,pubtest28of100,1,321,5473,9,73,5555
subtest28of10,pubtest28of100,1,321,5473,10,112,5595
subtest29of10,pubtest28of100,1,321,5473,13,149,5635
subtest23of10,pubtest28of100,1,321,5473,13,189,5675
subtest25of10,pubtest28of100,1,321,5473,14,227,5714
subtest210of10,pubtest28of100,1,321,5473,15,267,5755
subtest24of10,pubtest28of100,1,321,5473,18,304,5795
subtest26of10,pubtest28of100,1,321,5473,18,345,5836
subtest22of10,pubtest28of100,1,321,5473,19,383,5875
subtest23of10,pubtest29of100,1,321,5220,4,46,5270
subtest210of10,pubtest29of100,1,321,5220,5,84,5309
subtest29of10,pubtest29of100,1,321,5220,7,122,5349
subtest25of10,pubtest29of100,1,321,5220,8,161,5389
subtest22of10,pubtest29of100,1,321,5220,9,200,5429
subtest21of10,pubtest29of100,1,321,5220,9,240,5469
subtest27of10,pubtest29of100,1,321,5220,11,278,5509
subtest28of10,pubtest29of100,1,321,5220,12,317,5549
subtest26of10,pubtest29of100,1,321,5220,15,354,5589
subtest24of10,pubtest29of100,1,321,5220,15,394,5629
subtest29of10,pubtest210of100,1,323,5292,2,41,5335
subtest21of10,pubtest210of100,1,323,5292,5,77,5374
subtest27of10,pubtest210of100,1,323,5292,11,110,5413
subtest210of10,pubtest210of100,1,323,5292,12,149,5453
subtest28of10,pubtest210of100,1,323,5292,14,185,5491
subtest26of10,pubtest210of100,1,323,5292,17,224,5533
subtest22of10,pubtest210of100,1,323,5292,19,262,5573
subtest24of10,pubtest210of100,1,323,5292,19,302,5613
subtest23of10,pubtest210of100,1,323,5292,14,342,5648
subtest25of10,pubtest210of100,1,323,5292,19,381,5692
subtest210of10,pubtest211of100,1,323,5277,1,45,5323
subtest24of10,pubtest211of100,1,323,5277,3,82,5362
subtest22of10,pubtest211of100,1,323,5277,8,117,5402
subtest29of10,pubtest211of100,1,323,5277,8,157,5442
subtest21of10,pubtest211of100,1,323,5277,10,195,5482
subtest25of10,pubtest211of100,1,323,5277,28,219,5524
subtest26of10,pubtest211of100,1,323,5277,29,257,5563
subtest23of10,pubtest211of100,1,323,5277,30,295,5602
subtest28of10,pubtest211of100,1,323,5277,32,333,5642
subtest27of10,pubtest211of100,1,323,5277,31,373,5681
subtest25of10,pubtest212of100,1,323,5173,0,42,5215
subtest28of10,pubtest212of100,1,323,5173,1,80,5254
subtest29of10,pubtest212of100,1,323,5173,8,112,5293
subtest24of10,pubtest212of100,1,323,5173,10,150,5333
subtest23of10,pubtest212of100,1,323,5173,15,185,5373
subtest22of10,pubtest212of100,1,323,5173,37,203,5413
subtest26of10,pubtest212of100,1,323,5173,39,241,5453
subtest27of10,pubtest212of100,1,323,5173,39,281,5493
subtest21of10,pubtest212of100,1,323,5173,40,317,5530
subtest210of10,pubtest212of100,1,323,5173,43,357,5573
subtest23of10,pubtest213of100,1,322,5252,-1,90,5341
subtest26of10,pubtest213of100,1,322,5252,3,125,5380
subtest29of10,pubtest213of100,1,322,5252,3,165,5420
subtest22of10,pubtest213of100,1,322,5252,4,205,5461
subtest27of10,pubtest213of100,1,322,5252,8,239,5499
subtest21of10,pubtest213of100,1,322,5252,10,278,5540
subtest24of10,pubtest213of100,1,322,5252,11,317,5580
subtest210of10,pubtest213of100,1,322,5252,16,353,5621
subtest25of10,pubtest213of100,1,322,5252,17,390,5659
subtest28of10,pubtest213of100,1,322,5252,20,428,5700
subtest21of10,pubtest214of100,1,323,5195,1,42,5238
subtest23of10,pubtest214of100,1,323,5195,9,72,5276
subtest25of10,pubtest214of100,1,323,5195,10,111,5316
subtest26of10,pubtest214of100,1,323,5195,10,150,5355
subtest27of10,pubtest214of100,1,323,5195,11,189,5395
subtest29of10,pubtest214of100,1,323,5195,13,227,5435
subtest22of10,pubtest214of100,1,323,5195,13,267,5475
subtest24of10,pubtest214of100,1,323,5195,14,306,5515
subtest28of10,pubtest214of100,1,323,5195,15,346,5556
subtest210of10,pubtest214of100,1,323,5195,16,384,5595
subtest24of10,pubtest215of100,1,323,5188,2,43,5233
subtest27of10,pubtest215of100,1,323,5188,2,82,5272
subtest29of10,pubtest215of100,1,323,5188,5,119,5312
subtest26of10,pubtest215of100,1,323,5188,5,159,5352
subtest210of10,pubtest215of100,1,323,5188,7,197,5392
subtest21of10,pubtest215of100,1,323,5188,9,235,5432
subtest22of10,pubtest215of100,1,323,5188,15,269,5472
subtest28of10,pubtest215of100,1,323,5188,15,309,5512
subtest23of10,pubtest215of100,1,323,5188,17,347,5552
subtest25of10,pubtest215of100,1,323,5188,16,386,5590
subtest24of10,pubtest216of100,1,323,5188,34,42,5264
subtest27of10,pubtest216of100,1,323,5188,36,77,5301
subtest25of10,pubtest216of100,1,323,5188,38,116,5342
subtest29of10,pubtest216of100,1,323,5188,38,155,5381
subtest26of10,pubtest216of100,1,323,5188,40,195,5423
subtest210of10,pubtest216of100,1,323,5188,41,234,5463
subtest21of10,pubtest216of100,1,323,5188,35,273,5496
subtest28of10,pubtest216of100,1,323,5188,38,314,5540
subtest22of10,pubtest216of100,1,323,5188,38,354,5580
subtest23of10,pubtest216of100,1,323,5188,35,392,5615
subtest27of10,pubtest217of100,1,322,5188,6,39,5233
subtest22of10,pubtest217of100,1,322,5188,10,75,5273
subtest21of10,pubtest217of100,1,322,5188,9,115,5312
subtest26of10,pubtest217of100,1,322,5188,11,155,5354
subtest23of10,pubtest217of100,1,322,5188,11,194,5393
subtest29of10,pubtest217of100,1,322,5188,13,232,5433
subtest25of10,pubtest217of100,1,322,5188,13,271,5472
subtest28of10,pubtest217of100,1,322,5188,18,307,5513
subtest24of10,pubtest217of100,1,322,5188,18,347,5553
subtest210of10,pubtest217of100,1,322,5188,22,383,5593
subtest29of10,pubtest218of100,1,323,5199,4,41,5244
subtest22of10,pubtest218of100,1,323,5199,5,78,5282
subtest21of10,pubtest218of100,1,323,5199,6,118,5323
subtest27of10,pubtest218of100,1,323,5199,10,154,5363
subtest28of10,pubtest218of100,1,323,5199,10,194,5403
subtest23of10,pubtest218of100,1,323,5199,18,226,5443
subtest24of10,pubtest218of100,1,323,5199,18,266,5483
subtest25of10,pubtest218of100,1,323,5199,20,304,5523
subtest26of10,pubtest218of100,1,323,5199,25,339,5563
subtest210of10,pubtest218of100,1,323,5199,25,379,5603
subtest210of10,pubtest219of100,1,323,5294,2,40,5336
subtest26of10,pubtest219of100,1,323,5294,6,76,5376
subtest25of10,pubtest219of100,1,323,5294,7,115,5416
subtest21of10,pubtest219of100,1,323,5294,8,154,5456
subtest22of10,pubtest219of100,1,323,5294,8,194,5496
subtest24of10,pubtest219of100,1,323,5294,18,224,5536
subtest29of10,pubtest219of100,1,323,5294,19,263,5576
subtest23of10,pubtest219of100,1,323,5294,25,297,5616
subtest27of10,pubtest219of100,1,323,5294,26,336,5656
subtest28of10,pubtest219of100,1,323,5294,27,375,5696
subtest25of10,pubtest220of100,1,323,5194,1,44,5239
subtest23of10,pubtest220of100,1,323,5194,10,72,5276
subtest210of10,pubtest220of100,1,323,5194,10,112,5316
subtest29of10,pubtest220of100,1,323,5194,12,151,5357
subtest21of10,pubtest220of100,1,323,5194,33,169,5396
subtest27of10,pubtest220of100,1,323,5194,40,202,5436
subtest28of10,pubtest220of100,1,323,5194,40,240,5474
subtest24of10,pubtest220of100,1,323,5194,40,279,5513
subtest22of10,pubtest220of100,1,323,5194,44,318,5556
subtest26of10,pubtest220of100,1,323,5194,44,358,5596
subtest24of10,pubtest221of100,1,323,5327,3,39,5369
subtest28of10,pubtest221of100,1,323,5327,14,65,5406
subtest21of10,pubtest221of100,1,323,5327,14,106,5447
subtest23of10,pubtest221of100,1,323,5327,19,142,5488
subtest25of10,pubtest221of100,1,323,5327,22,179,5528
subtest22of10,pubtest221of100,1,323,5327,22,219,5568
subtest210of10,pubtest221of100,1,323,5327,23,258,5608
subtest26of10,pubtest221of100,1,323,5327,24,298,5649
subtest29of10,pubtest221of100,1,323,5327,24,337,5688
subtest27of10,pubtest221of100,1,323,5327,26,375,5728
subtest21of10,pubtest222of100,1,323,5276,6,42,5324
subtest22of10,pubtest222of100,1,323,5276,8,79,5363
subtest29of10,pubtest222of100,1,323,5276,10,117,5403
subtest27of10,pubtest222of100,1,323,5276,24,144,5444
subtest23of10,pubtest222of100,1,323,5276,26,181,5483
subtest28of10,pubtest222of100,1,323,5276,26,221,5523
subtest25of10,pubtest222of100,1,323,5276,27,260,5563
subtest210of10,pubtest222of100,1,323,5276,27,300,5603
subtest26of10,pubtest222of100,1,323,5276,29,337,5642
subtest24of10,pubtest222of100,1,323,5276,33,374,5683
subtest23of10,pubtest223of100,1,323,5195,21,43,5259
subtest21of10,pubtest223of100,1,323,5195,21,82,5298
subtest29of10,pubtest223of100,1,323,5195,29,112,5336
subtest28of10,pubtest223of100,1,323,5195,29,151,5375
subtest24of10,pubtest223of100,1,323,5195,31,190,5416
subtest210of10,pubtest223of100,1,323,5195,33,229,5457
subtest26of10,pubtest223of100,1,323,5195,33,269,5497
subtest25of10,pubtest223of100,1,323,5195,34,308,5537
subtest27of10,pubtest223of100,1,323,5195,36,346,5577
subtest22of10,pubtest223of100,1,323,5195,35,386,5616
subtest21of10,pubtest224of100,1,323,5260,4,38,5302
subtest28of10,pubtest224of100,1,323,5260,7,74,5341
subtest27of10,pubtest224of100,1,323,5260,12,109,5381
subtest23of10,pubtest224of100,1,323,5260,14,147,5421
subtest26of10,pubtest224of100,1,323,5260,16,185,5461
subtest29of10,pubtest224of100,1,323,5260,16,225,5501
subtest25of10,pubtest224of100,1,323,5260,18,263,5541
subtest22of10,pubtest224of100,1,323,5260,18,303,5581
subtest24of10,pubtest224of100,1,323,5260,22,339,5621
subtest210of10,pubtest224of100,1,323,5260,26,374,5660
subtest22of10,pubtest225of100,1,323,5277,0,41,5318
subtest27of10,pubtest225of100,1,323,5277,0,81,5358
subtest21of10,pubtest225of100,1,323,5277,3,117,5397
subtest26of10,pubtest225of100,1,323,5277,7,153,5437
subtest25of10,pubtest225of100,1,323,5277,7,193,5477
subtest23of10,pubtest225of100,1,323,5277,10,229,5516
subtest24of10,pubtest225of100,1,323,5277,14,266,5557
subtest29of10,pubtest225of100,1,323,5277,16,304,5597
subtest28of10,pubtest225of100,1,323,5277,17,343,5637
subtest210of10,pubtest225of100,1,323,5277,18,382,5677
subtest27of10,pubtest226of100,1,323,5232,6,46,5284
subtest22of10,pubtest226of100,1,323,5232,7,86,5325
subtest210of10,pubtest226of100,1,323,5232,7,126,5365
subtest21of10,pubtest226of100,1,323,5232,9,163,5404
subtest28of10,pubtest226of100,1,323,5232,10,202,5444
subtest23of10,pubtest226of100,1,323,5232,6,241,5479
subtest25of10,pubtest226of100,1,323,5232,3,280,5515
subtest29of10,pubtest226of100,1,323,5232,18,314,5564
subtest26of10,pubtest226of100,1,323,5232,25,347,5604
subtest24of10,pubtest226of100,1,323,5232,25,387,5644
subtest29of10,pubtest227of100,1,323,5426,5,43,5474
subtest24of10,pubtest227of100,1,323,5426,7,81,5514
subtest210of10,pubtest227of100,1,323,5426,7,120,5553
subtest26of10,pubtest227of100,1,323,5426,13,155,5594
subtest25of10,pubtest227of100,1,323,5426,16,192,5634
subtest23of10,pubtest227of100,1,323,5426,16,232,5674
subtest21of10,pubtest227of100,1,323,5426,19,268,5713
subtest22of10,pubtest227of100,1,323,5426,18,308,5752
subtest27of10,pubtest227of100,1,323,5426,19,347,5792
subtest28of10,pubtest227of100,1,323,5426,23,385,5834
subtest21of10,pubtest228of100,1,323,5194,4,40,5238
subtest25of10,pubtest228of100,1,323,5194,7,74,5275
subtest27of10,pubtest228of100,1,323,5194,10,113,5317
subtest23of10,pubtest228of100,1,323,5194,8,153,5355
subtest26of10,pubtest228of100,1,323,5194,11,192,5397
subtest29of10,pubtest228of100,1,323,5194,24,219,5437
subtest24of10,pubtest228of100,1,323,5194,27,256,5477
subtest210of10,pubtest228of100,1,323,5194,28,294,5516
subtest22of10,pubtest228of100,1,323,5194,29,334,5557
subtest28of10,pubtest228of100,1,323,5194,30,373,5597
subtest24of10,pubtest229of100,1,321,5234,0,39,5273
subtest21of10,pubtest229of100,1,321,5234,9,69,5312
subtest22of10,pubtest229of100,1,321,5234,10,108,5352
subtest28of10,pubtest229of100,1,321,5234,9,148,5391
subtest27of10,pubtest229of100,1,321,5234,9,187,5430
subtest210of10,pubtest229of100,1,321,5234,14,221,5469
subtest26of10,pubtest229of100,1,321,5234,15,261,5510
subtest23of10,pubtest229of100,1,321,5234,13,299,5546
subtest29of10,pubtest229of100,1,321,5234,19,339,5592
subtest25of10,pubtest229of100,1,321,5234,13,380,5627
subtest21of10,pubtest230of100,1,323,5274,2,40,5316
subtest22of10,pubtest230of100,1,323,5274,2,79,5355
subtest27of10,pubtest230of100,1,323,5274,4,121,5399
subtest23of10,pubtest230of100,1,323,5274,8,157,5439
subtest29of10,pubtest230of100,1,323,5274,5,196,5475
subtest210of10,pubtest230of100,1,323,5274,9,235,5518
subtest28of10,pubtest230of100,1,323,5274,7,274,5555
subtest25of10,pubtest230of100,1,323,5274,11,313,5598
subtest24of10,pubtest230of100,1,323,5274,12,354,5640
subtest26of10,pubtest230of100,1,323,5274,11,393,5678
subtest23of10,pubtest231of100,1,323,5287,42,41,5370
subtest25of10,pubtest231of100,1,323,5287,44,78,5409
subtest28of10,pubtest231of100,1,323,5287,44,119,5450
subtest24of10,pubtest231of100,1,323,5287,49,153,5489
subtest26of10,pubtest231of100,1,323,5287,52,190,5529
subtest210of10,pubtest231of100,1,323,5287,52,230,5569
subtest22of10,pubtest231of100,1,323,5287,57,265,5609
subtest29of10,pubtest231of100,1,323,5287,59,303,5649
subtest27of10,pubtest231of100,1,323,5287,60,340,5687
subtest21of10,pubtest231of100,1,323,5287,62,380,5729
subtest21of10,pubtest232of100,1,323,5276,3,38,5317
subtest27of10,pubtest232of100,1,323,5276,4,77,5357
subtest22of10,pubtest232of100,1,323,5276,7,113,5396
subtest23of10,pubtest232of100,1,323,5276,12,147,5435
subtest28of10,pubtest232of100,1,323,5276,14,187,5477
subtest29of10,pubtest232of100,1,323,5276,12,225,5513
subtest25of10,pubtest232of100,1,323,5276,16,264,5556
subtest210of10,pubtest232of100,1,323,5276,18,302,5596
subtest24of10,pubtest232of100,1,323,5276,18,342,5636
subtest26of10,pubtest232of100,1,323,5276,19,381,5676
subtest29of10,pubtest233of100,1,323,5199,6,41,5246
subtest24of10,pubtest233of100,1,323,5199,6,80,5285
subtest25of10,pubtest233of100,1,323,5199,8,118,5325
subtest26of10,pubtest233of100,1,323,5199,86,80,5365
subtest23of10,pubtest233of100,1,323,5199,87,118,5404
subtest21of10,pubtest233of100,1,323,5199,88,157,5444
subtest22of10,pubtest233of100,1,323,5199,88,197,5484
subtest210of10,pubtest233of100,1,323,5199,90,235,5524
subtest27of10,pubtest233of100,1,323,5199,90,275,5564
subtest28of10,pubtest233of100,1,323,5199,94,311,5604
subtest25of10,pubtest234of100,1,323,5381,0,41,5422
subtest26of10,pubtest234of100,1,323,5381,2,77,5460
subtest27of10,pubtest234of100,1,323,5381,2,117,5500
subtest22of10,pubtest234of100,1,323,5381,4,155,5540
subtest29of10,pubtest234of100,1,323,5381,4,195,5580
subtest21of10,pubtest234of100,1,323,5381,6,232,5619
subtest23of10,pubtest234of100,1,323,5381,20,259,5660
subtest210of10,pubtest234of100,1,323,5381,25,294,5700
subtest24of10,pubtest234of100,1,323,5381,28,331,5740
subtest28of10,pubtest234of100,1,323,5381,35,364,5780
subtest23of10,pubtest235of100,1,321,5702,-1,40,5741
subtest21of10,pubtest235of100,1,321,5702,-2,81,5781
subtest27of10,pubtest235of100,1,321,5702,1,118,5821
subtest29of10,pubtest235of100,1,321,5702,2,157,5861
subtest25of10,pubtest235of100,1,321,5702,5,195,5902
subtest210of10,pubtest235of100,1,321,5702,7,232,5941
subtest22of10,pubtest235of100,1,321,5702,9,270,5981
subtest24of10,pubtest235of100,1,321,5702,11,308,6021
subtest26of10,pubtest235of100,1,321,5702,11,348,6061
subtest28of10,pubtest235of100,1,321,5702,12,387,6101
subtest210of10,pubtest236of100,1,323,5396,2,41,5439
subtest23of10,pubtest236of100,1,323,5396,2,79,5477
subtest28of10,pubtest236of100,1,323,5396,9,112,5517
subtest27of10,pubtest236of100,1,323,5396,9,152,5557
subtest21of10,pubtest236of100,1,323,5396,11,191,5598
subtest25of10,pubtest236of100,1,323,5396,11,231,5638
subtest29of10,pubtest236of100,1,323,5396,13,269,5678
subtest24of10,pubtest236of100,1,323,5396,18,302,5716
subtest26of10,pubtest236of100,1,323,5396,20,342,5758
subtest22of10,pubtest236of100,1,323,5396,21,381,5798
subtest24of10,pubtest237of100,1,323,5255,15,40,5310
subtest23of10,pubtest237of100,1,323,5255,25,70,5350
subtest28of10,pubtest237of100,1,323,5255,68,64,5387
subtest21of10,pubtest237of100,1,323,5255,71,103,5429
subtest25of10,pubtest237of100,1,323,5255,70,142,5467
subtest27of10,pubtest237of100,1,323,5255,70,435,5760
subtest26of10,pubtest237of100,1,323,5255,77,466,5798
subtest29of10,pubtest237of100,1,323,5255,77,505,5837
subtest22of10,pubtest237of100,1,323,5255,77,544,5876
subtest210of10,pubtest237of100,1,323,5255,79,584,5918
subtest29of10,pubtest238of100,1,323,5249,3,421,5673
subtest22of10,pubtest238of100,1,323,5249,4,459,5712
subtest27of10,pubtest238of100,1,323,5249,5,497,5751
subtest28of10,pubtest238of100,1,323,5249,14,528,5791
subtest23of10,pubtest238of100,1,323,5249,14,568,5831
subtest25of10,pubtest238of100,1,323,5249,14,607,5870
subtest210of10,pubtest238of100,1,323,5249,24,638,5911
subtest21of10,pubtest238of100,1,323,5249,24,678,5951
subtest26of10,pubtest238of100,1,323,5249,28,714,5991
subtest24of10,pubtest238of100,1,323,5249,28,754,6031
subtest21of10,pubtest239of100,1,323,5195,3,38,5236
subtest27of10,pubtest239of100,1,323,5195,5,76,5276
subtest28of10,pubtest239of100,1,323,5195,6,115,5316
subtest25of10,pubtest239of100,1,323,5195,11,148,5354
subtest26of10,pubtest239of100,1,323,5195,21,180,5396
subtest29of10,pubtest239of100,1,323,5195,21,220,5436
subtest23of10,pubtest239of100,1,323,5195,23,258,5476
subtest22of10,pubtest239of100,1,323,5195,23,298,5516
subtest24of10,pubtest239of100,1,323,5195,23,337,5555
subtest210of10,pubtest239of100,1,323,5195,29,373,5597
subtest25of10,pubtest240of100,1,323,5476,14,43,5533
subtest210of10,pubtest240of100,1,323,5476,14,81,5571
subtest28of10,pubtest240of100,1,323,5476,16,120,5612
subtest29of10,pubtest240of100,1,323,5476,16,160,5652
subtest24of10,pubtest240of100,1,323,5476,17,200,5693
subtest27of10,pubtest240of100,1,323,5476,18,239,5733
subtest23of10,pubtest240of100,1,323,5476,19,277,5772
subtest22of10,pubtest240of100,1,323,5476,19,317,5812
subtest21of10,pubtest240of100,1,323,5476,21,355,5852
subtest26of10,pubtest240of100,1,323,5476,34,382,5892
subtest23of10,pubtest241of100,1,323,5620,3,40,5663
subtest24of10,pubtest241of100,1,323,5620,5,77,5702
subtest27of10,pubtest241of100,1,323,5620,6,116,5742
subtest210of10,pubtest241of100,1,323,5620,7,156,5783
subtest21of10,pubtest241of100,1,323,5620,12,191,5823
subtest29of10,pubtest241of100,1,323,5620,19,223,5862
subtest28of10,pubtest241of100,1,323,5620,20,262,5902
subtest22of10,pubtest241of100,1,323,5620,21,301,5942
subtest25of10,pubtest241of100,1,323,5620,19,340,5979
subtest26of10,pubtest241of100,1,323,5620,21,380,6021
subtest26of10,pubtest242of100,1,323,5369,3,45,5417
subtest23of10,pubtest242of100,1,323,5369,3,84,5456
subtest27of10,pubtest242of100,1,323,5369,1,125,5495
subtest25of10,pubtest242of100,1,323,5369,10,157,5536
subtest29of10,pubtest242of100,1,323,5369,10,197,5576
subtest21of10,pubtest242of100,1,323,5369,11,236,5616
subtest210of10,pubtest242of100,1,323,5369,15,273,5657
subtest22of10,pubtest242of100,1,323,5369,15,312,5696
subtest24of10,pubtest242of100,1,323,5369,16,350,5735
subtest28of10,pubtest242of100,1,323,5369,17,390,5776
subtest29of10,pubtest243of100,1,323,5332,-1,41,5372
subtest28of10,pubtest243of100,1,323,5332,1,78,5411
subtest23of10,pubtest243of100,1,323,5332,3,116,5451
subtest26of10,pubtest243of100,1,323,5332,4,155,5491
subtest22of10,pubtest243of100,1,323,5332,3,195,5530
subtest24of10,pubtest243of100,1,323,5332,9,230,5571
subtest25of10,pubtest243of100,1,323,5332,14,265,5611
subtest210of10,pubtest243of100,1,323,5332,17,301,5650
subtest21of10,pubtest243of100,1,323,5332,18,341,5691
subtest27of10,pubtest243of100,1,323,5332,17,380,5729
subtest27of10,pubtest244of100,1,323,5241,6,40,5287
subtest26of10,pubtest244of100,1,323,5241,6,79,5326
subtest25of10,pubtest244of100,1,323,5241,10,114,5365
subtest29of10,pubtest244of100,1,323,5241,11,154,5406
subtest21of10,pubtest244of100,1,323,5241,12,193,5446
subtest28of10,pubtest244of100,1,323,5241,12,233,5486
subtest210of10,pubtest244of100,1,323,5241,16,269,5526
subtest23of10,pubtest244of100,1,323,5241,16,308,5565
subtest22of10,pubtest244of100,1,323,5241,20,346,5607
subtest24of10,pubtest244of100,1,323,5241,21,384,5646
subtest29of10,pubtest245of100,1,322,5342,3,45,5390
subtest23of10,pubtest245of100,1,322,5342,5,82,5429
subtest25of10,pubtest245of100,1,322,5342,7,120,5469
subtest21of10,pubtest245of100,1,322,5342,8,161,5511
subtest27of10,pubtest245of100,1,322,5342,8,200,5550
subtest26of10,pubtest245of100,1,322,5342,13,234,5589
subtest22of10,pubtest245of100,1,322,5342,14,273,5629
subtest24of10,pubtest245of100,1,322,5342,15,312,5669
subtest28of10,pubtest245of100,1,322,5342,16,351,5709
subtest210of10,pubtest245of100,1,322,5342,21,386,5749
subtest26of10,pubtest246of100,1,323,5270,-1,41,5310
subtest27of10,pubtest246of100,1,323,5270,10,69,5349
subtest21of10,pubtest246of100,1,323,5270,11,108,5389
subtest28of10,pubtest246of100,1,323,5270,12,148,5430
subtest29of10,pubtest246of100,1,323,5270,13,184,5467
subtest210of10,pubtest246of100,1,323,5270,14,223,5507
subtest22of10,pubtest246of100,1,323,5270,15,263,5548
subtest25of10,pubtest246of100,1,323,5270,14,302,5586
subtest23of10,pubtest246of100,1,323,5270,13,342,5625
subtest24of10,pubtest246of100,1,323,5270,15,380,5665
subtest27of10,pubtest247of100,1,323,5322,5,39,5366
subtest23of10,pubtest247of100,1,323,5322,6,77,5405
subtest21of10,pubtest247of100,1,323,5322,7,116,5445
subtest26of10,pubtest247of100,1,323,5322,8,155,5485
subtest22of10,pubtest247of100,1,323,5322,10,193,5525
subtest29of10,pubtest247of100,1,323,5322,11,232,5565
subtest28of10,pubtest247of100,1,323,5322,17,266,5605
subtest24of10,pubtest247of100,1,323,5322,18,305,5645
subtest210of10,pubtest247of100,1,323,5322,18,345,5685
subtest25of10,pubtest247of100,1,323,5322,17,385,5724
subtest29of10,pubtest248of100,1,323,5238,8,206,5452
subtest26of10,pubtest248of100,1,323,5238,8,39,5285
subtest23of10,pubtest248of100,1,323,5238,10,79,5327
subtest25of10,pubtest248of100,1,323,5238,10,321,5569
subtest27of10,pubtest248of100,1,323,5238,11,158,5407
subtest21of10,pubtest248of100,1,323,5238,213,196,5647
subtest24of10,pubtest248of100,1,323,5238,213,234,5685
subtest210of10,pubtest248of100,1,323,5238,213,274,5725
subtest22of10,pubtest248of100,1,323,5238,213,313,5764
subtest28of10,pubtest248of100,1,323,5238,213,353,5804
subtest27of10,pubtest249of100,1,323,5254,3,42,5299
subtest28of10,pubtest249of100,1,323,5254,4,79,5337
subtest24of10,pubtest249of100,1,323,5254,11,113,5378
subtest26of10,pubtest249of100,1,323,5254,12,152,5418
subtest25of10,pubtest249of100,1,323,5254,13,192,5459
subtest22of10,pubtest249of100,1,323,5254,14,230,5498
subtest21of10,pubtest249of100,1,323,5254,15,269,5538
subtest29of10,pubtest249of100,1,323,5254,17,307,5578
subtest23of10,pubtest249of100,1,323,5254,17,347,5618
subtest210of10,pubtest249of100,1,323,5254,19,385,5658
subtest27of10,pubtest250of100,1,323,5216,-2,40,5254
subtest23of10,pubtest250of100,1,323,5216,-1,77,5292
subtest29of10,pubtest250of100,1,323,5216,0,116,5332
subtest21of10,pubtest250of100,1,323,5216,6,150,5372
subtest28of10,pubtest250of100,1,323,5216,11,185,5412
subtest24of10,pubtest250of100,1,323,5216,15,221,5452
subtest210of10,pubtest250of100,1,323,5216,16,260,5492
subtest26of10,pubtest250of100,1,323,5216,15,299,5530
subtest22of10,pubtest250of100,1,323,5216,17,339,5572
subtest25of10,pubtest250of100,1,323,5216,15,382,5613
subtest22of10,pubtest251of100,1,323,5256,5,43,5304
subtest23of10,pubtest251of100,1,323,5256,5,83,5344
subtest24of10,pubtest251of100,1,323,5256,7,120,5383
subtest27of10,pubtest251of100,1,323,5256,9,159,5424
subtest25of10,pubtest251of100,1,323,5256,14,193,5463
subtest28of10,pubtest251of100,1,323,5256,14,232,5502
subtest21of10,pubtest251of100,1,323,5256,16,272,5544
subtest29of10,pubtest251of100,1,323,5256,16,311,5583
subtest210of10,pubtest251of100,1,323,5256,21,346,5623
subtest26of10,pubtest251of100,1,323,5256,25,382,5663
subtest21of10,pubtest252of100,1,323,5476,9,92,5577
subtest27of10,pubtest252of100,1,323,5476,10,129,5615
subtest28of10,pubtest252of100,1,323,5476,9,168,5653
subtest29of10,pubtest252of100,1,323,5476,8,210,5694
subtest25of10,pubtest252of100,1,323,5476,18,241,5735
subtest23of10,pubtest252of100,1,323,5476,22,276,5774
subtest22of10,pubtest252of100,1,323,5476,23,315,5814
subtest24of10,pubtest252of100,1,323,5476,24,355,5855
subtest210of10,pubtest252of100,1,323,5476,26,394,5896
subtest26of10,pubtest252of100,1,323,5476,23,434,5933
subtest23of10,pubtest253of100,1,322,5317,7,42,5366
subtest28of10,pubtest253of100,1,322,5317,8,81,5406
subtest27of10,pubtest253of100,1,322,5317,10,116,5443
subtest21of10,pubtest253of100,1,322,5317,13,155,5485
subtest29of10,pubtest253of100,1,322,5317,11,195,5523
subtest22of10,pubtest253of100,1,322,5317,14,234,5565
subtest25of10,pubtest253of100,1,322,5317,11,273,5601
subtest24of10,pubtest253of100,1,322,5317,12,313,5642
subtest210of10,pubtest253of100,1,322,5317,17,351,5685
subtest26of10,pubtest253of100,1,322,5317,16,391,5724
subtest210of10,pubtest254of100,1,323,5263,2,39,5304
subtest27of10,pubtest254of100,1,323,5263,2,77,5342
subtest21of10,pubtest254of100,1,323,5263,7,113,5383
subtest28of10,pubtest254of100,1,323,5263,12,149,5424
subtest24of10,pubtest254of100,1,323,5263,13,187,5463
subtest25of10,pubtest254of100,1,323,5263,13,228,5504
subtest22of10,pubtest254of100,1,323,5263,15,265,5543
subtest23of10,pubtest254of100,1,323,5263,15,305,5583
subtest29of10,pubtest254of100,1,323,5263,15,344,5622
subtest26of10,pubtest254of100,1,323,5263,17,383,5663
subtest22of10,pubtest255of100,1,322,5179,2,40,5221
subtest23of10,pubtest255of100,1,322,5179,2,79,5260
subtest27of10,pubtest255of100,1,322,5179,11,110,5300
subtest28of10,pubtest255of100,1,322,5179,14,147,5340
subtest29of10,pubtest255of100,1,322,5179,14,187,5380
subtest21of10,pubtest255of100,1,322,5179,16,225,5420
subtest24of10,pubtest255of100,1,322,5179,16,265,5460
subtest210of10,pubtest255of100,1,322,5179,17,304,5500
subtest25of10,pubtest255of100,1,322,5179,32,328,5539
subtest26of10,pubtest255of100,1,322,5179,32,368,5579
subtest29of10,pubtest256of100,1,323,5374,2,38,5414
subtest21of10,pubtest256of100,1,323,5374,5,75,5454
subtest23of10,pubtest256of100,1,323,5374,8,111,5493
subtest26of10,pubtest256of100,1,323,5374,9,151,5534
subtest210of10,pubtest256of100,1,323,5374,15,183,5572
subtest25of10,pubtest256of100,1,323,5374,15,223,5612
subtest27of10,pubtest256of100,1,323,5374,18,261,5653
subtest28of10,pubtest256of100,1,323,5374,22,297,5693
subtest22of10,pubtest256of100,1,323,5374,23,337,5734
subtest24of10,pubtest256of100,1,323,5374,24,375,5773
subtest24of10,pubtest257of100,1,323,5321,6,43,5370
subtest28of10,pubtest257of100,1,323,5321,20,67,5408
subtest21of10,pubtest257of100,1,323,5321,20,106,5447
subtest22of10,pubtest257of100,1,323,5321,24,145,5490
subtest210of10,pubtest257of100,1,323,5321,24,185,5530
subtest27of10,pubtest257of100,1,323,5321,21,225,5567
subtest29of10,pubtest257of100,1,323,5321,26,263,5610
subtest23of10,pubtest257of100,1,323,5321,26,303,5650
subtest25of10,pubtest257of100,1,323,5321,28,341,5690
subtest26of10,pubtest257of100,1,323,5321,28,383,5732
subtest28of10,pubtest258of100,1,323,5212,3,42,5257
subtest23of10,pubtest258of100,1,323,5212,4,80,5296
subtest25of10,pubtest258of100,1,323,5212,5,119,5336
subtest21of10,pubtest258of100,1,323,5212,10,155,5377
subtest29of10,pubtest258of100,1,323,5212,16,188,5416
subtest27of10,pubtest258of100,1,323,5212,16,227,5455
subtest26of10,pubtest258of100,1,323,5212,16,267,5495
subtest210of10,pubtest258of100,1,323,5212,18,306,5536
subtest22of10,pubtest258of100,1,323,5212,18,345,5575
subtest24of10,pubtest258of100,1,323,5212,21,383,5616
subtest21of10,pubtest259of100,1,323,5301,3,40,5344
subtest28of10,pubtest259of100,1,323,5301,4,78,5383
subtest25of10,pubtest259of100,1,323,5301,5,116,5422
subtest24of10,pubtest259of100,1,323,5301,6,156,5463
subtest27of10,pubtest259of100,1,323,5301,13,189,5503
subtest26of10,pubtest259of100,1,323,5301,13,229,5543
subtest210of10,pubtest259of100,1,323,5301,16,265,5582
subtest22of10,pubtest259of100,1,323,5301,15,304,5620
subtest23of10,pubtest259of100,1,323,5301,15,347,5663
subtest29of10,pubtest259of100,1,323,5301,19,383,5703
subtest210of10,pubtest260of100,1,323,5401,1,42,5444
subtest23of10,pubtest260of100,1,323,5401,6,75,5482
subtest21of10,pubtest260of100,1,323,5401,7,114,5522
subtest26of10,pubtest260of100,1,323,5401,8,153,5562
subtest28of10,pubtest260of100,1,323,5401,12,189,5602
subtest29of10,pubtest260of100,1,323,5401,12,229,5642
subtest27of10,pubtest260of100,1,323,5401,9,268,5678
subtest22of10,pubtest260of100,1,323,5401,9,308,5718
subtest25of10,pubtest260of100,1,323,5401,12,348,5761
subtest24of10,pubtest260of100,1,323,5401,15,386,5802
subtest28of10,pubtest261of100,1,323,5420,2,78,5500
subtest25of10,pubtest261of100,1,323,5420,1,117,5538
subtest26of10,pubtest261of100,1,323,5420,81,75,5576
subtest21of10,pubtest261of100,1,323,5420,82,115,5617
subtest27of10,pubtest261of100,1,323,5420,83,154,5657
subtest29of10,pubtest261of100,1,323,5420,80,194,5694
subtest24of10,pubtest261of100,1,323,5420,84,233,5737
subtest22of10,pubtest261of100,1,323,5420,85,272,5777
subtest23of10,pubtest261of100,1,323,5420,86,312,5818
subtest210of10,pubtest261of100,1,323,5420,86,350,5856
subtest21of10,pubtest262of100,1,323,5229,3,39,5271
subtest22of10,pubtest262of100,1,323,5229,4,77,5310
subtest23of10,pubtest262of100,1,323,5229,14,107,5350
subtest26of10,pubtest262of100,1,323,5229,15,146,5390
subtest25of10,pubtest262of100,1,323,5229,16,185,5430
subtest29of10,pubtest262of100,1,323,5229,17,224,5470
subtest24of10,pubtest262of100,1,323,5229,18,263,5510
subtest27of10,pubtest262of100,1,323,5229,19,303,5551
subtest210of10,pubtest262of100,1,323,5229,17,342,5588
subtest28of10,pubtest262of100,1,323,5229,22,379,5630
subtest22of10,pubtest263of100,1,322,5244,49,45,5338
subtest29of10,pubtest263of100,1,322,5244,49,83,5376
subtest23of10,pubtest263of100,1,322,5244,67,105,5416
subtest26of10,pubtest263of100,1,322,5244,67,145,5456
subtest24of10,pubtest263of100,1,322,5244,67,184,5495
subtest25of10,pubtest263of100,1,322,5244,69,222,5535
subtest27of10,pubtest263of100,1,322,5244,71,259,5574
subtest21of10,pubtest263of100,1,322,5244,74,298,5616
subtest28of10,pubtest263of100,1,322,5244,74,338,5656
subtest210of10,pubtest263of100,1,322,5244,71,377,5692
subtest22of10,pubtest264of100,1,322,5179,4,38,5221
subtest29of10,pubtest264of100,1,322,5179,5,76,5260
subtest24of10,pubtest264of100,1,322,5179,6,115,5300
subtest23of10,pubtest264of100,1,322,5179,5,151,5335
subtest27of10,pubtest264of100,1,322,5179,7,190,5376
subtest21of10,pubtest264of100,1,322,5179,9,229,5417
subtest28of10,pubtest264of100,1,322,5179,24,256,5459
subtest26of10,pubtest264of100,1,322,5179,25,295,5499
subtest210of10,pubtest264of100,1,322,5179,26,335,5540
subtest25of10,pubtest264of100,1,322,5179,24,375,5578
subtest26of10,pubtest265of100,1,323,5237,1,39,5277
subtest27of10,pubtest265of100,1,323,5237,8,72,5317
subtest21of10,pubtest265of100,1,323,5237,11,109,5357
subtest29of10,pubtest265of100,1,323,5237,14,147,5398
subtest22of10,pubtest265of100,1,323,5237,15,185,5437
subtest25of10,pubtest265of100,1,323,5237,15,225,5477
subtest28of10,pubtest265of100,1,323,5237,16,264,5517
subtest23of10,pubtest265of100,1,323,5237,18,302,5557
subtest24of10,pubtest265of100,1,323,5237,18,342,5597
subtest210of10,pubtest265of100,1,323,5237,14,381,5632
subtest29of10,pubtest266of100,1,321,5328,2,39,5369
subtest25of10,pubtest266of100,1,321,5328,4,77,5409
subtest210of10,pubtest266of100,1,321,5328,17,103,5448
subtest27of10,pubtest266of100,1,321,5328,17,143,5488
subtest21of10,pubtest266of100,1,321,5328,19,181,5528
subtest28of10,pubtest266of100,1,321,5328,19,221,5568
subtest23of10,pubtest266of100,1,321,5328,20,260,5608
subtest22of10,pubtest266of100,1,321,5328,21,299,5648
subtest26of10,pubtest266of100,1,321,5328,21,339,5688
subtest24of10,pubtest266of100,1,321,5328,22,376,5726
subtest23of10,pubtest267of100,1,323,5282,7,41,5330
subtest29of10,pubtest267of100,1,323,5282,11,77,5370
subtest27of10,pubtest267of100,1,323,5282,10,117,5409
subtest26of10,pubtest267of100,1,323,5282,9,154,5445
subtest28of10,pubtest267of100,1,323,5282,10,194,5486
subtest25of10,pubtest267of100,1,323,5282,10,233,5525
subtest21of10,pubtest267of100,1,323,5282,18,270,5570
subtest24of10,pubtest267of100,1,323,5282,19,308,5609
subtest22of10,pubtest267of100,1,323,5282,20,348,5650
subtest210of10,pubtest267of100,1,323,5282,26,382,5690
subtest23of10,pubtest268of100,1,323,5246,2,38,5286
subtest25of10,pubtest268of100,1,323,5246,5,72,5323
subtest29of10,pubtest268of100,1,323,5246,11,107,5364
subtest28of10,pubtest268of100,1,323,5246,12,147,5405
subtest24of10,pubtest268of100,1,323,5246,11,186,5443
subtest27of10,pubtest268of100,1,323,5246,14,225,5485
subtest21of10,pubtest268of100,1,323,5246,16,263,5525
subtest22of10,pubtest268of100,1,323,5246,18,301,5565
subtest210of10,pubtest268of100,1,323,5246,18,341,5605
subtest26of10,pubtest268of100,1,323,5246,19,381,5646
subtest24of10,pubtest269of100,1,323,5162,2,40,5204
subtest27of10,pubtest269of100,1,323,5162,3,79,5244
subtest25of10,pubtest269of100,1,323,5162,11,109,5282
subtest26of10,pubtest269of100,1,323,5162,12,148,5322
subtest210of10,pubtest269of100,1,323,5162,11,188,5361
subtest21of10,pubtest269of100,1,323,5162,15,226,5403
subtest29of10,pubtest269of100,1,323,5162,18,263,5443
subtest22of10,pubtest269of100,1,323,5162,19,302,5483
subtest28of10,pubtest269of100,1,323,5162,58,303,5523
subtest23of10,pubtest269of100,1,323,5162,58,343,5563
subtest23of10,pubtest270of100,1,323,5233,2,45,5280
subtest27of10,pubtest270of100,1,323,5233,3,82,5318
subtest26of10,pubtest270of100,1,323,5233,5,515,5753
subtest210of10,pubtest270of100,1,323,5233,10,547,5790
subtest28of10,pubtest270of100,1,323,5233,14,580,5827
subtest24of10,pubtest270of100,1,323,5233,18,618,5869
subtest22of10,pubtest270of100,1,323,5233,19,658,5910
subtest25of10,pubtest270of100,1,323,5233,14,697,5944
subtest21of10,pubtest270of100,1,323,5233,20,737,5990
subtest29of10,pubtest270of100,1,323,5233,14,776,6023
subtest24of10,pubtest271of100,1,323,5364,2,43,5409
subtest25of10,pubtest271of100,1,323,5364,9,76,5449
subtest22of10,pubtest271of100,1,323,5364,9,115,5488
subtest27of10,pubtest271of100,1,323,5364,14,152,5530
subtest21of10,pubtest271of100,1,323,5364,18,187,5569
subtest210of10,pubtest271of100,1,323,5364,18,227,5609
subtest23of10,pubtest271of100,1,323,5364,23,261,5648
subtest26of10,pubtest271of100,1,323,5364,23,301,5688
subtest28of10,pubtest271of100,1,323,5364,25,342,5731
subtest29of10,pubtest271of100,1,323,5364,26,379,5769
subtest25of10,pubtest272of100,1,323,5208,1,41,5250
subtest21of10,pubtest272of100,1,323,5208,4,77,5289
subtest29of10,pubtest272of100,1,323,5208,6,115,5329
subtest26of10,pubtest272of100,1,323,5208,5,156,5369
subtest23of10,pubtest272of100,1,323,5208,7,194,5409
subtest24of10,pubtest272of100,1,323,5208,12,229,5449
subtest27of10,pubtest272of100,1,323,5208,19,262,5489
subtest210of10,pubtest272of100,1,323,5208,19,302,5529
subtest22of10,pubtest272of100,1,323,5208,25,336,5569
subtest28of10,pubtest272of100,1,323,5208,25,376,5609
subtest22of10,pubtest273of100,1,321,5249,5,41,5295
subtest26of10,pubtest273of100,1,321,5249,6,77,5332
subtest29of10,pubtest273of100,1,321,5249,8,116,5373
subtest28of10,pubtest273of100,1,321,5249,8,156,5413
subtest210of10,pubtest273of100,1,321,5249,13,191,5453
subtest25of10,pubtest273of100,1,321,5249,13,231,5493
subtest24of10,pubtest273of100,1,321,5249,15,269,5533
subtest27of10,pubtest273of100,1,321,5249,22,302,5573
subtest23of10,pubtest273of100,1,321,5249,22,342,5613
subtest21of10,pubtest273of100,1,321,5249,22,381,5652
subtest26of10,pubtest274of100,1,323,5281,2,41,5324
subtest21of10,pubtest274of100,1,323,5281,3,80,5364
subtest23of10,pubtest274of100,1,323,5281,8,115,5404
subtest22of10,pubtest274of100,1,323,5281,12,151,5444
subtest29of10,pubtest274of100,1,323,5281,11,191,5483
subtest25of10,pubtest274of100,1,323,5281,14,229,5524
subtest28of10,pubtest274of100,1,323,5281,17,266,5564
subtest27of10,pubtest274of100,1,323,5281,17,306,5604
subtest24of10,pubtest274of100,1,323,5281,19,344,5644
subtest210of10,pubtest274of100,1,323,5281,23,380,5684
subtest29of10,pubtest275of100,1,323,5577,12,42,5631
subtest24of10,pubtest275of100,1,323,5577,13,80,5670
subtest21of10,pubtest275of100,1,323,5577,14,118,5709
subtest26of10,pubtest275of100,1,323,5577,16,157,5750
subtest28of10,pubtest275of100,1,323,5577,17,196,5790
subtest210of10,pubtest275of100,1,323,5577,15,235,5827
subtest23of10,pubtest275of100,1,323,5577,15,274,5866
subtest27of10,pubtest275of100,1,323,5577,11,314,5902
subtest22of10,pubtest275of100,1,323,5577,14,355,5946
subtest25of10,pubtest275of100,1,323,5577,14,393,5984
subtest28of10,pubtest276of100,1,323,5366,4,43,5413
subtest21of10,pubtest276of100,1,323,5366,6,80,5452
subtest25of10,pubtest276of100,1,323,5366,6,119,5491
subtest24of10,pubtest276of100,1,323,5366,7,159,5532
subtest29of10,pubtest276of100,1,323,5366,9,197,5572
subtest27of10,pubtest276of100,1,323,5366,8,238,5612
subtest23of10,pubtest276of100,1,323,5366,10,274,5650
subtest26of10,pubtest276of100,1,323,5366,13,313,5692
subtest210of10,pubtest276of100,1,323,5366,14,352,5732
subtest22of10,pubtest276of100,1,323,5366,15,391,5772
subtest29of10,pubtest277of100,1,323,5255,5,40,5300
subtest22of10,pubtest277of100,1,323,5255,4,79,5338
subtest21of10,pubtest277of100,1,323,5255,6,116,5377
subtest27of10,pubtest277of100,1,323,5255,9,155,5419
subtest28of10,pubtest277of100,1,323,5255,9,195,5459
subtest210of10,pubtest277of100,1,323,5255,11,233,5499
subtest24of10,pubtest277of100,1,323,5255,11,273,5539
subtest25of10,pubtest277of100,1,323,5255,22,302,5579
subtest23of10,pubtest277of100,1,323,5255,30,334,5619
subtest26of10,pubtest277of100,1,323,5255,30,375,5660
subtest22of10,pubtest278of100,1,323,5268,8,42,5318
subtest29of10,pubtest278of100,1,323,5268,8,81,5357
subtest23of10,pubtest278of100,1,323,5268,9,119,5396
subtest21of10,pubtest278of100,1,323,5268,16,153,5437
subtest27of10,pubtest278of100,1,323,5268,16,193,5477
subtest28of10,pubtest278of100,1,323,5268,20,229,5517
subtest25of10,pubtest278of100,1,323,5268,37,252,5557
subtest26of10,pubtest278of100,1,323,5268,38,291,5597
subtest24of10,pubtest278of100,1,323,5268,41,328,5637
subtest210of10,pubtest278of100,1,323,5268,42,366,5676
subtest25of10,pubtest279of100,1,323,5199,2,44,5245
subtest28of10,pubtest279of100,1,323,5199,3,81,5283
subtest21of10,pubtest279of100,1,323,5199,4,120,5323
subtest29of10,pubtest279of100,1,323,5199,14,150,5363
subtest24of10,pubtest279of100,1,323,5199,14,190,5403
subtest23of10,pubtest279of100,1,323,5199,16,226,5441
subtest26of10,pubtest279of100,1,323,5199,18,267,5484
subtest27of10,pubtest279of100,1,323,5199,16,305,5520
subtest22of10,pubtest279of100,1,323,5199,20,344,5563
subtest210of10,pubtest279of100,1,323,5199,25,380,5604
subtest27of10,pubtest280of100,1,323,5239,-2,40,5277
subtest23of10,pubtest280of100,1,323,5239,5,71,5315
subtest26of10,pubtest280of100,1,323,5239,2,111,5352
subtest210of10,pubtest280of100,1,323,5239,5,150,5394
subtest21of10,pubtest280of100,1,323,5239,1,189,5429
subtest24of10,pubtest280of100,1,323,5239,1,229,5469
subtest29of10,pubtest280of100,1,323,5239,0,268,5507
subtest25of10,pubtest280of100,1,323,5239,13,303,5555
subtest28of10,pubtest280of100,1,323,5239,36,320,5595
subtest22of10,pubtest280of100,1,323,5239,37,359,5635
subtest24of10,pubtest281of100,1,323,5721,2,39,5762
subtest23of10,pubtest281of100,1,323,5721,8,72,5801
subtest28of10,pubtest281of100,1,323,5721,9,112,5842
subtest22of10,pubtest281of100,1,323,5721,10,150,5881
subtest27of10,pubtest281of100,1,323,5721,13,186,5920
subtest21of10,pubtest281of100,1,323,5721,14,226,5961
subtest210of10,pubtest281of100,1,323,5721,15,265,6001
subtest25of10,pubtest281of100,1,323,5721,13,305,6039
subtest29of10,pubtest281of100,1,323,5721,16,344,6081
subtest26of10,pubtest281of100,1,323,5721,18,380,6119
subtest24of10,pubtest282of100,1,323,5151,2,40,5193
subtest23of10,pubtest282of100,1,323,5151,2,79,5232
subtest21of10,pubtest282of100,1,323,5151,6,115,5272
subtest25of10,pubtest282of100,1,323,5151,7,154,5312
subtest22of10,pubtest282of100,1,323,5151,10,191,5352
subtest29of10,pubtest282of100,1,323,5151,14,227,5392
subtest26of10,pubtest282of100,1,323,5151,16,264,5431
subtest27of10,pubtest282of100,1,323,5151,25,296,5472
subtest210of10,pubtest282of100,1,323,5151,25,336,5512
subtest28of10,pubtest282of100,1,323,5151,27,374,5552
subtest27of10,pubtest283of100,1,323,5220,3,40,5263
subtest24of10,pubtest283of100,1,323,5220,10,71,5301
subtest22of10,pubtest283of100,1,323,5220,13,108,5341
subtest23of10,pubtest283of100,1,323,5220,11,147,5378
subtest28of10,pubtest283of100,1,323,5220,15,186,5421
subtest21of10,pubtest283of100,1,323,5220,16,225,5461
subtest29of10,pubtest283of100,1,323,5220,17,264,5501
subtest210of10,pubtest283of100,1,323,5220,18,303,5541
subtest25of10,pubtest283of100,1,323,5220,19,342,5581
subtest26of10,pubtest283of100,1,323,5220,19,382,5621
subtest25of10,pubtest284of100,1,323,5234,5,42,5281
subtest22of10,pubtest284of100,1,323,5234,5,81,5320
subtest210of10,pubtest284of100,1,323,5234,7,119,5360
subtest29of10,pubtest284of100,1,323,5234,8,158,5400
subtest27of10,pubtest284of100,1,323,5234,9,197,5440
subtest24of10,pubtest284of100,1,323,5234,11,235,5480
subtest23of10,pubtest284of100,1,323,5234,15,271,5520
subtest21of10,pubtest284of100,1,323,5234,16,311,5561
subtest28of10,pubtest284of100,1,323,5234,22,344,5600
subtest26of10,pubtest284of100,1,323,5234,22,384,5640
subtest23of10,pubtest285of100,1,323,5210,1,41,5252
subtest25of10,pubtest285of100,1,323,5210,3,79,5292
subtest27of10,pubtest285of100,1,323,5210,5,117,5332
subtest24of10,pubtest285of100,1,323,5210,5,157,5372
subtest22of10,pubtest285of100,1,323,5210,16,186,5412
subtest21of10,pubtest285of100,1,323,5210,16,223,5449
subtest26of10,pubtest285of100,1,323,5210,20,262,5492
subtest28of10,pubtest285of100,1,323,5210,17,302,5529
subtest29of10,pubtest285of100,1,323,5210,21,341,5572
subtest210of10,pubtest285of100,1,323,5210,22,381,5613
subtest23of10,pubtest286of100,1,323,5176,-1,45,5220
subtest25of10,pubtest286of100,1,323,5176,1,82,5259
subtest210of10,pubtest286of100,1,323,5176,4,119,5299
subtest29of10,pubtest286of100,1,323,5176,6,157,5339
subtest21of10,pubtest286of100,1,323,5176,12,191,5379
subtest24of10,pubtest286of100,1,323,5176,12,231,5419
subtest26of10,pubtest286of100,1,323,5176,13,270,5459
subtest27of10,pubtest286of100,1,323,5176,21,302,5499
subtest28of10,pubtest286of100,1,323,5176,21,342,5539
subtest22of10,pubtest286of100,1,323,5176,21,381,5578
subtest26of10,pubtest287of100,1,323,5237,4,41,5282
subtest29of10,pubtest287of100,1,323,5237,6,79,5322
subtest28of10,pubtest287of100,1,323,5237,6,118,5361
subtest210of10,pubtest287of100,1,323,5237,10,154,5401
subtest24of10,pubtest287of100,1,323,5237,17,187,5441
subtest27of10,pubtest287of100,1,323,5237,17,227,5481
subtest25of10,pubtest287of100,1,323,5237,19,264,5520
subtest21of10,pubtest287of100,1,323,5237,20,305,5562
subtest23of10,pubtest287of100,1,323,5237,21,341,5599
subtest22of10,pubtest287of100,1,323,5237,21,381,5639
subtest29of10,pubtest288of100,1,323,5221,1,43,5265
subtest26of10,pubtest288of100,1,323,5221,8,74,5303
subtest25of10,pubtest288of100,1,323,5221,12,109,5342
subtest27of10,pubtest288of100,1,323,5221,12,149,5382
subtest28of10,pubtest288of100,1,323,5221,40,161,5422
subtest21of10,pubtest288of100,1,323,5221,37,205,5463
subtest22of10,pubtest288of100,1,323,5221,38,241,5500
subtest24of10,pubtest288of100,1,323,5221,41,280,5542
subtest23of10,pubtest288of100,1,323,5221,42,319,5582
subtest210of10,pubtest288of100,1,323,5221,44,357,5622
subtest29of10,pubtest289of100,1,323,5170,1,39,5210
subtest23of10,pubtest289of100,1,323,5170,10,68,5248
subtest210of10,pubtest289of100,1,323,5170,10,106,5286
subtest24of10,pubtest289of100,1,323,5170,12,146,5328
subtest25of10,pubtest289of100,1,323,5170,14,185,5369
subtest27of10,pubtest289of100,1,323,5170,19,220,5409
subtest26of10,pubtest289of100,1,323,5170,20,261,5451
subtest28of10,pubtest289of100,1,323,5170,22,298,5490
subtest22of10,pubtest289of100,1,323,5170,22,337,5529
subtest21of10,pubtest289of100,1,323,5170,22,376,5568
subtest29of10,pubtest290of100,1,323,5168,2,39,5209
subtest23of10,pubtest290of100,1,323,5168,9,72,5249
subtest22of10,pubtest290of100,1,323,5168,9,111,5288
subtest25of10,pubtest290of100,1,323,5168,11,149,5328
subtest27of10,pubtest290of100,1,323,5168,12,187,5367
subtest26of10,pubtest290of100,1,323,5168,13,227,5408
subtest28of10,pubtest290of100,1,323,5168,14,266,5448
subtest210of10,pubtest290of100,1,323,5168,15,306,5489
subtest21of10,pubtest290of100,1,323,5168,16,342,5526
subtest24of10,pubtest290of100,1,323,5168,16,382,5566
subtest24of10,pubtest291of100,1,323,5257,2,38,5297
subtest23of10,pubtest291of100,1,323,5257,4,75,5336
subtest28of10,pubtest291of100,1,323,5257,8,112,5377
subtest27of10,pubtest291of100,1,323,5257,18,141,5416
subtest210of10,pubtest291of100,1,323,5257,19,180,5456
subtest22of10,pubtest291of100,1,323,5257,22,217,5496
subtest21of10,pubtest291of100,1,323,5257,22,257,5536
subtest25of10,pubtest291of100,1,323,5257,24,295,5576
subtest26of10,pubtest291of100,1,323,5257,27,332,5616
subtest29of10,pubtest291of100,1,323,5257,27,372,5656
subtest29of10,pubtest292of100,1,323,5176,4,40,5220
subtest28of10,pubtest292of100,1,323,5176,4,79,5259
subtest21of10,pubtest292of100,1,323,5176,8,115,5299
subtest25of10,pubtest292of100,1,323,5176,12,151,5339
subtest26of10,pubtest292of100,1,323,5176,17,186,5379
subtest22of10,pubtest292of100,1,323,5176,17,226,5419
subtest27of10,pubtest292of100,1,323,5176,17,265,5458
subtest23of10,pubtest292of100,1,323,5176,23,300,5499
subtest210of10,pubtest292of100,1,323,5176,23,340,5539
subtest24of10,pubtest292of100,1,323,5176,23,379,5578
subtest24of10,pubtest293of100,1,323,5170,1,41,5212
subtest25of10,pubtest293of100,1,323,5170,6,75,5251
subtest23of10,pubtest293of100,1,323,5170,10,111,5291
subtest28of10,pubtest293of100,1,323,5170,10,151,5331
subtest27of10,pubtest293of100,1,323,5170,12,189,5371
subtest21of10,pubtest293of100,1,323,5170,12,229,5411
subtest29of10,pubtest293of100,1,323,5170,13,268,5451
subtest26of10,pubtest293of100,1,323,5170,14,307,5491
subtest210of10,pubtest293of100,1,323,5170,15,344,5529
subtest22of10,pubtest293of100,1,323,5170,18,383,5571
subtest21of10,pubtest294of100,1,323,5150,2,39,5191
subtest25of10,pubtest294of100,1,323,5150,3,77,5230
subtest29of10,pubtest294of100,1,323,5150,10,110,5270
subtest27of10,pubtest294of100,1,323,5150,11,149,5310
subtest23of10,pubtest294of100,1,323,5150,12,187,5349
subtest26of10,pubtest294of100,1,323,5150,15,225,5390
subtest210of10,pubtest294of100,1,323,5150,15,265,5430
subtest24of10,pubtest294of100,1,323,5150,16,303,5469
subtest22of10,pubtest294of100,1,323,5150,17,343,5510
subtest28of10,pubtest294of100,1,323,5150,18,382,5550
subtest25of10,pubtest295of100,1,323,5198,1,39,5238
subtest23of10,pubtest295of100,1,323,5198,10,67,5275
subtest27of10,pubtest295of100,1,323,5198,13,106,5317
subtest210of10,pubtest295of100,1,323,5198,12,146,5356
subtest22of10,pubtest295of100,1,323,5198,14,185,5397
subtest29of10,pubtest295of100,1,323,5198,15,226,5439
subtest24of10,pubtest295of100,1,323,5198,10,263,5471
subtest26of10,pubtest295of100,1,323,5198,16,303,5517
subtest21of10,pubtest295of100,1,323,5198,17,342,5557
subtest28of10,pubtest295of100,1,323,5198,17,382,5597
subtest25of10,pubtest296of100,1,322,5160,6,39,5205
subtest24of10,pubtest296of100,1,322,5160,7,77,5244
subtest26of10,pubtest296of100,1,322,5160,9,115,5284
subtest27of10,pubtest296of100,1,322,5160,9,156,5325
subtest23of10,pubtest296of100,1,322,5160,10,194,5364
subtest29of10,pubtest296of100,1,322,5160,11,232,5403
subtest28of10,pubtest296of100,1,322,5160,12,272,5444
subtest21of10,pubtest296of100,1,322,5160,13,311,5484
subtest210of10,pubtest296of100,1,322,5160,16,346,5522
subtest22of10,pubtest296of100,1,322,5160,18,386,5564
subtest25of10,pubtest297of100,1,323,5183,4,42,5229
subtest29of10,pubtest297of100,1,323,5183,5,81,5269
subtest23of10,pubtest297of100,1,323,5183,8,118,5309
subtest210of10,pubtest297of100,1,323,5183,11,155,5349
subtest22of10,pubtest297of100,1,323,5183,14,192,5389
subtest27of10,pubtest297of100,1,323,5183,17,229,5429
subtest26of10,pubtest297of100,1,323,5183,21,265,5469
subtest21of10,pubtest297of100,1,323,5183,24,302,5509
subtest24of10,pubtest297of100,1,323,5183,24,342,5549
subtest28of10,pubtest297of100,1,323,5183,24,381,5588
subtest25of10,pubtest298of100,1,323,5261,6,40,5307
subtest29of10,pubtest298of100,1,323,5261,3,80,5344
subtest22of10,pubtest298of100,1,323,5261,4,120,5385
subtest24of10,pubtest298of100,1,323,5261,7,158,5426
subtest23of10,pubtest298of100,1,323,5261,8,197,5466
subtest210of10,pubtest298of100,1,323,5261,8,237,5506
subtest21of10,pubtest298of100,1,323,5261,13,272,5546
subtest27of10,pubtest298of100,1,323,5261,13,312,5586
subtest28of10,pubtest298of100,1,323,5261,15,352,5628
subtest26of10,pubtest298of100,1,323,5261,15,390,5666
subtest22of10,pubtest299of100,1,323,5250,1,42,5293
subtest210of10,pubtest299of100,1,323,5250,8,74,5332
subtest29of10,pubtest299of100,1,323,5250,9,113,5372
subtest27of10,pubtest299of100,1,323,5250,10,151,5411
subtest24of10,pubtest299of100,1,323,5250,10,191,5451
subtest28of10,pubtest299of100,1,323,5250,12,230,5492
subtest26of10,pubtest299of100,1,323,5250,14,268,5532
subtest23of10,pubtest299of100,1,323,5250,14,304,5568
subtest21of10,pubtest299of100,1,323,5250,19,343,5612
subtest25of10,pubtest299of100,1,323,5250,15,382,5647
subtest21of10,pubtest2100of100,1,325,5231,1,39,5271
subtest24of10,pubtest2100of100,1,325,5231,11,68,5310
subtest29of10,pubtest2100of100,1,325,5231,13,106,5350
subtest23of10,pubtest2100of100,1,325,5231,18,141,5390
subtest27of10,pubtest2100of100,1,325,5231,21,178,5430
subtest22of10,pubtest2100of100,1,325,5231,23,216,5470
subtest25of10,pubtest2100of100,1,325,5231,25,254,5510
subtest28of10,pubtest2100of100,1,325,5231,27,292,5550
subtest210of10,pubtest2100of100,1,325,5231,30,330,5591
subtest26of10,pubtest2100of100,1,325,5231,32,367,5630
subtest26of10,pubtest21of100,1,322,10222,4,40,10266
subtest24of10,pubtest21of100,1,322,10222,7,77,10306
subtest29of10,pubtest21of100,1,322,10222,7,117,10346
subtest27of10,pubtest21of100,1,322,10222,6,159,10387
subtest25of10,pubtest21of100,1,322,10222,14,190,10426
subtest210of10,pubtest21of100,1,322,10222,18,226,10466
subtest28of10,pubtest21of100,1,322,10222,19,265,10506
subtest21of10,pubtest21of100,1,322,10222,19,305,10546
subtest23of10,pubtest21of100,1,322,10222,26,337,10585
subtest22of10,pubtest21of100,1,322,10222,26,377,10625
subtest29of10,pubtest22of100,1,321,5163,1,39,5203
subtest24of10,pubtest22of100,1,321,5163,10,69,5242
subtest27of10,pubtest22of100,1,321,5163,21,98,5282
subtest23of10,pubtest22of100,1,321,5163,22,137,5322
subtest25of10,pubtest22of100,1,321,5163,23,176,5362
subtest28of10,pubtest22of100,1,321,5163,24,215,5402
subtest21of10,pubtest22of100,1,321,5163,25,254,5442
subtest26of10,pubtest22of100,1,321,5163,28,289,5480
subtest210of10,pubtest22of100,1,321,5163,30,329,5522
subtest22of10,pubtest22of100,1,321,5163,30,368,5561
subtest23of10,pubtest23of100,1,321,5179,4,45,5228
subtest28of10,pubtest23of100,1,321,5179,11,77,5267
subtest24of10,pubtest23of100,1,321,5179,11,117,5307
subtest21of10,pubtest23of100,1,321,5179,15,153,5347
subtest210of10,pubtest23of100,1,321,5179,14,193,5386
subtest25of10,pubtest23of100,1,321,5179,15,231,5425
subtest22of10,pubtest23of100,1,321,5179,14,271,5464
subtest27of10,pubtest23of100,1,321,5179,15,311,5505
subtest26of10,pubtest23of100,1,321,5179,15,351,5545
subtest29of10,pubtest23of100,1,321,5179,12,389,5580
subtest23of10,pubtest24of100,1,321,5196,5,39,5240
subtest24of10,pubtest24of100,1,321,5196,6,77,5279
subtest25of10,pubtest24of100,1,321,5196,9,114,5319
subtest21of10,pubtest24of100,1,321,5196,13,150,5359
subtest29of10,pubtest24of100,1,321,5196,15,188,5399
subtest27of10,pubtest24of100,1,321,5196,15,228,5439
subtest28of10,pubtest24of100,1,321,5196,16,267,5479
subtest22of10,pubtest24of100,1,321,5196,17,306,5519
subtest210of10,pubtest24of100,1,321,5196,22,341,5559
subtest26of10,pubtest24of100,1,321,5196,25,377,5598
subtest21of10,pubtest25of100,1,321,5175,3,41,5219
subtest28of10,pubtest25of100,1,321,5175,3,79,5257
subtest27of10,pubtest25of100,1,321,5175,5,117,5297
subtest210of10,pubtest25of100,1,321,5175,6,156,5337
subtest25of10,pubtest25of100,1,321,5175,10,192,5377
subtest23of10,pubtest25of100,1,321,5175,15,227,5417
subtest26of10,pubtest25of100,1,321,5175,15,267,5457
subtest29of10,pubtest25of100,1,321,5175,19,303,5497
subtest22of10,pubtest25of100,1,321,5175,21,341,5537
subtest24of10,pubtest25of100,1,321,5175,22,380,5577
subtest21of10,pubtest26of100,1,321,5264,2,41,5307
subtest23of10,pubtest26of100,1,321,5264,5,77,5346
subtest22of10,pubtest26of100,1,321,5264,6,118,5388
subtest29of10,pubtest26of100,1,321,5264,7,156,5427
subtest27of10,pubtest26of100,1,321,5264,12,191,5467
subtest26of10,pubtest26of100,1,321,5264,15,227,5506
subtest25of10,pubtest26of100,1,321,5264,16,266,5546
subtest210of10,pubtest26of100,1,321,5264,20,302,5586
subtest24of10,pubtest26of100,1,321,5264,23,339,5626
subtest28of10,pubtest26of100,1,321,5264,23,379,5666
subtest27of10,pubtest27of100,1,320,5151,3,39,5193
subtest23of10,pubtest27of100,1,320,5151,6,75,5232
subtest24of10,pubtest27of100,1,320,5151,5,115,5271
subtest28of10,pubtest27of100,1,320,5151,5,154,5310
subtest210of10,pubtest27of100,1,320,5151,11,190,5352
subtest29of10,pubtest27of100,1,320,5151,14,227,5392
subtest25of10,pubtest27of100,1,320,5151,18,262,5431
subtest21of10,pubtest27of100,1,320,5151,18,302,5471
subtest26of10,pubtest27of100,1,320,5151,21,340,5512
subtest22of10,pubtest27of100,1,320,5151,21,380,5552
subtest27of10,pubtest28of100,1,321,5546,1,42,5589
subtest21of10,pubtest28of100,1,321,5546,4,78,5628
subtest28of10,pubtest28of100,1,321,5546,5,115,5666
subtest29of10,pubtest28of100,1,321,5546,11,152,5709
subtest23of10,pubtest28of100,1,321,5546,16,187,5749
subtest210of10,pubtest28of100,1,321,5546,17,225,5788
subtest25of10,pubtest28of100,1,321,5546,18,264,5828
subtest26of10,pubtest28of100,1,321,5546,25,297,5868
subtest24of10,pubtest28of100,1,321,5546,25,337,5908
subtest22of10,pubtest28of100,1,321,5546,27,375,5948
subtest23of10,pubtest29of100,1,321,5162,1,41,5204
subtest29of10,pubtest29of100,1,321,5162,8,73,5243
subtest210of10,pubtest29of100,1,321,5162,9,111,5282
subtest25of10,pubtest29of100,1,321,5162,11,368,5541
subtest22of10,pubtest29of100,1,321,5162,12,403,5577
subtest21of10,pubtest29of100,1,321,5162,13,443,5618
subtest28of10,pubtest29of100,1,321,5162,15,481,5658
subtest24of10,pubtest29of100,1,321,5162,17,517,5696
subtest27of10,pubtest29of100,1,321,5162,17,556,5735
subtest26of10,pubtest29of100,1,321,5162,20,596,5778
subtest29of10,pubtest210of100,1,323,5228,1,42,5271
subtest21of10,pubtest210of100,1,323,5228,3,78,5309
subtest27of10,pubtest210of100,1,323,5228,6,114,5348
subtest210of10,pubtest210of100,1,323,5228,5,154,5387
subtest28of10,pubtest210of100,1,323,5228,11,190,5429
subtest24of10,pubtest210of100,1,323,5228,16,225,5469
subtest23of10,pubtest210of100,1,323,5228,16,265,5509
subtest22of10,pubtest210of100,1,323,5228,18,302,5548
subtest25of10,pubtest210of100,1,323,5228,18,343,5589
subtest26of10,pubtest210of100,1,323,5228,20,381,5629
subtest210of10,pubtest211of100,1,323,5264,2,41,5307
subtest24of10,pubtest211of100,1,323,5264,3,79,5346
subtest29of10,pubtest211of100,1,323,5264,7,114,5385
subtest22of10,pubtest211of100,1,323,5264,8,153,5425
subtest21of10,pubtest211of100,1,323,5264,10,191,5465
subtest26of10,pubtest211of100,1,323,5264,12,229,5505
subtest28of10,pubtest211of100,1,323,5264,13,267,5544
subtest25of10,pubtest211of100,1,323,5264,13,307,5584
subtest23of10,pubtest211of100,1,323,5264,15,346,5625
subtest27of10,pubtest211of100,1,323,5264,14,387,5665
subtest25of10,pubtest212of100,1,323,5214,1,39,5254
subtest28of10,pubtest212of100,1,323,5214,3,77,5294
subtest29of10,pubtest212of100,1,323,5214,3,114,5331
subtest23of10,pubtest212of100,1,323,5214,5,154,5373
subtest27of10,pubtest212of100,1,323,5214,13,184,5411
subtest24of10,pubtest212of100,1,323,5214,16,223,5453
subtest21of10,pubtest212of100,1,323,5214,17,262,5493
subtest22of10,pubtest212of100,1,323,5214,20,299,5533
subtest26of10,pubtest212of100,1,323,5214,20,338,5572
subtest210of10,pubtest212of100,1,323,5214,21,380,5615
subtest23of10,pubtest213of100,1,322,5248,2,43,5293
subtest26of10,pubtest213of100,1,322,5248,4,80,5332
subtest29of10,pubtest213of100,1,322,5248,7,115,5370
subtest22of10,pubtest213of100,1,322,5248,7,155,5410
subtest27of10,pubtest213of100,1,322,5248,9,194,5451
subtest21of10,pubtest213of100,1,322,5248,10,233,5491
subtest24of10,pubtest213of100,1,322,5248,11,272,5531
subtest210of10,pubtest213of100,1,322,5248,15,308,5571
subtest25of10,pubtest213of100,1,322,5248,17,346,5611
subtest28of10,pubtest213of100,1,322,5248,25,378,5651
subtest21of10,pubtest214of100,1,323,5171,1,45,5217
subtest23of10,pubtest214of100,1,323,5171,8,77,5256
subtest25of10,pubtest214of100,1,323,5171,13,112,5296
subtest27of10,pubtest214of100,1,323,5171,14,148,5333
subtest26of10,pubtest214of100,1,323,5171,13,187,5371
subtest29of10,pubtest214of100,1,323,5171,16,227,5414
subtest22of10,pubtest214of100,1,323,5171,18,266,5455
subtest210of10,pubtest214of100,1,323,5171,23,301,5495
subtest24of10,pubtest214of100,1,323,5171,23,340,5534
subtest28of10,pubtest214of100,1,323,5171,25,379,5575
subtest27of10,pubtest215of100,1,323,5194,1,41,5236
subtest21of10,pubtest215of100,1,323,5194,3,77,5274
subtest24of10,pubtest215of100,1,323,5194,3,117,5314
subtest29of10,pubtest215of100,1,323,5194,1,158,5353
subtest26of10,pubtest215of100,1,323,5194,5,196,5395
subtest25of10,pubtest215of100,1,323,5194,10,231,5435
subtest23of10,pubtest215of100,1,323,5194,10,270,5474
subtest210of10,pubtest215of100,1,323,5194,11,310,5515
subtest22of10,pubtest215of100,1,323,5194,19,340,5553
subtest28of10,pubtest215of100,1,323,5194,21,380,5595
subtest24of10,pubtest216of100,1,323,5229,5,45,5279
subtest21of10,pubtest216of100,1,323,5229,5,84,5318
subtest23of10,pubtest216of100,1,323,5229,8,121,5358
subtest27of10,pubtest216of100,1,323,5229,8,161,5398
subtest25of10,pubtest216of100,1,323,5229,11,198,5438
subtest28of10,pubtest216of100,1,323,5229,16,233,5478
subtest29of10,pubtest216of100,1,323,5229,17,272,5518
subtest22of10,pubtest216of100,1,323,5229,20,309,5558
subtest26of10,pubtest216of100,1,323,5229,21,350,5600
subtest210of10,pubtest216of100,1,323,5229,23,386,5638
subtest27of10,pubtest217of100,1,322,5207,7,42,5256
subtest22of10,pubtest217of100,1,322,5207,8,80,5295
subtest21of10,pubtest217of100,1,322,5207,9,119,5335
subtest26of10,pubtest217of100,1,322,5207,10,159,5376
subtest23of10,pubtest217of100,1,322,5207,10,198,5415
subtest24of10,pubtest217of100,1,322,5207,12,236,5455
subtest29of10,pubtest217of100,1,322,5207,12,275,5494
subtest25of10,pubtest217of100,1,322,5207,12,315,5534
subtest28of10,pubtest217of100,1,322,5207,17,351,5575
subtest210of10,pubtest217of100,1,322,5207,18,388,5613
subtest29of10,pubtest218of100,1,323,5313,4,41,5358
subtest22of10,pubtest218of100,1,323,5313,5,78,5396
subtest21of10,pubtest218of100,1,323,5313,6,118,5437
subtest28of10,pubtest218of100,1,323,5313,8,155,5476
subtest27of10,pubtest218of100,1,323,5313,8,195,5516
subtest24of10,pubtest218of100,1,323,5313,14,230,5557
subtest25of10,pubtest218of100,1,323,5313,18,266,5597
subtest23of10,pubtest218of100,1,323,5313,18,306,5637
subtest210of10,pubtest218of100,1,323,5313,24,340,5677
subtest26of10,pubtest218of100,1,323,5313,24,381,5718
subtest210of10,pubtest219of100,1,323,5300,4,40,5344
subtest25of10,pubtest219of100,1,323,5300,4,78,5382
subtest21of10,pubtest219of100,1,323,5300,6,116,5422
subtest26of10,pubtest219of100,1,323,5300,6,155,5461
subtest29of10,pubtest219of100,1,323,5300,14,188,5502
subtest27of10,pubtest219of100,1,323,5300,15,226,5541
subtest24of10,pubtest219of100,1,323,5300,15,266,5581
subtest23of10,pubtest219of100,1,323,5300,15,303,5618
subtest28of10,pubtest219of100,1,323,5300,19,343,5662
subtest22of10,pubtest219of100,1,323,5300,14,382,5696
subtest23of10,pubtest220of100,1,323,5261,25,172,5458
subtest29of10,pubtest220of100,1,323,5261,32,215,5508
subtest25of10,pubtest220of100,1,323,5261,3,283,5547
subtest210of10,pubtest220of100,1,323,5261,32,294,5587
subtest27of10,pubtest220of100,1,323,5261,199,167,5627
subtest22of10,pubtest220of100,1,323,5261,201,206,5668
subtest26of10,pubtest220of100,1,323,5261,203,243,5707
subtest24of10,pubtest220of100,1,323,5261,205,281,5747
subtest21of10,pubtest220of100,1,323,5261,207,319,5787
subtest28of10,pubtest220of100,1,323,5261,208,357,5826
subtest24of10,pubtest221of100,1,323,5372,4,45,5421
subtest21of10,pubtest221of100,1,323,5372,5,82,5459
subtest23of10,pubtest221of100,1,323,5372,8,119,5499
subtest28of10,pubtest221of100,1,323,5372,7,158,5537
subtest22of10,pubtest221of100,1,323,5372,11,196,5579
subtest25of10,pubtest221of100,1,323,5372,34,213,5619
subtest210of10,pubtest221of100,1,323,5372,36,249,5657
subtest27of10,pubtest221of100,1,323,5372,39,288,5699
subtest29of10,pubtest221of100,1,323,5372,36,328,5736
subtest26of10,pubtest221of100,1,323,5372,40,367,5779
subtest22of10,pubtest222of100,1,323,5218,7,40,5265
subtest21of10,pubtest222of100,1,323,5218,8,78,5304
subtest29of10,pubtest222of100,1,323,5218,11,115,5344
subtest27of10,pubtest222of100,1,323,5218,12,154,5384
subtest28of10,pubtest222of100,1,323,5218,13,193,5424
subtest23of10,pubtest222of100,1,323,5218,13,234,5465
subtest210of10,pubtest222of100,1,323,5218,18,269,5505
subtest25of10,pubtest222of100,1,323,5218,18,308,5544
subtest24of10,pubtest222of100,1,323,5218,27,339,5584
subtest26of10,pubtest222of100,1,323,5218,27,381,5626
subtest21of10,pubtest223of100,1,323,5256,2,240,5498
subtest23of10,pubtest223of100,1,323,5256,10,271,5537
subtest28of10,pubtest223of100,1,323,5256,12,309,5577
subtest29of10,pubtest223of100,1,323,5256,16,345,5617
subtest24of10,pubtest223of100,1,323,5256,15,385,5656
subtest210of10,pubtest223of100,1,323,5256,17,424,5697
subtest27of10,pubtest223of100,1,323,5256,18,460,5734
subtest25of10,pubtest223of100,1,323,5256,21,500,5777
subtest26of10,pubtest223of100,1,323,5256,20,539,5815
subtest22of10,pubtest223of100,1,323,5256,20,579,5855
subtest21of10,pubtest224of100,1,323,5197,-1,42,5238
subtest28of10,pubtest224of100,1,323,5197,1,78,5276
subtest27of10,pubtest224of100,1,323,5197,3,117,5317
subtest23of10,pubtest224of100,1,323,5197,9,233,5439
subtest29of10,pubtest224of100,1,323,5197,19,224,5440
subtest26of10,pubtest224of100,1,323,5197,9,234,5440
subtest25of10,pubtest224of100,1,323,5197,23,258,5478
subtest22of10,pubtest224of100,1,323,5197,23,297,5517
subtest24of10,pubtest224of100,1,323,5197,25,335,5557
subtest210of10,pubtest224of100,1,323,5197,25,375,5597
subtest22of10,pubtest225of100,1,323,5209,3,43,5255
subtest27of10,pubtest225of100,1,323,5209,3,82,5294
subtest21of10,pubtest225of100,1,323,5209,9,115,5333
subtest26of10,pubtest225of100,1,323,5209,15,149,5373
subtest25of10,pubtest225of100,1,323,5209,38,166,5413
subtest24of10,pubtest225of100,1,323,5209,41,200,5450
subtest29of10,pubtest225of100,1,323,5209,44,240,5493
subtest28of10,pubtest225of100,1,323,5209,45,279,5533
subtest210of10,pubtest225of100,1,323,5209,47,317,5573
subtest23of10,pubtest225of100,1,323,5209,41,357,5607
subtest25of10,pubtest226of100,1,323,5190,4,38,5232
subtest23of10,pubtest226of100,1,323,5190,6,75,5271
subtest22of10,pubtest226of100,1,323,5190,4,117,5311
subtest210of10,pubtest226of100,1,323,5190,7,154,5351
subtest27of10,pubtest226of100,1,323,5190,14,187,5391
subtest21of10,pubtest226of100,1,323,5190,18,223,5431
subtest29of10,pubtest226of100,1,323,5190,18,263,5471
subtest28of10,pubtest226of100,1,323,5190,25,296,5511
subtest26of10,pubtest226of100,1,323,5190,25,336,5551
subtest24of10,pubtest226of100,1,323,5190,28,373,5591
subtest29of10,pubtest227of100,1,323,5199,4,41,5244
subtest25of10,pubtest227of100,1,323,5199,16,65,5280
subtest27of10,pubtest227of100,1,323,5199,18,104,5321
subtest210of10,pubtest227of100,1,323,5199,16,143,5358
subtest24of10,pubtest227of100,1,323,5199,18,183,5400
subtest23of10,pubtest227of100,1,323,5199,17,222,5438
subtest26of10,pubtest227of100,1,323,5199,26,257,5482
subtest22of10,pubtest227of100,1,323,5199,27,297,5523
subtest21of10,pubtest227of100,1,323,5199,26,338,5563
subtest28of10,pubtest227of100,1,323,5199,29,375,5603
subtest21of10,pubtest228of100,1,323,5143,1,39,5183
subtest26of10,pubtest228of100,1,323,5143,9,70,5222
subtest25of10,pubtest228of100,1,323,5143,12,107,5262
subtest29of10,pubtest228of100,1,323,5143,14,145,5302
subtest23of10,pubtest228of100,1,323,5143,13,185,5341
subtest24of10,pubtest228of100,1,323,5143,14,224,5381
subtest27of10,pubtest228of100,1,323,5143,14,264,5421
subtest28of10,pubtest228of100,1,323,5143,19,300,5462
subtest22of10,pubtest228of100,1,323,5143,19,340,5502
subtest210of10,pubtest228of100,1,323,5143,21,378,5542
subtest23of10,pubtest229of100,1,321,5212,9,40,5261
subtest24of10,pubtest229of100,1,321,5212,5,83,5300
subtest28of10,pubtest229of100,1,321,5212,8,120,5340
subtest27of10,pubtest229of100,1,321,5212,8,159,5379
subtest29of10,pubtest229of100,1,321,5212,10,198,5420
subtest21of10,pubtest229of100,1,321,5212,6,237,5455
subtest25of10,pubtest229of100,1,321,5212,8,276,5496
subtest22of10,pubtest229of100,1,321,5212,13,315,5540
subtest26of10,pubtest229of100,1,321,5212,36,332,5580
subtest210of10,pubtest229of100,1,321,5212,36,371,5619
subtest22of10,pubtest230of100,1,323,5186,4,40,5230
subtest21of10,pubtest230of100,1,323,5186,6,77,5269
subtest27of10,pubtest230of100,1,323,5186,11,112,5309
subtest29of10,pubtest230of100,1,323,5186,14,149,5349
subtest25of10,pubtest230of100,1,323,5186,15,188,5389
subtest28of10,pubtest230of100,1,323,5186,18,225,5429
subtest23of10,pubtest230of100,1,323,5186,18,265,5469
subtest24of10,pubtest230of100,1,323,5186,20,303,5509
subtest210of10,pubtest230of100,1,323,5186,20,343,5549
subtest26of10,pubtest230of100,1,323,5186,22,381,5589
subtest25of10,pubtest231of100,1,323,5224,8,39,5271
subtest23of10,pubtest231of100,1,323,5224,7,80,5311
subtest28of10,pubtest231of100,1,323,5224,16,110,5350
subtest24of10,pubtest231of100,1,323,5224,17,149,5390
subtest29of10,pubtest231of100,1,323,5224,18,188,5430
subtest210of10,pubtest231of100,1,323,5224,23,223,5470
subtest27of10,pubtest231of100,1,323,5224,24,262,5510
subtest26of10,pubtest231of100,1,323,5224,28,298,5550
subtest22of10,pubtest231of100,1,323,5224,28,338,5590
subtest21of10,pubtest231of100,1,323,5224,29,377,5630
subtest21of10,pubtest232of100,1,323,5201,0,42,5243
subtest27of10,pubtest232of100,1,323,5201,1,78,5280
subtest22of10,pubtest232of100,1,323,5201,10,110,5321
subtest28of10,pubtest232of100,1,323,5201,14,146,5361
subtest210of10,pubtest232of100,1,323,5201,15,185,5401
subtest23of10,pubtest232of100,1,323,5201,15,224,5440
subtest29of10,pubtest232of100,1,323,5201,17,263,5481
subtest24of10,pubtest232of100,1,323,5201,21,299,5521
subtest25of10,pubtest232of100,1,323,5201,21,339,5561
subtest26of10,pubtest232of100,1,323,5201,22,378,5601
subtest24of10,pubtest233of100,1,323,5290,2,39,5331
subtest29of10,pubtest233of100,1,323,5290,6,75,5371
subtest25of10,pubtest233of100,1,323,5290,7,113,5410
subtest210of10,pubtest233of100,1,323,5290,12,148,5450
subtest27of10,pubtest233of100,1,323,5290,13,184,5487
subtest21of10,pubtest233of100,1,323,5290,16,224,5530
subtest26of10,pubtest233of100,1,323,5290,16,263,5569
subtest23of10,pubtest233of100,1,323,5290,17,305,5612
subtest22of10,pubtest233of100,1,323,5290,26,334,5650
subtest28of10,pubtest233of100,1,323,5290,52,348,5690
subtest25of10,pubtest234of100,1,323,5188,-1,42,5229
subtest26of10,pubtest234of100,1,323,5188,-1,81,5268
subtest27of10,pubtest234of100,1,323,5188,2,118,5308
subtest22of10,pubtest234of100,1,323,5188,3,156,5347
subtest21of10,pubtest234of100,1,323,5188,4,196,5388
subtest29of10,pubtest234of100,1,323,5188,6,234,5428
subtest210of10,pubtest234of100,1,323,5188,5,274,5467
subtest23of10,pubtest234of100,1,323,5188,10,309,5507
subtest24of10,pubtest234of100,1,323,5188,12,348,5548
subtest28of10,pubtest234of100,1,323,5188,16,384,5588
subtest23of10,pubtest235of100,1,321,5253,4,40,5297
subtest21of10,pubtest235of100,1,321,5253,4,79,5336
subtest210of10,pubtest235of100,1,321,5253,12,113,5378
subtest27of10,pubtest235of100,1,321,5253,18,146,5417
subtest22of10,pubtest235of100,1,321,5253,18,185,5456
subtest25of10,pubtest235of100,1,321,5253,20,223,5496
subtest29of10,pubtest235of100,1,321,5253,20,263,5536
subtest24of10,pubtest235of100,1,321,5253,21,302,5576
subtest26of10,pubtest235of100,1,321,5253,22,342,5617
subtest28of10,pubtest235of100,1,321,5253,23,380,5656
subtest210of10,pubtest236of100,1,323,5197,2,41,5240
subtest23of10,pubtest236of100,1,323,5197,6,76,5279
subtest27of10,pubtest236of100,1,323,5197,6,116,5319
subtest28of10,pubtest236of100,1,323,5197,11,150,5358
subtest25of10,pubtest236of100,1,323,5197,11,190,5398
subtest29of10,pubtest236of100,1,323,5197,24,218,5439
subtest24of10,pubtest236of100,1,323,5197,24,258,5479
subtest21of10,pubtest236of100,1,323,5197,24,297,5518
subtest22of10,pubtest236of100,1,323,5197,26,336,5559
subtest26of10,pubtest236of100,1,323,5197,27,375,5599
subtest24of10,pubtest237of100,1,323,5166,4,45,5215
subtest28of10,pubtest237of100,1,323,5166,4,83,5253
subtest23of10,pubtest237of100,1,323,5166,6,122,5294
subtest25of10,pubtest237of100,1,323,5166,8,160,5334
subtest22of10,pubtest237of100,1,323,5166,13,195,5374
subtest26of10,pubtest237of100,1,323,5166,13,235,5414
subtest27of10,pubtest237of100,1,323,5166,17,271,5454
subtest29of10,pubtest237of100,1,323,5166,22,306,5494
subtest210of10,pubtest237of100,1,323,5166,22,346,5534
subtest21of10,pubtest237of100,1,323,5166,22,385,5573
subtest22of10,pubtest238of100,1,323,5219,8,41,5268
subtest27of10,pubtest238of100,1,323,5219,8,80,5307
subtest29of10,pubtest238of100,1,323,5219,7,118,5344
subtest28of10,pubtest238of100,1,323,5219,10,158,5387
subtest25of10,pubtest238of100,1,323,5219,13,193,5425
subtest23of10,pubtest238of100,1,323,5219,14,233,5466
subtest21of10,pubtest238of100,1,323,5219,15,272,5506
subtest210of10,pubtest238of100,1,323,5219,15,312,5546
subtest26of10,pubtest238of100,1,323,5219,18,347,5584
subtest24of10,pubtest238of100,1,323,5219,20,387,5626
subtest21of10,pubtest239of100,1,323,5286,2,43,5331
subtest28of10,pubtest239of100,1,323,5286,2,83,5371
subtest27of10,pubtest239of100,1,323,5286,4,119,5409
subtest26of10,pubtest239of100,1,323,5286,8,157,5451
subtest25of10,pubtest239of100,1,323,5286,13,191,5490
subtest29of10,pubtest239of100,1,323,5286,13,231,5530
subtest24of10,pubtest239of100,1,323,5286,17,267,5570
subtest23of10,pubtest239of100,1,323,5286,17,307,5610
subtest210of10,pubtest239of100,1,323,5286,19,345,5650
subtest22of10,pubtest239of100,1,323,5286,19,385,5690
subtest25of10,pubtest240of100,1,323,5248,2,40,5290
subtest21of10,pubtest240of100,1,323,5248,5,76,5329
subtest29of10,pubtest240of100,1,323,5248,5,116,5369
subtest27of10,pubtest240of100,1,323,5248,14,147,5409
subtest210of10,pubtest240of100,1,323,5248,14,187,5449
subtest23of10,pubtest240of100,1,323,5248,18,223,5489
subtest28of10,pubtest240of100,1,323,5248,18,263,5529
subtest24of10,pubtest240of100,1,323,5248,20,299,5567
subtest26of10,pubtest240of100,1,323,5248,22,339,5609
subtest22of10,pubtest240of100,1,323,5248,20,378,5646
subtest23of10,pubtest241of100,1,323,5226,3,40,5269
subtest24of10,pubtest241of100,1,323,5226,11,71,5308
subtest27of10,pubtest241of100,1,323,5226,11,111,5348
subtest210of10,pubtest241of100,1,323,5226,13,149,5388
subtest21of10,pubtest241of100,1,323,5226,13,189,5428
subtest29of10,pubtest241of100,1,323,5226,17,224,5467
subtest25of10,pubtest241of100,1,323,5226,18,262,5506
subtest26of10,pubtest241of100,1,323,5226,21,301,5548
subtest28of10,pubtest241of100,1,323,5226,21,341,5588
subtest22of10,pubtest241of100,1,323,5226,22,380,5628
subtest27of10,pubtest242of100,1,323,5286,2,40,5328
subtest23of10,pubtest242of100,1,323,5286,5,76,5367
subtest25of10,pubtest242of100,1,323,5286,5,115,5406
subtest29of10,pubtest242of100,1,323,5286,8,152,5446
subtest21of10,pubtest242of100,1,323,5286,16,184,5486
subtest210of10,pubtest242of100,1,323,5286,19,220,5525
subtest26of10,pubtest242of100,1,323,5286,19,261,5566
subtest24of10,pubtest242of100,1,323,5286,21,299,5606
subtest22of10,pubtest242of100,1,323,5286,21,339,5646
subtest28of10,pubtest242of100,1,323,5286,23,377,5686
subtest28of10,pubtest243of100,1,323,5335,5,38,5378
subtest29of10,pubtest243of100,1,323,5335,33,49,5417
subtest23of10,pubtest243of100,1,323,5335,35,87,5457
subtest22of10,pubtest243of100,1,323,5335,36,126,5497
subtest27of10,pubtest243of100,1,323,5335,37,166,5538
subtest25of10,pubtest243of100,1,323,5335,38,204,5577
subtest26of10,pubtest243of100,1,323,5335,39,243,5617
subtest21of10,pubtest243of100,1,323,5335,42,281,5658
subtest24of10,pubtest243of100,1,323,5335,56,307,5698
subtest210of10,pubtest243of100,1,323,5335,82,321,5738
subtest26of10,pubtest244of100,1,323,5153,4,41,5198
subtest25of10,pubtest244of100,1,323,5153,5,79,5237
subtest27of10,pubtest244of100,1,323,5153,4,118,5275
subtest28of10,pubtest244of100,1,323,5153,13,151,5317
subtest29of10,pubtest244of100,1,323,5153,13,191,5357
subtest21of10,pubtest244of100,1,323,5153,15,231,5399
subtest23of10,pubtest244of100,1,323,5153,16,269,5438
subtest210of10,pubtest244of100,1,323,5153,17,308,5478
subtest22of10,pubtest244of100,1,323,5153,21,344,5518
subtest24of10,pubtest244of100,1,323,5153,22,382,5557
subtest29of10,pubtest245of100,1,322,5263,10,48,5321
subtest26of10,pubtest245of100,1,322,5263,10,87,5360
subtest210of10,pubtest245of100,1,322,5263,15,122,5400
subtest28of10,pubtest245of100,1,322,5263,13,162,5438
subtest27of10,pubtest245of100,1,322,5263,17,200,5480
subtest21of10,pubtest245of100,1,322,5263,18,239,5520
subtest22of10,pubtest245of100,1,322,5263,12,279,5554
subtest23of10,pubtest245of100,1,322,5263,19,318,5600
subtest25of10,pubtest245of100,1,322,5263,12,356,5631
subtest24of10,pubtest245of100,1,322,5263,20,395,5678
subtest27of10,pubtest246of100,1,323,5180,23,43,5246
subtest26of10,pubtest246of100,1,323,5180,24,81,5285
subtest29of10,pubtest246of100,1,323,5180,25,119,5324
subtest21of10,pubtest246of100,1,323,5180,24,159,5363
subtest210of10,pubtest246of100,1,323,5180,33,191,5404
subtest28of10,pubtest246of100,1,323,5180,32,228,5440
subtest25of10,pubtest246of100,1,323,5180,32,268,5480
subtest23of10,pubtest246of100,1,323,5180,32,308,5520
subtest24of10,pubtest246of100,1,323,5180,36,347,5563
subtest22of10,pubtest246of100,1,323,5180,38,387,5605
subtest27of10,pubtest247of100,1,323,5194,4,38,5236
subtest23of10,pubtest247of100,1,323,5194,4,77,5275
subtest26of10,pubtest247of100,1,323,5194,6,115,5315
subtest21of10,pubtest247of100,1,323,5194,8,153,5355
subtest29of10,pubtest247of100,1,323,5194,12,189,5395
subtest28of10,pubtest247of100,1,323,5194,15,226,5435
subtest22of10,pubtest247of100,1,323,5194,15,266,5475
subtest25of10,pubtest247of100,1,323,5194,19,302,5515
subtest210of10,pubtest247of100,1,323,5194,26,336,5556
subtest24of10,pubtest247of100,1,323,5194,27,374,5595
subtest29of10,pubtest248of100,1,323,5183,2,44,5229
subtest28of10,pubtest248of100,1,323,5183,10,74,5267
subtest26of10,pubtest248of100,1,323,5183,10,113,5306
subtest25of10,pubtest248of100,1,323,5183,13,153,5349
subtest23of10,pubtest248of100,1,323,5183,14,191,5388
subtest27of10,pubtest248of100,1,323,5183,17,228,5428
subtest24of10,pubtest248of100,1,323,5183,18,267,5468
subtest22of10,pubtest248of100,1,323,5183,19,306,5508
subtest21of10,pubtest248of100,1,323,5183,19,346,5548
subtest210of10,pubtest248of100,1,323,5183,21,385,5589
subtest28of10,pubtest249of100,1,323,5176,8,42,5226
subtest27of10,pubtest249of100,1,323,5176,8,81,5265
subtest24of10,pubtest249of100,1,323,5176,10,120,5306
subtest26of10,pubtest249of100,1,323,5176,11,158,5345
subtest21of10,pubtest249of100,1,323,5176,13,196,5385
subtest25of10,pubtest249of100,1,323,5176,11,237,5424
subtest29of10,pubtest249of100,1,323,5176,14,275,5465
subtest22of10,pubtest249of100,1,323,5176,20,309,5505
subtest23of10,pubtest249of100,1,323,5176,20,349,5545
subtest210of10,pubtest249of100,1,323,5176,22,387,5585
subtest27of10,pubtest250of100,1,323,5164,3,38,5205
subtest23of10,pubtest250of100,1,323,5164,5,76,5245
subtest28of10,pubtest250of100,1,323,5164,6,113,5283
subtest29of10,pubtest250of100,1,323,5164,12,149,5325
subtest21of10,pubtest250of100,1,323,5164,16,184,5364
subtest25of10,pubtest250of100,1,323,5164,17,223,5404
subtest24of10,pubtest250of100,1,323,5164,18,262,5444
subtest210of10,pubtest250of100,1,323,5164,27,293,5484
subtest22of10,pubtest250of100,1,323,5164,27,333,5524
subtest26of10,pubtest250of100,1,323,5164,28,370,5562
subtest23of10,pubtest251of100,1,323,5260,5,39,5304
subtest22of10,pubtest251of100,1,323,5260,6,77,5343
subtest24of10,pubtest251of100,1,323,5260,13,111,5384
subtest27of10,pubtest251of100,1,323,5260,17,146,5423
subtest210of10,pubtest251of100,1,323,5260,19,183,5462
subtest21of10,pubtest251of100,1,323,5260,19,223,5502
subtest29of10,pubtest251of100,1,323,5260,19,263,5542
subtest25of10,pubtest251of100,1,323,5260,17,300,5577
subtest26of10,pubtest251of100,1,323,5260,20,338,5618
subtest28of10,pubtest251of100,1,323,5260,18,377,5655
subtest28of10,pubtest252of100,1,323,5313,4,429,5746
subtest29of10,pubtest252of100,1,323,5313,5,468,5786
subtest21of10,pubtest252of100,1,323,5313,5,507,5825
subtest27of10,pubtest252of100,1,323,5313,7,544,5864
subtest25of10,pubtest252of100,1,323,5313,7,584,5904
subtest26of10,pubtest252of100,1,323,5313,10,621,5944
subtest23of10,pubtest252of100,1,323,5313,14,658,5985
subtest22of10,pubtest252of100,1,323,5313,14,698,6025
subtest24of10,pubtest252of100,1,323,5313,15,736,6064
subtest210of10,pubtest252of100,1,323,5313,16,776,6105
subtest28of10,pubtest253of100,1,322,5192,5,160,5357
subtest23of10,pubtest253of100,1,322,5192,5,198,5395
subtest25of10,pubtest253of100,1,322,5192,165,77,5434
subtest26of10,pubtest253of100,1,322,5192,166,116,5474
subtest24of10,pubtest253of100,1,322,5192,167,155,5514
subtest22of10,pubtest253of100,1,322,5192,168,194,5554
subtest210of10,pubtest253of100,1,322,5192,168,234,5594
subtest29of10,pubtest253of100,1,322,5192,169,273,5634
subtest27of10,pubtest253of100,1,322,5192,169,313,5674
subtest21of10,pubtest253of100,1,322,5192,171,352,5715
subtest210of10,pubtest254of100,1,323,5193,3,40,5236
subtest27of10,pubtest254of100,1,323,5193,3,79,5275
subtest28of10,pubtest254of100,1,323,5193,6,118,5317
subtest21of10,pubtest254of100,1,323,5193,5,156,5354
subtest25of10,pubtest254of100,1,323,5193,15,187,5395
subtest24of10,pubtest254of100,1,323,5193,20,222,5435
subtest23of10,pubtest254of100,1,323,5193,20,262,5475
subtest22of10,pubtest254of100,1,323,5193,22,300,5515
subtest29of10,pubtest254of100,1,323,5193,22,338,5553
subtest26of10,pubtest254of100,1,323,5193,23,378,5594
subtest22of10,pubtest255of100,1,322,5165,3,42,5210
subtest27of10,pubtest255of100,1,322,5165,5,79,5249
subtest23of10,pubtest255of100,1,322,5165,5,117,5287
subtest29of10,pubtest255of100,1,322,5165,8,156,5329
subtest28of10,pubtest255of100,1,322,5165,12,192,5369
subtest25of10,pubtest255of100,1,322,5165,13,231,5409
subtest24of10,pubtest255of100,1,322,5165,14,271,5450
subtest21of10,pubtest255of100,1,322,5165,13,308,5486
subtest26of10,pubtest255of100,1,322,5165,27,337,5529
subtest210of10,pubtest255of100,1,322,5165,26,377,5568
subtest29of10,pubtest256of100,1,323,5218,5,46,5269
subtest23of10,pubtest256of100,1,323,5218,7,83,5308
subtest210of10,pubtest256of100,1,323,5218,9,121,5348
subtest28of10,pubtest256of100,1,323,5218,10,160,5388
subtest26of10,pubtest256of100,1,323,5218,6,199,5423
subtest21of10,pubtest256of100,1,323,5218,12,236,5466
subtest25of10,pubtest256of100,1,323,5218,17,273,5508
subtest22of10,pubtest256of100,1,323,5218,26,304,5548
subtest24of10,pubtest256of100,1,323,5218,29,341,5588
subtest27of10,pubtest256of100,1,323,5218,29,381,5628
subtest24of10,pubtest257of100,1,323,5154,3,43,5200
subtest21of10,pubtest257of100,1,323,5154,6,80,5240
subtest28of10,pubtest257of100,1,323,5154,11,113,5278
subtest27of10,pubtest257of100,1,323,5154,10,152,5316
subtest23of10,pubtest257of100,1,323,5154,13,192,5359
subtest29of10,pubtest257of100,1,323,5154,16,229,5399
subtest22of10,pubtest257of100,1,323,5154,16,269,5439
subtest25of10,pubtest257of100,1,323,5154,23,302,5479
subtest210of10,pubtest257of100,1,323,5154,26,339,5519
subtest26of10,pubtest257of100,1,323,5154,26,379,5559
subtest25of10,pubtest258of100,1,323,5270,6,43,5319
subtest23of10,pubtest258of100,1,323,5270,5,82,5357
subtest28of10,pubtest258of100,1,323,5270,3,121,5394
subtest26of10,pubtest258of100,1,323,5270,8,159,5437
subtest21of10,pubtest258of100,1,323,5270,9,198,5477
subtest29of10,pubtest258of100,1,323,5270,10,237,5517
subtest27of10,pubtest258of100,1,323,5270,12,274,5556
subtest22of10,pubtest258of100,1,323,5270,13,314,5597
subtest210of10,pubtest258of100,1,323,5270,12,353,5635
subtest24of10,pubtest258of100,1,323,5270,22,385,5677
subtest21of10,pubtest259of100,1,323,5281,2,41,5324
subtest25of10,pubtest259of100,1,323,5281,11,71,5363
subtest28of10,pubtest259of100,1,323,5281,11,111,5403
subtest24of10,pubtest259of100,1,323,5281,13,149,5443
subtest27of10,pubtest259of100,1,323,5281,17,185,5483
subtest26of10,pubtest259of100,1,323,5281,17,224,5522
subtest29of10,pubtest259of100,1,323,5281,19,263,5563
subtest23of10,pubtest259of100,1,323,5281,19,303,5603
subtest22of10,pubtest259of100,1,323,5281,19,342,5642
subtest210of10,pubtest259of100,1,323,5281,20,382,5683
subtest210of10,pubtest260of100,1,323,5280,1,39,5320
subtest26of10,pubtest260of100,1,323,5280,2,78,5360
subtest23of10,pubtest260of100,1,323,5280,3,115,5398
subtest21of10,pubtest260of100,1,323,5280,8,151,5439
subtest27of10,pubtest260of100,1,323,5280,9,190,5479
subtest22of10,pubtest260of100,1,323,5280,16,223,5519
subtest29of10,pubtest260of100,1,323,5280,16,263,5559
subtest24of10,pubtest260of100,1,323,5280,20,299,5599
subtest28of10,pubtest260of100,1,323,5280,20,339,5639
subtest25of10,pubtest260of100,1,323,5280,18,377,5675
subtest25of10,pubtest261of100,1,323,5263,4,42,5309
subtest28of10,pubtest261of100,1,323,5263,6,80,5349
subtest29of10,pubtest261of100,1,323,5263,8,118,5389
subtest210of10,pubtest261of100,1,323,5263,16,149,5428
subtest23of10,pubtest261of100,1,323,5263,16,189,5468
subtest27of10,pubtest261of100,1,323,5263,28,218,5509
subtest22of10,pubtest261of100,1,323,5263,28,258,5549
subtest21of10,pubtest261of100,1,323,5263,33,293,5589
subtest24of10,pubtest261of100,1,323,5263,34,332,5629
subtest26of10,pubtest261of100,1,323,5263,35,371,5669
subtest23of10,pubtest262of100,1,323,5387,0,40,5427
subtest21of10,pubtest262of100,1,323,5387,0,80,5467
subtest27of10,pubtest262of100,1,323,5387,0,118,5505
subtest29of10,pubtest262of100,1,323,5387,32,129,5548
subtest25of10,pubtest262of100,1,323,5387,47,154,5588
subtest22of10,pubtest262of100,1,323,5387,51,190,5628
subtest26of10,pubtest262of100,1,323,5387,51,230,5668
subtest24of10,pubtest262of100,1,323,5387,53,268,5708
subtest210of10,pubtest262of100,1,323,5387,52,309,5748
subtest28of10,pubtest262of100,1,323,5387,54,347,5788
subtest22of10,pubtest263of100,1,322,5504,4,41,5549
subtest29of10,pubtest263of100,1,322,5504,6,78,5588
subtest24of10,pubtest263of100,1,322,5504,8,115,5627
subtest23of10,pubtest263of100,1,322,5504,12,153,5669
subtest26of10,pubtest263of100,1,322,5504,12,191,5707
subtest210of10,pubtest263of100,1,322,5504,16,227,5747
subtest25of10,pubtest263of100,1,322,5504,16,267,5787
subtest28of10,pubtest263of100,1,322,5504,18,305,5827
subtest27of10,pubtest263of100,1,322,5504,21,342,5867
subtest21of10,pubtest263of100,1,322,5504,23,380,5907
subtest22of10,pubtest264of100,1,322,5265,3,40,5308
subtest29of10,pubtest264of100,1,322,5265,4,79,5348
subtest24of10,pubtest264of100,1,322,5265,5,117,5387
subtest23of10,pubtest264of100,1,322,5265,8,154,5427
subtest27of10,pubtest264of100,1,322,5265,9,193,5467
subtest28of10,pubtest264of100,1,322,5265,10,231,5506
subtest21of10,pubtest264of100,1,322,5265,12,270,5547
subtest25of10,pubtest264of100,1,322,5265,13,309,5587
subtest26of10,pubtest264of100,1,322,5265,18,344,5627
subtest210of10,pubtest264of100,1,322,5265,22,380,5667
subtest26of10,pubtest265of100,1,323,5220,5,115,5340
subtest27of10,pubtest265of100,1,323,5220,6,153,5379
subtest210of10,pubtest265of100,1,323,5220,8,191,5419
subtest21of10,pubtest265of100,1,323,5220,9,230,5459
subtest29of10,pubtest265of100,1,323,5220,11,268,5499
subtest22of10,pubtest265of100,1,323,5220,11,308,5539
subtest28of10,pubtest265of100,1,323,5220,14,345,5579
subtest24of10,pubtest265of100,1,323,5220,15,385,5620
subtest23of10,pubtest265of100,1,323,5220,16,423,5659
subtest25of10,pubtest265of100,1,323,5220,16,463,5699
subtest29of10,pubtest266of100,1,321,5244,4,41,5289
subtest210of10,pubtest266of100,1,321,5244,6,78,5328
subtest25of10,pubtest266of100,1,321,5244,9,116,5369
subtest27of10,pubtest266of100,1,321,5244,9,155,5408
subtest23of10,pubtest266of100,1,321,5244,18,186,5448
subtest28of10,pubtest266of100,1,321,5244,23,221,5488
subtest26of10,pubtest266of100,1,321,5244,23,262,5529
subtest21of10,pubtest266of100,1,321,5244,23,300,5567
subtest24of10,pubtest266of100,1,321,5244,26,338,5608
subtest22of10,pubtest266of100,1,321,5244,26,378,5648
subtest23of10,pubtest267of100,1,323,5156,7,40,5203
subtest26of10,pubtest267of100,1,323,5156,8,80,5244
subtest28of10,pubtest267of100,1,323,5156,9,118,5283
subtest25of10,pubtest267of100,1,323,5156,12,154,5322
subtest24of10,pubtest267of100,1,323,5156,13,193,5362
subtest27of10,pubtest267of100,1,323,5156,19,227,5402
subtest22of10,pubtest267of100,1,323,5156,19,267,5442
subtest29of10,pubtest267of100,1,323,5156,20,306,5482
subtest210of10,pubtest267of100,1,323,5156,22,344,5522
subtest21of10,pubtest267of100,1,323,5156,26,380,5562
subtest23of10,pubtest268of100,1,323,5225,7,38,5270
subtest24of10,pubtest268of100,1,323,5225,14,71,5310
subtest25of10,pubtest268of100,1,323,5225,15,110,5350
subtest29of10,pubtest268of100,1,323,5225,18,146,5389
subtest27of10,pubtest268of100,1,323,5225,19,185,5429
subtest28of10,pubtest268of100,1,323,5225,20,224,5469
subtest22of10,pubtest268of100,1,323,5225,20,264,5509
subtest21of10,pubtest268of100,1,323,5225,21,301,5547
subtest210of10,pubtest268of100,1,323,5225,24,340,5589
subtest26of10,pubtest268of100,1,323,5225,25,380,5630
subtest24of10,pubtest269of100,1,323,5217,5,431,5653
subtest27of10,pubtest269of100,1,323,5217,6,469,5692
subtest210of10,pubtest269of100,1,323,5217,7,508,5732
subtest25of10,pubtest269of100,1,323,5217,13,540,5770
subtest22of10,pubtest269of100,1,323,5217,16,579,5812
subtest23of10,pubtest269of100,1,323,5217,17,618,5852
subtest21of10,pubtest269of100,1,323,5217,17,658,5892
subtest28of10,pubtest269of100,1,323,5217,19,696,5932
subtest29of10,pubtest269of100,1,323,5217,19,736,5972
subtest26of10,pubtest269of100,1,323,5217,13,776,6006
subtest23of10,pubtest270of100,1,323,5227,4,41,5272
subtest26of10,pubtest270of100,1,323,5227,7,76,5310
subtest27of10,pubtest270of100,1,323,5227,9,115,5351
subtest210of10,pubtest270of100,1,323,5227,13,150,5390
subtest29of10,pubtest270of100,1,323,5227,15,188,5430
subtest25of10,pubtest270of100,1,323,5227,18,225,5470
subtest28of10,pubtest270of100,1,323,5227,19,263,5509
subtest21of10,pubtest270of100,1,323,5227,20,305,5552
subtest22of10,pubtest270of100,1,323,5227,21,342,5590
subtest24of10,pubtest270of100,1,323,5227,23,381,5631
subtest24of10,pubtest271of100,1,323,5279,-1,41,5319
subtest25of10,pubtest271of100,1,323,5279,0,80,5359
subtest27of10,pubtest271of100,1,323,5279,3,115,5397
subtest22of10,pubtest271of100,1,323,5279,8,150,5437
subtest210of10,pubtest271of100,1,323,5279,10,189,5478
subtest21of10,pubtest271of100,1,323,5279,14,225,5518
subtest29of10,pubtest271of100,1,323,5279,15,263,5557
subtest23of10,pubtest271of100,1,323,5279,16,303,5598
subtest26of10,pubtest271of100,1,323,5279,16,341,5636
subtest28of10,pubtest271of100,1,323,5279,30,368,5677
subtest25of10,pubtest272of100,1,323,5211,3,40,5254
subtest26of10,pubtest272of100,1,323,5211,3,79,5293
subtest21of10,pubtest272of100,1,323,5211,5,117,5333
subtest24of10,pubtest272of100,1,323,5211,7,155,5373
subtest29of10,pubtest272of100,1,323,5211,6,195,5412
subtest23of10,pubtest272of100,1,323,5211,8,231,5450
subtest22of10,pubtest272of100,1,323,5211,12,269,5492
subtest210of10,pubtest272of100,1,323,5211,13,309,5533
subtest27of10,pubtest272of100,1,323,5211,9,349,5569
subtest28of10,pubtest272of100,1,323,5211,14,387,5612
subtest22of10,pubtest273of100,1,321,5190,2,39,5231
subtest29of10,pubtest273of100,1,321,5190,5,75,5270
subtest26of10,pubtest273of100,1,321,5190,11,109,5310
subtest28of10,pubtest273of100,1,321,5190,16,144,5350
subtest25of10,pubtest273of100,1,321,5190,16,184,5390
subtest27of10,pubtest273of100,1,321,5190,21,219,5430
subtest23of10,pubtest273of100,1,321,5190,23,257,5470
subtest21of10,pubtest273of100,1,321,5190,23,297,5510
subtest210of10,pubtest273of100,1,321,5190,21,336,5547
subtest24of10,pubtest273of100,1,321,5190,23,376,5589
subtest26of10,pubtest274of100,1,323,5173,2,38,5213
subtest21of10,pubtest274of100,1,323,5173,2,78,5253
subtest23of10,pubtest274of100,1,323,5173,4,115,5292
subtest29of10,pubtest274of100,1,323,5173,4,156,5333
subtest22of10,pubtest274of100,1,323,5173,9,190,5372
subtest28of10,pubtest274of100,1,323,5173,10,230,5413
subtest27of10,pubtest274of100,1,323,5173,9,269,5451
subtest25of10,pubtest274of100,1,323,5173,9,308,5490
subtest24of10,pubtest274of100,1,323,5173,12,347,5532
subtest210of10,pubtest274of100,1,323,5173,15,384,5572
subtest27of10,pubtest275of100,1,323,5215,2,40,5257
subtest29of10,pubtest275of100,1,323,5215,5,76,5296
subtest24of10,pubtest275of100,1,323,5215,6,115,5336
subtest25of10,pubtest275of100,1,323,5215,8,153,5376
subtest21of10,pubtest275of100,1,323,5215,9,192,5416
subtest23of10,pubtest275of100,1,323,5215,12,229,5456
subtest22of10,pubtest275of100,1,323,5215,12,269,5496
subtest210of10,pubtest275of100,1,323,5215,13,306,5534
subtest26of10,pubtest275of100,1,323,5215,17,344,5576
subtest28of10,pubtest275of100,1,323,5215,22,379,5616
subtest21of10,pubtest276of100,1,323,5194,2,51,5247
subtest25of10,pubtest276of100,1,323,5194,2,90,5286
subtest29of10,pubtest276of100,1,323,5194,4,128,5326
subtest23of10,pubtest276of100,1,323,5194,6,166,5366
subtest26of10,pubtest276of100,1,323,5194,10,202,5406
subtest27of10,pubtest276of100,1,323,5194,12,240,5446
subtest24of10,pubtest276of100,1,323,5194,12,280,5486
subtest28of10,pubtest276of100,1,323,5194,12,319,5525
subtest22of10,pubtest276of100,1,323,5194,14,358,5566
subtest210of10,pubtest276of100,1,323,5194,15,397,5606
subtest22of10,pubtest277of100,1,323,5565,6,39,5610
subtest28of10,pubtest277of100,1,323,5565,9,77,5651
subtest29of10,pubtest277of100,1,323,5565,6,117,5688
subtest24of10,pubtest277of100,1,323,5565,13,153,5731
subtest21of10,pubtest277of100,1,323,5565,26,180,5771
subtest27of10,pubtest277of100,1,323,5565,27,219,5811
subtest210of10,pubtest277of100,1,323,5565,28,259,5852
subtest25of10,pubtest277of100,1,323,5565,30,297,5892
subtest26of10,pubtest277of100,1,323,5565,30,335,5930
subtest23of10,pubtest277of100,1,323,5565,31,375,5971
subtest29of10,pubtest278of100,1,323,5198,5,46,5249
subtest22of10,pubtest278of100,1,323,5198,6,85,5289
subtest21of10,pubtest278of100,1,323,5198,9,121,5328
subtest25of10,pubtest278of100,1,323,5198,11,160,5369
subtest28of10,pubtest278of100,1,323,5198,8,199,5405
subtest26of10,pubtest278of100,1,323,5198,12,238,5448
subtest27of10,pubtest278of100,1,323,5198,11,277,5486
subtest24of10,pubtest278of100,1,323,5198,14,316,5528
subtest210of10,pubtest278of100,1,323,5198,15,353,5566
subtest23of10,pubtest278of100,1,323,5198,8,393,5599
subtest25of10,pubtest279of100,1,323,5256,3,38,5297
subtest28of10,pubtest279of100,1,323,5256,4,76,5336
subtest24of10,pubtest279of100,1,323,5256,5,115,5376
subtest26of10,pubtest279of100,1,323,5256,7,153,5416
subtest21of10,pubtest279of100,1,323,5256,7,193,5456
subtest27of10,pubtest279of100,1,323,5256,13,228,5497
subtest22of10,pubtest279of100,1,323,5256,12,268,5536
subtest29of10,pubtest279of100,1,323,5256,9,306,5571
subtest23of10,pubtest279of100,1,323,5256,22,338,5616
subtest210of10,pubtest279of100,1,323,5256,27,373,5656
subtest27of10,pubtest280of100,1,323,5168,3,38,5209
subtest29of10,pubtest280of100,1,323,5168,6,74,5248
subtest24of10,pubtest280of100,1,323,5168,8,110,5286
subtest21of10,pubtest280of100,1,323,5168,14,146,5328
subtest26of10,pubtest280of100,1,323,5168,15,185,5368
subtest23of10,pubtest280of100,1,323,5168,26,214,5408
subtest210of10,pubtest280of100,1,323,5168,28,252,5448
subtest25of10,pubtest280of100,1,323,5168,26,294,5488
subtest28of10,pubtest280of100,1,323,5168,28,333,5529
subtest22of10,pubtest280of100,1,323,5168,30,370,5568
subtest24of10,pubtest281of100,1,323,5283,2,139,5424
subtest23of10,pubtest281of100,1,323,5283,4,173,5460
subtest28of10,pubtest281of100,1,323,5283,4,212,5499
subtest22of10,pubtest281of100,1,323,5283,6,252,5541
subtest27of10,pubtest281of100,1,323,5283,6,291,5580
subtest210of10,pubtest281of100,1,323,5283,11,326,5620
subtest25of10,pubtest281of100,1,323,5283,18,359,5660
subtest21of10,pubtest281of100,1,323,5283,19,398,5700
subtest29of10,pubtest281of100,1,323,5283,25,432,5740
subtest26of10,pubtest281of100,1,323,5283,26,469,5778
subtest23of10,pubtest282of100,1,323,5168,7,43,5218
subtest21of10,pubtest282of100,1,323,5168,8,82,5258
subtest24of10,pubtest282of100,1,323,5168,7,120,5295
subtest22of10,pubtest282of100,1,323,5168,14,155,5337
subtest25of10,pubtest282of100,1,323,5168,16,193,5377
subtest29of10,pubtest282of100,1,323,5168,17,233,5418
subtest28of10,pubtest282of100,1,323,5168,21,268,5457
subtest210of10,pubtest282of100,1,323,5168,19,308,5495
subtest26of10,pubtest282of100,1,323,5168,19,347,5534
subtest27of10,pubtest282of100,1,323,5168,19,387,5574
subtest24of10,pubtest283of100,1,323,5199,5,42,5246
subtest27of10,pubtest283of100,1,323,5199,7,78,5284
subtest23of10,pubtest283of100,1,323,5199,10,114,5323
subtest22of10,pubtest283of100,1,323,5199,12,153,5364
subtest25of10,pubtest283of100,1,323,5199,14,191,5404
subtest28of10,pubtest283of100,1,323,5199,15,230,5444
subtest21of10,pubtest283of100,1,323,5199,16,269,5484
subtest29of10,pubtest283of100,1,323,5199,18,307,5524
subtest210of10,pubtest283of100,1,323,5199,19,347,5565
subtest26of10,pubtest283of100,1,323,5199,25,381,5605
subtest25of10,pubtest284of100,1,323,5272,5,39,5316
subtest22of10,pubtest284of100,1,323,5272,5,79,5356
subtest29of10,pubtest284of100,1,323,5272,8,115,5395
subtest210of10,pubtest284of100,1,323,5272,7,154,5433
subtest27of10,pubtest284of100,1,323,5272,14,189,5475
subtest23of10,pubtest284of100,1,323,5272,16,227,5515
subtest24of10,pubtest284of100,1,323,5272,17,267,5556
subtest21of10,pubtest284of100,1,323,5272,22,301,5595
subtest26of10,pubtest284of100,1,323,5272,23,340,5635
subtest28of10,pubtest284of100,1,323,5272,22,382,5676
subtest23of10,pubtest285of100,1,323,5186,7,40,5233
subtest24of10,pubtest285of100,1,323,5186,7,79,5272
subtest25of10,pubtest285of100,1,323,5186,10,116,5312
subtest22of10,pubtest285of100,1,323,5186,11,155,5352
subtest27of10,pubtest285of100,1,323,5186,12,194,5392
subtest28of10,pubtest285of100,1,323,5186,14,232,5432
subtest210of10,pubtest285of100,1,323,5186,30,256,5472
subtest21of10,pubtest285of100,1,323,5186,31,296,5513
subtest29of10,pubtest285of100,1,323,5186,39,327,5552
subtest26of10,pubtest285of100,1,323,5186,40,365,5591
subtest210of10,pubtest286of100,1,323,5185,7,128,5320
subtest23of10,pubtest286of100,1,323,5185,6,167,5358
subtest25of10,pubtest286of100,1,323,5185,8,117,5310
subtest24of10,pubtest286of100,1,323,5185,97,157,5439
subtest29of10,pubtest286of100,1,323,5185,96,198,5479
subtest27of10,pubtest286of100,1,323,5185,96,236,5517
subtest22of10,pubtest286of100,1,323,5185,99,275,5559
subtest26of10,pubtest286of100,1,323,5185,95,315,5595
subtest28of10,pubtest286of100,1,323,5185,95,355,5635
subtest21of10,pubtest286of100,1,323,5185,94,394,5673
subtest26of10,pubtest287of100,1,323,5184,9,38,5231
subtest29of10,pubtest287of100,1,323,5184,10,77,5271
subtest28of10,pubtest287of100,1,323,5184,12,114,5310
subtest27of10,pubtest287of100,1,323,5184,13,153,5350
subtest210of10,pubtest287of100,1,323,5184,14,192,5390
subtest25of10,pubtest287of100,1,323,5184,15,231,5430
subtest21of10,pubtest287of100,1,323,5184,19,267,5470
subtest24of10,pubtest287of100,1,323,5184,21,305,5510
subtest23of10,pubtest287of100,1,323,5184,24,342,5550
subtest22of10,pubtest287of100,1,323,5184,26,379,5589
subtest29of10,pubtest288of100,1,323,5208,6,38,5252
subtest26of10,pubtest288of100,1,323,5208,9,74,5291
subtest25of10,pubtest288of100,1,323,5208,10,113,5331
subtest27of10,pubtest288of100,1,323,5208,11,152,5371
subtest21of10,pubtest288of100,1,323,5208,16,187,5411
subtest22of10,pubtest288of100,1,323,5208,16,221,5445
subtest210of10,pubtest288of100,1,323,5208,22,261,5491
subtest24of10,pubtest288of100,1,323,5208,22,300,5530
subtest28of10,pubtest288of100,1,323,5208,24,338,5570
subtest23of10,pubtest288of100,1,323,5208,25,378,5611
subtest29of10,pubtest289of100,1,323,5212,14,40,5266
subtest210of10,pubtest289of100,1,323,5212,15,79,5306
subtest24of10,pubtest289of100,1,323,5212,37,96,5345
subtest23of10,pubtest289of100,1,323,5212,61,111,5384
subtest25of10,pubtest289of100,1,323,5212,66,146,5424
subtest26of10,pubtest289of100,1,323,5212,73,179,5464
subtest27of10,pubtest289of100,1,323,5212,76,216,5504
subtest28of10,pubtest289of100,1,323,5212,77,256,5545
subtest21of10,pubtest289of100,1,323,5212,79,293,5584
subtest22of10,pubtest289of100,1,323,5212,108,304,5624
subtest29of10,pubtest290of100,1,323,5174,4,39,5217
subtest23of10,pubtest290of100,1,323,5174,5,78,5257
subtest22of10,pubtest290of100,1,323,5174,16,107,5297
subtest25of10,pubtest290of100,1,323,5174,26,137,5337
subtest27of10,pubtest290of100,1,323,5174,61,141,5376
subtest26of10,pubtest290of100,1,323,5174,72,170,5416
subtest21of10,pubtest290of100,1,323,5174,106,177,5457
subtest210of10,pubtest290of100,1,323,5174,128,193,5495
subtest28of10,pubtest290of100,1,323,5174,130,231,5535
subtest24of10,pubtest290of100,1,323,5174,144,258,5576
subtest23of10,pubtest291of100,1,323,5318,7,40,5365
subtest24of10,pubtest291of100,1,323,5318,8,79,5405
subtest27of10,pubtest291of100,1,323,5318,20,106,5444
subtest28of10,pubtest291of100,1,323,5318,26,140,5484
subtest21of10,pubtest291of100,1,323,5318,29,177,5524
subtest25of10,pubtest291of100,1,323,5318,37,209,5564
subtest210of10,pubtest291of100,1,323,5318,40,246,5604
subtest29of10,pubtest291of100,1,323,5318,46,280,5644
subtest22of10,pubtest291of100,1,323,5318,54,312,5684
subtest26of10,pubtest291of100,1,323,5318,55,351,5724
subtest28of10,pubtest292of100,1,323,5245,12,39,5296
subtest29of10,pubtest292of100,1,323,5245,37,53,5335
subtest21of10,pubtest292of100,1,323,5245,58,71,5374
subtest25of10,pubtest292of100,1,323,5245,71,99,5415
subtest27of10,pubtest292of100,1,323,5245,76,134,5455
subtest26of10,pubtest292of100,1,323,5245,84,166,5495
subtest22of10,pubtest292of100,1,323,5245,148,141,5534
subtest23of10,pubtest292of100,1,323,5245,172,157,5574
subtest24of10,pubtest292of100,1,323,5245,198,171,5614
subtest210of10,pubtest292of100,1,323,5245,219,191,5655
subtest24of10,pubtest293of100,1,323,5234,14,39,5287
subtest25of10,pubtest293of100,1,323,5234,43,50,5327
subtest28of10,pubtest293of100,1,323,5234,83,50,5367
subtest23of10,pubtest293of100,1,323,5234,94,79,5407
subtest210of10,pubtest293of100,1,323,5234,117,96,5447
subtest27of10,pubtest293of100,1,323,5234,143,110,5487
subtest26of10,pubtest293of100,1,323,5234,147,146,5527
subtest21of10,pubtest293of100,1,323,5234,175,156,5565
subtest29of10,pubtest293of100,1,323,5234,175,196,5605
subtest22of10,pubtest293of100,1,323,5234,186,226,5646
subtest21of10,pubtest294of100,1,323,5165,3,47,5215
subtest210of10,pubtest294of100,1,323,5165,20,70,5255
subtest25of10,pubtest294of100,1,323,5165,22,107,5294
subtest29of10,pubtest294of100,1,323,5165,30,139,5334
subtest27of10,pubtest294of100,1,323,5165,38,172,5375
subtest26of10,pubtest294of100,1,323,5165,56,193,5414
subtest23of10,pubtest294of100,1,323,5165,63,225,5453
subtest24of10,pubtest294of100,1,323,5165,64,265,5494
subtest22of10,pubtest294of100,1,323,5165,82,287,5534
subtest28of10,pubtest294of100,1,323,5165,88,321,5574
subtest25of10,pubtest295of100,1,323,5236,3,42,5281
subtest24of10,pubtest295of100,1,323,5236,10,72,5318
subtest23of10,pubtest295of100,1,323,5236,10,111,5357
subtest29of10,pubtest295of100,1,323,5236,18,147,5401
subtest27of10,pubtest295of100,1,323,5236,18,186,5440
subtest22of10,pubtest295of100,1,323,5236,18,225,5479
subtest210of10,pubtest295of100,1,323,5236,20,265,5521
subtest21of10,pubtest295of100,1,323,5236,28,296,5560
subtest28of10,pubtest295of100,1,323,5236,28,336,5600
subtest26of10,pubtest295of100,1,323,5236,30,374,5640
subtest25of10,pubtest296of100,1,322,5175,8,37,5220
subtest24of10,pubtest296of100,1,322,5175,16,70,5261
subtest27of10,pubtest296of100,1,322,5175,42,83,5300
subtest23of10,pubtest296of100,1,322,5175,45,120,5340
subtest26of10,pubtest296of100,1,322,5175,54,151,5380
subtest29of10,pubtest296of100,1,322,5175,57,188,5420
subtest28of10,pubtest296of100,1,322,5175,57,227,5459
subtest21of10,pubtest296of100,1,322,5175,66,259,5500
subtest210of10,pubtest296of100,1,322,5175,75,289,5539
subtest22of10,pubtest296of100,1,322,5175,82,323,5580
subtest25of10,pubtest297of100,1,323,5205,6,43,5254
subtest29of10,pubtest297of100,1,323,5205,13,75,5293
subtest210of10,pubtest297of100,1,323,5205,16,111,5332
subtest23of10,pubtest297of100,1,323,5205,26,141,5372
subtest22of10,pubtest297of100,1,323,5205,29,179,5413
subtest27of10,pubtest297of100,1,323,5205,45,200,5450
subtest21of10,pubtest297of100,1,323,5205,48,239,5492
subtest26of10,pubtest297of100,1,323,5205,72,255,5532
subtest28of10,pubtest297of100,1,323,5205,79,288,5572
subtest24of10,pubtest297of100,1,323,5205,86,322,5613
subtest22of10,pubtest298of100,1,323,5175,5,42,5222
subtest29of10,pubtest298of100,1,323,5175,14,71,5260
subtest25of10,pubtest298of100,1,323,5175,22,103,5300
subtest23of10,pubtest298of100,1,323,5175,25,140,5340
subtest24of10,pubtest298of100,1,323,5175,31,174,5380
subtest21of10,pubtest298of100,1,323,5175,34,212,5421
subtest210of10,pubtest298of100,1,323,5175,35,250,5460
subtest27of10,pubtest298of100,1,323,5175,43,282,5500
subtest26of10,pubtest298of100,1,323,5175,49,316,5540
subtest28of10,pubtest298of100,1,323,5175,49,356,5580
subtest22of10,pubtest299of100,1,323,5420,5,41,5466
subtest29of10,pubtest299of100,1,323,5420,12,73,5505
subtest210of10,pubtest299of100,1,323,5420,16,109,5545
subtest27of10,pubtest299of100,1,323,5420,17,149,5586
subtest24of10,pubtest299of100,1,323,5420,18,187,5625
subtest28of10,pubtest299of100,1,323,5420,21,224,5665
subtest23of10,pubtest299of100,1,323,5420,24,261,5705
subtest25of10,pubtest299of100,1,323,5420,25,300,5745
subtest26of10,pubtest299of100,1,323,5420,29,336,5785
subtest21of10,pubtest299of100,1,323,5420,31,374,5825
subtest24of10,pubtest2100of100,1,325,5289,5,40,5334
subtest21of10,pubtest2100of100,1,325,5289,24,61,5374
subtest29of10,pubtest2100of100,1,325,5289,28,97,5414
subtest23of10,pubtest2100of100,1,325,5289,39,126,5454
subtest22of10,pubtest2100of100,1,325,5289,71,133,5493
subtest27of10,pubtest2100of100,1,325,5289,73,171,5533
subtest28of10,pubtest2100of100,1,325,5289,84,200,5573
subtest25of10,pubtest2100of100,1,325,5289,110,214,5613
subtest210of10,pubtest2100of100,1,325,5289,131,233,5653
subtest26of10,pubtest2100of100,1,325,5289,160,244,5693
subtest27of10,pubtest21of100,1,322,10251,8,38,10297
subtest25of10,pubtest21of100,1,322,10251,10,75,10336
subtest21of10,pubtest21of100,1,322,10251,11,115,10377
subtest29of10,pubtest21of100,1,322,10251,8,155,10414
subtest26of10,pubtest21of100,1,322,10251,15,191,10457
subtest23of10,pubtest21of100,1,322,10251,15,229,10495
subtest24of10,pubtest21of100,1,322,10251,17,269,10537
subtest28of10,pubtest21of100,1,322,10251,18,308,10577
subtest210of10,pubtest21of100,1,322,10251,18,348,10617
subtest22of10,pubtest21of100,1,322,10251,27,379,10657
subtest29of10,pubtest22of100,1,321,5182,4,41,5227
subtest27of10,pubtest22of100,1,321,5182,5,79,5266
subtest24of10,pubtest22of100,1,321,5182,9,115,5306
subtest28of10,pubtest22of100,1,321,5182,11,153,5346
subtest23of10,pubtest22of100,1,321,5182,11,193,5386
subtest25of10,pubtest22of100,1,321,5182,13,231,5426
subtest26of10,pubtest22of100,1,321,5182,13,270,5465
subtest21of10,pubtest22of100,1,321,5182,15,309,5506
subtest210of10,pubtest22of100,1,321,5182,15,347,5544
subtest22of10,pubtest22of100,1,321,5182,23,381,5586
subtest28of10,pubtest23of100,1,321,5464,10,46,5520
subtest23of10,pubtest23of100,1,321,5464,9,86,5559
subtest29of10,pubtest23of100,1,321,5464,11,123,5598
subtest24of10,pubtest23of100,1,321,5464,13,161,5638
subtest25of10,pubtest23of100,1,321,5464,14,200,5678
subtest27of10,pubtest23of100,1,321,5464,17,237,5718
subtest26of10,pubtest23of100,1,321,5464,21,273,5758
subtest21of10,pubtest23of100,1,321,5464,22,312,5798
subtest22of10,pubtest23of100,1,321,5464,23,351,5838
subtest210of10,pubtest23of100,1,321,5464,25,389,5878
subtest24of10,pubtest24of100,1,321,5245,7,44,5296
subtest28of10,pubtest24of100,1,321,5245,10,81,5336
subtest23of10,pubtest24of100,1,321,5245,11,120,5376
subtest21of10,pubtest24of100,1,321,5245,12,159,5416
subtest29of10,pubtest24of100,1,321,5245,12,199,5456
subtest27of10,pubtest24of100,1,321,5245,14,237,5496
subtest25of10,pubtest24of100,1,321,5245,14,277,5536
subtest22of10,pubtest24of100,1,321,5245,15,316,5576
subtest210of10,pubtest24of100,1,321,5245,19,353,5617
subtest26of10,pubtest24of100,1,321,5245,24,387,5656
subtest28of10,pubtest25of100,1,321,5267,5,40,5312
subtest21of10,pubtest25of100,1,321,5267,5,80,5352
subtest210of10,pubtest25of100,1,321,5267,7,117,5391
subtest27of10,pubtest25of100,1,321,5267,11,153,5431
subtest26of10,pubtest25of100,1,321,5267,25,179,5471
subtest25of10,pubtest25of100,1,321,5267,26,218,5511
subtest23of10,pubtest25of100,1,321,5267,29,255,5551
subtest29of10,pubtest25of100,1,321,5267,30,292,5589
subtest22of10,pubtest25of100,1,321,5267,30,332,5629
subtest24of10,pubtest25of100,1,321,5267,32,371,5670
subtest21of10,pubtest26of100,1,321,5221,7,40,5268
subtest22of10,pubtest26of100,1,321,5221,8,78,5307
subtest23of10,pubtest26of100,1,321,5221,13,114,5348
subtest29of10,pubtest26of100,1,321,5221,13,153,5387
subtest27of10,pubtest26of100,1,321,5221,17,189,5427
subtest26of10,pubtest26of100,1,321,5221,16,228,5465
subtest25of10,pubtest26of100,1,321,5221,19,267,5507
subtest210of10,pubtest26of100,1,321,5221,75,251,5547
subtest28of10,pubtest26of100,1,321,5221,75,291,5587
subtest24of10,pubtest26of100,1,321,5221,79,327,5627
subtest28of10,pubtest27of100,1,320,5237,8,41,5286
subtest27of10,pubtest27of100,1,320,5237,6,80,5323
subtest24of10,pubtest27of100,1,320,5237,9,121,5367
subtest23of10,pubtest27of100,1,320,5237,9,158,5404
subtest29of10,pubtest27of100,1,320,5237,11,197,5445
subtest210of10,pubtest27of100,1,320,5237,13,235,5485
subtest25of10,pubtest27of100,1,320,5237,13,276,5526
subtest21of10,pubtest27of100,1,320,5237,16,312,5565
subtest26of10,pubtest27of100,1,320,5237,20,348,5605
subtest22of10,pubtest27of100,1,320,5237,19,389,5645
subtest27of10,pubtest28of100,1,321,5199,6,51,5256
subtest25of10,pubtest28of100,1,321,5199,11,84,5294
subtest28of10,pubtest28of100,1,321,5199,11,123,5333
subtest21of10,pubtest28of100,1,321,5199,7,167,5373
subtest210of10,pubtest28of100,1,321,5199,10,202,5411
subtest29of10,pubtest28of100,1,321,5199,9,241,5449
subtest24of10,pubtest28of100,1,321,5199,15,277,5491
subtest22of10,pubtest28of100,1,321,5199,17,317,5533
subtest26of10,pubtest28of100,1,321,5199,17,356,5572
subtest23of10,pubtest28of100,1,321,5199,17,395,5611
subtest210of10,pubtest29of100,1,321,5225,4,38,5267
subtest23of10,pubtest29of100,1,321,5225,7,75,5307
subtest22of10,pubtest29of100,1,321,5225,7,113,5345
subtest29of10,pubtest29of100,1,321,5225,16,145,5386
subtest25of10,pubtest29of100,1,321,5225,16,185,5426
subtest28of10,pubtest29of100,1,321,5225,16,225,5466
subtest21of10,pubtest29of100,1,321,5225,20,261,5506
subtest26of10,pubtest29of100,1,321,5225,18,304,5547
subtest27of10,pubtest29of100,1,321,5225,19,344,5588
subtest24of10,pubtest29of100,1,321,5225,18,383,5626
subtest29of10,pubtest210of100,1,323,5609,6,42,5657
subtest21of10,pubtest210of100,1,323,5609,10,78,5697
subtest210of10,pubtest210of100,1,323,5609,24,103,5736
subtest27of10,pubtest210of100,1,323,5609,25,143,5777
subtest28of10,pubtest210of100,1,323,5609,28,179,5816
subtest23of10,pubtest210of100,1,323,5609,28,219,5856
subtest25of10,pubtest210of100,1,323,5609,63,224,5896
subtest24of10,pubtest210of100,1,323,5609,64,264,5937
subtest26of10,pubtest210of100,1,323,5609,65,301,5975
subtest22of10,pubtest210of100,1,323,5609,68,339,6016
subtest210of10,pubtest211of100,1,323,5187,8,39,5234
subtest29of10,pubtest211of100,1,323,5187,14,72,5273
subtest24of10,pubtest211of100,1,323,5187,14,112,5313
subtest21of10,pubtest211of100,1,323,5187,17,149,5353
subtest25of10,pubtest211of100,1,323,5187,18,186,5391
subtest22of10,pubtest211of100,1,323,5187,17,226,5430
subtest27of10,pubtest211of100,1,323,5187,21,265,5473
subtest23of10,pubtest211of100,1,323,5187,18,304,5509
subtest26of10,pubtest211of100,1,323,5187,22,344,5553
subtest28of10,pubtest211of100,1,323,5187,22,383,5592
subtest25of10,pubtest212of100,1,323,5266,2,41,5309
subtest29of10,pubtest212of100,1,323,5266,5,80,5351
subtest28of10,pubtest212of100,1,323,5266,6,118,5390
subtest27of10,pubtest212of100,1,323,5266,11,154,5431
subtest23of10,pubtest212of100,1,323,5266,11,193,5470
subtest21of10,pubtest212of100,1,323,5266,17,227,5510
subtest24of10,pubtest212of100,1,323,5266,18,266,5550
subtest22of10,pubtest212of100,1,323,5266,20,304,5590
subtest26of10,pubtest212of100,1,323,5266,21,343,5630
subtest210of10,pubtest212of100,1,323,5266,22,382,5670
subtest23of10,pubtest213of100,1,322,5181,5,42,5228
subtest26of10,pubtest213of100,1,322,5181,9,78,5268
subtest29of10,pubtest213of100,1,322,5181,41,85,5307
subtest22of10,pubtest213of100,1,322,5181,42,124,5347
subtest27of10,pubtest213of100,1,322,5181,44,162,5387
subtest21of10,pubtest213of100,1,322,5181,46,200,5427
subtest210of10,pubtest213of100,1,322,5181,54,232,5467
subtest24of10,pubtest213of100,1,322,5181,54,272,5507
subtest28of10,pubtest213of100,1,322,5181,56,310,5547
subtest25of10,pubtest213of100,1,322,5181,56,350,5587
subtest21of10,pubtest214of100,1,323,5138,2,41,5181
subtest23of10,pubtest214of100,1,323,5138,8,74,5220
subtest25of10,pubtest214of100,1,323,5138,12,110,5260
subtest26of10,pubtest214of100,1,323,5138,11,150,5299
subtest27of10,pubtest214of100,1,323,5138,14,189,5341
subtest22of10,pubtest214of100,1,323,5138,13,228,5379
subtest24of10,pubtest214of100,1,323,5138,14,269,5421
subtest210of10,pubtest214of100,1,323,5138,13,307,5458
subtest29of10,pubtest214of100,1,323,5138,13,346,5497
subtest28of10,pubtest214of100,1,323,5138,18,384,5540
subtest24of10,pubtest215of100,1,323,5217,5,41,5263
subtest27of10,pubtest215of100,1,323,5217,6,79,5302
subtest29of10,pubtest215of100,1,323,5217,7,119,5343
subtest26of10,pubtest215of100,1,323,5217,8,158,5383
subtest21of10,pubtest215of100,1,323,5217,10,195,5422
subtest210of10,pubtest215of100,1,323,5217,16,229,5462
subtest25of10,pubtest215of100,1,323,5217,16,269,5502
subtest22of10,pubtest215of100,1,323,5217,22,302,5541
subtest28of10,pubtest215of100,1,323,5217,23,342,5582
subtest23of10,pubtest215of100,1,323,5217,27,378,5622
subtest21of10,pubtest216of100,1,323,5194,5,46,5245
subtest24of10,pubtest216of100,1,323,5194,6,85,5285
subtest28of10,pubtest216of100,1,323,5194,7,123,5324
subtest23of10,pubtest216of100,1,323,5194,9,159,5362
subtest27of10,pubtest216of100,1,323,5194,12,198,5404
subtest25of10,pubtest216of100,1,323,5194,13,238,5445
subtest22of10,pubtest216of100,1,323,5194,17,273,5484
subtest29of10,pubtest216of100,1,323,5194,24,306,5524
subtest26of10,pubtest216of100,1,323,5194,24,346,5564
subtest210of10,pubtest216of100,1,323,5194,35,375,5604
subtest27of10,pubtest217of100,1,322,5300,8,38,5346
subtest22of10,pubtest217of100,1,322,5300,9,76,5385
subtest26of10,pubtest217of100,1,322,5300,10,115,5425
subtest23of10,pubtest217of100,1,322,5300,10,155,5465
subtest21of10,pubtest217of100,1,322,5300,12,193,5505
subtest29of10,pubtest217of100,1,322,5300,15,230,5545
subtest24of10,pubtest217of100,1,322,5300,15,270,5585
subtest25of10,pubtest217of100,1,322,5300,23,302,5625
subtest28of10,pubtest217of100,1,322,5300,29,336,5665
subtest210of10,pubtest217of100,1,322,5300,33,371,5704
subtest29of10,pubtest218of100,1,323,5183,3,42,5228
subtest21of10,pubtest218of100,1,323,5183,4,80,5267
subtest22of10,pubtest218of100,1,323,5183,8,116,5307
subtest27of10,pubtest218of100,1,323,5183,9,155,5347
subtest23of10,pubtest218of100,1,323,5183,10,194,5387
subtest28of10,pubtest218of100,1,323,5183,13,231,5427
subtest25of10,pubtest218of100,1,323,5183,13,271,5467
subtest24of10,pubtest218of100,1,323,5183,18,306,5507
subtest210of10,pubtest218of100,1,323,5183,19,345,5547
subtest26of10,pubtest218of100,1,323,5183,39,366,5588
subtest210of10,pubtest219of100,1,323,5279,8,43,5330
subtest25of10,pubtest219of100,1,323,5279,9,80,5368
subtest26of10,pubtest219of100,1,323,5279,11,118,5408
subtest21of10,pubtest219of100,1,323,5279,12,158,5449
subtest29of10,pubtest219of100,1,323,5279,13,196,5488
subtest23of10,pubtest219of100,1,323,5279,13,236,5528
subtest24of10,pubtest219of100,1,323,5279,15,274,5568
subtest28of10,pubtest219of100,1,323,5279,16,313,5608
subtest22of10,pubtest219of100,1,323,5279,15,353,5647
subtest27of10,pubtest219of100,1,323,5279,15,390,5684
subtest25of10,pubtest220of100,1,323,5291,2,38,5331
subtest29of10,pubtest220of100,1,323,5291,8,73,5372
subtest23of10,pubtest220of100,1,323,5291,7,113,5411
subtest210of10,pubtest220of100,1,323,5291,7,152,5450
subtest24of10,pubtest220of100,1,323,5291,13,185,5489
subtest21of10,pubtest220of100,1,323,5291,18,222,5531
subtest27of10,pubtest220of100,1,323,5291,20,260,5571
subtest28of10,pubtest220of100,1,323,5291,23,297,5611
subtest26of10,pubtest220of100,1,323,5291,26,334,5651
subtest22of10,pubtest220of100,1,323,5291,26,374,5691
subtest24of10,pubtest221of100,1,323,5248,4,41,5293
subtest28of10,pubtest221of100,1,323,5248,8,76,5332
subtest21of10,pubtest221of100,1,323,5248,8,116,5372
subtest22of10,pubtest221of100,1,323,5248,10,154,5412
subtest23of10,pubtest221of100,1,323,5248,10,194,5452
subtest210of10,pubtest221of100,1,323,5248,15,229,5492
subtest25of10,pubtest221of100,1,323,5248,16,268,5532
subtest29of10,pubtest221of100,1,323,5248,22,302,5572
subtest26of10,pubtest221of100,1,323,5248,31,331,5610
subtest27of10,pubtest221of100,1,323,5248,31,371,5650
subtest22of10,pubtest222of100,1,323,5280,4,231,5515
subtest21of10,pubtest222of100,1,323,5280,5,267,5552
subtest27of10,pubtest222of100,1,323,5280,7,305,5592
subtest29of10,pubtest222of100,1,323,5280,7,345,5632
subtest23of10,pubtest222of100,1,323,5280,9,382,5671
subtest25of10,pubtest222of100,1,323,5280,15,417,5712
subtest28of10,pubtest222of100,1,323,5280,15,458,5753
subtest210of10,pubtest222of100,1,323,5280,17,495,5792
subtest26of10,pubtest222of100,1,323,5280,21,531,5832
subtest24of10,pubtest222of100,1,323,5280,22,571,5873
subtest21of10,pubtest223of100,1,323,5208,9,41,5258
subtest28of10,pubtest223of100,1,323,5208,9,80,5297
subtest23of10,pubtest223of100,1,323,5208,11,117,5336
subtest24of10,pubtest223of100,1,323,5208,12,156,5376
subtest29of10,pubtest223of100,1,323,5208,18,190,5416
subtest210of10,pubtest223of100,1,323,5208,59,189,5456
subtest27of10,pubtest223of100,1,323,5208,59,229,5496
subtest22of10,pubtest223of100,1,323,5208,61,267,5536
subtest25of10,pubtest223of100,1,323,5208,67,301,5576
subtest26of10,pubtest223of100,1,323,5208,67,341,5616
subtest21of10,pubtest224of100,1,323,5294,4,39,5337
subtest28of10,pubtest224of100,1,323,5294,6,76,5376
subtest27of10,pubtest224of100,1,323,5294,7,115,5416
subtest23of10,pubtest224of100,1,323,5294,13,149,5456
subtest26of10,pubtest224of100,1,323,5294,16,186,5496
subtest29of10,pubtest224of100,1,323,5294,17,226,5537
subtest25of10,pubtest224of100,1,323,5294,20,262,5576
subtest22of10,pubtest224of100,1,323,5294,20,302,5616
subtest24of10,pubtest224of100,1,323,5294,22,340,5656
subtest210of10,pubtest224of100,1,323,5294,22,381,5697
subtest27of10,pubtest225of100,1,323,5246,4,215,5465
subtest21of10,pubtest225of100,1,323,5246,10,246,5502
subtest26of10,pubtest225of100,1,323,5246,10,285,5541
subtest24of10,pubtest225of100,1,323,5246,11,324,5581
subtest25of10,pubtest225of100,1,323,5246,15,360,5621
subtest28of10,pubtest225of100,1,323,5246,16,399,5661
subtest23of10,pubtest225of100,1,323,5246,17,438,5701
subtest22of10,pubtest225of100,1,323,5246,5,491,5742
subtest29of10,pubtest225of100,1,323,5246,18,315,5579
subtest210of10,pubtest225of100,1,323,5246,19,353,5618
subtest25of10,pubtest226of100,1,323,5376,6,38,5420
subtest22of10,pubtest226of100,1,323,5376,6,77,5459
subtest23of10,pubtest226of100,1,323,5376,9,114,5499
subtest210of10,pubtest226of100,1,323,5376,9,154,5539
subtest27of10,pubtest226of100,1,323,5376,24,179,5579
subtest28of10,pubtest226of100,1,323,5376,25,218,5619
subtest21of10,pubtest226of100,1,323,5376,28,256,5660
subtest29of10,pubtest226of100,1,323,5376,28,295,5699
subtest26of10,pubtest226of100,1,323,5376,31,331,5738
subtest24of10,pubtest226of100,1,323,5376,32,373,5781
subtest210of10,pubtest227of100,1,323,5176,9,48,5233
subtest29of10,pubtest227of100,1,323,5176,9,87,5272
subtest25of10,pubtest227of100,1,323,5176,11,124,5311
subtest26of10,pubtest227of100,1,323,5176,13,162,5351
subtest23of10,pubtest227of100,1,323,5176,14,201,5391
subtest24of10,pubtest227of100,1,323,5176,16,239,5431
subtest27of10,pubtest227of100,1,323,5176,17,278,5471
subtest22of10,pubtest227of100,1,323,5176,20,314,5510
subtest21of10,pubtest227of100,1,323,5176,20,354,5550
subtest28of10,pubtest227of100,1,323,5176,22,393,5591
subtest21of10,pubtest228of100,1,323,5286,5,39,5330
subtest26of10,pubtest228of100,1,323,5286,5,77,5368
subtest25of10,pubtest228of100,1,323,5286,9,116,5411
subtest23of10,pubtest228of100,1,323,5286,10,154,5450
subtest27of10,pubtest228of100,1,323,5286,12,191,5489
subtest29of10,pubtest228of100,1,323,5286,12,230,5528
subtest210of10,pubtest228of100,1,323,5286,14,269,5569
subtest24of10,pubtest228of100,1,323,5286,14,309,5609
subtest22of10,pubtest228of100,1,323,5286,22,341,5649
subtest28of10,pubtest228of100,1,323,5286,22,381,5689
subtest24of10,pubtest229of100,1,321,5219,3,42,5264
subtest28of10,pubtest229of100,1,321,5219,6,77,5302
subtest22of10,pubtest229of100,1,321,5219,12,111,5342
subtest21of10,pubtest229of100,1,321,5219,13,150,5382
subtest26of10,pubtest229of100,1,321,5219,14,188,5421
subtest27of10,pubtest229of100,1,321,5219,16,225,5460
subtest23of10,pubtest229of100,1,321,5219,18,265,5502
subtest25of10,pubtest229of100,1,321,5219,20,303,5542
subtest210of10,pubtest229of100,1,321,5219,14,343,5576
subtest29of10,pubtest229of100,1,321,5219,23,380,5622
subtest21of10,pubtest230of100,1,323,5166,6,40,5212
subtest22of10,pubtest230of100,1,323,5166,9,78,5253
subtest27of10,pubtest230of100,1,323,5166,9,117,5292
subtest29of10,pubtest230of100,1,323,5166,14,151,5331
subtest28of10,pubtest230of100,1,323,5166,15,190,5371
subtest25of10,pubtest230of100,1,323,5166,17,228,5411
subtest23of10,pubtest230of100,1,323,5166,19,266,5451
subtest210of10,pubtest230of100,1,323,5166,20,305,5491
subtest26of10,pubtest230of100,1,323,5166,24,341,5531
subtest24of10,pubtest230of100,1,323,5166,24,381,5571
subtest23of10,pubtest231of100,1,323,5182,5,41,5228
subtest25of10,pubtest231of100,1,323,5182,8,78,5268
subtest28of10,pubtest231of100,1,323,5182,10,116,5308
subtest29of10,pubtest231of100,1,323,5182,15,150,5347
subtest27of10,pubtest231of100,1,323,5182,16,187,5385
subtest26of10,pubtest231of100,1,323,5182,19,226,5427
subtest24of10,pubtest231of100,1,323,5182,15,266,5463
subtest21of10,pubtest231of100,1,323,5182,21,305,5508
subtest22of10,pubtest231of100,1,323,5182,22,344,5548
subtest210of10,pubtest231of100,1,323,5182,19,384,5585
subtest21of10,pubtest232of100,1,323,5204,6,39,5249
subtest23of10,pubtest232of100,1,323,5204,9,75,5288
subtest22of10,pubtest232of100,1,323,5204,8,115,5327
subtest27of10,pubtest232of100,1,323,5204,9,154,5367
subtest29of10,pubtest232of100,1,323,5204,14,190,5408
subtest25of10,pubtest232of100,1,323,5204,23,221,5448
subtest28of10,pubtest232of100,1,323,5204,23,261,5488
subtest26of10,pubtest232of100,1,323,5204,25,299,5528
subtest24of10,pubtest232of100,1,323,5204,25,337,5566
subtest210of10,pubtest232of100,1,323,5204,26,376,5606
subtest29of10,pubtest233of100,1,323,5227,8,38,5273
subtest24of10,pubtest233of100,1,323,5227,9,77,5313
subtest25of10,pubtest233of100,1,323,5227,10,114,5351
subtest210of10,pubtest233of100,1,323,5227,11,156,5394
subtest27of10,pubtest233of100,1,323,5227,17,189,5433
subtest26of10,pubtest233of100,1,323,5227,19,228,5474
subtest22of10,pubtest233of100,1,323,5227,21,265,5513
subtest23of10,pubtest233of100,1,323,5227,22,304,5553
subtest28of10,pubtest233of100,1,323,5227,27,339,5593
subtest21of10,pubtest233of100,1,323,5227,28,378,5633
subtest26of10,pubtest234of100,1,323,5205,5,41,5251
subtest25of10,pubtest234of100,1,323,5205,5,80,5290
subtest27of10,pubtest234of100,1,323,5205,9,116,5330
subtest22of10,pubtest234of100,1,323,5205,9,156,5370
subtest21of10,pubtest234of100,1,323,5205,12,193,5410
subtest23of10,pubtest234of100,1,323,5205,16,227,5448
subtest29of10,pubtest234of100,1,323,5205,16,267,5488
subtest210of10,pubtest234of100,1,323,5205,17,307,5529
subtest24of10,pubtest234of100,1,323,5205,20,345,5570
subtest28of10,pubtest234of100,1,323,5205,21,385,5611
subtest21of10,pubtest235of100,1,321,5217,7,41,5265
subtest23of10,pubtest235of100,1,321,5217,8,78,5303
subtest210of10,pubtest235of100,1,321,5217,10,117,5344
subtest22of10,pubtest235of100,1,321,5217,14,153,5384
subtest27of10,pubtest235of100,1,321,5217,15,192,5424
subtest24of10,pubtest235of100,1,321,5217,16,231,5464
subtest29of10,pubtest235of100,1,321,5217,20,267,5504
subtest25of10,pubtest235of100,1,321,5217,22,305,5544
subtest26of10,pubtest235of100,1,321,5217,22,345,5584
subtest28of10,pubtest235of100,1,321,5217,47,360,5624
subtest210of10,pubtest236of100,1,323,5209,7,39,5255
subtest23of10,pubtest236of100,1,323,5209,11,74,5294
subtest27of10,pubtest236of100,1,323,5209,11,115,5335
subtest28of10,pubtest236of100,1,323,5209,13,152,5374
subtest21of10,pubtest236of100,1,323,5209,13,192,5414
subtest25of10,pubtest236of100,1,323,5209,13,229,5451
subtest29of10,pubtest236of100,1,323,5209,16,269,5494
subtest24of10,pubtest236of100,1,323,5209,19,307,5535
subtest26of10,pubtest236of100,1,323,5209,20,345,5574
subtest22of10,pubtest236of100,1,323,5209,21,384,5614
subtest24of10,pubtest237of100,1,323,5145,9,41,5195
subtest25of10,pubtest237of100,1,323,5145,13,76,5234
subtest23of10,pubtest237of100,1,323,5145,12,115,5272
subtest26of10,pubtest237of100,1,323,5145,15,154,5314
subtest27of10,pubtest237of100,1,323,5145,16,193,5354
subtest21of10,pubtest237of100,1,323,5145,17,231,5393
subtest28of10,pubtest237of100,1,323,5145,14,269,5428
subtest22of10,pubtest237of100,1,323,5145,18,309,5472
subtest210of10,pubtest237of100,1,323,5145,28,342,5515
subtest29of10,pubtest237of100,1,323,5145,27,381,5553
subtest22of10,pubtest238of100,1,323,5296,2,43,5341
subtest29of10,pubtest238of100,1,323,5296,1,82,5379
subtest28of10,pubtest238of100,1,323,5296,5,118,5419
subtest27of10,pubtest238of100,1,323,5296,14,149,5459
subtest210of10,pubtest238of100,1,323,5296,17,186,5499
subtest25of10,pubtest238of100,1,323,5296,20,223,5539
subtest26of10,pubtest238of100,1,323,5296,22,261,5579
subtest21of10,pubtest238of100,1,323,5296,22,301,5619
subtest23of10,pubtest238of100,1,323,5296,21,340,5657
subtest24of10,pubtest238of100,1,323,5296,27,376,5699
subtest21of10,pubtest239of100,1,323,5172,4,43,5219
subtest27of10,pubtest239of100,1,323,5172,11,75,5258
subtest26of10,pubtest239of100,1,323,5172,11,115,5298
subtest28of10,pubtest239of100,1,323,5172,11,153,5336
subtest22of10,pubtest239of100,1,323,5172,16,189,5377
subtest25of10,pubtest239of100,1,323,5172,16,229,5417
subtest24of10,pubtest239of100,1,323,5172,13,269,5454
subtest23of10,pubtest239of100,1,323,5172,19,306,5497
subtest29of10,pubtest239of100,1,323,5172,19,347,5538
subtest210of10,pubtest239of100,1,323,5172,19,386,5577
subtest25of10,pubtest240of100,1,323,5197,16,39,5252
subtest29of10,pubtest240of100,1,323,5197,18,77,5292
subtest21of10,pubtest240of100,1,323,5197,17,115,5329
subtest27of10,pubtest240of100,1,323,5197,19,155,5371
subtest23of10,pubtest240of100,1,323,5197,21,193,5411
subtest24of10,pubtest240of100,1,323,5197,21,233,5451
subtest210of10,pubtest240of100,1,323,5197,18,270,5485
subtest28of10,pubtest240of100,1,323,5197,21,310,5528
subtest22of10,pubtest240of100,1,323,5197,23,349,5569
subtest26of10,pubtest240of100,1,323,5197,79,335,5611
subtest23of10,pubtest241of100,1,323,5241,9,39,5289
subtest24of10,pubtest241of100,1,323,5241,13,72,5326
subtest210of10,pubtest241of100,1,323,5241,17,111,5369
subtest25of10,pubtest241of100,1,323,5241,16,150,5407
subtest27of10,pubtest241of100,1,323,5241,13,190,5444
subtest28of10,pubtest241of100,1,323,5241,18,229,5488
subtest21of10,pubtest241of100,1,323,5241,19,268,5528
subtest26of10,pubtest241of100,1,323,5241,20,307,5568
subtest22of10,pubtest241of100,1,323,5241,20,347,5608
subtest29of10,pubtest241of100,1,323,5241,22,385,5648
subtest27of10,pubtest242of100,1,323,5183,7,39,5229
subtest23of10,pubtest242of100,1,323,5183,8,78,5269
subtest26of10,pubtest242of100,1,323,5183,9,117,5309
subtest25of10,pubtest242of100,1,323,5183,10,156,5349
subtest210of10,pubtest242of100,1,323,5183,13,193,5389
subtest22of10,pubtest242of100,1,323,5183,16,231,5430
subtest21of10,pubtest242of100,1,323,5183,16,270,5469
subtest29of10,pubtest242of100,1,323,5183,18,308,5509
subtest28of10,pubtest242of100,1,323,5183,18,348,5549
subtest24of10,pubtest242of100,1,323,5183,19,387,5589
subtest29of10,pubtest243of100,1,323,5283,7,39,5329
subtest28of10,pubtest243of100,1,323,5283,9,77,5369
subtest22of10,pubtest243of100,1,323,5283,10,116,5409
subtest23of10,pubtest243of100,1,323,5283,11,155,5449
subtest26of10,pubtest243of100,1,323,5283,19,187,5489
subtest25of10,pubtest243of100,1,323,5283,18,227,5528
subtest27of10,pubtest243of100,1,323,5283,22,263,5568
subtest24of10,pubtest243of100,1,323,5283,24,302,5609
subtest21of10,pubtest243of100,1,323,5283,25,341,5649
subtest210of10,pubtest243of100,1,323,5283,26,380,5689
subtest26of10,pubtest244of100,1,323,5345,19,39,5403
subtest22of10,pubtest244of100,1,323,5345,23,74,5442
subtest210of10,pubtest244of100,1,323,5345,21,114,5480
subtest27of10,pubtest244of100,1,323,5345,22,154,5521
subtest29of10,pubtest244of100,1,323,5345,21,193,5559
subtest24of10,pubtest244of100,1,323,5345,24,233,5602
subtest28of10,pubtest244of100,1,323,5345,19,278,5642
subtest23of10,pubtest244of100,1,323,5345,26,311,5682
subtest21of10,pubtest244of100,1,323,5345,26,350,5721
subtest25of10,pubtest244of100,1,323,5345,20,388,5753
subtest29of10,pubtest245of100,1,322,5312,6,53,5371
subtest26of10,pubtest245of100,1,322,5312,6,92,5410
subtest22of10,pubtest245of100,1,322,5312,12,126,5450
subtest24of10,pubtest245of100,1,322,5312,12,166,5490
subtest210of10,pubtest245of100,1,322,5312,13,205,5530
subtest23of10,pubtest245of100,1,322,5312,8,244,5564
subtest28of10,pubtest245of100,1,322,5312,15,284,5611
subtest21of10,pubtest245of100,1,322,5312,17,322,5651
subtest25of10,pubtest245of100,1,322,5312,18,360,5690
subtest27of10,pubtest245of100,1,322,5312,19,399,5730
subtest26of10,pubtest246of100,1,323,5346,9,41,5396
subtest27of10,pubtest246of100,1,323,5346,11,78,5435
subtest21of10,pubtest246of100,1,323,5346,12,117,5475
subtest28of10,pubtest246of100,1,323,5346,18,150,5514
subtest29of10,pubtest246of100,1,323,5346,19,189,5554
subtest23of10,pubtest246of100,1,323,5346,23,225,5594
subtest25of10,pubtest246of100,1,323,5346,24,264,5634
subtest22of10,pubtest246of100,1,323,5346,33,293,5672
subtest24of10,pubtest246of100,1,323,5346,35,333,5714
subtest210of10,pubtest246of100,1,323,5346,32,372,5750
subtest27of10,pubtest247of100,1,323,5219,7,41,5267
subtest23of10,pubtest247of100,1,323,5219,12,76,5307
subtest21of10,pubtest247of100,1,323,5219,14,113,5346
subtest26of10,pubtest247of100,1,323,5219,15,152,5386
subtest22of10,pubtest247of100,1,323,5219,16,191,5426
subtest28of10,pubtest247of100,1,323,5219,17,228,5464
subtest210of10,pubtest247of100,1,323,5219,19,267,5505
subtest29of10,pubtest247of100,1,323,5219,63,263,5545
subtest25of10,pubtest247of100,1,323,5219,68,300,5587
subtest24of10,pubtest247of100,1,323,5219,67,339,5625
subtest26of10,pubtest248of100,1,323,5188,8,42,5238
subtest29of10,pubtest248of100,1,323,5188,8,81,5277
subtest25of10,pubtest248of100,1,323,5188,14,114,5316
subtest23of10,pubtest248of100,1,323,5188,21,147,5356
subtest28of10,pubtest248of100,1,323,5188,21,188,5397
subtest27of10,pubtest248of100,1,323,5188,39,209,5436
subtest21of10,pubtest248of100,1,323,5188,39,250,5477
subtest22of10,pubtest248of100,1,323,5188,46,282,5516
subtest210of10,pubtest248of100,1,323,5188,46,321,5555
subtest24of10,pubtest248of100,1,323,5188,46,359,5593
subtest25of10,pubtest249of100,1,323,5358,10,44,5412
subtest27of10,pubtest249of100,1,323,5358,7,84,5449
subtest26of10,pubtest249of100,1,323,5358,11,122,5491
subtest24of10,pubtest249of100,1,323,5358,13,161,5532
subtest28of10,pubtest249of100,1,323,5358,9,199,5566
subtest21of10,pubtest249of100,1,323,5358,18,235,5611
subtest29of10,pubtest249of100,1,323,5358,22,271,5651
subtest22of10,pubtest249of100,1,323,5358,22,309,5689
subtest210of10,pubtest249of100,1,323,5358,23,349,5730
subtest23of10,pubtest249of100,1,323,5358,23,388,5769
subtest27of10,pubtest250of100,1,323,5185,5,42,5232
subtest23of10,pubtest250of100,1,323,5185,7,80,5272
subtest28of10,pubtest250of100,1,323,5185,9,117,5311
subtest29of10,pubtest250of100,1,323,5185,10,156,5351
subtest24of10,pubtest250of100,1,323,5185,14,193,5392
subtest25of10,pubtest250of100,1,323,5185,66,179,5430
subtest21of10,pubtest250of100,1,323,5185,66,219,5470
subtest210of10,pubtest250of100,1,323,5185,69,257,5511
subtest26of10,pubtest250of100,1,323,5185,70,296,5551
subtest22of10,pubtest250of100,1,323,5185,73,334,5592
subtest23of10,pubtest251of100,1,323,5258,5,45,5308
subtest22of10,pubtest251of100,1,323,5258,6,83,5347
subtest24of10,pubtest251of100,1,323,5258,13,116,5387
subtest27of10,pubtest251of100,1,323,5258,13,156,5427
subtest21of10,pubtest251of100,1,323,5258,14,195,5467
subtest28of10,pubtest251of100,1,323,5258,14,234,5506
subtest25of10,pubtest251of100,1,323,5258,16,274,5548
subtest210of10,pubtest251of100,1,323,5258,17,312,5587
subtest29of10,pubtest251of100,1,323,5258,17,349,5624
subtest26of10,pubtest251of100,1,323,5258,20,389,5667
subtest29of10,pubtest252of100,1,323,5147,7,43,5197
subtest28of10,pubtest252of100,1,323,5147,7,82,5236
subtest21of10,pubtest252of100,1,323,5147,13,116,5276
subtest27of10,pubtest252of100,1,323,5147,14,155,5316
subtest26of10,pubtest252of100,1,323,5147,15,192,5354
subtest25of10,pubtest252of100,1,323,5147,17,231,5395
subtest22of10,pubtest252of100,1,323,5147,18,271,5436
subtest24of10,pubtest252of100,1,323,5147,20,309,5476
subtest23of10,pubtest252of100,1,323,5147,20,349,5516
subtest210of10,pubtest252of100,1,323,5147,24,385,5556
subtest28of10,pubtest253of100,1,322,5187,4,41,5232
subtest23of10,pubtest253of100,1,322,5187,4,80,5271
subtest25of10,pubtest253of100,1,322,5187,8,117,5312
subtest29of10,pubtest253of100,1,322,5187,12,153,5352
subtest27of10,pubtest253of100,1,322,5187,12,193,5392
subtest24of10,pubtest253of100,1,322,5187,24,221,5432
subtest21of10,pubtest253of100,1,322,5187,25,261,5473
subtest22of10,pubtest253of100,1,322,5187,25,300,5512
subtest210of10,pubtest253of100,1,322,5187,32,333,5552
subtest26of10,pubtest253of100,1,322,5187,33,373,5593
subtest210of10,pubtest254of100,1,323,5202,1,40,5243
subtest27of10,pubtest254of100,1,323,5202,4,77,5283
subtest28of10,pubtest254of100,1,323,5202,6,114,5322
subtest21of10,pubtest254of100,1,323,5202,7,153,5362
subtest25of10,pubtest254of100,1,323,5202,8,192,5402
subtest24of10,pubtest254of100,1,323,5202,9,231,5442
subtest23of10,pubtest254of100,1,323,5202,14,266,5482
subtest29of10,pubtest254of100,1,323,5202,15,305,5522
subtest26of10,pubtest254of100,1,323,5202,16,342,5560
subtest22of10,pubtest254of100,1,323,5202,16,382,5600
subtest23of10,pubtest255of100,1,322,5205,9,38,5252
subtest22of10,pubtest255of100,1,322,5205,9,77,5291
subtest28of10,pubtest255of100,1,322,5205,12,114,5331
subtest27of10,pubtest255of100,1,322,5205,12,154,5371
subtest29of10,pubtest255of100,1,322,5205,23,183,5411
subtest24of10,pubtest255of100,1,322,5205,25,220,5450
subtest21of10,pubtest255of100,1,322,5205,28,258,5491
subtest210of10,pubtest255of100,1,322,5205,28,298,5531
subtest26of10,pubtest255of100,1,322,5205,31,335,5571
subtest25of10,pubtest255of100,1,322,5205,37,369,5611
subtest29of10,pubtest256of100,1,323,5311,6,41,5358
subtest21of10,pubtest256of100,1,323,5311,67,40,5418
subtest26of10,pubtest256of100,1,323,5311,80,66,5457
subtest25of10,pubtest256of100,1,323,5311,80,106,5497
subtest23of10,pubtest256of100,1,323,5311,78,145,5534
subtest24of10,pubtest256of100,1,323,5311,82,183,5576
subtest28of10,pubtest256of100,1,323,5311,83,222,5616
subtest27of10,pubtest256of100,1,323,5311,84,262,5657
subtest22of10,pubtest256of100,1,323,5311,83,301,5695
subtest210of10,pubtest256of100,1,323,5311,83,343,5737
subtest24of10,pubtest257of100,1,323,5197,9,41,5247
subtest21of10,pubtest257of100,1,323,5197,10,79,5286
subtest28of10,pubtest257of100,1,323,5197,11,118,5326
subtest27of10,pubtest257of100,1,323,5197,12,158,5367
subtest23of10,pubtest257of100,1,323,5197,13,196,5406
subtest22of10,pubtest257of100,1,323,5197,14,235,5446
subtest29of10,pubtest257of100,1,323,5197,15,273,5485
subtest25of10,pubtest257of100,1,323,5197,16,313,5526
subtest210of10,pubtest257of100,1,323,5197,18,351,5566
subtest26of10,pubtest257of100,1,323,5197,19,390,5606
subtest28of10,pubtest258of100,1,323,5192,5,40,5237
subtest23of10,pubtest258of100,1,323,5192,9,75,5276
subtest25of10,pubtest258of100,1,323,5192,11,114,5317
subtest26of10,pubtest258of100,1,323,5192,13,151,5356
subtest21of10,pubtest258of100,1,323,5192,18,186,5396
subtest210of10,pubtest258of100,1,323,5192,20,224,5436
subtest29of10,pubtest258of100,1,323,5192,21,263,5476
subtest22of10,pubtest258of100,1,323,5192,22,300,5514
subtest27of10,pubtest258of100,1,323,5192,37,327,5556
subtest24of10,pubtest258of100,1,323,5192,42,362,5596
subtest21of10,pubtest259of100,1,323,5165,3,40,5208
subtest28of10,pubtest259of100,1,323,5165,6,76,5247
subtest25of10,pubtest259of100,1,323,5165,6,116,5287
subtest24of10,pubtest259of100,1,323,5165,17,145,5327
subtest27of10,pubtest259of100,1,323,5165,17,183,5365
subtest29of10,pubtest259of100,1,323,5165,20,222,5407
subtest23of10,pubtest259of100,1,323,5165,21,261,5447
subtest26of10,pubtest259of100,1,323,5165,22,300,5487
subtest22of10,pubtest259of100,1,323,5165,23,339,5527
subtest210of10,pubtest259of100,1,323,5165,24,378,5567
subtest210of10,pubtest260of100,1,323,5251,5,39,5295
subtest23of10,pubtest260of100,1,323,5251,5,78,5334
subtest21of10,pubtest260of100,1,323,5251,8,116,5375
subtest26of10,pubtest260of100,1,323,5251,8,156,5415
subtest29of10,pubtest260of100,1,323,5251,11,193,5455
subtest22of10,pubtest260of100,1,323,5251,11,232,5494
subtest27of10,pubtest260of100,1,323,5251,11,272,5534
subtest25of10,pubtest260of100,1,323,5251,13,311,5575
subtest28of10,pubtest260of100,1,323,5251,17,347,5615
subtest24of10,pubtest260of100,1,323,5251,17,387,5655
subtest28of10,pubtest261of100,1,323,5203,13,45,5261
subtest25of10,pubtest261of100,1,323,5203,13,85,5301
subtest210of10,pubtest261of100,1,323,5203,16,122,5341
subtest23of10,pubtest261of100,1,323,5203,16,160,5379
subtest27of10,pubtest261of100,1,323,5203,17,200,5420
subtest22of10,pubtest261of100,1,323,5203,17,239,5459
subtest29of10,pubtest261of100,1,323,5203,15,279,5497
subtest21of10,pubtest261of100,1,323,5203,22,315,5540
subtest24of10,pubtest261of100,1,323,5203,22,355,5580
subtest26of10,pubtest261of100,1,323,5203,25,392,5620
subtest21of10,pubtest262of100,1,323,5258,50,40,5348
subtest22of10,pubtest262of100,1,323,5258,68,63,5389
subtest23of10,pubtest262of100,1,323,5258,69,102,5429
subtest26of10,pubtest262of100,1,323,5258,76,134,5468
subtest27of10,pubtest262of100,1,323,5258,81,167,5506
subtest210of10,pubtest262of100,1,323,5258,82,207,5547
subtest29of10,pubtest262of100,1,323,5258,103,227,5588
subtest25of10,pubtest262of100,1,323,5258,137,233,5628
subtest24of10,pubtest262of100,1,323,5258,137,273,5668
subtest28of10,pubtest262of100,1,323,5258,148,302,5708
subtest22of10,pubtest263of100,1,322,5303,56,314,5673
subtest29of10,pubtest263of100,1,322,5303,63,345,5711
subtest24of10,pubtest263of100,1,322,5303,80,368,5751
subtest23of10,pubtest263of100,1,322,5303,96,392,5791
subtest26of10,pubtest263of100,1,322,5303,116,412,5831
subtest25of10,pubtest263of100,1,322,5303,146,422,5871
subtest210of10,pubtest263of100,1,322,5303,157,451,5911
subtest27of10,pubtest263of100,1,322,5303,196,453,5952
subtest28of10,pubtest263of100,1,322,5303,197,492,5992
subtest21of10,pubtest263of100,1,322,5303,198,530,6031
subtest22of10,pubtest264of100,1,322,5172,20,40,5232
subtest29of10,pubtest264of100,1,322,5172,23,77,5272
subtest23of10,pubtest264of100,1,322,5172,23,117,5312
subtest24of10,pubtest264of100,1,322,5172,24,157,5353
subtest27of10,pubtest264of100,1,322,5172,25,195,5392
subtest21of10,pubtest264of100,1,322,5172,26,234,5432
subtest25of10,pubtest264of100,1,322,5172,40,261,5473
subtest28of10,pubtest264of100,1,322,5172,40,299,5511
subtest26of10,pubtest264of100,1,322,5172,41,340,5553
subtest210of10,pubtest264of100,1,322,5172,42,378,5592
subtest26of10,pubtest265of100,1,323,5551,68,41,5660
subtest210of10,pubtest265of100,1,323,5551,71,78,5700
subtest27of10,pubtest265of100,1,323,5551,86,103,5740
subtest22of10,pubtest265of100,1,323,5551,108,120,5779
subtest28of10,pubtest265of100,1,323,5551,124,144,5819
subtest21of10,pubtest265of100,1,323,5551,124,184,5859
subtest29of10,pubtest265of100,1,323,5551,126,220,5897
subtest24of10,pubtest265of100,1,323,5551,126,260,5937
subtest25of10,pubtest265of100,1,323,5551,130,298,5979
subtest23of10,pubtest265of100,1,323,5551,130,338,6019
subtest29of10,pubtest266of100,1,321,5359,50,42,5451
subtest210of10,pubtest266of100,1,321,5359,51,81,5491
subtest25of10,pubtest266of100,1,321,5359,64,107,5530
subtest27of10,pubtest266of100,1,321,5359,64,145,5568
subtest21of10,pubtest266of100,1,321,5359,67,184,5610
subtest23of10,pubtest266of100,1,321,5359,68,223,5650
subtest26of10,pubtest266of100,1,321,5359,68,262,5689
subtest24of10,pubtest266of100,1,321,5359,71,300,5730
subtest22of10,pubtest266of100,1,321,5359,71,340,5770
subtest28of10,pubtest266of100,1,321,5359,71,381,5811
subtest23of10,pubtest267of100,1,323,5192,6,38,5236
subtest25of10,pubtest267of100,1,323,5192,21,62,5275
subtest26of10,pubtest267of100,1,323,5192,21,102,5315
subtest27of10,pubtest267of100,1,323,5192,22,142,5356
subtest28of10,pubtest267of100,1,323,5192,23,182,5397
subtest21of10,pubtest267of100,1,323,5192,24,220,5436
subtest29of10,pubtest267of100,1,323,5192,24,259,5475
subtest24of10,pubtest267of100,1,323,5192,26,297,5515
subtest22of10,pubtest267of100,1,323,5192,26,336,5554
subtest210of10,pubtest267of100,1,323,5192,36,367,5595
subtest23of10,pubtest268of100,1,323,5260,17,38,5315
subtest24of10,pubtest268of100,1,323,5260,32,63,5355
subtest25of10,pubtest268of100,1,323,5260,33,102,5395
subtest27of10,pubtest268of100,1,323,5260,57,117,5434
subtest28of10,pubtest268of100,1,323,5260,57,158,5475
subtest29of10,pubtest268of100,1,323,5260,56,196,5512
subtest22of10,pubtest268of100,1,323,5260,68,225,5553
subtest210of10,pubtest268of100,1,323,5260,70,264,5594
subtest21of10,pubtest268of100,1,323,5260,68,303,5631
subtest26of10,pubtest268of100,1,323,5260,71,344,5675
subtest24of10,pubtest269of100,1,323,5171,7,40,5218
subtest27of10,pubtest269of100,1,323,5171,19,68,5258
subtest210of10,pubtest269of100,1,323,5171,20,106,5297
subtest25of10,pubtest269of100,1,323,5171,26,140,5337
subtest26of10,pubtest269of100,1,323,5171,41,165,5377
subtest21of10,pubtest269of100,1,323,5171,43,203,5417
subtest22of10,pubtest269of100,1,323,5171,43,243,5457
subtest29of10,pubtest269of100,1,323,5171,47,278,5496
subtest23of10,pubtest269of100,1,323,5171,63,304,5538
subtest28of10,pubtest269of100,1,323,5171,63,343,5577
subtest26of10,pubtest270of100,1,323,5233,39,40,5312
subtest23of10,pubtest270of100,1,323,5233,38,78,5349
subtest29of10,pubtest270of100,1,323,5233,40,119,5392
subtest210of10,pubtest270of100,1,323,5233,41,157,5431
subtest27of10,pubtest270of100,1,323,5233,38,198,5469
subtest25of10,pubtest270of100,1,323,5233,59,220,5512
subtest21of10,pubtest270of100,1,323,5233,60,257,5550
subtest22of10,pubtest270of100,1,323,5233,61,297,5591
subtest24of10,pubtest270of100,1,323,5233,61,336,5630
subtest28of10,pubtest270of100,1,323,5233,60,374,5667
subtest24of10,pubtest271of100,1,323,5136,17,251,5404
subtest22of10,pubtest271of100,1,323,5136,21,285,5442
subtest210of10,pubtest271of100,1,323,5136,22,324,5482
subtest25of10,pubtest271of100,1,323,5136,21,363,5520
subtest27of10,pubtest271of100,1,323,5136,39,387,5562
subtest26of10,pubtest271of100,1,323,5136,40,426,5602
subtest23of10,pubtest271of100,1,323,5136,42,460,5638
subtest29of10,pubtest271of100,1,323,5136,42,500,5678
subtest21of10,pubtest271of100,1,323,5136,41,540,5717
subtest28of10,pubtest271of100,1,323,5136,58,568,5762
subtest25of10,pubtest272of100,1,323,5198,4,48,5250
subtest21of10,pubtest272of100,1,323,5198,15,76,5289
subtest26of10,pubtest272of100,1,323,5198,16,115,5329
subtest29of10,pubtest272of100,1,323,5198,24,147,5369
subtest23of10,pubtest272of100,1,323,5198,35,175,5408
subtest24of10,pubtest272of100,1,323,5198,40,212,5450
subtest27of10,pubtest272of100,1,323,5198,41,250,5489
subtest210of10,pubtest272of100,1,323,5198,42,289,5529
subtest22of10,pubtest272of100,1,323,5198,43,330,5571
subtest28of10,pubtest272of100,1,323,5198,44,367,5609
subtest22of10,pubtest273of100,1,321,5196,40,38,5274
subtest26of10,pubtest273of100,1,321,5196,49,70,5315
subtest29of10,pubtest273of100,1,321,5196,49,108,5353
subtest27of10,pubtest273of100,1,321,5196,51,147,5394
subtest25of10,pubtest273of100,1,321,5196,51,186,5433
subtest28of10,pubtest273of100,1,321,5196,79,199,5474
subtest23of10,pubtest273of100,1,321,5196,90,228,5514
subtest210of10,pubtest273of100,1,321,5196,91,267,5554
subtest24of10,pubtest273of100,1,321,5196,95,304,5595
subtest21of10,pubtest273of100,1,321,5196,95,342,5633
subtest26of10,pubtest274of100,1,323,5190,52,40,5282
subtest21of10,pubtest274of100,1,323,5190,51,79,5320
subtest23of10,pubtest274of100,1,323,5190,53,117,5360
subtest29of10,pubtest274of100,1,323,5190,54,157,5401
subtest25of10,pubtest274of100,1,323,5190,67,183,5440
subtest27of10,pubtest274of100,1,323,5190,67,223,5480
subtest28of10,pubtest274of100,1,323,5190,68,262,5520
subtest22of10,pubtest274of100,1,323,5190,69,301,5560
subtest24of10,pubtest274of100,1,323,5190,72,338,5600
subtest210of10,pubtest274of100,1,323,5190,73,377,5640
subtest27of10,pubtest275of100,1,323,5172,20,39,5231
subtest29of10,pubtest275of100,1,323,5172,20,78,5270
subtest21of10,pubtest275of100,1,323,5172,22,114,5308
subtest25of10,pubtest275of100,1,323,5172,23,154,5349
subtest22of10,pubtest275of100,1,323,5172,26,192,5390
subtest23of10,pubtest275of100,1,323,5172,26,232,5430
subtest24of10,pubtest275of100,1,323,5172,22,271,5465
subtest210of10,pubtest275of100,1,323,5172,27,311,5510
subtest26of10,pubtest275of100,1,323,5172,34,346,5552
subtest28of10,pubtest275of100,1,323,5172,37,382,5591
subtest21of10,pubtest276of100,1,323,5253,42,40,5335
subtest28of10,pubtest276of100,1,323,5253,42,79,5374
subtest24of10,pubtest276of100,1,323,5253,44,117,5414
subtest27of10,pubtest276of100,1,323,5253,44,157,5454
subtest23of10,pubtest276of100,1,323,5253,46,195,5494
subtest210of10,pubtest276of100,1,323,5253,46,235,5534
subtest25of10,pubtest276of100,1,323,5253,43,274,5570
subtest26of10,pubtest276of100,1,323,5253,47,314,5614
subtest29of10,pubtest276of100,1,323,5253,46,353,5652
subtest22of10,pubtest276of100,1,323,5253,61,380,5694
subtest22of10,pubtest277of100,1,323,6524,16,40,6580
subtest29of10,pubtest277of100,1,323,6524,16,79,6619
subtest28of10,pubtest277of100,1,323,6524,18,117,6659
subtest24of10,pubtest277of100,1,323,6524,18,157,6699
subtest210of10,pubtest277of100,1,323,6524,20,195,6739
subtest21of10,pubtest277of100,1,323,6524,20,234,6778
subtest27of10,pubtest277of100,1,323,6524,29,266,6819
subtest25of10,pubtest277of100,1,323,6524,30,305,6859
subtest23of10,pubtest277of100,1,323,6524,31,344,6899
subtest26of10,pubtest277of100,1,323,6524,31,384,6939
subtest22of10,pubtest278of100,1,323,8052,4,40,8096
subtest29of10,pubtest278of100,1,323,8052,15,68,8135
subtest23of10,pubtest278of100,1,323,8052,25,99,8176
subtest21of10,pubtest278of100,1,323,8052,94,70,8216
subtest28of10,pubtest278of100,1,323,8052,94,109,8255
subtest27of10,pubtest278of100,1,323,8052,96,148,8296
subtest25of10,pubtest278of100,1,323,8052,100,183,8335
subtest26of10,pubtest278of100,1,323,8052,101,222,8375
subtest24of10,pubtest278of100,1,323,8052,104,260,8416
subtest210of10,pubtest278of100,1,323,8052,104,300,8456
subtest25of10,pubtest279of100,1,323,5903,22,39,5964
subtest28of10,pubtest279of100,1,323,5903,45,55,6003
subtest24of10,pubtest279of100,1,323,5903,45,95,6043
subtest21of10,pubtest279of100,1,323,5903,46,132,6081
subtest27of10,pubtest279of100,1,323,5903,48,172,6123
subtest29of10,pubtest279of100,1,323,5903,47,212,6162
subtest23of10,pubtest279of100,1,323,5903,48,251,6202
subtest26of10,pubtest279of100,1,323,5903,47,290,6240
subtest22of10,pubtest279of100,1,323,5903,51,328,6282
subtest210of10,pubtest279of100,1,323,5903,53,367,6323
subtest27of10,pubtest280of100,1,323,5636,6,40,5682
subtest29of10,pubtest280of100,1,323,5636,19,66,5721
subtest24of10,pubtest280of100,1,323,5636,23,102,5761
subtest21of10,pubtest280of100,1,323,5636,23,142,5801
subtest210of10,pubtest280of100,1,323,5636,26,178,5840
subtest25of10,pubtest280of100,1,323,5636,27,218,5881
subtest22of10,pubtest280of100,1,323,5636,29,256,5921
subtest28of10,pubtest280of100,1,323,5636,29,296,5961
subtest23of10,pubtest280of100,1,323,5636,26,335,5997
subtest26of10,pubtest280of100,1,323,5636,27,375,6038
subtest27of10,pubtest281of100,1,323,5179,32,39,5250
subtest23of10,pubtest281of100,1,323,5179,33,79,5291
subtest24of10,pubtest281of100,1,323,5179,32,117,5328
subtest28of10,pubtest281of100,1,323,5179,34,157,5370
subtest22of10,pubtest281of100,1,323,5179,36,195,5410
subtest25of10,pubtest281of100,1,323,5179,47,224,5450
subtest210of10,pubtest281of100,1,323,5179,47,264,5490
subtest21of10,pubtest281of100,1,323,5179,49,302,5530
subtest29of10,pubtest281of100,1,323,5179,48,341,5568
subtest26of10,pubtest281of100,1,323,5179,49,381,5609
subtest24of10,pubtest282of100,1,323,5257,35,45,5337
subtest23of10,pubtest282of100,1,323,5257,34,84,5375
subtest21of10,pubtest282of100,1,323,5257,36,123,5416
subtest25of10,pubtest282of100,1,323,5257,40,159,5456
subtest22of10,pubtest282of100,1,323,5257,52,187,5496
subtest27of10,pubtest282of100,1,323,5257,53,223,5533
subtest26of10,pubtest282of100,1,323,5257,53,262,5572
subtest29of10,pubtest282of100,1,323,5257,52,303,5612
subtest28of10,pubtest282of100,1,323,5257,60,339,5656
subtest210of10,pubtest282of100,1,323,5257,59,379,5695
subtest24of10,pubtest283of100,1,323,5312,7,38,5357
subtest27of10,pubtest283of100,1,323,5312,20,66,5398
subtest22of10,pubtest283of100,1,323,5312,22,101,5435
subtest28of10,pubtest283of100,1,323,5312,24,141,5477
subtest23of10,pubtest283of100,1,323,5312,24,180,5516
subtest25of10,pubtest283of100,1,323,5312,27,218,5557
subtest21of10,pubtest283of100,1,323,5312,80,204,5596
subtest29of10,pubtest283of100,1,323,5312,80,244,5636
subtest210of10,pubtest283of100,1,323,5312,83,282,5677
subtest26of10,pubtest283of100,1,323,5312,82,322,5716
subtest25of10,pubtest284of100,1,323,5194,23,209,5426
subtest22of10,pubtest284of100,1,323,5194,23,246,5463
subtest210of10,pubtest284of100,1,323,5194,33,276,5503
subtest29of10,pubtest284of100,1,323,5194,41,307,5542
subtest24of10,pubtest284of100,1,323,5194,42,347,5583
subtest27of10,pubtest284of100,1,323,5194,99,329,5622
subtest28of10,pubtest284of100,1,323,5194,100,368,5662
subtest23of10,pubtest284of100,1,323,5194,101,407,5702
subtest21of10,pubtest284of100,1,323,5194,113,435,5742
subtest26of10,pubtest284of100,1,323,5194,116,472,5782
subtest23of10,pubtest285of100,1,323,5185,11,40,5236
subtest25of10,pubtest285of100,1,323,5185,23,67,5275
subtest24of10,pubtest285of100,1,323,5185,24,106,5315
subtest22of10,pubtest285of100,1,323,5185,27,141,5353
subtest27of10,pubtest285of100,1,323,5185,27,182,5394
subtest28of10,pubtest285of100,1,323,5185,30,220,5435
subtest21of10,pubtest285of100,1,323,5185,30,260,5475
subtest29of10,pubtest285of100,1,323,5185,41,289,5515
subtest210of10,pubtest285of100,1,323,5185,42,328,5555
subtest26of10,pubtest285of100,1,323,5185,44,366,5595
subtest210of10,pubtest286of100,1,323,5166,8,47,5221
subtest23of10,pubtest286of100,1,323,5166,7,87,5260
subtest25of10,pubtest286of100,1,323,5166,17,116,5299
subtest29of10,pubtest286of100,1,323,5166,18,156,5340
subtest21of10,pubtest286of100,1,323,5166,46,168,5380
subtest24of10,pubtest286of100,1,323,5166,47,207,5420
subtest27of10,pubtest286of100,1,323,5166,48,246,5460
subtest26of10,pubtest286of100,1,323,5166,59,275,5500
subtest22of10,pubtest286of100,1,323,5166,64,308,5538
subtest28of10,pubtest286of100,1,323,5166,65,348,5579
subtest26of10,pubtest287of100,1,323,5239,6,41,5286
subtest29of10,pubtest287of100,1,323,5239,7,80,5326
subtest28of10,pubtest287of100,1,323,5239,11,116,5366
subtest210of10,pubtest287of100,1,323,5239,14,152,5405
subtest27of10,pubtest287of100,1,323,5239,15,191,5445
subtest25of10,pubtest287of100,1,323,5239,15,229,5483
subtest24of10,pubtest287of100,1,323,5239,20,267,5526
subtest21of10,pubtest287of100,1,323,5239,21,305,5565
subtest23of10,pubtest287of100,1,323,5239,24,342,5605
subtest22of10,pubtest287of100,1,323,5239,25,381,5645
subtest29of10,pubtest288of100,1,323,5439,3,119,5561
subtest26of10,pubtest288of100,1,323,5439,4,155,5598
subtest25of10,pubtest288of100,1,323,5439,6,192,5637
subtest27of10,pubtest288of100,1,323,5439,7,232,5678
subtest21of10,pubtest288of100,1,323,5439,17,261,5717
subtest22of10,pubtest288of100,1,323,5439,18,299,5756
subtest23of10,pubtest288of100,1,323,5439,18,338,5795
subtest210of10,pubtest288of100,1,323,5439,21,377,5837
subtest28of10,pubtest288of100,1,323,5439,23,415,5877
subtest24of10,pubtest288of100,1,323,5439,22,454,5915
subtest29of10,pubtest289of100,1,323,5265,6,48,5319
subtest210of10,pubtest289of100,1,323,5265,7,87,5359
subtest23of10,pubtest289of100,1,323,5265,8,124,5397
subtest25of10,pubtest289of100,1,323,5265,10,163,5438
subtest24of10,pubtest289of100,1,323,5265,11,202,5478
subtest26of10,pubtest289of100,1,323,5265,19,234,5518
subtest27of10,pubtest289of100,1,323,5265,51,242,5558
subtest28of10,pubtest289of100,1,323,5265,53,280,5598
subtest21of10,pubtest289of100,1,323,5265,54,318,5637
subtest22of10,pubtest289of100,1,323,5265,56,358,5679
subtest29of10,pubtest290of100,1,323,5188,9,41,5238
subtest22of10,pubtest290of100,1,323,5188,11,77,5276
subtest23of10,pubtest290of100,1,323,5188,12,116,5316
subtest25of10,pubtest290of100,1,323,5188,16,153,5357
subtest27of10,pubtest290of100,1,323,5188,17,192,5397
subtest26of10,pubtest290of100,1,323,5188,17,234,5439
subtest210of10,pubtest290of100,1,323,5188,20,270,5478
subtest21of10,pubtest290of100,1,323,5188,22,308,5518
subtest28of10,pubtest290of100,1,323,5188,21,348,5557
subtest24of10,pubtest290of100,1,323,5188,24,385,5597
subtest23of10,pubtest291of100,1,323,5223,6,42,5271
subtest24of10,pubtest291of100,1,323,5223,11,76,5310
subtest21of10,pubtest291of100,1,323,5223,12,114,5349
subtest28of10,pubtest291of100,1,323,5223,13,154,5390
subtest27of10,pubtest291of100,1,323,5223,12,193,5428
subtest25of10,pubtest291of100,1,323,5223,19,226,5468
subtest210of10,pubtest291of100,1,323,5223,20,266,5509
subtest29of10,pubtest291of100,1,323,5223,23,304,5550
subtest22of10,pubtest291of100,1,323,5223,25,342,5590
subtest26of10,pubtest291of100,1,323,5223,28,379,5630
subtest28of10,pubtest292of100,1,323,5192,4,38,5234
subtest29of10,pubtest292of100,1,323,5192,7,73,5272
subtest21of10,pubtest292of100,1,323,5192,8,112,5312
subtest25of10,pubtest292of100,1,323,5192,10,150,5352
subtest27of10,pubtest292of100,1,323,5192,11,190,5393
subtest26of10,pubtest292of100,1,323,5192,15,228,5435
subtest22of10,pubtest292of100,1,323,5192,16,266,5474
subtest23of10,pubtest292of100,1,323,5192,17,304,5513
subtest24of10,pubtest292of100,1,323,5192,17,344,5553
subtest210of10,pubtest292of100,1,323,5192,19,382,5593
subtest24of10,pubtest293of100,1,323,5308,2,40,5350
subtest25of10,pubtest293of100,1,323,5308,2,79,5389
subtest28of10,pubtest293of100,1,323,5308,4,117,5429
subtest23of10,pubtest293of100,1,323,5308,4,157,5469
subtest27of10,pubtest293of100,1,323,5308,10,190,5508
subtest210of10,pubtest293of100,1,323,5308,11,230,5549
subtest21of10,pubtest293of100,1,323,5308,12,269,5589
subtest29of10,pubtest293of100,1,323,5308,14,306,5628
subtest22of10,pubtest293of100,1,323,5308,16,345,5669
subtest26of10,pubtest293of100,1,323,5308,17,385,5710
subtest21of10,pubtest294of100,1,323,5259,4,38,5301
subtest210of10,pubtest294of100,1,323,5259,15,65,5339
subtest26of10,pubtest294of100,1,323,5259,17,104,5380
subtest29of10,pubtest294of100,1,323,5259,18,143,5420
subtest25of10,pubtest294of100,1,323,5259,15,182,5456
subtest23of10,pubtest294of100,1,323,5259,20,223,5502
subtest27of10,pubtest294of100,1,323,5259,20,262,5541
subtest24of10,pubtest294of100,1,323,5259,22,299,5580
subtest28of10,pubtest294of100,1,323,5259,22,339,5620
subtest22of10,pubtest294of100,1,323,5259,22,378,5659
subtest25of10,pubtest295of100,1,323,5213,10,38,5261
subtest23of10,pubtest295of100,1,323,5213,10,77,5300
subtest27of10,pubtest295of100,1,323,5213,11,116,5340
subtest21of10,pubtest295of100,1,323,5213,14,153,5380
subtest29of10,pubtest295of100,1,323,5213,14,193,5420
subtest24of10,pubtest295of100,1,323,5213,16,231,5460
subtest22of10,pubtest295of100,1,323,5213,18,269,5500
subtest210of10,pubtest295of100,1,323,5213,18,307,5538
subtest26of10,pubtest295of100,1,323,5213,21,346,5580
subtest28of10,pubtest295of100,1,323,5213,21,386,5620
subtest25of10,pubtest296of100,1,322,5271,4,39,5314
subtest27of10,pubtest296of100,1,322,5271,15,67,5353
subtest24of10,pubtest296of100,1,322,5271,16,105,5392
subtest23of10,pubtest296of100,1,322,5271,18,144,5433
subtest21of10,pubtest296of100,1,322,5271,20,182,5473
subtest26of10,pubtest296of100,1,322,5271,19,223,5513
subtest29of10,pubtest296of100,1,322,5271,20,261,5552
subtest210of10,pubtest296of100,1,322,5271,22,300,5593
subtest22of10,pubtest296of100,1,322,5271,23,339,5633
subtest28of10,pubtest296of100,1,322,5271,23,379,5673
subtest25of10,pubtest297of100,1,323,5168,6,49,5223
subtest210of10,pubtest297of100,1,323,5168,6,89,5263
subtest29of10,pubtest297of100,1,323,5168,13,123,5304
subtest23of10,pubtest297of100,1,323,5168,14,162,5344
subtest22of10,pubtest297of100,1,323,5168,15,200,5383
subtest27of10,pubtest297of100,1,323,5168,15,240,5423
subtest21of10,pubtest297of100,1,323,5168,19,274,5461
subtest26of10,pubtest297of100,1,323,5168,20,313,5501
subtest28of10,pubtest297of100,1,323,5168,23,352,5543
subtest24of10,pubtest297of100,1,323,5168,24,391,5583
subtest29of10,pubtest298of100,1,323,5239,18,43,5300
subtest25of10,pubtest298of100,1,323,5239,19,82,5340
subtest22of10,pubtest298of100,1,323,5239,18,121,5378
subtest23of10,pubtest298of100,1,323,5239,42,141,5422
subtest24of10,pubtest298of100,1,323,5239,42,181,5462
subtest21of10,pubtest298of100,1,323,5239,43,220,5502
subtest27of10,pubtest298of100,1,323,5239,44,259,5542
subtest28of10,pubtest298of100,1,323,5239,45,298,5582
subtest210of10,pubtest298of100,1,323,5239,46,337,5622
subtest26of10,pubtest298of100,1,323,5239,62,361,5662
subtest22of10,pubtest299of100,1,323,5350,10,38,5398
subtest29of10,pubtest299of100,1,323,5350,10,77,5437
subtest210of10,pubtest299of100,1,323,5350,17,110,5477
subtest27of10,pubtest299of100,1,323,5350,19,148,5517
subtest24of10,pubtest299of100,1,323,5350,19,188,5557
subtest28of10,pubtest299of100,1,323,5350,24,220,5594
subtest23of10,pubtest299of100,1,323,5350,24,259,5633
subtest25of10,pubtest299of100,1,323,5350,27,299,5676
subtest26of10,pubtest299of100,1,323,5350,27,338,5715
subtest21of10,pubtest299of100,1,323,5350,27,378,5755
subtest24of10,pubtest2100of100,1,325,5166,5,69,5240
subtest21of10,pubtest2100of100,1,325,5166,8,105,5279
subtest29of10,pubtest2100of100,1,325,5166,9,144,5319
subtest22of10,pubtest2100of100,1,325,5166,13,180,5359
subtest27of10,pubtest2100of100,1,325,5166,15,218,5399
subtest25of10,pubtest2100of100,1,325,5166,15,258,5439
subtest28of10,pubtest2100of100,1,325,5166,16,297,5479
subtest210of10,pubtest2100of100,1,325,5166,17,336,5519
subtest23of10,pubtest2100of100,1,325,5166,13,376,5555
subtest26of10,pubtest2100of100,1,325,5166,23,410,5599
subtest26of10,pubtest21of100,1,322,10193,12,48,10253
subtest27of10,pubtest21of100,1,322,10193,17,82,10292
subtest29of10,pubtest21of100,1,322,10193,19,120,10332
subtest24of10,pubtest21of100,1,322,10193,25,154,10372
subtest25of10,pubtest21of100,1,322,10193,27,191,10411
subtest210of10,pubtest21of100,1,322,10193,29,230,10452
subtest21of10,pubtest21of100,1,322,10193,33,266,10492
subtest28of10,pubtest21of100,1,322,10193,35,303,10531
subtest23of10,pubtest21of100,1,322,10193,35,343,10571
subtest22of10,pubtest21of100,1,322,10193,39,381,10613
subtest29of10,pubtest22of100,1,321,5290,30,40,5360
subtest27of10,pubtest22of100,1,321,5290,33,76,5399
subtest24of10,pubtest22of100,1,321,5290,34,115,5439
subtest23of10,pubtest22of100,1,321,5290,36,153,5479
subtest25of10,pubtest22of100,1,321,5290,37,191,5518
subtest28of10,pubtest22of100,1,321,5290,38,231,5559
subtest21of10,pubtest22of100,1,321,5290,41,268,5599
subtest22of10,pubtest22of100,1,321,5290,102,328,5720
subtest26of10,pubtest22of100,1,321,5290,44,305,5639
subtest210of10,pubtest22of100,1,321,5290,99,288,5677
subtest23of10,pubtest23of100,1,321,5303,4,254,5561
subtest28of10,pubtest23of100,1,321,5303,7,291,5601
subtest24of10,pubtest23of100,1,321,5303,8,331,5642
subtest27of10,pubtest23of100,1,321,5303,15,363,5681
subtest29of10,pubtest23of100,1,321,5303,15,403,5721
subtest26of10,pubtest23of100,1,321,5303,15,444,5762
subtest25of10,pubtest23of100,1,321,5303,18,480,5801
subtest22of10,pubtest23of100,1,321,5303,19,519,5841
subtest21of10,pubtest23of100,1,321,5303,20,558,5881
subtest210of10,pubtest23of100,1,321,5303,21,597,5921
subtest23of10,pubtest24of100,1,321,5207,15,39,5261
subtest25of10,pubtest24of100,1,321,5207,17,75,5299
subtest24of10,pubtest24of100,1,321,5207,18,114,5339
subtest21of10,pubtest24of100,1,321,5207,24,148,5379
subtest29of10,pubtest24of100,1,321,5207,25,187,5419
subtest28of10,pubtest24of100,1,321,5207,26,227,5460
subtest210of10,pubtest24of100,1,321,5207,27,264,5498
subtest22of10,pubtest24of100,1,321,5207,29,303,5539
subtest26of10,pubtest24of100,1,321,5207,30,342,5579
subtest27of10,pubtest24of100,1,321,5207,27,382,5616
subtest28of10,pubtest25of100,1,321,5148,23,40,5211
subtest21of10,pubtest25of100,1,321,5148,31,70,5249
subtest210of10,pubtest25of100,1,321,5148,32,108,5288
subtest27of10,pubtest25of100,1,321,5148,50,130,5328
subtest25of10,pubtest25of100,1,321,5148,51,168,5367
subtest23of10,pubtest25of100,1,321,5148,52,208,5408
subtest22of10,pubtest25of100,1,321,5148,52,247,5447
subtest24of10,pubtest25of100,1,321,5148,54,287,5489
subtest29of10,pubtest25of100,1,321,5148,55,326,5529
subtest26of10,pubtest25of100,1,321,5148,51,365,5564
subtest22of10,pubtest26of100,1,321,5211,5,42,5258
subtest21of10,pubtest26of100,1,321,5211,5,81,5297
subtest29of10,pubtest26of100,1,321,5211,7,119,5337
subtest23of10,pubtest26of100,1,321,5211,9,157,5377
subtest26of10,pubtest26of100,1,321,5211,14,189,5414
subtest210of10,pubtest26of100,1,321,5211,16,229,5456
subtest27of10,pubtest26of100,1,321,5211,16,268,5495
subtest28of10,pubtest26of100,1,321,5211,19,307,5537
subtest24of10,pubtest26of100,1,321,5211,20,346,5577
subtest25of10,pubtest26of100,1,321,5211,16,386,5613
subtest27of10,pubtest27of100,1,320,5199,3,41,5243
subtest28of10,pubtest27of100,1,320,5199,6,77,5282
subtest23of10,pubtest27of100,1,320,5199,16,107,5322
subtest24of10,pubtest27of100,1,320,5199,16,147,5362
subtest29of10,pubtest27of100,1,320,5199,22,182,5403
subtest22of10,pubtest27of100,1,320,5199,23,216,5438
subtest210of10,pubtest27of100,1,320,5199,22,256,5477
subtest21of10,pubtest27of100,1,320,5199,24,295,5518
subtest26of10,pubtest27of100,1,320,5199,24,335,5558
subtest25of10,pubtest27of100,1,320,5199,23,374,5596
subtest27of10,pubtest28of100,1,321,5226,7,49,5282
subtest28of10,pubtest28of100,1,321,5226,8,87,5321
subtest21of10,pubtest28of100,1,321,5226,11,123,5360
subtest23of10,pubtest28of100,1,321,5226,13,162,5401
subtest25of10,pubtest28of100,1,321,5226,15,200,5441
subtest210of10,pubtest28of100,1,321,5226,15,240,5481
subtest29of10,pubtest28of100,1,321,5226,16,279,5521
subtest26of10,pubtest28of100,1,321,5226,20,315,5561
subtest24of10,pubtest28of100,1,321,5226,22,353,5601
subtest22of10,pubtest28of100,1,321,5226,22,393,5641
subtest23of10,pubtest29of100,1,321,5359,7,41,5407
subtest210of10,pubtest29of100,1,321,5359,8,489,5856
subtest29of10,pubtest29of100,1,321,5359,10,525,5894
subtest25of10,pubtest29of100,1,321,5359,10,565,5934
subtest21of10,pubtest29of100,1,321,5359,11,602,5972
subtest22of10,pubtest29of100,1,321,5359,12,641,6012
subtest28of10,pubtest29of100,1,321,5359,16,679,6054
subtest27of10,pubtest29of100,1,321,5359,16,720,6095
subtest24of10,pubtest29of100,1,321,5359,20,755,6134
subtest26of10,pubtest29of100,1,321,5359,21,795,6175
subtest29of10,pubtest210of100,1,323,5211,3,43,5257
subtest21of10,pubtest210of100,1,323,5211,5,81,5297
subtest210of10,pubtest210of100,1,323,5211,7,119,5337
subtest27of10,pubtest210of100,1,323,5211,8,157,5376
subtest28of10,pubtest210of100,1,323,5211,13,192,5416
subtest23of10,pubtest210of100,1,323,5211,13,232,5456
subtest25of10,pubtest210of100,1,323,5211,15,270,5496
subtest24of10,pubtest210of100,1,323,5211,15,310,5536
subtest22of10,pubtest210of100,1,323,5211,19,346,5576
subtest26of10,pubtest210of100,1,323,5211,21,384,5616
subtest210of10,pubtest211of100,1,323,5579,8,39,5626
subtest24of10,pubtest211of100,1,323,5579,17,69,5665
subtest25of10,pubtest211of100,1,323,5579,23,103,5705
subtest22of10,pubtest211of100,1,323,5579,24,142,5745
subtest26of10,pubtest211of100,1,323,5579,24,182,5785
subtest29of10,pubtest211of100,1,323,5579,22,221,5822
subtest21of10,pubtest211of100,1,323,5579,22,261,5862
subtest23of10,pubtest211of100,1,323,5579,30,296,5905
subtest27of10,pubtest211of100,1,323,5579,31,335,5945
subtest28of10,pubtest211of100,1,323,5579,35,371,5985
subtest25of10,pubtest212of100,1,323,5262,2,138,5402
subtest29of10,pubtest212of100,1,323,5262,4,175,5441
subtest28of10,pubtest212of100,1,323,5262,6,213,5481
subtest23of10,pubtest212of100,1,323,5262,6,253,5521
subtest24of10,pubtest212of100,1,323,5262,8,291,5561
subtest21of10,pubtest212of100,1,323,5262,14,325,5601
subtest27of10,pubtest212of100,1,323,5262,13,365,5640
subtest22of10,pubtest212of100,1,323,5262,18,400,5680
subtest26of10,pubtest212of100,1,323,5262,19,440,5721
subtest210of10,pubtest212of100,1,323,5262,20,479,5761
subtest23of10,pubtest213of100,1,322,5265,8,40,5313
subtest26of10,pubtest213of100,1,322,5265,10,78,5353
subtest29of10,pubtest213of100,1,322,5265,12,115,5392
subtest22of10,pubtest213of100,1,322,5265,14,151,5430
subtest21of10,pubtest213of100,1,322,5265,17,190,5472
subtest27of10,pubtest213of100,1,322,5265,18,229,5512
subtest24of10,pubtest213of100,1,322,5265,14,269,5548
subtest210of10,pubtest213of100,1,322,5265,19,308,5592
subtest25of10,pubtest213of100,1,322,5265,50,318,5633
subtest28of10,pubtest213of100,1,322,5265,50,357,5672
subtest21of10,pubtest214of100,1,323,5175,8,42,5225
subtest23of10,pubtest214of100,1,323,5175,10,78,5263
subtest25of10,pubtest214of100,1,323,5175,12,116,5303
subtest26of10,pubtest214of100,1,323,5175,13,156,5344
subtest27of10,pubtest214of100,1,323,5175,15,198,5388
subtest29of10,pubtest214of100,1,323,5175,31,222,5428
subtest22of10,pubtest214of100,1,323,5175,32,261,5468
subtest210of10,pubtest214of100,1,323,5175,33,300,5508
subtest28of10,pubtest214of100,1,323,5175,34,339,5548
subtest24of10,pubtest214of100,1,323,5175,34,381,5590
subtest27of10,pubtest215of100,1,323,5341,11,40,5392
subtest24of10,pubtest215of100,1,323,5341,12,79,5432
subtest29of10,pubtest215of100,1,323,5341,13,117,5471
subtest21of10,pubtest215of100,1,323,5341,14,158,5513
subtest26of10,pubtest215of100,1,323,5341,17,194,5552
subtest25of10,pubtest215of100,1,323,5341,18,232,5591
subtest210of10,pubtest215of100,1,323,5341,27,263,5631
subtest23of10,pubtest215of100,1,323,5341,30,300,5671
subtest22of10,pubtest215of100,1,323,5341,31,338,5710
subtest28of10,pubtest215of100,1,323,5341,32,378,5751
subtest23of10,pubtest216of100,1,323,5447,15,43,5505
subtest21of10,pubtest216of100,1,323,5447,14,83,5544
subtest28of10,pubtest216of100,1,323,5447,16,121,5584
subtest27of10,pubtest216of100,1,323,5447,16,161,5624
subtest24of10,pubtest216of100,1,323,5447,14,200,5661
subtest22of10,pubtest216of100,1,323,5447,21,236,5704
subtest25of10,pubtest216of100,1,323,5447,21,275,5743
subtest29of10,pubtest216of100,1,323,5447,23,311,5781
subtest210of10,pubtest216of100,1,323,5447,23,354,5824
subtest26of10,pubtest216of100,1,323,5447,23,390,5860
subtest27of10,pubtest217of100,1,322,5182,9,46,5237
subtest22of10,pubtest217of100,1,322,5182,9,86,5277
subtest21of10,pubtest217of100,1,322,5182,11,123,5316
subtest24of10,pubtest217of100,1,322,5182,11,164,5357
subtest29of10,pubtest217of100,1,322,5182,13,201,5396
subtest28of10,pubtest217of100,1,322,5182,13,241,5436
subtest23of10,pubtest217of100,1,322,5182,14,280,5476
subtest26of10,pubtest217of100,1,322,5182,14,320,5516
subtest25of10,pubtest217of100,1,322,5182,17,357,5556
subtest210of10,pubtest217of100,1,322,5182,21,393,5596
subtest29of10,pubtest218of100,1,323,5254,858,408,6520
subtest21of10,pubtest218of100,1,323,5254,859,446,6559
subtest22of10,pubtest218of100,1,323,5254,860,485,6599
subtest27of10,pubtest218of100,1,323,5254,861,522,6637
subtest25of10,pubtest218of100,1,323,5254,864,561,6679
subtest24of10,pubtest218of100,1,323,5254,865,600,6719
subtest23of10,pubtest218of100,1,323,5254,865,640,6759
subtest28of10,pubtest218of100,1,323,5254,861,680,6795
subtest26of10,pubtest218of100,1,323,5254,866,718,6838
subtest210of10,pubtest218of100,1,323,5254,867,758,6879
subtest210of10,pubtest219of100,1,323,5129,14,39,5182
subtest22of10,pubtest219of100,1,323,5129,18,76,5223
subtest28of10,pubtest219of100,1,323,5129,18,117,5264
subtest21of10,pubtest219of100,1,323,5129,19,154,5302
subtest23of10,pubtest219of100,1,323,5129,20,195,5344
subtest25of10,pubtest219of100,1,323,5129,15,234,5378
subtest29of10,pubtest219of100,1,323,5129,21,275,5425
subtest27of10,pubtest219of100,1,323,5129,23,313,5465
subtest24of10,pubtest219of100,1,323,5129,22,352,5503
subtest26of10,pubtest219of100,1,323,5129,22,390,5541
subtest25of10,pubtest220of100,1,323,5328,6,43,5377
subtest23of10,pubtest220of100,1,323,5328,7,81,5416
subtest29of10,pubtest220of100,1,323,5328,10,117,5455
subtest210of10,pubtest220of100,1,323,5328,10,157,5495
subtest21of10,pubtest220of100,1,323,5328,17,191,5536
subtest27of10,pubtest220of100,1,323,5328,17,230,5575
subtest28of10,pubtest220of100,1,323,5328,25,262,5615
subtest24of10,pubtest220of100,1,323,5328,25,301,5654
subtest26of10,pubtest220of100,1,323,5328,29,338,5695
subtest22of10,pubtest220of100,1,323,5328,32,375,5735
subtest28of10,pubtest221of100,1,323,5205,7,96,5308
subtest24of10,pubtest221of100,1,323,5205,7,135,5347
subtest21of10,pubtest221of100,1,323,5205,125,56,5386
subtest210of10,pubtest221of100,1,323,5205,126,95,5426
subtest23of10,pubtest221of100,1,323,5205,127,134,5466
subtest25of10,pubtest221of100,1,323,5205,127,172,5504
subtest27of10,pubtest221of100,1,323,5205,130,210,5545
subtest26of10,pubtest221of100,1,323,5205,131,251,5587
subtest22of10,pubtest221of100,1,323,5205,125,289,5619
subtest29of10,pubtest221of100,1,323,5205,131,329,5665
subtest22of10,pubtest222of100,1,323,5250,7,46,5303
subtest21of10,pubtest222of100,1,323,5250,6,85,5341
subtest29of10,pubtest222of100,1,323,5250,12,120,5382
subtest27of10,pubtest222of100,1,323,5250,22,149,5421
subtest28of10,pubtest222of100,1,323,5250,25,187,5462
subtest23of10,pubtest222of100,1,323,5250,24,228,5502
subtest25of10,pubtest222of100,1,323,5250,26,266,5542
subtest210of10,pubtest222of100,1,323,5250,29,303,5582
subtest26of10,pubtest222of100,1,323,5250,29,343,5622
subtest24of10,pubtest222of100,1,323,5250,30,382,5662
subtest21of10,pubtest223of100,1,323,5327,10,40,5377
subtest23of10,pubtest223of100,1,323,5327,11,77,5415
subtest28of10,pubtest223of100,1,323,5327,12,116,5455
subtest24of10,pubtest223of100,1,323,5327,14,154,5495
subtest29of10,pubtest223of100,1,323,5327,16,193,5536
subtest210of10,pubtest223of100,1,323,5327,23,225,5575
subtest27of10,pubtest223of100,1,323,5327,23,265,5615
subtest22of10,pubtest223of100,1,323,5327,25,303,5655
subtest26of10,pubtest223of100,1,323,5327,27,341,5695
subtest25of10,pubtest223of100,1,323,5327,29,379,5735
subtest21of10,pubtest224of100,1,323,5299,4,42,5345
subtest27of10,pubtest224of100,1,323,5299,8,77,5384
subtest28of10,pubtest224of100,1,323,5299,8,117,5424
subtest23of10,pubtest224of100,1,323,5299,10,156,5465
subtest26of10,pubtest224of100,1,323,5299,12,193,5504
subtest29of10,pubtest224of100,1,323,5299,14,231,5544
subtest25of10,pubtest224of100,1,323,5299,16,269,5584
subtest22of10,pubtest224of100,1,323,5299,18,307,5624
subtest24of10,pubtest224of100,1,323,5299,22,340,5661
subtest210of10,pubtest224of100,1,323,5299,25,380,5704
subtest27of10,pubtest225of100,1,323,5278,5,42,5325
subtest22of10,pubtest225of100,1,323,5278,6,79,5363
subtest21of10,pubtest225of100,1,323,5278,8,118,5404
subtest26of10,pubtest225of100,1,323,5278,9,158,5445
subtest25of10,pubtest225of100,1,323,5278,17,187,5482
subtest24of10,pubtest225of100,1,323,5278,17,227,5522
subtest23of10,pubtest225of100,1,323,5278,21,265,5564
subtest28of10,pubtest225of100,1,323,5278,21,305,5604
subtest29of10,pubtest225of100,1,323,5278,23,343,5644
subtest210of10,pubtest225of100,1,323,5278,23,383,5684
subtest22of10,pubtest226of100,1,323,5234,9,44,5287
subtest25of10,pubtest226of100,1,323,5234,10,81,5325
subtest23of10,pubtest226of100,1,323,5234,20,111,5365
subtest27of10,pubtest226of100,1,323,5234,21,152,5407
subtest21of10,pubtest226of100,1,323,5234,22,191,5447
subtest29of10,pubtest226of100,1,323,5234,23,230,5487
subtest28of10,pubtest226of100,1,323,5234,24,268,5526
subtest210of10,pubtest226of100,1,323,5234,22,308,5564
subtest26of10,pubtest226of100,1,323,5234,27,345,5606
subtest24of10,pubtest226of100,1,323,5234,28,384,5646
subtest29of10,pubtest227of100,1,323,5334,5,44,5383
subtest210of10,pubtest227of100,1,323,5334,7,81,5422
subtest25of10,pubtest227of100,1,323,5334,8,121,5463
subtest24of10,pubtest227of100,1,323,5334,9,160,5503
subtest23of10,pubtest227of100,1,323,5334,16,192,5542
subtest26of10,pubtest227of100,1,323,5334,16,232,5582
subtest27of10,pubtest227of100,1,323,5334,18,270,5622
subtest21of10,pubtest227of100,1,323,5334,20,308,5662
subtest22of10,pubtest227of100,1,323,5334,20,348,5702
subtest28of10,pubtest227of100,1,323,5334,23,384,5741
subtest21of10,pubtest228of100,1,323,5179,5,40,5224
subtest25of10,pubtest228of100,1,323,5179,5,79,5263
subtest23of10,pubtest228of100,1,323,5179,7,117,5303
subtest27of10,pubtest228of100,1,323,5179,14,150,5343
subtest26of10,pubtest228of100,1,323,5179,14,190,5383
subtest29of10,pubtest228of100,1,323,5179,16,227,5422
subtest24of10,pubtest228of100,1,323,5179,17,267,5463
subtest210of10,pubtest228of100,1,323,5179,22,302,5503
subtest22of10,pubtest228of100,1,323,5179,22,342,5543
subtest28of10,pubtest228of100,1,323,5179,24,380,5583
subtest24of10,pubtest229of100,1,321,5228,6,40,5274
subtest28of10,pubtest229of100,1,321,5228,14,70,5312
subtest22of10,pubtest229of100,1,321,5228,17,108,5353
subtest21of10,pubtest229of100,1,321,5228,15,148,5391
subtest210of10,pubtest229of100,1,321,5228,18,187,5433
subtest29of10,pubtest229of100,1,321,5228,19,226,5473
subtest27of10,pubtest229of100,1,321,5228,20,265,5513
subtest25of10,pubtest229of100,1,321,5228,21,304,5553
subtest26of10,pubtest229of100,1,321,5228,22,344,5594
subtest23of10,pubtest229of100,1,321,5228,21,384,5633
subtest22of10,pubtest230of100,1,323,5375,4,40,5419
subtest21of10,pubtest230of100,1,323,5375,6,79,5460
subtest27of10,pubtest230of100,1,323,5375,7,117,5499
subtest29of10,pubtest230of100,1,323,5375,8,156,5539
subtest28of10,pubtest230of100,1,323,5375,9,195,5579
subtest25of10,pubtest230of100,1,323,5375,10,234,5619
subtest23of10,pubtest230of100,1,323,5375,10,274,5659
subtest210of10,pubtest230of100,1,323,5375,20,304,5699
subtest24of10,pubtest230of100,1,323,5375,20,344,5739
subtest26of10,pubtest230of100,1,323,5375,23,379,5777
subtest23of10,pubtest231of100,1,323,5329,6,46,5381
subtest28of10,pubtest231of100,1,323,5329,6,86,5421
subtest25of10,pubtest231of100,1,323,5329,13,118,5460
subtest27of10,pubtest231of100,1,323,5329,14,157,5500
subtest24of10,pubtest231of100,1,323,5329,13,197,5539
subtest21of10,pubtest231of100,1,323,5329,16,234,5579
subtest26of10,pubtest231of100,1,323,5329,16,273,5618
subtest22of10,pubtest231of100,1,323,5329,19,312,5660
subtest210of10,pubtest231of100,1,323,5329,16,352,5697
subtest29of10,pubtest231of100,1,323,5329,20,391,5740
subtest21of10,pubtest232of100,1,323,5238,16,227,5481
subtest27of10,pubtest232of100,1,323,5238,18,263,5519
subtest28of10,pubtest232of100,1,323,5238,19,301,5558
subtest22of10,pubtest232of100,1,323,5238,17,341,5596
subtest23of10,pubtest232of100,1,323,5238,24,377,5639
subtest29of10,pubtest232of100,1,323,5238,24,416,5678
subtest25of10,pubtest232of100,1,323,5238,27,454,5719
subtest210of10,pubtest232of100,1,323,5238,27,494,5759
subtest24of10,pubtest232of100,1,323,5238,29,532,5799
subtest26of10,pubtest232of100,1,323,5238,31,570,5839
subtest29of10,pubtest233of100,1,323,5255,4,51,5310
subtest24of10,pubtest233of100,1,323,5255,3,91,5349
subtest25of10,pubtest233of100,1,323,5255,7,126,5388
subtest27of10,pubtest233of100,1,323,5255,8,165,5428
subtest210of10,pubtest233of100,1,323,5255,9,204,5468
subtest23of10,pubtest233of100,1,323,5255,13,239,5507
subtest26of10,pubtest233of100,1,323,5255,14,278,5547
subtest21of10,pubtest233of100,1,323,5255,14,317,5586
subtest28of10,pubtest233of100,1,323,5255,16,357,5628
subtest22of10,pubtest233of100,1,323,5255,15,396,5666
subtest25of10,pubtest234of100,1,323,5203,17,46,5266
subtest27of10,pubtest234of100,1,323,5203,18,86,5307
subtest26of10,pubtest234of100,1,323,5203,19,125,5347
subtest21of10,pubtest234of100,1,323,5203,28,155,5386
subtest29of10,pubtest234of100,1,323,5203,54,169,5426
subtest23of10,pubtest234of100,1,323,5203,61,203,5467
subtest22of10,pubtest234of100,1,323,5203,62,242,5507
subtest210of10,pubtest234of100,1,323,5203,77,266,5546
subtest24of10,pubtest234of100,1,323,5203,124,259,5586
subtest28of10,pubtest234of100,1,323,5203,134,289,5626
subtest21of10,pubtest235of100,1,321,5333,39,41,5413
subtest23of10,pubtest235of100,1,321,5333,40,80,5453
subtest210of10,pubtest235of100,1,321,5333,43,118,5494
subtest22of10,pubtest235of100,1,321,5333,51,148,5532
subtest27of10,pubtest235of100,1,321,5333,51,188,5572
subtest24of10,pubtest235of100,1,321,5333,54,226,5613
subtest29of10,pubtest235of100,1,321,5333,55,265,5653
subtest26of10,pubtest235of100,1,321,5333,56,304,5693
subtest25of10,pubtest235of100,1,321,5333,60,340,5733
subtest28of10,pubtest235of100,1,321,5333,61,380,5774
subtest210of10,pubtest236of100,1,323,5295,7,43,5345
subtest23of10,pubtest236of100,1,323,5295,8,83,5386
subtest27of10,pubtest236of100,1,323,5295,18,113,5426
subtest28of10,pubtest236of100,1,323,5295,25,146,5466
subtest25of10,pubtest236of100,1,323,5295,25,186,5506
subtest21of10,pubtest236of100,1,323,5295,33,219,5547
subtest29of10,pubtest236of100,1,323,5295,35,256,5586
subtest24of10,pubtest236of100,1,323,5295,44,288,5627
subtest26of10,pubtest236of100,1,323,5295,50,321,5666
subtest22of10,pubtest236of100,1,323,5295,58,353,5706
subtest24of10,pubtest237of100,1,323,5204,6,39,5249
subtest23of10,pubtest237of100,1,323,5204,9,75,5288
subtest25of10,pubtest237of100,1,323,5204,9,114,5327
subtest28of10,pubtest237of100,1,323,5204,17,147,5368
subtest27of10,pubtest237of100,1,323,5204,17,187,5408
subtest21of10,pubtest237of100,1,323,5204,18,226,5448
subtest29of10,pubtest237of100,1,323,5204,25,258,5487
subtest26of10,pubtest237of100,1,323,5204,26,298,5528
subtest22of10,pubtest237of100,1,323,5204,27,335,5566
subtest210of10,pubtest237of100,1,323,5204,29,375,5608
subtest29of10,pubtest238of100,1,323,5424,6,40,5470
subtest22of10,pubtest238of100,1,323,5424,7,78,5509
subtest27of10,pubtest238of100,1,323,5424,9,116,5549
subtest28of10,pubtest238of100,1,323,5424,9,156,5589
subtest23of10,pubtest238of100,1,323,5424,16,189,5629
subtest21of10,pubtest238of100,1,323,5424,18,227,5669
subtest25of10,pubtest238of100,1,323,5424,13,270,5707
subtest26of10,pubtest238of100,1,323,5424,20,306,5750
subtest210of10,pubtest238of100,1,323,5424,19,345,5788
subtest24of10,pubtest238of100,1,323,5424,24,381,5829
subtest21of10,pubtest239of100,1,323,5298,11,40,5349
subtest28of10,pubtest239of100,1,323,5298,53,41,5392
subtest26of10,pubtest239of100,1,323,5298,62,72,5432
subtest27of10,pubtest239of100,1,323,5298,62,112,5472
subtest25of10,pubtest239of100,1,323,5298,68,145,5511
subtest24of10,pubtest239of100,1,323,5298,68,187,5553
subtest29of10,pubtest239of100,1,323,5298,83,211,5592
subtest23of10,pubtest239of100,1,323,5298,102,231,5631
subtest22of10,pubtest239of100,1,323,5298,104,269,5671
subtest210of10,pubtest239of100,1,323,5298,104,309,5711
subtest25of10,pubtest240of100,1,323,5195,5,38,5238
subtest29of10,pubtest240of100,1,323,5195,15,67,5277
subtest21of10,pubtest240of100,1,323,5195,15,107,5317
subtest27of10,pubtest240of100,1,323,5195,16,147,5358
subtest23of10,pubtest240of100,1,323,5195,18,184,5397
subtest210of10,pubtest240of100,1,323,5195,20,222,5437
subtest24of10,pubtest240of100,1,323,5195,22,450,5667
subtest28of10,pubtest240of100,1,323,5195,22,488,5705
subtest22of10,pubtest240of100,1,323,5195,26,524,5745
subtest26of10,pubtest240of100,1,323,5195,26,564,5785
subtest23of10,pubtest241of100,1,323,5192,5,114,5311
subtest24of10,pubtest241of100,1,323,5192,14,106,5312
subtest27of10,pubtest241of100,1,323,5192,14,145,5351
subtest21of10,pubtest241of100,1,323,5192,16,183,5391
subtest210of10,pubtest241of100,1,323,5192,18,219,5429
subtest29of10,pubtest241of100,1,323,5192,20,258,5470
subtest25of10,pubtest241of100,1,323,5192,21,298,5511
subtest28of10,pubtest241of100,1,323,5192,18,337,5547
subtest26of10,pubtest241of100,1,323,5192,23,377,5592
subtest22of10,pubtest241of100,1,323,5192,24,415,5631
subtest27of10,pubtest242of100,1,323,5394,6,39,5439
subtest23of10,pubtest242of100,1,323,5394,11,74,5479
subtest26of10,pubtest242of100,1,323,5394,12,113,5519
subtest25of10,pubtest242of100,1,323,5394,14,152,5560
subtest29of10,pubtest242of100,1,323,5394,14,191,5599
subtest210of10,pubtest242of100,1,323,5394,16,229,5639
subtest21of10,pubtest242of100,1,323,5394,16,269,5679
subtest24of10,pubtest242of100,1,323,5394,20,305,5719
subtest22of10,pubtest242of100,1,323,5394,20,345,5759
subtest28of10,pubtest242of100,1,323,5394,22,383,5799
subtest29of10,pubtest243of100,1,323,5308,6,40,5354
subtest28of10,pubtest243of100,1,323,5308,6,79,5393
subtest23of10,pubtest243of100,1,323,5308,14,112,5434
subtest22of10,pubtest243of100,1,323,5308,15,150,5473
subtest26of10,pubtest243of100,1,323,5308,16,189,5513
subtest25of10,pubtest243of100,1,323,5308,19,226,5553
subtest24of10,pubtest243of100,1,323,5308,20,266,5594
subtest27of10,pubtest243of100,1,323,5308,21,302,5631
subtest210of10,pubtest243of100,1,323,5308,22,341,5671
subtest21of10,pubtest243of100,1,323,5308,24,381,5713
subtest26of10,pubtest244of100,1,323,5254,6,49,5309
subtest27of10,pubtest244of100,1,323,5254,7,87,5348
subtest25of10,pubtest244of100,1,323,5254,8,126,5388
subtest29of10,pubtest244of100,1,323,5254,13,161,5428
subtest21of10,pubtest244of100,1,323,5254,17,197,5468
subtest28of10,pubtest244of100,1,323,5254,17,237,5508
subtest23of10,pubtest244of100,1,323,5254,19,275,5548
subtest210of10,pubtest244of100,1,323,5254,20,314,5588
subtest24of10,pubtest244of100,1,323,5254,19,353,5626
subtest22of10,pubtest244of100,1,323,5254,20,393,5667
subtest26of10,pubtest245of100,1,322,5550,7,46,5603
subtest23of10,pubtest245of100,1,322,5550,8,84,5642
subtest29of10,pubtest245of100,1,322,5550,5,126,5681
subtest24of10,pubtest245of100,1,322,5550,17,156,5723
subtest25of10,pubtest245of100,1,322,5550,17,195,5762
subtest22of10,pubtest245of100,1,322,5550,15,235,5800
subtest21of10,pubtest245of100,1,322,5550,24,268,5842
subtest28of10,pubtest245of100,1,322,5550,25,307,5882
subtest27of10,pubtest245of100,1,322,5550,26,346,5922
subtest210of10,pubtest245of100,1,322,5550,26,386,5962
subtest26of10,pubtest246of100,1,323,5312,17,40,5369
subtest27of10,pubtest246of100,1,323,5312,18,78,5408
subtest21of10,pubtest246of100,1,323,5312,20,115,5447
subtest28of10,pubtest246of100,1,323,5312,20,155,5487
subtest29of10,pubtest246of100,1,323,5312,23,192,5527
subtest23of10,pubtest246of100,1,323,5312,24,231,5567
subtest25of10,pubtest246of100,1,323,5312,26,269,5607
subtest210of10,pubtest246of100,1,323,5312,50,284,5646
subtest24of10,pubtest246of100,1,323,5312,52,323,5687
subtest22of10,pubtest246of100,1,323,5312,53,362,5727
subtest27of10,pubtest247of100,1,323,5348,5,41,5394
subtest23of10,pubtest247of100,1,323,5348,7,79,5434
subtest26of10,pubtest247of100,1,323,5348,11,114,5473
subtest22of10,pubtest247of100,1,323,5348,14,151,5513
subtest29of10,pubtest247of100,1,323,5348,14,191,5553
subtest21of10,pubtest247of100,1,323,5348,12,230,5590
subtest28of10,pubtest247of100,1,323,5348,19,266,5633
subtest25of10,pubtest247of100,1,323,5348,23,302,5673
subtest210of10,pubtest247of100,1,323,5348,25,340,5713
subtest24of10,pubtest247of100,1,323,5348,26,379,5753
subtest29of10,pubtest248of100,1,323,5224,6,48,5278
subtest26of10,pubtest248of100,1,323,5224,7,86,5317
subtest25of10,pubtest248of100,1,323,5224,9,125,5358
subtest28of10,pubtest248of100,1,323,5224,10,162,5396
subtest21of10,pubtest248of100,1,323,5224,11,202,5437
subtest23of10,pubtest248of100,1,323,5224,12,241,5477
subtest27of10,pubtest248of100,1,323,5224,13,280,5517
subtest24of10,pubtest248of100,1,323,5224,16,317,5557
subtest22of10,pubtest248of100,1,323,5224,20,353,5597
subtest210of10,pubtest248of100,1,323,5224,21,392,5637
subtest27of10,pubtest249of100,1,323,5211,7,321,5539
subtest28of10,pubtest249of100,1,323,5211,8,356,5575
subtest25of10,pubtest249of100,1,323,5211,16,389,5616
subtest21of10,pubtest249of100,1,323,5211,17,428,5656
subtest24of10,pubtest249of100,1,323,5211,18,467,5696
subtest29of10,pubtest249of100,1,323,5211,20,505,5736
subtest23of10,pubtest249of100,1,323,5211,21,544,5776
subtest22of10,pubtest249of100,1,323,5211,22,581,5814
subtest26of10,pubtest249of100,1,323,5211,24,621,5856
subtest210of10,pubtest249of100,1,323,5211,26,659,5896
subtest27of10,pubtest250of100,1,323,5267,1,40,5308
subtest28of10,pubtest250of100,1,323,5267,1,77,5345
subtest23of10,pubtest250of100,1,323,5267,3,116,5386
subtest24of10,pubtest250of100,1,323,5267,3,156,5426
subtest29of10,pubtest250of100,1,323,5267,6,192,5465
subtest21of10,pubtest250of100,1,323,5267,8,231,5506
subtest25of10,pubtest250of100,1,323,5267,9,271,5547
subtest210of10,pubtest250of100,1,323,5267,14,305,5586
subtest26of10,pubtest250of100,1,323,5267,21,338,5626
subtest22of10,pubtest250of100,1,323,5267,22,379,5668
subtest22of10,pubtest251of100,1,323,5366,4,38,5408
subtest23of10,pubtest251of100,1,323,5366,4,77,5447
subtest27of10,pubtest251of100,1,323,5366,8,113,5487
subtest24of10,pubtest251of100,1,323,5366,7,153,5526
subtest28of10,pubtest251of100,1,323,5366,9,193,5568
subtest210of10,pubtest251of100,1,323,5366,10,231,5607
subtest25of10,pubtest251of100,1,323,5366,11,270,5647
subtest26of10,pubtest251of100,1,323,5366,15,306,5687
subtest29of10,pubtest251of100,1,323,5366,15,346,5727
subtest21of10,pubtest251of100,1,323,5366,15,386,5767
subtest29of10,pubtest252of100,1,323,5206,8,38,5252
subtest21of10,pubtest252of100,1,323,5206,10,75,5291
subtest28of10,pubtest252of100,1,323,5206,10,114,5330
subtest27of10,pubtest252of100,1,323,5206,11,154,5371
subtest25of10,pubtest252of100,1,323,5206,16,188,5410
subtest26of10,pubtest252of100,1,323,5206,16,228,5450
subtest22of10,pubtest252of100,1,323,5206,19,265,5490
subtest23of10,pubtest252of100,1,323,5206,18,304,5528
subtest210of10,pubtest252of100,1,323,5206,22,343,5571
subtest24of10,pubtest252of100,1,323,5206,21,382,5609
subtest23of10,pubtest253of100,1,322,5269,3,40,5312
subtest28of10,pubtest253of100,1,322,5269,4,79,5352
subtest29of10,pubtest253of100,1,322,5269,8,114,5391
subtest24of10,pubtest253of100,1,322,5269,6,154,5429
subtest25of10,pubtest253of100,1,322,5269,5,197,5471
subtest27of10,pubtest253of100,1,322,5269,9,232,5510
subtest21of10,pubtest253of100,1,322,5269,10,272,5551
subtest22of10,pubtest253of100,1,322,5269,12,310,5591
subtest210of10,pubtest253of100,1,322,5269,13,349,5631
subtest26of10,pubtest253of100,1,322,5269,13,389,5671
subtest210of10,pubtest254of100,1,323,5351,3,43,5397
subtest21of10,pubtest254of100,1,323,5351,4,80,5435
subtest25of10,pubtest254of100,1,323,5351,5,120,5476
subtest28of10,pubtest254of100,1,323,5351,6,160,5517
subtest23of10,pubtest254of100,1,323,5351,7,197,5555
subtest29of10,pubtest254of100,1,323,5351,7,237,5595
subtest27of10,pubtest254of100,1,323,5351,3,276,5630
subtest22of10,pubtest254of100,1,323,5351,8,315,5674
subtest24of10,pubtest254of100,1,323,5351,8,355,5714
subtest26of10,pubtest254of100,1,323,5351,39,365,5755
subtest22of10,pubtest255of100,1,322,5312,3,39,5354
subtest27of10,pubtest255of100,1,322,5312,5,77,5394
subtest23of10,pubtest255of100,1,322,5312,5,116,5433
subtest21of10,pubtest255of100,1,322,5312,7,153,5472
subtest29of10,pubtest255of100,1,322,5312,7,193,5512
subtest28of10,pubtest255of100,1,322,5312,9,232,5553
subtest25of10,pubtest255of100,1,322,5312,16,265,5593
subtest24of10,pubtest255of100,1,322,5312,19,302,5633
subtest210of10,pubtest255of100,1,322,5312,20,341,5673
subtest26of10,pubtest255of100,1,322,5312,24,378,5714
subtest29of10,pubtest256of100,1,323,5296,5,39,5340
subtest21of10,pubtest256of100,1,323,5296,23,61,5380
subtest26of10,pubtest256of100,1,323,5296,24,98,5418
subtest23of10,pubtest256of100,1,323,5296,26,137,5459
subtest210of10,pubtest256of100,1,323,5296,28,177,5501
subtest25of10,pubtest256of100,1,323,5296,27,216,5539
subtest28of10,pubtest256of100,1,323,5296,29,254,5579
subtest27of10,pubtest256of100,1,323,5296,29,294,5619
subtest22of10,pubtest256of100,1,323,5296,54,309,5659
subtest24of10,pubtest256of100,1,323,5296,55,349,5700
subtest24of10,pubtest257of100,1,323,5144,4,41,5189
subtest21of10,pubtest257of100,1,323,5144,6,78,5228
subtest27of10,pubtest257of100,1,323,5144,7,116,5267
subtest28of10,pubtest257of100,1,323,5144,14,149,5307
subtest23of10,pubtest257of100,1,323,5144,15,189,5348
subtest29of10,pubtest257of100,1,323,5144,16,227,5387
subtest25of10,pubtest257of100,1,323,5144,17,266,5427
subtest22of10,pubtest257of100,1,323,5144,16,305,5465
subtest210of10,pubtest257of100,1,323,5144,23,340,5507
subtest26of10,pubtest257of100,1,323,5144,24,379,5547
subtest28of10,pubtest258of100,1,323,5363,5,49,5417
subtest23of10,pubtest258of100,1,323,5363,6,88,5457
subtest25of10,pubtest258of100,1,323,5363,11,122,5496
subtest26of10,pubtest258of100,1,323,5363,13,162,5538
subtest21of10,pubtest258of100,1,323,5363,14,199,5576
subtest210of10,pubtest258of100,1,323,5363,17,234,5614
subtest29of10,pubtest258of100,1,323,5363,18,273,5654
subtest27of10,pubtest258of100,1,323,5363,20,312,5695
subtest22of10,pubtest258of100,1,323,5363,21,352,5736
subtest24of10,pubtest258of100,1,323,5363,23,391,5777
subtest21of10,pubtest259of100,1,323,5174,5,39,5218
subtest25of10,pubtest259of100,1,323,5174,7,76,5257
subtest28of10,pubtest259of100,1,323,5174,7,116,5297
subtest24of10,pubtest259of100,1,323,5174,16,148,5338
subtest27of10,pubtest259of100,1,323,5174,19,184,5377
subtest29of10,pubtest259of100,1,323,5174,21,222,5417
subtest23of10,pubtest259of100,1,323,5174,20,264,5458
subtest22of10,pubtest259of100,1,323,5174,23,302,5499
subtest26of10,pubtest259of100,1,323,5174,22,341,5537
subtest210of10,pubtest259of100,1,323,5174,24,379,5577
subtest210of10,pubtest260of100,1,323,5729,5,50,5784
subtest23of10,pubtest260of100,1,323,5729,6,88,5823
subtest27of10,pubtest260of100,1,323,5729,8,126,5863
subtest21of10,pubtest260of100,1,323,5729,9,165,5903
subtest26of10,pubtest260of100,1,323,5729,11,204,5944
subtest29of10,pubtest260of100,1,323,5729,12,242,5983
subtest22of10,pubtest260of100,1,323,5729,13,281,6023
subtest25of10,pubtest260of100,1,323,5729,17,317,6063
subtest28of10,pubtest260of100,1,323,5729,30,344,6103
subtest24of10,pubtest260of100,1,323,5729,30,382,6141
subtest25of10,pubtest261of100,1,323,5211,7,41,5259
subtest28of10,pubtest261of100,1,323,5211,8,79,5298
subtest29of10,pubtest261of100,1,323,5211,10,117,5338
subtest210of10,pubtest261of100,1,323,5211,12,155,5378
subtest23of10,pubtest261of100,1,323,5211,12,195,5418
subtest22of10,pubtest261of100,1,323,5211,13,234,5458
subtest24of10,pubtest261of100,1,323,5211,18,268,5497
subtest27of10,pubtest261of100,1,323,5211,18,308,5537
subtest21of10,pubtest261of100,1,323,5211,22,345,5578
subtest26of10,pubtest261of100,1,323,5211,23,384,5618
subtest21of10,pubtest262of100,1,323,5219,42,40,5301
subtest22of10,pubtest262of100,1,323,5219,43,79,5341
subtest23of10,pubtest262of100,1,323,5219,44,116,5379
subtest27of10,pubtest262of100,1,323,5219,49,154,5422
subtest26of10,pubtest262of100,1,323,5219,50,192,5461
subtest29of10,pubtest262of100,1,323,5219,53,229,5501
subtest25of10,pubtest262of100,1,323,5219,53,271,5543
subtest210of10,pubtest262of100,1,323,5219,55,308,5582
subtest24of10,pubtest262of100,1,323,5219,58,344,5621
subtest28of10,pubtest262of100,1,323,5219,58,384,5661
subtest22of10,pubtest263of100,1,322,5235,4,40,5279
subtest29of10,pubtest263of100,1,322,5235,7,75,5317
subtest24of10,pubtest263of100,1,322,5235,8,115,5358
subtest23of10,pubtest263of100,1,322,5235,12,150,5397
subtest26of10,pubtest263of100,1,322,5235,13,190,5438
subtest210of10,pubtest263of100,1,322,5235,15,227,5477
subtest25of10,pubtest263of100,1,322,5235,18,263,5516
subtest27of10,pubtest263of100,1,322,5235,19,303,5557
subtest21of10,pubtest263of100,1,322,5235,20,340,5595
subtest28of10,pubtest263of100,1,322,5235,20,380,5635
subtest22of10,pubtest264of100,1,322,5195,6,39,5240
subtest29of10,pubtest264of100,1,322,5195,9,76,5280
subtest23of10,pubtest264of100,1,322,5195,10,114,5319
subtest24of10,pubtest264of100,1,322,5195,10,154,5359
subtest27of10,pubtest264of100,1,322,5195,15,189,5399
subtest21of10,pubtest264of100,1,322,5195,17,226,5438
subtest28of10,pubtest264of100,1,322,5195,17,266,5478
subtest25of10,pubtest264of100,1,322,5195,20,304,5519
subtest26of10,pubtest264of100,1,322,5195,27,337,5559
subtest210of10,pubtest264of100,1,322,5195,27,378,5600
subtest26of10,pubtest265of100,1,323,5192,11,329,5532
subtest22of10,pubtest265of100,1,323,5192,34,345,5571
subtest21of10,pubtest265of100,1,323,5192,32,385,5609
subtest28of10,pubtest265of100,1,323,5192,36,423,5651
subtest25of10,pubtest265of100,1,323,5192,36,463,5691
subtest23of10,pubtest265of100,1,323,5192,37,502,5731
subtest24of10,pubtest265of100,1,323,5192,38,541,5771
subtest27of10,pubtest265of100,1,323,5192,31,582,5805
subtest210of10,pubtest265of100,1,323,5192,39,620,5851
subtest29of10,pubtest265of100,1,323,5192,39,660,5891
subtest29of10,pubtest266of100,1,321,5167,5,239,5411
subtest210of10,pubtest266of100,1,321,5167,6,274,5447
subtest25of10,pubtest266of100,1,321,5167,8,313,5488
subtest27of10,pubtest266of100,1,321,5167,15,346,5528
subtest23of10,pubtest266of100,1,321,5167,17,384,5568
subtest26of10,pubtest266of100,1,321,5167,16,424,5607
subtest21of10,pubtest266of100,1,321,5167,18,464,5649
subtest28of10,pubtest266of100,1,321,5167,19,502,5688
subtest22of10,pubtest266of100,1,321,5167,20,539,5726
subtest24of10,pubtest266of100,1,321,5167,20,579,5766
subtest23of10,pubtest267of100,1,323,5393,6,38,5437
subtest26of10,pubtest267of100,1,323,5393,13,70,5476
subtest28of10,pubtest267of100,1,323,5393,18,106,5517
subtest25of10,pubtest267of100,1,323,5393,17,147,5557
subtest21of10,pubtest267of100,1,323,5393,21,182,5596
subtest24of10,pubtest267of100,1,323,5393,21,223,5637
subtest29of10,pubtest267of100,1,323,5393,19,261,5673
subtest27of10,pubtest267of100,1,323,5393,17,300,5710
subtest210of10,pubtest267of100,1,323,5393,23,340,5756
subtest22of10,pubtest267of100,1,323,5393,25,378,5796
subtest23of10,pubtest268of100,1,323,5341,10,41,5392
subtest25of10,pubtest268of100,1,323,5341,11,79,5431
subtest29of10,pubtest268of100,1,323,5341,15,115,5471
subtest21of10,pubtest268of100,1,323,5341,43,127,5511
subtest27of10,pubtest268of100,1,323,5341,42,167,5550
subtest24of10,pubtest268of100,1,323,5341,44,206,5591
subtest28of10,pubtest268of100,1,323,5341,45,245,5631
subtest22of10,pubtest268of100,1,323,5341,47,283,5671
subtest210of10,pubtest268of100,1,323,5341,48,322,5711
subtest26of10,pubtest268of100,1,323,5341,48,364,5753
subtest24of10,pubtest269of100,1,323,5276,7,40,5323
subtest27of10,pubtest269of100,1,323,5276,10,76,5362
subtest210of10,pubtest269of100,1,323,5276,10,116,5402
subtest26of10,pubtest269of100,1,323,5276,14,152,5442
subtest25of10,pubtest269of100,1,323,5276,16,190,5482
subtest21of10,pubtest269of100,1,323,5276,18,228,5522
subtest22of10,pubtest269of100,1,323,5276,19,267,5562
subtest29of10,pubtest269of100,1,323,5276,20,307,5603
subtest23of10,pubtest269of100,1,323,5276,23,342,5641
subtest28of10,pubtest269of100,1,323,5276,23,382,5681
subtest23of10,pubtest270of100,1,323,5235,5,42,5282
subtest26of10,pubtest270of100,1,323,5235,12,73,5320
subtest27of10,pubtest270of100,1,323,5235,12,113,5360
subtest210of10,pubtest270of100,1,323,5235,14,151,5400
subtest29of10,pubtest270of100,1,323,5235,15,189,5439
subtest28of10,pubtest270of100,1,323,5235,27,218,5480
subtest21of10,pubtest270of100,1,323,5235,27,258,5520
subtest25of10,pubtest270of100,1,323,5235,27,297,5559
subtest22of10,pubtest270of100,1,323,5235,29,336,5600
subtest24of10,pubtest270of100,1,323,5235,30,376,5641
subtest24of10,pubtest271of100,1,323,5224,5,45,5274
subtest25of10,pubtest271of100,1,323,5224,6,81,5311
subtest27of10,pubtest271of100,1,323,5224,14,113,5351
subtest22of10,pubtest271of100,1,323,5224,14,153,5391
subtest21of10,pubtest271of100,1,323,5224,20,189,5433
subtest210of10,pubtest271of100,1,323,5224,21,227,5472
subtest23of10,pubtest271of100,1,323,5224,41,247,5512
subtest28of10,pubtest271of100,1,323,5224,42,288,5554
subtest29of10,pubtest271of100,1,323,5224,42,327,5593
subtest26of10,pubtest271of100,1,323,5224,41,365,5630
subtest25of10,pubtest272of100,1,323,5274,4,40,5318
subtest26of10,pubtest272of100,1,323,5274,7,76,5357
subtest21of10,pubtest272of100,1,323,5274,9,114,5397
subtest29of10,pubtest272of100,1,323,5274,9,154,5437
subtest24of10,pubtest272of100,1,323,5274,14,189,5477
subtest23of10,pubtest272of100,1,323,5274,15,229,5518
subtest27of10,pubtest272of100,1,323,5274,15,268,5557
subtest210of10,pubtest272of100,1,323,5274,17,306,5597
subtest22of10,pubtest272of100,1,323,5274,21,342,5637
subtest28of10,pubtest272of100,1,323,5274,22,380,5676
subtest22of10,pubtest273of100,1,321,5280,13,39,5332
subtest29of10,pubtest273of100,1,321,5280,14,78,5372
subtest28of10,pubtest273of100,1,321,5280,62,69,5411
subtest21of10,pubtest273of100,1,321,5280,66,105,5451
subtest25of10,pubtest273of100,1,321,5280,62,145,5487
subtest26of10,pubtest273of100,1,321,5280,61,184,5525
subtest24of10,pubtest273of100,1,321,5280,66,224,5570
subtest27of10,pubtest273of100,1,321,5280,68,263,5611
subtest210of10,pubtest273of100,1,321,5280,65,302,5647
subtest23of10,pubtest273of100,1,321,5280,65,342,5687
subtest26of10,pubtest274of100,1,323,5222,5,41,5268
subtest21of10,pubtest274of100,1,323,5222,5,79,5306
subtest23of10,pubtest274of100,1,323,5222,7,119,5348
subtest22of10,pubtest274of100,1,323,5222,10,156,5388
subtest29of10,pubtest274of100,1,323,5222,15,191,5428
subtest28of10,pubtest274of100,1,323,5222,16,230,5468
subtest25of10,pubtest274of100,1,323,5222,17,498,5737
subtest27of10,pubtest274of100,1,323,5222,18,497,5737
subtest24of10,pubtest274of100,1,323,5222,18,497,5737
subtest210of10,pubtest274of100,1,323,5222,22,493,5737
subtest24of10,pubtest275of100,1,323,5266,7,290,5563
subtest27of10,pubtest275of100,1,323,5266,6,292,5564
subtest29of10,pubtest275of100,1,323,5266,7,330,5603
subtest25of10,pubtest275of100,1,323,5266,9,368,5643
subtest22of10,pubtest275of100,1,323,5266,9,408,5683
subtest210of10,pubtest275of100,1,323,5266,18,439,5723
subtest26of10,pubtest275of100,1,323,5266,22,473,5761
subtest21of10,pubtest275of100,1,323,5266,22,513,5801
subtest28of10,pubtest275of100,1,323,5266,25,551,5842
subtest23of10,pubtest275of100,1,323,5266,25,591,5882
subtest28of10,pubtest276of100,1,323,5216,4,42,5262
subtest21of10,pubtest276of100,1,323,5216,6,80,5302
subtest25of10,pubtest276of100,1,323,5216,6,119,5341
subtest24of10,pubtest276of100,1,323,5216,8,155,5379
subtest27of10,pubtest276of100,1,323,5216,8,195,5419
subtest29of10,pubtest276of100,1,323,5216,12,233,5461
subtest23of10,pubtest276of100,1,323,5216,12,273,5501
subtest26of10,pubtest276of100,1,323,5216,15,310,5541
subtest22of10,pubtest276of100,1,323,5216,26,339,5581
subtest210of10,pubtest276of100,1,323,5216,26,379,5621
subtest22of10,pubtest277of100,1,323,5288,5,283,5576
subtest29of10,pubtest277of100,1,323,5288,8,318,5614
subtest28of10,pubtest277of100,1,323,5288,9,357,5654
subtest27of10,pubtest277of100,1,323,5288,15,391,5694
subtest21of10,pubtest277of100,1,323,5288,14,432,5734
subtest24of10,pubtest277of100,1,323,5288,14,470,5772
subtest25of10,pubtest277of100,1,323,5288,24,502,5814
subtest23of10,pubtest277of100,1,323,5288,25,541,5854
subtest210of10,pubtest277of100,1,323,5288,45,561,5894
subtest26of10,pubtest277of100,1,323,5288,45,601,5934
subtest22of10,pubtest278of100,1,323,5175,7,40,5222
subtest29of10,pubtest278of100,1,323,5175,7,79,5261
subtest23of10,pubtest278of100,1,323,5175,10,116,5301
subtest28of10,pubtest278of100,1,323,5175,11,155,5341
subtest21of10,pubtest278of100,1,323,5175,17,190,5382
subtest27of10,pubtest278of100,1,323,5175,21,225,5421
subtest25of10,pubtest278of100,1,323,5175,21,265,5461
subtest26of10,pubtest278of100,1,323,5175,24,300,5499
subtest210of10,pubtest278of100,1,323,5175,27,340,5542
subtest24of10,pubtest278of100,1,323,5175,28,378,5581
subtest25of10,pubtest279of100,1,323,5582,6,45,5633
subtest21of10,pubtest279of100,1,323,5582,8,83,5673
subtest29of10,pubtest279of100,1,323,5582,16,115,5713
subtest27of10,pubtest279of100,1,323,5582,17,154,5753
subtest23of10,pubtest279of100,1,323,5582,18,191,5791
subtest24of10,pubtest279of100,1,323,5582,24,227,5833
subtest28of10,pubtest279of100,1,323,5582,24,266,5872
subtest26of10,pubtest279of100,1,323,5582,26,305,5913
subtest22of10,pubtest279of100,1,323,5582,26,345,5953
subtest210of10,pubtest279of100,1,323,5582,26,383,5991
subtest27of10,pubtest280of100,1,323,5263,7,41,5311
subtest29of10,pubtest280of100,1,323,5263,9,78,5350
subtest24of10,pubtest280of100,1,323,5263,10,118,5391
subtest26of10,pubtest280of100,1,323,5263,35,132,5430
subtest21of10,pubtest280of100,1,323,5263,39,168,5470
subtest23of10,pubtest280of100,1,323,5263,40,207,5510
subtest28of10,pubtest280of100,1,323,5263,41,246,5550
subtest22of10,pubtest280of100,1,323,5263,42,286,5591
subtest25of10,pubtest280of100,1,323,5263,43,324,5630
subtest210of10,pubtest280of100,1,323,5263,43,364,5670
subtest24of10,pubtest281of100,1,323,5258,5,40,5303
subtest23of10,pubtest281of100,1,323,5258,8,76,5342
subtest27of10,pubtest281of100,1,323,5258,10,114,5382
subtest28of10,pubtest281of100,1,323,5258,12,152,5422
subtest22of10,pubtest281of100,1,323,5258,12,192,5462
subtest25of10,pubtest281of100,1,323,5258,13,231,5502
subtest21of10,pubtest281of100,1,323,5258,18,266,5542
subtest26of10,pubtest281of100,1,323,5258,23,300,5581
subtest29of10,pubtest281of100,1,323,5258,24,340,5622
subtest210of10,pubtest281of100,1,323,5258,23,379,5660
subtest24of10,pubtest282of100,1,323,5286,5,42,5333
subtest23of10,pubtest282of100,1,323,5286,7,79,5372
subtest21of10,pubtest282of100,1,323,5286,13,113,5412
subtest25of10,pubtest282of100,1,323,5286,20,146,5452
subtest29of10,pubtest282of100,1,323,5286,21,185,5492
subtest27of10,pubtest282of100,1,323,5286,22,224,5532
subtest28of10,pubtest282of100,1,323,5286,23,263,5572
subtest22of10,pubtest282of100,1,323,5286,23,303,5612
subtest210of10,pubtest282of100,1,323,5286,24,344,5654
subtest26of10,pubtest282of100,1,323,5286,25,383,5694
subtest24of10,pubtest283of100,1,323,5316,9,38,5363
subtest27of10,pubtest283of100,1,323,5316,9,77,5402
subtest23of10,pubtest283of100,1,323,5316,12,114,5442
subtest22of10,pubtest283of100,1,323,5316,12,158,5486
subtest25of10,pubtest283of100,1,323,5316,17,192,5525
subtest28of10,pubtest283of100,1,323,5316,18,232,5566
subtest210of10,pubtest283of100,1,323,5316,20,270,5606
subtest29of10,pubtest283of100,1,323,5316,20,310,5646
subtest21of10,pubtest283of100,1,323,5316,21,349,5686
subtest26of10,pubtest283of100,1,323,5316,25,385,5726
subtest25of10,pubtest284of100,1,323,5169,6,40,5215
subtest22of10,pubtest284of100,1,323,5169,30,55,5254
subtest29of10,pubtest284of100,1,323,5169,30,95,5294
subtest210of10,pubtest284of100,1,323,5169,32,133,5334
subtest27of10,pubtest284of100,1,323,5169,33,172,5374
subtest24of10,pubtest284of100,1,323,5169,36,209,5414
subtest28of10,pubtest284of100,1,323,5169,37,248,5454
subtest23of10,pubtest284of100,1,323,5169,36,288,5493
subtest21of10,pubtest284of100,1,323,5169,39,326,5534
subtest26of10,pubtest284of100,1,323,5169,40,365,5574
subtest25of10,pubtest285of100,1,323,5259,8,39,5306
subtest27of10,pubtest285of100,1,323,5259,8,78,5345
subtest23of10,pubtest285of100,1,323,5259,6,117,5382
subtest24of10,pubtest285of100,1,323,5259,10,156,5425
subtest22of10,pubtest285of100,1,323,5259,14,193,5466
subtest21of10,pubtest285of100,1,323,5259,17,229,5505
subtest28of10,pubtest285of100,1,323,5259,21,265,5545
subtest29of10,pubtest285of100,1,323,5259,22,304,5585
subtest26of10,pubtest285of100,1,323,5259,25,341,5625
subtest210of10,pubtest285of100,1,323,5259,25,381,5665
subtest23of10,pubtest286of100,1,323,5210,4,40,5254
subtest210of10,pubtest286of100,1,323,5210,8,75,5293
subtest25of10,pubtest286of100,1,323,5210,10,113,5333
subtest29of10,pubtest286of100,1,323,5210,10,153,5373
subtest21of10,pubtest286of100,1,323,5210,11,192,5413
subtest24of10,pubtest286of100,1,323,5210,11,232,5453
subtest26of10,pubtest286of100,1,323,5210,15,267,5492
subtest27of10,pubtest286of100,1,323,5210,14,309,5533
subtest28of10,pubtest286of100,1,323,5210,18,345,5573
subtest22of10,pubtest286of100,1,323,5210,18,385,5613
subtest26of10,pubtest287of100,1,323,5279,5,39,5323
subtest29of10,pubtest287of100,1,323,5279,8,76,5363
subtest28of10,pubtest287of100,1,323,5279,10,112,5401
subtest27of10,pubtest287of100,1,323,5279,10,152,5441
subtest21of10,pubtest287of100,1,323,5279,16,188,5483
subtest25of10,pubtest287of100,1,323,5279,15,228,5522
subtest24of10,pubtest287of100,1,323,5279,15,267,5561
subtest210of10,pubtest287of100,1,323,5279,15,306,5600
subtest22of10,pubtest287of100,1,323,5279,19,346,5644
subtest23of10,pubtest287of100,1,323,5279,19,385,5683
subtest29of10,pubtest288of100,1,323,5295,5,41,5341
subtest26of10,pubtest288of100,1,323,5295,7,78,5380
subtest25of10,pubtest288of100,1,323,5295,8,117,5420
subtest27of10,pubtest288of100,1,323,5295,17,148,5460
subtest21of10,pubtest288of100,1,323,5295,25,180,5500
subtest22of10,pubtest288of100,1,323,5295,25,220,5540
subtest23of10,pubtest288of100,1,323,5295,26,259,5580
subtest24of10,pubtest288of100,1,323,5295,27,298,5620
subtest210of10,pubtest288of100,1,323,5295,28,337,5660
subtest28of10,pubtest288of100,1,323,5295,28,377,5700
subtest210of10,pubtest289of100,1,323,5198,7,41,5246
subtest29of10,pubtest289of100,1,323,5198,14,73,5285
subtest26of10,pubtest289of100,1,323,5198,16,111,5325
subtest24of10,pubtest289of100,1,323,5198,16,151,5365
subtest27of10,pubtest289of100,1,323,5198,18,188,5404
subtest28of10,pubtest289of100,1,323,5198,18,228,5444
subtest25of10,pubtest289of100,1,323,5198,18,266,5482
subtest23of10,pubtest289of100,1,323,5198,16,305,5519
subtest21of10,pubtest289of100,1,323,5198,23,344,5565
subtest22of10,pubtest289of100,1,323,5198,26,382,5606
subtest22of10,pubtest290of100,1,323,5265,10,41,5316
subtest25of10,pubtest290of100,1,323,5265,12,79,5356
subtest29of10,pubtest290of100,1,323,5265,9,123,5397
subtest23of10,pubtest290of100,1,323,5265,9,158,5432
subtest26of10,pubtest290of100,1,323,5265,14,197,5476
subtest27of10,pubtest290of100,1,323,5265,17,235,5517
subtest210of10,pubtest290of100,1,323,5265,19,272,5556
subtest21of10,pubtest290of100,1,323,5265,20,311,5596
subtest28of10,pubtest290of100,1,323,5265,22,351,5638
subtest24of10,pubtest290of100,1,323,5265,22,389,5676
subtest23of10,pubtest291of100,1,323,5320,5,54,5379
subtest24of10,pubtest291of100,1,323,5320,6,91,5417
subtest27of10,pubtest291of100,1,323,5320,7,130,5457
subtest28of10,pubtest291of100,1,323,5320,9,168,5497
subtest21of10,pubtest291of100,1,323,5320,13,204,5537
subtest210of10,pubtest291of100,1,323,5320,16,241,5577
subtest25of10,pubtest291of100,1,323,5320,16,282,5618
subtest29of10,pubtest291of100,1,323,5320,18,318,5656
subtest22of10,pubtest291of100,1,323,5320,20,357,5697
subtest26of10,pubtest291of100,1,323,5320,21,396,5737
subtest28of10,pubtest292of100,1,323,5224,5,49,5278
subtest21of10,pubtest292of100,1,323,5224,7,86,5317
subtest29of10,pubtest292of100,1,323,5224,6,125,5355
subtest27of10,pubtest292of100,1,323,5224,15,157,5396
subtest25of10,pubtest292of100,1,323,5224,15,196,5435
subtest26of10,pubtest292of100,1,323,5224,15,235,5474
subtest22of10,pubtest292of100,1,323,5224,19,274,5517
subtest24of10,pubtest292of100,1,323,5224,19,315,5558
subtest23of10,pubtest292of100,1,323,5224,21,352,5597
subtest210of10,pubtest292of100,1,323,5224,23,395,5642
subtest25of10,pubtest293of100,1,323,5315,8,40,5363
subtest28of10,pubtest293of100,1,323,5315,9,78,5402
subtest24of10,pubtest293of100,1,323,5315,6,120,5441
subtest23of10,pubtest293of100,1,323,5315,14,153,5482
subtest210of10,pubtest293of100,1,323,5315,18,189,5522
subtest27of10,pubtest293of100,1,323,5315,19,230,5564
subtest21of10,pubtest293of100,1,323,5315,25,262,5602
subtest26of10,pubtest293of100,1,323,5315,25,302,5642
subtest29of10,pubtest293of100,1,323,5315,27,340,5682
subtest22of10,pubtest293of100,1,323,5315,27,380,5722
subtest21of10,pubtest294of100,1,323,5343,4,40,5387
subtest25of10,pubtest294of100,1,323,5343,5,77,5425
subtest210of10,pubtest294of100,1,323,5343,7,116,5466
subtest29of10,pubtest294of100,1,323,5343,8,156,5507
subtest27of10,pubtest294of100,1,323,5343,13,190,5546
subtest23of10,pubtest294of100,1,323,5343,13,228,5584
subtest26of10,pubtest294of100,1,323,5343,12,268,5623
subtest24of10,pubtest294of100,1,323,5343,17,306,5666
subtest22of10,pubtest294of100,1,323,5343,20,343,5706
subtest28of10,pubtest294of100,1,323,5343,20,382,5745
subtest25of10,pubtest295of100,1,323,5274,8,50,5332
subtest24of10,pubtest295of100,1,323,5274,8,89,5371
subtest27of10,pubtest295of100,1,323,5274,10,127,5411
subtest210of10,pubtest295of100,1,323,5274,13,164,5451
subtest29of10,pubtest295of100,1,323,5274,15,202,5491
subtest28of10,pubtest295of100,1,323,5274,16,241,5531
subtest26of10,pubtest295of100,1,323,5274,17,280,5571
subtest21of10,pubtest295of100,1,323,5274,17,320,5611
subtest22of10,pubtest295of100,1,323,5274,14,358,5646
subtest23of10,pubtest295of100,1,323,5274,20,397,5691
subtest25of10,pubtest296of100,1,322,5206,7,42,5255
subtest24of10,pubtest296of100,1,322,5206,8,81,5295
subtest27of10,pubtest296of100,1,322,5206,9,119,5334
subtest26of10,pubtest296of100,1,322,5206,13,156,5375
subtest23of10,pubtest296of100,1,322,5206,14,194,5414
subtest29of10,pubtest296of100,1,322,5206,18,230,5454
subtest210of10,pubtest296of100,1,322,5206,22,266,5494
subtest28of10,pubtest296of100,1,322,5206,22,305,5533
subtest21of10,pubtest296of100,1,322,5206,21,345,5572
subtest22of10,pubtest296of100,1,322,5206,29,379,5614
subtest25of10,pubtest297of100,1,323,5226,13,42,5281
subtest29of10,pubtest297of100,1,323,5226,19,75,5320
subtest210of10,pubtest297of100,1,323,5226,20,114,5360
subtest23of10,pubtest297of100,1,323,5226,21,153,5400
subtest22of10,pubtest297of100,1,323,5226,21,193,5440
subtest26of10,pubtest297of100,1,323,5226,26,227,5479
subtest28of10,pubtest297of100,1,323,5226,26,267,5519
subtest21of10,pubtest297of100,1,323,5226,26,306,5558
subtest24of10,pubtest297of100,1,323,5226,28,345,5599
subtest27of10,pubtest297of100,1,323,5226,24,385,5635
subtest22of10,pubtest298of100,1,323,5378,4,42,5424
subtest23of10,pubtest298of100,1,323,5378,7,81,5466
subtest25of10,pubtest298of100,1,323,5378,7,120,5505
subtest29of10,pubtest298of100,1,323,5378,5,161,5544
subtest24of10,pubtest298of100,1,323,5378,16,192,5586
subtest21of10,pubtest298of100,1,323,5378,18,230,5626
subtest27of10,pubtest298of100,1,323,5378,19,269,5666
subtest210of10,pubtest298of100,1,323,5378,21,307,5706
subtest28of10,pubtest298of100,1,323,5378,21,347,5746
subtest26of10,pubtest298of100,1,323,5378,23,385,5786
subtest22of10,pubtest299of100,1,323,5289,5,41,5335
subtest29of10,pubtest299of100,1,323,5289,13,72,5374
subtest210of10,pubtest299of100,1,323,5289,14,111,5414
subtest24of10,pubtest299of100,1,323,5289,15,150,5454
subtest27of10,pubtest299of100,1,323,5289,16,189,5494
subtest23of10,pubtest299of100,1,323,5289,20,225,5534
subtest28of10,pubtest299of100,1,323,5289,21,264,5574
subtest25of10,pubtest299of100,1,323,5289,24,301,5614
subtest21of10,pubtest299of100,1,323,5289,24,341,5654
subtest26of10,pubtest299of100,1,323,5289,25,379,5693
subtest21of10,pubtest2100of100,1,325,5260,7,48,5315
subtest24of10,pubtest2100of100,1,325,5260,7,88,5355
subtest29of10,pubtest2100of100,1,325,5260,9,126,5395
subtest22of10,pubtest2100of100,1,325,5260,14,160,5434
subtest28of10,pubtest2100of100,1,325,5260,16,198,5474
subtest23of10,pubtest2100of100,1,325,5260,17,237,5514
subtest27of10,pubtest2100of100,1,325,5260,11,276,5547
subtest25of10,pubtest2100of100,1,325,5260,18,316,5594
subtest210of10,pubtest2100of100,1,325,5260,47,329,5636
subtest26of10,pubtest2100of100,1,325,5260,69,346,5675
subtest27of10,pubtest21of100,1,322,10332,5,42,10379
subtest26of10,pubtest21of100,1,322,10332,6,80,10418
subtest24of10,pubtest21of100,1,322,10332,8,118,10458
subtest29of10,pubtest21of100,1,322,10332,9,157,10498
subtest25of10,pubtest21of100,1,322,10332,10,196,10538
subtest21of10,pubtest21of100,1,322,10332,15,231,10578
subtest210of10,pubtest21of100,1,322,10332,16,270,10618
subtest23of10,pubtest21of100,1,322,10332,23,303,10658
subtest28of10,pubtest21of100,1,322,10332,23,343,10698
subtest22of10,pubtest21of100,1,322,10332,24,380,10736
subtest29of10,pubtest22of100,1,321,5178,8,41,5227
subtest27of10,pubtest22of100,1,321,5178,16,72,5266
subtest24of10,pubtest22of100,1,321,5178,17,111,5306
subtest23of10,pubtest22of100,1,321,5178,18,150,5346
subtest28of10,pubtest22of100,1,321,5178,18,190,5386
subtest25of10,pubtest22of100,1,321,5178,24,223,5425
subtest21of10,pubtest22of100,1,321,5178,31,257,5466
subtest26of10,pubtest22of100,1,321,5178,31,297,5506
subtest210of10,pubtest22of100,1,321,5178,32,336,5546
subtest22of10,pubtest22of100,1,321,5178,33,376,5587
subtest28of10,pubtest23of100,1,321,5380,16,41,5437
subtest26of10,pubtest23of100,1,321,5380,19,76,5475
subtest24of10,pubtest23of100,1,321,5380,20,115,5515
subtest25of10,pubtest23of100,1,321,5380,21,154,5555
subtest29of10,pubtest23of100,1,321,5380,22,194,5596
subtest23of10,pubtest23of100,1,321,5380,16,233,5629
subtest27of10,pubtest23of100,1,321,5380,21,274,5675
subtest21of10,pubtest23of100,1,321,5380,24,311,5715
subtest22of10,pubtest23of100,1,321,5380,24,351,5755
subtest210of10,pubtest23of100,1,321,5380,30,386,5796
subtest23of10,pubtest24of100,1,321,5211,38,44,5293
subtest24of10,pubtest24of100,1,321,5211,58,64,5333
subtest25of10,pubtest24of100,1,321,5211,59,102,5372
subtest28of10,pubtest24of100,1,321,5211,61,140,5412
subtest21of10,pubtest24of100,1,321,5211,65,176,5452
subtest29of10,pubtest24of100,1,321,5211,69,212,5492
subtest27of10,pubtest24of100,1,321,5211,72,249,5532
subtest22of10,pubtest24of100,1,321,5211,85,276,5572
subtest210of10,pubtest24of100,1,321,5211,88,313,5612
subtest26of10,pubtest24of100,1,321,5211,88,352,5651
subtest21of10,pubtest25of100,1,321,5363,6,40,5409
subtest28of10,pubtest25of100,1,321,5363,6,79,5448
subtest26of10,pubtest25of100,1,321,5363,11,111,5485
subtest22of10,pubtest25of100,1,321,5363,14,151,5528
subtest23of10,pubtest25of100,1,321,5363,14,190,5567
subtest27of10,pubtest25of100,1,321,5363,10,230,5603
subtest210of10,pubtest25of100,1,321,5363,10,269,5642
subtest25of10,pubtest25of100,1,321,5363,16,309,5688
subtest29of10,pubtest25of100,1,321,5363,15,348,5726
subtest24of10,pubtest25of100,1,321,5363,22,383,5768
subtest22of10,pubtest26of100,1,321,5209,5,41,5255
subtest21of10,pubtest26of100,1,321,5209,6,79,5294
subtest29of10,pubtest26of100,1,321,5209,17,106,5332
subtest23of10,pubtest26of100,1,321,5209,18,146,5373
subtest26of10,pubtest26of100,1,321,5209,20,184,5413
subtest25of10,pubtest26of100,1,321,5209,19,224,5452
subtest27of10,pubtest26of100,1,321,5209,21,263,5493
subtest210of10,pubtest26of100,1,321,5209,21,303,5533
subtest24of10,pubtest26of100,1,321,5209,44,320,5573
subtest28of10,pubtest26of100,1,321,5209,44,360,5613
subtest27of10,pubtest27of100,1,320,5205,13,40,5258
subtest28of10,pubtest27of100,1,320,5205,17,75,5297
subtest23of10,pubtest27of100,1,320,5205,19,113,5337
subtest29of10,pubtest27of100,1,320,5205,19,153,5377
subtest210of10,pubtest27of100,1,320,5205,21,173,5399
subtest21of10,pubtest27of100,1,320,5205,40,212,5457
subtest26of10,pubtest27of100,1,320,5205,41,251,5497
subtest22of10,pubtest27of100,1,320,5205,41,291,5537
subtest25of10,pubtest27of100,1,320,5205,42,330,5577
subtest24of10,pubtest27of100,1,320,5205,18,369,5592
subtest27of10,pubtest28of100,1,321,5168,4,43,5215
subtest21of10,pubtest28of100,1,321,5168,6,79,5253
subtest28of10,pubtest28of100,1,321,5168,8,117,5293
subtest29of10,pubtest28of100,1,321,5168,13,152,5333
subtest23of10,pubtest28of100,1,321,5168,16,191,5375
subtest25of10,pubtest28of100,1,321,5168,16,230,5414
subtest26of10,pubtest28of100,1,321,5168,20,265,5453
subtest210of10,pubtest28of100,1,321,5168,20,305,5493
subtest24of10,pubtest28of100,1,321,5168,21,344,5533
subtest22of10,pubtest28of100,1,321,5168,25,380,5573
subtest23of10,pubtest29of100,1,321,5255,5,42,5302
subtest29of10,pubtest29of100,1,321,5255,7,79,5341
subtest25of10,pubtest29of100,1,321,5255,11,115,5381
subtest210of10,pubtest29of100,1,321,5255,12,155,5422
subtest22of10,pubtest29of100,1,321,5255,20,186,5461
subtest21of10,pubtest29of100,1,321,5255,22,225,5502
subtest28of10,pubtest29of100,1,321,5255,22,264,5541
subtest26of10,pubtest29of100,1,321,5255,25,318,5598
subtest27of10,pubtest29of100,1,321,5255,25,356,5636
subtest24of10,pubtest29of100,1,321,5255,27,395,5677
subtest29of10,pubtest210of100,1,323,5322,4,41,5367
subtest21of10,pubtest210of100,1,323,5322,9,75,5406
subtest27of10,pubtest210of100,1,323,5322,11,112,5445
subtest210of10,pubtest210of100,1,323,5322,13,151,5486
subtest23of10,pubtest210of100,1,323,5322,16,188,5526
subtest24of10,pubtest210of100,1,323,5322,17,227,5566
subtest25of10,pubtest210of100,1,323,5322,18,266,5606
subtest22of10,pubtest210of100,1,323,5322,19,305,5646
subtest28of10,pubtest210of100,1,323,5322,16,344,5682
subtest26of10,pubtest210of100,1,323,5322,20,384,5726
subtest210of10,pubtest211of100,1,323,5183,5,41,5229
subtest24of10,pubtest211of100,1,323,5183,10,74,5267
subtest29of10,pubtest211of100,1,323,5183,11,114,5308
subtest22of10,pubtest211of100,1,323,5183,12,152,5347
subtest21of10,pubtest211of100,1,323,5183,13,191,5387
subtest25of10,pubtest211of100,1,323,5183,14,230,5427
subtest26of10,pubtest211of100,1,323,5183,15,269,5467
subtest27of10,pubtest211of100,1,323,5183,16,308,5507
subtest23of10,pubtest211of100,1,323,5183,16,348,5547
subtest28of10,pubtest211of100,1,323,5183,19,385,5587
subtest25of10,pubtest212of100,1,323,5526,6,40,5572
subtest28of10,pubtest212of100,1,323,5526,8,79,5613
subtest29of10,pubtest212of100,1,323,5526,12,115,5653
subtest24of10,pubtest212of100,1,323,5526,13,152,5691
subtest23of10,pubtest212of100,1,323,5526,13,192,5731
subtest27of10,pubtest212of100,1,323,5526,21,225,5772
subtest21of10,pubtest212of100,1,323,5526,25,262,5813
subtest22of10,pubtest212of100,1,323,5526,36,291,5853
subtest26of10,pubtest212of100,1,323,5526,36,331,5893
subtest210of10,pubtest212of100,1,323,5526,40,367,5933
subtest23of10,pubtest213of100,1,322,5166,17,40,5223
subtest29of10,pubtest213of100,1,322,5166,19,78,5263
subtest26of10,pubtest213of100,1,322,5166,19,117,5302
subtest27of10,pubtest213of100,1,322,5166,28,148,5342
subtest22of10,pubtest213of100,1,322,5166,52,164,5382
subtest21of10,pubtest213of100,1,322,5166,53,203,5422
subtest25of10,pubtest213of100,1,322,5166,55,241,5462
subtest24of10,pubtest213of100,1,322,5166,54,281,5501
subtest210of10,pubtest213of100,1,322,5166,56,320,5542
subtest28of10,pubtest213of100,1,322,5166,57,358,5581
subtest21of10,pubtest214of100,1,323,5217,5,40,5262
subtest23of10,pubtest214of100,1,323,5217,13,71,5301
subtest26of10,pubtest214of100,1,323,5217,14,110,5341
subtest25of10,pubtest214of100,1,323,5217,68,95,5380
subtest27of10,pubtest214of100,1,323,5217,71,132,5420
subtest29of10,pubtest214of100,1,323,5217,75,168,5460
subtest22of10,pubtest214of100,1,323,5217,75,208,5500
subtest210of10,pubtest214of100,1,323,5217,83,240,5540
subtest24of10,pubtest214of100,1,323,5217,100,263,5580
subtest28of10,pubtest214of100,1,323,5217,100,303,5620
subtest27of10,pubtest215of100,1,323,5175,246,38,5459
subtest24of10,pubtest215of100,1,323,5175,257,66,5498
subtest26of10,pubtest215of100,1,323,5175,258,105,5538
subtest25of10,pubtest215of100,1,323,5175,260,144,5579
subtest22of10,pubtest215of100,1,323,5175,261,182,5618
subtest28of10,pubtest215of100,1,323,5175,261,222,5658
subtest23of10,pubtest215of100,1,323,5175,260,261,5696
subtest29of10,pubtest215of100,1,323,5175,257,304,5736
subtest210of10,pubtest215of100,1,323,5175,263,340,5778
subtest21of10,pubtest215of100,1,323,5175,258,379,5812
subtest24of10,pubtest216of100,1,323,5570,12,42,5624
subtest21of10,pubtest216of100,1,323,5570,12,81,5663
subtest23of10,pubtest216of100,1,323,5570,14,120,5704
subtest27of10,pubtest216of100,1,323,5570,26,147,5743
subtest28of10,pubtest216of100,1,323,5570,27,186,5783
subtest25of10,pubtest216of100,1,323,5570,31,222,5823
subtest22of10,pubtest216of100,1,323,5570,32,261,5863
subtest29of10,pubtest216of100,1,323,5570,33,300,5903
subtest26of10,pubtest216of100,1,323,5570,34,339,5943
subtest210of10,pubtest216of100,1,323,5570,45,368,5983
subtest27of10,pubtest217of100,1,322,5183,29,44,5256
subtest22of10,pubtest217of100,1,322,5183,29,83,5295
subtest21of10,pubtest217of100,1,322,5183,30,120,5333
subtest26of10,pubtest217of100,1,322,5183,31,159,5373
subtest24of10,pubtest217of100,1,322,5183,34,199,5416
subtest23of10,pubtest217of100,1,322,5183,45,227,5455
subtest29of10,pubtest217of100,1,322,5183,46,266,5495
subtest25of10,pubtest217of100,1,322,5183,47,305,5535
subtest28of10,pubtest217of100,1,322,5183,48,345,5576
subtest210of10,pubtest217of100,1,322,5183,49,383,5615
subtest29of10,pubtest218of100,1,323,5162,57,39,5258
subtest21of10,pubtest218of100,1,323,5162,57,78,5297
subtest28of10,pubtest218of100,1,323,5162,59,117,5338
subtest22of10,pubtest218of100,1,323,5162,59,157,5378
subtest27of10,pubtest218of100,1,323,5162,61,196,5419
subtest23of10,pubtest218of100,1,323,5162,74,221,5457
subtest25of10,pubtest218of100,1,323,5162,74,261,5497
subtest24of10,pubtest218of100,1,323,5162,76,300,5538
subtest210of10,pubtest218of100,1,323,5162,78,338,5578
subtest26of10,pubtest218of100,1,323,5162,91,365,5618
subtest210of10,pubtest219of100,1,323,5223,270,41,5534
subtest25of10,pubtest219of100,1,323,5223,271,78,5572
subtest24of10,pubtest219of100,1,323,5223,273,116,5612
subtest28of10,pubtest219of100,1,323,5223,274,155,5652
subtest21of10,pubtest219of100,1,323,5223,275,194,5692
subtest26of10,pubtest219of100,1,323,5223,275,233,5731
subtest27of10,pubtest219of100,1,323,5223,275,273,5771
subtest22of10,pubtest219of100,1,323,5223,273,312,5808
subtest23of10,pubtest219of100,1,323,5223,277,349,5849
subtest29of10,pubtest219of100,1,323,5223,275,389,5887
subtest25of10,pubtest220of100,1,323,5325,172,41,5538
subtest210of10,pubtest220of100,1,323,5325,173,79,5577
subtest23of10,pubtest220of100,1,323,5325,174,118,5617
subtest29of10,pubtest220of100,1,323,5325,174,158,5657
subtest24of10,pubtest220of100,1,323,5325,186,185,5696
subtest27of10,pubtest220of100,1,323,5325,187,225,5737
subtest21of10,pubtest220of100,1,323,5325,186,263,5774
subtest28of10,pubtest220of100,1,323,5325,190,302,5817
subtest26of10,pubtest220of100,1,323,5325,206,326,5857
subtest22of10,pubtest220of100,1,323,5325,206,366,5897
subtest24of10,pubtest221of100,1,323,5312,36,46,5394
subtest28of10,pubtest221of100,1,323,5312,37,84,5433
subtest21of10,pubtest221of100,1,323,5312,36,122,5470
subtest23of10,pubtest221of100,1,323,5312,42,159,5513
subtest25of10,pubtest221of100,1,323,5312,42,198,5552
subtest22of10,pubtest221of100,1,323,5312,133,147,5592
subtest29of10,pubtest221of100,1,323,5312,135,186,5633
subtest210of10,pubtest221of100,1,323,5312,134,224,5670
subtest26of10,pubtest221of100,1,323,5312,140,260,5712
subtest27of10,pubtest221of100,1,323,5312,141,299,5752
subtest29of10,pubtest222of100,1,323,5178,5,39,5222
subtest21of10,pubtest222of100,1,323,5178,5,79,5262
subtest22of10,pubtest222of100,1,323,5178,5,116,5299
subtest28of10,pubtest222of100,1,323,5178,20,143,5341
subtest210of10,pubtest222of100,1,323,5178,35,168,5381
subtest25of10,pubtest222of100,1,323,5178,36,207,5421
subtest23of10,pubtest222of100,1,323,5178,36,247,5461
subtest27of10,pubtest222of100,1,323,5178,35,286,5499
subtest26of10,pubtest222of100,1,323,5178,40,325,5543
subtest24of10,pubtest222of100,1,323,5178,40,364,5582
subtest21of10,pubtest223of100,1,323,5286,9,44,5339
subtest28of10,pubtest223of100,1,323,5286,11,81,5378
subtest23of10,pubtest223of100,1,323,5286,30,101,5417
subtest29of10,pubtest223of100,1,323,5286,30,141,5457
subtest24of10,pubtest223of100,1,323,5286,47,165,5498
subtest27of10,pubtest223of100,1,323,5286,48,204,5538
subtest210of10,pubtest223of100,1,323,5286,50,241,5577
subtest25of10,pubtest223of100,1,323,5286,66,265,5617
subtest26of10,pubtest223of100,1,323,5286,71,300,5657
subtest22of10,pubtest223of100,1,323,5286,72,339,5697
subtest21of10,pubtest224of100,1,323,5217,18,38,5273
subtest27of10,pubtest224of100,1,323,5217,22,73,5312
subtest28of10,pubtest224of100,1,323,5217,24,112,5353
subtest23of10,pubtest224of100,1,323,5217,33,142,5392
subtest26of10,pubtest224of100,1,323,5217,33,182,5432
subtest29of10,pubtest224of100,1,323,5217,35,219,5471
subtest25of10,pubtest224of100,1,323,5217,38,258,5513
subtest24of10,pubtest224of100,1,323,5217,38,297,5552
subtest210of10,pubtest224of100,1,323,5217,39,336,5592
subtest22of10,pubtest224of100,1,323,5217,39,376,5632
subtest27of10,pubtest225of100,1,323,5203,9,43,5255
subtest22of10,pubtest225of100,1,323,5203,10,82,5295
subtest21of10,pubtest225of100,1,323,5203,29,101,5333
subtest24of10,pubtest225of100,1,323,5203,31,444,5678
subtest26of10,pubtest225of100,1,323,5203,32,483,5718
subtest25of10,pubtest225of100,1,323,5203,48,507,5758
subtest23of10,pubtest225of100,1,323,5203,69,526,5798
subtest29of10,pubtest225of100,1,323,5203,70,565,5838
subtest28of10,pubtest225of100,1,323,5203,82,593,5878
subtest210of10,pubtest225of100,1,323,5203,82,634,5919
subtest25of10,pubtest226of100,1,323,5360,34,167,5561
subtest22of10,pubtest226of100,1,323,5360,33,167,5560
subtest23of10,pubtest226of100,1,323,5360,44,198,5602
subtest27of10,pubtest226of100,1,323,5360,45,236,5641
subtest210of10,pubtest226of100,1,323,5360,46,275,5681
subtest21of10,pubtest226of100,1,323,5360,47,314,5721
subtest29of10,pubtest226of100,1,323,5360,49,352,5761
subtest28of10,pubtest226of100,1,323,5360,50,391,5801
subtest24of10,pubtest226of100,1,323,5360,51,430,5841
subtest26of10,pubtest226of100,1,323,5360,51,469,5880
subtest210of10,pubtest227of100,1,323,5387,12,42,5441
subtest29of10,pubtest227of100,1,323,5387,12,82,5481
subtest24of10,pubtest227of100,1,323,5387,72,61,5520
subtest25of10,pubtest227of100,1,323,5387,86,87,5560
subtest23of10,pubtest227of100,1,323,5387,86,127,5600
subtest26of10,pubtest227of100,1,323,5387,89,164,5640
subtest27of10,pubtest227of100,1,323,5387,89,204,5680
subtest21of10,pubtest227of100,1,323,5387,90,241,5718
subtest22of10,pubtest227of100,1,323,5387,92,281,5760
subtest28of10,pubtest227of100,1,323,5387,246,167,5800
subtest21of10,pubtest228of100,1,323,5382,25,39,5446
subtest26of10,pubtest228of100,1,323,5382,26,79,5487
subtest25of10,pubtest228of100,1,323,5382,29,114,5525
subtest23of10,pubtest228of100,1,323,5382,30,154,5566
subtest24of10,pubtest228of100,1,323,5382,31,191,5604
subtest27of10,pubtest228of100,1,323,5382,31,231,5644
subtest29of10,pubtest228of100,1,323,5382,43,261,5686
subtest210of10,pubtest228of100,1,323,5382,43,301,5726
subtest22of10,pubtest228of100,1,323,5382,45,339,5766
subtest28of10,pubtest228of100,1,323,5382,44,378,5804
subtest24of10,pubtest229of100,1,321,5231,21,40,5292
subtest28of10,pubtest229of100,1,321,5231,28,71,5330
subtest22of10,pubtest229of100,1,321,5231,30,110,5371
subtest21of10,pubtest229of100,1,321,5231,30,149,5410
subtest27of10,pubtest229of100,1,321,5231,43,177,5451
subtest210of10,pubtest229of100,1,321,5231,45,214,5490
subtest25of10,pubtest229of100,1,321,5231,46,253,5530
subtest29of10,pubtest229of100,1,321,5231,47,293,5571
subtest23of10,pubtest229of100,1,321,5231,44,332,5607
subtest26of10,pubtest229of100,1,321,5231,49,371,5651
subtest210of10,pubtest230of100,1,323,5201,57,39,5297
subtest27of10,pubtest230of100,1,323,5201,54,81,5336
subtest29of10,pubtest230of100,1,323,5201,55,121,5377
subtest21of10,pubtest230of100,1,323,5201,54,159,5414
subtest23of10,pubtest230of100,1,323,5201,57,199,5457
subtest28of10,pubtest230of100,1,323,5201,58,237,5496
subtest24of10,pubtest230of100,1,323,5201,59,277,5537
subtest25of10,pubtest230of100,1,323,5201,61,314,5576
subtest26of10,pubtest230of100,1,323,5201,61,354,5616
subtest22of10,pubtest230of100,1,323,5201,296,158,5655
subtest23of10,pubtest231of100,1,323,5277,248,436,5961
subtest25of10,pubtest231of100,1,323,5277,258,464,5999
subtest28of10,pubtest231of100,1,323,5277,259,503,6039
subtest24of10,pubtest231of100,1,323,5277,265,537,6079
subtest29of10,pubtest231of100,1,323,5277,278,564,6119
subtest210of10,pubtest231of100,1,323,5277,279,603,6159
subtest26of10,pubtest231of100,1,323,5277,280,640,6197
subtest27of10,pubtest231of100,1,323,5277,280,679,6236
subtest21of10,pubtest231of100,1,323,5277,281,719,6277
subtest22of10,pubtest231of100,1,323,5277,285,757,6319
subtest21of10,pubtest232of100,1,323,5351,20,39,5410
subtest22of10,pubtest232of100,1,323,5351,21,77,5449
subtest27of10,pubtest232of100,1,323,5351,23,115,5489
subtest28of10,pubtest232of100,1,323,5351,23,155,5529
subtest23of10,pubtest232of100,1,323,5351,23,192,5566
subtest25of10,pubtest232of100,1,323,5351,25,231,5607
subtest210of10,pubtest232of100,1,323,5351,28,270,5649
subtest29of10,pubtest232of100,1,323,5351,27,310,5688
subtest24of10,pubtest232of100,1,323,5351,36,342,5729
subtest26of10,pubtest232of100,1,323,5351,36,382,5769
subtest24of10,pubtest233of100,1,323,5175,33,39,5247
subtest29of10,pubtest233of100,1,323,5175,37,76,5288
subtest25of10,pubtest233of100,1,323,5175,40,112,5327
subtest27of10,pubtest233of100,1,323,5175,41,151,5367
subtest210of10,pubtest233of100,1,323,5175,43,189,5407
subtest26of10,pubtest233of100,1,323,5175,54,218,5447
subtest23of10,pubtest233of100,1,323,5175,57,255,5487
subtest21of10,pubtest233of100,1,323,5175,63,289,5527
subtest22of10,pubtest233of100,1,323,5175,75,317,5567
subtest28of10,pubtest233of100,1,323,5175,101,331,5607
subtest26of10,pubtest234of100,1,323,5211,15,40,5266
subtest25of10,pubtest234of100,1,323,5211,16,78,5305
subtest27of10,pubtest234of100,1,323,5211,17,118,5346
subtest22of10,pubtest234of100,1,323,5211,19,155,5385
subtest21of10,pubtest234of100,1,323,5211,19,195,5425
subtest29of10,pubtest234of100,1,323,5211,34,219,5464
subtest210of10,pubtest234of100,1,323,5211,35,259,5505
subtest23of10,pubtest234of100,1,323,5211,34,298,5543
subtest28of10,pubtest234of100,1,323,5211,36,338,5585
subtest24of10,pubtest234of100,1,323,5211,37,375,5623
subtest21of10,pubtest235of100,1,321,5192,11,38,5241
subtest210of10,pubtest235of100,1,321,5192,28,61,5281
subtest22of10,pubtest235of100,1,321,5192,42,86,5320
subtest27of10,pubtest235of100,1,321,5192,42,126,5360
subtest25of10,pubtest235of100,1,321,5192,44,164,5400
subtest29of10,pubtest235of100,1,321,5192,44,204,5440
subtest23of10,pubtest235of100,1,321,5192,42,241,5475
subtest26of10,pubtest235of100,1,321,5192,48,280,5520
subtest24of10,pubtest235of100,1,321,5192,45,321,5558
subtest28of10,pubtest235of100,1,321,5192,64,344,5600
subtest210of10,pubtest236of100,1,323,5224,50,39,5313
subtest23of10,pubtest236of100,1,323,5224,67,60,5351
subtest27of10,pubtest236of100,1,323,5224,68,100,5392
subtest28of10,pubtest236of100,1,323,5224,86,121,5431
subtest21of10,pubtest236of100,1,323,5224,86,159,5469
subtest25of10,pubtest236of100,1,323,5224,86,197,5507
subtest29of10,pubtest236of100,1,323,5224,101,227,5552
subtest24of10,pubtest236of100,1,323,5224,106,261,5591
subtest26of10,pubtest236of100,1,323,5224,107,300,5631
subtest22of10,pubtest236of100,1,323,5224,121,326,5671
subtest24of10,pubtest237of100,1,323,5264,9,40,5313
subtest23of10,pubtest237of100,1,323,5264,11,76,5351
subtest28of10,pubtest237of100,1,323,5264,22,105,5391
subtest25of10,pubtest237of100,1,323,5264,26,141,5431
subtest26of10,pubtest237of100,1,323,5264,26,181,5471
subtest27of10,pubtest237of100,1,323,5264,42,207,5513
subtest22of10,pubtest237of100,1,323,5264,47,240,5551
subtest210of10,pubtest237of100,1,323,5264,48,279,5591
subtest21of10,pubtest237of100,1,323,5264,48,318,5630
subtest29of10,pubtest237of100,1,323,5264,51,357,5672
subtest29of10,pubtest238of100,1,323,5310,63,39,5412
subtest27of10,pubtest238of100,1,323,5310,64,77,5451
subtest28of10,pubtest238of100,1,323,5310,66,115,5491
subtest25of10,pubtest238of100,1,323,5310,66,155,5531
subtest22of10,pubtest238of100,1,323,5310,64,195,5569
subtest23of10,pubtest238of100,1,323,5310,77,224,5611
subtest210of10,pubtest238of100,1,323,5310,77,264,5651
subtest26of10,pubtest238of100,1,323,5310,79,303,5692
subtest21of10,pubtest238of100,1,323,5310,80,342,5732
subtest24of10,pubtest238of100,1,323,5310,81,378,5769
subtest21of10,pubtest239of100,1,323,5188,5,39,5232
subtest27of10,pubtest239of100,1,323,5188,7,77,5272
subtest28of10,pubtest239of100,1,323,5188,10,113,5311
subtest25of10,pubtest239of100,1,323,5188,60,103,5351
subtest26of10,pubtest239of100,1,323,5188,60,143,5391
subtest24of10,pubtest239of100,1,323,5188,62,181,5431
subtest29of10,pubtest239of100,1,323,5188,63,221,5472
subtest22of10,pubtest239of100,1,323,5188,70,253,5511
subtest23of10,pubtest239of100,1,323,5188,280,83,5551
subtest210of10,pubtest239of100,1,323,5188,280,123,5591
subtest25of10,pubtest240of100,1,323,5243,31,38,5312
subtest210of10,pubtest240of100,1,323,5243,32,77,5352
subtest29of10,pubtest240of100,1,323,5243,34,113,5390
subtest21of10,pubtest240of100,1,323,5243,32,154,5429
subtest27of10,pubtest240of100,1,323,5243,38,191,5472
subtest23of10,pubtest240of100,1,323,5243,37,231,5511
subtest28of10,pubtest240of100,1,323,5243,37,270,5550
subtest24of10,pubtest240of100,1,323,5243,75,274,5592
subtest22of10,pubtest240of100,1,323,5243,75,314,5632
subtest26of10,pubtest240of100,1,323,5243,88,341,5672
subtest23of10,pubtest241of100,1,323,5229,13,270,5512
subtest27of10,pubtest241of100,1,323,5229,25,259,5513
subtest24of10,pubtest241of100,1,323,5229,26,298,5553
subtest21of10,pubtest241of100,1,323,5229,45,318,5592
subtest29of10,pubtest241of100,1,323,5229,45,358,5632
subtest25of10,pubtest241of100,1,323,5229,46,398,5673
subtest210of10,pubtest241of100,1,323,5229,50,433,5712
subtest28of10,pubtest241of100,1,323,5229,50,472,5751
subtest22of10,pubtest241of100,1,323,5229,52,511,5792
subtest26of10,pubtest241of100,1,323,5229,53,551,5833
subtest27of10,pubtest242of100,1,323,5167,6,43,5216
subtest23of10,pubtest242of100,1,323,5167,7,79,5253
subtest26of10,pubtest242of100,1,323,5167,18,107,5292
subtest25of10,pubtest242of100,1,323,5167,40,125,5332
subtest210of10,pubtest242of100,1,323,5167,41,164,5372
subtest29of10,pubtest242of100,1,323,5167,41,204,5412
subtest21of10,pubtest242of100,1,323,5167,43,243,5453
subtest22of10,pubtest242of100,1,323,5167,43,282,5492
subtest24of10,pubtest242of100,1,323,5167,47,316,5530
subtest28of10,pubtest242of100,1,323,5167,47,355,5569
subtest28of10,pubtest243of100,1,323,5149,42,40,5231
subtest29of10,pubtest243of100,1,323,5149,120,37,5306
subtest23of10,pubtest243of100,1,323,5149,122,76,5347
subtest22of10,pubtest243of100,1,323,5149,124,113,5386
subtest26of10,pubtest243of100,1,323,5149,125,152,5426
subtest25of10,pubtest243of100,1,323,5149,126,190,5465
subtest24of10,pubtest243of100,1,323,5149,128,229,5506
subtest210of10,pubtest243of100,1,323,5149,139,258,5546
subtest27of10,pubtest243of100,1,323,5149,140,297,5586
subtest21of10,pubtest243of100,1,323,5149,143,334,5626
subtest27of10,pubtest244of100,1,323,5240,33,40,5313
subtest25of10,pubtest244of100,1,323,5240,51,61,5352
subtest26of10,pubtest244of100,1,323,5240,51,101,5392
subtest29of10,pubtest244of100,1,323,5240,54,138,5432
subtest210of10,pubtest244of100,1,323,5240,55,177,5472
subtest21of10,pubtest244of100,1,323,5240,54,216,5510
subtest22of10,pubtest244of100,1,323,5240,56,256,5552
subtest28of10,pubtest244of100,1,323,5240,58,294,5592
subtest24of10,pubtest244of100,1,323,5240,57,334,5631
subtest23of10,pubtest244of100,1,323,5240,59,373,5672
subtest29of10,pubtest245of100,1,322,5214,6,41,5261
subtest26of10,pubtest245of100,1,322,5214,19,68,5301
subtest23of10,pubtest245of100,1,322,5214,19,107,5340
subtest25of10,pubtest245of100,1,322,5214,20,147,5381
subtest22of10,pubtest245of100,1,322,5214,25,182,5421
subtest24of10,pubtest245of100,1,322,5214,26,220,5460
subtest21of10,pubtest245of100,1,322,5214,43,243,5500
subtest28of10,pubtest245of100,1,322,5214,61,265,5540
subtest27of10,pubtest245of100,1,322,5214,61,304,5579
subtest210of10,pubtest245of100,1,322,5214,63,343,5620
subtest26of10,pubtest246of100,1,323,5477,35,44,5556
subtest27of10,pubtest246of100,1,323,5477,35,84,5596
subtest23of10,pubtest246of100,1,323,5477,48,110,5635
subtest28of10,pubtest246of100,1,323,5477,49,150,5676
subtest210of10,pubtest246of100,1,323,5477,50,188,5715
subtest25of10,pubtest246of100,1,323,5477,50,227,5754
subtest24of10,pubtest246of100,1,323,5477,94,224,5795
subtest22of10,pubtest246of100,1,323,5477,97,261,5835
subtest21of10,pubtest246of100,1,323,5477,355,43,5875
subtest29of10,pubtest246of100,1,323,5477,849,37,6363
subtest27of10,pubtest247of100,1,323,5180,16,38,5234
subtest23of10,pubtest247of100,1,323,5180,37,57,5274
subtest26of10,pubtest247of100,1,323,5180,55,78,5313
subtest21of10,pubtest247of100,1,323,5180,57,116,5353
subtest22of10,pubtest247of100,1,323,5180,70,144,5394
subtest29of10,pubtest247of100,1,323,5180,70,183,5433
subtest28of10,pubtest247of100,1,323,5180,72,221,5473
subtest25of10,pubtest247of100,1,323,5180,88,245,5513
subtest210of10,pubtest247of100,1,323,5180,90,283,5553
subtest24of10,pubtest247of100,1,323,5180,90,323,5593
subtest29of10,pubtest248of100,1,323,5268,6,46,5320
subtest25of10,pubtest248of100,1,323,5268,7,82,5357
subtest26of10,pubtest248of100,1,323,5268,125,39,5432
subtest23of10,pubtest248of100,1,323,5268,126,77,5471
subtest27of10,pubtest248of100,1,323,5268,127,116,5511
subtest28of10,pubtest248of100,1,323,5268,127,158,5553
subtest24of10,pubtest248of100,1,323,5268,138,186,5592
subtest21of10,pubtest248of100,1,323,5268,138,225,5631
subtest22of10,pubtest248of100,1,323,5268,147,256,5671
subtest210of10,pubtest248of100,1,323,5268,148,295,5711
subtest27of10,pubtest249of100,1,323,5365,85,41,5491
subtest28of10,pubtest249of100,1,323,5365,87,78,5530
subtest25of10,pubtest249of100,1,323,5365,101,103,5569
subtest21of10,pubtest249of100,1,323,5365,103,142,5610
subtest24of10,pubtest249of100,1,323,5365,104,180,5649
subtest29of10,pubtest249of100,1,323,5365,106,218,5689
subtest26of10,pubtest249of100,1,323,5365,109,255,5729
subtest23of10,pubtest249of100,1,323,5365,120,284,5769
subtest22of10,pubtest249of100,1,323,5365,123,319,5807
subtest210of10,pubtest249of100,1,323,5365,124,358,5847
subtest27of10,pubtest250of100,1,323,5288,9,44,5341
subtest23of10,pubtest250of100,1,323,5288,28,64,5380
subtest21of10,pubtest250of100,1,323,5288,43,90,5421
subtest29of10,pubtest250of100,1,323,5288,42,130,5460
subtest25of10,pubtest250of100,1,323,5288,44,166,5498
subtest28of10,pubtest250of100,1,323,5288,42,206,5536
subtest24of10,pubtest250of100,1,323,5288,44,245,5577
subtest210of10,pubtest250of100,1,323,5288,44,284,5616
subtest26of10,pubtest250of100,1,323,5288,184,188,5660
subtest22of10,pubtest250of100,1,323,5288,185,227,5700
subtest23of10,pubtest251of100,1,323,5343,20,38,5401
subtest21of10,pubtest251of100,1,323,5343,41,55,5439
subtest29of10,pubtest251of100,1,323,5343,43,93,5479
subtest24of10,pubtest251of100,1,323,5343,44,133,5520
subtest28of10,pubtest251of100,1,323,5343,45,172,5560
subtest210of10,pubtest251of100,1,323,5343,47,211,5601
subtest26of10,pubtest251of100,1,323,5343,48,250,5641
subtest27of10,pubtest251of100,1,323,5343,283,55,5681
subtest25of10,pubtest251of100,1,323,5343,304,73,5720
subtest22of10,pubtest251of100,1,323,5343,486,39,5868
subtest29of10,pubtest252of100,1,323,5201,261,41,5503
subtest28of10,pubtest252of100,1,323,5201,263,78,5542
subtest26of10,pubtest252of100,1,323,5201,265,116,5582
subtest27of10,pubtest252of100,1,323,5201,265,156,5622
subtest21of10,pubtest252of100,1,323,5201,266,195,5662
subtest23of10,pubtest252of100,1,323,5201,267,234,5702
subtest22of10,pubtest252of100,1,323,5201,268,273,5742
subtest24of10,pubtest252of100,1,323,5201,268,312,5781
subtest210of10,pubtest252of100,1,323,5201,269,352,5822
subtest25of10,pubtest252of100,1,323,5201,270,389,5860
subtest28of10,pubtest253of100,1,322,5286,28,40,5354
subtest23of10,pubtest253of100,1,322,5286,47,59,5392
subtest24of10,pubtest253of100,1,322,5286,48,99,5433
subtest22of10,pubtest253of100,1,322,5286,49,137,5472
subtest25of10,pubtest253of100,1,322,5286,50,177,5513
subtest210of10,pubtest253of100,1,322,5286,53,214,5553
subtest21of10,pubtest253of100,1,322,5286,53,254,5593
subtest27of10,pubtest253of100,1,322,5286,54,293,5633
subtest26of10,pubtest253of100,1,322,5286,55,332,5673
subtest29of10,pubtest253of100,1,322,5286,56,372,5714
subtest210of10,pubtest254of100,1,323,5325,29,42,5396
subtest27of10,pubtest254of100,1,323,5325,70,42,5437
subtest21of10,pubtest254of100,1,323,5325,72,80,5477
subtest28of10,pubtest254of100,1,323,5325,74,118,5517
subtest25of10,pubtest254of100,1,323,5325,76,156,5557
subtest23of10,pubtest254of100,1,323,5325,88,187,5600
subtest29of10,pubtest254of100,1,323,5325,96,217,5638
subtest24of10,pubtest254of100,1,323,5325,110,242,5677
subtest22of10,pubtest254of100,1,323,5325,111,282,5718
subtest26of10,pubtest254of100,1,323,5325,112,320,5757
subtest23of10,pubtest255of100,1,322,5269,15,45,5329
subtest27of10,pubtest255of100,1,322,5269,17,83,5369
subtest22of10,pubtest255of100,1,322,5269,16,122,5407
subtest29of10,pubtest255of100,1,322,5269,24,155,5448
subtest28of10,pubtest255of100,1,322,5269,35,184,5488
subtest24of10,pubtest255of100,1,322,5269,54,205,5528
subtest25of10,pubtest255of100,1,322,5269,56,243,5568
subtest210of10,pubtest255of100,1,322,5269,56,283,5608
subtest21of10,pubtest255of100,1,322,5269,55,320,5644
subtest26of10,pubtest255of100,1,322,5269,59,360,5688
subtest29of10,pubtest256of100,1,323,5273,5,40,5318
subtest21of10,pubtest256of100,1,323,5273,22,63,5358
subtest23of10,pubtest256of100,1,323,5273,63,62,5398
subtest26of10,pubtest256of100,1,323,5273,64,100,5437
subtest25of10,pubtest256of100,1,323,5273,65,137,5475
subtest27of10,pubtest256of100,1,323,5273,81,163,5517
subtest210of10,pubtest256of100,1,323,5273,82,201,5556
subtest28of10,pubtest256of100,1,323,5273,84,240,5597
subtest22of10,pubtest256of100,1,323,5273,84,280,5637
subtest24of10,pubtest256of100,1,323,5273,86,318,5677
subtest21of10,pubtest257of100,1,323,5184,90,43,5317
subtest24of10,pubtest257of100,1,323,5184,92,82,5358
subtest27of10,pubtest257of100,1,323,5184,105,109,5398
subtest23of10,pubtest257of100,1,323,5184,106,148,5438
subtest29of10,pubtest257of100,1,323,5184,107,187,5478
subtest28of10,pubtest257of100,1,323,5184,108,227,5519
subtest25of10,pubtest257of100,1,323,5184,113,261,5558
subtest22of10,pubtest257of100,1,323,5184,113,301,5598
subtest210of10,pubtest257of100,1,323,5184,125,329,5638
subtest26of10,pubtest257of100,1,323,5184,125,369,5678
subtest28of10,pubtest258of100,1,323,5181,14,39,5234
subtest23of10,pubtest258of100,1,323,5181,19,73,5273
subtest25of10,pubtest258of100,1,323,5181,24,108,5313
subtest21of10,pubtest258of100,1,323,5181,24,148,5353
subtest27of10,pubtest258of100,1,323,5181,25,187,5393
subtest29of10,pubtest258of100,1,323,5181,26,226,5433
subtest26of10,pubtest258of100,1,323,5181,27,265,5473
subtest210of10,pubtest258of100,1,323,5181,26,305,5512
subtest22of10,pubtest258of100,1,323,5181,31,341,5553
subtest24of10,pubtest258of100,1,323,5181,34,378,5593
subtest21of10,pubtest259of100,1,323,5490,38,41,5569
subtest25of10,pubtest259of100,1,323,5490,40,79,5609
subtest28of10,pubtest259of100,1,323,5490,41,116,5647
subtest27of10,pubtest259of100,1,323,5490,42,156,5688
subtest24of10,pubtest259of100,1,323,5490,45,193,5728
subtest23of10,pubtest259of100,1,323,5490,56,222,5768
subtest29of10,pubtest259of100,1,323,5490,95,223,5808
subtest26of10,pubtest259of100,1,323,5490,97,261,5848
subtest22of10,pubtest259of100,1,323,5490,100,298,5888
subtest210of10,pubtest259of100,1,323,5490,100,338,5928
subtest210of10,pubtest260of100,1,323,5387,25,50,5462
subtest23of10,pubtest260of100,1,323,5387,25,88,5500
subtest21of10,pubtest260of100,1,323,5387,29,126,5542
subtest26of10,pubtest260of100,1,323,5387,30,166,5583
subtest29of10,pubtest260of100,1,323,5387,46,189,5622
subtest27of10,pubtest260of100,1,323,5387,46,229,5662
subtest22of10,pubtest260of100,1,323,5387,48,266,5701
subtest28of10,pubtest260of100,1,323,5387,49,306,5742
subtest25of10,pubtest260of100,1,323,5387,48,345,5780
subtest24of10,pubtest260of100,1,323,5387,73,362,5822
subtest25of10,pubtest261of100,1,323,5283,31,39,5353
subtest28of10,pubtest261of100,1,323,5283,31,78,5392
subtest29of10,pubtest261of100,1,323,5283,33,116,5432
subtest23of10,pubtest261of100,1,323,5283,33,156,5472
subtest210of10,pubtest261of100,1,323,5283,35,194,5512
subtest22of10,pubtest261of100,1,323,5283,35,233,5551
subtest27of10,pubtest261of100,1,323,5283,39,270,5592
subtest21of10,pubtest261of100,1,323,5283,39,310,5632
subtest24of10,pubtest261of100,1,323,5283,42,348,5673
subtest26of10,pubtest261of100,1,323,5283,50,380,5713
subtest22of10,pubtest262of100,1,323,5429,47,41,5517
subtest21of10,pubtest262of100,1,323,5429,47,80,5556
subtest26of10,pubtest262of100,1,323,5429,49,118,5596
subtest23of10,pubtest262of100,1,323,5429,49,158,5636
subtest27of10,pubtest262of100,1,323,5429,63,184,5676
subtest29of10,pubtest262of100,1,323,5429,64,223,5716
subtest210of10,pubtest262of100,1,323,5429,66,261,5756
subtest24of10,pubtest262of100,1,323,5429,68,300,5797
subtest25of10,pubtest262of100,1,323,5429,67,339,5835
subtest28of10,pubtest262of100,1,323,5429,69,378,5876
subtest22of10,pubtest263of100,1,322,5182,37,42,5261
subtest24of10,pubtest263of100,1,322,5182,40,80,5302
subtest29of10,pubtest263of100,1,322,5182,39,121,5342
subtest26of10,pubtest263of100,1,322,5182,49,152,5383
subtest23of10,pubtest263of100,1,322,5182,72,168,5422
subtest25of10,pubtest263of100,1,322,5182,75,205,5462
subtest27of10,pubtest263of100,1,322,5182,76,244,5502
subtest28of10,pubtest263of100,1,322,5182,76,284,5542
subtest210of10,pubtest263of100,1,322,5182,75,323,5580
subtest21of10,pubtest263of100,1,322,5182,90,350,5622
subtest22of10,pubtest264of100,1,322,5208,18,39,5265
subtest29of10,pubtest264of100,1,322,5208,20,76,5304
subtest27of10,pubtest264of100,1,322,5208,22,115,5345
subtest23of10,pubtest264of100,1,322,5208,21,154,5383
subtest21of10,pubtest264of100,1,322,5208,23,193,5424
subtest24of10,pubtest264of100,1,322,5208,23,233,5464
subtest25of10,pubtest264of100,1,322,5208,36,260,5504
subtest26of10,pubtest264of100,1,322,5208,37,300,5545
subtest28of10,pubtest264of100,1,322,5208,39,337,5584
subtest210of10,pubtest264of100,1,322,5208,41,375,5624
subtest26of10,pubtest265of100,1,323,5227,33,40,5300
subtest28of10,pubtest265of100,1,323,5227,64,49,5340
subtest23of10,pubtest265of100,1,323,5227,89,64,5380
subtest24of10,pubtest265of100,1,323,5227,90,100,5417
subtest27of10,pubtest265of100,1,323,5227,290,39,5556
subtest21of10,pubtest265of100,1,323,5227,291,77,5595
subtest29of10,pubtest265of100,1,323,5227,292,116,5635
subtest25of10,pubtest265of100,1,323,5227,305,144,5676
subtest210of10,pubtest265of100,1,323,5227,312,176,5715
subtest22of10,pubtest265of100,1,323,5227,312,216,5755
subtest25of10,pubtest266of100,1,321,5325,49,41,5415
subtest29of10,pubtest266of100,1,321,5325,49,80,5454
subtest210of10,pubtest266of100,1,321,5325,53,116,5494
subtest27of10,pubtest266of100,1,321,5325,65,146,5536
subtest23of10,pubtest266of100,1,321,5325,66,184,5575
subtest26of10,pubtest266of100,1,321,5325,67,222,5614
subtest21of10,pubtest266of100,1,321,5325,67,262,5654
subtest28of10,pubtest266of100,1,321,5325,73,296,5694
subtest22of10,pubtest266of100,1,321,5325,85,325,5735
subtest24of10,pubtest266of100,1,321,5325,84,364,5773
subtest26of10,pubtest267of100,1,323,5183,23,38,5244
subtest23of10,pubtest267of100,1,323,5183,23,78,5284
subtest28of10,pubtest267of100,1,323,5183,28,112,5323
subtest24of10,pubtest267of100,1,323,5183,32,148,5363
subtest25of10,pubtest267of100,1,323,5183,32,188,5403
subtest22of10,pubtest267of100,1,323,5183,42,217,5442
subtest29of10,pubtest267of100,1,323,5183,43,254,5480
subtest27of10,pubtest267of100,1,323,5183,42,294,5519
subtest21of10,pubtest267of100,1,323,5183,86,294,5563
subtest210of10,pubtest267of100,1,323,5183,103,317,5603
subtest23of10,pubtest268of100,1,323,5322,13,133,5468
subtest24of10,pubtest268of100,1,323,5322,21,161,5504
subtest25of10,pubtest268of100,1,323,5322,29,193,5544
subtest29of10,pubtest268of100,1,323,5322,36,226,5584
subtest27of10,pubtest268of100,1,323,5322,36,266,5624
subtest28of10,pubtest268of100,1,323,5322,37,305,5664
subtest21of10,pubtest268of100,1,323,5322,38,344,5704
subtest22of10,pubtest268of100,1,323,5322,39,383,5744
subtest210of10,pubtest268of100,1,323,5322,40,422,5784
subtest26of10,pubtest268of100,1,323,5322,41,461,5824
subtest24of10,pubtest269of100,1,323,5226,8,40,5274
subtest27of10,pubtest269of100,1,323,5226,8,79,5313
subtest210of10,pubtest269of100,1,323,5226,11,116,5353
subtest25of10,pubtest269of100,1,323,5226,16,151,5393
subtest26of10,pubtest269of100,1,323,5226,17,190,5433
subtest21of10,pubtest269of100,1,323,5226,22,226,5474
subtest29of10,pubtest269of100,1,323,5226,31,256,5513
subtest23of10,pubtest269of100,1,323,5226,31,296,5553
subtest22of10,pubtest269of100,1,323,5226,33,334,5593
subtest28of10,pubtest269of100,1,323,5226,33,374,5633
subtest23of10,pubtest270of100,1,323,5308,8,44,5360
subtest27of10,pubtest270of100,1,323,5308,10,80,5398
subtest26of10,pubtest270of100,1,323,5308,10,120,5438
subtest29of10,pubtest270of100,1,323,5308,17,154,5479
subtest25of10,pubtest270of100,1,323,5308,18,192,5518
subtest210of10,pubtest270of100,1,323,5308,25,225,5558
subtest21of10,pubtest270of100,1,323,5308,31,257,5596
subtest28of10,pubtest270of100,1,323,5308,32,296,5636
subtest24of10,pubtest270of100,1,323,5308,35,335,5678
subtest22of10,pubtest270of100,1,323,5308,35,375,5718
subtest24of10,pubtest271of100,1,323,5479,9,41,5529
subtest25of10,pubtest271of100,1,323,5479,10,79,5568
subtest22of10,pubtest271of100,1,323,5479,13,116,5608
subtest26of10,pubtest271of100,1,323,5479,16,153,5648
subtest210of10,pubtest271of100,1,323,5479,14,193,5686
subtest27of10,pubtest271of100,1,323,5479,18,231,5728
subtest21of10,pubtest271of100,1,323,5479,23,266,5768
subtest23of10,pubtest271of100,1,323,5479,23,306,5808
subtest29of10,pubtest271of100,1,323,5479,26,343,5848
subtest28of10,pubtest271of100,1,323,5479,27,384,5890
subtest25of10,pubtest272of100,1,323,5185,7,41,5233
subtest26of10,pubtest272of100,1,323,5185,10,78,5273
subtest21of10,pubtest272of100,1,323,5185,11,117,5313
subtest29of10,pubtest272of100,1,323,5185,12,156,5353
subtest23of10,pubtest272of100,1,323,5185,12,196,5393
subtest27of10,pubtest272of100,1,323,5185,18,230,5433
subtest24of10,pubtest272of100,1,323,5185,18,270,5473
subtest210of10,pubtest272of100,1,323,5185,26,302,5513
subtest22of10,pubtest272of100,1,323,5185,27,341,5553
subtest28of10,pubtest272of100,1,323,5185,30,379,5594
subtest22of10,pubtest273of100,1,321,5501,12,39,5552
subtest29of10,pubtest273of100,1,321,5501,14,75,5590
subtest26of10,pubtest273of100,1,321,5501,15,115,5631
subtest28of10,pubtest273of100,1,321,5501,25,144,5670
subtest25of10,pubtest273of100,1,321,5501,25,184,5710
subtest27of10,pubtest273of100,1,321,5501,27,222,5750
subtest23of10,pubtest273of100,1,321,5501,34,253,5788
subtest210of10,pubtest273of100,1,321,5501,42,288,5831
subtest21of10,pubtest273of100,1,321,5501,42,327,5870
subtest24of10,pubtest273of100,1,321,5501,43,366,5910
subtest21of10,pubtest274of100,1,323,5321,8,78,5407
subtest26of10,pubtest274of100,1,323,5321,8,114,5443
subtest23of10,pubtest274of100,1,323,5321,11,149,5481
subtest22of10,pubtest274of100,1,323,5321,14,188,5523
subtest25of10,pubtest274of100,1,323,5321,14,228,5563
subtest29of10,pubtest274of100,1,323,5321,13,267,5601
subtest28of10,pubtest274of100,1,323,5321,17,305,5643
subtest27of10,pubtest274of100,1,323,5321,17,345,5683
subtest210of10,pubtest274of100,1,323,5321,19,383,5723
subtest24of10,pubtest274of100,1,323,5321,19,422,5762
subtest27of10,pubtest275of100,1,323,5327,16,38,5381
subtest24of10,pubtest275of100,1,323,5327,17,77,5421
subtest29of10,pubtest275of100,1,323,5327,17,115,5459
subtest25of10,pubtest275of100,1,323,5327,19,154,5500
subtest23of10,pubtest275of100,1,323,5327,23,190,5540
subtest21of10,pubtest275of100,1,323,5327,24,229,5580
subtest22of10,pubtest275of100,1,323,5327,25,268,5620
subtest210of10,pubtest275of100,1,323,5327,28,305,5660
subtest26of10,pubtest275of100,1,323,5327,35,338,5700
subtest28of10,pubtest275of100,1,323,5327,39,374,5740
subtest28of10,pubtest276of100,1,323,5211,9,41,5261
subtest21of10,pubtest276of100,1,323,5211,10,79,5300
subtest25of10,pubtest276of100,1,323,5211,48,80,5339
subtest27of10,pubtest276of100,1,323,5211,49,119,5379
subtest23of10,pubtest276of100,1,323,5211,51,157,5419
subtest29of10,pubtest276of100,1,323,5211,51,195,5457
subtest26of10,pubtest276of100,1,323,5211,58,229,5498
subtest24of10,pubtest276of100,1,323,5211,58,269,5538
subtest210of10,pubtest276of100,1,323,5211,60,309,5580
subtest22of10,pubtest276of100,1,323,5211,61,347,5619
subtest22of10,pubtest277of100,1,323,5348,4,39,5391
subtest29of10,pubtest277of100,1,323,5348,5,77,5430
subtest21of10,pubtest277of100,1,323,5348,10,112,5470
subtest28of10,pubtest277of100,1,323,5348,9,152,5509
subtest27of10,pubtest277of100,1,323,5348,11,191,5550
subtest24of10,pubtest277of100,1,323,5348,16,227,5591
subtest210of10,pubtest277of100,1,323,5348,16,266,5630
subtest25of10,pubtest277of100,1,323,5348,17,304,5669
subtest23of10,pubtest277of100,1,323,5348,19,345,5712
subtest26of10,pubtest277of100,1,323,5348,19,383,5750
subtest29of10,pubtest278of100,1,323,5215,7,39,5261
subtest22of10,pubtest278of100,1,323,5215,8,77,5300
subtest23of10,pubtest278of100,1,323,5215,14,111,5340
subtest21of10,pubtest278of100,1,323,5215,15,149,5379
subtest28of10,pubtest278of100,1,323,5215,16,189,5420
subtest27of10,pubtest278of100,1,323,5215,16,228,5459
subtest25of10,pubtest278of100,1,323,5215,18,267,5500
subtest26of10,pubtest278of100,1,323,5215,22,303,5540
subtest210of10,pubtest278of100,1,323,5215,23,343,5581
subtest24of10,pubtest278of100,1,323,5215,22,380,5617
subtest25of10,pubtest279of100,1,323,5178,9,43,5230
subtest28of10,pubtest279of100,1,323,5178,8,84,5270
subtest21of10,pubtest279of100,1,323,5178,11,120,5309
subtest24of10,pubtest279of100,1,323,5178,18,153,5349
subtest29of10,pubtest279of100,1,323,5178,18,192,5388
subtest27of10,pubtest279of100,1,323,5178,19,232,5429
subtest26of10,pubtest279of100,1,323,5178,24,267,5469
subtest23of10,pubtest279of100,1,323,5178,24,307,5509
subtest22of10,pubtest279of100,1,323,5178,27,344,5549
subtest210of10,pubtest279of100,1,323,5178,30,381,5589
subtest27of10,pubtest280of100,1,323,5589,9,40,5638
subtest29of10,pubtest280of100,1,323,5589,13,75,5677
subtest24of10,pubtest280of100,1,323,5589,14,113,5716
subtest21of10,pubtest280of100,1,323,5589,19,149,5757
subtest26of10,pubtest280of100,1,323,5589,20,188,5797
subtest23of10,pubtest280of100,1,323,5589,28,220,5837
subtest25of10,pubtest280of100,1,323,5589,33,255,5877
subtest210of10,pubtest280of100,1,323,5589,34,295,5918
subtest28of10,pubtest280of100,1,323,5589,38,330,5957
subtest22of10,pubtest280of100,1,323,5589,39,369,5997
subtest24of10,pubtest281of100,1,323,5204,8,40,5252
subtest23of10,pubtest281of100,1,323,5204,9,78,5291
subtest28of10,pubtest281of100,1,323,5204,15,112,5331
subtest27of10,pubtest281of100,1,323,5204,20,147,5371
subtest25of10,pubtest281of100,1,323,5204,24,183,5411
subtest22of10,pubtest281of100,1,323,5204,26,221,5451
subtest21of10,pubtest281of100,1,323,5204,26,261,5491
subtest210of10,pubtest281of100,1,323,5204,27,300,5531
subtest29of10,pubtest281of100,1,323,5204,29,338,5571
subtest26of10,pubtest281of100,1,323,5204,33,374,5611
subtest23of10,pubtest282of100,1,323,5231,7,44,5282
subtest21of10,pubtest282of100,1,323,5231,8,82,5321
subtest24of10,pubtest282of100,1,323,5231,7,121,5359
subtest25of10,pubtest282of100,1,323,5231,11,159,5401
subtest29of10,pubtest282of100,1,323,5231,19,191,5441
subtest22of10,pubtest282of100,1,323,5231,20,230,5481
subtest27of10,pubtest282of100,1,323,5231,26,264,5521
subtest26of10,pubtest282of100,1,323,5231,27,303,5561
subtest210of10,pubtest282of100,1,323,5231,28,342,5601
subtest28of10,pubtest282of100,1,323,5231,29,382,5642
subtest27of10,pubtest283of100,1,323,5238,6,40,5284
subtest24of10,pubtest283of100,1,323,5238,8,76,5322
subtest23of10,pubtest283of100,1,323,5238,15,109,5362
subtest25of10,pubtest283of100,1,323,5238,16,149,5403
subtest22of10,pubtest283of100,1,323,5238,17,187,5442
subtest21of10,pubtest283of100,1,323,5238,18,227,5483
subtest28of10,pubtest283of100,1,323,5238,19,265,5522
subtest29of10,pubtest283of100,1,323,5238,19,305,5562
subtest210of10,pubtest283of100,1,323,5238,21,344,5603
subtest26of10,pubtest283of100,1,323,5238,21,383,5642
subtest22of10,pubtest284of100,1,323,5249,10,41,5300
subtest210of10,pubtest284of100,1,323,5249,10,79,5338
subtest29of10,pubtest284of100,1,323,5249,12,119,5380
subtest24of10,pubtest284of100,1,323,5249,14,157,5420
subtest27of10,pubtest284of100,1,323,5249,14,197,5460
subtest25of10,pubtest284of100,1,323,5249,10,236,5495
subtest21of10,pubtest284of100,1,323,5249,17,274,5540
subtest23of10,pubtest284of100,1,323,5249,16,313,5578
subtest28of10,pubtest284of100,1,323,5249,19,352,5620
subtest26of10,pubtest284of100,1,323,5249,32,377,5658
subtest23of10,pubtest285of100,1,323,5199,10,49,5258
subtest25of10,pubtest285of100,1,323,5199,12,88,5299
subtest24of10,pubtest285of100,1,323,5199,18,121,5338
subtest27of10,pubtest285of100,1,323,5199,19,160,5378
subtest21of10,pubtest285of100,1,323,5199,21,198,5418
subtest22of10,pubtest285of100,1,323,5199,25,234,5458
subtest210of10,pubtest285of100,1,323,5199,26,273,5498
subtest26of10,pubtest285of100,1,323,5199,27,312,5538
subtest28of10,pubtest285of100,1,323,5199,27,352,5578
subtest29of10,pubtest285of100,1,323,5199,28,391,5618
subtest23of10,pubtest286of100,1,323,5296,12,40,5348
subtest29of10,pubtest286of100,1,323,5296,19,72,5387
subtest210of10,pubtest286of100,1,323,5296,19,112,5427
subtest24of10,pubtest286of100,1,323,5296,20,151,5467
subtest21of10,pubtest286of100,1,323,5296,22,189,5507
subtest26of10,pubtest286of100,1,323,5296,23,229,5548
subtest25of10,pubtest286of100,1,323,5296,19,267,5582
subtest27of10,pubtest286of100,1,323,5296,24,307,5627
subtest22of10,pubtest286of100,1,323,5296,25,346,5667
subtest28of10,pubtest286of100,1,323,5296,27,384,5707
subtest26of10,pubtest287of100,1,323,5335,8,39,5382
subtest28of10,pubtest287of100,1,323,5335,13,73,5421
subtest29of10,pubtest287of100,1,323,5335,14,111,5460
subtest210of10,pubtest287of100,1,323,5335,20,145,5500
subtest25of10,pubtest287of100,1,323,5335,24,181,5540
subtest27of10,pubtest287of100,1,323,5335,24,221,5580
subtest24of10,pubtest287of100,1,323,5335,26,260,5621
subtest21of10,pubtest287of100,1,323,5335,44,281,5660
subtest23of10,pubtest287of100,1,323,5335,46,317,5698
subtest22of10,pubtest287of100,1,323,5335,49,356,5740
subtest29of10,pubtest288of100,1,323,5187,8,38,5233
subtest26of10,pubtest288of100,1,323,5187,9,76,5272
subtest27of10,pubtest288of100,1,323,5187,11,114,5312
subtest22of10,pubtest288of100,1,323,5187,10,154,5351
subtest25of10,pubtest288of100,1,323,5187,11,191,5389
subtest210of10,pubtest288of100,1,323,5187,16,229,5432
subtest21of10,pubtest288of100,1,323,5187,24,261,5472
subtest23of10,pubtest288of100,1,323,5187,25,302,5514
subtest24of10,pubtest288of100,1,323,5187,26,339,5552
subtest28of10,pubtest288of100,1,323,5187,28,377,5592
subtest29of10,pubtest289of100,1,323,5254,8,42,5304
subtest210of10,pubtest289of100,1,323,5254,9,550,5813
subtest23of10,pubtest289of100,1,323,5254,17,581,5852
subtest24of10,pubtest289of100,1,323,5254,17,620,5891
subtest25of10,pubtest289of100,1,323,5254,24,654,5932
subtest27of10,pubtest289of100,1,323,5254,26,694,5974
subtest26of10,pubtest289of100,1,323,5254,26,733,6013
subtest28of10,pubtest289of100,1,323,5254,31,767,6052
subtest22of10,pubtest289of100,1,323,5254,35,803,6092
subtest21of10,pubtest289of100,1,323,5254,35,843,6132
subtest29of10,pubtest290of100,1,323,5149,38,39,5226
subtest22of10,pubtest290of100,1,323,5149,40,75,5264
subtest23of10,pubtest290of100,1,323,5149,42,113,5304
subtest25of10,pubtest290of100,1,323,5149,43,151,5343
subtest27of10,pubtest290of100,1,323,5149,44,191,5384
subtest21of10,pubtest290of100,1,323,5149,45,230,5424
subtest26of10,pubtest290of100,1,323,5149,46,270,5465
subtest28of10,pubtest290of100,1,323,5149,47,306,5502
subtest210of10,pubtest290of100,1,323,5149,47,345,5541
subtest24of10,pubtest290of100,1,323,5149,51,384,5584
subtest23of10,pubtest291of100,1,323,5285,9,40,5334
subtest24of10,pubtest291of100,1,323,5285,9,78,5372
subtest27of10,pubtest291of100,1,323,5285,11,117,5413
subtest21of10,pubtest291of100,1,323,5285,14,154,5453
subtest25of10,pubtest291of100,1,323,5285,20,188,5493
subtest28of10,pubtest291of100,1,323,5285,20,229,5534
subtest210of10,pubtest291of100,1,323,5285,20,267,5572
subtest29of10,pubtest291of100,1,323,5285,30,298,5613
subtest22of10,pubtest291of100,1,323,5285,31,337,5653
subtest26of10,pubtest291of100,1,323,5285,35,373,5693
subtest29of10,pubtest292of100,1,323,5153,10,41,5204
subtest28of10,pubtest292of100,1,323,5153,15,75,5243
subtest21of10,pubtest292of100,1,323,5153,17,113,5283
subtest25of10,pubtest292of100,1,323,5153,17,153,5323
subtest27of10,pubtest292of100,1,323,5153,20,190,5363
subtest26of10,pubtest292of100,1,323,5153,20,231,5404
subtest22of10,pubtest292of100,1,323,5153,22,268,5443
subtest24of10,pubtest292of100,1,323,5153,22,308,5483
subtest23of10,pubtest292of100,1,323,5153,23,347,5523
subtest210of10,pubtest292of100,1,323,5153,24,386,5563
subtest25of10,pubtest293of100,1,323,5421,15,41,5477
subtest23of10,pubtest293of100,1,323,5421,16,78,5515
subtest24of10,pubtest293of100,1,323,5421,15,120,5556
subtest28of10,pubtest293of100,1,323,5421,18,157,5596
subtest27of10,pubtest293of100,1,323,5421,46,169,5636
subtest21of10,pubtest293of100,1,323,5421,46,208,5675
subtest210of10,pubtest293of100,1,323,5421,48,247,5716
subtest29of10,pubtest293of100,1,323,5421,48,287,5756
subtest26of10,pubtest293of100,1,323,5421,55,320,5796
subtest22of10,pubtest293of100,1,323,5421,55,360,5836
subtest25of10,pubtest294of100,1,323,5164,21,41,5226
subtest21of10,pubtest294of100,1,323,5164,20,81,5265
subtest29of10,pubtest294of100,1,323,5164,22,117,5303
subtest210of10,pubtest294of100,1,323,5164,20,156,5340
subtest27of10,pubtest294of100,1,323,5164,23,195,5382
subtest28of10,pubtest294of100,1,323,5164,27,234,5425
subtest24of10,pubtest294of100,1,323,5164,26,274,5464
subtest22of10,pubtest294of100,1,323,5164,28,314,5506
subtest26of10,pubtest294of100,1,323,5164,29,352,5545
subtest23of10,pubtest294of100,1,323,5164,29,391,5584
subtest25of10,pubtest295of100,1,323,5273,6,41,5320
subtest24of10,pubtest295of100,1,323,5273,10,77,5360
subtest22of10,pubtest295of100,1,323,5273,14,111,5398
subtest27of10,pubtest295of100,1,323,5273,15,153,5441
subtest23of10,pubtest295of100,1,323,5273,14,191,5478
subtest210of10,pubtest295of100,1,323,5273,18,228,5519
subtest28of10,pubtest295of100,1,323,5273,20,266,5559
subtest29of10,pubtest295of100,1,323,5273,20,306,5599
subtest26of10,pubtest295of100,1,323,5273,24,342,5639
subtest21of10,pubtest295of100,1,323,5273,25,381,5679
subtest25of10,pubtest296of100,1,322,5189,7,39,5235
subtest27of10,pubtest296of100,1,322,5189,8,77,5274
subtest24of10,pubtest296of100,1,322,5189,9,116,5314
subtest23of10,pubtest296of100,1,322,5189,10,155,5354
subtest26of10,pubtest296of100,1,322,5189,19,185,5393
subtest29of10,pubtest296of100,1,322,5189,19,225,5433
subtest21of10,pubtest296of100,1,322,5189,21,264,5474
subtest210of10,pubtest296of100,1,322,5189,27,298,5514
subtest28of10,pubtest296of100,1,322,5189,24,338,5551
subtest22of10,pubtest296of100,1,322,5189,29,376,5594
subtest25of10,pubtest297of100,1,323,5268,10,45,5323
subtest210of10,pubtest297of100,1,323,5268,11,82,5361
subtest29of10,pubtest297of100,1,323,5268,14,119,5401
subtest22of10,pubtest297of100,1,323,5268,13,158,5439
subtest23of10,pubtest297of100,1,323,5268,21,191,5480
subtest26of10,pubtest297of100,1,323,5268,25,228,5521
subtest27of10,pubtest297of100,1,323,5268,26,267,5561
subtest28of10,pubtest297of100,1,323,5268,32,301,5601
subtest21of10,pubtest297of100,1,323,5268,34,339,5641
subtest24of10,pubtest297of100,1,323,5268,33,379,5680
subtest22of10,pubtest298of100,1,323,5280,9,38,5327
subtest29of10,pubtest298of100,1,323,5280,14,74,5368
subtest21of10,pubtest298of100,1,323,5280,17,111,5408
subtest24of10,pubtest298of100,1,323,5280,16,152,5448
subtest23of10,pubtest298of100,1,323,5280,16,191,5487
subtest25of10,pubtest298of100,1,323,5280,16,230,5526
subtest210of10,pubtest298of100,1,323,5280,24,264,5568
subtest27of10,pubtest298of100,1,323,5280,25,303,5608
subtest28of10,pubtest298of100,1,323,5280,26,342,5648
subtest26of10,pubtest298of100,1,323,5280,37,371,5688
subtest29of10,pubtest299of100,1,323,5328,27,42,5397
subtest22of10,pubtest299of100,1,323,5328,26,81,5435
subtest27of10,pubtest299of100,1,323,5328,29,118,5475
subtest210of10,pubtest299of100,1,323,5328,30,157,5515
subtest23of10,pubtest299of100,1,323,5328,31,196,5555
subtest21of10,pubtest299of100,1,323,5328,33,234,5595
subtest25of10,pubtest299of100,1,323,5328,33,274,5635
subtest26of10,pubtest299of100,1,323,5328,37,310,5675
subtest28of10,pubtest299of100,1,323,5328,37,350,5715
subtest24of10,pubtest299of100,1,323,5328,34,389,5751
subtest21of10,pubtest2100of100,1,325,5298,6,39,5343
subtest24of10,pubtest2100of100,1,325,5298,7,77,5382
subtest22of10,pubtest2100of100,1,325,5298,14,107,5419
subtest29of10,pubtest2100of100,1,325,5298,14,145,5457
subtest26of10,pubtest2100of100,1,325,5298,19,185,5502
subtest25of10,pubtest2100of100,1,325,5298,18,225,5541
subtest210of10,pubtest2100of100,1,325,5298,18,264,5580
subtest28of10,pubtest2100of100,1,325,5298,17,304,5619
subtest27of10,pubtest2100of100,1,325,5298,20,344,5662
subtest23of10,pubtest2100of100,1,325,5298,16,383,5697
subtest26of10,pubtest21of100,1,322,10356,7,43,10406
subtest29of10,pubtest21of100,1,322,10356,8,84,10448
subtest27of10,pubtest21of100,1,322,10356,6,123,10485
subtest24of10,pubtest21of100,1,322,10356,10,159,10525
subtest25of10,pubtest21of100,1,322,10356,11,198,10565
subtest21of10,pubtest21of100,1,322,10356,13,236,10605
subtest210of10,pubtest21of100,1,322,10356,19,270,10645
subtest28of10,pubtest21of100,1,322,10356,20,309,10685
subtest22of10,pubtest21of100,1,322,10356,21,348,10725
subtest23of10,pubtest21of100,1,322,10356,20,388,10764
subtest29of10,pubtest22of100,1,321,5535,16,40,5591
subtest27of10,pubtest22of100,1,321,5535,26,70,5631
subtest23of10,pubtest22of100,1,321,5535,49,87,5671
subtest24of10,pubtest22of100,1,321,5535,48,127,5710
subtest25of10,pubtest22of100,1,321,5535,50,165,5750
subtest28of10,pubtest22of100,1,321,5535,57,198,5790
subtest21of10,pubtest22of100,1,321,5535,58,234,5827
subtest26of10,pubtest22of100,1,321,5535,63,272,5870
subtest22of10,pubtest22of100,1,321,5535,64,311,5910
subtest210of10,pubtest22of100,1,321,5535,64,350,5949
subtest23of10,pubtest23of100,1,321,5251,7,39,5297
subtest29of10,pubtest23of100,1,321,5251,12,73,5336
subtest28of10,pubtest23of100,1,321,5251,12,113,5376
subtest27of10,pubtest23of100,1,321,5251,17,148,5416
subtest24of10,pubtest23of100,1,321,5251,17,188,5456
subtest25of10,pubtest23of100,1,321,5251,20,225,5496
subtest26of10,pubtest23of100,1,321,5251,21,264,5536
subtest21of10,pubtest23of100,1,321,5251,22,304,5577
subtest22of10,pubtest23of100,1,321,5251,23,342,5616
subtest210of10,pubtest23of100,1,321,5251,23,382,5656
subtest23of10,pubtest24of100,1,321,5261,14,43,5318
subtest25of10,pubtest24of100,1,321,5261,15,82,5358
subtest24of10,pubtest24of100,1,321,5261,14,121,5396
subtest28of10,pubtest24of100,1,321,5261,17,160,5438
subtest21of10,pubtest24of100,1,321,5261,19,198,5478
subtest29of10,pubtest24of100,1,321,5261,27,229,5517
subtest27of10,pubtest24of100,1,321,5261,35,261,5557
subtest22of10,pubtest24of100,1,321,5261,35,300,5596
subtest210of10,pubtest24of100,1,321,5261,36,340,5637
subtest26of10,pubtest24of100,1,321,5261,40,375,5676
subtest21of10,pubtest25of100,1,321,5171,9,41,5221
subtest25of10,pubtest25of100,1,321,5171,10,80,5261
subtest27of10,pubtest25of100,1,321,5171,9,119,5299
subtest23of10,pubtest25of100,1,321,5171,13,156,5340
subtest28of10,pubtest25of100,1,321,5171,29,180,5380
subtest29of10,pubtest25of100,1,321,5171,27,222,5420
subtest210of10,pubtest25of100,1,321,5171,31,258,5460
subtest26of10,pubtest25of100,1,321,5171,32,297,5500
subtest22of10,pubtest25of100,1,321,5171,33,336,5540
subtest24of10,pubtest25of100,1,321,5171,33,376,5580
subtest21of10,pubtest26of100,1,321,5287,18,47,5352
subtest22of10,pubtest26of100,1,321,5287,20,87,5394
subtest29of10,pubtest26of100,1,321,5287,21,126,5434
subtest23of10,pubtest26of100,1,321,5287,25,161,5473
subtest27of10,pubtest26of100,1,321,5287,26,200,5513
subtest26of10,pubtest26of100,1,321,5287,27,240,5554
subtest210of10,pubtest26of100,1,321,5287,28,278,5593
subtest28of10,pubtest26of100,1,321,5287,28,319,5634
subtest25of10,pubtest26of100,1,321,5287,29,357,5673
subtest24of10,pubtest26of100,1,321,5287,30,396,5713
subtest27of10,pubtest27of100,1,320,5315,9,73,5397
subtest28of10,pubtest27of100,1,320,5315,15,104,5434
subtest23of10,pubtest27of100,1,320,5315,18,141,5474
subtest24of10,pubtest27of100,1,320,5315,20,178,5513
subtest29of10,pubtest27of100,1,320,5315,23,215,5553
subtest210of10,pubtest27of100,1,320,5315,24,251,5590
subtest25of10,pubtest27of100,1,320,5315,28,290,5633
subtest21of10,pubtest27of100,1,320,5315,27,330,5672
subtest22of10,pubtest27of100,1,320,5315,27,369,5711
subtest26of10,pubtest27of100,1,320,5315,30,408,5753
subtest21of10,pubtest28of100,1,321,5202,14,49,5265
subtest27of10,pubtest28of100,1,321,5202,14,88,5304
subtest29of10,pubtest28of100,1,321,5202,18,124,5344
subtest25of10,pubtest28of100,1,321,5202,20,164,5386
subtest210of10,pubtest28of100,1,321,5202,21,202,5425
subtest26of10,pubtest28of100,1,321,5202,23,239,5464
subtest23of10,pubtest28of100,1,321,5202,23,279,5504
subtest28of10,pubtest28of100,1,321,5202,24,317,5543
subtest24of10,pubtest28of100,1,321,5202,35,347,5584
subtest22of10,pubtest28of100,1,321,5202,41,381,5624
subtest29of10,pubtest29of100,1,321,5288,7,39,5334
subtest23of10,pubtest29of100,1,321,5288,7,78,5373
subtest210of10,pubtest29of100,1,321,5288,10,116,5414
subtest22of10,pubtest29of100,1,321,5288,17,149,5454
subtest25of10,pubtest29of100,1,321,5288,23,183,5494
subtest24of10,pubtest29of100,1,321,5288,24,222,5534
subtest28of10,pubtest29of100,1,321,5288,23,261,5572
subtest21of10,pubtest29of100,1,321,5288,23,299,5610
subtest27of10,pubtest29of100,1,321,5288,26,339,5653
subtest26of10,pubtest29of100,1,321,5288,29,377,5694
subtest29of10,pubtest210of100,1,323,5323,6,71,5400
subtest21of10,pubtest210of100,1,323,5323,15,102,5440
subtest27of10,pubtest210of100,1,323,5323,15,79,5417
subtest210of10,pubtest210of100,1,323,5323,78,118,5519
subtest22of10,pubtest210of100,1,323,5323,79,157,5559
subtest25of10,pubtest210of100,1,323,5323,80,196,5599
subtest23of10,pubtest210of100,1,323,5323,80,236,5639
subtest24of10,pubtest210of100,1,323,5323,80,275,5678
subtest28of10,pubtest210of100,1,323,5323,82,316,5721
subtest26of10,pubtest210of100,1,323,5323,81,353,5757
subtest210of10,pubtest211of100,1,323,5223,3,44,5270
subtest24of10,pubtest211of100,1,323,5223,4,84,5311
subtest22of10,pubtest211of100,1,323,5223,9,119,5351
subtest29of10,pubtest211of100,1,323,5223,9,159,5391
subtest26of10,pubtest211of100,1,323,5223,11,197,5431
subtest21of10,pubtest211of100,1,323,5223,18,230,5471
subtest25of10,pubtest211of100,1,323,5223,28,260,5511
subtest23of10,pubtest211of100,1,323,5223,29,299,5551
subtest28of10,pubtest211of100,1,323,5223,30,338,5591
subtest27of10,pubtest211of100,1,323,5223,35,371,5629
subtest25of10,pubtest212of100,1,323,5157,8,43,5208
subtest29of10,pubtest212of100,1,323,5157,11,79,5247
subtest28of10,pubtest212of100,1,323,5157,15,115,5287
subtest27of10,pubtest212of100,1,323,5157,18,152,5327
subtest24of10,pubtest212of100,1,323,5157,16,192,5365
subtest23of10,pubtest212of100,1,323,5157,16,231,5404
subtest21of10,pubtest212of100,1,323,5157,20,270,5447
subtest26of10,pubtest212of100,1,323,5157,30,300,5487
subtest22of10,pubtest212of100,1,323,5157,30,340,5527
subtest210of10,pubtest212of100,1,323,5157,35,376,5568
subtest23of10,pubtest213of100,1,322,5788,10,38,5836
subtest26of10,pubtest213of100,1,322,5788,11,76,5875
subtest29of10,pubtest213of100,1,322,5788,12,115,5915
subtest27of10,pubtest213of100,1,322,5788,17,150,5955
subtest22of10,pubtest213of100,1,322,5788,17,190,5995
subtest24of10,pubtest213of100,1,322,5788,19,227,6034
subtest210of10,pubtest213of100,1,322,5788,20,267,6075
subtest21of10,pubtest213of100,1,322,5788,27,300,6115
subtest25of10,pubtest213of100,1,322,5788,30,337,6155
subtest28of10,pubtest213of100,1,322,5788,33,374,6195
subtest21of10,pubtest214of100,1,323,5285,9,40,5334
subtest23of10,pubtest214of100,1,323,5285,12,76,5373
subtest25of10,pubtest214of100,1,323,5285,13,115,5413
subtest26of10,pubtest214of100,1,323,5285,13,155,5453
subtest27of10,pubtest214of100,1,323,5285,18,190,5493
subtest22of10,pubtest214of100,1,323,5285,19,229,5533
subtest29of10,pubtest214of100,1,323,5285,25,263,5573
subtest210of10,pubtest214of100,1,323,5285,26,302,5613
subtest24of10,pubtest214of100,1,323,5285,28,340,5653
subtest28of10,pubtest214of100,1,323,5285,30,380,5695
subtest27of10,pubtest215of100,1,323,5358,11,267,5636
subtest24of10,pubtest215of100,1,323,5358,11,308,5677
subtest29of10,pubtest215of100,1,323,5358,19,339,5716
subtest26of10,pubtest215of100,1,323,5358,20,378,5756
subtest21of10,pubtest215of100,1,323,5358,21,417,5796
subtest25of10,pubtest215of100,1,323,5358,26,452,5836
subtest210of10,pubtest215of100,1,323,5358,26,491,5875
subtest23of10,pubtest215of100,1,323,5358,28,531,5917
subtest22of10,pubtest215of100,1,323,5358,29,567,5954
subtest28of10,pubtest215of100,1,323,5358,32,606,5996
subtest24of10,pubtest216of100,1,323,5261,10,46,5317
subtest21of10,pubtest216of100,1,323,5261,10,85,5356
subtest23of10,pubtest216of100,1,323,5261,12,122,5395
subtest27of10,pubtest216of100,1,323,5261,17,154,5432
subtest25of10,pubtest216of100,1,323,5261,20,194,5475
subtest22of10,pubtest216of100,1,323,5261,22,232,5515
subtest29of10,pubtest216of100,1,323,5261,23,271,5555
subtest26of10,pubtest216of100,1,323,5261,23,311,5595
subtest28of10,pubtest216of100,1,323,5261,17,349,5627
subtest210of10,pubtest216of100,1,323,5261,66,348,5675
subtest27of10,pubtest217of100,1,322,5274,13,40,5327
subtest26of10,pubtest217of100,1,322,5274,15,78,5367
subtest21of10,pubtest217of100,1,322,5274,15,117,5406
subtest23of10,pubtest217of100,1,322,5274,17,155,5446
subtest25of10,pubtest217of100,1,322,5274,18,194,5486
subtest29of10,pubtest217of100,1,322,5274,18,234,5526
subtest22of10,pubtest217of100,1,322,5274,14,273,5561
subtest28of10,pubtest217of100,1,322,5274,19,313,5606
subtest24of10,pubtest217of100,1,322,5274,19,350,5643
subtest210of10,pubtest217of100,1,322,5274,21,389,5684
subtest29of10,pubtest218of100,1,323,5288,7,39,5334
subtest22of10,pubtest218of100,1,323,5288,7,78,5373
subtest21of10,pubtest218of100,1,323,5288,13,113,5414
subtest27of10,pubtest218of100,1,323,5288,18,146,5452
subtest23of10,pubtest218of100,1,323,5288,23,182,5493
subtest25of10,pubtest218of100,1,323,5288,23,221,5532
subtest24of10,pubtest218of100,1,323,5288,24,262,5574
subtest210of10,pubtest218of100,1,323,5288,25,299,5612
subtest26of10,pubtest218of100,1,323,5288,26,339,5653
subtest28of10,pubtest218of100,1,323,5288,23,378,5689
subtest210of10,pubtest219of100,1,323,5224,7,40,5271
subtest26of10,pubtest219of100,1,323,5224,11,75,5310
subtest25of10,pubtest219of100,1,323,5224,12,113,5349
subtest21of10,pubtest219of100,1,323,5224,17,149,5390
subtest22of10,pubtest219of100,1,323,5224,20,185,5429
subtest24of10,pubtest219of100,1,323,5224,23,222,5469
subtest29of10,pubtest219of100,1,323,5224,23,262,5509
subtest27of10,pubtest219of100,1,323,5224,27,298,5549
subtest23of10,pubtest219of100,1,323,5224,27,338,5589
subtest28of10,pubtest219of100,1,323,5224,24,379,5627
subtest210of10,pubtest220of100,1,323,5224,11,38,5273
subtest25of10,pubtest220of100,1,323,5224,10,79,5313
subtest23of10,pubtest220of100,1,323,5224,12,116,5352
subtest21of10,pubtest220of100,1,323,5224,47,122,5393
subtest29of10,pubtest220of100,1,323,5224,47,162,5433
subtest24of10,pubtest220of100,1,323,5224,49,198,5471
subtest27of10,pubtest220of100,1,323,5224,51,239,5514
subtest26of10,pubtest220of100,1,323,5224,52,277,5553
subtest28of10,pubtest220of100,1,323,5224,53,315,5592
subtest22of10,pubtest220of100,1,323,5224,54,354,5632
subtest24of10,pubtest221of100,1,323,5278,6,43,5327
subtest21of10,pubtest221of100,1,323,5278,16,71,5365
subtest23of10,pubtest221of100,1,323,5278,17,110,5405
subtest22of10,pubtest221of100,1,323,5278,18,149,5445
subtest210of10,pubtest221of100,1,323,5278,20,184,5482
subtest27of10,pubtest221of100,1,323,5278,23,224,5525
subtest26of10,pubtest221of100,1,323,5278,23,263,5564
subtest25of10,pubtest221of100,1,323,5278,20,303,5601
subtest28of10,pubtest221of100,1,323,5278,17,342,5637
subtest29of10,pubtest221of100,1,323,5278,26,381,5685
subtest21of10,pubtest222of100,1,323,5257,14,44,5315
subtest22of10,pubtest222of100,1,323,5257,16,83,5356
subtest29of10,pubtest222of100,1,323,5257,17,121,5395
subtest27of10,pubtest222of100,1,323,5257,19,159,5435
subtest28of10,pubtest222of100,1,323,5257,21,197,5475
subtest210of10,pubtest222of100,1,323,5257,26,232,5515
subtest23of10,pubtest222of100,1,323,5257,26,273,5556
subtest25of10,pubtest222of100,1,323,5257,28,310,5595
subtest26of10,pubtest222of100,1,323,5257,28,350,5635
subtest24of10,pubtest222of100,1,323,5257,32,384,5673
subtest21of10,pubtest223of100,1,323,5186,19,509,5714
subtest23of10,pubtest223of100,1,323,5186,19,549,5754
subtest28of10,pubtest223of100,1,323,5186,21,588,5795
subtest25of10,pubtest223of100,1,323,5186,26,623,5835
subtest27of10,pubtest223of100,1,323,5186,27,662,5875
subtest29of10,pubtest223of100,1,323,5186,28,700,5914
subtest24of10,pubtest223of100,1,323,5186,28,740,5954
subtest210of10,pubtest223of100,1,323,5186,31,777,5994
subtest22of10,pubtest223of100,1,323,5186,37,813,6036
subtest26of10,pubtest223of100,1,323,5186,41,847,6074
subtest21of10,pubtest224of100,1,323,5221,6,48,5275
subtest28of10,pubtest224of100,1,323,5221,8,83,5312
subtest27of10,pubtest224of100,1,323,5221,8,122,5351
subtest23of10,pubtest224of100,1,323,5221,9,161,5391
subtest26of10,pubtest224of100,1,323,5221,16,194,5431
subtest29of10,pubtest224of100,1,323,5221,16,234,5471
subtest25of10,pubtest224of100,1,323,5221,17,273,5511
subtest22of10,pubtest224of100,1,323,5221,20,310,5551
subtest24of10,pubtest224of100,1,323,5221,25,345,5591
subtest210of10,pubtest224of100,1,323,5221,25,385,5631
subtest27of10,pubtest225of100,1,323,5234,7,38,5279
subtest22of10,pubtest225of100,1,323,5234,11,74,5319
subtest21of10,pubtest225of100,1,323,5234,13,111,5358
subtest25of10,pubtest225of100,1,323,5234,19,145,5398
subtest26of10,pubtest225of100,1,323,5234,19,185,5438
subtest24of10,pubtest225of100,1,323,5234,53,191,5478
subtest23of10,pubtest225of100,1,323,5234,55,229,5518
subtest28of10,pubtest225of100,1,323,5234,54,270,5558
subtest29of10,pubtest225of100,1,323,5234,56,308,5598
subtest210of10,pubtest225of100,1,323,5234,57,347,5638
subtest25of10,pubtest226of100,1,323,5278,11,43,5332
subtest22of10,pubtest226of100,1,323,5278,12,80,5370
subtest210of10,pubtest226of100,1,323,5278,15,119,5412
subtest23of10,pubtest226of100,1,323,5278,14,158,5450
subtest27of10,pubtest226of100,1,323,5278,19,194,5491
subtest29of10,pubtest226of100,1,323,5278,21,232,5531
subtest21of10,pubtest226of100,1,323,5278,21,270,5569
subtest26of10,pubtest226of100,1,323,5278,22,310,5610
subtest24of10,pubtest226of100,1,323,5278,24,349,5651
subtest28of10,pubtest226of100,1,323,5278,20,388,5686
subtest29of10,pubtest227of100,1,323,5326,7,43,5376
subtest25of10,pubtest227of100,1,323,5326,14,76,5416
subtest210of10,pubtest227of100,1,323,5326,14,116,5456
subtest27of10,pubtest227of100,1,323,5326,19,151,5496
subtest24of10,pubtest227of100,1,323,5326,19,191,5536
subtest21of10,pubtest227of100,1,323,5326,21,227,5574
subtest23of10,pubtest227of100,1,323,5326,19,267,5612
subtest22of10,pubtest227of100,1,323,5326,22,306,5654
subtest26of10,pubtest227of100,1,323,5326,21,345,5692
subtest28of10,pubtest227of100,1,323,5326,23,384,5733
subtest21of10,pubtest228of100,1,323,5278,6,40,5324
subtest26of10,pubtest228of100,1,323,5278,15,70,5363
subtest25of10,pubtest228of100,1,323,5278,17,106,5401
subtest23of10,pubtest228of100,1,323,5278,23,142,5443
subtest27of10,pubtest228of100,1,323,5278,25,182,5485
subtest29of10,pubtest228of100,1,323,5278,26,220,5524
subtest24of10,pubtest228of100,1,323,5278,27,258,5563
subtest210of10,pubtest228of100,1,323,5278,28,297,5603
subtest22of10,pubtest228of100,1,323,5278,32,333,5643
subtest28of10,pubtest228of100,1,323,5278,32,373,5683
subtest24of10,pubtest229of100,1,321,5308,5,40,5353
subtest28of10,pubtest229of100,1,321,5308,6,79,5393
subtest21of10,pubtest229of100,1,321,5308,7,117,5432
subtest22of10,pubtest229of100,1,321,5308,9,156,5473
subtest210of10,pubtest229of100,1,321,5308,16,189,5513
subtest27of10,pubtest229of100,1,321,5308,18,227,5553
subtest23of10,pubtest229of100,1,321,5308,19,266,5593
subtest26of10,pubtest229of100,1,321,5308,19,304,5631
subtest29of10,pubtest229of100,1,321,5308,23,341,5672
subtest25of10,pubtest229of100,1,321,5308,23,381,5712
subtest22of10,pubtest230of100,1,323,5167,7,38,5212
subtest21of10,pubtest230of100,1,323,5167,15,69,5251
subtest28of10,pubtest230of100,1,323,5167,19,105,5291
subtest27of10,pubtest230of100,1,323,5167,20,142,5329
subtest29of10,pubtest230of100,1,323,5167,22,182,5371
subtest25of10,pubtest230of100,1,323,5167,25,218,5410
subtest210of10,pubtest230of100,1,323,5167,26,258,5451
subtest23of10,pubtest230of100,1,323,5167,25,299,5491
subtest24of10,pubtest230of100,1,323,5167,27,338,5532
subtest26of10,pubtest230of100,1,323,5167,35,369,5571
subtest23of10,pubtest231of100,1,323,5227,8,41,5276
subtest25of10,pubtest231of100,1,323,5227,9,81,5317
subtest28of10,pubtest231of100,1,323,5227,10,119,5356
subtest24of10,pubtest231of100,1,323,5227,19,150,5396
subtest29of10,pubtest231of100,1,323,5227,20,189,5436
subtest210of10,pubtest231of100,1,323,5227,21,228,5476
subtest27of10,pubtest231of100,1,323,5227,21,268,5516
subtest21of10,pubtest231of100,1,323,5227,23,305,5555
subtest26of10,pubtest231of100,1,323,5227,23,345,5595
subtest22of10,pubtest231of100,1,323,5227,27,382,5636
subtest21of10,pubtest232of100,1,323,5322,9,40,5371
subtest22of10,pubtest232of100,1,323,5322,10,78,5410
subtest23of10,pubtest232of100,1,323,5322,12,116,5450
subtest27of10,pubtest232of100,1,323,5322,12,155,5489
subtest29of10,pubtest232of100,1,323,5322,19,189,5530
subtest28of10,pubtest232of100,1,323,5322,18,230,5570
subtest210of10,pubtest232of100,1,323,5322,20,268,5610
subtest25of10,pubtest232of100,1,323,5322,21,307,5650
subtest24of10,pubtest232of100,1,323,5322,46,322,5690
subtest26of10,pubtest232of100,1,323,5322,47,361,5730
subtest24of10,pubtest233of100,1,323,5304,13,39,5356
subtest29of10,pubtest233of100,1,323,5304,15,77,5396
subtest25of10,pubtest233of100,1,323,5304,16,117,5437
subtest210of10,pubtest233of100,1,323,5304,18,154,5476
subtest28of10,pubtest233of100,1,323,5304,18,194,5516
subtest22of10,pubtest233of100,1,323,5304,19,233,5556
subtest26of10,pubtest233of100,1,323,5304,19,273,5596
subtest27of10,pubtest233of100,1,323,5304,17,312,5633
subtest23of10,pubtest233of100,1,323,5304,24,348,5676
subtest21of10,pubtest233of100,1,323,5304,30,382,5716
subtest25of10,pubtest234of100,1,323,5263,7,42,5312
subtest26of10,pubtest234of100,1,323,5263,8,79,5350
subtest27of10,pubtest234of100,1,323,5263,10,118,5391
subtest21of10,pubtest234of100,1,323,5263,11,157,5431
subtest29of10,pubtest234of100,1,323,5263,15,193,5471
subtest210of10,pubtest234of100,1,323,5263,19,229,5511
subtest23of10,pubtest234of100,1,323,5263,19,269,5551
subtest22of10,pubtest234of100,1,323,5263,16,308,5587
subtest24of10,pubtest234of100,1,323,5263,21,347,5631
subtest28of10,pubtest234of100,1,323,5263,21,387,5671
subtest21of10,pubtest235of100,1,321,5155,9,38,5202
subtest210of10,pubtest235of100,1,321,5155,12,74,5241
subtest22of10,pubtest235of100,1,321,5155,13,113,5281
subtest23of10,pubtest235of100,1,321,5155,12,153,5320
subtest27of10,pubtest235of100,1,321,5155,24,182,5361
subtest29of10,pubtest235of100,1,321,5155,28,219,5402
subtest25of10,pubtest235of100,1,321,5155,28,258,5441
subtest24of10,pubtest235of100,1,321,5155,32,294,5481
subtest26of10,pubtest235of100,1,321,5155,41,325,5521
subtest28of10,pubtest235of100,1,321,5155,42,364,5561
subtest210of10,pubtest236of100,1,323,5268,9,42,5319
subtest23of10,pubtest236of100,1,323,5268,10,79,5357
subtest25of10,pubtest236of100,1,323,5268,13,117,5398
subtest27of10,pubtest236of100,1,323,5268,14,156,5438
subtest28of10,pubtest236of100,1,323,5268,14,196,5478
subtest21of10,pubtest236of100,1,323,5268,16,233,5517
subtest24of10,pubtest236of100,1,323,5268,16,273,5557
subtest22of10,pubtest236of100,1,323,5268,19,311,5598
subtest26of10,pubtest236of100,1,323,5268,19,351,5638
subtest29of10,pubtest236of100,1,323,5268,18,390,5676
subtest24of10,pubtest237of100,1,323,5207,10,38,5255
subtest23of10,pubtest237of100,1,323,5207,10,78,5295
subtest25of10,pubtest237of100,1,323,5207,12,116,5335
subtest28of10,pubtest237of100,1,323,5207,13,156,5376
subtest27of10,pubtest237of100,1,323,5207,15,192,5414
subtest26of10,pubtest237of100,1,323,5207,63,185,5455
subtest21of10,pubtest237of100,1,323,5207,64,224,5495
subtest22of10,pubtest237of100,1,323,5207,66,261,5534
subtest29of10,pubtest237of100,1,323,5207,67,300,5574
subtest210of10,pubtest237of100,1,323,5207,68,340,5615
subtest29of10,pubtest238of100,1,323,5476,8,46,5530
subtest22of10,pubtest238of100,1,323,5476,8,84,5568
subtest27of10,pubtest238of100,1,323,5476,12,120,5608
subtest25of10,pubtest238of100,1,323,5476,14,158,5648
subtest28of10,pubtest238of100,1,323,5476,16,196,5688
subtest23of10,pubtest238of100,1,323,5476,16,234,5726
subtest210of10,pubtest238of100,1,323,5476,18,274,5768
subtest21of10,pubtest238of100,1,323,5476,19,310,5805
subtest26of10,pubtest238of100,1,323,5476,20,351,5847
subtest24of10,pubtest238of100,1,323,5476,28,384,5888
subtest21of10,pubtest239of100,1,323,5193,10,381,5584
subtest28of10,pubtest239of100,1,323,5193,11,419,5623
subtest27of10,pubtest239of100,1,323,5193,13,456,5662
subtest25of10,pubtest239of100,1,323,5193,15,494,5702
subtest26of10,pubtest239of100,1,323,5193,22,527,5742
subtest24of10,pubtest239of100,1,323,5193,22,565,5780
subtest29of10,pubtest239of100,1,323,5193,25,604,5822
subtest23of10,pubtest239of100,1,323,5193,36,633,5862
subtest22of10,pubtest239of100,1,323,5193,37,672,5902
subtest210of10,pubtest239of100,1,323,5193,38,711,5942
subtest25of10,pubtest240of100,1,323,5325,7,39,5371
subtest21of10,pubtest240of100,1,323,5325,8,77,5410
subtest210of10,pubtest240of100,1,323,5325,11,114,5450
subtest29of10,pubtest240of100,1,323,5325,13,152,5490
subtest28of10,pubtest240of100,1,323,5325,14,191,5530
subtest27of10,pubtest240of100,1,323,5325,15,230,5570
subtest23of10,pubtest240of100,1,323,5325,17,268,5610
subtest24of10,pubtest240of100,1,323,5325,17,308,5650
subtest22of10,pubtest240of100,1,323,5325,19,346,5690
subtest26of10,pubtest240of100,1,323,5325,22,383,5730
subtest23of10,pubtest241of100,1,323,5341,10,459,5810
subtest27of10,pubtest241of100,1,323,5341,10,459,5810
subtest24of10,pubtest241of100,1,323,5341,7,502,5850
subtest210of10,pubtest241of100,1,323,5341,15,533,5889
subtest21of10,pubtest241of100,1,323,5341,19,569,5929
subtest29of10,pubtest241of100,1,323,5341,22,606,5969
subtest25of10,pubtest241of100,1,323,5341,27,642,6010
subtest28of10,pubtest241of100,1,323,5341,29,679,6049
subtest26of10,pubtest241of100,1,323,5341,29,719,6089
subtest22of10,pubtest241of100,1,323,5341,30,758,6129
subtest27of10,pubtest242of100,1,323,5225,7,41,5273
subtest23of10,pubtest242of100,1,323,5225,9,78,5312
subtest26of10,pubtest242of100,1,323,5225,10,118,5353
subtest25of10,pubtest242of100,1,323,5225,11,156,5392
subtest210of10,pubtest242of100,1,323,5225,26,181,5432
subtest29of10,pubtest242of100,1,323,5225,29,218,5472
subtest22of10,pubtest242of100,1,323,5225,31,256,5512
subtest21of10,pubtest242of100,1,323,5225,31,296,5552
subtest24of10,pubtest242of100,1,323,5225,33,334,5592
subtest28of10,pubtest242of100,1,323,5225,33,374,5632
subtest28of10,pubtest243of100,1,323,5165,7,39,5211
subtest29of10,pubtest243of100,1,323,5165,12,73,5250
subtest22of10,pubtest243of100,1,323,5165,18,107,5290
subtest23of10,pubtest243of100,1,323,5165,20,146,5331
subtest26of10,pubtest243of100,1,323,5165,19,185,5369
subtest24of10,pubtest243of100,1,323,5165,21,224,5410
subtest25of10,pubtest243of100,1,323,5165,22,261,5448
subtest27of10,pubtest243of100,1,323,5165,24,301,5490
subtest21of10,pubtest243of100,1,323,5165,30,335,5530
subtest210of10,pubtest243of100,1,323,5165,31,374,5570
subtest27of10,pubtest244of100,1,323,5170,9,38,5217
subtest25of10,pubtest244of100,1,323,5170,14,71,5255
subtest29of10,pubtest244of100,1,323,5170,15,111,5296
subtest26of10,pubtest244of100,1,323,5170,16,148,5334
subtest21of10,pubtest244of100,1,323,5170,20,186,5376
subtest23of10,pubtest244of100,1,323,5170,20,226,5416
subtest22of10,pubtest244of100,1,323,5170,22,264,5456
subtest24of10,pubtest244of100,1,323,5170,21,304,5495
subtest28of10,pubtest244of100,1,323,5170,21,343,5534
subtest210of10,pubtest244of100,1,323,5170,23,383,5576
subtest29of10,pubtest245of100,1,322,5322,6,40,5368
subtest26of10,pubtest245of100,1,322,5322,7,80,5409
subtest23of10,pubtest245of100,1,322,5322,10,118,5450
subtest22of10,pubtest245of100,1,322,5322,16,151,5489
subtest25of10,pubtest245of100,1,322,5322,16,191,5529
subtest24of10,pubtest245of100,1,322,5322,18,230,5570
subtest28of10,pubtest245of100,1,322,5322,22,265,5609
subtest21of10,pubtest245of100,1,322,5322,23,304,5649
subtest27of10,pubtest245of100,1,322,5322,24,343,5689
subtest210of10,pubtest245of100,1,322,5322,25,383,5730
subtest26of10,pubtest246of100,1,323,5157,4,45,5206
subtest27of10,pubtest246of100,1,323,5157,6,80,5243
subtest21of10,pubtest246of100,1,323,5157,8,118,5283
subtest29of10,pubtest246of100,1,323,5157,12,154,5323
subtest28of10,pubtest246of100,1,323,5157,15,191,5363
subtest23of10,pubtest246of100,1,323,5157,16,230,5403
subtest25of10,pubtest246of100,1,323,5157,28,258,5443
subtest210of10,pubtest246of100,1,323,5157,28,298,5483
subtest24of10,pubtest246of100,1,323,5157,31,335,5523
subtest22of10,pubtest246of100,1,323,5157,38,368,5563
subtest27of10,pubtest247of100,1,323,5676,9,40,5725
subtest23of10,pubtest247of100,1,323,5676,17,71,5764
subtest26of10,pubtest247of100,1,323,5676,17,111,5804
subtest22of10,pubtest247of100,1,323,5676,19,149,5844
subtest21of10,pubtest247of100,1,323,5676,19,190,5885
subtest29of10,pubtest247of100,1,323,5676,23,225,5924
subtest25of10,pubtest247of100,1,323,5676,26,262,5964
subtest28of10,pubtest247of100,1,323,5676,26,302,6004
subtest210of10,pubtest247of100,1,323,5676,29,339,6044
subtest24of10,pubtest247of100,1,323,5676,29,379,6084
subtest29of10,pubtest248of100,1,323,5180,10,48,5238
subtest26of10,pubtest248of100,1,323,5180,12,85,5277
subtest25of10,pubtest248of100,1,323,5180,14,124,5318
subtest23of10,pubtest248of100,1,323,5180,20,157,5357
subtest28of10,pubtest248of100,1,323,5180,31,186,5397
subtest24of10,pubtest248of100,1,323,5180,43,214,5437
subtest21of10,pubtest248of100,1,323,5180,44,253,5477
subtest210of10,pubtest248of100,1,323,5180,45,292,5517
subtest22of10,pubtest248of100,1,323,5180,45,332,5557
subtest27of10,pubtest248of100,1,323,5180,42,371,5593
subtest27of10,pubtest249of100,1,323,5228,17,44,5289
subtest29of10,pubtest249of100,1,323,5228,20,82,5330
subtest21of10,pubtest249of100,1,323,5228,22,121,5371
subtest25of10,pubtest249of100,1,323,5228,19,163,5410
subtest23of10,pubtest249of100,1,323,5228,24,199,5451
subtest24of10,pubtest249of100,1,323,5228,36,226,5490
subtest28of10,pubtest249of100,1,323,5228,36,266,5530
subtest26of10,pubtest249of100,1,323,5228,41,301,5570
subtest22of10,pubtest249of100,1,323,5228,41,341,5610
subtest210of10,pubtest249of100,1,323,5228,44,378,5650
subtest27of10,pubtest250of100,1,323,5163,8,44,5215
subtest23of10,pubtest250of100,1,323,5163,9,84,5256
subtest29of10,pubtest250of100,1,323,5163,19,113,5295
subtest21of10,pubtest250of100,1,323,5163,19,153,5335
subtest24of10,pubtest250of100,1,323,5163,21,191,5375
subtest28of10,pubtest250of100,1,323,5163,21,231,5415
subtest210of10,pubtest250of100,1,323,5163,23,269,5455
subtest25of10,pubtest250of100,1,323,5163,23,308,5494
subtest22of10,pubtest250of100,1,323,5163,27,345,5535
subtest26of10,pubtest250of100,1,323,5163,25,385,5573
subtest23of10,pubtest251of100,1,323,5281,8,42,5331
subtest22of10,pubtest251of100,1,323,5281,9,81,5371
subtest24of10,pubtest251of100,1,323,5281,10,119,5410
subtest28of10,pubtest251of100,1,323,5281,17,152,5450
subtest27of10,pubtest251of100,1,323,5281,17,192,5490
subtest25of10,pubtest251of100,1,323,5281,19,232,5532
subtest210of10,pubtest251of100,1,323,5281,23,266,5570
subtest21of10,pubtest251of100,1,323,5281,26,303,5610
subtest26of10,pubtest251of100,1,323,5281,26,344,5651
subtest29of10,pubtest251of100,1,323,5281,27,382,5690
subtest29of10,pubtest252of100,1,323,5318,8,44,5370
subtest28of10,pubtest252of100,1,323,5318,8,83,5409
subtest21of10,pubtest252of100,1,323,5318,10,119,5447
subtest27of10,pubtest252of100,1,323,5318,13,158,5489
subtest26of10,pubtest252of100,1,323,5318,17,194,5529
subtest25of10,pubtest252of100,1,323,5318,21,230,5569
subtest23of10,pubtest252of100,1,323,5318,22,268,5608
subtest22of10,pubtest252of100,1,323,5318,23,309,5650
subtest210of10,pubtest252of100,1,323,5318,24,347,5689
subtest24of10,pubtest252of100,1,323,5318,25,386,5729
subtest28of10,pubtest253of100,1,322,5264,6,40,5310
subtest23of10,pubtest253of100,1,322,5264,13,72,5349
subtest24of10,pubtest253of100,1,322,5264,13,112,5389
subtest25of10,pubtest253of100,1,322,5264,15,150,5429
subtest29of10,pubtest253of100,1,322,5264,16,189,5469
subtest22of10,pubtest253of100,1,322,5264,17,228,5509
subtest21of10,pubtest253of100,1,322,5264,22,263,5549
subtest210of10,pubtest253of100,1,322,5264,22,303,5589
subtest27of10,pubtest253of100,1,322,5264,22,342,5628
subtest26of10,pubtest253of100,1,322,5264,25,380,5669
subtest210of10,pubtest254of100,1,323,5229,9,41,5279
subtest27of10,pubtest254of100,1,323,5229,13,77,5319
subtest21of10,pubtest254of100,1,323,5229,17,112,5358
subtest28of10,pubtest254of100,1,323,5229,17,151,5397
subtest24of10,pubtest254of100,1,323,5229,22,187,5438
subtest23of10,pubtest254of100,1,323,5229,21,227,5477
subtest25of10,pubtest254of100,1,323,5229,21,264,5514
subtest22of10,pubtest254of100,1,323,5229,26,302,5557
subtest26of10,pubtest254of100,1,323,5229,28,341,5598
subtest29of10,pubtest254of100,1,323,5229,26,381,5636
subtest22of10,pubtest255of100,1,322,5188,11,40,5239
subtest23of10,pubtest255of100,1,322,5188,11,79,5278
subtest27of10,pubtest255of100,1,322,5188,12,116,5316
subtest28of10,pubtest255of100,1,322,5188,15,156,5359
subtest24of10,pubtest255of100,1,322,5188,16,194,5398
subtest21of10,pubtest255of100,1,322,5188,16,234,5438
subtest29of10,pubtest255of100,1,322,5188,17,273,5478
subtest25of10,pubtest255of100,1,322,5188,21,308,5517
subtest210of10,pubtest255of100,1,322,5188,21,348,5557
subtest26of10,pubtest255of100,1,322,5188,29,381,5598
subtest29of10,pubtest256of100,1,323,5270,6,39,5315
subtest21of10,pubtest256of100,1,323,5270,6,78,5354
subtest26of10,pubtest256of100,1,323,5270,8,116,5394
subtest23of10,pubtest256of100,1,323,5270,10,154,5434
subtest210of10,pubtest256of100,1,323,5270,8,194,5472
subtest25of10,pubtest256of100,1,323,5270,11,233,5514
subtest28of10,pubtest256of100,1,323,5270,13,271,5554
subtest27of10,pubtest256of100,1,323,5270,14,310,5594
subtest22of10,pubtest256of100,1,323,5270,18,346,5634
subtest24of10,pubtest256of100,1,323,5270,19,383,5672
subtest21of10,pubtest257of100,1,323,5292,7,45,5344
subtest24of10,pubtest257of100,1,323,5292,8,83,5383
subtest27of10,pubtest257of100,1,323,5292,11,120,5423
subtest23of10,pubtest257of100,1,323,5292,17,155,5464
subtest29of10,pubtest257of100,1,323,5292,17,194,5503
subtest28of10,pubtest257of100,1,323,5292,16,232,5540
subtest25of10,pubtest257of100,1,323,5292,48,243,5583
subtest22of10,pubtest257of100,1,323,5292,50,281,5623
subtest210of10,pubtest257of100,1,323,5292,54,316,5662
subtest26of10,pubtest257of100,1,323,5292,55,357,5704
subtest28of10,pubtest258of100,1,323,5356,7,88,5451
subtest23of10,pubtest258of100,1,323,5356,8,124,5488
subtest25of10,pubtest258of100,1,323,5356,11,162,5529
subtest26of10,pubtest258of100,1,323,5356,13,200,5569
subtest21of10,pubtest258of100,1,323,5356,18,235,5609
subtest29of10,pubtest258of100,1,323,5356,24,270,5650
subtest24of10,pubtest258of100,1,323,5356,26,307,5689
subtest22of10,pubtest258of100,1,323,5356,25,347,5728
subtest210of10,pubtest258of100,1,323,5356,25,386,5767
subtest27of10,pubtest258of100,1,323,5356,24,426,5806
subtest21of10,pubtest259of100,1,323,5255,6,41,5302
subtest28of10,pubtest259of100,1,323,5255,7,80,5342
subtest24of10,pubtest259of100,1,323,5255,8,119,5382
subtest25of10,pubtest259of100,1,323,5255,9,157,5421
subtest26of10,pubtest259of100,1,323,5255,10,197,5462
subtest27of10,pubtest259of100,1,323,5255,15,231,5501
subtest22of10,pubtest259of100,1,323,5255,15,271,5541
subtest23of10,pubtest259of100,1,323,5255,17,307,5579
subtest210of10,pubtest259of100,1,323,5255,19,348,5622
subtest29of10,pubtest259of100,1,323,5255,17,386,5658
subtest210of10,pubtest260of100,1,323,5184,7,362,5553
subtest23of10,pubtest260of100,1,323,5184,8,399,5591
subtest21of10,pubtest260of100,1,323,5184,10,437,5631
subtest29of10,pubtest260of100,1,323,5184,12,471,5667
subtest26of10,pubtest260of100,1,323,5184,12,511,5707
subtest22of10,pubtest260of100,1,323,5184,18,549,5751
subtest25of10,pubtest260of100,1,323,5184,18,589,5791
subtest27of10,pubtest260of100,1,323,5184,19,627,5830
subtest28of10,pubtest260of100,1,323,5184,20,667,5871
subtest24of10,pubtest260of100,1,323,5184,23,704,5911
subtest25of10,pubtest261of100,1,323,5372,7,41,5420
subtest29of10,pubtest261of100,1,323,5372,12,75,5459
subtest28of10,pubtest261of100,1,323,5372,12,115,5499
subtest210of10,pubtest261of100,1,323,5372,14,153,5539
subtest22of10,pubtest261of100,1,323,5372,17,190,5579
subtest23of10,pubtest261of100,1,323,5372,17,230,5619
subtest27of10,pubtest261of100,1,323,5372,19,268,5659
subtest21of10,pubtest261of100,1,323,5372,23,304,5699
subtest24of10,pubtest261of100,1,323,5372,26,341,5739
subtest26of10,pubtest261of100,1,323,5372,26,381,5779
subtest21of10,pubtest262of100,1,323,5185,7,39,5231
subtest22of10,pubtest262of100,1,323,5185,8,78,5271
subtest23of10,pubtest262of100,1,323,5185,10,116,5311
subtest26of10,pubtest262of100,1,323,5185,20,146,5351
subtest27of10,pubtest262of100,1,323,5185,20,186,5391
subtest29of10,pubtest262of100,1,323,5185,21,223,5429
subtest210of10,pubtest262of100,1,323,5185,22,262,5469
subtest28of10,pubtest262of100,1,323,5185,24,301,5510
subtest25of10,pubtest262of100,1,323,5185,24,340,5549
subtest24of10,pubtest262of100,1,323,5185,24,380,5589
subtest22of10,pubtest263of100,1,322,5402,8,41,5451
subtest29of10,pubtest263of100,1,322,5402,9,79,5490
subtest24of10,pubtest263of100,1,322,5402,10,116,5528
subtest26of10,pubtest263of100,1,322,5402,12,155,5569
subtest23of10,pubtest263of100,1,322,5402,13,195,5610
subtest25of10,pubtest263of100,1,322,5402,28,220,5650
subtest27of10,pubtest263of100,1,322,5402,28,261,5691
subtest21of10,pubtest263of100,1,322,5402,30,298,5730
subtest28of10,pubtest263of100,1,322,5402,30,338,5770
subtest210of10,pubtest263of100,1,322,5402,31,377,5810
subtest22of10,pubtest264of100,1,322,5303,7,42,5352
subtest29of10,pubtest264of100,1,322,5303,8,81,5392
subtest23of10,pubtest264of100,1,322,5303,10,118,5431
subtest27of10,pubtest264of100,1,322,5303,10,158,5471
subtest24of10,pubtest264of100,1,322,5303,15,193,5511
subtest21of10,pubtest264of100,1,322,5303,21,227,5551
subtest28of10,pubtest264of100,1,322,5303,21,266,5590
subtest25of10,pubtest264of100,1,322,5303,25,303,5631
subtest26of10,pubtest264of100,1,322,5303,56,310,5669
subtest210of10,pubtest264of100,1,322,5303,58,350,5711
subtest26of10,pubtest265of100,1,323,5285,4,40,5329
subtest27of10,pubtest265of100,1,323,5285,8,75,5368
subtest210of10,pubtest265of100,1,323,5285,10,113,5408
subtest22of10,pubtest265of100,1,323,5285,13,150,5448
subtest21of10,pubtest265of100,1,323,5285,17,186,5488
subtest29of10,pubtest265of100,1,323,5285,20,223,5528
subtest25of10,pubtest265of100,1,323,5285,26,257,5568
subtest23of10,pubtest265of100,1,323,5285,30,293,5608
subtest28of10,pubtest265of100,1,323,5285,30,333,5648
subtest24of10,pubtest265of100,1,323,5285,33,370,5688
subtest29of10,pubtest266of100,1,321,5233,7,40,5280
subtest210of10,pubtest266of100,1,321,5233,10,79,5322
subtest25of10,pubtest266of100,1,321,5233,11,117,5361
subtest27of10,pubtest266of100,1,321,5233,12,156,5401
subtest21of10,pubtest266of100,1,321,5233,18,192,5443
subtest23of10,pubtest266of100,1,321,5233,18,231,5482
subtest26of10,pubtest266of100,1,321,5233,19,270,5522
subtest28of10,pubtest266of100,1,321,5233,26,301,5560
subtest24of10,pubtest266of100,1,321,5233,26,342,5601
subtest22of10,pubtest266of100,1,321,5233,28,381,5642
subtest23of10,pubtest267of100,1,323,5352,30,41,5423
subtest26of10,pubtest267of100,1,323,5352,30,80,5462
subtest25of10,pubtest267of100,1,323,5352,34,115,5501
subtest27of10,pubtest267of100,1,323,5352,36,154,5542
subtest28of10,pubtest267of100,1,323,5352,39,192,5583
subtest21of10,pubtest267of100,1,323,5352,44,226,5622
subtest210of10,pubtest267of100,1,323,5352,45,265,5662
subtest24of10,pubtest267of100,1,323,5352,41,305,5698
subtest29of10,pubtest267of100,1,323,5352,40,350,5742
subtest22of10,pubtest267of100,1,323,5352,46,384,5782
subtest23of10,pubtest268of100,1,323,5221,9,41,5271
subtest24of10,pubtest268of100,1,323,5221,10,77,5308
subtest25of10,pubtest268of100,1,323,5221,11,115,5347
subtest28of10,pubtest268of100,1,323,5221,14,155,5390
subtest29of10,pubtest268of100,1,323,5221,15,194,5430
subtest27of10,pubtest268of100,1,323,5221,17,233,5471
subtest21of10,pubtest268of100,1,323,5221,18,271,5510
subtest22of10,pubtest268of100,1,323,5221,25,304,5550
subtest26of10,pubtest268of100,1,323,5221,25,343,5589
subtest210of10,pubtest268of100,1,323,5221,26,382,5629
subtest27of10,pubtest269of100,1,323,5321,6,41,5368
subtest25of10,pubtest269of100,1,323,5321,6,80,5407
subtest21of10,pubtest269of100,1,323,5321,8,118,5447
subtest29of10,pubtest269of100,1,323,5321,9,157,5487
subtest23of10,pubtest269of100,1,323,5321,11,195,5527
subtest24of10,pubtest269of100,1,323,5321,12,235,5568
subtest210of10,pubtest269of100,1,323,5321,13,271,5605
subtest22of10,pubtest269of100,1,323,5321,13,311,5645
subtest26of10,pubtest269of100,1,323,5321,16,350,5687
subtest28of10,pubtest269of100,1,323,5321,21,386,5728
subtest23of10,pubtest270of100,1,323,5276,7,41,5324
subtest27of10,pubtest270of100,1,323,5276,13,74,5363
subtest210of10,pubtest270of100,1,323,5276,15,111,5402
subtest26of10,pubtest270of100,1,323,5276,14,150,5440
subtest29of10,pubtest270of100,1,323,5276,14,189,5479
subtest25of10,pubtest270of100,1,323,5276,17,230,5523
subtest28of10,pubtest270of100,1,323,5276,19,267,5562
subtest21of10,pubtest270of100,1,323,5276,20,308,5604
subtest24of10,pubtest270of100,1,323,5276,24,345,5645
subtest22of10,pubtest270of100,1,323,5276,24,383,5683
subtest24of10,pubtest271of100,1,323,5203,7,40,5250
subtest25of10,pubtest271of100,1,323,5203,8,77,5288
subtest22of10,pubtest271of100,1,323,5203,9,116,5328
subtest27of10,pubtest271of100,1,323,5203,11,154,5368
subtest210of10,pubtest271of100,1,323,5203,16,189,5408
subtest21of10,pubtest271of100,1,323,5203,18,227,5448
subtest23of10,pubtest271of100,1,323,5203,24,261,5488
subtest26of10,pubtest271of100,1,323,5203,24,301,5528
subtest29of10,pubtest271of100,1,323,5203,35,328,5566
subtest28of10,pubtest271of100,1,323,5203,35,368,5606
subtest25of10,pubtest272of100,1,323,5276,6,40,5322
subtest21of10,pubtest272of100,1,323,5276,12,73,5361
subtest26of10,pubtest272of100,1,323,5276,13,113,5402
subtest29of10,pubtest272of100,1,323,5276,14,151,5441
subtest23of10,pubtest272of100,1,323,5276,16,189,5481
subtest24of10,pubtest272of100,1,323,5276,15,228,5519
subtest210of10,pubtest272of100,1,323,5276,19,266,5561
subtest22of10,pubtest272of100,1,323,5276,20,305,5601
subtest28of10,pubtest272of100,1,323,5276,22,344,5642
subtest27of10,pubtest272of100,1,323,5276,20,385,5681
subtest22of10,pubtest273of100,1,321,5214,6,47,5267
subtest29of10,pubtest273of100,1,321,5214,9,84,5307
subtest26of10,pubtest273of100,1,321,5214,12,120,5346
subtest28of10,pubtest273of100,1,321,5214,13,159,5386
subtest25of10,pubtest273of100,1,321,5214,17,196,5427
subtest27of10,pubtest273of100,1,321,5214,22,231,5467
subtest23of10,pubtest273of100,1,321,5214,23,269,5506
subtest210of10,pubtest273of100,1,321,5214,25,307,5546
subtest21of10,pubtest273of100,1,321,5214,25,347,5586
subtest24of10,pubtest273of100,1,321,5214,27,385,5626
subtest26of10,pubtest274of100,1,323,5284,7,40,5331
subtest21of10,pubtest274of100,1,323,5284,7,79,5370
subtest23of10,pubtest274of100,1,323,5284,15,110,5409
subtest22of10,pubtest274of100,1,323,5284,15,149,5448
subtest29of10,pubtest274of100,1,323,5284,17,189,5490
subtest25of10,pubtest274of100,1,323,5284,17,228,5529
subtest28of10,pubtest274of100,1,323,5284,24,261,5569
subtest27of10,pubtest274of100,1,323,5284,24,301,5609
subtest24of10,pubtest274of100,1,323,5284,26,339,5649
subtest210of10,pubtest274of100,1,323,5284,29,376,5689
subtest24of10,pubtest275of100,1,323,5171,9,41,5221
subtest27of10,pubtest275of100,1,323,5171,9,79,5259
subtest29of10,pubtest275of100,1,323,5171,12,119,5302
subtest21of10,pubtest275of100,1,323,5171,19,152,5342
subtest25of10,pubtest275of100,1,323,5171,18,192,5381
subtest22of10,pubtest275of100,1,323,5171,18,231,5420
subtest210of10,pubtest275of100,1,323,5171,24,267,5462
subtest23of10,pubtest275of100,1,323,5171,25,305,5501
subtest26of10,pubtest275of100,1,323,5171,26,345,5542
subtest28of10,pubtest275of100,1,323,5171,29,382,5582
subtest28of10,pubtest276of100,1,323,5152,11,39,5202
subtest21of10,pubtest276of100,1,323,5152,12,77,5241
subtest25of10,pubtest276of100,1,323,5152,17,112,5281
subtest27of10,pubtest276of100,1,323,5152,18,151,5321
subtest24of10,pubtest276of100,1,323,5152,19,188,5359
subtest26of10,pubtest276of100,1,323,5152,20,227,5399
subtest23of10,pubtest276of100,1,323,5152,23,266,5441
subtest210of10,pubtest276of100,1,323,5152,24,305,5481
subtest22of10,pubtest276of100,1,323,5152,25,344,5521
subtest29of10,pubtest276of100,1,323,5152,25,384,5561
subtest22of10,pubtest277of100,1,323,5193,8,39,5240
subtest29of10,pubtest277of100,1,323,5193,11,75,5279
subtest28of10,pubtest277of100,1,323,5193,30,96,5319
subtest24of10,pubtest277of100,1,323,5193,32,134,5359
subtest21of10,pubtest277of100,1,323,5193,31,176,5400
subtest25of10,pubtest277of100,1,323,5193,33,213,5439
subtest27of10,pubtest277of100,1,323,5193,32,253,5478
subtest23of10,pubtest277of100,1,323,5193,37,289,5519
subtest210of10,pubtest277of100,1,323,5193,40,326,5559
subtest26of10,pubtest277of100,1,323,5193,43,365,5601
subtest29of10,pubtest278of100,1,323,5174,19,38,5231
subtest22of10,pubtest278of100,1,323,5174,20,77,5271
subtest28of10,pubtest278of100,1,323,5174,23,112,5309
subtest23of10,pubtest278of100,1,323,5174,24,152,5350
subtest21of10,pubtest278of100,1,323,5174,25,191,5390
subtest27of10,pubtest278of100,1,323,5174,32,224,5430
subtest25of10,pubtest278of100,1,323,5174,40,256,5470
subtest26of10,pubtest278of100,1,323,5174,41,295,5510
subtest210of10,pubtest278of100,1,323,5174,42,334,5550
subtest24of10,pubtest278of100,1,323,5174,43,374,5591
subtest28of10,pubtest279of100,1,323,5259,9,41,5309
subtest25of10,pubtest279of100,1,323,5259,12,77,5348
subtest21of10,pubtest279of100,1,323,5259,13,116,5388
subtest24of10,pubtest279of100,1,323,5259,14,155,5428
subtest22of10,pubtest279of100,1,323,5259,16,194,5469
subtest27of10,pubtest279of100,1,323,5259,15,234,5508
subtest29of10,pubtest279of100,1,323,5259,15,272,5546
subtest23of10,pubtest279of100,1,323,5259,17,313,5589
subtest26of10,pubtest279of100,1,323,5259,18,349,5626
subtest210of10,pubtest279of100,1,323,5259,20,388,5667
subtest27of10,pubtest280of100,1,323,5255,6,42,5303
subtest29of10,pubtest280of100,1,323,5255,11,76,5342
subtest24of10,pubtest280of100,1,323,5255,14,113,5382
subtest21of10,pubtest280of100,1,323,5255,15,152,5422
subtest23of10,pubtest280of100,1,323,5255,19,186,5460
subtest26of10,pubtest280of100,1,323,5255,19,226,5500
subtest210of10,pubtest280of100,1,323,5255,23,264,5542
subtest25of10,pubtest280of100,1,323,5255,23,303,5581
subtest28of10,pubtest280of100,1,323,5255,24,343,5622
subtest22of10,pubtest280of100,1,323,5255,26,381,5662
subtest24of10,pubtest281of100,1,323,5459,6,39,5504
subtest23of10,pubtest281of100,1,323,5459,8,74,5541
subtest27of10,pubtest281of100,1,323,5459,10,114,5583
subtest28of10,pubtest281of100,1,323,5459,11,153,5623
subtest22of10,pubtest281of100,1,323,5459,16,188,5663
subtest25of10,pubtest281of100,1,323,5459,21,223,5703
subtest210of10,pubtest281of100,1,323,5459,25,259,5743
subtest29of10,pubtest281of100,1,323,5459,27,297,5783
subtest21of10,pubtest281of100,1,323,5459,26,338,5823
subtest26of10,pubtest281of100,1,323,5459,29,376,5864
subtest24of10,pubtest282of100,1,323,5198,9,85,5292
subtest23of10,pubtest282of100,1,323,5198,8,123,5329
subtest21of10,pubtest282of100,1,323,5198,10,161,5369
subtest22of10,pubtest282of100,1,323,5198,12,199,5409
subtest25of10,pubtest282of100,1,323,5198,12,239,5449
subtest26of10,pubtest282of100,1,323,5198,36,255,5489
subtest29of10,pubtest282of100,1,323,5198,37,294,5529
subtest210of10,pubtest282of100,1,323,5198,38,333,5569
subtest27of10,pubtest282of100,1,323,5198,39,372,5609
subtest28of10,pubtest282of100,1,323,5198,43,408,5649
subtest24of10,pubtest283of100,1,323,5369,9,41,5419
subtest27of10,pubtest283of100,1,323,5369,10,80,5459
subtest22of10,pubtest283of100,1,323,5369,11,119,5499
subtest23of10,pubtest283of100,1,323,5369,12,158,5539
subtest28of10,pubtest283of100,1,323,5369,27,183,5579
subtest210of10,pubtest283of100,1,323,5369,28,219,5616
subtest26of10,pubtest283of100,1,323,5369,29,259,5657
subtest29of10,pubtest283of100,1,323,5369,28,299,5696
subtest25of10,pubtest283of100,1,323,5369,32,338,5739
subtest21of10,pubtest283of100,1,323,5369,33,378,5780
subtest25of10,pubtest284of100,1,323,5232,7,39,5278
subtest22of10,pubtest284of100,1,323,5232,7,78,5317
subtest210of10,pubtest284of100,1,323,5232,11,115,5358
subtest29of10,pubtest284of100,1,323,5232,14,148,5394
subtest27of10,pubtest284of100,1,323,5232,16,189,5437
subtest23of10,pubtest284of100,1,323,5232,16,228,5476
subtest24of10,pubtest284of100,1,323,5232,21,265,5518
subtest21of10,pubtest284of100,1,323,5232,22,303,5557
subtest26of10,pubtest284of100,1,323,5232,23,343,5598
subtest28of10,pubtest284of100,1,323,5232,22,382,5636
subtest23of10,pubtest285of100,1,323,5230,7,41,5278
subtest25of10,pubtest285of100,1,323,5230,11,77,5318
subtest24of10,pubtest285of100,1,323,5230,12,116,5358
subtest27of10,pubtest285of100,1,323,5230,13,155,5398
subtest22of10,pubtest285of100,1,323,5230,18,190,5438
subtest21of10,pubtest285of100,1,323,5230,21,229,5480
subtest28of10,pubtest285of100,1,323,5230,21,268,5519
subtest29of10,pubtest285of100,1,323,5230,21,306,5557
subtest210of10,pubtest285of100,1,323,5230,24,344,5598
subtest26of10,pubtest285of100,1,323,5230,31,377,5638
subtest23of10,pubtest286of100,1,323,5268,7,39,5314
subtest25of10,pubtest286of100,1,323,5268,9,77,5354
subtest210of10,pubtest286of100,1,323,5268,11,114,5393
subtest24of10,pubtest286of100,1,323,5268,11,154,5433
subtest29of10,pubtest286of100,1,323,5268,17,188,5473
subtest21of10,pubtest286of100,1,323,5268,19,226,5513
subtest26of10,pubtest286of100,1,323,5268,22,263,5553
subtest27of10,pubtest286of100,1,323,5268,25,298,5591
subtest22of10,pubtest286of100,1,323,5268,30,335,5633
subtest28of10,pubtest286of100,1,323,5268,30,375,5673
subtest26of10,pubtest287of100,1,323,5224,8,41,5273
subtest29of10,pubtest287of100,1,323,5224,9,78,5311
subtest28of10,pubtest287of100,1,323,5224,10,118,5352
subtest210of10,pubtest287of100,1,323,5224,17,151,5392
subtest27of10,pubtest287of100,1,323,5224,24,182,5430
subtest24of10,pubtest287of100,1,323,5224,27,221,5472
subtest21of10,pubtest287of100,1,323,5224,28,260,5512
subtest23of10,pubtest287of100,1,323,5224,29,299,5552
subtest25of10,pubtest287of100,1,323,5224,30,338,5592
subtest22of10,pubtest287of100,1,323,5224,30,377,5631
subtest29of10,pubtest288of100,1,323,5302,9,38,5349
subtest21of10,pubtest288of100,1,323,5302,16,70,5388
subtest26of10,pubtest288of100,1,323,5302,14,111,5427
subtest27of10,pubtest288of100,1,323,5302,17,149,5468
subtest25of10,pubtest288of100,1,323,5302,17,188,5507
subtest23of10,pubtest288of100,1,323,5302,22,224,5548
subtest24of10,pubtest288of100,1,323,5302,23,264,5589
subtest22of10,pubtest288of100,1,323,5302,22,304,5628
subtest210of10,pubtest288of100,1,323,5302,24,342,5668
subtest28of10,pubtest288of100,1,323,5302,28,378,5708
subtest29of10,pubtest289of100,1,323,5283,9,42,5334
subtest210of10,pubtest289of100,1,323,5283,9,81,5373
subtest23of10,pubtest289of100,1,323,5283,11,118,5412
subtest25of10,pubtest289of100,1,323,5283,11,158,5452
subtest24of10,pubtest289of100,1,323,5283,13,196,5492
subtest27of10,pubtest289of100,1,323,5283,14,235,5532
subtest21of10,pubtest289of100,1,323,5283,14,279,5576
subtest26of10,pubtest289of100,1,323,5283,16,317,5616
subtest28of10,pubtest289of100,1,323,5283,17,356,5656
subtest22of10,pubtest289of100,1,323,5283,20,393,5696
subtest29of10,pubtest290of100,1,323,5205,9,42,5256
subtest22of10,pubtest290of100,1,323,5205,10,80,5295
subtest23of10,pubtest290of100,1,323,5205,28,102,5335
subtest26of10,pubtest290of100,1,323,5205,29,141,5375
subtest25of10,pubtest290of100,1,323,5205,29,181,5415
subtest27of10,pubtest290of100,1,323,5205,31,222,5458
subtest21of10,pubtest290of100,1,323,5205,35,259,5499
subtest210of10,pubtest290of100,1,323,5205,35,299,5539
subtest28of10,pubtest290of100,1,323,5205,39,335,5579
subtest24of10,pubtest290of100,1,323,5205,40,374,5619
subtest24of10,pubtest291of100,1,323,5302,9,39,5350
subtest23of10,pubtest291of100,1,323,5302,10,78,5390
subtest27of10,pubtest291of100,1,323,5302,29,97,5428
subtest28of10,pubtest291of100,1,323,5302,31,137,5470
subtest210of10,pubtest291of100,1,323,5302,32,176,5510
subtest21of10,pubtest291of100,1,323,5302,33,215,5550
subtest22of10,pubtest291of100,1,323,5302,37,251,5590
subtest25of10,pubtest291of100,1,323,5302,43,285,5630
subtest29of10,pubtest291of100,1,323,5302,43,327,5672
subtest26of10,pubtest291of100,1,323,5302,46,363,5711
subtest29of10,pubtest292of100,1,323,5204,20,40,5264
subtest28of10,pubtest292of100,1,323,5204,20,81,5305
subtest21of10,pubtest292of100,1,323,5204,22,118,5344
subtest25of10,pubtest292of100,1,323,5204,25,154,5383
subtest23of10,pubtest292of100,1,323,5204,39,180,5423
subtest27of10,pubtest292of100,1,323,5204,39,220,5463
subtest26of10,pubtest292of100,1,323,5204,39,259,5502
subtest22of10,pubtest292of100,1,323,5204,41,298,5543
subtest24of10,pubtest292of100,1,323,5204,42,337,5583
subtest210of10,pubtest292of100,1,323,5204,43,376,5623
subtest25of10,pubtest293of100,1,323,5404,8,40,5452
subtest23of10,pubtest293of100,1,323,5404,9,78,5491
subtest24of10,pubtest293of100,1,323,5404,9,118,5531
subtest28of10,pubtest293of100,1,323,5404,12,155,5571
subtest210of10,pubtest293of100,1,323,5404,14,193,5611
subtest26of10,pubtest293of100,1,323,5404,31,216,5651
subtest22of10,pubtest293of100,1,323,5404,32,253,5689
subtest27of10,pubtest293of100,1,323,5404,34,292,5730
subtest29of10,pubtest293of100,1,323,5404,35,332,5771
subtest21of10,pubtest293of100,1,323,5404,37,370,5811
subtest25of10,pubtest294of100,1,323,5242,8,42,5292
subtest21of10,pubtest294of100,1,323,5242,7,81,5330
subtest29of10,pubtest294of100,1,323,5242,10,116,5368
subtest27of10,pubtest294of100,1,323,5242,10,156,5408
subtest23of10,pubtest294of100,1,323,5242,14,194,5450
subtest210of10,pubtest294of100,1,323,5242,16,232,5490
subtest24of10,pubtest294of100,1,323,5242,24,265,5531
subtest26of10,pubtest294of100,1,323,5242,23,305,5570
subtest22of10,pubtest294of100,1,323,5242,28,340,5610
subtest28of10,pubtest294of100,1,323,5242,28,380,5650
subtest25of10,pubtest295of100,1,323,5255,6,40,5301
subtest24of10,pubtest295of100,1,323,5255,10,77,5342
subtest23of10,pubtest295of100,1,323,5255,15,112,5382
subtest22of10,pubtest295of100,1,323,5255,17,151,5423
subtest27of10,pubtest295of100,1,323,5255,17,190,5462
subtest210of10,pubtest295of100,1,323,5255,18,231,5504
subtest29of10,pubtest295of100,1,323,5255,23,265,5543
subtest21of10,pubtest295of100,1,323,5255,28,478,5761
subtest28of10,pubtest295of100,1,323,5255,30,513,5798
subtest26of10,pubtest295of100,1,323,5255,31,552,5838
subtest25of10,pubtest296of100,1,322,5351,7,38,5396
subtest24of10,pubtest296of100,1,322,5351,11,73,5435
subtest27of10,pubtest296of100,1,322,5351,16,108,5475
subtest26of10,pubtest296of100,1,322,5351,16,147,5514
subtest23of10,pubtest296of100,1,322,5351,17,187,5555
subtest29of10,pubtest296of100,1,322,5351,20,224,5595
subtest21of10,pubtest296of100,1,322,5351,20,264,5635
subtest28of10,pubtest296of100,1,322,5351,21,303,5675
subtest22of10,pubtest296of100,1,322,5351,28,336,5715
subtest210of10,pubtest296of100,1,322,5351,28,376,5755
subtest25of10,pubtest297of100,1,323,5317,9,39,5365
subtest29of10,pubtest297of100,1,323,5317,9,79,5405
subtest23of10,pubtest297of100,1,323,5317,11,116,5444
subtest210of10,pubtest297of100,1,323,5317,13,154,5484
subtest27of10,pubtest297of100,1,323,5317,13,194,5524
subtest22of10,pubtest297of100,1,323,5317,16,230,5563
subtest21of10,pubtest297of100,1,323,5317,20,267,5604
subtest26of10,pubtest297of100,1,323,5317,20,307,5644
subtest28of10,pubtest297of100,1,323,5317,22,345,5684
subtest24of10,pubtest297of100,1,323,5317,26,381,5724
subtest22of10,pubtest298of100,1,323,5212,11,46,5269
subtest29of10,pubtest298of100,1,323,5212,10,85,5307
subtest25of10,pubtest298of100,1,323,5212,17,119,5348
subtest24of10,pubtest298of100,1,323,5212,17,159,5388
subtest23of10,pubtest298of100,1,323,5212,37,180,5429
subtest21of10,pubtest298of100,1,323,5212,38,218,5468
subtest27of10,pubtest298of100,1,323,5212,39,257,5508
subtest28of10,pubtest298of100,1,323,5212,40,295,5547
subtest26of10,pubtest298of100,1,323,5212,41,335,5588
subtest210of10,pubtest298of100,1,323,5212,40,374,5626
subtest22of10,pubtest299of100,1,323,5420,6,39,5465
subtest29of10,pubtest299of100,1,323,5420,10,74,5504
subtest210of10,pubtest299of100,1,323,5420,15,109,5544
subtest24of10,pubtest299of100,1,323,5420,17,147,5584
subtest27of10,pubtest299of100,1,323,5420,18,186,5624
subtest23of10,pubtest299of100,1,323,5420,22,222,5664
subtest28of10,pubtest299of100,1,323,5420,23,261,5704
subtest25of10,pubtest299of100,1,323,5420,25,298,5743
subtest26of10,pubtest299of100,1,323,5420,27,337,5784
subtest21of10,pubtest299of100,1,323,5420,28,376,5824
subtest21of10,pubtest2100of100,1,325,5301,9,39,5349
subtest24of10,pubtest2100of100,1,325,5301,9,78,5388
subtest29of10,pubtest2100of100,1,325,5301,11,116,5428
subtest23of10,pubtest2100of100,1,325,5301,12,153,5466
subtest22of10,pubtest2100of100,1,325,5301,14,193,5508
subtest28of10,pubtest2100of100,1,325,5301,18,229,5548
subtest27of10,pubtest2100of100,1,325,5301,17,269,5587
subtest25of10,pubtest2100of100,1,325,5301,17,308,5626
subtest210of10,pubtest2100of100,1,325,5301,20,347,5668
subtest26of10,pubtest2100of100,1,325,5301,23,384,5708
subtest27of10,pubtest21of100,1,322,10234,11,40,10285
subtest26of10,pubtest21of100,1,322,10234,11,80,10325
subtest24of10,pubtest21of100,1,322,10234,13,117,10364
subtest29of10,pubtest21of100,1,322,10234,15,155,10404
subtest21of10,pubtest21of100,1,322,10234,42,168,10444
subtest25of10,pubtest21of100,1,322,10234,41,209,10484
subtest210of10,pubtest21of100,1,322,10234,43,247,10524
subtest28of10,pubtest21of100,1,322,10234,44,286,10564
subtest22of10,pubtest21of100,1,322,10234,46,324,10604
subtest23of10,pubtest21of100,1,322,10234,46,364,10644
subtest29of10,pubtest22of100,1,321,5254,5,38,5297
subtest24of10,pubtest22of100,1,321,5254,8,75,5337
subtest27of10,pubtest22of100,1,321,5254,26,96,5376
subtest23of10,pubtest22of100,1,321,5254,26,136,5416
subtest28of10,pubtest22of100,1,321,5254,29,173,5456
subtest25of10,pubtest22of100,1,321,5254,31,211,5496
subtest26of10,pubtest22of100,1,321,5254,35,247,5536
subtest21of10,pubtest22of100,1,321,5254,39,282,5575
subtest210of10,pubtest22of100,1,321,5254,45,317,5616
subtest22of10,pubtest22of100,1,321,5254,46,356,5656
subtest23of10,pubtest23of100,1,321,5342,7,39,5388
subtest28of10,pubtest23of100,1,321,5342,8,77,5427
subtest24of10,pubtest23of100,1,321,5342,9,116,5467
subtest26of10,pubtest23of100,1,321,5342,14,149,5505
subtest22of10,pubtest23of100,1,321,5342,16,189,5547
subtest29of10,pubtest23of100,1,321,5342,18,227,5587
subtest25of10,pubtest23of100,1,321,5342,18,267,5627
subtest27of10,pubtest23of100,1,321,5342,18,306,5666
subtest210of10,pubtest23of100,1,321,5342,23,342,5707
subtest21of10,pubtest23of100,1,321,5342,36,369,5747
subtest24of10,pubtest24of100,1,321,5266,10,40,5316
subtest23of10,pubtest24of100,1,321,5266,10,79,5355
subtest25of10,pubtest24of100,1,321,5266,13,118,5397
subtest21of10,pubtest24of100,1,321,5266,15,155,5436
subtest29of10,pubtest24of100,1,321,5266,16,196,5478
subtest27of10,pubtest24of100,1,321,5266,19,232,5517
subtest28of10,pubtest24of100,1,321,5266,21,269,5556
subtest22of10,pubtest24of100,1,321,5266,21,309,5596
subtest210of10,pubtest24of100,1,321,5266,24,346,5636
subtest26of10,pubtest24of100,1,321,5266,28,382,5676
subtest21of10,pubtest25of100,1,321,5284,23,41,5348
subtest28of10,pubtest25of100,1,321,5284,24,75,5383
subtest210of10,pubtest25of100,1,321,5284,25,116,5425
subtest27of10,pubtest25of100,1,321,5284,32,149,5465
subtest26of10,pubtest25of100,1,321,5284,32,189,5505
subtest25of10,pubtest25of100,1,321,5284,40,221,5545
subtest22of10,pubtest25of100,1,321,5284,42,260,5586
subtest23of10,pubtest25of100,1,321,5284,62,279,5625
subtest29of10,pubtest25of100,1,321,5284,63,318,5665
subtest24of10,pubtest25of100,1,321,5284,63,358,5705
subtest21of10,pubtest26of100,1,321,5281,7,40,5328
subtest29of10,pubtest26of100,1,321,5281,8,79,5368
subtest22of10,pubtest26of100,1,321,5281,10,116,5407
subtest26of10,pubtest26of100,1,321,5281,14,152,5447
subtest27of10,pubtest26of100,1,321,5281,14,192,5487
subtest23of10,pubtest26of100,1,321,5281,12,231,5524
subtest25of10,pubtest26of100,1,321,5281,15,271,5567
subtest210of10,pubtest26of100,1,321,5281,22,304,5607
subtest28of10,pubtest26of100,1,321,5281,27,339,5647
subtest24of10,pubtest26of100,1,321,5281,33,373,5687
subtest27of10,pubtest27of100,1,320,5297,7,41,5345
subtest28of10,pubtest27of100,1,320,5297,14,74,5385
subtest23of10,pubtest27of100,1,320,5297,15,113,5425
subtest29of10,pubtest27of100,1,320,5297,18,150,5465
subtest25of10,pubtest27of100,1,320,5297,22,185,5504
subtest210of10,pubtest27of100,1,320,5297,23,225,5545
subtest24of10,pubtest27of100,1,320,5297,24,264,5585
subtest22of10,pubtest27of100,1,320,5297,27,302,5626
subtest26of10,pubtest27of100,1,320,5297,27,341,5665
subtest21of10,pubtest27of100,1,320,5297,27,380,5704
subtest27of10,pubtest28of100,1,321,5191,6,42,5239
subtest28of10,pubtest28of100,1,321,5191,24,62,5277
subtest21of10,pubtest28of100,1,321,5191,35,91,5317
subtest29of10,pubtest28of100,1,321,5191,38,127,5356
subtest23of10,pubtest28of100,1,321,5191,41,164,5396
subtest25of10,pubtest28of100,1,321,5191,45,200,5436
subtest210of10,pubtest28of100,1,321,5191,45,237,5473
subtest24of10,pubtest28of100,1,321,5191,49,276,5516
subtest26of10,pubtest28of100,1,321,5191,50,315,5556
subtest22of10,pubtest28of100,1,321,5191,52,353,5596
subtest23of10,pubtest29of100,1,321,5325,7,40,5372
subtest29of10,pubtest29of100,1,321,5325,17,70,5412
subtest210of10,pubtest29of100,1,321,5325,17,110,5452
subtest28of10,pubtest29of100,1,321,5325,27,140,5492
subtest22of10,pubtest29of100,1,321,5325,26,180,5531
subtest25of10,pubtest29of100,1,321,5325,28,219,5572
subtest21of10,pubtest29of100,1,321,5325,29,258,5612
subtest27of10,pubtest29of100,1,321,5325,30,298,5653
subtest24of10,pubtest29of100,1,321,5325,33,334,5692
subtest26of10,pubtest29of100,1,321,5325,33,374,5732
subtest29of10,pubtest210of100,1,323,5253,7,41,5301
subtest21of10,pubtest210of100,1,323,5253,12,74,5339
subtest210of10,pubtest210of100,1,323,5253,12,114,5379
subtest27of10,pubtest210of100,1,323,5253,14,152,5419
subtest23of10,pubtest210of100,1,323,5253,17,189,5459
subtest25of10,pubtest210of100,1,323,5253,18,228,5499
subtest28of10,pubtest210of100,1,323,5253,20,266,5539
subtest24of10,pubtest210of100,1,323,5253,23,303,5579
subtest22of10,pubtest210of100,1,323,5253,24,340,5617
subtest26of10,pubtest210of100,1,323,5253,24,380,5657
subtest210of10,pubtest211of100,1,323,5268,4,39,5311
subtest29of10,pubtest211of100,1,323,5268,13,69,5350
subtest24of10,pubtest211of100,1,323,5268,13,109,5390
subtest21of10,pubtest211of100,1,323,5268,16,147,5431
subtest25of10,pubtest211of100,1,323,5268,21,181,5470
subtest23of10,pubtest211of100,1,323,5268,21,221,5510
subtest22of10,pubtest211of100,1,323,5268,24,257,5549
subtest26of10,pubtest211of100,1,323,5268,27,295,5590
subtest27of10,pubtest211of100,1,323,5268,27,335,5630
subtest28of10,pubtest211of100,1,323,5268,31,371,5670
subtest25of10,pubtest212of100,1,323,5824,8,40,5872
subtest29of10,pubtest212of100,1,323,5824,13,73,5910
subtest28of10,pubtest212of100,1,323,5824,19,109,5952
subtest23of10,pubtest212of100,1,323,5824,22,146,5992
subtest24of10,pubtest212of100,1,323,5824,22,186,6032
subtest27of10,pubtest212of100,1,323,5824,23,225,6072
subtest21of10,pubtest212of100,1,323,5824,27,262,6113
subtest210of10,pubtest212of100,1,323,5824,29,299,6152
subtest26of10,pubtest212of100,1,323,5824,28,339,6191
subtest22of10,pubtest212of100,1,323,5824,27,378,6229
subtest23of10,pubtest213of100,1,322,8908,7,39,8954
subtest26of10,pubtest213of100,1,322,8908,8,78,8994
subtest29of10,pubtest213of100,1,322,8908,35,91,9034
subtest22of10,pubtest213of100,1,322,8908,45,121,9074
subtest27of10,pubtest213of100,1,322,8908,58,147,9113
subtest21of10,pubtest213of100,1,322,8908,64,181,9153
subtest24of10,pubtest213of100,1,322,8908,94,191,9193
subtest25of10,pubtest213of100,1,322,8908,102,222,9232
subtest210of10,pubtest213of100,1,322,8908,112,253,9273
subtest28of10,pubtest213of100,1,322,8908,136,269,9313
subtest21of10,pubtest214of100,1,323,5603,8,40,5651
subtest23of10,pubtest214of100,1,323,5603,12,75,5690
subtest26of10,pubtest214of100,1,323,5603,13,114,5730
subtest25of10,pubtest214of100,1,323,5603,17,149,5769
subtest22of10,pubtest214of100,1,323,5603,19,188,5810
subtest27of10,pubtest214of100,1,323,5603,23,224,5850
subtest210of10,pubtest214of100,1,323,5603,27,260,5890
subtest29of10,pubtest214of100,1,323,5603,28,299,5930
subtest24of10,pubtest214of100,1,323,5603,29,338,5970
subtest28of10,pubtest214of100,1,323,5603,34,373,6010
subtest27of10,pubtest215of100,1,323,5255,8,39,5302
subtest24of10,pubtest215of100,1,323,5255,9,78,5342
subtest29of10,pubtest215of100,1,323,5255,11,116,5382
subtest21of10,pubtest215of100,1,323,5255,14,154,5423
subtest26of10,pubtest215of100,1,323,5255,14,193,5462
subtest25of10,pubtest215of100,1,323,5255,16,231,5502
subtest210of10,pubtest215of100,1,323,5255,20,267,5542
subtest23of10,pubtest215of100,1,323,5255,20,307,5582
subtest22of10,pubtest215of100,1,323,5255,22,346,5623
subtest28of10,pubtest215of100,1,323,5255,22,385,5662
subtest24of10,pubtest216of100,1,323,5435,8,45,5488
subtest21of10,pubtest216of100,1,323,5435,10,84,5529
subtest22of10,pubtest216of100,1,323,5435,14,120,5569
subtest23of10,pubtest216of100,1,323,5435,14,160,5609
subtest28of10,pubtest216of100,1,323,5435,12,198,5645
subtest27of10,pubtest216of100,1,323,5435,12,236,5683
subtest26of10,pubtest216of100,1,323,5435,19,274,5728
subtest29of10,pubtest216of100,1,323,5435,19,315,5769
subtest25of10,pubtest216of100,1,323,5435,14,353,5802
subtest210of10,pubtest216of100,1,323,5435,24,389,5848
subtest27of10,pubtest217of100,1,322,5256,9,39,5304
subtest22of10,pubtest217of100,1,322,5256,42,43,5341
subtest26of10,pubtest217of100,1,322,5256,43,82,5381
subtest21of10,pubtest217of100,1,322,5256,44,121,5421
subtest23of10,pubtest217of100,1,322,5256,50,157,5463
subtest25of10,pubtest217of100,1,322,5256,52,194,5502
subtest29of10,pubtest217of100,1,322,5256,51,234,5541
subtest24of10,pubtest217of100,1,322,5256,53,273,5582
subtest28of10,pubtest217of100,1,322,5256,54,312,5622
subtest210of10,pubtest217of100,1,322,5256,60,346,5662
subtest29of10,pubtest218of100,1,323,5237,6,40,5283
subtest21of10,pubtest218of100,1,323,5237,15,70,5322
subtest22of10,pubtest218of100,1,323,5237,17,109,5363
subtest27of10,pubtest218of100,1,323,5237,19,147,5403
subtest23of10,pubtest218of100,1,323,5237,19,186,5442
subtest25of10,pubtest218of100,1,323,5237,20,225,5482
subtest28of10,pubtest218of100,1,323,5237,21,265,5523
subtest24of10,pubtest218of100,1,323,5237,22,304,5563
subtest210of10,pubtest218of100,1,323,5237,25,342,5604
subtest26of10,pubtest218of100,1,323,5237,25,381,5643
subtest210of10,pubtest219of100,1,323,5187,7,44,5238
subtest26of10,pubtest219of100,1,323,5187,13,78,5278
subtest25of10,pubtest219of100,1,323,5187,13,118,5318
subtest21of10,pubtest219of100,1,323,5187,16,155,5358
subtest22of10,pubtest219of100,1,323,5187,16,194,5397
subtest24of10,pubtest219of100,1,323,5187,18,233,5438
subtest29of10,pubtest219of100,1,323,5187,20,271,5478
subtest23of10,pubtest219of100,1,323,5187,22,309,5518
subtest28of10,pubtest219of100,1,323,5187,22,349,5558
subtest27of10,pubtest219of100,1,323,5187,29,382,5598
subtest25of10,pubtest220of100,1,323,5316,4,40,5360
subtest23of10,pubtest220of100,1,323,5316,10,73,5399
subtest29of10,pubtest220of100,1,323,5316,12,111,5439
subtest210of10,pubtest220of100,1,323,5316,12,151,5479
subtest24of10,pubtest220of100,1,323,5316,14,189,5519
subtest21of10,pubtest220of100,1,323,5316,19,224,5559
subtest27of10,pubtest220of100,1,323,5316,19,264,5599
subtest26of10,pubtest220of100,1,323,5316,23,300,5639
subtest28of10,pubtest220of100,1,323,5316,23,340,5679
subtest22of10,pubtest220of100,1,323,5316,26,377,5719
subtest24of10,pubtest221of100,1,323,5289,10,39,5338
subtest21of10,pubtest221of100,1,323,5289,11,78,5378
subtest23of10,pubtest221of100,1,323,5289,13,115,5417
subtest28of10,pubtest221of100,1,323,5289,14,154,5457
subtest25of10,pubtest221of100,1,323,5289,17,190,5496
subtest22of10,pubtest221of100,1,323,5289,19,229,5537
subtest210of10,pubtest221of100,1,323,5289,47,241,5577
subtest29of10,pubtest221of100,1,323,5289,50,278,5617
subtest26of10,pubtest221of100,1,323,5289,52,316,5657
subtest27of10,pubtest221of100,1,323,5289,52,356,5697
subtest22of10,pubtest222of100,1,323,5225,16,39,5280
subtest21of10,pubtest222of100,1,323,5225,17,77,5319
subtest29of10,pubtest222of100,1,323,5225,18,114,5357
subtest27of10,pubtest222of100,1,323,5225,29,145,5399
subtest28of10,pubtest222of100,1,323,5225,29,184,5438
subtest23of10,pubtest222of100,1,323,5225,30,224,5479
subtest25of10,pubtest222of100,1,323,5225,32,262,5519
subtest210of10,pubtest222of100,1,323,5225,33,301,5559
subtest26of10,pubtest222of100,1,323,5225,37,337,5599
subtest24of10,pubtest222of100,1,323,5225,37,377,5639
subtest21of10,pubtest223of100,1,323,5265,8,50,5323
subtest23of10,pubtest223of100,1,323,5265,13,83,5361
subtest29of10,pubtest223of100,1,323,5265,13,123,5401
subtest28of10,pubtest223of100,1,323,5265,17,158,5440
subtest27of10,pubtest223of100,1,323,5265,17,198,5480
subtest24of10,pubtest223of100,1,323,5265,20,236,5521
subtest25of10,pubtest223of100,1,323,5265,21,276,5562
subtest210of10,pubtest223of100,1,323,5265,55,281,5601
subtest22of10,pubtest223of100,1,323,5265,55,321,5641
subtest26of10,pubtest223of100,1,323,5265,57,359,5681
subtest21of10,pubtest224of100,1,323,5313,8,40,5361
subtest28of10,pubtest224of100,1,323,5313,11,76,5400
subtest27of10,pubtest224of100,1,323,5313,11,118,5442
subtest23of10,pubtest224of100,1,323,5313,18,150,5481
subtest26of10,pubtest224of100,1,323,5313,18,190,5521
subtest29of10,pubtest224of100,1,323,5313,19,228,5560
subtest25of10,pubtest224of100,1,323,5313,21,265,5599
subtest22of10,pubtest224of100,1,323,5313,22,305,5640
subtest24of10,pubtest224of100,1,323,5313,27,340,5680
subtest210of10,pubtest224of100,1,323,5313,28,379,5720
subtest27of10,pubtest225of100,1,323,5219,8,40,5267
subtest22of10,pubtest225of100,1,323,5219,11,76,5306
subtest26of10,pubtest225of100,1,323,5219,11,116,5346
subtest21of10,pubtest225of100,1,323,5219,16,151,5386
subtest24of10,pubtest225of100,1,323,5219,20,187,5426
subtest28of10,pubtest225of100,1,323,5219,21,226,5466
subtest210of10,pubtest225of100,1,323,5219,22,265,5506
subtest29of10,pubtest225of100,1,323,5219,23,304,5546
subtest23of10,pubtest225of100,1,323,5219,22,343,5584
subtest25of10,pubtest225of100,1,323,5219,24,381,5624
subtest22of10,pubtest226of100,1,323,5174,11,41,5226
subtest25of10,pubtest226of100,1,323,5174,11,81,5266
subtest23of10,pubtest226of100,1,323,5174,12,118,5304
subtest27of10,pubtest226of100,1,323,5174,13,158,5345
subtest210of10,pubtest226of100,1,323,5174,17,194,5385
subtest21of10,pubtest226of100,1,323,5174,19,233,5426
subtest28of10,pubtest226of100,1,323,5174,60,231,5465
subtest29of10,pubtest226of100,1,323,5174,60,271,5505
subtest26of10,pubtest226of100,1,323,5174,62,309,5545
subtest24of10,pubtest226of100,1,323,5174,62,348,5584
subtest210of10,pubtest227of100,1,323,5346,9,40,5395
subtest29of10,pubtest227of100,1,323,5346,13,75,5434
subtest25of10,pubtest227of100,1,323,5346,14,115,5475
subtest24of10,pubtest227of100,1,323,5346,19,150,5515
subtest22of10,pubtest227of100,1,323,5346,20,188,5554
subtest26of10,pubtest227of100,1,323,5346,21,227,5594
subtest23of10,pubtest227of100,1,323,5346,21,267,5634
subtest21of10,pubtest227of100,1,323,5346,22,306,5674
subtest27of10,pubtest227of100,1,323,5346,23,345,5714
subtest28of10,pubtest227of100,1,323,5346,30,378,5754
subtest21of10,pubtest228of100,1,323,5151,7,42,5200
subtest26of10,pubtest228of100,1,323,5151,14,74,5239
subtest25of10,pubtest228of100,1,323,5151,16,112,5279
subtest23of10,pubtest228of100,1,323,5151,19,149,5319
subtest27of10,pubtest228of100,1,323,5151,19,189,5359
subtest210of10,pubtest228of100,1,323,5151,21,227,5399
subtest29of10,pubtest228of100,1,323,5151,21,267,5439
subtest22of10,pubtest228of100,1,323,5151,23,306,5480
subtest24of10,pubtest228of100,1,323,5151,23,345,5519
subtest28of10,pubtest228of100,1,323,5151,28,380,5559
subtest24of10,pubtest229of100,1,321,5197,7,43,5247
subtest27of10,pubtest229of100,1,321,5197,15,73,5285
subtest21of10,pubtest229of100,1,321,5197,15,112,5324
subtest28of10,pubtest229of100,1,321,5197,14,152,5363
subtest23of10,pubtest229of100,1,321,5197,21,186,5404
subtest22of10,pubtest229of100,1,321,5197,21,226,5444
subtest210of10,pubtest229of100,1,321,5197,23,264,5484
subtest25of10,pubtest229of100,1,321,5197,23,304,5524
subtest29of10,pubtest229of100,1,321,5197,25,342,5564
subtest26of10,pubtest229of100,1,321,5197,29,379,5605
subtest22of10,pubtest230of100,1,323,5452,9,38,5499
subtest21of10,pubtest230of100,1,323,5452,12,75,5539
subtest29of10,pubtest230of100,1,323,5452,14,112,5578
subtest27of10,pubtest230of100,1,323,5452,14,153,5619
subtest28of10,pubtest230of100,1,323,5452,14,191,5657
subtest25of10,pubtest230of100,1,323,5452,18,229,5699
subtest23of10,pubtest230of100,1,323,5452,19,268,5739
subtest210of10,pubtest230of100,1,323,5452,21,307,5780
subtest24of10,pubtest230of100,1,323,5452,21,344,5817
subtest26of10,pubtest230of100,1,323,5452,24,382,5858
subtest23of10,pubtest231of100,1,323,5257,7,39,5303
subtest28of10,pubtest231of100,1,323,5257,14,72,5343
subtest25of10,pubtest231of100,1,323,5257,15,110,5382
subtest24of10,pubtest231of100,1,323,5257,16,149,5422
subtest29of10,pubtest231of100,1,323,5257,22,184,5463
subtest27of10,pubtest231of100,1,323,5257,24,218,5499
subtest26of10,pubtest231of100,1,323,5257,26,259,5542
subtest21of10,pubtest231of100,1,323,5257,27,297,5581
subtest22of10,pubtest231of100,1,323,5257,28,337,5622
subtest210of10,pubtest231of100,1,323,5257,23,377,5657
subtest21of10,pubtest232of100,1,323,5274,7,44,5325
subtest22of10,pubtest232of100,1,323,5274,8,82,5364
subtest27of10,pubtest232of100,1,323,5274,10,120,5404
subtest28of10,pubtest232of100,1,323,5274,24,146,5444
subtest29of10,pubtest232of100,1,323,5274,24,186,5484
subtest25of10,pubtest232of100,1,323,5274,26,224,5524
subtest23of10,pubtest232of100,1,323,5274,22,264,5560
subtest24of10,pubtest232of100,1,323,5274,26,303,5603
subtest26of10,pubtest232of100,1,323,5274,28,343,5645
subtest210of10,pubtest232of100,1,323,5274,29,381,5684
subtest29of10,pubtest233of100,1,323,5228,7,38,5273
subtest24of10,pubtest233of100,1,323,5228,9,76,5313
subtest25of10,pubtest233of100,1,323,5228,12,112,5352
subtest27of10,pubtest233of100,1,323,5228,16,148,5392
subtest23of10,pubtest233of100,1,323,5228,25,179,5432
subtest26of10,pubtest233of100,1,323,5228,25,217,5470
subtest21of10,pubtest233of100,1,323,5228,27,257,5512
subtest210of10,pubtest233of100,1,323,5228,25,299,5552
subtest22of10,pubtest233of100,1,323,5228,60,304,5592
subtest28of10,pubtest233of100,1,323,5228,60,344,5632
subtest25of10,pubtest234of100,1,323,5186,7,40,5233
subtest27of10,pubtest234of100,1,323,5186,12,75,5273
subtest26of10,pubtest234of100,1,323,5186,12,116,5314
subtest21of10,pubtest234of100,1,323,5186,15,152,5353
subtest29of10,pubtest234of100,1,323,5186,16,190,5392
subtest22of10,pubtest234of100,1,323,5186,19,227,5432
subtest23of10,pubtest234of100,1,323,5186,20,266,5472
subtest210of10,pubtest234of100,1,323,5186,30,295,5511
subtest28of10,pubtest234of100,1,323,5186,31,335,5552
subtest24of10,pubtest234of100,1,323,5186,30,374,5590
subtest21of10,pubtest235of100,1,321,5218,11,41,5270
subtest210of10,pubtest235of100,1,321,5218,15,76,5309
subtest23of10,pubtest235of100,1,321,5218,16,115,5349
subtest22of10,pubtest235of100,1,321,5218,18,153,5389
subtest27of10,pubtest235of100,1,321,5218,18,193,5429
subtest29of10,pubtest235of100,1,321,5218,20,231,5469
subtest24of10,pubtest235of100,1,321,5218,21,270,5509
subtest26of10,pubtest235of100,1,321,5218,22,309,5549
subtest25of10,pubtest235of100,1,321,5218,22,347,5587
subtest28of10,pubtest235of100,1,321,5218,25,384,5627
subtest23of10,pubtest236of100,1,323,5392,9,39,5440
subtest210of10,pubtest236of100,1,323,5392,8,78,5478
subtest27of10,pubtest236of100,1,323,5392,13,114,5519
subtest28of10,pubtest236of100,1,323,5392,13,153,5558
subtest25of10,pubtest236of100,1,323,5392,18,190,5600
subtest21of10,pubtest236of100,1,323,5392,19,228,5639
subtest29of10,pubtest236of100,1,323,5392,22,266,5680
subtest24of10,pubtest236of100,1,323,5392,23,302,5717
subtest26of10,pubtest236of100,1,323,5392,26,341,5759
subtest22of10,pubtest236of100,1,323,5392,26,381,5799
subtest24of10,pubtest237of100,1,323,5240,21,39,5300
subtest23of10,pubtest237of100,1,323,5240,25,74,5339
subtest28of10,pubtest237of100,1,323,5240,27,112,5379
subtest25of10,pubtest237of100,1,323,5240,30,149,5419
subtest27of10,pubtest237of100,1,323,5240,33,184,5457
subtest21of10,pubtest237of100,1,323,5240,36,223,5499
subtest22of10,pubtest237of100,1,323,5240,37,262,5539
subtest210of10,pubtest237of100,1,323,5240,38,301,5579
subtest26of10,pubtest237of100,1,323,5240,37,340,5617
subtest29of10,pubtest237of100,1,323,5240,41,378,5659
subtest29of10,pubtest238of100,1,323,5391,9,40,5440
subtest27of10,pubtest238of100,1,323,5391,11,77,5479
subtest25of10,pubtest238of100,1,323,5391,12,114,5517
subtest23of10,pubtest238of100,1,323,5391,15,153,5559
subtest22of10,pubtest238of100,1,323,5391,15,192,5598
subtest21of10,pubtest238of100,1,323,5391,19,229,5639
subtest28of10,pubtest238of100,1,323,5391,21,267,5679
subtest210of10,pubtest238of100,1,323,5391,23,305,5719
subtest26of10,pubtest238of100,1,323,5391,25,343,5759
subtest24of10,pubtest238of100,1,323,5391,26,382,5799
subtest21of10,pubtest239of100,1,323,5264,8,41,5313
subtest28of10,pubtest239of100,1,323,5264,11,76,5351
subtest27of10,pubtest239of100,1,323,5264,11,117,5392
subtest26of10,pubtest239of100,1,323,5264,16,152,5432
subtest25of10,pubtest239of100,1,323,5264,21,187,5472
subtest24of10,pubtest239of100,1,323,5264,22,226,5512
subtest29of10,pubtest239of100,1,323,5264,24,264,5552
subtest23of10,pubtest239of100,1,323,5264,33,295,5592
subtest22of10,pubtest239of100,1,323,5264,34,334,5632
subtest210of10,pubtest239of100,1,323,5264,35,373,5672
subtest25of10,pubtest240of100,1,323,5187,9,41,5237
subtest21of10,pubtest240of100,1,323,5187,19,71,5277
subtest29of10,pubtest240of100,1,323,5187,24,105,5316
subtest27of10,pubtest240of100,1,323,5187,24,145,5356
subtest23of10,pubtest240of100,1,323,5187,27,182,5396
subtest210of10,pubtest240of100,1,323,5187,28,220,5435
subtest28of10,pubtest240of100,1,323,5187,29,260,5476
subtest24of10,pubtest240of100,1,323,5187,32,297,5516
subtest22of10,pubtest240of100,1,323,5187,33,336,5556
subtest26of10,pubtest240of100,1,323,5187,33,374,5594
subtest23of10,pubtest241of100,1,323,5293,9,40,5342
subtest24of10,pubtest241of100,1,323,5293,12,76,5381
subtest27of10,pubtest241of100,1,323,5293,12,116,5421
subtest21of10,pubtest241of100,1,323,5293,14,154,5461
subtest210of10,pubtest241of100,1,323,5293,21,187,5501
subtest28of10,pubtest241of100,1,323,5293,24,224,5541
subtest29of10,pubtest241of100,1,323,5293,24,264,5581
subtest26of10,pubtest241of100,1,323,5293,26,300,5619
subtest25of10,pubtest241of100,1,323,5293,26,339,5658
subtest22of10,pubtest241of100,1,323,5293,31,377,5701
subtest27of10,pubtest242of100,1,323,5180,6,40,5226
subtest23of10,pubtest242of100,1,323,5180,9,78,5267
subtest26of10,pubtest242of100,1,323,5180,10,116,5306
subtest25of10,pubtest242of100,1,323,5180,15,151,5346
subtest210of10,pubtest242of100,1,323,5180,21,185,5386
subtest22of10,pubtest242of100,1,323,5180,22,222,5424
subtest29of10,pubtest242of100,1,323,5180,21,262,5463
subtest21of10,pubtest242of100,1,323,5180,24,301,5505
subtest28of10,pubtest242of100,1,323,5180,28,338,5546
subtest24of10,pubtest242of100,1,323,5180,28,378,5586
subtest29of10,pubtest243of100,1,323,5374,9,40,5423
subtest28of10,pubtest243of100,1,323,5374,9,78,5461
subtest22of10,pubtest243of100,1,323,5374,11,115,5500
subtest26of10,pubtest243of100,1,323,5374,13,154,5541
subtest23of10,pubtest243of100,1,323,5374,11,194,5579
subtest25of10,pubtest243of100,1,323,5374,15,233,5622
subtest27of10,pubtest243of100,1,323,5374,20,268,5662
subtest24of10,pubtest243of100,1,323,5374,21,307,5702
subtest21of10,pubtest243of100,1,323,5374,27,341,5742
subtest210of10,pubtest243of100,1,323,5374,27,381,5782
subtest26of10,pubtest244of100,1,323,5305,7,41,5353
subtest27of10,pubtest244of100,1,323,5305,10,78,5393
subtest25of10,pubtest244of100,1,323,5305,11,117,5433
subtest29of10,pubtest244of100,1,323,5305,17,150,5472
subtest28of10,pubtest244of100,1,323,5305,19,188,5512
subtest21of10,pubtest244of100,1,323,5305,20,227,5552
subtest23of10,pubtest244of100,1,323,5305,55,232,5592
subtest210of10,pubtest244of100,1,323,5305,56,271,5632
subtest24of10,pubtest244of100,1,323,5305,57,310,5672
subtest22of10,pubtest244of100,1,323,5305,57,350,5712
subtest29of10,pubtest245of100,1,322,5332,7,41,5380
subtest26of10,pubtest245of100,1,322,5332,9,80,5421
subtest23of10,pubtest245of100,1,322,5332,10,118,5460
subtest25of10,pubtest245of100,1,322,5332,12,155,5499
subtest22of10,pubtest245of100,1,322,5332,13,194,5539
subtest24of10,pubtest245of100,1,322,5332,20,228,5580
subtest21of10,pubtest245of100,1,322,5332,20,267,5619
subtest27of10,pubtest245of100,1,322,5332,24,303,5659
subtest28of10,pubtest245of100,1,322,5332,25,342,5699
subtest210of10,pubtest245of100,1,322,5332,26,381,5739
subtest26of10,pubtest246of100,1,323,5247,13,42,5302
subtest27of10,pubtest246of100,1,323,5247,13,79,5339
subtest21of10,pubtest246of100,1,323,5247,15,118,5380
subtest28of10,pubtest246of100,1,323,5247,16,154,5417
subtest22of10,pubtest246of100,1,323,5247,19,194,5460
subtest23of10,pubtest246of100,1,323,5247,17,234,5498
subtest29of10,pubtest246of100,1,323,5247,15,271,5533
subtest210of10,pubtest246of100,1,323,5247,17,311,5575
subtest25of10,pubtest246of100,1,323,5247,17,350,5614
subtest24of10,pubtest246of100,1,323,5247,20,390,5657
subtest27of10,pubtest247of100,1,323,5578,7,42,5627
subtest23of10,pubtest247of100,1,323,5578,8,80,5666
subtest26of10,pubtest247of100,1,323,5578,11,117,5706
subtest21of10,pubtest247of100,1,323,5578,15,153,5746
subtest22of10,pubtest247of100,1,323,5578,16,190,5784
subtest29of10,pubtest247of100,1,323,5578,17,230,5825
subtest25of10,pubtest247of100,1,323,5578,26,262,5866
subtest28of10,pubtest247of100,1,323,5578,27,301,5906
subtest210of10,pubtest247of100,1,323,5578,32,336,5946
subtest24of10,pubtest247of100,1,323,5578,32,376,5986
subtest29of10,pubtest248of100,1,323,5170,7,40,5217
subtest26of10,pubtest248of100,1,323,5170,17,69,5256
subtest25of10,pubtest248of100,1,323,5170,18,106,5294
subtest27of10,pubtest248of100,1,323,5170,21,145,5336
subtest23of10,pubtest248of100,1,323,5170,22,184,5376
subtest24of10,pubtest248of100,1,323,5170,23,223,5416
subtest21of10,pubtest248of100,1,323,5170,21,262,5453
subtest22of10,pubtest248of100,1,323,5170,24,301,5495
subtest28of10,pubtest248of100,1,323,5170,24,340,5534
subtest210of10,pubtest248of100,1,323,5170,23,380,5573
subtest27of10,pubtest249of100,1,323,5230,9,41,5280
subtest24of10,pubtest249of100,1,323,5230,18,72,5320
subtest25of10,pubtest249of100,1,323,5230,17,113,5360
subtest21of10,pubtest249of100,1,323,5230,19,461,5710
subtest28of10,pubtest249of100,1,323,5230,19,461,5710
subtest23of10,pubtest249of100,1,323,5230,24,494,5748
subtest26of10,pubtest249of100,1,323,5230,24,533,5787
subtest29of10,pubtest249of100,1,323,5230,25,571,5826
subtest22of10,pubtest249of100,1,323,5230,63,574,5867
subtest210of10,pubtest249of100,1,323,5230,64,614,5908
subtest27of10,pubtest250of100,1,323,5213,10,39,5262
subtest28of10,pubtest250of100,1,323,5213,10,78,5301
subtest23of10,pubtest250of100,1,323,5213,11,117,5341
subtest29of10,pubtest250of100,1,323,5213,13,155,5381
subtest21of10,pubtest250of100,1,323,5213,14,194,5421
subtest24of10,pubtest250of100,1,323,5213,15,233,5461
subtest25of10,pubtest250of100,1,323,5213,20,268,5501
subtest210of10,pubtest250of100,1,323,5213,29,299,5541
subtest26of10,pubtest250of100,1,323,5213,30,337,5580
subtest22of10,pubtest250of100,1,323,5213,32,376,5621
subtest23of10,pubtest251of100,1,323,5172,8,38,5218
subtest27of10,pubtest251of100,1,323,5172,9,77,5258
subtest25of10,pubtest251of100,1,323,5172,10,115,5297
subtest21of10,pubtest251of100,1,323,5172,13,152,5337
subtest29of10,pubtest251of100,1,323,5172,16,189,5377
subtest22of10,pubtest251of100,1,323,5172,16,229,5417
subtest210of10,pubtest251of100,1,323,5172,23,261,5456
subtest28of10,pubtest251of100,1,323,5172,23,302,5497
subtest24of10,pubtest251of100,1,323,5172,23,339,5534
subtest26of10,pubtest251of100,1,323,5172,26,379,5577
subtest28of10,pubtest252of100,1,323,5346,9,42,5397
subtest29of10,pubtest252of100,1,323,5346,10,80,5436
subtest21of10,pubtest252of100,1,323,5346,12,118,5476
subtest26of10,pubtest252of100,1,323,5346,12,158,5516
subtest25of10,pubtest252of100,1,323,5346,15,195,5556
subtest27of10,pubtest252of100,1,323,5346,15,234,5595
subtest23of10,pubtest252of100,1,323,5346,17,273,5636
subtest22of10,pubtest252of100,1,323,5346,20,310,5676
subtest24of10,pubtest252of100,1,323,5346,21,350,5717
subtest210of10,pubtest252of100,1,323,5346,22,388,5756
subtest28of10,pubtest253of100,1,322,5249,9,39,5297
subtest23of10,pubtest253of100,1,322,5249,11,79,5339
subtest24of10,pubtest253of100,1,322,5249,14,115,5378
subtest25of10,pubtest253of100,1,322,5249,17,152,5418
subtest22of10,pubtest253of100,1,322,5249,20,190,5459
subtest29of10,pubtest253of100,1,322,5249,20,229,5498
subtest27of10,pubtest253of100,1,322,5249,21,269,5539
subtest21of10,pubtest253of100,1,322,5249,22,307,5578
subtest210of10,pubtest253of100,1,322,5249,29,340,5618
subtest26of10,pubtest253of100,1,322,5249,31,378,5658
subtest210of10,pubtest254of100,1,323,5326,8,42,5376
subtest27of10,pubtest254of100,1,323,5326,9,79,5414
subtest21of10,pubtest254of100,1,323,5326,11,117,5454
subtest28of10,pubtest254of100,1,323,5326,12,156,5494
subtest25of10,pubtest254of100,1,323,5326,12,196,5534
subtest23of10,pubtest254of100,1,323,5326,15,234,5575
subtest29of10,pubtest254of100,1,323,5326,20,268,5614
subtest24of10,pubtest254of100,1,323,5326,20,308,5654
subtest22of10,pubtest254of100,1,323,5326,22,345,5693
subtest26of10,pubtest254of100,1,323,5326,24,384,5734
subtest22of10,pubtest255of100,1,322,5221,10,38,5269
subtest28of10,pubtest255of100,1,322,5221,20,67,5308
subtest23of10,pubtest255of100,1,322,5221,20,107,5348
subtest27of10,pubtest255of100,1,322,5221,21,147,5389
subtest21of10,pubtest255of100,1,322,5221,23,182,5426
subtest24of10,pubtest255of100,1,322,5221,23,222,5466
subtest25of10,pubtest255of100,1,322,5221,27,261,5509
subtest210of10,pubtest255of100,1,322,5221,27,300,5548
subtest29of10,pubtest255of100,1,322,5221,23,339,5583
subtest26of10,pubtest255of100,1,322,5221,28,379,5628
subtest29of10,pubtest256of100,1,323,5327,6,45,5378
subtest21of10,pubtest256of100,1,323,5327,7,82,5416
subtest26of10,pubtest256of100,1,323,5327,9,121,5457
subtest210of10,pubtest256of100,1,323,5327,13,157,5497
subtest25of10,pubtest256of100,1,323,5327,14,195,5536
subtest23of10,pubtest256of100,1,323,5327,15,235,5577
subtest28of10,pubtest256of100,1,323,5327,16,274,5617
subtest27of10,pubtest256of100,1,323,5327,17,313,5657
subtest22of10,pubtest256of100,1,323,5327,18,352,5697
subtest24of10,pubtest256of100,1,323,5327,18,392,5737
subtest24of10,pubtest257of100,1,323,5417,9,46,5472
subtest21of10,pubtest257of100,1,323,5417,9,85,5511
subtest28of10,pubtest257of100,1,323,5417,11,123,5551
subtest27of10,pubtest257of100,1,323,5417,11,163,5591
subtest22of10,pubtest257of100,1,323,5417,15,200,5632
subtest23of10,pubtest257of100,1,323,5417,16,238,5671
subtest29of10,pubtest257of100,1,323,5417,20,274,5711
subtest210of10,pubtest257of100,1,323,5417,20,314,5751
subtest25of10,pubtest257of100,1,323,5417,24,350,5791
subtest26of10,pubtest257of100,1,323,5417,25,389,5831
subtest28of10,pubtest258of100,1,323,5257,7,43,5307
subtest23of10,pubtest258of100,1,323,5257,8,82,5347
subtest25of10,pubtest258of100,1,323,5257,10,119,5386
subtest21of10,pubtest258of100,1,323,5257,10,159,5426
subtest26of10,pubtest258of100,1,323,5257,11,198,5466
subtest29of10,pubtest258of100,1,323,5257,23,226,5506
subtest27of10,pubtest258of100,1,323,5257,23,266,5546
subtest24of10,pubtest258of100,1,323,5257,25,302,5584
subtest210of10,pubtest258of100,1,323,5257,24,342,5623
subtest22of10,pubtest258of100,1,323,5257,25,382,5664
subtest21of10,pubtest259of100,1,323,5341,11,41,5393
subtest28of10,pubtest259of100,1,323,5341,15,76,5432
subtest25of10,pubtest259of100,1,323,5341,15,116,5472
subtest24of10,pubtest259of100,1,323,5341,16,155,5512
subtest27of10,pubtest259of100,1,323,5341,19,192,5552
subtest23of10,pubtest259of100,1,323,5341,20,229,5590
subtest26of10,pubtest259of100,1,323,5341,25,266,5632
subtest29of10,pubtest259of100,1,323,5341,25,306,5672
subtest22of10,pubtest259of100,1,323,5341,27,344,5712
subtest210of10,pubtest259of100,1,323,5341,29,382,5752
subtest210of10,pubtest260of100,1,323,5167,8,242,5417
subtest23of10,pubtest260of100,1,323,5167,8,280,5455
subtest21of10,pubtest260of100,1,323,5167,251,76,5494
subtest24of10,pubtest260of100,1,323,5167,252,116,5535
subtest25of10,pubtest260of100,1,323,5167,253,154,5574
subtest28of10,pubtest260of100,1,323,5167,253,194,5614
subtest29of10,pubtest260of100,1,323,5167,255,232,5654
subtest22of10,pubtest260of100,1,323,5167,255,274,5696
subtest26of10,pubtest260of100,1,323,5167,256,312,5735
subtest27of10,pubtest260of100,1,323,5167,255,351,5773
subtest25of10,pubtest261of100,1,323,5266,9,42,5317
subtest28of10,pubtest261of100,1,323,5266,10,79,5355
subtest29of10,pubtest261of100,1,323,5266,12,117,5395
subtest210of10,pubtest261of100,1,323,5266,14,155,5435
subtest23of10,pubtest261of100,1,323,5266,15,195,5476
subtest22of10,pubtest261of100,1,323,5266,19,230,5515
subtest24of10,pubtest261of100,1,323,5266,20,269,5555
subtest27of10,pubtest261of100,1,323,5266,24,305,5595
subtest21of10,pubtest261of100,1,323,5266,29,339,5634
subtest26of10,pubtest261of100,1,323,5266,30,379,5675
subtest23of10,pubtest262of100,1,323,5335,8,38,5381
subtest22of10,pubtest262of100,1,323,5335,8,77,5420
subtest21of10,pubtest262of100,1,323,5335,7,116,5458
subtest26of10,pubtest262of100,1,323,5335,15,150,5500
subtest27of10,pubtest262of100,1,323,5335,15,190,5540
subtest29of10,pubtest262of100,1,323,5335,18,225,5578
subtest25of10,pubtest262of100,1,323,5335,22,262,5619
subtest210of10,pubtest262of100,1,323,5335,23,302,5660
subtest24of10,pubtest262of100,1,323,5335,27,338,5700
subtest28of10,pubtest262of100,1,323,5335,28,377,5740
subtest22of10,pubtest263of100,1,322,5302,8,41,5351
subtest29of10,pubtest263of100,1,322,5302,10,77,5389
subtest23of10,pubtest263of100,1,322,5302,14,113,5429
subtest24of10,pubtest263of100,1,322,5302,13,153,5468
subtest26of10,pubtest263of100,1,322,5302,20,188,5510
subtest25of10,pubtest263of100,1,322,5302,21,226,5549
subtest210of10,pubtest263of100,1,322,5302,22,266,5590
subtest27of10,pubtest263of100,1,322,5302,27,300,5629
subtest28of10,pubtest263of100,1,322,5302,28,339,5669
subtest21of10,pubtest263of100,1,322,5302,31,377,5710
subtest22of10,pubtest264of100,1,322,5342,6,41,5389
subtest29of10,pubtest264of100,1,322,5342,10,76,5428
subtest24of10,pubtest264of100,1,322,5342,11,115,5468
subtest23of10,pubtest264of100,1,322,5342,11,155,5508
subtest27of10,pubtest264of100,1,322,5342,15,191,5548
subtest21of10,pubtest264of100,1,322,5342,15,231,5588
subtest25of10,pubtest264of100,1,322,5342,18,268,5628
subtest26of10,pubtest264of100,1,322,5342,21,305,5668
subtest28of10,pubtest264of100,1,322,5342,20,345,5707
subtest210of10,pubtest264of100,1,322,5342,40,364,5746
subtest26of10,pubtest265of100,1,323,5149,11,42,5202
subtest27of10,pubtest265of100,1,323,5149,12,80,5241
subtest210of10,pubtest265of100,1,323,5149,21,110,5280
subtest22of10,pubtest265of100,1,323,5149,33,138,5320
subtest29of10,pubtest265of100,1,323,5149,37,174,5360
subtest21of10,pubtest265of100,1,323,5149,37,214,5400
subtest25of10,pubtest265of100,1,323,5149,41,250,5440
subtest24of10,pubtest265of100,1,323,5149,42,289,5480
subtest23of10,pubtest265of100,1,323,5149,42,329,5520
subtest28of10,pubtest265of100,1,323,5149,41,368,5558
subtest29of10,pubtest266of100,1,321,5349,7,38,5394
subtest25of10,pubtest266of100,1,321,5349,12,71,5432
subtest210of10,pubtest266of100,1,321,5349,31,94,5474
subtest27of10,pubtest266of100,1,321,5349,33,131,5513
subtest23of10,pubtest266of100,1,321,5349,35,170,5554
subtest26of10,pubtest266of100,1,321,5349,39,206,5594
subtest28of10,pubtest266of100,1,321,5349,40,245,5634
subtest21of10,pubtest266of100,1,321,5349,41,283,5673
subtest24of10,pubtest266of100,1,321,5349,44,320,5713
subtest22of10,pubtest266of100,1,321,5349,46,358,5753
subtest23of10,pubtest267of100,1,323,5215,8,45,5268
subtest26of10,pubtest267of100,1,323,5215,12,80,5307
subtest28of10,pubtest267of100,1,323,5215,17,115,5347
subtest25of10,pubtest267of100,1,323,5215,19,153,5387
subtest24of10,pubtest267of100,1,323,5215,24,188,5427
subtest29of10,pubtest267of100,1,323,5215,25,227,5467
subtest27of10,pubtest267of100,1,323,5215,26,266,5507
subtest21of10,pubtest267of100,1,323,5215,31,299,5545
subtest22of10,pubtest267of100,1,323,5215,33,339,5587
subtest210of10,pubtest267of100,1,323,5215,34,378,5627
subtest23of10,pubtest268of100,1,323,5237,7,41,5285
subtest24of10,pubtest268of100,1,323,5237,10,78,5325
subtest25of10,pubtest268of100,1,323,5237,18,109,5364
subtest29of10,pubtest268of100,1,323,5237,19,146,5402
subtest27of10,pubtest268of100,1,323,5237,23,184,5444
subtest28of10,pubtest268of100,1,323,5237,52,195,5484
subtest21of10,pubtest268of100,1,323,5237,57,230,5524
subtest22of10,pubtest268of100,1,323,5237,58,270,5565
subtest210of10,pubtest268of100,1,323,5237,59,308,5604
subtest26of10,pubtest268of100,1,323,5237,59,348,5644
subtest24of10,pubtest269of100,1,323,5321,11,185,5517
subtest27of10,pubtest269of100,1,323,5321,13,222,5556
subtest210of10,pubtest269of100,1,323,5321,13,261,5595
subtest25of10,pubtest269of100,1,323,5321,19,296,5636
subtest26of10,pubtest269of100,1,323,5321,22,333,5676
subtest23of10,pubtest269of100,1,323,5321,23,371,5715
subtest29of10,pubtest269of100,1,323,5321,24,411,5756
subtest21of10,pubtest269of100,1,323,5321,23,448,5792
subtest22of10,pubtest269of100,1,323,5321,22,489,5832
subtest28of10,pubtest269of100,1,323,5321,28,527,5876
subtest23of10,pubtest270of100,1,323,5245,8,40,5293
subtest26of10,pubtest270of100,1,323,5245,10,77,5332
subtest27of10,pubtest270of100,1,323,5245,16,111,5372
subtest29of10,pubtest270of100,1,323,5245,17,150,5412
subtest210of10,pubtest270of100,1,323,5245,18,187,5450
subtest21of10,pubtest270of100,1,323,5245,22,225,5492
subtest25of10,pubtest270of100,1,323,5245,21,265,5531
subtest24of10,pubtest270of100,1,323,5245,23,304,5572
subtest28of10,pubtest270of100,1,323,5245,23,343,5611
subtest22of10,pubtest270of100,1,323,5245,25,382,5652
subtest24of10,pubtest271of100,1,323,5205,5,44,5254
subtest25of10,pubtest271of100,1,323,5205,9,82,5296
subtest27of10,pubtest271of100,1,323,5205,10,120,5335
subtest22of10,pubtest271of100,1,323,5205,11,159,5375
subtest210of10,pubtest271of100,1,323,5205,18,192,5415
subtest26of10,pubtest271of100,1,323,5205,21,229,5455
subtest21of10,pubtest271of100,1,323,5205,21,268,5494
subtest23of10,pubtest271of100,1,323,5205,22,308,5535
subtest29of10,pubtest271of100,1,323,5205,23,347,5575
subtest28of10,pubtest271of100,1,323,5205,25,385,5615
subtest25of10,pubtest272of100,1,323,5258,7,40,5305
subtest21of10,pubtest272of100,1,323,5258,11,76,5345
subtest26of10,pubtest272of100,1,323,5258,13,113,5384
subtest29of10,pubtest272of100,1,323,5258,17,149,5424
subtest24of10,pubtest272of100,1,323,5258,20,185,5463
subtest27of10,pubtest272of100,1,323,5258,20,225,5503
subtest23of10,pubtest272of100,1,323,5258,23,263,5544
subtest210of10,pubtest272of100,1,323,5258,55,271,5584
subtest22of10,pubtest272of100,1,323,5258,55,311,5624
subtest28of10,pubtest272of100,1,323,5258,57,349,5664
subtest22of10,pubtest273of100,1,321,5207,8,43,5258
subtest26of10,pubtest273of100,1,321,5207,11,79,5297
subtest29of10,pubtest273of100,1,321,5207,13,119,5339
subtest25of10,pubtest273of100,1,321,5207,19,152,5378
subtest28of10,pubtest273of100,1,321,5207,20,191,5418
subtest210of10,pubtest273of100,1,321,5207,22,228,5457
subtest27of10,pubtest273of100,1,321,5207,22,268,5497
subtest23of10,pubtest273of100,1,321,5207,24,306,5537
subtest24of10,pubtest273of100,1,321,5207,26,344,5577
subtest21of10,pubtest273of100,1,321,5207,26,384,5617
subtest21of10,pubtest274of100,1,323,5227,11,40,5278
subtest26of10,pubtest274of100,1,323,5227,13,77,5317
subtest23of10,pubtest274of100,1,323,5227,17,113,5357
subtest22of10,pubtest274of100,1,323,5227,19,151,5397
subtest29of10,pubtest274of100,1,323,5227,19,191,5437
subtest25of10,pubtest274of100,1,323,5227,21,229,5477
subtest28of10,pubtest274of100,1,323,5227,26,263,5516
subtest27of10,pubtest274of100,1,323,5227,26,303,5556
subtest24of10,pubtest274of100,1,323,5227,32,338,5597
subtest210of10,pubtest274of100,1,323,5227,39,371,5637
subtest24of10,pubtest275of100,1,323,5235,9,41,5285
subtest29of10,pubtest275of100,1,323,5235,10,81,5326
subtest27of10,pubtest275of100,1,323,5235,8,119,5362
subtest25of10,pubtest275of100,1,323,5235,16,154,5405
subtest21of10,pubtest275of100,1,323,5235,18,192,5445
subtest22of10,pubtest275of100,1,323,5235,19,232,5486
subtest210of10,pubtest275of100,1,323,5235,22,268,5525
subtest26of10,pubtest275of100,1,323,5235,23,307,5565
subtest23of10,pubtest275of100,1,323,5235,22,346,5603
subtest28of10,pubtest275of100,1,323,5235,27,384,5646
subtest28of10,pubtest276of100,1,323,5281,8,41,5330
subtest21of10,pubtest276of100,1,323,5281,10,78,5369
subtest25of10,pubtest276of100,1,323,5281,11,118,5410
subtest27of10,pubtest276of100,1,323,5281,12,157,5450
subtest29of10,pubtest276of100,1,323,5281,18,191,5490
subtest24of10,pubtest276of100,1,323,5281,39,209,5529
subtest26of10,pubtest276of100,1,323,5281,40,249,5570
subtest23of10,pubtest276of100,1,323,5281,40,288,5609
subtest22of10,pubtest276of100,1,323,5281,39,328,5648
subtest210of10,pubtest276of100,1,323,5281,41,367,5689
subtest22of10,pubtest277of100,1,323,5238,9,238,5485
subtest29of10,pubtest277of100,1,323,5238,12,275,5525
subtest28of10,pubtest277of100,1,323,5238,14,312,5564
subtest21of10,pubtest277of100,1,323,5238,14,354,5606
subtest27of10,pubtest277of100,1,323,5238,14,392,5644
subtest24of10,pubtest277of100,1,323,5238,17,428,5683
subtest23of10,pubtest277of100,1,323,5238,18,467,5723
subtest210of10,pubtest277of100,1,323,5238,20,507,5765
subtest26of10,pubtest277of100,1,323,5238,20,546,5804
subtest25of10,pubtest277of100,1,323,5238,18,585,5841
subtest29of10,pubtest278of100,1,323,5291,10,41,5342
subtest22of10,pubtest278of100,1,323,5291,19,70,5380
subtest23of10,pubtest278of100,1,323,5291,19,110,5420
subtest28of10,pubtest278of100,1,323,5291,21,149,5461
subtest21of10,pubtest278of100,1,323,5291,24,186,5501
subtest26of10,pubtest278of100,1,323,5291,25,223,5539
subtest25of10,pubtest278of100,1,323,5291,25,263,5579
subtest24of10,pubtest278of100,1,323,5291,28,302,5621
subtest27of10,pubtest278of100,1,323,5291,24,341,5656
subtest210of10,pubtest278of100,1,323,5291,31,379,5701
subtest24of10,pubtest279of100,1,323,5379,21,44,5444
subtest28of10,pubtest279of100,1,323,5379,18,86,5483
subtest21of10,pubtest279of100,1,323,5379,21,123,5523
subtest29of10,pubtest279of100,1,323,5379,22,163,5564
subtest27of10,pubtest279of100,1,323,5379,22,202,5603
subtest25of10,pubtest279of100,1,323,5379,19,241,5639
subtest23of10,pubtest279of100,1,323,5379,29,275,5683
subtest26of10,pubtest279of100,1,323,5379,29,315,5723
subtest22of10,pubtest279of100,1,323,5379,34,349,5762
subtest210of10,pubtest279of100,1,323,5379,34,389,5802
subtest27of10,pubtest280of100,1,323,5353,11,40,5404
subtest24of10,pubtest280of100,1,323,5353,11,79,5443
subtest29of10,pubtest280of100,1,323,5353,13,117,5483
subtest21of10,pubtest280of100,1,323,5353,13,157,5523
subtest23of10,pubtest280of100,1,323,5353,15,195,5563
subtest26of10,pubtest280of100,1,323,5353,15,235,5603
subtest210of10,pubtest280of100,1,323,5353,17,271,5641
subtest28of10,pubtest280of100,1,323,5353,19,311,5683
subtest25of10,pubtest280of100,1,323,5353,21,349,5723
subtest22of10,pubtest280of100,1,323,5353,21,389,5763
subtest24of10,pubtest281of100,1,323,5430,8,40,5478
subtest28of10,pubtest281of100,1,323,5430,11,78,5519
subtest23of10,pubtest281of100,1,323,5430,11,117,5558
subtest27of10,pubtest281of100,1,323,5430,18,149,5597
subtest25of10,pubtest281of100,1,323,5430,23,184,5637
subtest22of10,pubtest281of100,1,323,5430,24,223,5677
subtest21of10,pubtest281of100,1,323,5430,25,262,5717
subtest29of10,pubtest281of100,1,323,5430,26,301,5757
subtest210of10,pubtest281of100,1,323,5430,29,338,5797
subtest26of10,pubtest281of100,1,323,5430,30,377,5837
subtest23of10,pubtest282of100,1,323,5543,15,383,5941
subtest24of10,pubtest282of100,1,323,5543,15,421,5979
subtest21of10,pubtest282of100,1,323,5543,17,459,6019
subtest22of10,pubtest282of100,1,323,5543,18,498,6059
subtest25of10,pubtest282of100,1,323,5543,22,534,6099
subtest26of10,pubtest282of100,1,323,5543,23,573,6139
subtest210of10,pubtest282of100,1,323,5543,26,610,6179
subtest27of10,pubtest282of100,1,323,5543,27,649,6219
subtest28of10,pubtest282of100,1,323,5543,27,689,6259
subtest29of10,pubtest282of100,1,323,5543,25,728,6296
subtest27of10,pubtest283of100,1,323,5218,10,42,5270
subtest24of10,pubtest283of100,1,323,5218,9,80,5307
subtest23of10,pubtest283of100,1,323,5218,12,118,5348
subtest22of10,pubtest283of100,1,323,5218,13,157,5388
subtest25of10,pubtest283of100,1,323,5218,20,190,5428
subtest21of10,pubtest283of100,1,323,5218,23,227,5468
subtest28of10,pubtest283of100,1,323,5218,27,263,5508
subtest29of10,pubtest283of100,1,323,5218,29,301,5548
subtest210of10,pubtest283of100,1,323,5218,30,341,5589
subtest26of10,pubtest283of100,1,323,5218,31,377,5626
subtest25of10,pubtest284of100,1,323,5305,9,39,5353
subtest22of10,pubtest284of100,1,323,5305,10,78,5393
subtest29of10,pubtest284of100,1,323,5305,12,115,5432
subtest210of10,pubtest284of100,1,323,5305,17,150,5472
subtest27of10,pubtest284of100,1,323,5305,20,185,5510
subtest23of10,pubtest284of100,1,323,5305,23,225,5553
subtest21of10,pubtest284of100,1,323,5305,27,260,5592
subtest24of10,pubtest284of100,1,323,5305,32,295,5632
subtest28of10,pubtest284of100,1,323,5305,34,334,5673
subtest26of10,pubtest284of100,1,323,5305,37,370,5712
subtest23of10,pubtest285of100,1,323,5183,7,41,5231
subtest24of10,pubtest285of100,1,323,5183,9,78,5270
subtest25of10,pubtest285of100,1,323,5183,10,117,5310
subtest22of10,pubtest285of100,1,323,5183,14,153,5350
subtest27of10,pubtest285of100,1,323,5183,29,178,5390
subtest28of10,pubtest285of100,1,323,5183,33,215,5431
subtest21of10,pubtest285of100,1,323,5183,33,254,5470
subtest210of10,pubtest285of100,1,323,5183,35,292,5510
subtest26of10,pubtest285of100,1,323,5183,37,328,5548
subtest29of10,pubtest285of100,1,323,5183,37,368,5588
subtest23of10,pubtest286of100,1,323,5241,7,41,5289
subtest25of10,pubtest286of100,1,323,5241,7,80,5328
subtest210of10,pubtest286of100,1,323,5241,9,118,5368
subtest29of10,pubtest286of100,1,323,5241,23,142,5406
subtest24of10,pubtest286of100,1,323,5241,26,180,5447
subtest21of10,pubtest286of100,1,323,5241,27,220,5488
subtest26of10,pubtest286of100,1,323,5241,29,258,5528
subtest27of10,pubtest286of100,1,323,5241,33,295,5569
subtest22of10,pubtest286of100,1,323,5241,38,329,5608
subtest28of10,pubtest286of100,1,323,5241,38,368,5647
subtest26of10,pubtest287of100,1,323,5273,10,41,5324
subtest29of10,pubtest287of100,1,323,5273,12,79,5364
subtest28of10,pubtest287of100,1,323,5273,13,117,5403
subtest210of10,pubtest287of100,1,323,5273,17,153,5443
subtest25of10,pubtest287of100,1,323,5273,22,188,5483
subtest21of10,pubtest287of100,1,323,5273,22,228,5523
subtest27of10,pubtest287of100,1,323,5273,22,267,5562
subtest23of10,pubtest287of100,1,323,5273,26,302,5601
subtest24of10,pubtest287of100,1,323,5273,26,341,5640
subtest22of10,pubtest287of100,1,323,5273,28,381,5682
subtest29of10,pubtest288of100,1,323,5344,8,39,5391
subtest26of10,pubtest288of100,1,323,5344,10,76,5430
subtest27of10,pubtest288of100,1,323,5344,11,113,5468
subtest21of10,pubtest288of100,1,323,5344,13,153,5510
subtest22of10,pubtest288of100,1,323,5344,14,192,5550
subtest23of10,pubtest288of100,1,323,5344,15,231,5590
subtest25of10,pubtest288of100,1,323,5344,9,270,5623
subtest210of10,pubtest288of100,1,323,5344,21,305,5670
subtest24of10,pubtest288of100,1,323,5344,22,347,5713
subtest28of10,pubtest288of100,1,323,5344,34,373,5751
subtest29of10,pubtest289of100,1,323,5331,9,41,5381
subtest210of10,pubtest289of100,1,323,5331,11,78,5420
subtest24of10,pubtest289of100,1,323,5331,28,101,5460
subtest26of10,pubtest289of100,1,323,5331,30,140,5501
subtest23of10,pubtest289of100,1,323,5331,31,178,5540
subtest25of10,pubtest289of100,1,323,5331,32,217,5580
subtest27of10,pubtest289of100,1,323,5331,35,254,5620
subtest28of10,pubtest289of100,1,323,5331,37,291,5659
subtest22of10,pubtest289of100,1,323,5331,39,330,5700
subtest21of10,pubtest289of100,1,323,5331,37,370,5738
subtest23of10,pubtest290of100,1,323,5303,14,91,5408
subtest29of10,pubtest290of100,1,323,5303,9,97,5409
subtest22of10,pubtest290of100,1,323,5303,13,116,5432
subtest25of10,pubtest290of100,1,323,5303,15,154,5472
subtest26of10,pubtest290of100,1,323,5303,16,193,5512
subtest27of10,pubtest290of100,1,323,5303,17,232,5552
subtest210of10,pubtest290of100,1,323,5303,20,269,5592
subtest21of10,pubtest290of100,1,323,5303,21,308,5632
subtest28of10,pubtest290of100,1,323,5303,21,349,5673
subtest24of10,pubtest290of100,1,323,5303,22,304,5629
subtest23of10,pubtest291of100,1,323,5284,24,42,5350
subtest24of10,pubtest291of100,1,323,5284,24,81,5389
subtest28of10,pubtest291of100,1,323,5284,26,120,5430
subtest27of10,pubtest291of100,1,323,5284,26,159,5469
subtest210of10,pubtest291of100,1,323,5284,33,192,5509
subtest21of10,pubtest291of100,1,323,5284,32,232,5548
subtest25of10,pubtest291of100,1,323,5284,34,271,5589
subtest29of10,pubtest291of100,1,323,5284,35,311,5630
subtest22of10,pubtest291of100,1,323,5284,36,349,5669
subtest26of10,pubtest291of100,1,323,5284,36,389,5709
subtest28of10,pubtest292of100,1,323,5155,9,41,5205
subtest25of10,pubtest292of100,1,323,5155,13,76,5244
subtest21of10,pubtest292of100,1,323,5155,13,116,5284
subtest27of10,pubtest292of100,1,323,5155,14,155,5324
subtest29of10,pubtest292of100,1,323,5155,11,195,5361
subtest26of10,pubtest292of100,1,323,5155,16,233,5404
subtest23of10,pubtest292of100,1,323,5155,16,274,5445
subtest22of10,pubtest292of100,1,323,5155,18,311,5484
subtest24of10,pubtest292of100,1,323,5155,21,348,5524
subtest210of10,pubtest292of100,1,323,5155,27,382,5564
subtest24of10,pubtest293of100,1,323,5188,10,41,5239
subtest25of10,pubtest293of100,1,323,5188,14,77,5279
subtest28of10,pubtest293of100,1,323,5188,17,114,5319
subtest23of10,pubtest293of100,1,323,5188,17,155,5360
subtest210of10,pubtest293of100,1,323,5188,21,190,5399
subtest27of10,pubtest293of100,1,323,5188,23,228,5439
subtest29of10,pubtest293of100,1,323,5188,25,266,5479
subtest21of10,pubtest293of100,1,323,5188,25,306,5519
subtest26of10,pubtest293of100,1,323,5188,31,340,5559
subtest22of10,pubtest293of100,1,323,5188,37,374,5599
subtest21of10,pubtest294of100,1,323,5231,9,49,5289
subtest29of10,pubtest294of100,1,323,5231,10,88,5329
subtest210of10,pubtest294of100,1,323,5231,12,125,5368
subtest25of10,pubtest294of100,1,323,5231,9,168,5408
subtest27of10,pubtest294of100,1,323,5231,18,199,5448
subtest23of10,pubtest294of100,1,323,5231,23,234,5488
subtest26of10,pubtest294of100,1,323,5231,26,271,5528
subtest24of10,pubtest294of100,1,323,5231,32,305,5568
subtest22of10,pubtest294of100,1,323,5231,32,345,5608
subtest28of10,pubtest294of100,1,323,5231,74,341,5646
subtest25of10,pubtest295of100,1,323,5209,7,44,5260
subtest24of10,pubtest295of100,1,323,5209,8,82,5299
subtest27of10,pubtest295of100,1,323,5209,10,120,5339
subtest23of10,pubtest295of100,1,323,5209,11,159,5379
subtest22of10,pubtest295of100,1,323,5209,15,195,5419
subtest210of10,pubtest295of100,1,323,5209,19,231,5459
subtest29of10,pubtest295of100,1,323,5209,20,270,5499
subtest21of10,pubtest295of100,1,323,5209,21,310,5540
subtest28of10,pubtest295of100,1,323,5209,21,350,5580
subtest26of10,pubtest295of100,1,323,5209,24,384,5617
subtest25of10,pubtest296of100,1,322,5304,11,38,5353
subtest27of10,pubtest296of100,1,322,5304,12,76,5392
subtest23of10,pubtest296of100,1,322,5304,13,114,5431
subtest26of10,pubtest296of100,1,322,5304,13,154,5471
subtest24of10,pubtest296of100,1,322,5304,11,193,5508
subtest21of10,pubtest296of100,1,322,5304,17,232,5553
subtest29of10,pubtest296of100,1,322,5304,17,271,5592
subtest28of10,pubtest296of100,1,322,5304,23,305,5632
subtest210of10,pubtest296of100,1,322,5304,24,344,5672
subtest22of10,pubtest296of100,1,322,5304,28,380,5712
subtest25of10,pubtest297of100,1,323,5371,9,272,5652
subtest29of10,pubtest297of100,1,323,5371,9,313,5693
subtest210of10,pubtest297of100,1,323,5371,10,351,5732
subtest22of10,pubtest297of100,1,323,5371,19,382,5772
subtest23of10,pubtest297of100,1,323,5371,20,423,5814
subtest27of10,pubtest297of100,1,323,5371,23,458,5852
subtest21of10,pubtest297of100,1,323,5371,31,489,5891
subtest26of10,pubtest297of100,1,323,5371,31,529,5931
subtest24of10,pubtest297of100,1,323,5371,36,565,5972
subtest28of10,pubtest297of100,1,323,5371,36,605,6012
subtest29of10,pubtest298of100,1,323,5222,8,44,5274
subtest22of10,pubtest298of100,1,323,5222,8,82,5312
subtest25of10,pubtest298of100,1,323,5222,10,120,5352
subtest24of10,pubtest298of100,1,323,5222,12,159,5393
subtest23of10,pubtest298of100,1,323,5222,13,197,5432
subtest21of10,pubtest298of100,1,323,5222,16,232,5470
subtest210of10,pubtest298of100,1,323,5222,17,271,5510
subtest27of10,pubtest298of100,1,323,5222,20,310,5552
subtest28of10,pubtest298of100,1,323,5222,20,350,5592
subtest26of10,pubtest298of100,1,323,5222,47,363,5632
subtest29of10,pubtest299of100,1,323,5204,9,42,5255
subtest22of10,pubtest299of100,1,323,5204,9,81,5294
subtest210of10,pubtest299of100,1,323,5204,15,115,5334
subtest27of10,pubtest299of100,1,323,5204,18,152,5374
subtest24of10,pubtest299of100,1,323,5204,19,192,5415
subtest23of10,pubtest299of100,1,323,5204,24,226,5454
subtest21of10,pubtest299of100,1,323,5204,25,265,5494
subtest25of10,pubtest299of100,1,323,5204,26,304,5534
subtest26of10,pubtest299of100,1,323,5204,27,343,5574
subtest28of10,pubtest299of100,1,323,5204,27,383,5614
subtest21of10,pubtest2100of100,1,325,5193,13,40,5246
subtest29of10,pubtest2100of100,1,325,5193,17,75,5285
subtest24of10,pubtest2100of100,1,325,5193,23,109,5325
subtest23of10,pubtest2100of100,1,325,5193,23,147,5363
subtest22of10,pubtest2100of100,1,325,5193,26,187,5406
subtest27of10,pubtest2100of100,1,325,5193,27,225,5445
subtest28of10,pubtest2100of100,1,325,5193,41,251,5485
subtest25of10,pubtest2100of100,1,325,5193,41,290,5524
subtest210of10,pubtest2100of100,1,325,5193,43,328,5564
subtest26of10,pubtest2100of100,1,325,5193,44,368,5605
subtest27of10,pubtest21of100,1,322,10266,13,40,10319
subtest26of10,pubtest21of100,1,322,10266,14,78,10358
subtest29of10,pubtest21of100,1,322,10266,15,115,10396
subtest21of10,pubtest21of100,1,322,10266,18,158,10442
subtest25of10,pubtest21of100,1,322,10266,18,198,10482
subtest24of10,pubtest21of100,1,322,10266,20,236,10522
subtest210of10,pubtest21of100,1,322,10266,20,276,10562
subtest23of10,pubtest21of100,1,322,10266,21,314,10601
subtest28of10,pubtest21of100,1,322,10266,22,354,10642
subtest22of10,pubtest21of100,1,322,10266,24,392,10682
subtest29of10,pubtest22of100,1,321,5289,5,42,5336
subtest24of10,pubtest22of100,1,321,5289,12,74,5375
subtest27of10,pubtest22of100,1,321,5289,10,114,5413
subtest23of10,pubtest22of100,1,321,5289,13,153,5455
subtest25of10,pubtest22of100,1,321,5289,20,186,5495
subtest28of10,pubtest22of100,1,321,5289,23,223,5535
subtest21of10,pubtest22of100,1,321,5289,26,261,5576
subtest26of10,pubtest22of100,1,321,5289,32,294,5615
subtest210of10,pubtest22of100,1,321,5289,33,333,5655
subtest22of10,pubtest22of100,1,321,5289,34,372,5695
subtest23of10,pubtest23of100,1,321,5367,9,40,5416
subtest28of10,pubtest23of100,1,321,5367,10,78,5455
subtest29of10,pubtest23of100,1,321,5367,10,117,5494
subtest24of10,pubtest23of100,1,321,5367,18,150,5535
subtest27of10,pubtest23of100,1,321,5367,19,189,5575
subtest25of10,pubtest23of100,1,321,5367,20,228,5615
subtest26of10,pubtest23of100,1,321,5367,22,266,5655
subtest21of10,pubtest23of100,1,321,5367,22,307,5696
subtest22of10,pubtest23of100,1,321,5367,26,342,5735
subtest210of10,pubtest23of100,1,321,5367,27,381,5775
subtest24of10,pubtest24of100,1,321,5213,7,41,5261
subtest23of10,pubtest24of100,1,321,5213,11,76,5300
subtest25of10,pubtest24of100,1,321,5213,12,116,5341
subtest28of10,pubtest24of100,1,321,5213,12,155,5380
subtest21of10,pubtest24of100,1,321,5213,16,191,5420
subtest27of10,pubtest24of100,1,321,5213,19,230,5462
subtest29of10,pubtest24of100,1,321,5213,20,267,5500
subtest22of10,pubtest24of100,1,321,5213,22,305,5540
subtest210of10,pubtest24of100,1,321,5213,24,343,5580
subtest26of10,pubtest24of100,1,321,5213,24,383,5620
subtest28of10,pubtest25of100,1,321,5159,6,39,5204
subtest210of10,pubtest25of100,1,321,5159,8,75,5242
subtest26of10,pubtest25of100,1,321,5159,11,114,5284
subtest21of10,pubtest25of100,1,321,5159,17,147,5323
subtest27of10,pubtest25of100,1,321,5159,18,187,5364
subtest22of10,pubtest25of100,1,321,5159,21,223,5403
subtest25of10,pubtest25of100,1,321,5159,24,260,5443
subtest23of10,pubtest25of100,1,321,5159,25,299,5483
subtest24of10,pubtest25of100,1,321,5159,26,338,5523
subtest29of10,pubtest25of100,1,321,5159,27,377,5563
subtest22of10,pubtest26of100,1,321,5287,4,39,5330
subtest21of10,pubtest26of100,1,321,5287,5,78,5370
subtest29of10,pubtest26of100,1,321,5287,6,117,5410
subtest23of10,pubtest26of100,1,321,5287,7,156,5450
subtest26of10,pubtest26of100,1,321,5287,9,194,5490
subtest27of10,pubtest26of100,1,321,5287,9,233,5529
subtest210of10,pubtest26of100,1,321,5287,10,273,5570
subtest25of10,pubtest26of100,1,321,5287,11,312,5610
subtest28of10,pubtest26of100,1,321,5287,13,350,5650
subtest24of10,pubtest26of100,1,321,5287,16,387,5690
subtest27of10,pubtest27of100,1,320,5188,12,42,5242
subtest28of10,pubtest27of100,1,320,5188,13,81,5282
subtest24of10,pubtest27of100,1,320,5188,15,119,5322
subtest29of10,pubtest27of100,1,320,5188,16,158,5362
subtest23of10,pubtest27of100,1,320,5188,13,197,5398
subtest210of10,pubtest27of100,1,320,5188,25,229,5442
subtest25of10,pubtest27of100,1,320,5188,24,269,5481
subtest22of10,pubtest27of100,1,320,5188,28,306,5522
subtest21of10,pubtest27of100,1,320,5188,28,346,5562
subtest26of10,pubtest27of100,1,320,5188,30,384,5602
subtest27of10,pubtest28of100,1,321,5251,4,40,5295
subtest28of10,pubtest28of100,1,321,5251,9,73,5333
subtest21of10,pubtest28of100,1,321,5251,9,113,5373
subtest29of10,pubtest28of100,1,321,5251,17,145,5413
subtest23of10,pubtest28of100,1,321,5251,17,184,5452
subtest25of10,pubtest28of100,1,321,5251,18,224,5493
subtest210of10,pubtest28of100,1,321,5251,24,258,5533
subtest26of10,pubtest28of100,1,321,5251,24,298,5573
subtest24of10,pubtest28of100,1,321,5251,31,331,5613
subtest22of10,pubtest28of100,1,321,5251,32,370,5653
subtest23of10,pubtest29of100,1,321,5214,7,41,5262
subtest29of10,pubtest29of100,1,321,5214,16,72,5302
subtest210of10,pubtest29of100,1,321,5214,18,109,5341
subtest22of10,pubtest29of100,1,321,5214,22,145,5381
subtest28of10,pubtest29of100,1,321,5214,22,183,5419
subtest24of10,pubtest29of100,1,321,5214,25,222,5461
subtest26of10,pubtest29of100,1,321,5214,27,260,5501
subtest21of10,pubtest29of100,1,321,5214,25,303,5542
subtest27of10,pubtest29of100,1,321,5214,28,339,5581
subtest25of10,pubtest29of100,1,321,5214,27,380,5621
subtest29of10,pubtest210of100,1,323,5252,7,42,5301
subtest21of10,pubtest210of100,1,323,5252,9,79,5340
subtest210of10,pubtest210of100,1,323,5252,17,109,5378
subtest27of10,pubtest210of100,1,323,5252,20,148,5420
subtest23of10,pubtest210of100,1,323,5252,20,188,5460
subtest24of10,pubtest210of100,1,323,5252,22,226,5500
subtest28of10,pubtest210of100,1,323,5252,23,265,5540
subtest25of10,pubtest210of100,1,323,5252,22,305,5579
subtest22of10,pubtest210of100,1,323,5252,24,344,5620
subtest26of10,pubtest210of100,1,323,5252,25,383,5660
subtest210of10,pubtest211of100,1,323,5360,9,44,5413
subtest29of10,pubtest211of100,1,323,5360,11,80,5451
subtest24of10,pubtest211of100,1,323,5360,12,121,5493
subtest21of10,pubtest211of100,1,323,5360,14,159,5533
subtest22of10,pubtest211of100,1,323,5360,15,197,5572
subtest25of10,pubtest211of100,1,323,5360,16,236,5612
subtest26of10,pubtest211of100,1,323,5360,20,272,5652
subtest23of10,pubtest211of100,1,323,5360,21,311,5692
subtest27of10,pubtest211of100,1,323,5360,22,351,5733
subtest28of10,pubtest211of100,1,323,5360,23,391,5774
subtest25of10,pubtest212of100,1,323,5233,18,40,5291
subtest29of10,pubtest212of100,1,323,5233,19,78,5330
subtest28of10,pubtest212of100,1,323,5233,21,116,5370
subtest23of10,pubtest212of100,1,323,5233,21,156,5410
subtest24of10,pubtest212of100,1,323,5233,22,195,5450
subtest27of10,pubtest212of100,1,323,5233,23,234,5490
subtest21of10,pubtest212of100,1,323,5233,26,272,5531
subtest22of10,pubtest212of100,1,323,5233,29,309,5571
subtest26of10,pubtest212of100,1,323,5233,29,348,5610
subtest210of10,pubtest212of100,1,323,5233,30,387,5650
subtest23of10,pubtest213of100,1,322,5215,8,39,5262
subtest26of10,pubtest213of100,1,322,5215,10,76,5301
subtest29of10,pubtest213of100,1,322,5215,10,116,5341
subtest22of10,pubtest213of100,1,322,5215,12,154,5381
subtest27of10,pubtest213of100,1,322,5215,14,193,5422
subtest21of10,pubtest213of100,1,322,5215,18,228,5461
subtest24of10,pubtest213of100,1,322,5215,19,267,5501
subtest25of10,pubtest213of100,1,322,5215,28,298,5541
subtest210of10,pubtest213of100,1,322,5215,28,338,5581
subtest28of10,pubtest213of100,1,322,5215,29,377,5621
subtest21of10,pubtest214of100,1,323,5991,8,40,6039
subtest23of10,pubtest214of100,1,323,5991,9,79,6079
subtest25of10,pubtest214of100,1,323,5991,15,112,6118
subtest26of10,pubtest214of100,1,323,5991,20,147,6158
subtest210of10,pubtest214of100,1,323,5991,22,185,6198
subtest29of10,pubtest214of100,1,323,5991,22,225,6238
subtest27of10,pubtest214of100,1,323,5991,21,266,6278
subtest22of10,pubtest214of100,1,323,5991,22,304,6317
subtest24of10,pubtest214of100,1,323,5991,26,342,6359
subtest28of10,pubtest214of100,1,323,5991,52,355,6398
subtest27of10,pubtest215of100,1,323,5202,10,40,5252
subtest24of10,pubtest215of100,1,323,5202,10,79,5291
subtest29of10,pubtest215of100,1,323,5202,12,117,5331
subtest26of10,pubtest215of100,1,323,5202,14,155,5371
subtest21of10,pubtest215of100,1,323,5202,15,194,5411
subtest210of10,pubtest215of100,1,323,5202,22,226,5450
subtest25of10,pubtest215of100,1,323,5202,22,266,5490
subtest23of10,pubtest215of100,1,323,5202,28,301,5531
subtest22of10,pubtest215of100,1,323,5202,30,338,5570
subtest28of10,pubtest215of100,1,323,5202,31,378,5611
subtest24of10,pubtest216of100,1,323,5380,11,51,5442
subtest21of10,pubtest216of100,1,323,5380,12,88,5480
subtest29of10,pubtest216of100,1,323,5380,16,124,5520
subtest22of10,pubtest216of100,1,323,5380,17,163,5560
subtest25of10,pubtest216of100,1,323,5380,14,201,5595
subtest26of10,pubtest216of100,1,323,5380,20,239,5639
subtest27of10,pubtest216of100,1,323,5380,18,280,5678
subtest23of10,pubtest216of100,1,323,5380,18,318,5716
subtest28of10,pubtest216of100,1,323,5380,16,358,5754
subtest210of10,pubtest216of100,1,323,5380,24,395,5799
subtest22of10,pubtest217of100,1,322,5223,9,42,5274
subtest27of10,pubtest217of100,1,322,5223,8,82,5313
subtest21of10,pubtest217of100,1,322,5223,14,115,5352
subtest26of10,pubtest217of100,1,322,5223,16,153,5392
subtest24of10,pubtest217of100,1,322,5223,20,187,5430
subtest23of10,pubtest217of100,1,322,5223,20,226,5469
subtest210of10,pubtest217of100,1,322,5223,23,265,5511
subtest25of10,pubtest217of100,1,322,5223,22,304,5549
subtest28of10,pubtest217of100,1,322,5223,23,344,5590
subtest29of10,pubtest217of100,1,322,5223,24,383,5630
subtest29of10,pubtest218of100,1,323,5200,7,508,5715
subtest21of10,pubtest218of100,1,323,5200,8,547,5755
subtest22of10,pubtest218of100,1,323,5200,10,585,5795
subtest23of10,pubtest218of100,1,323,5200,20,615,5835
subtest28of10,pubtest218of100,1,323,5200,19,655,5874
subtest27of10,pubtest218of100,1,323,5200,19,693,5912
subtest24of10,pubtest218of100,1,323,5200,20,733,5953
subtest25of10,pubtest218of100,1,323,5200,25,770,5995
subtest210of10,pubtest218of100,1,323,5200,52,783,6035
subtest26of10,pubtest218of100,1,323,5200,54,821,6075
subtest22of10,pubtest219of100,1,323,5342,14,44,5400
subtest210of10,pubtest219of100,1,323,5342,11,86,5439
subtest26of10,pubtest219of100,1,323,5342,13,123,5478
subtest25of10,pubtest219of100,1,323,5342,11,162,5515
subtest21of10,pubtest219of100,1,323,5342,16,201,5559
subtest29of10,pubtest219of100,1,323,5342,18,239,5599
subtest23of10,pubtest219of100,1,323,5342,21,276,5639
subtest27of10,pubtest219of100,1,323,5342,24,313,5679
subtest24of10,pubtest219of100,1,323,5342,25,352,5719
subtest28of10,pubtest219of100,1,323,5342,26,394,5762
subtest25of10,pubtest220of100,1,323,5394,6,38,5438
subtest23of10,pubtest220of100,1,323,5394,12,71,5477
subtest210of10,pubtest220of100,1,323,5394,12,111,5517
subtest29of10,pubtest220of100,1,323,5394,14,149,5557
subtest21of10,pubtest220of100,1,323,5394,15,188,5597
subtest24of10,pubtest220of100,1,323,5394,16,228,5638
subtest27of10,pubtest220of100,1,323,5394,17,266,5677
subtest28of10,pubtest220of100,1,323,5394,21,302,5717
subtest26of10,pubtest220of100,1,323,5394,21,342,5757
subtest22of10,pubtest220of100,1,323,5394,23,380,5797
subtest24of10,pubtest221of100,1,323,5436,7,42,5485
subtest21of10,pubtest221of100,1,323,5436,12,75,5523
subtest28of10,pubtest221of100,1,323,5436,15,113,5564
subtest23of10,pubtest221of100,1,323,5436,15,152,5603
subtest22of10,pubtest221of100,1,323,5436,18,188,5642
subtest25of10,pubtest221of100,1,323,5436,18,228,5682
subtest210of10,pubtest221of100,1,323,5436,22,264,5722
subtest29of10,pubtest221of100,1,323,5436,23,303,5762
subtest27of10,pubtest221of100,1,323,5436,23,343,5802
subtest26of10,pubtest221of100,1,323,5436,25,381,5842
subtest21of10,pubtest222of100,1,323,5383,9,39,5431
subtest29of10,pubtest222of100,1,323,5383,10,77,5470
subtest22of10,pubtest222of100,1,323,5383,9,116,5508
subtest27of10,pubtest222of100,1,323,5383,38,129,5550
subtest23of10,pubtest222of100,1,323,5383,38,169,5590
subtest28of10,pubtest222of100,1,323,5383,41,206,5630
subtest210of10,pubtest222of100,1,323,5383,42,245,5670
subtest25of10,pubtest222of100,1,323,5383,43,284,5710
subtest26of10,pubtest222of100,1,323,5383,45,322,5750
subtest24of10,pubtest222of100,1,323,5383,46,360,5789
subtest21of10,pubtest223of100,1,323,5282,11,38,5331
subtest28of10,pubtest223of100,1,323,5282,11,77,5370
subtest29of10,pubtest223of100,1,323,5282,13,115,5410
subtest23of10,pubtest223of100,1,323,5282,13,154,5449
subtest24of10,pubtest223of100,1,323,5282,14,194,5490
subtest27of10,pubtest223of100,1,323,5282,16,232,5530
subtest210of10,pubtest223of100,1,323,5282,21,265,5568
subtest25of10,pubtest223of100,1,323,5282,24,304,5610
subtest22of10,pubtest223of100,1,323,5282,25,344,5651
subtest26of10,pubtest223of100,1,323,5282,29,379,5690
subtest21of10,pubtest224of100,1,323,5170,10,40,5220
subtest27of10,pubtest224of100,1,323,5170,12,77,5259
subtest28of10,pubtest224of100,1,323,5170,13,116,5299
subtest23of10,pubtest224of100,1,323,5170,14,155,5339
subtest26of10,pubtest224of100,1,323,5170,15,194,5379
subtest29of10,pubtest224of100,1,323,5170,22,225,5417
subtest22of10,pubtest224of100,1,323,5170,24,265,5459
subtest25of10,pubtest224of100,1,323,5170,24,304,5498
subtest24of10,pubtest224of100,1,323,5170,28,341,5539
subtest210of10,pubtest224of100,1,323,5170,29,380,5579
subtest22of10,pubtest225of100,1,323,5304,8,40,5352
subtest26of10,pubtest225of100,1,323,5304,9,79,5392
subtest27of10,pubtest225of100,1,323,5304,10,117,5431
subtest24of10,pubtest225of100,1,323,5304,13,152,5469
subtest21of10,pubtest225of100,1,323,5304,15,192,5511
subtest25of10,pubtest225of100,1,323,5304,25,221,5550
subtest23of10,pubtest225of100,1,323,5304,26,261,5591
subtest28of10,pubtest225of100,1,323,5304,25,300,5629
subtest29of10,pubtest225of100,1,323,5304,27,340,5671
subtest210of10,pubtest225of100,1,323,5304,31,376,5711
subtest25of10,pubtest226of100,1,323,5378,15,40,5433
subtest22of10,pubtest226of100,1,323,5378,16,79,5473
subtest23of10,pubtest226of100,1,323,5378,18,117,5513
subtest210of10,pubtest226of100,1,323,5378,19,155,5552
subtest21of10,pubtest226of100,1,323,5378,21,192,5591
subtest27of10,pubtest226of100,1,323,5378,21,232,5631
subtest28of10,pubtest226of100,1,323,5378,27,266,5671
subtest29of10,pubtest226of100,1,323,5378,27,306,5711
subtest24of10,pubtest226of100,1,323,5378,33,341,5752
subtest26of10,pubtest226of100,1,323,5378,33,382,5793
subtest29of10,pubtest227of100,1,323,6530,9,40,6579
subtest210of10,pubtest227of100,1,323,6530,40,49,6619
subtest24of10,pubtest227of100,1,323,6530,41,87,6658
subtest25of10,pubtest227of100,1,323,6530,40,126,6696
subtest23of10,pubtest227of100,1,323,6530,45,164,6739
subtest26of10,pubtest227of100,1,323,6530,46,202,6778
subtest27of10,pubtest227of100,1,323,6530,47,241,6818
subtest21of10,pubtest227of100,1,323,6530,48,280,6858
subtest22of10,pubtest227of100,1,323,6530,49,318,6897
subtest28of10,pubtest227of100,1,323,6530,51,357,6938
subtest21of10,pubtest228of100,1,323,5365,11,40,5416
subtest26of10,pubtest228of100,1,323,5365,17,73,5455
subtest25of10,pubtest228of100,1,323,5365,17,112,5494
subtest23of10,pubtest228of100,1,323,5365,24,146,5535
subtest27of10,pubtest228of100,1,323,5365,24,186,5575
subtest29of10,pubtest228of100,1,323,5365,26,225,5616
subtest24of10,pubtest228of100,1,323,5365,27,263,5655
subtest210of10,pubtest228of100,1,323,5365,30,300,5695
subtest22of10,pubtest228of100,1,323,5365,31,338,5734
subtest28of10,pubtest228of100,1,323,5365,34,374,5773
subtest27of10,pubtest229of100,1,321,5190,10,42,5242
subtest21of10,pubtest229of100,1,321,5190,9,79,5278
subtest23of10,pubtest229of100,1,321,5190,21,109,5320
subtest25of10,pubtest229of100,1,321,5190,21,149,5360
subtest29of10,pubtest229of100,1,321,5190,23,187,5400
subtest24of10,pubtest229of100,1,321,5190,24,225,5439
subtest22of10,pubtest229of100,1,321,5190,25,265,5480
subtest210of10,pubtest229of100,1,321,5190,28,495,5713
subtest26of10,pubtest229of100,1,321,5190,28,534,5752
subtest28of10,pubtest229of100,1,321,5190,25,573,5788
subtest22of10,pubtest230of100,1,323,5179,8,213,5400
subtest27of10,pubtest230of100,1,323,5179,9,454,5642
subtest21of10,pubtest230of100,1,323,5179,8,491,5678
subtest28of10,pubtest230of100,1,323,5179,11,530,5720
subtest29of10,pubtest230of100,1,323,5179,12,569,5760
subtest25of10,pubtest230of100,1,323,5179,14,605,5798
subtest23of10,pubtest230of100,1,323,5179,16,645,5840
subtest24of10,pubtest230of100,1,323,5179,18,683,5880
subtest210of10,pubtest230of100,1,323,5179,18,723,5920
subtest26of10,pubtest230of100,1,323,5179,22,759,5960
subtest23of10,pubtest231of100,1,323,5233,9,321,5563
subtest25of10,pubtest231of100,1,323,5233,13,354,5600
subtest28of10,pubtest231of100,1,323,5233,15,392,5640
subtest24of10,pubtest231of100,1,323,5233,17,429,5679
subtest29of10,pubtest231of100,1,323,5233,20,467,5720
subtest210of10,pubtest231of100,1,323,5233,21,506,5760
subtest27of10,pubtest231of100,1,323,5233,22,546,5801
subtest26of10,pubtest231of100,1,323,5233,24,583,5840
subtest21of10,pubtest231of100,1,323,5233,26,621,5880
subtest22of10,pubtest231of100,1,323,5233,26,661,5920
subtest21of10,pubtest232of100,1,323,5248,8,43,5299
subtest27of10,pubtest232of100,1,323,5248,14,75,5337
subtest23of10,pubtest232of100,1,323,5248,14,115,5377
subtest22of10,pubtest232of100,1,323,5248,18,151,5417
subtest29of10,pubtest232of100,1,323,5248,20,189,5457
subtest25of10,pubtest232of100,1,323,5248,21,228,5497
subtest28of10,pubtest232of100,1,323,5248,22,268,5538
subtest210of10,pubtest232of100,1,323,5248,25,304,5577
subtest24of10,pubtest232of100,1,323,5248,27,342,5617
subtest26of10,pubtest232of100,1,323,5248,30,379,5657
subtest24of10,pubtest233of100,1,323,5210,6,39,5255
subtest29of10,pubtest233of100,1,323,5210,9,76,5295
subtest210of10,pubtest233of100,1,323,5210,17,107,5334
subtest26of10,pubtest233of100,1,323,5210,21,142,5373
subtest27of10,pubtest233of100,1,323,5210,22,182,5414
subtest23of10,pubtest233of100,1,323,5210,24,220,5454
subtest22of10,pubtest233of100,1,323,5210,24,259,5493
subtest28of10,pubtest233of100,1,323,5210,25,299,5534
subtest21of10,pubtest233of100,1,323,5210,26,338,5574
subtest25of10,pubtest233of100,1,323,5210,21,378,5609
subtest26of10,pubtest234of100,1,323,5271,8,39,5318
subtest27of10,pubtest234of100,1,323,5271,10,76,5357
subtest25of10,pubtest234of100,1,323,5271,9,115,5395
subtest21of10,pubtest234of100,1,323,5271,13,153,5437
subtest22of10,pubtest234of100,1,323,5271,14,192,5477
subtest29of10,pubtest234of100,1,323,5271,18,229,5518
subtest23of10,pubtest234of100,1,323,5271,41,245,5557
subtest210of10,pubtest234of100,1,323,5271,42,282,5595
subtest24of10,pubtest234of100,1,323,5271,45,321,5637
subtest28of10,pubtest234of100,1,323,5271,46,360,5677
subtest21of10,pubtest235of100,1,321,5344,9,39,5392
subtest23of10,pubtest235of100,1,321,5344,15,72,5431
subtest210of10,pubtest235of100,1,321,5344,17,111,5472
subtest22of10,pubtest235of100,1,321,5344,17,150,5511
subtest27of10,pubtest235of100,1,321,5344,23,184,5551
subtest25of10,pubtest235of100,1,321,5344,25,222,5591
subtest26of10,pubtest235of100,1,321,5344,26,261,5631
subtest29of10,pubtest235of100,1,321,5344,26,302,5672
subtest24of10,pubtest235of100,1,321,5344,22,340,5706
subtest28of10,pubtest235of100,1,321,5344,28,379,5751
subtest210of10,pubtest236of100,1,323,5255,11,41,5307
subtest23of10,pubtest236of100,1,323,5255,12,79,5346
subtest27of10,pubtest236of100,1,323,5255,14,117,5386
subtest28of10,pubtest236of100,1,323,5255,46,126,5427
subtest25of10,pubtest236of100,1,323,5255,48,164,5467
subtest21of10,pubtest236of100,1,323,5255,47,203,5505
subtest29of10,pubtest236of100,1,323,5255,49,242,5546
subtest24of10,pubtest236of100,1,323,5255,49,282,5586
subtest26of10,pubtest236of100,1,323,5255,53,318,5626
subtest22of10,pubtest236of100,1,323,5255,55,357,5667
subtest24of10,pubtest237of100,1,323,5202,8,41,5251
subtest23of10,pubtest237of100,1,323,5202,14,74,5290
subtest28of10,pubtest237of100,1,323,5202,14,115,5331
subtest27of10,pubtest237of100,1,323,5202,16,153,5371
subtest26of10,pubtest237of100,1,323,5202,16,191,5409
subtest25of10,pubtest237of100,1,323,5202,16,231,5449
subtest22of10,pubtest237of100,1,323,5202,16,270,5488
subtest21of10,pubtest237of100,1,323,5202,22,306,5530
subtest210of10,pubtest237of100,1,323,5202,23,345,5570
subtest29of10,pubtest237of100,1,323,5202,24,384,5610
subtest29of10,pubtest238of100,1,323,5393,9,39,5441
subtest22of10,pubtest238of100,1,323,5393,9,78,5480
subtest27of10,pubtest238of100,1,323,5393,10,117,5520
subtest21of10,pubtest238of100,1,323,5393,17,150,5560
subtest25of10,pubtest238of100,1,323,5393,17,190,5600
subtest28of10,pubtest238of100,1,323,5393,17,229,5639
subtest26of10,pubtest238of100,1,323,5393,19,268,5680
subtest23of10,pubtest238of100,1,323,5393,20,307,5720
subtest210of10,pubtest238of100,1,323,5393,21,346,5760
subtest24of10,pubtest238of100,1,323,5393,24,383,5800
subtest21of10,pubtest239of100,1,323,5231,8,43,5282
subtest28of10,pubtest239of100,1,323,5231,9,83,5323
subtest26of10,pubtest239of100,1,323,5231,13,119,5363
subtest27of10,pubtest239of100,1,323,5231,14,159,5404
subtest25of10,pubtest239of100,1,323,5231,20,192,5443
subtest24of10,pubtest239of100,1,323,5231,24,227,5482
subtest29of10,pubtest239of100,1,323,5231,24,266,5521
subtest22of10,pubtest239of100,1,323,5231,27,305,5563
subtest23of10,pubtest239of100,1,323,5231,57,314,5602
subtest210of10,pubtest239of100,1,323,5231,58,354,5643
subtest25of10,pubtest240of100,1,323,5243,8,38,5289
subtest210of10,pubtest240of100,1,323,5243,12,73,5328
subtest21of10,pubtest240of100,1,323,5243,12,113,5368
subtest27of10,pubtest240of100,1,323,5243,20,145,5408
subtest23of10,pubtest240of100,1,323,5243,21,184,5448
subtest24of10,pubtest240of100,1,323,5243,21,224,5488
subtest28of10,pubtest240of100,1,323,5243,22,263,5528
subtest22of10,pubtest240of100,1,323,5243,23,302,5568
subtest29of10,pubtest240of100,1,323,5243,18,342,5603
subtest26of10,pubtest240of100,1,323,5243,24,381,5648
subtest23of10,pubtest241of100,1,323,5190,9,42,5241
subtest27of10,pubtest241of100,1,323,5190,9,81,5280
subtest24of10,pubtest241of100,1,323,5190,12,118,5320
subtest21of10,pubtest241of100,1,323,5190,33,137,5360
subtest210of10,pubtest241of100,1,323,5190,34,176,5400
subtest29of10,pubtest241of100,1,323,5190,35,215,5440
subtest28of10,pubtest241of100,1,323,5190,39,251,5480
subtest25of10,pubtest241of100,1,323,5190,39,290,5519
subtest22of10,pubtest241of100,1,323,5190,40,330,5560
subtest26of10,pubtest241of100,1,323,5190,40,369,5599
subtest27of10,pubtest242of100,1,323,5309,10,39,5358
subtest23of10,pubtest242of100,1,323,5309,20,68,5397
subtest26of10,pubtest242of100,1,323,5309,20,106,5435
subtest29of10,pubtest242of100,1,323,5309,21,145,5475
subtest25of10,pubtest242of100,1,323,5309,21,184,5514
subtest21of10,pubtest242of100,1,323,5309,24,223,5556
subtest210of10,pubtest242of100,1,323,5309,24,263,5596
subtest22of10,pubtest242of100,1,323,5309,26,301,5636
subtest24of10,pubtest242of100,1,323,5309,27,341,5677
subtest28of10,pubtest242of100,1,323,5309,28,379,5716
subtest29of10,pubtest243of100,1,323,5164,11,40,5215
subtest28of10,pubtest243of100,1,323,5164,11,79,5254
subtest23of10,pubtest243of100,1,323,5164,15,115,5294
subtest22of10,pubtest243of100,1,323,5164,15,155,5334
subtest26of10,pubtest243of100,1,323,5164,18,192,5374
subtest25of10,pubtest243of100,1,323,5164,22,228,5414
subtest24of10,pubtest243of100,1,323,5164,26,263,5453
subtest27of10,pubtest243of100,1,323,5164,26,303,5493
subtest210of10,pubtest243of100,1,323,5164,30,340,5534
subtest21of10,pubtest243of100,1,323,5164,30,380,5574
subtest27of10,pubtest244of100,1,323,5373,28,46,5447
subtest26of10,pubtest244of100,1,323,5373,29,85,5487
subtest29of10,pubtest244of100,1,323,5373,32,120,5525
subtest28of10,pubtest244of100,1,323,5373,32,159,5564
subtest21of10,pubtest244of100,1,323,5373,33,196,5602
subtest210of10,pubtest244of100,1,323,5373,35,236,5644
subtest23of10,pubtest244of100,1,323,5373,39,274,5686
subtest24of10,pubtest244of100,1,323,5373,39,314,5726
subtest22of10,pubtest244of100,1,323,5373,40,352,5765
subtest25of10,pubtest244of100,1,323,5373,31,392,5796
subtest29of10,pubtest245of100,1,322,5332,9,42,5383
subtest23of10,pubtest245of100,1,322,5332,10,79,5421
subtest22of10,pubtest245of100,1,322,5332,12,115,5459
subtest26of10,pubtest245of100,1,322,5332,12,155,5499
subtest21of10,pubtest245of100,1,322,5332,14,194,5540
subtest25of10,pubtest245of100,1,322,5332,15,234,5581
subtest24of10,pubtest245of100,1,322,5332,14,273,5619
subtest28of10,pubtest245of100,1,322,5332,43,287,5662
subtest27of10,pubtest245of100,1,322,5332,43,327,5702
subtest210of10,pubtest245of100,1,322,5332,45,365,5742
subtest26of10,pubtest246of100,1,323,5380,8,42,5430
subtest27of10,pubtest246of100,1,323,5380,9,79,5468
subtest29of10,pubtest246of100,1,323,5380,11,117,5508
subtest21of10,pubtest246of100,1,323,5380,10,156,5546
subtest28of10,pubtest246of100,1,323,5380,24,184,5588
subtest25of10,pubtest246of100,1,323,5380,24,224,5628
subtest23of10,pubtest246of100,1,323,5380,23,265,5668
subtest24of10,pubtest246of100,1,323,5380,29,300,5709
subtest210of10,pubtest246of100,1,323,5380,29,339,5748
subtest22of10,pubtest246of100,1,323,5380,30,378,5788
subtest23of10,pubtest247of100,1,323,5267,7,39,5313
subtest27of10,pubtest247of100,1,323,5267,7,78,5352
subtest26of10,pubtest247of100,1,323,5267,9,116,5392
subtest22of10,pubtest247of100,1,323,5267,12,152,5431
subtest21of10,pubtest247of100,1,323,5267,12,192,5471
subtest25of10,pubtest247of100,1,323,5267,19,226,5512
subtest28of10,pubtest247of100,1,323,5267,18,267,5552
subtest29of10,pubtest247of100,1,323,5267,18,305,5590
subtest210of10,pubtest247of100,1,323,5267,23,342,5632
subtest24of10,pubtest247of100,1,323,5267,32,373,5672
subtest29of10,pubtest248of100,1,323,5543,8,40,5591
subtest25of10,pubtest248of100,1,323,5543,10,77,5630
subtest26of10,pubtest248of100,1,323,5543,15,111,5669
subtest23of10,pubtest248of100,1,323,5543,21,146,5710
subtest21of10,pubtest248of100,1,323,5543,64,141,5748
subtest27of10,pubtest248of100,1,323,5543,64,181,5788
subtest24of10,pubtest248of100,1,323,5543,70,216,5829
subtest28of10,pubtest248of100,1,323,5543,70,255,5868
subtest210of10,pubtest248of100,1,323,5543,76,290,5909
subtest22of10,pubtest248of100,1,323,5543,76,330,5949
subtest27of10,pubtest249of100,1,323,5235,8,46,5289
subtest28of10,pubtest249of100,1,323,5235,8,85,5328
subtest24of10,pubtest249of100,1,323,5235,17,116,5368
subtest25of10,pubtest249of100,1,323,5235,18,154,5407
subtest26of10,pubtest249of100,1,323,5235,20,193,5448
subtest21of10,pubtest249of100,1,323,5235,21,231,5487
subtest29of10,pubtest249of100,1,323,5235,23,270,5528
subtest23of10,pubtest249of100,1,323,5235,24,309,5568
subtest210of10,pubtest249of100,1,323,5235,25,348,5608
subtest22of10,pubtest249of100,1,323,5235,26,387,5648
subtest27of10,pubtest250of100,1,323,5293,8,41,5342
subtest29of10,pubtest250of100,1,323,5293,11,76,5380
subtest21of10,pubtest250of100,1,323,5293,11,116,5420
subtest23of10,pubtest250of100,1,323,5293,9,156,5458
subtest28of10,pubtest250of100,1,323,5293,16,192,5501
subtest25of10,pubtest250of100,1,323,5293,18,230,5541
subtest24of10,pubtest250of100,1,323,5293,18,271,5582
subtest210of10,pubtest250of100,1,323,5293,22,306,5621
subtest26of10,pubtest250of100,1,323,5293,24,344,5661
subtest22of10,pubtest250of100,1,323,5293,24,384,5701
subtest23of10,pubtest251of100,1,323,5230,10,41,5281
subtest27of10,pubtest251of100,1,323,5230,11,79,5320
subtest21of10,pubtest251of100,1,323,5230,12,119,5361
subtest25of10,pubtest251of100,1,323,5230,12,156,5398
subtest29of10,pubtest251of100,1,323,5230,14,196,5440
subtest22of10,pubtest251of100,1,323,5230,15,235,5480
subtest24of10,pubtest251of100,1,323,5230,16,274,5520
subtest28of10,pubtest251of100,1,323,5230,18,312,5560
subtest210of10,pubtest251of100,1,323,5230,20,350,5600
subtest26of10,pubtest251of100,1,323,5230,21,389,5640
subtest29of10,pubtest252of100,1,323,5262,8,48,5318
subtest28of10,pubtest252of100,1,323,5262,9,86,5357
subtest21of10,pubtest252of100,1,323,5262,10,125,5397
subtest26of10,pubtest252of100,1,323,5262,12,163,5437
subtest27of10,pubtest252of100,1,323,5262,13,202,5477
subtest22of10,pubtest252of100,1,323,5262,13,242,5517
subtest25of10,pubtest252of100,1,323,5262,19,276,5557
subtest23of10,pubtest252of100,1,323,5262,20,313,5595
subtest24of10,pubtest252of100,1,323,5262,22,353,5637
subtest210of10,pubtest252of100,1,323,5262,23,392,5677
subtest28of10,pubtest253of100,1,322,5291,11,42,5344
subtest23of10,pubtest253of100,1,322,5291,12,80,5383
subtest24of10,pubtest253of100,1,322,5291,13,119,5423
subtest22of10,pubtest253of100,1,322,5291,15,157,5463
subtest25of10,pubtest253of100,1,322,5291,17,195,5503
subtest210of10,pubtest253of100,1,322,5291,23,229,5543
subtest27of10,pubtest253of100,1,322,5291,29,263,5583
subtest29of10,pubtest253of100,1,322,5291,29,303,5623
subtest26of10,pubtest253of100,1,322,5291,31,341,5663
subtest21of10,pubtest253of100,1,322,5291,31,381,5703
subtest27of10,pubtest254of100,1,323,5249,9,39,5297
subtest21of10,pubtest254of100,1,323,5249,12,73,5334
subtest210of10,pubtest254of100,1,323,5249,14,113,5376
subtest25of10,pubtest254of100,1,323,5249,18,148,5415
subtest23of10,pubtest254of100,1,323,5249,21,185,5455
subtest29of10,pubtest254of100,1,323,5249,22,224,5495
subtest28of10,pubtest254of100,1,323,5249,23,263,5535
subtest24of10,pubtest254of100,1,323,5249,24,302,5575
subtest22of10,pubtest254of100,1,323,5249,29,337,5615
subtest26of10,pubtest254of100,1,323,5249,29,377,5655
subtest22of10,pubtest255of100,1,322,5217,13,50,5280
subtest23of10,pubtest255of100,1,322,5217,12,89,5318
subtest27of10,pubtest255of100,1,322,5217,14,128,5359
subtest28of10,pubtest255of100,1,322,5217,16,166,5399
subtest24of10,pubtest255of100,1,322,5217,18,204,5439
subtest25of10,pubtest255of100,1,322,5217,18,241,5476
subtest21of10,pubtest255of100,1,322,5217,19,281,5517
subtest26of10,pubtest255of100,1,322,5217,20,320,5557
subtest210of10,pubtest255of100,1,322,5217,19,360,5596
subtest29of10,pubtest255of100,1,322,5217,19,397,5633
subtest29of10,pubtest256of100,1,323,5186,10,41,5237
subtest21of10,pubtest256of100,1,323,5186,17,73,5276
subtest26of10,pubtest256of100,1,323,5186,25,105,5316
subtest23of10,pubtest256of100,1,323,5186,25,145,5356
subtest25of10,pubtest256of100,1,323,5186,28,182,5396
subtest27of10,pubtest256of100,1,323,5186,31,219,5436
subtest210of10,pubtest256of100,1,323,5186,33,255,5474
subtest28of10,pubtest256of100,1,323,5186,36,294,5516
subtest24of10,pubtest256of100,1,323,5186,37,333,5556
subtest22of10,pubtest256of100,1,323,5186,37,373,5596
subtest24of10,pubtest257of100,1,323,5210,13,41,5264
subtest21of10,pubtest257of100,1,323,5210,21,72,5303
subtest27of10,pubtest257of100,1,323,5210,26,107,5343
subtest23of10,pubtest257of100,1,323,5210,27,144,5381
subtest28of10,pubtest257of100,1,323,5210,30,183,5423
subtest29of10,pubtest257of100,1,323,5210,31,222,5463
subtest25of10,pubtest257of100,1,323,5210,32,261,5503
subtest210of10,pubtest257of100,1,323,5210,33,300,5543
subtest22of10,pubtest257of100,1,323,5210,33,341,5584
subtest26of10,pubtest257of100,1,323,5210,35,378,5623
subtest28of10,pubtest258of100,1,323,5157,26,45,5228
subtest23of10,pubtest258of100,1,323,5157,31,80,5268
subtest25of10,pubtest258of100,1,323,5157,33,118,5308
subtest21of10,pubtest258of100,1,323,5157,33,158,5348
subtest26of10,pubtest258of100,1,323,5157,36,195,5388
subtest29of10,pubtest258of100,1,323,5157,35,237,5429
subtest27of10,pubtest258of100,1,323,5157,37,275,5469
subtest210of10,pubtest258of100,1,323,5157,37,313,5507
subtest22of10,pubtest258of100,1,323,5157,38,353,5548
subtest24of10,pubtest258of100,1,323,5157,38,392,5587
subtest21of10,pubtest259of100,1,323,5251,7,39,5297
subtest28of10,pubtest259of100,1,323,5251,12,74,5337
subtest25of10,pubtest259of100,1,323,5251,15,110,5376
subtest24of10,pubtest259of100,1,323,5251,15,150,5416
subtest27of10,pubtest259of100,1,323,5251,15,188,5454
subtest26of10,pubtest259of100,1,323,5251,16,228,5495
subtest23of10,pubtest259of100,1,323,5251,16,267,5534
subtest22of10,pubtest259of100,1,323,5251,18,307,5576
subtest29of10,pubtest259of100,1,323,5251,39,326,5616
subtest210of10,pubtest259of100,1,323,5251,43,363,5657
subtest210of10,pubtest260of100,1,323,5172,10,47,5229
subtest23of10,pubtest260of100,1,323,5172,11,83,5266
subtest26of10,pubtest260of100,1,323,5172,12,121,5305
subtest21of10,pubtest260of100,1,323,5172,14,160,5346
subtest29of10,pubtest260of100,1,323,5172,14,199,5385
subtest27of10,pubtest260of100,1,323,5172,15,239,5426
subtest25of10,pubtest260of100,1,323,5172,16,276,5464
subtest22of10,pubtest260of100,1,323,5172,18,315,5505
subtest28of10,pubtest260of100,1,323,5172,20,354,5546
subtest24of10,pubtest260of100,1,323,5172,25,389,5586
subtest25of10,pubtest261of100,1,323,5278,15,40,5333
subtest28of10,pubtest261of100,1,323,5278,16,77,5371
subtest29of10,pubtest261of100,1,323,5278,18,114,5410
subtest210of10,pubtest261of100,1,323,5278,20,153,5451
subtest23of10,pubtest261of100,1,323,5278,27,186,5491
subtest27of10,pubtest261of100,1,323,5278,29,224,5531
subtest22of10,pubtest261of100,1,323,5278,28,263,5569
subtest21of10,pubtest261of100,1,323,5278,31,302,5611
subtest24of10,pubtest261of100,1,323,5278,35,339,5652
subtest26of10,pubtest261of100,1,323,5278,54,359,5691
subtest22of10,pubtest262of100,1,323,5178,8,44,5230
subtest21of10,pubtest262of100,1,323,5178,8,84,5270
subtest23of10,pubtest262of100,1,323,5178,9,123,5310
subtest27of10,pubtest262of100,1,323,5178,13,159,5350
subtest26of10,pubtest262of100,1,323,5178,16,196,5390
subtest25of10,pubtest262of100,1,323,5178,16,236,5430
subtest29of10,pubtest262of100,1,323,5178,18,274,5470
subtest210of10,pubtest262of100,1,323,5178,22,310,5510
subtest24of10,pubtest262of100,1,323,5178,25,347,5550
subtest28of10,pubtest262of100,1,323,5178,25,387,5590
subtest22of10,pubtest263of100,1,322,5194,10,41,5245
subtest29of10,pubtest263of100,1,322,5194,10,80,5284
subtest24of10,pubtest263of100,1,322,5194,12,118,5324
subtest23of10,pubtest263of100,1,322,5194,18,152,5364
subtest26of10,pubtest263of100,1,322,5194,19,191,5404
subtest25of10,pubtest263of100,1,322,5194,22,228,5444
subtest210of10,pubtest263of100,1,322,5194,23,267,5484
subtest28of10,pubtest263of100,1,322,5194,26,304,5524
subtest27of10,pubtest263of100,1,322,5194,26,344,5564
subtest21of10,pubtest263of100,1,322,5194,27,383,5604
subtest22of10,pubtest264of100,1,322,5180,10,40,5230
subtest29of10,pubtest264of100,1,322,5180,14,76,5270
subtest23of10,pubtest264of100,1,322,5180,14,116,5310
subtest27of10,pubtest264of100,1,322,5180,18,152,5350
subtest28of10,pubtest264of100,1,322,5180,18,192,5390
subtest24of10,pubtest264of100,1,322,5180,16,232,5428
subtest21of10,pubtest264of100,1,322,5180,22,268,5470
subtest25of10,pubtest264of100,1,322,5180,23,308,5511
subtest26of10,pubtest264of100,1,322,5180,26,344,5550
subtest210of10,pubtest264of100,1,322,5180,31,379,5590
subtest26of10,pubtest265of100,1,323,5184,8,43,5235
subtest27of10,pubtest265of100,1,323,5184,12,77,5273
subtest210of10,pubtest265of100,1,323,5184,13,115,5312
subtest22of10,pubtest265of100,1,323,5184,14,155,5353
subtest21of10,pubtest265of100,1,323,5184,15,194,5393
subtest28of10,pubtest265of100,1,323,5184,15,234,5433
subtest29of10,pubtest265of100,1,323,5184,22,268,5474
subtest25of10,pubtest265of100,1,323,5184,23,306,5513
subtest24of10,pubtest265of100,1,323,5184,27,343,5554
subtest23of10,pubtest265of100,1,323,5184,44,367,5595
subtest29of10,pubtest266of100,1,321,5209,9,40,5258
subtest210of10,pubtest266of100,1,321,5209,9,80,5298
subtest25of10,pubtest266of100,1,321,5209,12,116,5337
subtest27of10,pubtest266of100,1,321,5209,12,156,5377
subtest26of10,pubtest266of100,1,321,5209,17,191,5417
subtest23of10,pubtest266of100,1,321,5209,18,230,5457
subtest21of10,pubtest266of100,1,321,5209,22,266,5497
subtest28of10,pubtest266of100,1,321,5209,24,304,5537
subtest24of10,pubtest266of100,1,321,5209,33,334,5576
subtest22of10,pubtest266of100,1,321,5209,33,374,5616
subtest23of10,pubtest267of100,1,323,5209,9,41,5259
subtest26of10,pubtest267of100,1,323,5209,9,80,5298
subtest27of10,pubtest267of100,1,323,5209,11,119,5339
subtest25of10,pubtest267of100,1,323,5209,11,156,5376
subtest28of10,pubtest267of100,1,323,5209,11,196,5416
subtest29of10,pubtest267of100,1,323,5209,17,233,5459
subtest21of10,pubtest267of100,1,323,5209,18,271,5498
subtest24of10,pubtest267of100,1,323,5209,20,310,5539
subtest22of10,pubtest267of100,1,323,5209,21,349,5579
subtest210of10,pubtest267of100,1,323,5209,27,382,5618
subtest23of10,pubtest268of100,1,323,5242,7,42,5291
subtest25of10,pubtest268of100,1,323,5242,48,40,5330
subtest24of10,pubtest268of100,1,323,5242,50,77,5369
subtest29of10,pubtest268of100,1,323,5242,51,117,5410
subtest28of10,pubtest268of100,1,323,5242,54,154,5450
subtest27of10,pubtest268of100,1,323,5242,54,194,5490
subtest21of10,pubtest268of100,1,323,5242,55,234,5531
subtest22of10,pubtest268of100,1,323,5242,57,271,5570
subtest210of10,pubtest268of100,1,323,5242,58,310,5610
subtest26of10,pubtest268of100,1,323,5242,59,351,5652
subtest24of10,pubtest269of100,1,323,5225,9,41,5275
subtest27of10,pubtest269of100,1,323,5225,11,78,5314
subtest25of10,pubtest269of100,1,323,5225,12,117,5354
subtest210of10,pubtest269of100,1,323,5225,13,157,5395
subtest26of10,pubtest269of100,1,323,5225,17,192,5434
subtest21of10,pubtest269of100,1,323,5225,21,229,5475
subtest29of10,pubtest269of100,1,323,5225,21,268,5514
subtest28of10,pubtest269of100,1,323,5225,25,304,5554
subtest22of10,pubtest269of100,1,323,5225,23,344,5592
subtest23of10,pubtest269of100,1,323,5225,23,383,5631
subtest23of10,pubtest270of100,1,323,5242,18,40,5300
subtest210of10,pubtest270of100,1,323,5242,38,59,5339
subtest26of10,pubtest270of100,1,323,5242,38,99,5379
subtest27of10,pubtest270of100,1,323,5242,40,137,5419
subtest28of10,pubtest270of100,1,323,5242,42,174,5458
subtest25of10,pubtest270of100,1,323,5242,45,212,5499
subtest21of10,pubtest270of100,1,323,5242,46,252,5540
subtest24of10,pubtest270of100,1,323,5242,43,291,5576
subtest29of10,pubtest270of100,1,323,5242,42,330,5614
subtest22of10,pubtest270of100,1,323,5242,48,369,5659
subtest24of10,pubtest271of100,1,323,5333,8,38,5379
subtest25of10,pubtest271of100,1,323,5333,16,69,5418
subtest22of10,pubtest271of100,1,323,5333,16,109,5458
subtest27of10,pubtest271of100,1,323,5333,18,146,5497
subtest26of10,pubtest271of100,1,323,5333,19,186,5538
subtest23of10,pubtest271of100,1,323,5333,20,225,5578
subtest29of10,pubtest271of100,1,323,5333,21,265,5619
subtest28of10,pubtest271of100,1,323,5333,21,306,5660
subtest21of10,pubtest271of100,1,323,5333,23,342,5698
subtest210of10,pubtest271of100,1,323,5333,22,382,5737
subtest25of10,pubtest272of100,1,323,5155,7,40,5202
subtest26of10,pubtest272of100,1,323,5155,14,72,5241
subtest21of10,pubtest272of100,1,323,5155,15,111,5281
subtest29of10,pubtest272of100,1,323,5155,20,146,5321
subtest23of10,pubtest272of100,1,323,5155,20,186,5361
subtest27of10,pubtest272of100,1,323,5155,22,224,5401
subtest210of10,pubtest272of100,1,323,5155,22,264,5441
subtest24of10,pubtest272of100,1,323,5155,22,303,5480
subtest22of10,pubtest272of100,1,323,5155,24,343,5522
subtest28of10,pubtest272of100,1,323,5155,25,379,5559
subtest22of10,pubtest273of100,1,321,5274,8,39,5321
subtest29of10,pubtest273of100,1,321,5274,19,66,5359
subtest26of10,pubtest273of100,1,321,5274,19,106,5399
subtest28of10,pubtest273of100,1,321,5274,20,145,5439
subtest210of10,pubtest273of100,1,321,5274,21,184,5479
subtest23of10,pubtest273of100,1,321,5274,22,223,5519
subtest21of10,pubtest273of100,1,321,5274,23,260,5557
subtest27of10,pubtest273of100,1,321,5274,23,299,5596
subtest24of10,pubtest273of100,1,321,5274,26,339,5639
subtest25of10,pubtest273of100,1,321,5274,27,378,5679
subtest21of10,pubtest274of100,1,323,5428,14,40,5482
subtest26of10,pubtest274of100,1,323,5428,15,78,5521
subtest22of10,pubtest274of100,1,323,5428,17,115,5560
subtest24of10,pubtest274of100,1,323,5428,20,153,5601
subtest23of10,pubtest274of100,1,323,5428,17,196,5641
subtest27of10,pubtest274of100,1,323,5428,21,233,5682
subtest29of10,pubtest274of100,1,323,5428,22,271,5721
subtest25of10,pubtest274of100,1,323,5428,22,311,5761
subtest28of10,pubtest274of100,1,323,5428,23,350,5801
subtest210of10,pubtest274of100,1,323,5428,29,384,5841
subtest25of10,pubtest275of100,1,323,5307,22,45,5374
subtest29of10,pubtest275of100,1,323,5307,22,86,5415
subtest24of10,pubtest275of100,1,323,5307,24,123,5454
subtest21of10,pubtest275of100,1,323,5307,25,161,5493
subtest27of10,pubtest275of100,1,323,5307,22,199,5528
subtest23of10,pubtest275of100,1,323,5307,45,221,5573
subtest210of10,pubtest275of100,1,323,5307,46,260,5613
subtest22of10,pubtest275of100,1,323,5307,45,300,5652
subtest28of10,pubtest275of100,1,323,5307,50,335,5692
subtest26of10,pubtest275of100,1,323,5307,50,375,5732
subtest28of10,pubtest276of100,1,323,5269,7,42,5318
subtest21of10,pubtest276of100,1,323,5269,9,79,5357
subtest25of10,pubtest276of100,1,323,5269,10,118,5397
subtest24of10,pubtest276of100,1,323,5269,16,152,5437
subtest27of10,pubtest276of100,1,323,5269,16,192,5477
subtest29of10,pubtest276of100,1,323,5269,18,230,5517
subtest26of10,pubtest276of100,1,323,5269,18,270,5557
subtest23of10,pubtest276of100,1,323,5269,21,307,5597
subtest210of10,pubtest276of100,1,323,5269,23,345,5637
subtest22of10,pubtest276of100,1,323,5269,23,385,5677
subtest22of10,pubtest277of100,1,323,5179,8,39,5226
subtest29of10,pubtest277of100,1,323,5179,10,76,5265
subtest21of10,pubtest277of100,1,323,5179,11,116,5306
subtest24of10,pubtest277of100,1,323,5179,12,152,5343
subtest28of10,pubtest277of100,1,323,5179,12,191,5382
subtest27of10,pubtest277of100,1,323,5179,15,232,5426
subtest26of10,pubtest277of100,1,323,5179,17,269,5465
subtest25of10,pubtest277of100,1,323,5179,17,309,5505
subtest23of10,pubtest277of100,1,323,5179,18,348,5545
subtest210of10,pubtest277of100,1,323,5179,18,388,5585
subtest29of10,pubtest278of100,1,323,5221,8,38,5267
subtest22of10,pubtest278of100,1,323,5221,13,72,5306
subtest23of10,pubtest278of100,1,323,5221,13,112,5346
subtest27of10,pubtest278of100,1,323,5221,15,150,5386
subtest21of10,pubtest278of100,1,323,5221,15,190,5426
subtest28of10,pubtest278of100,1,323,5221,19,228,5468
subtest24of10,pubtest278of100,1,323,5221,21,265,5507
subtest26of10,pubtest278of100,1,323,5221,20,304,5545
subtest25of10,pubtest278of100,1,323,5221,20,343,5584
subtest210of10,pubtest278of100,1,323,5221,22,383,5626
subtest28of10,pubtest279of100,1,323,5202,9,40,5251
subtest25of10,pubtest279of100,1,323,5202,12,75,5289
subtest21of10,pubtest279of100,1,323,5202,13,114,5329
subtest24of10,pubtest279of100,1,323,5202,14,153,5369
subtest29of10,pubtest279of100,1,323,5202,15,192,5409
subtest27of10,pubtest279of100,1,323,5202,18,229,5449
subtest26of10,pubtest279of100,1,323,5202,18,270,5490
subtest23of10,pubtest279of100,1,323,5202,19,308,5529
subtest22of10,pubtest279of100,1,323,5202,22,345,5569
subtest210of10,pubtest279of100,1,323,5202,28,379,5609
subtest27of10,pubtest280of100,1,323,5194,7,39,5240
subtest29of10,pubtest280of100,1,323,5194,11,74,5279
subtest21of10,pubtest280of100,1,323,5194,12,113,5319
subtest24of10,pubtest280of100,1,323,5194,13,152,5359
subtest23of10,pubtest280of100,1,323,5194,16,190,5400
subtest210of10,pubtest280of100,1,323,5194,19,227,5440
subtest25of10,pubtest280of100,1,323,5194,21,264,5479
subtest22of10,pubtest280of100,1,323,5194,21,305,5520
subtest26of10,pubtest280of100,1,323,5194,19,346,5559
subtest28of10,pubtest280of100,1,323,5194,22,383,5599
subtest24of10,pubtest281of100,1,323,5208,8,39,5255
subtest23of10,pubtest281of100,1,323,5208,9,79,5296
subtest27of10,pubtest281of100,1,323,5208,12,116,5336
subtest28of10,pubtest281of100,1,323,5208,13,155,5376
subtest22of10,pubtest281of100,1,323,5208,14,194,5416
subtest25of10,pubtest281of100,1,323,5208,17,231,5456
subtest210of10,pubtest281of100,1,323,5208,28,260,5496
subtest21of10,pubtest281of100,1,323,5208,28,300,5536
subtest26of10,pubtest281of100,1,323,5208,36,332,5576
subtest29of10,pubtest281of100,1,323,5208,36,374,5618
subtest23of10,pubtest282of100,1,323,5466,8,44,5518
subtest21of10,pubtest282of100,1,323,5466,32,58,5556
subtest24of10,pubtest282of100,1,323,5466,33,96,5595
subtest25of10,pubtest282of100,1,323,5466,36,133,5635
subtest29of10,pubtest282of100,1,323,5466,37,172,5675
subtest27of10,pubtest282of100,1,323,5466,43,206,5715
subtest22of10,pubtest282of100,1,323,5466,43,246,5755
subtest26of10,pubtest282of100,1,323,5466,45,285,5796
subtest28of10,pubtest282of100,1,323,5466,49,318,5833
subtest210of10,pubtest282of100,1,323,5466,49,356,5871
subtest24of10,pubtest283of100,1,323,5225,10,43,5278
subtest27of10,pubtest283of100,1,323,5225,11,80,5316
subtest28of10,pubtest283of100,1,323,5225,13,119,5357
subtest22of10,pubtest283of100,1,323,5225,13,158,5396
subtest23of10,pubtest283of100,1,323,5225,20,190,5435
subtest210of10,pubtest283of100,1,323,5225,22,229,5476
subtest25of10,pubtest283of100,1,323,5225,22,269,5516
subtest26of10,pubtest283of100,1,323,5225,24,307,5556
subtest21of10,pubtest283of100,1,323,5225,24,348,5597
subtest29of10,pubtest283of100,1,323,5225,27,384,5636
subtest22of10,pubtest284of100,1,323,5517,10,40,5567
subtest25of10,pubtest284of100,1,323,5517,11,79,5607
subtest210of10,pubtest284of100,1,323,5517,17,113,5647
subtest29of10,pubtest284of100,1,323,5517,18,153,5688
subtest23of10,pubtest284of100,1,323,5517,19,191,5727
subtest27of10,pubtest284of100,1,323,5517,19,231,5767
subtest21of10,pubtest284of100,1,323,5517,23,268,5808
subtest24of10,pubtest284of100,1,323,5517,24,306,5847
subtest26of10,pubtest284of100,1,323,5517,24,346,5887
subtest28of10,pubtest284of100,1,323,5517,24,384,5925
subtest23of10,pubtest285of100,1,323,5319,9,40,5368
subtest25of10,pubtest285of100,1,323,5319,10,79,5408
subtest22of10,pubtest285of100,1,323,5319,12,117,5448
subtest24of10,pubtest285of100,1,323,5319,12,158,5489
subtest27of10,pubtest285of100,1,323,5319,14,195,5528
subtest28of10,pubtest285of100,1,323,5319,16,233,5568
subtest21of10,pubtest285of100,1,323,5319,19,268,5606
subtest26of10,pubtest285of100,1,323,5319,21,307,5647
subtest29of10,pubtest285of100,1,323,5319,21,347,5687
subtest210of10,pubtest285of100,1,323,5319,21,386,5726
subtest23of10,pubtest286of100,1,323,5268,7,330,5605
subtest25of10,pubtest286of100,1,323,5268,19,320,5607
subtest210of10,pubtest286of100,1,323,5268,19,357,5644
subtest29of10,pubtest286of100,1,323,5268,23,393,5684
subtest24of10,pubtest286of100,1,323,5268,28,428,5724
subtest21of10,pubtest286of100,1,323,5268,31,465,5764
subtest27of10,pubtest286of100,1,323,5268,35,500,5803
subtest26of10,pubtest286of100,1,323,5268,36,540,5844
subtest28of10,pubtest286of100,1,323,5268,37,579,5884
subtest22of10,pubtest286of100,1,323,5268,36,618,5922
subtest26of10,pubtest287of100,1,323,5204,11,46,5261
subtest29of10,pubtest287of100,1,323,5204,12,84,5300
subtest28of10,pubtest287of100,1,323,5204,14,122,5340
subtest27of10,pubtest287of100,1,323,5204,15,161,5380
subtest210of10,pubtest287of100,1,323,5204,18,198,5420
subtest21of10,pubtest287of100,1,323,5204,20,236,5460
subtest25of10,pubtest287of100,1,323,5204,19,276,5499
subtest24of10,pubtest287of100,1,323,5204,25,311,5540
subtest22of10,pubtest287of100,1,323,5204,25,351,5580
subtest23of10,pubtest287of100,1,323,5204,26,388,5618
subtest29of10,pubtest288of100,1,323,5210,22,40,5272
subtest25of10,pubtest288of100,1,323,5210,30,71,5311
subtest26of10,pubtest288of100,1,323,5210,31,114,5355
subtest27of10,pubtest288of100,1,323,5210,33,152,5395
subtest21of10,pubtest288of100,1,323,5210,34,191,5435
subtest22of10,pubtest288of100,1,323,5210,36,229,5475
subtest23of10,pubtest288of100,1,323,5210,37,268,5515
subtest24of10,pubtest288of100,1,323,5210,39,306,5555
subtest210of10,pubtest288of100,1,323,5210,38,345,5593
subtest28of10,pubtest288of100,1,323,5210,42,383,5635
subtest29of10,pubtest289of100,1,323,5216,10,43,5269
subtest210of10,pubtest289of100,1,323,5216,10,82,5308
subtest23of10,pubtest289of100,1,323,5216,12,121,5349
subtest24of10,pubtest289of100,1,323,5216,14,159,5389
subtest25of10,pubtest289of100,1,323,5216,15,198,5429
subtest26of10,pubtest289of100,1,323,5216,31,224,5471
subtest27of10,pubtest289of100,1,323,5216,33,261,5510
subtest28of10,pubtest289of100,1,323,5216,34,299,5549
subtest21of10,pubtest289of100,1,323,5216,35,338,5589
subtest22of10,pubtest289of100,1,323,5216,39,374,5629
subtest29of10,pubtest290of100,1,323,5241,14,49,5304
subtest26of10,pubtest290of100,1,323,5241,18,84,5343
subtest27of10,pubtest290of100,1,323,5241,19,123,5383
subtest21of10,pubtest290of100,1,323,5241,20,162,5423
subtest23of10,pubtest290of100,1,323,5241,16,206,5463
subtest22of10,pubtest290of100,1,323,5241,15,247,5503
subtest25of10,pubtest290of100,1,323,5241,22,280,5543
subtest210of10,pubtest290of100,1,323,5241,26,316,5583
subtest24of10,pubtest290of100,1,323,5241,35,348,5624
subtest28of10,pubtest290of100,1,323,5241,34,388,5663
subtest23of10,pubtest291of100,1,323,5163,12,41,5216
subtest24of10,pubtest291of100,1,323,5163,12,81,5256
subtest27of10,pubtest291of100,1,323,5163,18,114,5295
subtest28of10,pubtest291of100,1,323,5163,21,151,5335
subtest21of10,pubtest291of100,1,323,5163,24,188,5375
subtest210of10,pubtest291of100,1,323,5163,24,228,5415
subtest25of10,pubtest291of100,1,323,5163,26,266,5455
subtest29of10,pubtest291of100,1,323,5163,27,305,5495
subtest22of10,pubtest291of100,1,323,5163,28,346,5537
subtest26of10,pubtest291of100,1,323,5163,29,384,5576
subtest28of10,pubtest292of100,1,323,5252,9,49,5310
subtest29of10,pubtest292of100,1,323,5252,10,86,5348
subtest21of10,pubtest292of100,1,323,5252,11,125,5388
subtest25of10,pubtest292of100,1,323,5252,12,164,5428
subtest27of10,pubtest292of100,1,323,5252,18,198,5468
subtest23of10,pubtest292of100,1,323,5252,19,237,5508
subtest26of10,pubtest292of100,1,323,5252,20,276,5548
subtest22of10,pubtest292of100,1,323,5252,24,312,5588
subtest24of10,pubtest292of100,1,323,5252,33,343,5628
subtest210of10,pubtest292of100,1,323,5252,34,383,5669
subtest25of10,pubtest293of100,1,323,5411,8,38,5457
subtest24of10,pubtest293of100,1,323,5411,10,75,5496
subtest23of10,pubtest293of100,1,323,5411,15,110,5536
subtest28of10,pubtest293of100,1,323,5411,20,145,5576
subtest27of10,pubtest293of100,1,323,5411,34,171,5616
subtest21of10,pubtest293of100,1,323,5411,41,204,5656
subtest26of10,pubtest293of100,1,323,5411,41,244,5696
subtest22of10,pubtest293of100,1,323,5411,41,282,5734
subtest29of10,pubtest293of100,1,323,5411,43,322,5776
subtest210of10,pubtest293of100,1,323,5411,43,361,5815
subtest21of10,pubtest294of100,1,323,5246,7,41,5294
subtest210of10,pubtest294of100,1,323,5246,12,75,5333
subtest25of10,pubtest294of100,1,323,5246,12,114,5372
subtest29of10,pubtest294of100,1,323,5246,16,150,5412
subtest27of10,pubtest294of100,1,323,5246,17,189,5452
subtest26of10,pubtest294of100,1,323,5246,18,229,5493
subtest23of10,pubtest294of100,1,323,5246,19,267,5532
subtest22of10,pubtest294of100,1,323,5246,19,307,5572
subtest28of10,pubtest294of100,1,323,5246,20,346,5612
subtest24of10,pubtest294of100,1,323,5246,21,385,5652
subtest24of10,pubtest295of100,1,323,5558,9,44,5611
subtest23of10,pubtest295of100,1,323,5558,11,81,5650
subtest25of10,pubtest295of100,1,323,5558,9,123,5690
subtest22of10,pubtest295of100,1,323,5558,13,159,5730
subtest210of10,pubtest295of100,1,323,5558,17,195,5770
subtest27of10,pubtest295of100,1,323,5558,38,214,5810
subtest28of10,pubtest295of100,1,323,5558,40,251,5849
subtest29of10,pubtest295of100,1,323,5558,43,289,5890
subtest26of10,pubtest295of100,1,323,5558,45,327,5930
subtest21of10,pubtest295of100,1,323,5558,47,365,5970
subtest25of10,pubtest296of100,1,322,5338,15,125,5478
subtest27of10,pubtest296of100,1,322,5338,18,158,5514
subtest23of10,pubtest296of100,1,322,5338,20,198,5556
subtest26of10,pubtest296of100,1,322,5338,18,237,5593
subtest210of10,pubtest296of100,1,322,5338,22,275,5635
subtest21of10,pubtest296of100,1,322,5338,22,315,5675
subtest28of10,pubtest296of100,1,322,5338,23,355,5716
subtest22of10,pubtest296of100,1,322,5338,24,394,5756
subtest24of10,pubtest296of100,1,322,5338,16,441,5795
subtest29of10,pubtest296of100,1,322,5338,24,473,5835
subtest25of10,pubtest297of100,1,323,5344,10,40,5394
subtest210of10,pubtest297of100,1,323,5344,16,73,5433
subtest22of10,pubtest297of100,1,323,5344,18,111,5473
subtest26of10,pubtest297of100,1,323,5344,23,146,5513
subtest29of10,pubtest297of100,1,323,5344,23,186,5553
subtest23of10,pubtest297of100,1,323,5344,25,225,5594
subtest27of10,pubtest297of100,1,323,5344,29,260,5633
subtest28of10,pubtest297of100,1,323,5344,29,297,5670
subtest21of10,pubtest297of100,1,323,5344,30,337,5711
subtest24of10,pubtest297of100,1,323,5344,33,376,5753
subtest29of10,pubtest298of100,1,323,5461,9,42,5512
subtest22of10,pubtest298of100,1,323,5461,10,81,5552
subtest24of10,pubtest298of100,1,323,5461,11,119,5591
subtest21of10,pubtest298of100,1,323,5461,16,154,5631
subtest23of10,pubtest298of100,1,323,5461,15,194,5670
subtest210of10,pubtest298of100,1,323,5461,17,233,5711
subtest28of10,pubtest298of100,1,323,5461,17,272,5750
subtest26of10,pubtest298of100,1,323,5461,19,311,5791
subtest25of10,pubtest298of100,1,323,5461,18,353,5832
subtest27of10,pubtest298of100,1,323,5461,20,391,5872
subtest22of10,pubtest299of100,1,323,5544,11,47,5602
subtest29of10,pubtest299of100,1,323,5544,12,85,5641
subtest210of10,pubtest299of100,1,323,5544,14,123,5681
subtest27of10,pubtest299of100,1,323,5544,15,162,5721
subtest24of10,pubtest299of100,1,323,5544,17,200,5761
subtest23of10,pubtest299of100,1,323,5544,35,222,5801
subtest28of10,pubtest299of100,1,323,5544,35,262,5841
subtest26of10,pubtest299of100,1,323,5544,36,300,5880
subtest21of10,pubtest299of100,1,323,5544,37,341,5922
subtest25of10,pubtest299of100,1,323,5544,40,377,5961
subtest21of10,pubtest2100of100,1,325,5532,5,40,5577
subtest24of10,pubtest2100of100,1,325,5532,7,78,5617
subtest22of10,pubtest2100of100,1,325,5532,9,116,5657
subtest29of10,pubtest2100of100,1,325,5532,9,156,5697
subtest23of10,pubtest2100of100,1,325,5532,13,191,5736
subtest28of10,pubtest2100of100,1,325,5532,14,231,5777
subtest27of10,pubtest2100of100,1,325,5532,15,269,5816
subtest210of10,pubtest2100of100,1,325,5532,16,309,5857
subtest25of10,pubtest2100of100,1,325,5532,17,348,5897
subtest26of10,pubtest2100of100,1,325,5532,24,381,5937
subtest27of10,pubtest21of100,1,322,10911,12,41,10964
subtest26of10,pubtest21of100,1,322,10911,13,79,11003
subtest29of10,pubtest21of100,1,322,10911,15,117,11043
subtest21of10,pubtest21of100,1,322,10911,15,157,11083
subtest24of10,pubtest21of100,1,322,10911,16,195,11122
subtest210of10,pubtest21of100,1,322,10911,17,235,11163
subtest28of10,pubtest21of100,1,322,10911,19,273,11203
subtest23of10,pubtest21of100,1,322,10911,19,313,11243
subtest25of10,pubtest21of100,1,322,10911,18,352,11281
subtest22of10,pubtest21of100,1,322,10911,24,388,11323
subtest29of10,pubtest22of100,1,321,5379,6,39,5424
subtest27of10,pubtest22of100,1,321,5379,8,76,5463
subtest24of10,pubtest22of100,1,321,5379,9,116,5504
subtest23of10,pubtest22of100,1,321,5379,19,144,5542
subtest25of10,pubtest22of100,1,321,5379,19,184,5582
subtest28of10,pubtest22of100,1,321,5379,23,221,5623
subtest21of10,pubtest22of100,1,321,5379,24,260,5663
subtest26of10,pubtest22of100,1,321,5379,24,300,5703
subtest22of10,pubtest22of100,1,321,5379,26,338,5743
subtest210of10,pubtest22of100,1,321,5379,26,378,5783
subtest23of10,pubtest23of100,1,321,5397,11,41,5449
subtest29of10,pubtest23of100,1,321,5397,32,59,5488
subtest28of10,pubtest23of100,1,321,5397,33,98,5528
subtest27of10,pubtest23of100,1,321,5397,34,137,5568
subtest25of10,pubtest23of100,1,321,5397,38,172,5607
subtest21of10,pubtest23of100,1,321,5397,39,211,5647
subtest22of10,pubtest23of100,1,321,5397,40,249,5686
subtest210of10,pubtest23of100,1,321,5397,42,289,5728
subtest26of10,pubtest23of100,1,321,5397,40,329,5766
subtest24of10,pubtest23of100,1,321,5397,40,368,5805
subtest23of10,pubtest24of100,1,321,5356,7,39,5402
subtest24of10,pubtest24of100,1,321,5356,8,77,5441
subtest28of10,pubtest24of100,1,321,5356,12,113,5481
subtest25of10,pubtest24of100,1,321,5356,17,148,5521
subtest21of10,pubtest24of100,1,321,5356,30,174,5560
subtest29of10,pubtest24of100,1,321,5356,30,214,5600
subtest27of10,pubtest24of100,1,321,5356,34,251,5641
subtest22of10,pubtest24of100,1,321,5356,35,290,5681
subtest210of10,pubtest24of100,1,321,5356,36,329,5721
subtest26of10,pubtest24of100,1,321,5356,37,368,5761
subtest28of10,pubtest25of100,1,321,5995,9,38,6042
subtest21of10,pubtest25of100,1,321,5995,11,76,6082
subtest27of10,pubtest25of100,1,321,5995,12,115,6122
subtest210of10,pubtest25of100,1,321,5995,12,155,6162
subtest25of10,pubtest25of100,1,321,5995,19,188,6202
subtest26of10,pubtest25of100,1,321,5995,19,228,6242
subtest29of10,pubtest25of100,1,321,5995,21,266,6282
subtest23of10,pubtest25of100,1,321,5995,21,306,6322
subtest24of10,pubtest25of100,1,321,5995,23,345,6363
subtest22of10,pubtest25of100,1,321,5995,22,385,6402
subtest21of10,pubtest26of100,1,321,5839,11,41,5891
subtest29of10,pubtest26of100,1,321,5839,15,76,5930
subtest22of10,pubtest26of100,1,321,5839,28,103,5970
subtest23of10,pubtest26of100,1,321,5839,29,142,6010
subtest25of10,pubtest26of100,1,321,5839,45,164,6048
subtest28of10,pubtest26of100,1,321,5839,47,204,6090
subtest210of10,pubtest26of100,1,321,5839,47,243,6129
subtest26of10,pubtest26of100,1,321,5839,49,282,6170
subtest24of10,pubtest26of100,1,321,5839,49,322,6210
subtest27of10,pubtest26of100,1,321,5839,44,361,6244
subtest27of10,pubtest27of100,1,320,5500,7,40,5547
subtest23of10,pubtest27of100,1,320,5500,8,79,5587
subtest28of10,pubtest27of100,1,320,5500,12,113,5625
subtest24of10,pubtest27of100,1,320,5500,16,150,5666
subtest29of10,pubtest27of100,1,320,5500,19,187,5706
subtest210of10,pubtest27of100,1,320,5500,19,227,5746
subtest25of10,pubtest27of100,1,320,5500,21,265,5786
subtest21of10,pubtest27of100,1,320,5500,21,305,5826
subtest22of10,pubtest27of100,1,320,5500,22,344,5866
subtest26of10,pubtest27of100,1,320,5500,29,377,5906
subtest27of10,pubtest28of100,1,321,5207,8,42,5257
subtest21of10,pubtest28of100,1,321,5207,14,74,5295
subtest28of10,pubtest28of100,1,321,5207,18,110,5335
subtest29of10,pubtest28of100,1,321,5207,22,146,5375
subtest23of10,pubtest28of100,1,321,5207,35,173,5415
subtest210of10,pubtest28of100,1,321,5207,36,212,5455
subtest26of10,pubtest28of100,1,321,5207,39,250,5496
subtest25of10,pubtest28of100,1,321,5207,39,476,5722
subtest24of10,pubtest28of100,1,321,5207,41,515,5763
subtest22of10,pubtest28of100,1,321,5207,42,555,5804
subtest23of10,pubtest29of100,1,321,5634,8,108,5750
subtest29of10,pubtest29of100,1,321,5634,11,144,5789
subtest22of10,pubtest29of100,1,321,5634,13,182,5829
subtest25of10,pubtest29of100,1,321,5634,12,223,5869
subtest28of10,pubtest29of100,1,321,5634,15,260,5909
subtest21of10,pubtest29of100,1,321,5634,16,299,5949
subtest210of10,pubtest29of100,1,321,5634,9,346,5989
subtest24of10,pubtest29of100,1,321,5634,17,379,6030
subtest27of10,pubtest29of100,1,321,5634,18,417,6069
subtest26of10,pubtest29of100,1,321,5634,21,454,6109
subtest29of10,pubtest210of100,1,323,6226,8,40,6274
subtest21of10,pubtest210of100,1,323,6226,11,76,6313
subtest27of10,pubtest210of100,1,323,6226,12,115,6353
subtest210of10,pubtest210of100,1,323,6226,15,152,6393
subtest23of10,pubtest210of100,1,323,6226,17,190,6433
subtest25of10,pubtest210of100,1,323,6226,19,226,6471
subtest22of10,pubtest210of100,1,323,6226,21,266,6513
subtest28of10,pubtest210of100,1,323,6226,19,305,6550
subtest26of10,pubtest210of100,1,323,6226,23,345,6594
subtest24of10,pubtest210of100,1,323,6226,22,384,6632
subtest210of10,pubtest211of100,1,323,5478,17,41,5536
subtest24of10,pubtest211of100,1,323,5478,19,77,5574
subtest29of10,pubtest211of100,1,323,5478,20,117,5615
subtest21of10,pubtest211of100,1,323,5478,21,155,5654
subtest25of10,pubtest211of100,1,323,5478,21,195,5694
subtest22of10,pubtest211of100,1,323,5478,21,232,5731
subtest23of10,pubtest211of100,1,323,5478,25,271,5774
subtest28of10,pubtest211of100,1,323,5478,25,312,5815
subtest27of10,pubtest211of100,1,323,5478,27,349,5854
subtest26of10,pubtest211of100,1,323,5478,27,389,5894
subtest29of10,pubtest212of100,1,323,5318,31,40,5389
subtest28of10,pubtest212of100,1,323,5318,33,80,5431
subtest25of10,pubtest212of100,1,323,5318,30,123,5471
subtest23of10,pubtest212of100,1,323,5318,35,157,5510
subtest27of10,pubtest212of100,1,323,5318,56,176,5550
subtest21of10,pubtest212of100,1,323,5318,56,215,5589
subtest22of10,pubtest212of100,1,323,5318,58,254,5630
subtest26of10,pubtest212of100,1,323,5318,58,294,5670
subtest24of10,pubtest212of100,1,323,5318,59,334,5711
subtest210of10,pubtest212of100,1,323,5318,73,358,5749
subtest23of10,pubtest213of100,1,322,5330,7,39,5376
subtest26of10,pubtest213of100,1,322,5330,10,75,5415
subtest29of10,pubtest213of100,1,322,5330,10,115,5455
subtest27of10,pubtest213of100,1,322,5330,11,155,5496
subtest22of10,pubtest213of100,1,322,5330,20,185,5535
subtest21of10,pubtest213of100,1,322,5330,20,225,5575
subtest24of10,pubtest213of100,1,322,5330,22,263,5615
subtest210of10,pubtest213of100,1,322,5330,30,295,5655
subtest25of10,pubtest213of100,1,322,5330,30,335,5695
subtest28of10,pubtest213of100,1,322,5330,31,374,5735
subtest21of10,pubtest214of100,1,323,5380,9,43,5432
subtest23of10,pubtest214of100,1,323,5380,11,80,5471
subtest25of10,pubtest214of100,1,323,5380,13,117,5510
subtest26of10,pubtest214of100,1,323,5380,27,143,5550
subtest27of10,pubtest214of100,1,323,5380,37,173,5590
subtest29of10,pubtest214of100,1,323,5380,50,200,5630
subtest22of10,pubtest214of100,1,323,5380,50,240,5670
subtest210of10,pubtest214of100,1,323,5380,63,267,5710
subtest24of10,pubtest214of100,1,323,5380,63,307,5750
subtest28of10,pubtest214of100,1,323,5380,65,345,5790
subtest29of10,pubtest215of100,1,323,5361,12,49,5422
subtest27of10,pubtest215of100,1,323,5361,11,89,5461
subtest21of10,pubtest215of100,1,323,5361,13,128,5502
subtest25of10,pubtest215of100,1,323,5361,14,167,5542
subtest24of10,pubtest215of100,1,323,5361,16,203,5580
subtest22of10,pubtest215of100,1,323,5361,19,242,5622
subtest26of10,pubtest215of100,1,323,5361,18,282,5661
subtest23of10,pubtest215of100,1,323,5361,18,321,5700
subtest28of10,pubtest215of100,1,323,5361,20,361,5742
subtest210of10,pubtest215of100,1,323,5361,22,400,5783
subtest24of10,pubtest216of100,1,323,5398,9,40,5447
subtest21of10,pubtest216of100,1,323,5398,11,76,5485
subtest27of10,pubtest216of100,1,323,5398,15,112,5525
subtest23of10,pubtest216of100,1,323,5398,15,151,5564
subtest29of10,pubtest216of100,1,323,5398,18,189,5605
subtest22of10,pubtest216of100,1,323,5398,17,229,5644
subtest28of10,pubtest216of100,1,323,5398,17,271,5686
subtest26of10,pubtest216of100,1,323,5398,19,307,5724
subtest25of10,pubtest216of100,1,323,5398,21,346,5765
subtest210of10,pubtest216of100,1,323,5398,25,382,5805
subtest27of10,pubtest217of100,1,322,5342,13,49,5404
subtest22of10,pubtest217of100,1,322,5342,14,86,5442
subtest29of10,pubtest217of100,1,322,5342,19,123,5484
subtest24of10,pubtest217of100,1,322,5342,19,162,5523
subtest26of10,pubtest217of100,1,322,5342,18,199,5559
subtest23of10,pubtest217of100,1,322,5342,17,238,5597
subtest210of10,pubtest217of100,1,322,5342,24,276,5642
subtest21of10,pubtest217of100,1,322,5342,16,316,5674
subtest28of10,pubtest217of100,1,322,5342,23,355,5720
subtest25of10,pubtest217of100,1,322,5342,23,395,5760
subtest29of10,pubtest218of100,1,323,5671,7,41,5719
subtest21of10,pubtest218of100,1,323,5671,9,78,5758
subtest22of10,pubtest218of100,1,323,5671,10,117,5798
subtest27of10,pubtest218of100,1,323,5671,11,156,5838
subtest23of10,pubtest218of100,1,323,5671,14,193,5878
subtest28of10,pubtest218of100,1,323,5671,16,231,5918
subtest24of10,pubtest218of100,1,323,5671,17,268,5956
subtest25of10,pubtest218of100,1,323,5671,16,307,5994
subtest26of10,pubtest218of100,1,323,5671,21,346,6038
subtest210of10,pubtest218of100,1,323,5671,21,386,6078
subtest25of10,pubtest219of100,1,323,5520,15,46,5581
subtest26of10,pubtest219of100,1,323,5520,14,85,5619
subtest22of10,pubtest219of100,1,323,5520,17,124,5661
subtest210of10,pubtest219of100,1,323,5520,14,160,5694
subtest24of10,pubtest219of100,1,323,5520,37,183,5740
subtest29of10,pubtest219of100,1,323,5520,38,222,5780
subtest28of10,pubtest219of100,1,323,5520,39,261,5820
subtest21of10,pubtest219of100,1,323,5520,38,301,5859
subtest23of10,pubtest219of100,1,323,5520,43,337,5900
subtest27of10,pubtest219of100,1,323,5520,43,376,5939
subtest25of10,pubtest220of100,1,323,5466,9,46,5521
subtest210of10,pubtest220of100,1,323,5466,11,84,5561
subtest23of10,pubtest220of100,1,323,5466,13,124,5603
subtest29of10,pubtest220of100,1,323,5466,14,162,5642
subtest21of10,pubtest220of100,1,323,5466,38,177,5681
subtest24of10,pubtest220of100,1,323,5466,39,216,5721
subtest27of10,pubtest220of100,1,323,5466,40,255,5761
subtest28of10,pubtest220of100,1,323,5466,43,292,5801
subtest26of10,pubtest220of100,1,323,5466,44,331,5841
subtest22of10,pubtest220of100,1,323,5466,46,370,5882
subtest24of10,pubtest221of100,1,323,5491,11,41,5543
subtest21of10,pubtest221of100,1,323,5491,11,80,5582
subtest28of10,pubtest221of100,1,323,5491,16,115,5622
subtest23of10,pubtest221of100,1,323,5491,16,159,5666
subtest25of10,pubtest221of100,1,323,5491,18,197,5706
subtest22of10,pubtest221of100,1,323,5491,18,237,5746
subtest27of10,pubtest221of100,1,323,5491,25,271,5787
subtest210of10,pubtest221of100,1,323,5491,22,311,5824
subtest29of10,pubtest221of100,1,323,5491,22,349,5862
subtest26of10,pubtest221of100,1,323,5491,25,389,5905
subtest21of10,pubtest222of100,1,323,5341,10,41,5392
subtest22of10,pubtest222of100,1,323,5341,11,78,5430
subtest29of10,pubtest222of100,1,323,5341,13,117,5471
subtest27of10,pubtest222of100,1,323,5341,13,157,5511
subtest28of10,pubtest222of100,1,323,5341,16,194,5551
subtest210of10,pubtest222of100,1,323,5341,17,233,5591
subtest26of10,pubtest222of100,1,323,5341,18,272,5631
subtest23of10,pubtest222of100,1,323,5341,18,312,5671
subtest25of10,pubtest222of100,1,323,5341,20,350,5711
subtest24of10,pubtest222of100,1,323,5341,20,390,5751
subtest29of10,pubtest223of100,1,323,5373,13,41,5427
subtest23of10,pubtest223of100,1,323,5373,13,80,5466
subtest21of10,pubtest223of100,1,323,5373,12,121,5506
subtest28of10,pubtest223of100,1,323,5373,15,159,5547
subtest27of10,pubtest223of100,1,323,5373,16,197,5586
subtest24of10,pubtest223of100,1,323,5373,16,237,5626
subtest210of10,pubtest223of100,1,323,5373,18,275,5666
subtest25of10,pubtest223of100,1,323,5373,20,313,5706
subtest22of10,pubtest223of100,1,323,5373,23,349,5745
subtest26of10,pubtest223of100,1,323,5373,23,389,5785
subtest27of10,pubtest224of100,1,323,5304,8,42,5354
subtest21of10,pubtest224of100,1,323,5304,8,79,5391
subtest23of10,pubtest224of100,1,323,5304,10,120,5434
subtest28of10,pubtest224of100,1,323,5304,9,158,5471
subtest29of10,pubtest224of100,1,323,5304,12,198,5514
subtest26of10,pubtest224of100,1,323,5304,12,236,5552
subtest22of10,pubtest224of100,1,323,5304,13,276,5593
subtest24of10,pubtest224of100,1,323,5304,19,310,5633
subtest210of10,pubtest224of100,1,323,5304,19,350,5673
subtest25of10,pubtest224of100,1,323,5304,16,389,5709
subtest27of10,pubtest225of100,1,323,5219,13,46,5278
subtest21of10,pubtest225of100,1,323,5219,14,85,5318
subtest22of10,pubtest225of100,1,323,5219,13,123,5355
subtest26of10,pubtest225of100,1,323,5219,19,159,5397
subtest24of10,pubtest225of100,1,323,5219,21,201,5441
subtest25of10,pubtest225of100,1,323,5219,21,240,5480
subtest23of10,pubtest225of100,1,323,5219,26,276,5521
subtest29of10,pubtest225of100,1,323,5219,28,314,5561
subtest28of10,pubtest225of100,1,323,5219,31,351,5601
subtest210of10,pubtest225of100,1,323,5219,38,385,5642
subtest22of10,pubtest226of100,1,323,5270,18,41,5329
subtest210of10,pubtest226of100,1,323,5270,18,80,5368
subtest23of10,pubtest226of100,1,323,5270,20,119,5409
subtest27of10,pubtest226of100,1,323,5270,20,158,5448
subtest25of10,pubtest226of100,1,323,5270,18,197,5485
subtest21of10,pubtest226of100,1,323,5270,23,235,5528
subtest29of10,pubtest226of100,1,323,5270,24,274,5568
subtest28of10,pubtest226of100,1,323,5270,23,314,5607
subtest26of10,pubtest226of100,1,323,5270,28,348,5646
subtest24of10,pubtest226of100,1,323,5270,28,388,5686
subtest29of10,pubtest227of100,1,323,5262,10,42,5314
subtest210of10,pubtest227of100,1,323,5262,10,81,5353
subtest24of10,pubtest227of100,1,323,5262,11,119,5392
subtest26of10,pubtest227of100,1,323,5262,12,159,5433
subtest25of10,pubtest227of100,1,323,5262,13,199,5474
subtest23of10,pubtest227of100,1,323,5262,14,235,5511
subtest22of10,pubtest227of100,1,323,5262,23,268,5553
subtest27of10,pubtest227of100,1,323,5262,25,306,5593
subtest28of10,pubtest227of100,1,323,5262,26,345,5633
subtest21of10,pubtest227of100,1,323,5262,27,384,5673
subtest26of10,pubtest228of100,1,323,5346,13,42,5401
subtest21of10,pubtest228of100,1,323,5346,13,80,5439
subtest24of10,pubtest228of100,1,323,5346,15,119,5480
subtest23of10,pubtest228of100,1,323,5346,17,160,5523
subtest25of10,pubtest228of100,1,323,5346,17,199,5562
subtest27of10,pubtest228of100,1,323,5346,19,236,5601
subtest29of10,pubtest228of100,1,323,5346,23,272,5641
subtest210of10,pubtest228of100,1,323,5346,24,311,5681
subtest22of10,pubtest228of100,1,323,5346,25,350,5721
subtest28of10,pubtest228of100,1,323,5346,30,386,5762
subtest24of10,pubtest229of100,1,321,5701,12,43,5756
subtest21of10,pubtest229of100,1,321,5701,21,72,5794
subtest28of10,pubtest229of100,1,321,5701,22,110,5833
subtest22of10,pubtest229of100,1,321,5701,23,150,5874
subtest23of10,pubtest229of100,1,321,5701,25,188,5914
subtest25of10,pubtest229of100,1,321,5701,26,227,5954
subtest29of10,pubtest229of100,1,321,5701,27,265,5993
subtest26of10,pubtest229of100,1,321,5701,27,304,6032
subtest210of10,pubtest229of100,1,321,5701,30,343,6074
subtest27of10,pubtest229of100,1,321,5701,24,388,6113
subtest21of10,pubtest230of100,1,323,5250,4,41,5295
subtest27of10,pubtest230of100,1,323,5250,5,79,5334
subtest29of10,pubtest230of100,1,323,5250,7,117,5374
subtest25of10,pubtest230of100,1,323,5250,11,152,5413
subtest23of10,pubtest230of100,1,323,5250,18,186,5454
subtest22of10,pubtest230of100,1,323,5250,19,224,5493
subtest28of10,pubtest230of100,1,323,5250,20,264,5534
subtest210of10,pubtest230of100,1,323,5250,22,303,5575
subtest24of10,pubtest230of100,1,323,5250,22,342,5614
subtest26of10,pubtest230of100,1,323,5250,23,382,5655
subtest23of10,pubtest231of100,1,323,5250,10,41,5301
subtest28of10,pubtest231of100,1,323,5250,12,78,5340
subtest24of10,pubtest231of100,1,323,5250,17,113,5380
subtest29of10,pubtest231of100,1,323,5250,17,151,5418
subtest25of10,pubtest231of100,1,323,5250,16,191,5457
subtest210of10,pubtest231of100,1,323,5250,19,230,5499
subtest27of10,pubtest231of100,1,323,5250,17,270,5537
subtest21of10,pubtest231of100,1,323,5250,24,306,5580
subtest26of10,pubtest231of100,1,323,5250,24,346,5620
subtest22of10,pubtest231of100,1,323,5250,26,383,5659
subtest21of10,pubtest232of100,1,323,5440,7,41,5488
subtest27of10,pubtest232of100,1,323,5440,11,75,5526
subtest23of10,pubtest232of100,1,323,5440,14,112,5566
subtest29of10,pubtest232of100,1,323,5440,15,151,5606
subtest25of10,pubtest232of100,1,323,5440,23,183,5646
subtest22of10,pubtest232of100,1,323,5440,26,219,5685
subtest28of10,pubtest232of100,1,323,5440,26,258,5724
subtest210of10,pubtest232of100,1,323,5440,30,297,5767
subtest24of10,pubtest232of100,1,323,5440,34,333,5807
subtest26of10,pubtest232of100,1,323,5440,35,371,5846
subtest29of10,pubtest233of100,1,323,5851,14,53,5918
subtest27of10,pubtest233of100,1,323,5851,16,83,5950
subtest21of10,pubtest233of100,1,323,5851,25,121,5997
subtest26of10,pubtest233of100,1,323,5851,26,160,6037
subtest23of10,pubtest233of100,1,323,5851,26,202,6079
subtest22of10,pubtest233of100,1,323,5851,25,240,6116
subtest28of10,pubtest233of100,1,323,5851,28,278,6157
subtest25of10,pubtest233of100,1,323,5851,15,317,6183
subtest210of10,pubtest233of100,1,323,5851,29,358,6238
subtest24of10,pubtest233of100,1,323,5851,14,396,6261
subtest25of10,pubtest234of100,1,323,6390,4,49,6443
subtest26of10,pubtest234of100,1,323,6390,5,88,6483
subtest27of10,pubtest234of100,1,323,6390,14,119,6523
subtest22of10,pubtest234of100,1,323,6390,19,154,6563
subtest210of10,pubtest234of100,1,323,6390,21,192,6603
subtest24of10,pubtest234of100,1,323,6390,23,230,6643
subtest23of10,pubtest234of100,1,323,6390,23,270,6683
subtest21of10,pubtest234of100,1,323,6390,21,312,6723
subtest28of10,pubtest234of100,1,323,6390,27,346,6763
subtest29of10,pubtest234of100,1,323,6390,26,386,6802
subtest21of10,pubtest235of100,1,321,5520,9,38,5567
subtest210of10,pubtest235of100,1,321,5520,17,71,5608
subtest23of10,pubtest235of100,1,321,5520,18,109,5647
subtest22of10,pubtest235of100,1,321,5520,18,149,5687
subtest25of10,pubtest235of100,1,321,5520,23,184,5727
subtest24of10,pubtest235of100,1,321,5520,22,224,5766
subtest28of10,pubtest235of100,1,321,5520,24,263,5807
subtest27of10,pubtest235of100,1,321,5520,25,302,5847
subtest29of10,pubtest235of100,1,321,5520,26,341,5887
subtest26of10,pubtest235of100,1,321,5520,26,382,5928
subtest210of10,pubtest236of100,1,323,5321,11,42,5374
subtest23of10,pubtest236of100,1,323,5321,12,81,5414
subtest28of10,pubtest236of100,1,323,5321,11,119,5451
subtest27of10,pubtest236of100,1,323,5321,21,153,5495
subtest25of10,pubtest236of100,1,323,5321,22,191,5534
subtest21of10,pubtest236of100,1,323,5321,40,212,5573
subtest29of10,pubtest236of100,1,323,5321,40,251,5612
subtest24of10,pubtest236of100,1,323,5321,42,290,5653
subtest26of10,pubtest236of100,1,323,5321,43,329,5693
subtest22of10,pubtest236of100,1,323,5321,44,368,5733
subtest24of10,pubtest237of100,1,323,5348,12,40,5400
subtest25of10,pubtest237of100,1,323,5348,13,78,5439
subtest23of10,pubtest237of100,1,323,5348,12,117,5477
subtest28of10,pubtest237of100,1,323,5348,15,156,5519
subtest21of10,pubtest237of100,1,323,5348,18,191,5557
subtest27of10,pubtest237of100,1,323,5348,17,231,5596
subtest210of10,pubtest237of100,1,323,5348,20,270,5638
subtest22of10,pubtest237of100,1,323,5348,20,309,5677
subtest29of10,pubtest237of100,1,323,5348,22,349,5719
subtest26of10,pubtest237of100,1,323,5348,17,394,5759
subtest29of10,pubtest238of100,1,323,5268,12,48,5328
subtest21of10,pubtest238of100,1,323,5268,19,78,5365
subtest25of10,pubtest238of100,1,323,5268,14,116,5398
subtest27of10,pubtest238of100,1,323,5268,22,156,5446
subtest22of10,pubtest238of100,1,323,5268,13,194,5475
subtest24of10,pubtest238of100,1,323,5268,20,237,5525
subtest23of10,pubtest238of100,1,323,5268,24,273,5565
subtest210of10,pubtest238of100,1,323,5268,24,315,5607
subtest28of10,pubtest238of100,1,323,5268,20,359,5647
subtest26of10,pubtest238of100,1,323,5268,21,397,5686
subtest21of10,pubtest239of100,1,323,5355,9,46,5410
subtest28of10,pubtest239of100,1,323,5355,10,84,5449
subtest27of10,pubtest239of100,1,323,5355,13,120,5488
subtest26of10,pubtest239of100,1,323,5355,23,151,5529
subtest24of10,pubtest239of100,1,323,5355,24,191,5570
subtest25of10,pubtest239of100,1,323,5355,28,226,5609
subtest29of10,pubtest239of100,1,323,5355,31,261,5647
subtest23of10,pubtest239of100,1,323,5355,34,300,5689
subtest210of10,pubtest239of100,1,323,5355,34,340,5729
subtest22of10,pubtest239of100,1,323,5355,30,381,5766
subtest25of10,pubtest240of100,1,323,5427,7,43,5477
subtest21of10,pubtest240of100,1,323,5427,9,79,5515
subtest210of10,pubtest240of100,1,323,5427,14,463,5904
subtest29of10,pubtest240of100,1,323,5427,20,497,5944
subtest27of10,pubtest240of100,1,323,5427,22,535,5984
subtest24of10,pubtest240of100,1,323,5427,26,571,6024
subtest23of10,pubtest240of100,1,323,5427,25,613,6065
subtest28of10,pubtest240of100,1,323,5427,25,651,6103
subtest22of10,pubtest240of100,1,323,5427,31,686,6144
subtest26of10,pubtest240of100,1,323,5427,35,722,6184
subtest23of10,pubtest241of100,1,323,5476,8,41,5525
subtest27of10,pubtest241of100,1,323,5476,9,79,5564
subtest21of10,pubtest241of100,1,323,5476,12,117,5605
subtest210of10,pubtest241of100,1,323,5476,17,151,5644
subtest24of10,pubtest241of100,1,323,5476,16,191,5683
subtest28of10,pubtest241of100,1,323,5476,22,226,5724
subtest25of10,pubtest241of100,1,323,5476,28,260,5764
subtest29of10,pubtest241of100,1,323,5476,28,300,5804
subtest22of10,pubtest241of100,1,323,5476,32,336,5844
subtest26of10,pubtest241of100,1,323,5476,32,376,5884
subtest27of10,pubtest242of100,1,323,5345,10,38,5393
subtest23of10,pubtest242of100,1,323,5345,12,75,5432
subtest26of10,pubtest242of100,1,323,5345,13,114,5472
subtest210of10,pubtest242of100,1,323,5345,19,148,5512
subtest25of10,pubtest242of100,1,323,5345,18,188,5551
subtest29of10,pubtest242of100,1,323,5345,21,227,5593
subtest21of10,pubtest242of100,1,323,5345,24,263,5632
subtest22of10,pubtest242of100,1,323,5345,25,302,5672
subtest24of10,pubtest242of100,1,323,5345,25,342,5712
subtest28of10,pubtest242of100,1,323,5345,28,379,5752
subtest28of10,pubtest243of100,1,323,5351,10,45,5406
subtest29of10,pubtest243of100,1,323,5351,11,83,5445
subtest23of10,pubtest243of100,1,323,5351,13,121,5485
subtest22of10,pubtest243of100,1,323,5351,14,159,5524
subtest25of10,pubtest243of100,1,323,5351,16,199,5566
subtest26of10,pubtest243of100,1,323,5351,17,237,5605
subtest27of10,pubtest243of100,1,323,5351,20,274,5645
subtest210of10,pubtest243of100,1,323,5351,25,309,5685
subtest24of10,pubtest243of100,1,323,5351,24,349,5724
subtest21of10,pubtest243of100,1,323,5351,22,393,5766
subtest26of10,pubtest244of100,1,323,5463,11,40,5514
subtest27of10,pubtest244of100,1,323,5463,11,79,5553
subtest25of10,pubtest244of100,1,323,5463,13,116,5592
subtest21of10,pubtest244of100,1,323,5463,15,156,5634
subtest29of10,pubtest244of100,1,323,5463,13,194,5670
subtest23of10,pubtest244of100,1,323,5463,19,231,5713
subtest28of10,pubtest244of100,1,323,5463,19,271,5753
subtest210of10,pubtest244of100,1,323,5463,22,309,5794
subtest22of10,pubtest244of100,1,323,5463,23,347,5833
subtest24of10,pubtest244of100,1,323,5463,24,386,5873
subtest29of10,pubtest245of100,1,322,5328,10,41,5379
subtest26of10,pubtest245of100,1,322,5328,10,81,5419
subtest23of10,pubtest245of100,1,322,5328,12,118,5458
subtest22of10,pubtest245of100,1,322,5328,18,153,5499
subtest25of10,pubtest245of100,1,322,5328,19,191,5538
subtest24of10,pubtest245of100,1,322,5328,20,229,5577
subtest21of10,pubtest245of100,1,322,5328,21,269,5618
subtest27of10,pubtest245of100,1,322,5328,22,306,5656
subtest28of10,pubtest245of100,1,322,5328,22,346,5696
subtest210of10,pubtest245of100,1,322,5328,57,353,5738
subtest26of10,pubtest246of100,1,323,5348,17,58,5423
subtest27of10,pubtest246of100,1,323,5348,18,97,5463
subtest29of10,pubtest246of100,1,323,5348,20,135,5503
subtest25of10,pubtest246of100,1,323,5348,21,173,5542
subtest23of10,pubtest246of100,1,323,5348,24,211,5583
subtest28of10,pubtest246of100,1,323,5348,26,249,5623
subtest21of10,pubtest246of100,1,323,5348,28,287,5663
subtest210of10,pubtest246of100,1,323,5348,29,327,5704
subtest22of10,pubtest246of100,1,323,5348,30,365,5743
subtest24of10,pubtest246of100,1,323,5348,32,403,5783
subtest27of10,pubtest247of100,1,323,5310,7,41,5358
subtest23of10,pubtest247of100,1,323,5310,10,77,5397
subtest26of10,pubtest247of100,1,323,5310,12,115,5437
subtest21of10,pubtest247of100,1,323,5310,16,150,5476
subtest29of10,pubtest247of100,1,323,5310,17,189,5516
subtest25of10,pubtest247of100,1,323,5310,18,229,5557
subtest22of10,pubtest247of100,1,323,5310,16,268,5594
subtest28of10,pubtest247of100,1,323,5310,21,304,5635
subtest24of10,pubtest247of100,1,323,5310,25,342,5677
subtest210of10,pubtest247of100,1,323,5310,24,383,5717
subtest29of10,pubtest248of100,1,323,5534,10,47,5591
subtest26of10,pubtest248of100,1,323,5534,12,83,5629
subtest25of10,pubtest248of100,1,323,5534,12,120,5666
subtest23of10,pubtest248of100,1,323,5534,14,160,5708
subtest28of10,pubtest248of100,1,323,5534,15,197,5746
subtest27of10,pubtest248of100,1,323,5534,31,223,5788
subtest21of10,pubtest248of100,1,323,5534,31,264,5829
subtest24of10,pubtest248of100,1,323,5534,32,302,5868
subtest22of10,pubtest248of100,1,323,5534,33,343,5910
subtest210of10,pubtest248of100,1,323,5534,36,378,5948
subtest28of10,pubtest249of100,1,323,5309,11,40,5360
subtest27of10,pubtest249of100,1,323,5309,14,76,5399
subtest25of10,pubtest249of100,1,323,5309,15,114,5438
subtest21of10,pubtest249of100,1,323,5309,16,154,5479
subtest24of10,pubtest249of100,1,323,5309,15,193,5517
subtest26of10,pubtest249of100,1,323,5309,18,232,5559
subtest23of10,pubtest249of100,1,323,5309,19,271,5599
subtest29of10,pubtest249of100,1,323,5309,20,310,5639
subtest210of10,pubtest249of100,1,323,5309,21,347,5677
subtest22of10,pubtest249of100,1,323,5309,23,387,5719
subtest27of10,pubtest250of100,1,323,5349,9,39,5397
subtest23of10,pubtest250of100,1,323,5349,11,76,5436
subtest29of10,pubtest250of100,1,323,5349,12,114,5475
subtest28of10,pubtest250of100,1,323,5349,12,154,5515
subtest21of10,pubtest250of100,1,323,5349,15,191,5555
subtest25of10,pubtest250of100,1,323,5349,16,230,5595
subtest24of10,pubtest250of100,1,323,5349,25,261,5635
subtest210of10,pubtest250of100,1,323,5349,27,299,5675
subtest26of10,pubtest250of100,1,323,5349,27,339,5715
subtest22of10,pubtest250of100,1,323,5349,32,374,5755
subtest23of10,pubtest251of100,1,323,5260,11,38,5309
subtest27of10,pubtest251of100,1,323,5260,12,76,5348
subtest22of10,pubtest251of100,1,323,5260,11,116,5387
subtest25of10,pubtest251of100,1,323,5260,23,145,5428
subtest24of10,pubtest251of100,1,323,5260,23,185,5468
subtest28of10,pubtest251of100,1,323,5260,32,216,5508
subtest21of10,pubtest251of100,1,323,5260,35,253,5548
subtest29of10,pubtest251of100,1,323,5260,36,292,5588
subtest210of10,pubtest251of100,1,323,5260,37,331,5628
subtest26of10,pubtest251of100,1,323,5260,43,364,5667
subtest28of10,pubtest252of100,1,323,5232,16,40,5288
subtest26of10,pubtest252of100,1,323,5232,16,77,5325
subtest29of10,pubtest252of100,1,323,5232,15,117,5364
subtest21of10,pubtest252of100,1,323,5232,18,155,5405
subtest27of10,pubtest252of100,1,323,5232,20,192,5444
subtest22of10,pubtest252of100,1,323,5232,22,231,5485
subtest23of10,pubtest252of100,1,323,5232,22,270,5524
subtest210of10,pubtest252of100,1,323,5232,23,310,5565
subtest25of10,pubtest252of100,1,323,5232,22,349,5603
subtest24of10,pubtest252of100,1,323,5232,26,388,5646
subtest28of10,pubtest253of100,1,322,5242,13,38,5293
subtest29of10,pubtest253of100,1,322,5242,16,74,5332
subtest24of10,pubtest253of100,1,322,5242,15,114,5371
subtest25of10,pubtest253of100,1,322,5242,15,154,5411
subtest21of10,pubtest253of100,1,322,5242,17,193,5452
subtest27of10,pubtest253of100,1,322,5242,18,232,5492
subtest22of10,pubtest253of100,1,322,5242,19,271,5532
subtest210of10,pubtest253of100,1,322,5242,20,312,5574
subtest23of10,pubtest253of100,1,322,5242,14,348,5604
subtest26of10,pubtest253of100,1,322,5242,23,387,5652
subtest210of10,pubtest254of100,1,323,5228,10,41,5279
subtest27of10,pubtest254of100,1,323,5228,10,77,5315
subtest24of10,pubtest254of100,1,323,5228,12,116,5356
subtest28of10,pubtest254of100,1,323,5228,12,461,5701
subtest21of10,pubtest254of100,1,323,5228,21,493,5742
subtest23of10,pubtest254of100,1,323,5228,28,528,5784
subtest25of10,pubtest254of100,1,323,5228,27,567,5822
subtest22of10,pubtest254of100,1,323,5228,28,606,5862
subtest26of10,pubtest254of100,1,323,5228,30,644,5902
subtest29of10,pubtest254of100,1,323,5228,30,684,5942
subtest23of10,pubtest255of100,1,322,5250,9,352,5611
subtest22of10,pubtest255of100,1,322,5250,10,353,5613
subtest28of10,pubtest255of100,1,322,5250,12,389,5651
subtest27of10,pubtest255of100,1,322,5250,13,428,5691
subtest29of10,pubtest255of100,1,322,5250,20,461,5731
subtest21of10,pubtest255of100,1,322,5250,21,500,5771
subtest24of10,pubtest255of100,1,322,5250,22,539,5811
subtest25of10,pubtest255of100,1,322,5250,25,576,5851
subtest210of10,pubtest255of100,1,322,5250,25,616,5891
subtest26of10,pubtest255of100,1,322,5250,28,653,5931
subtest29of10,pubtest256of100,1,323,5330,9,41,5380
subtest21of10,pubtest256of100,1,323,5330,11,78,5419
subtest23of10,pubtest256of100,1,323,5330,20,109,5459
subtest25of10,pubtest256of100,1,323,5330,21,148,5499
subtest27of10,pubtest256of100,1,323,5330,24,185,5539
subtest26of10,pubtest256of100,1,323,5330,25,224,5579
subtest210of10,pubtest256of100,1,323,5330,26,263,5619
subtest28of10,pubtest256of100,1,323,5330,27,304,5661
subtest22of10,pubtest256of100,1,323,5330,28,342,5700
subtest24of10,pubtest256of100,1,323,5330,29,380,5739
subtest24of10,pubtest257of100,1,323,5251,10,41,5302
subtest21of10,pubtest257of100,1,323,5251,10,79,5340
subtest27of10,pubtest257of100,1,323,5251,13,116,5380
subtest23of10,pubtest257of100,1,323,5251,13,156,5420
subtest28of10,pubtest257of100,1,323,5251,22,187,5460
subtest29of10,pubtest257of100,1,323,5251,23,226,5500
subtest22of10,pubtest257of100,1,323,5251,25,262,5538
subtest25of10,pubtest257of100,1,323,5251,27,301,5579
subtest210of10,pubtest257of100,1,323,5251,27,341,5619
subtest26of10,pubtest257of100,1,323,5251,30,379,5660
subtest28of10,pubtest258of100,1,323,5247,11,40,5298
subtest23of10,pubtest258of100,1,323,5247,12,74,5333
subtest25of10,pubtest258of100,1,323,5247,15,112,5374
subtest21of10,pubtest258of100,1,323,5247,16,154,5417
subtest26of10,pubtest258of100,1,323,5247,14,192,5453
subtest210of10,pubtest258of100,1,323,5247,27,221,5495
subtest29of10,pubtest258of100,1,323,5247,28,261,5536
subtest22of10,pubtest258of100,1,323,5247,30,298,5575
subtest27of10,pubtest258of100,1,323,5247,29,337,5613
subtest24of10,pubtest258of100,1,323,5247,39,369,5655
subtest21of10,pubtest259of100,1,323,5353,11,41,5405
subtest28of10,pubtest259of100,1,323,5353,14,78,5445
subtest25of10,pubtest259of100,1,323,5353,14,118,5485
subtest24of10,pubtest259of100,1,323,5353,23,149,5525
subtest23of10,pubtest259of100,1,323,5353,31,180,5564
subtest29of10,pubtest259of100,1,323,5353,32,218,5603
subtest22of10,pubtest259of100,1,323,5353,35,257,5645
subtest210of10,pubtest259of100,1,323,5353,36,296,5685
subtest27of10,pubtest259of100,1,323,5353,31,335,5719
subtest26of10,pubtest259of100,1,323,5353,37,375,5765
subtest210of10,pubtest260of100,1,323,5216,10,38,5264
subtest21of10,pubtest260of100,1,323,5216,13,78,5307
subtest23of10,pubtest260of100,1,323,5216,11,118,5345
subtest27of10,pubtest260of100,1,323,5216,14,155,5385
subtest29of10,pubtest260of100,1,323,5216,16,194,5426
subtest25of10,pubtest260of100,1,323,5216,18,232,5466
subtest26of10,pubtest260of100,1,323,5216,21,269,5506
subtest28of10,pubtest260of100,1,323,5216,22,307,5545
subtest22of10,pubtest260of100,1,323,5216,22,347,5585
subtest24of10,pubtest260of100,1,323,5216,35,375,5626
subtest25of10,pubtest261of100,1,323,5243,10,43,5296
subtest28of10,pubtest261of100,1,323,5243,11,81,5335
subtest210of10,pubtest261of100,1,323,5243,12,120,5375
subtest29of10,pubtest261of100,1,323,5243,14,158,5415
subtest22of10,pubtest261of100,1,323,5243,15,198,5456
subtest23of10,pubtest261of100,1,323,5243,17,235,5495
subtest27of10,pubtest261of100,1,323,5243,34,258,5535
subtest24of10,pubtest261of100,1,323,5243,35,296,5574
subtest21of10,pubtest261of100,1,323,5243,36,336,5615
subtest26of10,pubtest261of100,1,323,5243,37,376,5656
subtest21of10,pubtest262of100,1,323,5308,9,42,5359
subtest22of10,pubtest262of100,1,323,5308,10,80,5398
subtest23of10,pubtest262of100,1,323,5308,12,118,5438
subtest26of10,pubtest262of100,1,323,5308,15,155,5478
subtest29of10,pubtest262of100,1,323,5308,22,188,5518
subtest27of10,pubtest262of100,1,323,5308,22,228,5558
subtest25of10,pubtest262of100,1,323,5308,23,266,5597
subtest210of10,pubtest262of100,1,323,5308,24,306,5638
subtest24of10,pubtest262of100,1,323,5308,33,337,5678
subtest28of10,pubtest262of100,1,323,5308,33,377,5718
subtest22of10,pubtest263of100,1,322,5271,13,38,5322
subtest29of10,pubtest263of100,1,322,5271,14,76,5361
subtest24of10,pubtest263of100,1,322,5271,17,113,5401
subtest23of10,pubtest263of100,1,322,5271,43,127,5441
subtest26of10,pubtest263of100,1,322,5271,43,167,5481
subtest210of10,pubtest263of100,1,322,5271,45,206,5522
subtest27of10,pubtest263of100,1,322,5271,45,245,5561
subtest21of10,pubtest263of100,1,322,5271,46,284,5601
subtest28of10,pubtest263of100,1,322,5271,47,326,5644
subtest25of10,pubtest263of100,1,322,5271,48,363,5682
subtest22of10,pubtest264of100,1,322,5259,10,40,5309
subtest29of10,pubtest264of100,1,322,5259,10,79,5348
subtest23of10,pubtest264of100,1,322,5259,12,117,5388
subtest27of10,pubtest264of100,1,322,5259,12,156,5427
subtest24of10,pubtest264of100,1,322,5259,13,196,5468
subtest28of10,pubtest264of100,1,322,5259,21,228,5508
subtest21of10,pubtest264of100,1,322,5259,21,268,5548
subtest25of10,pubtest264of100,1,322,5259,24,305,5588
subtest26of10,pubtest264of100,1,322,5259,28,346,5633
subtest210of10,pubtest264of100,1,322,5259,28,385,5672
subtest26of10,pubtest265of100,1,323,5475,19,46,5540
subtest27of10,pubtest265of100,1,323,5475,20,83,5578
subtest210of10,pubtest265of100,1,323,5475,22,122,5619
subtest21of10,pubtest265of100,1,323,5475,27,157,5659
subtest22of10,pubtest265of100,1,323,5475,27,198,5700
subtest28of10,pubtest265of100,1,323,5475,29,235,5739
subtest29of10,pubtest265of100,1,323,5475,29,275,5779
subtest25of10,pubtest265of100,1,323,5475,30,314,5819
subtest24of10,pubtest265of100,1,323,5475,31,352,5858
subtest23of10,pubtest265of100,1,323,5475,33,391,5899
subtest29of10,pubtest266of100,1,321,5353,9,40,5402
subtest210of10,pubtest266of100,1,321,5353,38,51,5442
subtest25of10,pubtest266of100,1,321,5353,41,87,5481
subtest27of10,pubtest266of100,1,321,5353,46,122,5521
subtest26of10,pubtest266of100,1,321,5353,53,153,5559
subtest23of10,pubtest266of100,1,321,5353,55,193,5601
subtest28of10,pubtest266of100,1,321,5353,58,230,5641
subtest24of10,pubtest266of100,1,321,5353,62,266,5681
subtest22of10,pubtest266of100,1,321,5353,63,305,5721
subtest21of10,pubtest266of100,1,321,5353,62,346,5761
subtest23of10,pubtest267of100,1,323,5264,10,40,5314
subtest26of10,pubtest267of100,1,323,5264,17,72,5353
subtest28of10,pubtest267of100,1,323,5264,21,108,5393
subtest25of10,pubtest267of100,1,323,5264,21,148,5433
subtest27of10,pubtest267of100,1,323,5264,23,186,5473
subtest29of10,pubtest267of100,1,323,5264,24,226,5514
subtest24of10,pubtest267of100,1,323,5264,25,264,5553
subtest22of10,pubtest267of100,1,323,5264,37,290,5591
subtest21of10,pubtest267of100,1,323,5264,37,330,5631
subtest210of10,pubtest267of100,1,323,5264,41,368,5673
subtest23of10,pubtest268of100,1,323,5348,11,40,5399
subtest24of10,pubtest268of100,1,323,5348,14,76,5438
subtest25of10,pubtest268of100,1,323,5348,14,116,5478
subtest29of10,pubtest268of100,1,323,5348,18,152,5518
subtest27of10,pubtest268of100,1,323,5348,20,190,5558
subtest28of10,pubtest268of100,1,323,5348,23,227,5598
subtest21of10,pubtest268of100,1,323,5348,25,265,5638
subtest22of10,pubtest268of100,1,323,5348,26,306,5680
subtest210of10,pubtest268of100,1,323,5348,27,344,5719
subtest26of10,pubtest268of100,1,323,5348,31,379,5758
subtest24of10,pubtest269of100,1,323,5444,11,304,5759
subtest27of10,pubtest269of100,1,323,5444,14,341,5799
subtest25of10,pubtest269of100,1,323,5444,26,369,5839
subtest21of10,pubtest269of100,1,323,5444,32,402,5878
subtest210of10,pubtest269of100,1,323,5444,32,442,5918
subtest29of10,pubtest269of100,1,323,5444,34,481,5959
subtest23of10,pubtest269of100,1,323,5444,37,517,5998
subtest26of10,pubtest269of100,1,323,5444,38,557,6039
subtest22of10,pubtest269of100,1,323,5444,59,576,6079
subtest28of10,pubtest269of100,1,323,5444,60,614,6118
subtest23of10,pubtest270of100,1,323,5399,16,39,5454
subtest27of10,pubtest270of100,1,323,5399,19,77,5495
subtest26of10,pubtest270of100,1,323,5399,20,116,5535
subtest29of10,pubtest270of100,1,323,5399,31,145,5575
subtest210of10,pubtest270of100,1,323,5399,58,158,5615
subtest25of10,pubtest270of100,1,323,5399,88,167,5654
subtest28of10,pubtest270of100,1,323,5399,107,188,5694
subtest21of10,pubtest270of100,1,323,5399,131,204,5734
subtest24of10,pubtest270of100,1,323,5399,133,243,5775
subtest22of10,pubtest270of100,1,323,5399,162,252,5813
subtest24of10,pubtest271of100,1,323,5288,14,42,5344
subtest25of10,pubtest271of100,1,323,5288,16,79,5383
subtest22of10,pubtest271of100,1,323,5288,19,115,5422
subtest27of10,pubtest271of100,1,323,5288,23,149,5460
subtest210of10,pubtest271of100,1,323,5288,23,188,5499
subtest23of10,pubtest271of100,1,323,5288,34,220,5542
subtest26of10,pubtest271of100,1,323,5288,35,260,5583
subtest21of10,pubtest271of100,1,323,5288,34,298,5620
subtest28of10,pubtest271of100,1,323,5288,36,338,5662
subtest29of10,pubtest271of100,1,323,5288,36,376,5700
subtest25of10,pubtest272of100,1,323,5288,9,131,5428
subtest26of10,pubtest272of100,1,323,5288,15,164,5467
subtest21of10,pubtest272of100,1,323,5288,15,204,5507
subtest24of10,pubtest272of100,1,323,5288,20,240,5548
subtest29of10,pubtest272of100,1,323,5288,20,280,5588
subtest23of10,pubtest272of100,1,323,5288,21,319,5628
subtest22of10,pubtest272of100,1,323,5288,25,353,5666
subtest28of10,pubtest272of100,1,323,5288,27,393,5708
subtest27of10,pubtest272of100,1,323,5288,25,432,5745
subtest210of10,pubtest272of100,1,323,5288,28,471,5787
subtest29of10,pubtest273of100,1,321,5246,12,39,5297
subtest22of10,pubtest273of100,1,321,5246,11,78,5335
subtest25of10,pubtest273of100,1,321,5246,14,118,5378
subtest26of10,pubtest273of100,1,321,5246,15,156,5417
subtest28of10,pubtest273of100,1,321,5246,19,192,5457
subtest27of10,pubtest273of100,1,321,5246,23,228,5497
subtest210of10,pubtest273of100,1,321,5246,39,252,5537
subtest23of10,pubtest273of100,1,321,5246,40,291,5577
subtest24of10,pubtest273of100,1,321,5246,41,330,5617
subtest21of10,pubtest273of100,1,321,5246,40,370,5656
subtest21of10,pubtest274of100,1,323,5295,21,44,5360
subtest26of10,pubtest274of100,1,323,5295,21,84,5400
subtest29of10,pubtest274of100,1,323,5295,23,122,5440
subtest22of10,pubtest274of100,1,323,5295,23,162,5480
subtest23of10,pubtest274of100,1,323,5295,23,199,5517
subtest27of10,pubtest274of100,1,323,5295,28,238,5561
subtest24of10,pubtest274of100,1,323,5295,27,278,5600
subtest25of10,pubtest274of100,1,323,5295,25,317,5637
subtest28of10,pubtest274of100,1,323,5295,27,358,5680
subtest210of10,pubtest274of100,1,323,5295,42,383,5720
subtest27of10,pubtest275of100,1,323,5326,10,41,5377
subtest29of10,pubtest275of100,1,323,5326,11,80,5417
subtest25of10,pubtest275of100,1,323,5326,12,118,5456
subtest24of10,pubtest275of100,1,323,5326,13,157,5496
subtest21of10,pubtest275of100,1,323,5326,18,193,5537
subtest23of10,pubtest275of100,1,323,5326,25,226,5577
subtest22of10,pubtest275of100,1,323,5326,28,260,5614
subtest210of10,pubtest275of100,1,323,5326,28,300,5654
subtest28of10,pubtest275of100,1,323,5326,34,336,5696
subtest26of10,pubtest275of100,1,323,5326,34,376,5736
subtest28of10,pubtest276of100,1,323,5391,14,39,5444
subtest21of10,pubtest276of100,1,323,5391,15,77,5483
subtest25of10,pubtest276of100,1,323,5391,17,116,5524
subtest27of10,pubtest276of100,1,323,5391,20,152,5563
subtest24of10,pubtest276of100,1,323,5391,31,182,5604
subtest29of10,pubtest276of100,1,323,5391,61,191,5643
subtest23of10,pubtest276of100,1,323,5391,83,209,5683
subtest26of10,pubtest276of100,1,323,5391,83,249,5723
subtest210of10,pubtest276of100,1,323,5391,84,288,5763
subtest22of10,pubtest276of100,1,323,5391,112,300,5803
subtest22of10,pubtest277of100,1,323,5290,16,41,5347
subtest29of10,pubtest277of100,1,323,5290,16,79,5385
subtest28of10,pubtest277of100,1,323,5290,17,119,5426
subtest21of10,pubtest277of100,1,323,5290,18,158,5466
subtest24of10,pubtest277of100,1,323,5290,22,193,5505
subtest27of10,pubtest277of100,1,323,5290,22,233,5545
subtest25of10,pubtest277of100,1,323,5290,35,261,5586
subtest23of10,pubtest277of100,1,323,5290,35,300,5625
subtest210of10,pubtest277of100,1,323,5290,37,341,5668
subtest26of10,pubtest277of100,1,323,5290,47,370,5707
subtest29of10,pubtest278of100,1,323,5397,12,41,5450
subtest22of10,pubtest278of100,1,323,5397,14,78,5489
subtest23of10,pubtest278of100,1,323,5397,15,117,5529
subtest21of10,pubtest278of100,1,323,5397,19,153,5569
subtest28of10,pubtest278of100,1,323,5397,19,193,5609
subtest25of10,pubtest278of100,1,323,5397,21,231,5649
subtest27of10,pubtest278of100,1,323,5397,20,271,5688
subtest26of10,pubtest278of100,1,323,5397,25,307,5729
subtest24of10,pubtest278of100,1,323,5397,25,347,5769
subtest210of10,pubtest278of100,1,323,5397,39,373,5809
subtest28of10,pubtest279of100,1,323,5349,9,43,5401
subtest25of10,pubtest279of100,1,323,5349,19,72,5440
subtest21of10,pubtest279of100,1,323,5349,21,110,5480
subtest24of10,pubtest279of100,1,323,5349,28,142,5519
subtest29of10,pubtest279of100,1,323,5349,30,180,5559
subtest26of10,pubtest279of100,1,323,5349,31,219,5599
subtest27of10,pubtest279of100,1,323,5349,32,258,5639
subtest22of10,pubtest279of100,1,323,5349,39,292,5680
subtest210of10,pubtest279of100,1,323,5349,41,329,5719
subtest23of10,pubtest279of100,1,323,5349,43,367,5759
subtest27of10,pubtest280of100,1,323,5279,8,39,5326
subtest29of10,pubtest280of100,1,323,5279,19,68,5366
subtest24of10,pubtest280of100,1,323,5279,26,100,5405
subtest21of10,pubtest280of100,1,323,5279,27,139,5445
subtest23of10,pubtest280of100,1,323,5279,38,166,5483
subtest25of10,pubtest280of100,1,323,5279,45,201,5525
subtest26of10,pubtest280of100,1,323,5279,55,231,5565
subtest210of10,pubtest280of100,1,323,5279,58,268,5605
subtest28of10,pubtest280of100,1,323,5279,65,302,5646
subtest22of10,pubtest280of100,1,323,5279,74,333,5686
subtest24of10,pubtest281of100,1,323,5316,13,38,5367
subtest23of10,pubtest281of100,1,323,5316,13,76,5405
subtest22of10,pubtest281of100,1,323,5316,15,115,5446
subtest27of10,pubtest281of100,1,323,5316,16,154,5486
subtest25of10,pubtest281of100,1,323,5316,17,193,5526
subtest28of10,pubtest281of100,1,323,5316,17,234,5567
subtest210of10,pubtest281of100,1,323,5316,18,272,5606
subtest21of10,pubtest281of100,1,323,5316,19,309,5644
subtest26of10,pubtest281of100,1,323,5316,22,348,5686
subtest29of10,pubtest281of100,1,323,5316,22,388,5726
subtest24of10,pubtest282of100,1,323,5430,10,41,5481
subtest23of10,pubtest282of100,1,323,5430,10,80,5520
subtest22of10,pubtest282of100,1,323,5430,26,104,5560
subtest25of10,pubtest282of100,1,323,5430,27,143,5600
subtest21of10,pubtest282of100,1,323,5430,26,185,5641
subtest27of10,pubtest282of100,1,323,5430,29,222,5681
subtest29of10,pubtest282of100,1,323,5430,28,261,5719
subtest210of10,pubtest282of100,1,323,5430,31,299,5760
subtest26of10,pubtest282of100,1,323,5430,31,338,5799
subtest28of10,pubtest282of100,1,323,5430,31,378,5839
subtest24of10,pubtest283of100,1,323,5252,8,40,5300
subtest23of10,pubtest283of100,1,323,5252,10,74,5336
subtest27of10,pubtest283of100,1,323,5252,10,114,5376
subtest22of10,pubtest283of100,1,323,5252,21,144,5417
subtest21of10,pubtest283of100,1,323,5252,27,178,5457
subtest29of10,pubtest283of100,1,323,5252,28,217,5497
subtest210of10,pubtest283of100,1,323,5252,29,256,5537
subtest28of10,pubtest283of100,1,323,5252,29,296,5577
subtest25of10,pubtest283of100,1,323,5252,27,335,5614
subtest26of10,pubtest283of100,1,323,5252,31,374,5657
subtest22of10,pubtest284of100,1,323,5370,16,56,5442
subtest25of10,pubtest284of100,1,323,5370,17,94,5481
subtest27of10,pubtest284of100,1,323,5370,21,130,5521
subtest21of10,pubtest284of100,1,323,5370,22,169,5561
subtest24of10,pubtest284of100,1,323,5370,23,208,5601
subtest23of10,pubtest284of100,1,323,5370,24,247,5641
subtest29of10,pubtest284of100,1,323,5370,19,288,5677
subtest28of10,pubtest284of100,1,323,5370,25,318,5713
subtest26of10,pubtest284of100,1,323,5370,25,357,5752
subtest210of10,pubtest284of100,1,323,5370,35,396,5801
subtest23of10,pubtest285of100,1,323,5236,11,39,5286
subtest25of10,pubtest285of100,1,323,5236,15,74,5325
subtest24of10,pubtest285of100,1,323,5236,17,113,5366
subtest27of10,pubtest285of100,1,323,5236,23,147,5406
subtest22of10,pubtest285of100,1,323,5236,24,186,5446
subtest21of10,pubtest285of100,1,323,5236,37,213,5486
subtest28of10,pubtest285of100,1,323,5236,37,253,5526
subtest29of10,pubtest285of100,1,323,5236,43,287,5566
subtest210of10,pubtest285of100,1,323,5236,43,327,5606
subtest26of10,pubtest285of100,1,323,5236,51,359,5646
subtest23of10,pubtest286of100,1,323,5305,8,122,5435
subtest210of10,pubtest286of100,1,323,5305,17,153,5475
subtest25of10,pubtest286of100,1,323,5305,40,170,5515
subtest29of10,pubtest286of100,1,323,5305,41,209,5555
subtest24of10,pubtest286of100,1,323,5305,48,240,5593
subtest21of10,pubtest286of100,1,323,5305,51,280,5636
subtest27of10,pubtest286of100,1,323,5305,53,317,5675
subtest26of10,pubtest286of100,1,323,5305,54,356,5715
subtest22of10,pubtest286of100,1,323,5305,57,394,5756
subtest28of10,pubtest286of100,1,323,5305,59,431,5795
subtest26of10,pubtest287of100,1,323,5242,12,38,5292
subtest29of10,pubtest287of100,1,323,5242,13,77,5332
subtest27of10,pubtest287of100,1,323,5242,20,109,5371
subtest28of10,pubtest287of100,1,323,5242,25,140,5407
subtest25of10,pubtest287of100,1,323,5242,25,180,5447
subtest21of10,pubtest287of100,1,323,5242,26,218,5486
subtest24of10,pubtest287of100,1,323,5242,28,257,5527
subtest22of10,pubtest287of100,1,323,5242,29,297,5568
subtest210of10,pubtest287of100,1,323,5242,27,336,5605
subtest23of10,pubtest287of100,1,323,5242,28,376,5646
subtest29of10,pubtest288of100,1,323,5268,8,39,5315
subtest25of10,pubtest288of100,1,323,5268,21,65,5354
subtest27of10,pubtest288of100,1,323,5268,26,99,5393
subtest22of10,pubtest288of100,1,323,5268,27,138,5433
subtest26of10,pubtest288of100,1,323,5268,26,178,5472
subtest21of10,pubtest288of100,1,323,5268,29,216,5513
subtest210of10,pubtest288of100,1,323,5268,32,253,5553
subtest24of10,pubtest288of100,1,323,5268,33,293,5594
subtest23of10,pubtest288of100,1,323,5268,31,331,5630
subtest28of10,pubtest288of100,1,323,5268,34,371,5673
subtest29of10,pubtest289of100,1,323,5254,15,41,5310
subtest210of10,pubtest289of100,1,323,5254,16,77,5347
subtest23of10,pubtest289of100,1,323,5254,18,116,5388
subtest24of10,pubtest289of100,1,323,5254,20,154,5428
subtest26of10,pubtest289of100,1,323,5254,44,170,5468
subtest25of10,pubtest289of100,1,323,5254,44,210,5508
subtest27of10,pubtest289of100,1,323,5254,46,248,5548
subtest28of10,pubtest289of100,1,323,5254,46,288,5588
subtest21of10,pubtest289of100,1,323,5254,46,328,5628
subtest22of10,pubtest289of100,1,323,5254,47,367,5668
subtest29of10,pubtest290of100,1,323,5350,15,39,5404
subtest22of10,pubtest290of100,1,323,5350,15,76,5441
subtest25of10,pubtest290of100,1,323,5350,17,116,5483
subtest23of10,pubtest290of100,1,323,5350,16,154,5520
subtest26of10,pubtest290of100,1,323,5350,50,162,5562
subtest27of10,pubtest290of100,1,323,5350,51,201,5602
subtest210of10,pubtest290of100,1,323,5350,87,205,5642
subtest21of10,pubtest290of100,1,323,5350,107,225,5682
subtest28of10,pubtest290of100,1,323,5350,108,264,5722
subtest24of10,pubtest290of100,1,323,5350,110,302,5762
subtest27of10,pubtest291of100,1,323,5244,22,42,5308
subtest24of10,pubtest291of100,1,323,5244,22,80,5346
subtest29of10,pubtest291of100,1,323,5244,25,117,5386
subtest28of10,pubtest291of100,1,323,5244,25,157,5426
subtest25of10,pubtest291of100,1,323,5244,24,195,5463
subtest21of10,pubtest291of100,1,323,5244,24,235,5503
subtest23of10,pubtest291of100,1,323,5244,27,274,5545
subtest210of10,pubtest291of100,1,323,5244,61,278,5583
subtest22of10,pubtest291of100,1,323,5244,64,316,5624
subtest26of10,pubtest291of100,1,323,5244,65,356,5665
subtest28of10,pubtest292of100,1,323,5264,13,38,5315
subtest29of10,pubtest292of100,1,323,5264,13,77,5354
subtest21of10,pubtest292of100,1,323,5264,15,116,5395
subtest25of10,pubtest292of100,1,323,5264,23,148,5435
subtest26of10,pubtest292of100,1,323,5264,24,186,5474
subtest27of10,pubtest292of100,1,323,5264,25,225,5514
subtest23of10,pubtest292of100,1,323,5264,25,265,5554
subtest22of10,pubtest292of100,1,323,5264,32,298,5594
subtest24of10,pubtest292of100,1,323,5264,34,336,5634
subtest210of10,pubtest292of100,1,323,5264,35,375,5674
subtest25of10,pubtest293of100,1,323,5305,13,40,5358
subtest24of10,pubtest293of100,1,323,5305,23,70,5398
subtest23of10,pubtest293of100,1,323,5305,27,106,5438
subtest28of10,pubtest293of100,1,323,5305,35,137,5477
subtest27of10,pubtest293of100,1,323,5305,38,173,5516
subtest210of10,pubtest293of100,1,323,5305,43,209,5557
subtest21of10,pubtest293of100,1,323,5305,43,249,5597
subtest26of10,pubtest293of100,1,323,5305,45,289,5639
subtest29of10,pubtest293of100,1,323,5305,54,319,5678
subtest22of10,pubtest293of100,1,323,5305,64,348,5717
subtest21of10,pubtest294of100,1,323,5301,9,41,5351
subtest25of10,pubtest294of100,1,323,5301,12,77,5390
subtest29of10,pubtest294of100,1,323,5301,21,108,5430
subtest27of10,pubtest294of100,1,323,5301,22,147,5470
subtest210of10,pubtest294of100,1,323,5301,40,169,5510
subtest23of10,pubtest294of100,1,323,5301,41,208,5550
subtest26of10,pubtest294of100,1,323,5301,45,244,5590
subtest24of10,pubtest294of100,1,323,5301,45,285,5631
subtest22of10,pubtest294of100,1,323,5301,47,322,5670
subtest28of10,pubtest294of100,1,323,5301,48,361,5710
subtest25of10,pubtest295of100,1,323,5322,8,247,5577
subtest24of10,pubtest295of100,1,323,5322,11,284,5617
subtest23of10,pubtest295of100,1,323,5322,21,313,5656
subtest22of10,pubtest295of100,1,323,5322,52,322,5696
subtest210of10,pubtest295of100,1,323,5322,53,361,5736
subtest27of10,pubtest295of100,1,323,5322,59,395,5776
subtest28of10,pubtest295of100,1,323,5322,91,403,5816
subtest29of10,pubtest295of100,1,323,5322,104,430,5856
subtest21of10,pubtest295of100,1,323,5322,122,452,5896
subtest26of10,pubtest295of100,1,323,5322,125,489,5936
subtest25of10,pubtest296of100,1,322,5267,3,40,5310
subtest27of10,pubtest296of100,1,322,5267,5,78,5350
subtest23of10,pubtest296of100,1,322,5267,8,114,5389
subtest29of10,pubtest296of100,1,322,5267,38,125,5430
subtest21of10,pubtest296of100,1,322,5267,39,163,5469
subtest24of10,pubtest296of100,1,322,5267,42,200,5509
subtest26of10,pubtest296of100,1,322,5267,43,239,5549
subtest210of10,pubtest296of100,1,322,5267,47,276,5590
subtest22of10,pubtest296of100,1,322,5267,48,314,5629
subtest28of10,pubtest296of100,1,322,5267,47,353,5667
subtest25of10,pubtest297of100,1,323,5249,15,40,5304
subtest29of10,pubtest297of100,1,323,5249,17,77,5343
subtest210of10,pubtest297of100,1,323,5249,19,116,5384
subtest23of10,pubtest297of100,1,323,5249,20,155,5424
subtest22of10,pubtest297of100,1,323,5249,33,180,5462
subtest26of10,pubtest297of100,1,323,5249,34,220,5503
subtest28of10,pubtest297of100,1,323,5249,36,259,5544
subtest27of10,pubtest297of100,1,323,5249,35,300,5584
subtest21of10,pubtest297of100,1,323,5249,40,334,5623
subtest24of10,pubtest297of100,1,323,5249,42,372,5663
subtest29of10,pubtest298of100,1,323,5243,14,43,5300
subtest22of10,pubtest298of100,1,323,5243,15,83,5341
subtest25of10,pubtest298of100,1,323,5243,16,121,5380
subtest23of10,pubtest298of100,1,323,5243,17,161,5421
subtest24of10,pubtest298of100,1,323,5243,18,197,5458
subtest27of10,pubtest298of100,1,323,5243,25,232,5500
subtest21of10,pubtest298of100,1,323,5243,25,273,5541
subtest28of10,pubtest298of100,1,323,5243,26,310,5579
subtest210of10,pubtest298of100,1,323,5243,24,350,5617
subtest26of10,pubtest298of100,1,323,5243,26,389,5658
subtest22of10,pubtest299of100,1,323,5281,17,38,5336
subtest29of10,pubtest299of100,1,323,5281,17,77,5375
subtest210of10,pubtest299of100,1,323,5281,19,115,5415
subtest27of10,pubtest299of100,1,323,5281,20,153,5454
subtest23of10,pubtest299of100,1,323,5281,21,193,5495
subtest28of10,pubtest299of100,1,323,5281,22,230,5533
subtest21of10,pubtest299of100,1,323,5281,23,269,5573
subtest25of10,pubtest299of100,1,323,5281,25,309,5615
subtest24of10,pubtest299of100,1,323,5281,25,348,5654
subtest26of10,pubtest299of100,1,323,5281,27,389,5697
subtest21of10,pubtest2100of100,1,325,5243,9,41,5293
subtest23of10,pubtest2100of100,1,325,5243,11,78,5332
subtest24of10,pubtest2100of100,1,325,5243,10,116,5369
subtest28of10,pubtest2100of100,1,325,5243,13,153,5409
subtest210of10,pubtest2100of100,1,325,5243,16,193,5452
subtest27of10,pubtest2100of100,1,325,5243,12,233,5488
subtest22of10,pubtest2100of100,1,325,5243,13,272,5528
subtest29of10,pubtest2100of100,1,325,5243,11,311,5565
subtest25of10,pubtest2100of100,1,325,5243,15,351,5609
subtest26of10,pubtest2100of100,1,325,5243,20,390,5653
subtest27of10,pubtest21of100,1,322,10386,11,40,10437
subtest26of10,pubtest21of100,1,322,10386,13,77,10476
subtest29of10,pubtest21of100,1,322,10386,13,117,10516
subtest25of10,pubtest21of100,1,322,10386,15,155,10556
subtest21of10,pubtest21of100,1,322,10386,18,192,10596
subtest24of10,pubtest21of100,1,322,10386,21,230,10637
subtest23of10,pubtest21of100,1,322,10386,25,265,10676
subtest210of10,pubtest21of100,1,322,10386,34,296,10716
subtest28of10,pubtest21of100,1,322,10386,35,335,10756
subtest22of10,pubtest21of100,1,322,10386,37,373,10796
subtest29of10,pubtest22of100,1,321,5254,6,48,5308
subtest24of10,pubtest22of100,1,321,5254,15,79,5348
subtest27of10,pubtest22of100,1,321,5254,15,118,5387
subtest23of10,pubtest22of100,1,321,5254,19,155,5428
subtest21of10,pubtest22of100,1,321,5254,20,194,5468
subtest28of10,pubtest22of100,1,321,5254,18,234,5506
subtest210of10,pubtest22of100,1,321,5254,22,271,5547
subtest25of10,pubtest22of100,1,321,5254,21,313,5588
subtest26of10,pubtest22of100,1,321,5254,22,349,5625
subtest22of10,pubtest22of100,1,321,5254,23,390,5667
subtest23of10,pubtest23of100,1,321,5305,7,40,5352
subtest28of10,pubtest23of100,1,321,5305,10,76,5391
subtest29of10,pubtest23of100,1,321,5305,10,117,5432
subtest27of10,pubtest23of100,1,321,5305,11,155,5471
subtest25of10,pubtest23of100,1,321,5305,12,193,5510
subtest26of10,pubtest23of100,1,321,5305,15,230,5550
subtest24of10,pubtest23of100,1,321,5305,15,270,5590
subtest21of10,pubtest23of100,1,321,5305,19,306,5630
subtest22of10,pubtest23of100,1,321,5305,19,346,5670
subtest210of10,pubtest23of100,1,321,5305,55,350,5710
subtest24of10,pubtest24of100,1,321,5212,8,39,5259
subtest23of10,pubtest24of100,1,321,5212,8,78,5298
subtest25of10,pubtest24of100,1,321,5212,10,116,5338
subtest21of10,pubtest24of100,1,321,5212,10,156,5378
subtest29of10,pubtest24of100,1,321,5212,13,191,5416
subtest28of10,pubtest24of100,1,321,5212,12,234,5458
subtest27of10,pubtest24of100,1,321,5212,18,268,5498
subtest22of10,pubtest24of100,1,321,5212,18,307,5537
subtest26of10,pubtest24of100,1,321,5212,21,346,5579
subtest210of10,pubtest24of100,1,321,5212,20,386,5618
subtest21of10,pubtest25of100,1,321,5378,14,43,5435
subtest210of10,pubtest25of100,1,321,5378,13,83,5474
subtest26of10,pubtest25of100,1,321,5378,13,123,5514
subtest25of10,pubtest25of100,1,321,5378,15,161,5554
subtest28of10,pubtest25of100,1,321,5378,14,202,5594
subtest23of10,pubtest25of100,1,321,5378,18,238,5634
subtest29of10,pubtest25of100,1,321,5378,20,276,5674
subtest22of10,pubtest25of100,1,321,5378,20,316,5714
subtest27of10,pubtest25of100,1,321,5378,20,355,5753
subtest24of10,pubtest25of100,1,321,5378,20,395,5793
subtest21of10,pubtest26of100,1,321,5358,7,41,5406
subtest22of10,pubtest26of100,1,321,5358,11,76,5445
subtest29of10,pubtest26of100,1,321,5358,13,114,5485
subtest26of10,pubtest26of100,1,321,5358,14,153,5525
subtest23of10,pubtest26of100,1,321,5358,14,194,5566
subtest25of10,pubtest26of100,1,321,5358,17,230,5605
subtest27of10,pubtest26of100,1,321,5358,18,269,5645
subtest210of10,pubtest26of100,1,321,5358,19,308,5685
subtest28of10,pubtest26of100,1,321,5358,20,347,5725
subtest24of10,pubtest26of100,1,321,5358,21,386,5765
subtest27of10,pubtest27of100,1,320,5284,7,41,5332
subtest28of10,pubtest27of100,1,320,5284,10,77,5371
subtest23of10,pubtest27of100,1,320,5284,11,117,5412
subtest24of10,pubtest27of100,1,320,5284,19,148,5451
subtest29of10,pubtest27of100,1,320,5284,19,188,5491
subtest25of10,pubtest27of100,1,320,5284,28,219,5531
subtest21of10,pubtest27of100,1,320,5284,30,257,5571
subtest210of10,pubtest27of100,1,320,5284,30,297,5611
subtest26of10,pubtest27of100,1,320,5284,32,335,5651
subtest22of10,pubtest27of100,1,320,5284,32,375,5691
subtest27of10,pubtest28of100,1,321,5282,24,43,5349
subtest21of10,pubtest28of100,1,321,5282,30,76,5388
subtest28of10,pubtest28of100,1,321,5282,30,116,5428
subtest29of10,pubtest28of100,1,321,5282,38,148,5468
subtest23of10,pubtest28of100,1,321,5282,38,187,5507
subtest210of10,pubtest28of100,1,321,5282,40,226,5548
subtest25of10,pubtest28of100,1,321,5282,40,266,5588
subtest24of10,pubtest28of100,1,321,5282,42,303,5627
subtest22of10,pubtest28of100,1,321,5282,44,342,5668
subtest26of10,pubtest28of100,1,321,5282,42,382,5706
subtest23of10,pubtest29of100,1,321,5315,8,42,5365
subtest210of10,pubtest29of100,1,321,5315,14,74,5403
subtest29of10,pubtest29of100,1,321,5315,15,113,5443
subtest22of10,pubtest29of100,1,321,5315,16,152,5483
subtest25of10,pubtest29of100,1,321,5315,17,191,5523
subtest21of10,pubtest29of100,1,321,5315,16,231,5562
subtest28of10,pubtest29of100,1,321,5315,21,267,5603
subtest26of10,pubtest29of100,1,321,5315,23,305,5643
subtest24of10,pubtest29of100,1,321,5315,23,345,5683
subtest27of10,pubtest29of100,1,321,5315,21,387,5723
subtest29of10,pubtest210of100,1,323,5236,15,38,5289
subtest21of10,pubtest210of100,1,323,5236,16,76,5328
subtest210of10,pubtest210of100,1,323,5236,18,113,5367
subtest27of10,pubtest210of100,1,323,5236,20,152,5408
subtest28of10,pubtest210of100,1,323,5236,20,193,5449
subtest25of10,pubtest210of100,1,323,5236,22,230,5488
subtest24of10,pubtest210of100,1,323,5236,22,270,5528
subtest22of10,pubtest210of100,1,323,5236,24,308,5568
subtest26of10,pubtest210of100,1,323,5236,24,349,5609
subtest23of10,pubtest210of100,1,323,5236,24,387,5647
subtest210of10,pubtest211of100,1,323,5596,9,41,5646
subtest24of10,pubtest211of100,1,323,5596,13,75,5684
subtest29of10,pubtest211of100,1,323,5596,14,114,5724
subtest21of10,pubtest211of100,1,323,5596,30,138,5764
subtest22of10,pubtest211of100,1,323,5596,31,178,5805
subtest25of10,pubtest211of100,1,323,5596,32,217,5845
subtest23of10,pubtest211of100,1,323,5596,34,254,5884
subtest27of10,pubtest211of100,1,323,5596,36,292,5924
subtest26of10,pubtest211of100,1,323,5596,43,325,5964
subtest28of10,pubtest211of100,1,323,5596,44,364,6004
subtest25of10,pubtest212of100,1,323,5218,9,41,5268
subtest29of10,pubtest212of100,1,323,5218,17,73,5308
subtest28of10,pubtest212of100,1,323,5218,19,111,5348
subtest23of10,pubtest212of100,1,323,5218,27,143,5388
subtest27of10,pubtest212of100,1,323,5218,52,157,5427
subtest21of10,pubtest212of100,1,323,5218,63,186,5467
subtest24of10,pubtest212of100,1,323,5218,65,224,5507
subtest22of10,pubtest212of100,1,323,5218,90,239,5547
subtest210of10,pubtest212of100,1,323,5218,106,264,5588
subtest26of10,pubtest212of100,1,323,5218,106,304,5628
subtest23of10,pubtest213of100,1,322,5271,15,45,5331
subtest29of10,pubtest213of100,1,322,5271,17,83,5371
subtest26of10,pubtest213of100,1,322,5271,16,122,5409
subtest27of10,pubtest213of100,1,322,5271,18,159,5448
subtest24of10,pubtest213of100,1,322,5271,19,196,5486
subtest28of10,pubtest213of100,1,322,5271,24,236,5531
subtest22of10,pubtest213of100,1,322,5271,23,275,5569
subtest210of10,pubtest213of100,1,322,5271,23,314,5608
subtest25of10,pubtest213of100,1,322,5271,19,354,5644
subtest21of10,pubtest213of100,1,322,5271,18,392,5681
subtest21of10,pubtest214of100,1,323,5464,8,41,5513
subtest23of10,pubtest214of100,1,323,5464,22,67,5553
subtest25of10,pubtest214of100,1,323,5464,33,95,5592
subtest26of10,pubtest214of100,1,323,5464,34,134,5632
subtest27of10,pubtest214of100,1,323,5464,36,172,5672
subtest29of10,pubtest214of100,1,323,5464,37,211,5712
subtest22of10,pubtest214of100,1,323,5464,38,253,5755
subtest210of10,pubtest214of100,1,323,5464,47,281,5792
subtest24of10,pubtest214of100,1,323,5464,52,316,5832
subtest28of10,pubtest214of100,1,323,5464,53,355,5872
subtest27of10,pubtest215of100,1,323,5270,14,44,5328
subtest24of10,pubtest215of100,1,323,5270,14,82,5366
subtest29of10,pubtest215of100,1,323,5270,31,104,5405
subtest21of10,pubtest215of100,1,323,5270,32,143,5445
subtest26of10,pubtest215of100,1,323,5270,36,179,5485
subtest210of10,pubtest215of100,1,323,5270,39,216,5525
subtest25of10,pubtest215of100,1,323,5270,50,245,5565
subtest22of10,pubtest215of100,1,323,5270,55,278,5603
subtest23of10,pubtest215of100,1,323,5270,61,314,5645
subtest28of10,pubtest215of100,1,323,5270,69,346,5685
subtest24of10,pubtest216of100,1,323,5401,15,148,5564
subtest21of10,pubtest216of100,1,323,5401,19,187,5607
subtest27of10,pubtest216of100,1,323,5401,21,221,5643
subtest28of10,pubtest216of100,1,323,5401,22,258,5681
subtest23of10,pubtest216of100,1,323,5401,20,299,5720
subtest25of10,pubtest216of100,1,323,5401,26,336,5763
subtest22of10,pubtest216of100,1,323,5401,23,376,5800
subtest29of10,pubtest216of100,1,323,5401,28,413,5842
subtest26of10,pubtest216of100,1,323,5401,29,453,5883
subtest210of10,pubtest216of100,1,323,5401,30,492,5923
subtest27of10,pubtest217of100,1,322,5332,12,40,5384
subtest21of10,pubtest217of100,1,322,5332,32,58,5422
subtest22of10,pubtest217of100,1,322,5332,45,86,5463
subtest23of10,pubtest217of100,1,322,5332,60,112,5504
subtest29of10,pubtest217of100,1,322,5332,82,128,5542
subtest26of10,pubtest217of100,1,322,5332,89,161,5582
subtest25of10,pubtest217of100,1,322,5332,113,177,5622
subtest24of10,pubtest217of100,1,322,5332,138,192,5662
subtest28of10,pubtest217of100,1,322,5332,171,199,5702
subtest210of10,pubtest217of100,1,322,5332,172,238,5742
subtest22of10,pubtest218of100,1,323,5384,16,40,5440
subtest29of10,pubtest218of100,1,323,5384,16,77,5477
subtest24of10,pubtest218of100,1,323,5384,20,115,5519
subtest23of10,pubtest218of100,1,323,5384,19,154,5557
subtest210of10,pubtest218of100,1,323,5384,21,194,5599
subtest25of10,pubtest218of100,1,323,5384,20,233,5637
subtest28of10,pubtest218of100,1,323,5384,19,273,5676
subtest27of10,pubtest218of100,1,323,5384,18,313,5715
subtest21of10,pubtest218of100,1,323,5384,18,352,5754
subtest26of10,pubtest218of100,1,323,5384,21,392,5797
subtest210of10,pubtest219of100,1,323,5247,9,40,5296
subtest25of10,pubtest219of100,1,323,5247,9,78,5334
subtest26of10,pubtest219of100,1,323,5247,13,114,5374
subtest21of10,pubtest219of100,1,323,5247,25,142,5414
subtest29of10,pubtest219of100,1,323,5247,28,179,5454
subtest22of10,pubtest219of100,1,323,5247,28,220,5495
subtest24of10,pubtest219of100,1,323,5247,30,255,5532
subtest28of10,pubtest219of100,1,323,5247,32,295,5574
subtest23of10,pubtest219of100,1,323,5247,34,333,5614
subtest27of10,pubtest219of100,1,323,5247,33,373,5653
subtest25of10,pubtest220of100,1,323,5511,10,46,5567
subtest23of10,pubtest220of100,1,323,5511,12,83,5606
subtest29of10,pubtest220of100,1,323,5511,14,120,5645
subtest27of10,pubtest220of100,1,323,5511,15,159,5685
subtest210of10,pubtest220of100,1,323,5511,17,198,5726
subtest24of10,pubtest220of100,1,323,5511,18,236,5765
subtest21of10,pubtest220of100,1,323,5511,19,276,5806
subtest28of10,pubtest220of100,1,323,5511,33,302,5846
subtest26of10,pubtest220of100,1,323,5511,42,333,5886
subtest22of10,pubtest220of100,1,323,5511,43,373,5927
subtest21of10,pubtest221of100,1,323,5321,11,48,5380
subtest24of10,pubtest221of100,1,323,5321,11,87,5419
subtest28of10,pubtest221of100,1,323,5321,18,120,5459
subtest22of10,pubtest221of100,1,323,5321,19,158,5498
subtest23of10,pubtest221of100,1,323,5321,20,198,5539
subtest25of10,pubtest221of100,1,323,5321,19,237,5577
subtest29of10,pubtest221of100,1,323,5321,21,276,5618
subtest27of10,pubtest221of100,1,323,5321,28,310,5659
subtest210of10,pubtest221of100,1,323,5321,29,349,5699
subtest26of10,pubtest221of100,1,323,5321,37,381,5739
subtest22of10,pubtest222of100,1,323,5324,11,41,5376
subtest21of10,pubtest222of100,1,323,5324,10,81,5415
subtest29of10,pubtest222of100,1,323,5324,20,111,5455
subtest27of10,pubtest222of100,1,323,5324,25,146,5495
subtest28of10,pubtest222of100,1,323,5324,25,186,5535
subtest23of10,pubtest222of100,1,323,5324,32,220,5576
subtest25of10,pubtest222of100,1,323,5324,33,256,5613
subtest24of10,pubtest222of100,1,323,5324,36,295,5655
subtest26of10,pubtest222of100,1,323,5324,36,335,5695
subtest210of10,pubtest222of100,1,323,5324,33,375,5732
subtest21of10,pubtest223of100,1,323,5241,10,282,5533
subtest23of10,pubtest223of100,1,323,5241,12,320,5573
subtest24of10,pubtest223of100,1,323,5241,14,356,5611
subtest28of10,pubtest223of100,1,323,5241,14,396,5651
subtest29of10,pubtest223of100,1,323,5241,30,422,5693
subtest27of10,pubtest223of100,1,323,5241,30,462,5733
subtest210of10,pubtest223of100,1,323,5241,32,500,5773
subtest22of10,pubtest223of100,1,323,5241,39,533,5813
subtest26of10,pubtest223of100,1,323,5241,39,573,5853
subtest25of10,pubtest223of100,1,323,5241,38,612,5891
subtest21of10,pubtest224of100,1,323,5290,9,40,5339
subtest28of10,pubtest224of100,1,323,5290,14,76,5380
subtest27of10,pubtest224of100,1,323,5290,16,115,5421
subtest23of10,pubtest224of100,1,323,5290,16,153,5459
subtest26of10,pubtest224of100,1,323,5290,18,192,5500
subtest22of10,pubtest224of100,1,323,5290,18,232,5540
subtest29of10,pubtest224of100,1,323,5290,19,271,5580
subtest25of10,pubtest224of100,1,323,5290,20,312,5622
subtest210of10,pubtest224of100,1,323,5290,25,346,5661
subtest24of10,pubtest224of100,1,323,5290,24,385,5699
subtest22of10,pubtest225of100,1,323,5299,27,41,5367
subtest27of10,pubtest225of100,1,323,5299,28,80,5407
subtest21of10,pubtest225of100,1,323,5299,31,117,5447
subtest24of10,pubtest225of100,1,323,5299,33,155,5487
subtest26of10,pubtest225of100,1,323,5299,32,194,5525
subtest25of10,pubtest225of100,1,323,5299,36,233,5568
subtest28of10,pubtest225of100,1,323,5299,38,270,5607
subtest29of10,pubtest225of100,1,323,5299,41,307,5647
subtest210of10,pubtest225of100,1,323,5299,43,345,5687
subtest23of10,pubtest225of100,1,323,5299,42,384,5725
subtest25of10,pubtest226of100,1,323,5273,10,42,5325
subtest22of10,pubtest226of100,1,323,5273,11,81,5365
subtest23of10,pubtest226of100,1,323,5273,12,120,5405
subtest27of10,pubtest226of100,1,323,5273,16,155,5444
subtest210of10,pubtest226of100,1,323,5273,22,189,5484
subtest21of10,pubtest226of100,1,323,5273,23,226,5522
subtest28of10,pubtest226of100,1,323,5273,25,266,5564
subtest29of10,pubtest226of100,1,323,5273,27,305,5605
subtest26of10,pubtest226of100,1,323,5273,27,344,5644
subtest24of10,pubtest226of100,1,323,5273,29,382,5684
subtest29of10,pubtest227of100,1,323,5333,9,38,5380
subtest210of10,pubtest227of100,1,323,5333,10,78,5421
subtest24of10,pubtest227of100,1,323,5333,15,113,5461
subtest23of10,pubtest227of100,1,323,5333,15,153,5501
subtest27of10,pubtest227of100,1,323,5333,16,193,5542
subtest25of10,pubtest227of100,1,323,5333,14,232,5579
subtest21of10,pubtest227of100,1,323,5333,18,271,5622
subtest26of10,pubtest227of100,1,323,5333,20,308,5661
subtest22of10,pubtest227of100,1,323,5333,24,344,5701
subtest28of10,pubtest227of100,1,323,5333,27,381,5741
subtest21of10,pubtest228of100,1,323,5310,13,41,5364
subtest25of10,pubtest228of100,1,323,5310,16,78,5404
subtest26of10,pubtest228of100,1,323,5310,17,116,5443
subtest27of10,pubtest228of100,1,323,5310,18,155,5483
subtest23of10,pubtest228of100,1,323,5310,19,194,5523
subtest24of10,pubtest228of100,1,323,5310,20,233,5563
subtest29of10,pubtest228of100,1,323,5310,20,273,5603
subtest210of10,pubtest228of100,1,323,5310,22,311,5643
subtest28of10,pubtest228of100,1,323,5310,62,311,5683
subtest22of10,pubtest228of100,1,323,5310,62,351,5723
subtest24of10,pubtest229of100,1,321,5236,10,39,5285
subtest21of10,pubtest229of100,1,321,5236,13,74,5323
subtest28of10,pubtest229of100,1,321,5236,17,111,5364
subtest27of10,pubtest229of100,1,321,5236,17,150,5403
subtest22of10,pubtest229of100,1,321,5236,19,188,5443
subtest23of10,pubtest229of100,1,321,5236,20,226,5482
subtest25of10,pubtest229of100,1,321,5236,23,264,5523
subtest210of10,pubtest229of100,1,321,5236,27,300,5563
subtest29of10,pubtest229of100,1,321,5236,27,340,5603
subtest26of10,pubtest229of100,1,321,5236,29,378,5643
subtest22of10,pubtest230of100,1,323,5492,11,235,5738
subtest21of10,pubtest230of100,1,323,5492,12,273,5777
subtest27of10,pubtest230of100,1,323,5492,13,310,5815
subtest28of10,pubtest230of100,1,323,5492,15,349,5856
subtest29of10,pubtest230of100,1,323,5492,16,389,5897
subtest210of10,pubtest230of100,1,323,5492,18,427,5937
subtest23of10,pubtest230of100,1,323,5492,18,467,5977
subtest24of10,pubtest230of100,1,323,5492,20,505,6017
subtest26of10,pubtest230of100,1,323,5492,20,547,6059
subtest25of10,pubtest230of100,1,323,5492,17,585,6094
subtest23of10,pubtest231of100,1,323,5357,12,39,5408
subtest25of10,pubtest231of100,1,323,5357,13,77,5447
subtest28of10,pubtest231of100,1,323,5357,14,468,5839
subtest24of10,pubtest231of100,1,323,5357,15,504,5876
subtest29of10,pubtest231of100,1,323,5357,21,537,5915
subtest210of10,pubtest231of100,1,323,5357,21,577,5955
subtest27of10,pubtest231of100,1,323,5357,25,613,5995
subtest21of10,pubtest231of100,1,323,5357,25,652,6034
subtest26of10,pubtest231of100,1,323,5357,26,693,6076
subtest22of10,pubtest231of100,1,323,5357,27,731,6115
subtest21of10,pubtest232of100,1,323,5297,8,40,5345
subtest27of10,pubtest232of100,1,323,5297,10,77,5384
subtest23of10,pubtest232of100,1,323,5297,17,109,5423
subtest22of10,pubtest232of100,1,323,5297,18,149,5464
subtest29of10,pubtest232of100,1,323,5297,19,188,5504
subtest28of10,pubtest232of100,1,323,5297,30,215,5542
subtest210of10,pubtest232of100,1,323,5297,31,254,5582
subtest25of10,pubtest232of100,1,323,5297,30,294,5621
subtest24of10,pubtest232of100,1,323,5297,34,333,5664
subtest26of10,pubtest232of100,1,323,5297,34,373,5704
subtest29of10,pubtest233of100,1,323,5462,10,41,5513
subtest25of10,pubtest233of100,1,323,5462,15,76,5553
subtest24of10,pubtest233of100,1,323,5462,16,113,5591
subtest210of10,pubtest233of100,1,323,5462,19,152,5633
subtest23of10,pubtest233of100,1,323,5462,20,190,5672
subtest21of10,pubtest233of100,1,323,5462,21,230,5713
subtest27of10,pubtest233of100,1,323,5462,17,269,5748
subtest26of10,pubtest233of100,1,323,5462,20,310,5792
subtest22of10,pubtest233of100,1,323,5462,27,344,5833
subtest28of10,pubtest233of100,1,323,5462,28,383,5873
subtest25of10,pubtest234of100,1,323,5382,16,44,5442
subtest26of10,pubtest234of100,1,323,5382,16,82,5480
subtest27of10,pubtest234of100,1,323,5382,18,120,5520
subtest22of10,pubtest234of100,1,323,5382,18,160,5560
subtest21of10,pubtest234of100,1,323,5382,20,198,5600
subtest29of10,pubtest234of100,1,323,5382,20,237,5639
subtest210of10,pubtest234of100,1,323,5382,23,275,5680
subtest23of10,pubtest234of100,1,323,5382,25,313,5720
subtest24of10,pubtest234of100,1,323,5382,26,350,5758
subtest28of10,pubtest234of100,1,323,5382,27,389,5798
subtest21of10,pubtest235of100,1,321,5278,10,39,5327
subtest210of10,pubtest235of100,1,321,5278,12,76,5366
subtest23of10,pubtest235of100,1,321,5278,14,114,5406
subtest22of10,pubtest235of100,1,321,5278,16,152,5446
subtest29of10,pubtest235of100,1,321,5278,17,192,5487
subtest27of10,pubtest235of100,1,321,5278,17,231,5526
subtest25of10,pubtest235of100,1,321,5278,22,267,5567
subtest26of10,pubtest235of100,1,321,5278,23,305,5606
subtest24of10,pubtest235of100,1,321,5278,22,344,5644
subtest28of10,pubtest235of100,1,321,5278,25,383,5686
subtest23of10,pubtest236of100,1,323,5464,10,38,5512
subtest210of10,pubtest236of100,1,323,5464,11,73,5548
subtest29of10,pubtest236of100,1,323,5464,16,111,5591
subtest25of10,pubtest236of100,1,323,5464,15,150,5629
subtest28of10,pubtest236of100,1,323,5464,15,190,5669
subtest21of10,pubtest236of100,1,323,5464,15,230,5709
subtest27of10,pubtest236of100,1,323,5464,12,268,5744
subtest24of10,pubtest236of100,1,323,5464,19,308,5791
subtest26of10,pubtest236of100,1,323,5464,21,346,5831
subtest22of10,pubtest236of100,1,323,5464,48,358,5870
subtest24of10,pubtest237of100,1,323,5399,10,40,5449
subtest23of10,pubtest237of100,1,323,5399,13,76,5488
subtest28of10,pubtest237of100,1,323,5399,19,110,5528
subtest26of10,pubtest237of100,1,323,5399,21,148,5568
subtest27of10,pubtest237of100,1,323,5399,22,188,5609
subtest25of10,pubtest237of100,1,323,5399,21,226,5646
subtest21of10,pubtest237of100,1,323,5399,24,265,5688
subtest22of10,pubtest237of100,1,323,5399,27,301,5727
subtest29of10,pubtest237of100,1,323,5399,33,336,5768
subtest210of10,pubtest237of100,1,323,5399,33,376,5808
subtest29of10,pubtest238of100,1,323,5378,11,46,5435
subtest27of10,pubtest238of100,1,323,5378,13,84,5475
subtest28of10,pubtest238of100,1,323,5378,15,122,5515
subtest22of10,pubtest238of100,1,323,5378,12,165,5555
subtest25of10,pubtest238of100,1,323,5378,20,197,5595
subtest23of10,pubtest238of100,1,323,5378,19,237,5634
subtest210of10,pubtest238of100,1,323,5378,20,276,5674
subtest21of10,pubtest238of100,1,323,5378,22,315,5715
subtest26of10,pubtest238of100,1,323,5378,23,354,5755
subtest24of10,pubtest238of100,1,323,5378,25,392,5795
subtest21of10,pubtest239of100,1,323,5235,8,295,5538
subtest28of10,pubtest239of100,1,323,5235,9,333,5577
subtest27of10,pubtest239of100,1,323,5235,10,372,5617
subtest26of10,pubtest239of100,1,323,5235,17,405,5657
subtest25of10,pubtest239of100,1,323,5235,20,442,5697
subtest24of10,pubtest239of100,1,323,5235,20,481,5736
subtest23of10,pubtest239of100,1,323,5235,21,521,5777
subtest29of10,pubtest239of100,1,323,5235,21,560,5816
subtest22of10,pubtest239of100,1,323,5235,23,599,5857
subtest210of10,pubtest239of100,1,323,5235,26,636,5897
subtest25of10,pubtest240of100,1,323,5301,8,41,5350
subtest21of10,pubtest240of100,1,323,5301,14,74,5389
subtest210of10,pubtest240of100,1,323,5301,35,93,5429
subtest29of10,pubtest240of100,1,323,5301,36,132,5469
subtest27of10,pubtest240of100,1,323,5301,36,171,5508
subtest23of10,pubtest240of100,1,323,5301,39,209,5549
subtest28of10,pubtest240of100,1,323,5301,42,246,5589
subtest24of10,pubtest240of100,1,323,5301,42,286,5629
subtest22of10,pubtest240of100,1,323,5301,43,325,5669
subtest26of10,pubtest240of100,1,323,5301,47,361,5709
subtest23of10,pubtest241of100,1,323,5564,9,39,5612
subtest24of10,pubtest241of100,1,323,5564,9,78,5651
subtest27of10,pubtest241of100,1,323,5564,15,115,5694
subtest210of10,pubtest241of100,1,323,5564,17,152,5733
subtest28of10,pubtest241of100,1,323,5564,20,188,5772
subtest29of10,pubtest241of100,1,323,5564,20,228,5812
subtest21of10,pubtest241of100,1,323,5564,20,267,5851
subtest22of10,pubtest241of100,1,323,5564,24,304,5892
subtest25of10,pubtest241of100,1,323,5564,24,343,5931
subtest26of10,pubtest241of100,1,323,5564,24,383,5971
subtest27of10,pubtest242of100,1,323,5405,8,42,5455
subtest26of10,pubtest242of100,1,323,5405,17,71,5493
subtest23of10,pubtest242of100,1,323,5405,16,111,5532
subtest25of10,pubtest242of100,1,323,5405,17,150,5572
subtest210of10,pubtest242of100,1,323,5405,18,190,5613
subtest29of10,pubtest242of100,1,323,5405,22,226,5653
subtest21of10,pubtest242of100,1,323,5405,24,262,5691
subtest22of10,pubtest242of100,1,323,5405,30,298,5733
subtest24of10,pubtest242of100,1,323,5405,30,338,5773
subtest28of10,pubtest242of100,1,323,5405,31,377,5813
subtest28of10,pubtest243of100,1,323,5298,8,40,5346
subtest23of10,pubtest243of100,1,323,5298,11,78,5387
subtest22of10,pubtest243of100,1,323,5298,12,118,5428
subtest29of10,pubtest243of100,1,323,5298,9,159,5466
subtest26of10,pubtest243of100,1,323,5298,17,191,5506
subtest25of10,pubtest243of100,1,323,5298,17,233,5548
subtest27of10,pubtest243of100,1,323,5298,23,267,5588
subtest24of10,pubtest243of100,1,323,5298,26,303,5627
subtest21of10,pubtest243of100,1,323,5298,26,343,5667
subtest210of10,pubtest243of100,1,323,5298,27,382,5707
subtest27of10,pubtest244of100,1,323,5245,9,41,5295
subtest26of10,pubtest244of100,1,323,5245,11,78,5334
subtest25of10,pubtest244of100,1,323,5245,12,117,5374
subtest29of10,pubtest244of100,1,323,5245,13,156,5414
subtest21of10,pubtest244of100,1,323,5245,19,190,5454
subtest28of10,pubtest244of100,1,323,5245,24,223,5492
subtest23of10,pubtest244of100,1,323,5245,27,448,5720
subtest22of10,pubtest244of100,1,323,5245,27,486,5758
subtest210of10,pubtest244of100,1,323,5245,24,525,5794
subtest24of10,pubtest244of100,1,323,5245,29,564,5838
subtest29of10,pubtest245of100,1,322,5616,10,39,5665
subtest26of10,pubtest245of100,1,322,5616,10,76,5702
subtest22of10,pubtest245of100,1,322,5616,13,115,5744
subtest23of10,pubtest245of100,1,322,5616,14,155,5785
subtest24of10,pubtest245of100,1,322,5616,15,193,5824
subtest25of10,pubtest245of100,1,322,5616,19,229,5864
subtest28of10,pubtest245of100,1,322,5616,27,261,5904
subtest21of10,pubtest245of100,1,322,5616,27,301,5944
subtest27of10,pubtest245of100,1,322,5616,36,332,5984
subtest210of10,pubtest245of100,1,322,5616,36,372,6024
subtest27of10,pubtest246of100,1,323,6322,9,38,6369
subtest26of10,pubtest246of100,1,323,6322,11,75,6408
subtest21of10,pubtest246of100,1,323,6322,11,115,6448
subtest25of10,pubtest246of100,1,323,6322,13,153,6488
subtest29of10,pubtest246of100,1,323,6322,13,193,6528
subtest23of10,pubtest246of100,1,323,6322,14,232,6568
subtest28of10,pubtest246of100,1,323,6322,19,265,6606
subtest24of10,pubtest246of100,1,323,6322,22,304,6648
subtest210of10,pubtest246of100,1,323,6322,23,343,6688
subtest22of10,pubtest246of100,1,323,6322,23,383,6728
subtest27of10,pubtest247of100,1,323,8045,9,40,8094
subtest23of10,pubtest247of100,1,323,8045,10,78,8133
subtest26of10,pubtest247of100,1,323,8045,13,116,8174
subtest21of10,pubtest247of100,1,323,8045,13,155,8213
subtest22of10,pubtest247of100,1,323,8045,15,193,8253
subtest29of10,pubtest247of100,1,323,8045,21,227,8293
subtest28of10,pubtest247of100,1,323,8045,22,266,8333
subtest210of10,pubtest247of100,1,323,8045,27,301,8373
subtest25of10,pubtest247of100,1,323,8045,27,341,8413
subtest24of10,pubtest247of100,1,323,8045,28,380,8453
subtest29of10,pubtest248of100,1,323,6675,7,41,6723
subtest25of10,pubtest248of100,1,323,6675,12,74,6761
subtest26of10,pubtest248of100,1,323,6675,15,110,6800
subtest23of10,pubtest248of100,1,323,6675,16,149,6840
subtest27of10,pubtest248of100,1,323,6675,20,185,6880
subtest21of10,pubtest248of100,1,323,6675,20,225,6920
subtest28of10,pubtest248of100,1,323,6675,22,262,6959
subtest24of10,pubtest248of100,1,323,6675,46,279,7000
subtest22of10,pubtest248of100,1,323,6675,46,319,7040
subtest210of10,pubtest248of100,1,323,6675,48,357,7080
subtest27of10,pubtest249of100,1,323,5356,9,41,5406
subtest28of10,pubtest249of100,1,323,5356,15,73,5444
subtest25of10,pubtest249of100,1,323,5356,15,112,5483
subtest24of10,pubtest249of100,1,323,5356,18,151,5525
subtest26of10,pubtest249of100,1,323,5356,18,193,5567
subtest21of10,pubtest249of100,1,323,5356,21,229,5606
subtest29of10,pubtest249of100,1,323,5356,21,269,5646
subtest22of10,pubtest249of100,1,323,5356,23,306,5685
subtest23of10,pubtest249of100,1,323,5356,23,345,5724
subtest210of10,pubtest249of100,1,323,5356,23,385,5764
subtest28of10,pubtest250of100,1,323,5472,8,43,5523
subtest27of10,pubtest250of100,1,323,5472,8,82,5562
subtest23of10,pubtest250of100,1,323,5472,11,120,5603
subtest29of10,pubtest250of100,1,323,5472,13,158,5643
subtest21of10,pubtest250of100,1,323,5472,13,198,5683
subtest25of10,pubtest250of100,1,323,5472,17,233,5722
subtest24of10,pubtest250of100,1,323,5472,17,273,5762
subtest210of10,pubtest250of100,1,323,5472,24,307,5803
subtest26of10,pubtest250of100,1,323,5472,28,343,5843
subtest22of10,pubtest250of100,1,323,5472,31,380,5883
subtest22of10,pubtest251of100,1,323,5347,10,41,5398
subtest23of10,pubtest251of100,1,323,5347,10,80,5437
subtest27of10,pubtest251of100,1,323,5347,17,111,5475
subtest24of10,pubtest251of100,1,323,5347,17,151,5515
subtest21of10,pubtest251of100,1,323,5347,23,187,5557
subtest29of10,pubtest251of100,1,323,5347,23,228,5598
subtest25of10,pubtest251of100,1,323,5347,23,267,5637
subtest28of10,pubtest251of100,1,323,5347,25,305,5677
subtest210of10,pubtest251of100,1,323,5347,25,345,5717
subtest26of10,pubtest251of100,1,323,5347,27,383,5757
subtest29of10,pubtest252of100,1,323,5308,13,42,5363
subtest28of10,pubtest252of100,1,323,5308,14,79,5401
subtest21of10,pubtest252of100,1,323,5308,15,118,5441
subtest27of10,pubtest252of100,1,323,5308,16,157,5481
subtest25of10,pubtest252of100,1,323,5308,17,196,5521
subtest26of10,pubtest252of100,1,323,5308,17,234,5559
subtest23of10,pubtest252of100,1,323,5308,19,274,5601
subtest22of10,pubtest252of100,1,323,5308,20,311,5639
subtest24of10,pubtest252of100,1,323,5308,22,350,5680
subtest210of10,pubtest252of100,1,323,5308,25,388,5721
subtest28of10,pubtest253of100,1,322,5414,8,38,5460
subtest23of10,pubtest253of100,1,322,5414,18,67,5499
subtest24of10,pubtest253of100,1,322,5414,19,106,5539
subtest25of10,pubtest253of100,1,322,5414,21,144,5579
subtest29of10,pubtest253of100,1,322,5414,23,182,5619
subtest22of10,pubtest253of100,1,322,5414,23,222,5659
subtest210of10,pubtest253of100,1,322,5414,25,260,5699
subtest26of10,pubtest253of100,1,322,5414,25,300,5739
subtest27of10,pubtest253of100,1,322,5414,26,339,5779
subtest21of10,pubtest253of100,1,322,5414,25,378,5817
subtest210of10,pubtest254of100,1,323,5288,9,232,5529
subtest27of10,pubtest254of100,1,323,5288,10,271,5569
subtest28of10,pubtest254of100,1,323,5288,12,309,5609
subtest25of10,pubtest254of100,1,323,5288,17,345,5650
subtest23of10,pubtest254of100,1,323,5288,18,383,5689
subtest21of10,pubtest254of100,1,323,5288,17,423,5728
subtest24of10,pubtest254of100,1,323,5288,19,462,5769
subtest22of10,pubtest254of100,1,323,5288,21,498,5807
subtest26of10,pubtest254of100,1,323,5288,23,538,5849
subtest29of10,pubtest254of100,1,323,5288,24,577,5889
subtest23of10,pubtest255of100,1,322,5348,11,41,5400
subtest22of10,pubtest255of100,1,322,5348,11,81,5440
subtest27of10,pubtest255of100,1,322,5348,13,118,5479
subtest24of10,pubtest255of100,1,322,5348,16,154,5518
subtest29of10,pubtest255of100,1,322,5348,16,195,5559
subtest28of10,pubtest255of100,1,322,5348,18,232,5598
subtest21of10,pubtest255of100,1,322,5348,18,272,5638
subtest25of10,pubtest255of100,1,322,5348,22,310,5680
subtest210of10,pubtest255of100,1,322,5348,28,343,5719
subtest26of10,pubtest255of100,1,322,5348,33,380,5761
subtest29of10,pubtest256of100,1,323,5317,14,41,5372
subtest26of10,pubtest256of100,1,323,5317,14,81,5412
subtest21of10,pubtest256of100,1,323,5317,16,118,5451
subtest25of10,pubtest256of100,1,323,5317,20,155,5492
subtest210of10,pubtest256of100,1,323,5317,20,194,5531
subtest27of10,pubtest256of100,1,323,5317,22,233,5572
subtest23of10,pubtest256of100,1,323,5317,20,273,5610
subtest28of10,pubtest256of100,1,323,5317,27,305,5649
subtest24of10,pubtest256of100,1,323,5317,29,345,5691
subtest22of10,pubtest256of100,1,323,5317,27,384,5728
subtest27of10,pubtest257of100,1,323,5319,14,41,5374
subtest24of10,pubtest257of100,1,323,5319,12,81,5412
subtest21of10,pubtest257of100,1,323,5319,13,117,5449
subtest22of10,pubtest257of100,1,323,5319,19,156,5494
subtest26of10,pubtest257of100,1,323,5319,18,196,5533
subtest25of10,pubtest257of100,1,323,5319,17,234,5570
subtest29of10,pubtest257of100,1,323,5319,17,275,5611
subtest23of10,pubtest257of100,1,323,5319,21,313,5653
subtest28of10,pubtest257of100,1,323,5319,18,352,5689
subtest210of10,pubtest257of100,1,323,5319,22,392,5733
subtest28of10,pubtest258of100,1,323,5475,10,241,5726
subtest23of10,pubtest258of100,1,323,5475,12,278,5765
subtest25of10,pubtest258of100,1,323,5475,13,317,5805
subtest26of10,pubtest258of100,1,323,5475,14,356,5845
subtest21of10,pubtest258of100,1,323,5475,15,395,5885
subtest210of10,pubtest258of100,1,323,5475,16,434,5925
subtest29of10,pubtest258of100,1,323,5475,20,470,5965
subtest22of10,pubtest258of100,1,323,5475,23,507,6005
subtest27of10,pubtest258of100,1,323,5475,28,542,6045
subtest24of10,pubtest258of100,1,323,5475,41,569,6085
subtest28of10,pubtest259of100,1,323,5411,11,41,5463
subtest21of10,pubtest259of100,1,323,5411,11,81,5503
subtest24of10,pubtest259of100,1,323,5411,18,112,5541
subtest25of10,pubtest259of100,1,323,5411,20,152,5583
subtest27of10,pubtest259of100,1,323,5411,23,188,5622
subtest26of10,pubtest259of100,1,323,5411,23,228,5662
subtest23of10,pubtest259of100,1,323,5411,25,266,5702
subtest29of10,pubtest259of100,1,323,5411,26,304,5741
subtest22of10,pubtest259of100,1,323,5411,27,344,5782
subtest210of10,pubtest259of100,1,323,5411,28,383,5822
subtest210of10,pubtest260of100,1,323,5317,12,49,5378
subtest23of10,pubtest260of100,1,323,5317,12,87,5416
subtest21of10,pubtest260of100,1,323,5317,13,126,5456
subtest26of10,pubtest260of100,1,323,5317,15,164,5496
subtest27of10,pubtest260of100,1,323,5317,16,203,5536
subtest29of10,pubtest260of100,1,323,5317,18,241,5576
subtest28of10,pubtest260of100,1,323,5317,21,277,5615
subtest22of10,pubtest260of100,1,323,5317,20,316,5653
subtest24of10,pubtest260of100,1,323,5317,23,356,5696
subtest25of10,pubtest260of100,1,323,5317,24,395,5736
subtest25of10,pubtest261of100,1,323,5319,16,40,5375
subtest28of10,pubtest261of100,1,323,5319,18,77,5414
subtest210of10,pubtest261of100,1,323,5319,35,102,5456
subtest29of10,pubtest261of100,1,323,5319,36,140,5495
subtest23of10,pubtest261of100,1,323,5319,49,169,5537
subtest22of10,pubtest261of100,1,323,5319,74,183,5576
subtest27of10,pubtest261of100,1,323,5319,90,206,5615
subtest24of10,pubtest261of100,1,323,5319,97,239,5655
subtest21of10,pubtest261of100,1,323,5319,119,257,5695
subtest26of10,pubtest261of100,1,323,5319,126,290,5735
subtest21of10,pubtest262of100,1,323,5365,8,45,5418
subtest22of10,pubtest262of100,1,323,5365,9,83,5457
subtest23of10,pubtest262of100,1,323,5365,12,120,5497
subtest27of10,pubtest262of100,1,323,5365,16,156,5537
subtest210of10,pubtest262of100,1,323,5365,21,191,5577
subtest25of10,pubtest262of100,1,323,5365,21,231,5617
subtest29of10,pubtest262of100,1,323,5365,19,270,5654
subtest26of10,pubtest262of100,1,323,5365,18,310,5693
subtest24of10,pubtest262of100,1,323,5365,51,321,5737
subtest28of10,pubtest262of100,1,323,5365,56,356,5777
subtest22of10,pubtest263of100,1,322,5448,8,46,5502
subtest29of10,pubtest263of100,1,322,5448,10,83,5541
subtest24of10,pubtest263of100,1,322,5448,12,121,5581
subtest26of10,pubtest263of100,1,322,5448,14,159,5621
subtest23of10,pubtest263of100,1,322,5448,16,197,5661
subtest210of10,pubtest263of100,1,322,5448,20,233,5701
subtest25of10,pubtest263of100,1,322,5448,23,270,5741
subtest28of10,pubtest263of100,1,322,5448,28,305,5781
subtest27of10,pubtest263of100,1,322,5448,28,343,5819
subtest21of10,pubtest263of100,1,322,5448,31,382,5861
subtest22of10,pubtest264of100,1,322,5308,11,39,5358
subtest29of10,pubtest264of100,1,322,5308,12,78,5398
subtest24of10,pubtest264of100,1,322,5308,14,115,5437
subtest23of10,pubtest264of100,1,322,5308,14,155,5477
subtest27of10,pubtest264of100,1,322,5308,17,192,5517
subtest21of10,pubtest264of100,1,322,5308,17,232,5557
subtest25of10,pubtest264of100,1,322,5308,23,266,5597
subtest28of10,pubtest264of100,1,322,5308,28,301,5637
subtest26of10,pubtest264of100,1,322,5308,32,337,5677
subtest210of10,pubtest264of100,1,322,5308,32,377,5717
subtest26of10,pubtest265of100,1,323,5493,10,40,5543
subtest27of10,pubtest265of100,1,323,5493,15,74,5582
subtest210of10,pubtest265of100,1,323,5493,16,113,5622
subtest29of10,pubtest265of100,1,323,5493,17,153,5663
subtest21of10,pubtest265of100,1,323,5493,18,191,5702
subtest25of10,pubtest265of100,1,323,5493,22,227,5742
subtest23of10,pubtest265of100,1,323,5493,23,266,5782
subtest22of10,pubtest265of100,1,323,5493,22,306,5821
subtest28of10,pubtest265of100,1,323,5493,29,340,5862
subtest24of10,pubtest265of100,1,323,5493,35,374,5902
subtest29of10,pubtest266of100,1,321,5234,9,44,5287
subtest210of10,pubtest266of100,1,321,5234,10,83,5327
subtest27of10,pubtest266of100,1,321,5234,12,120,5366
subtest25of10,pubtest266of100,1,321,5234,14,158,5406
subtest23of10,pubtest266of100,1,321,5234,17,195,5446
subtest26of10,pubtest266of100,1,321,5234,18,234,5486
subtest21of10,pubtest266of100,1,321,5234,26,266,5526
subtest28of10,pubtest266of100,1,321,5234,27,305,5566
subtest22of10,pubtest266of100,1,321,5234,31,341,5606
subtest24of10,pubtest266of100,1,321,5234,31,381,5646
subtest28of10,pubtest267of100,1,323,5364,16,44,5424
subtest25of10,pubtest267of100,1,323,5364,15,83,5462
subtest23of10,pubtest267of100,1,323,5364,14,124,5502
subtest26of10,pubtest267of100,1,323,5364,14,164,5542
subtest27of10,pubtest267of100,1,323,5364,21,197,5582
subtest24of10,pubtest267of100,1,323,5364,24,235,5623
subtest29of10,pubtest267of100,1,323,5364,26,272,5662
subtest22of10,pubtest267of100,1,323,5364,26,312,5702
subtest21of10,pubtest267of100,1,323,5364,28,350,5742
subtest210of10,pubtest267of100,1,323,5364,29,390,5783
subtest23of10,pubtest268of100,1,323,5256,12,41,5309
subtest25of10,pubtest268of100,1,323,5256,21,71,5348
subtest24of10,pubtest268of100,1,323,5256,22,110,5388
subtest29of10,pubtest268of100,1,323,5256,24,148,5428
subtest28of10,pubtest268of100,1,323,5256,26,186,5468
subtest22of10,pubtest268of100,1,323,5256,26,226,5508
subtest27of10,pubtest268of100,1,323,5256,26,264,5546
subtest210of10,pubtest268of100,1,323,5256,28,304,5588
subtest21of10,pubtest268of100,1,323,5256,28,341,5625
subtest26of10,pubtest268of100,1,323,5256,32,380,5668
subtest24of10,pubtest269of100,1,323,5246,8,40,5294
subtest210of10,pubtest269of100,1,323,5246,10,77,5333
subtest27of10,pubtest269of100,1,323,5246,10,116,5372
subtest26of10,pubtest269of100,1,323,5246,18,149,5413
subtest25of10,pubtest269of100,1,323,5246,18,188,5452
subtest22of10,pubtest269of100,1,323,5246,25,222,5493
subtest29of10,pubtest269of100,1,323,5246,26,263,5535
subtest23of10,pubtest269of100,1,323,5246,28,300,5574
subtest21of10,pubtest269of100,1,323,5246,25,339,5610
subtest28of10,pubtest269of100,1,323,5246,28,379,5653
subtest23of10,pubtest270of100,1,323,5472,11,340,5823
subtest26of10,pubtest270of100,1,323,5472,12,376,5860
subtest210of10,pubtest270of100,1,323,5472,14,415,5901
subtest29of10,pubtest270of100,1,323,5472,16,452,5940
subtest28of10,pubtest270of100,1,323,5472,23,485,5980
subtest25of10,pubtest270of100,1,323,5472,29,519,6020
subtest22of10,pubtest270of100,1,323,5472,352,235,6059
subtest27of10,pubtest270of100,1,323,5472,12,274,5758
subtest24of10,pubtest270of100,1,323,5472,352,314,6138
subtest21of10,pubtest270of100,1,323,5472,34,353,5859
subtest24of10,pubtest271of100,1,323,5330,9,43,5382
subtest22of10,pubtest271of100,1,323,5330,9,518,5857
subtest25of10,pubtest271of100,1,323,5330,14,552,5896
subtest27of10,pubtest271of100,1,323,5330,16,590,5936
subtest210of10,pubtest271of100,1,323,5330,17,629,5976
subtest21of10,pubtest271of100,1,323,5330,22,664,6016
subtest26of10,pubtest271of100,1,323,5330,23,703,6056
subtest23of10,pubtest271of100,1,323,5330,27,739,6096
subtest29of10,pubtest271of100,1,323,5330,28,778,6136
subtest28of10,pubtest271of100,1,323,5330,29,817,6176
subtest25of10,pubtest272of100,1,323,5408,8,38,5454
subtest26of10,pubtest272of100,1,323,5408,18,68,5494
subtest21of10,pubtest272of100,1,323,5408,23,102,5533
subtest29of10,pubtest272of100,1,323,5408,23,142,5573
subtest22of10,pubtest272of100,1,323,5408,26,179,5613
subtest28of10,pubtest272of100,1,323,5408,26,219,5653
subtest210of10,pubtest272of100,1,323,5408,28,257,5693
subtest27of10,pubtest272of100,1,323,5408,28,297,5733
subtest23of10,pubtest272of100,1,323,5408,30,335,5773
subtest24of10,pubtest272of100,1,323,5408,30,374,5812
subtest26of10,pubtest273of100,1,321,5286,13,113,5412
subtest22of10,pubtest273of100,1,321,5286,11,152,5449
subtest28of10,pubtest273of100,1,321,5286,13,190,5489
subtest29of10,pubtest273of100,1,321,5286,12,230,5528
subtest25of10,pubtest273of100,1,321,5286,19,264,5569
subtest27of10,pubtest273of100,1,321,5286,21,300,5607
subtest210of10,pubtest273of100,1,321,5286,21,339,5646
subtest23of10,pubtest273of100,1,321,5286,22,378,5686
subtest24of10,pubtest273of100,1,321,5286,21,418,5725
subtest21of10,pubtest273of100,1,321,5286,25,458,5769
subtest21of10,pubtest274of100,1,323,5323,14,44,5381
subtest22of10,pubtest274of100,1,323,5323,17,79,5419
subtest26of10,pubtest274of100,1,323,5323,16,118,5457
subtest23of10,pubtest274of100,1,323,5323,19,156,5498
subtest29of10,pubtest274of100,1,323,5323,20,195,5538
subtest25of10,pubtest274of100,1,323,5323,25,230,5578
subtest28of10,pubtest274of100,1,323,5323,26,269,5618
subtest24of10,pubtest274of100,1,323,5323,31,304,5658
subtest27of10,pubtest274of100,1,323,5323,31,344,5698
subtest210of10,pubtest274of100,1,323,5323,33,382,5738
subtest27of10,pubtest275of100,1,323,5262,9,42,5313
subtest24of10,pubtest275of100,1,323,5262,10,80,5352
subtest29of10,pubtest275of100,1,323,5262,11,119,5392
subtest25of10,pubtest275of100,1,323,5262,23,145,5430
subtest22of10,pubtest275of100,1,323,5262,24,184,5470
subtest210of10,pubtest275of100,1,323,5262,28,222,5512
subtest21of10,pubtest275of100,1,323,5262,29,263,5554
subtest26of10,pubtest275of100,1,323,5262,31,300,5593
subtest23of10,pubtest275of100,1,323,5262,31,339,5632
subtest28of10,pubtest275of100,1,323,5262,34,376,5672
subtest28of10,pubtest276of100,1,323,5288,11,42,5341
subtest21of10,pubtest276of100,1,323,5288,12,80,5380
subtest25of10,pubtest276of100,1,323,5288,14,118,5420
subtest24of10,pubtest276of100,1,323,5288,14,158,5460
subtest26of10,pubtest276of100,1,323,5288,16,196,5500
subtest29of10,pubtest276of100,1,323,5288,16,235,5539
subtest27of10,pubtest276of100,1,323,5288,16,275,5579
subtest22of10,pubtest276of100,1,323,5288,20,312,5620
subtest210of10,pubtest276of100,1,323,5288,20,352,5660
subtest23of10,pubtest276of100,1,323,5288,24,388,5700
subtest22of10,pubtest277of100,1,323,5313,9,40,5362
subtest29of10,pubtest277of100,1,323,5313,10,77,5400
subtest28of10,pubtest277of100,1,323,5313,16,112,5441
subtest24of10,pubtest277of100,1,323,5313,19,149,5481
subtest21of10,pubtest277of100,1,323,5313,20,188,5521
subtest27of10,pubtest277of100,1,323,5313,22,226,5561
subtest210of10,pubtest277of100,1,323,5313,22,266,5601
subtest25of10,pubtest277of100,1,323,5313,23,305,5641
subtest23of10,pubtest277of100,1,323,5313,26,341,5680
subtest26of10,pubtest277of100,1,323,5313,26,381,5720
subtest29of10,pubtest278of100,1,323,5396,12,40,5448
subtest21of10,pubtest278of100,1,323,5396,14,77,5487
subtest27of10,pubtest278of100,1,323,5396,15,114,5525
subtest23of10,pubtest278of100,1,323,5396,13,153,5562
subtest22of10,pubtest278of100,1,323,5396,13,192,5601
subtest28of10,pubtest278of100,1,323,5396,14,233,5643
subtest25of10,pubtest278of100,1,323,5396,21,270,5687
subtest26of10,pubtest278of100,1,323,5396,25,307,5728
subtest24of10,pubtest278of100,1,323,5396,46,325,5767
subtest210of10,pubtest278of100,1,323,5396,52,359,5807
subtest28of10,pubtest279of100,1,323,5380,12,38,5430
subtest25of10,pubtest279of100,1,323,5380,11,77,5468
subtest21of10,pubtest279of100,1,323,5380,13,116,5509
subtest29of10,pubtest279of100,1,323,5380,21,148,5549
subtest24of10,pubtest279of100,1,323,5380,20,188,5588
subtest27of10,pubtest279of100,1,323,5380,22,226,5628
subtest23of10,pubtest279of100,1,323,5380,23,267,5670
subtest26of10,pubtest279of100,1,323,5380,24,303,5707
subtest210of10,pubtest279of100,1,323,5380,29,340,5749
subtest22of10,pubtest279of100,1,323,5380,27,381,5788
subtest27of10,pubtest280of100,1,323,5358,17,41,5416
subtest29of10,pubtest280of100,1,323,5358,22,75,5455
subtest24of10,pubtest280of100,1,323,5358,22,115,5495
subtest21of10,pubtest280of100,1,323,5358,25,151,5534
subtest23of10,pubtest280of100,1,323,5358,27,191,5576
subtest26of10,pubtest280of100,1,323,5358,29,228,5615
subtest25of10,pubtest280of100,1,323,5358,29,268,5655
subtest28of10,pubtest280of100,1,323,5358,31,306,5695
subtest210of10,pubtest280of100,1,323,5358,31,346,5735
subtest22of10,pubtest280of100,1,323,5358,32,385,5775
subtest24of10,pubtest281of100,1,323,5754,16,46,5816
subtest23of10,pubtest281of100,1,323,5754,16,84,5854
subtest25of10,pubtest281of100,1,323,5754,19,122,5895
subtest22of10,pubtest281of100,1,323,5754,20,161,5935
subtest27of10,pubtest281of100,1,323,5754,22,199,5975
subtest28of10,pubtest281of100,1,323,5754,22,239,6015
subtest21of10,pubtest281of100,1,323,5754,53,248,6055
subtest210of10,pubtest281of100,1,323,5754,54,287,6095
subtest29of10,pubtest281of100,1,323,5754,55,324,6133
subtest26of10,pubtest281of100,1,323,5754,57,363,6174
subtest23of10,pubtest282of100,1,323,5259,11,39,5309
subtest24of10,pubtest282of100,1,323,5259,11,78,5348
subtest21of10,pubtest282of100,1,323,5259,14,115,5388
subtest22of10,pubtest282of100,1,323,5259,15,154,5428
subtest25of10,pubtest282of100,1,323,5259,18,189,5466
subtest29of10,pubtest282of100,1,323,5259,21,229,5509
subtest27of10,pubtest282of100,1,323,5259,22,267,5548
subtest26of10,pubtest282of100,1,323,5259,23,306,5588
subtest210of10,pubtest282of100,1,323,5259,24,345,5628
subtest28of10,pubtest282of100,1,323,5259,27,384,5670
subtest27of10,pubtest283of100,1,323,5357,8,39,5404
subtest24of10,pubtest283of100,1,323,5357,17,69,5443
subtest23of10,pubtest283of100,1,323,5357,17,110,5484
subtest22of10,pubtest283of100,1,323,5357,19,146,5522
subtest25of10,pubtest283of100,1,323,5357,20,186,5563
subtest28of10,pubtest283of100,1,323,5357,21,226,5604
subtest21of10,pubtest283of100,1,323,5357,22,264,5643
subtest29of10,pubtest283of100,1,323,5357,23,303,5683
subtest210of10,pubtest283of100,1,323,5357,24,342,5723
subtest26of10,pubtest283of100,1,323,5357,29,377,5763
subtest25of10,pubtest284of100,1,323,5355,15,41,5411
subtest22of10,pubtest284of100,1,323,5355,15,80,5450
subtest210of10,pubtest284of100,1,323,5355,17,118,5490
subtest24of10,pubtest284of100,1,323,5355,21,154,5530
subtest21of10,pubtest284of100,1,323,5355,25,191,5571
subtest28of10,pubtest284of100,1,323,5355,25,230,5610
subtest23of10,pubtest284of100,1,323,5355,26,269,5650
subtest27of10,pubtest284of100,1,323,5355,25,308,5688
subtest26of10,pubtest284of100,1,323,5355,27,348,5730
subtest29of10,pubtest284of100,1,323,5355,21,387,5763
subtest24of10,pubtest285of100,1,323,5409,14,40,5463
subtest23of10,pubtest285of100,1,323,5409,14,79,5502
subtest25of10,pubtest285of100,1,323,5409,17,116,5542
subtest27of10,pubtest285of100,1,323,5409,18,155,5582
subtest22of10,pubtest285of100,1,323,5409,18,196,5623
subtest28of10,pubtest285of100,1,323,5409,24,229,5662
subtest21of10,pubtest285of100,1,323,5409,25,268,5702
subtest29of10,pubtest285of100,1,323,5409,29,304,5742
subtest210of10,pubtest285of100,1,323,5409,31,340,5780
subtest26of10,pubtest285of100,1,323,5409,31,380,5820
subtest23of10,pubtest286of100,1,323,5299,10,400,5709
subtest210of10,pubtest286of100,1,323,5299,13,437,5749
subtest25of10,pubtest286of100,1,323,5299,15,475,5789
subtest29of10,pubtest286of100,1,323,5299,15,515,5829
subtest24of10,pubtest286of100,1,323,5299,18,552,5869
subtest27of10,pubtest286of100,1,323,5299,20,591,5910
subtest21of10,pubtest286of100,1,323,5299,19,631,5949
subtest26of10,pubtest286of100,1,323,5299,25,665,5989
subtest22of10,pubtest286of100,1,323,5299,25,705,6029
subtest28of10,pubtest286of100,1,323,5299,28,743,6070
subtest26of10,pubtest287of100,1,323,5318,14,42,5374
subtest29of10,pubtest287of100,1,323,5318,15,80,5413
subtest28of10,pubtest287of100,1,323,5318,17,118,5453
subtest27of10,pubtest287of100,1,323,5318,17,158,5493
subtest25of10,pubtest287of100,1,323,5318,27,188,5533
subtest21of10,pubtest287of100,1,323,5318,28,227,5573
subtest210of10,pubtest287of100,1,323,5318,27,267,5612
subtest24of10,pubtest287of100,1,323,5318,30,306,5654
subtest22of10,pubtest287of100,1,323,5318,33,341,5692
subtest23of10,pubtest287of100,1,323,5318,39,376,5733
subtest29of10,pubtest288of100,1,323,5296,14,55,5365
subtest26of10,pubtest288of100,1,323,5296,14,95,5405
subtest22of10,pubtest288of100,1,323,5296,18,131,5445
subtest23of10,pubtest288of100,1,323,5296,19,166,5481
subtest210of10,pubtest288of100,1,323,5296,24,204,5524
subtest24of10,pubtest288of100,1,323,5296,25,243,5564
subtest28of10,pubtest288of100,1,323,5296,26,282,5604
subtest21of10,pubtest288of100,1,323,5296,17,321,5634
subtest25of10,pubtest288of100,1,323,5296,16,360,5672
subtest27of10,pubtest288of100,1,323,5296,30,398,5724
subtest29of10,pubtest289of100,1,323,5485,8,41,5534
subtest23of10,pubtest289of100,1,323,5485,16,72,5573
subtest24of10,pubtest289of100,1,323,5485,16,112,5613
subtest210of10,pubtest289of100,1,323,5485,16,151,5652
subtest26of10,pubtest289of100,1,323,5485,19,189,5693
subtest27of10,pubtest289of100,1,323,5485,20,229,5734
subtest25of10,pubtest289of100,1,323,5485,19,268,5772
subtest28of10,pubtest289of100,1,323,5485,21,305,5811
subtest21of10,pubtest289of100,1,323,5485,24,343,5852
subtest22of10,pubtest289of100,1,323,5485,25,383,5893
subtest22of10,pubtest290of100,1,323,5262,10,42,5314
subtest29of10,pubtest290of100,1,323,5262,10,80,5352
subtest23of10,pubtest290of100,1,323,5262,26,105,5393
subtest26of10,pubtest290of100,1,323,5262,29,140,5431
subtest27of10,pubtest290of100,1,323,5262,31,179,5472
subtest21of10,pubtest290of100,1,323,5262,31,219,5512
subtest25of10,pubtest290of100,1,323,5262,29,258,5549
subtest210of10,pubtest290of100,1,323,5262,32,298,5592
subtest28of10,pubtest290of100,1,323,5262,34,338,5634
subtest24of10,pubtest290of100,1,323,5262,39,371,5672
subtest27of10,pubtest291of100,1,323,5435,15,41,5491
subtest24of10,pubtest291of100,1,323,5435,14,81,5530
subtest23of10,pubtest291of100,1,323,5435,14,121,5570
subtest21of10,pubtest291of100,1,323,5435,19,156,5610
subtest28of10,pubtest291of100,1,323,5435,19,196,5650
subtest210of10,pubtest291of100,1,323,5435,21,234,5690
subtest29of10,pubtest291of100,1,323,5435,21,274,5730
subtest25of10,pubtest291of100,1,323,5435,24,311,5770
subtest26of10,pubtest291of100,1,323,5435,26,349,5810
subtest22of10,pubtest291of100,1,323,5435,26,387,5848
subtest29of10,pubtest292of100,1,323,5394,11,38,5443
subtest28of10,pubtest292of100,1,323,5394,12,77,5483
subtest27of10,pubtest292of100,1,323,5394,17,111,5522
subtest21of10,pubtest292of100,1,323,5394,16,153,5563
subtest25of10,pubtest292of100,1,323,5394,18,191,5603
subtest26of10,pubtest292of100,1,323,5394,23,225,5642
subtest23of10,pubtest292of100,1,323,5394,24,264,5682
subtest22of10,pubtest292of100,1,323,5394,25,303,5722
subtest210of10,pubtest292of100,1,323,5394,57,310,5761
subtest24of10,pubtest292of100,1,323,5394,57,350,5801
subtest24of10,pubtest293of100,1,323,5347,13,41,5401
subtest25of10,pubtest293of100,1,323,5347,17,78,5442
subtest28of10,pubtest293of100,1,323,5347,19,115,5481
subtest210of10,pubtest293of100,1,323,5347,20,154,5521
subtest23of10,pubtest293of100,1,323,5347,21,193,5561
subtest26of10,pubtest293of100,1,323,5347,23,231,5601
subtest21of10,pubtest293of100,1,323,5347,26,267,5640
subtest27of10,pubtest293of100,1,323,5347,27,307,5681
subtest22of10,pubtest293of100,1,323,5347,26,346,5719
subtest29of10,pubtest293of100,1,323,5347,28,386,5761
subtest21of10,pubtest294of100,1,323,5276,8,42,5326
subtest210of10,pubtest294of100,1,323,5276,11,78,5365
subtest25of10,pubtest294of100,1,323,5276,11,117,5404
subtest29of10,pubtest294of100,1,323,5276,13,156,5445
subtest27of10,pubtest294of100,1,323,5276,17,192,5485
subtest26of10,pubtest294of100,1,323,5276,38,211,5525
subtest23of10,pubtest294of100,1,323,5276,39,250,5565
subtest24of10,pubtest294of100,1,323,5276,40,290,5606
subtest22of10,pubtest294of100,1,323,5276,43,326,5645
subtest28of10,pubtest294of100,1,323,5276,44,365,5685
subtest25of10,pubtest295of100,1,323,5312,10,288,5610
subtest24of10,pubtest295of100,1,323,5312,10,326,5648
subtest23of10,pubtest295of100,1,323,5312,12,364,5688
subtest27of10,pubtest295of100,1,323,5312,15,401,5728
subtest22of10,pubtest295of100,1,323,5312,15,441,5768
subtest29of10,pubtest295of100,1,323,5312,15,477,5804
subtest210of10,pubtest295of100,1,323,5312,19,517,5848
subtest21of10,pubtest295of100,1,323,5312,21,556,5889
subtest28of10,pubtest295of100,1,323,5312,24,592,5928
subtest26of10,pubtest295of100,1,323,5312,26,630,5968
subtest25of10,pubtest296of100,1,322,5440,9,43,5492
subtest24of10,pubtest296of100,1,322,5440,10,82,5532
subtest26of10,pubtest296of100,1,322,5440,13,119,5572
subtest27of10,pubtest296of100,1,322,5440,14,157,5611
subtest23of10,pubtest296of100,1,322,5440,15,196,5651
subtest21of10,pubtest296of100,1,322,5440,21,230,5691
subtest29of10,pubtest296of100,1,322,5440,21,270,5731
subtest210of10,pubtest296of100,1,322,5440,24,307,5771
subtest28of10,pubtest296of100,1,322,5440,24,347,5811
subtest22of10,pubtest296of100,1,322,5440,27,384,5851
subtest25of10,pubtest297of100,1,323,5359,9,39,5407
subtest210of10,pubtest297of100,1,323,5359,10,77,5446
subtest29of10,pubtest297of100,1,323,5359,12,115,5486
subtest22of10,pubtest297of100,1,323,5359,14,152,5525
subtest27of10,pubtest297of100,1,323,5359,26,181,5566
subtest23of10,pubtest297of100,1,323,5359,26,223,5608
subtest26of10,pubtest297of100,1,323,5359,28,259,5646
subtest21of10,pubtest297of100,1,323,5359,29,298,5686
subtest24of10,pubtest297of100,1,323,5359,32,335,5726
subtest28of10,pubtest297of100,1,323,5359,32,374,5765
subtest29of10,pubtest298of100,1,323,5410,9,42,5461
subtest22of10,pubtest298of100,1,323,5410,10,79,5499
subtest24of10,pubtest298of100,1,323,5410,11,118,5539
subtest25of10,pubtest298of100,1,323,5410,13,156,5579
subtest21of10,pubtest298of100,1,323,5410,15,194,5619
subtest27of10,pubtest298of100,1,323,5410,15,234,5659
subtest23of10,pubtest298of100,1,323,5410,15,273,5698
subtest210of10,pubtest298of100,1,323,5410,20,309,5739
subtest28of10,pubtest298of100,1,323,5410,21,348,5779
subtest26of10,pubtest298of100,1,323,5410,24,385,5819
subtest22of10,pubtest299of100,1,323,5296,10,39,5345
subtest29of10,pubtest299of100,1,323,5296,12,75,5383
subtest210of10,pubtest299of100,1,323,5296,14,114,5424
subtest27of10,pubtest299of100,1,323,5296,15,153,5464
subtest24of10,pubtest299of100,1,323,5296,19,189,5504
subtest28of10,pubtest299of100,1,323,5296,20,228,5544
subtest23of10,pubtest299of100,1,323,5296,22,267,5585
subtest25of10,pubtest299of100,1,323,5296,22,306,5624
subtest21of10,pubtest299of100,1,323,5296,23,345,5664
subtest26of10,pubtest299of100,1,323,5296,24,386,5706
subtest24of10,pubtest2100of100,1,325,5412,14,42,5468
subtest21of10,pubtest2100of100,1,325,5412,14,81,5507
subtest29of10,pubtest2100of100,1,325,5412,16,119,5547
subtest22of10,pubtest2100of100,1,325,5412,16,159,5587
subtest28of10,pubtest2100of100,1,325,5412,16,197,5625
subtest27of10,pubtest2100of100,1,325,5412,21,234,5667
subtest23of10,pubtest2100of100,1,325,5412,21,274,5707
subtest210of10,pubtest2100of100,1,325,5412,23,312,5747
subtest25of10,pubtest2100of100,1,325,5412,23,354,5789
subtest26of10,pubtest2100of100,1,325,5412,32,384,5828
subtest26of10,pubtest21of100,1,322,10596,11,41,10648
subtest27of10,pubtest21of100,1,322,10596,13,78,10687
subtest29of10,pubtest21of100,1,322,10596,13,118,10727
subtest24of10,pubtest21of100,1,322,10596,15,156,10767
subtest25of10,pubtest21of100,1,322,10596,24,187,10807
subtest21of10,pubtest21of100,1,322,10596,25,226,10847
subtest210of10,pubtest21of100,1,322,10596,26,266,10888
subtest28of10,pubtest21of100,1,322,10596,27,302,10925
subtest22of10,pubtest21of100,1,322,10596,29,342,10967
subtest23of10,pubtest21of100,1,322,10596,39,372,11007
subtest29of10,pubtest22of100,1,321,5411,6,40,5457
subtest27of10,pubtest22of100,1,321,5411,10,75,5496
subtest24of10,pubtest22of100,1,321,5411,11,114,5536
subtest23of10,pubtest22of100,1,321,5411,16,149,5576
subtest25of10,pubtest22of100,1,321,5411,19,186,5616
subtest28of10,pubtest22of100,1,321,5411,20,225,5656
subtest21of10,pubtest22of100,1,321,5411,19,265,5695
subtest26of10,pubtest22of100,1,321,5411,21,304,5736
subtest210of10,pubtest22of100,1,321,5411,26,339,5776
subtest22of10,pubtest22of100,1,321,5411,26,379,5816
subtest28of10,pubtest23of100,1,321,5439,11,41,5491
subtest23of10,pubtest23of100,1,321,5439,11,80,5530
subtest29of10,pubtest23of100,1,321,5439,13,120,5572
subtest27of10,pubtest23of100,1,321,5439,14,158,5611
subtest24of10,pubtest23of100,1,321,5439,15,197,5651
subtest25of10,pubtest23of100,1,321,5439,18,234,5691
subtest26of10,pubtest23of100,1,321,5439,18,274,5731
subtest21of10,pubtest23of100,1,321,5439,23,309,5771
subtest22of10,pubtest23of100,1,321,5439,23,350,5812
subtest210of10,pubtest23of100,1,321,5439,25,387,5851
subtest23of10,pubtest24of100,1,321,5471,9,38,5518
subtest21of10,pubtest24of100,1,321,5471,17,69,5557
subtest24of10,pubtest24of100,1,321,5471,17,109,5597
subtest25of10,pubtest24of100,1,321,5471,17,148,5636
subtest29of10,pubtest24of100,1,321,5471,19,188,5678
subtest27of10,pubtest24of100,1,321,5471,24,222,5717
subtest22of10,pubtest24of100,1,321,5471,24,262,5757
subtest28of10,pubtest24of100,1,321,5471,24,299,5794
subtest26of10,pubtest24of100,1,321,5471,26,339,5836
subtest210of10,pubtest24of100,1,321,5471,26,377,5874
subtest28of10,pubtest25of100,1,321,5842,9,122,5973
subtest21of10,pubtest25of100,1,321,5842,10,158,6010
subtest210of10,pubtest25of100,1,321,5842,14,195,6051
subtest27of10,pubtest25of100,1,321,5842,21,227,6090
subtest26of10,pubtest25of100,1,321,5842,22,267,6131
subtest22of10,pubtest25of100,1,321,5842,23,306,6171
subtest25of10,pubtest25of100,1,321,5842,25,343,6210
subtest24of10,pubtest25of100,1,321,5842,25,383,6250
subtest29of10,pubtest25of100,1,321,5842,26,421,6289
subtest23of10,pubtest25of100,1,321,5842,27,461,6330
subtest21of10,pubtest26of100,1,321,5454,9,38,5501
subtest22of10,pubtest26of100,1,321,5454,18,68,5540
subtest23of10,pubtest26of100,1,321,5454,19,108,5581
subtest29of10,pubtest26of100,1,321,5454,18,147,5619
subtest27of10,pubtest26of100,1,321,5454,23,181,5658
subtest24of10,pubtest26of100,1,321,5454,25,220,5699
subtest25of10,pubtest26of100,1,321,5454,27,259,5740
subtest28of10,pubtest26of100,1,321,5454,27,299,5780
subtest26of10,pubtest26of100,1,321,5454,23,338,5815
subtest210of10,pubtest26of100,1,321,5454,28,378,5860
subtest28of10,pubtest27of100,1,320,5312,14,41,5367
subtest27of10,pubtest27of100,1,320,5312,14,76,5402
subtest24of10,pubtest27of100,1,320,5312,16,116,5444
subtest29of10,pubtest27of100,1,320,5312,16,154,5482
subtest23of10,pubtest27of100,1,320,5312,15,194,5521
subtest25of10,pubtest27of100,1,320,5312,27,225,5564
subtest210of10,pubtest27of100,1,320,5312,50,242,5604
subtest21of10,pubtest27of100,1,320,5312,52,279,5643
subtest26of10,pubtest27of100,1,320,5312,54,318,5684
subtest22of10,pubtest27of100,1,320,5312,54,357,5723
subtest27of10,pubtest28of100,1,321,5472,7,40,5519
subtest21of10,pubtest28of100,1,321,5472,15,71,5558
subtest28of10,pubtest28of100,1,321,5472,15,108,5595
subtest29of10,pubtest28of100,1,321,5472,20,145,5637
subtest210of10,pubtest28of100,1,321,5472,21,185,5678
subtest25of10,pubtest28of100,1,321,5472,22,224,5718
subtest23of10,pubtest28of100,1,321,5472,24,262,5758
subtest24of10,pubtest28of100,1,321,5472,23,302,5797
subtest22of10,pubtest28of100,1,321,5472,23,341,5836
subtest26of10,pubtest28of100,1,321,5472,25,381,5878
subtest23of10,pubtest29of100,1,321,5411,9,173,5593
subtest29of10,pubtest29of100,1,321,5411,10,211,5632
subtest210of10,pubtest29of100,1,321,5411,12,249,5672
subtest22of10,pubtest29of100,1,321,5411,13,288,5712
subtest25of10,pubtest29of100,1,321,5411,21,320,5752
subtest21of10,pubtest29of100,1,321,5411,23,356,5790
subtest28of10,pubtest29of100,1,321,5411,25,396,5832
subtest24of10,pubtest29of100,1,321,5411,27,435,5873
subtest26of10,pubtest29of100,1,321,5411,27,474,5912
subtest27of10,pubtest29of100,1,321,5411,28,514,5953
subtest29of10,pubtest210of100,1,323,5358,9,38,5405
subtest21of10,pubtest210of100,1,323,5358,11,75,5444
subtest210of10,pubtest210of100,1,323,5358,11,116,5485
subtest27of10,pubtest210of100,1,323,5358,15,151,5524
subtest23of10,pubtest210of100,1,323,5358,18,188,5564
subtest25of10,pubtest210of100,1,323,5358,19,227,5604
subtest28of10,pubtest210of100,1,323,5358,22,264,5644
subtest24of10,pubtest210of100,1,323,5358,23,301,5682
subtest22of10,pubtest210of100,1,323,5358,26,340,5724
subtest26of10,pubtest210of100,1,323,5358,28,378,5764
subtest210of10,pubtest211of100,1,323,5320,15,290,5625
subtest29of10,pubtest211of100,1,323,5320,16,329,5665
subtest22of10,pubtest211of100,1,323,5320,17,366,5703
subtest28of10,pubtest211of100,1,323,5320,20,405,5745
subtest24of10,pubtest211of100,1,323,5320,18,446,5784
subtest21of10,pubtest211of100,1,323,5320,20,484,5824
subtest27of10,pubtest211of100,1,323,5320,20,524,5864
subtest25of10,pubtest211of100,1,323,5320,23,561,5904
subtest26of10,pubtest211of100,1,323,5320,24,601,5945
subtest23of10,pubtest211of100,1,323,5320,23,640,5983
subtest25of10,pubtest212of100,1,323,5291,25,39,5355
subtest29of10,pubtest212of100,1,323,5291,27,76,5394
subtest28of10,pubtest212of100,1,323,5291,28,115,5434
subtest23of10,pubtest212of100,1,323,5291,29,155,5475
subtest27of10,pubtest212of100,1,323,5291,32,191,5514
subtest24of10,pubtest212of100,1,323,5291,38,223,5552
subtest21of10,pubtest212of100,1,323,5291,39,263,5593
subtest22of10,pubtest212of100,1,323,5291,40,302,5633
subtest26of10,pubtest212of100,1,323,5291,47,335,5673
subtest210of10,pubtest212of100,1,323,5291,48,375,5714
subtest23of10,pubtest213of100,1,322,5565,8,40,5613
subtest26of10,pubtest213of100,1,322,5565,10,77,5652
subtest29of10,pubtest213of100,1,322,5565,10,117,5692
subtest27of10,pubtest213of100,1,322,5565,11,156,5732
subtest22of10,pubtest213of100,1,322,5565,19,188,5772
subtest21of10,pubtest213of100,1,322,5565,21,226,5812
subtest25of10,pubtest213of100,1,322,5565,23,264,5852
subtest24of10,pubtest213of100,1,322,5565,22,301,5888
subtest28of10,pubtest213of100,1,322,5565,25,341,5931
subtest210of10,pubtest213of100,1,322,5565,24,383,5972
subtest21of10,pubtest214of100,1,323,5366,10,43,5419
subtest23of10,pubtest214of100,1,323,5366,13,80,5459
subtest26of10,pubtest214of100,1,323,5366,18,115,5499
subtest27of10,pubtest214of100,1,323,5366,19,154,5539
subtest25of10,pubtest214of100,1,323,5366,20,195,5581
subtest29of10,pubtest214of100,1,323,5366,20,234,5620
subtest22of10,pubtest214of100,1,323,5366,23,271,5660
subtest210of10,pubtest214of100,1,323,5366,26,307,5699
subtest24of10,pubtest214of100,1,323,5366,26,347,5739
subtest28of10,pubtest214of100,1,323,5366,28,385,5779
subtest27of10,pubtest215of100,1,323,5415,9,41,5465
subtest24of10,pubtest215of100,1,323,5415,11,78,5504
subtest29of10,pubtest215of100,1,323,5415,11,118,5544
subtest21of10,pubtest215of100,1,323,5415,13,156,5584
subtest25of10,pubtest215of100,1,323,5415,15,194,5624
subtest210of10,pubtest215of100,1,323,5415,18,231,5664
subtest26of10,pubtest215of100,1,323,5415,18,271,5704
subtest23of10,pubtest215of100,1,323,5415,25,304,5744
subtest22of10,pubtest215of100,1,323,5415,27,342,5784
subtest28of10,pubtest215of100,1,323,5415,28,382,5825
subtest24of10,pubtest216of100,1,323,5329,34,45,5408
subtest21of10,pubtest216of100,1,323,5329,35,83,5447
subtest23of10,pubtest216of100,1,323,5329,37,121,5487
subtest27of10,pubtest216of100,1,323,5329,41,157,5527
subtest28of10,pubtest216of100,1,323,5329,43,196,5568
subtest25of10,pubtest216of100,1,323,5329,42,236,5607
subtest29of10,pubtest216of100,1,323,5329,47,270,5646
subtest22of10,pubtest216of100,1,323,5329,48,310,5687
subtest26of10,pubtest216of100,1,323,5329,52,346,5727
subtest210of10,pubtest216of100,1,323,5329,53,385,5767
subtest27of10,pubtest217of100,1,322,5362,10,43,5415
subtest22of10,pubtest217of100,1,322,5362,11,81,5454
subtest21of10,pubtest217of100,1,322,5362,14,118,5494
subtest23of10,pubtest217of100,1,322,5362,12,158,5532
subtest29of10,pubtest217of100,1,322,5362,15,198,5575
subtest26of10,pubtest217of100,1,322,5362,19,233,5614
subtest24of10,pubtest217of100,1,322,5362,24,269,5655
subtest25of10,pubtest217of100,1,322,5362,31,301,5694
subtest28of10,pubtest217of100,1,322,5362,36,336,5734
subtest210of10,pubtest217of100,1,322,5362,36,375,5773
subtest29of10,pubtest218of100,1,323,5362,8,45,5415
subtest21of10,pubtest218of100,1,323,5362,11,81,5454
subtest27of10,pubtest218of100,1,323,5362,12,120,5494
subtest22of10,pubtest218of100,1,323,5362,40,132,5534
subtest28of10,pubtest218of100,1,323,5362,42,170,5574
subtest23of10,pubtest218of100,1,323,5362,41,208,5611
subtest25of10,pubtest218of100,1,323,5362,47,245,5654
subtest24of10,pubtest218of100,1,323,5362,48,284,5694
subtest210of10,pubtest218of100,1,323,5362,50,322,5734
subtest26of10,pubtest218of100,1,323,5362,51,361,5774
subtest210of10,pubtest219of100,1,323,5547,9,42,5598
subtest25of10,pubtest219of100,1,323,5547,9,80,5636
subtest26of10,pubtest219of100,1,323,5547,18,111,5676
subtest22of10,pubtest219of100,1,323,5547,19,150,5716
subtest21of10,pubtest219of100,1,323,5547,20,189,5756
subtest29of10,pubtest219of100,1,323,5547,21,227,5795
subtest23of10,pubtest219of100,1,323,5547,22,267,5836
subtest24of10,pubtest219of100,1,323,5547,25,304,5876
subtest27of10,pubtest219of100,1,323,5547,25,342,5914
subtest28of10,pubtest219of100,1,323,5547,28,381,5956
subtest23of10,pubtest220of100,1,323,5238,11,428,5677
subtest210of10,pubtest220of100,1,323,5238,11,467,5716
subtest25of10,pubtest220of100,1,323,5238,11,123,5372
subtest22of10,pubtest220of100,1,323,5238,398,161,5797
subtest29of10,pubtest220of100,1,323,5238,13,200,5451
subtest26of10,pubtest220of100,1,323,5238,399,239,5876
subtest21of10,pubtest220of100,1,323,5238,13,278,5529
subtest27of10,pubtest220of100,1,323,5238,401,317,5956
subtest28of10,pubtest220of100,1,323,5238,402,356,5996
subtest24of10,pubtest220of100,1,323,5238,403,395,6036
subtest24of10,pubtest221of100,1,323,5288,13,42,5343
subtest21of10,pubtest221of100,1,323,5288,13,80,5381
subtest23of10,pubtest221of100,1,323,5288,15,118,5421
subtest25of10,pubtest221of100,1,323,5288,15,157,5460
subtest28of10,pubtest221of100,1,323,5288,16,197,5501
subtest22of10,pubtest221of100,1,323,5288,18,233,5539
subtest210of10,pubtest221of100,1,323,5288,20,273,5581
subtest26of10,pubtest221of100,1,323,5288,23,310,5621
subtest29of10,pubtest221of100,1,323,5288,24,349,5661
subtest27of10,pubtest221of100,1,323,5288,26,387,5701
subtest22of10,pubtest222of100,1,323,5392,9,41,5442
subtest29of10,pubtest222of100,1,323,5392,17,71,5480
subtest21of10,pubtest222of100,1,323,5392,17,111,5520
subtest27of10,pubtest222of100,1,323,5392,20,149,5561
subtest23of10,pubtest222of100,1,323,5392,20,189,5601
subtest25of10,pubtest222of100,1,323,5392,21,229,5642
subtest28of10,pubtest222of100,1,323,5392,22,267,5681
subtest210of10,pubtest222of100,1,323,5392,24,305,5721
subtest26of10,pubtest222of100,1,323,5392,25,344,5761
subtest24of10,pubtest222of100,1,323,5392,28,381,5801
subtest21of10,pubtest223of100,1,323,5350,13,38,5401
subtest23of10,pubtest223of100,1,323,5350,14,76,5440
subtest28of10,pubtest223of100,1,323,5350,17,114,5481
subtest29of10,pubtest223of100,1,323,5350,21,149,5520
subtest24of10,pubtest223of100,1,323,5350,21,189,5560
subtest210of10,pubtest223of100,1,323,5350,22,228,5600
subtest27of10,pubtest223of100,1,323,5350,23,267,5640
subtest25of10,pubtest223of100,1,323,5350,27,303,5680
subtest22of10,pubtest223of100,1,323,5350,28,342,5720
subtest26of10,pubtest223of100,1,323,5350,32,379,5761
subtest21of10,pubtest224of100,1,323,5297,7,38,5342
subtest27of10,pubtest224of100,1,323,5297,7,77,5381
subtest23of10,pubtest224of100,1,323,5297,10,114,5421
subtest29of10,pubtest224of100,1,323,5297,16,148,5461
subtest25of10,pubtest224of100,1,323,5297,16,188,5501
subtest26of10,pubtest224of100,1,323,5297,22,223,5542
subtest28of10,pubtest224of100,1,323,5297,22,262,5581
subtest22of10,pubtest224of100,1,323,5297,24,300,5621
subtest24of10,pubtest224of100,1,323,5297,26,338,5661
subtest210of10,pubtest224of100,1,323,5297,27,377,5701
subtest27of10,pubtest225of100,1,323,5373,10,42,5425
subtest22of10,pubtest225of100,1,323,5373,10,81,5464
subtest21of10,pubtest225of100,1,323,5373,13,118,5504
subtest25of10,pubtest225of100,1,323,5373,14,158,5545
subtest26of10,pubtest225of100,1,323,5373,29,181,5583
subtest24of10,pubtest225of100,1,323,5373,30,221,5624
subtest23of10,pubtest225of100,1,323,5373,29,258,5660
subtest29of10,pubtest225of100,1,323,5373,34,297,5704
subtest28of10,pubtest225of100,1,323,5373,37,334,5744
subtest210of10,pubtest225of100,1,323,5373,38,373,5784
subtest25of10,pubtest226of100,1,323,5302,8,39,5349
subtest23of10,pubtest226of100,1,323,5302,8,78,5388
subtest27of10,pubtest226of100,1,323,5302,14,112,5428
subtest21of10,pubtest226of100,1,323,5302,15,152,5469
subtest22of10,pubtest226of100,1,323,5302,16,191,5509
subtest29of10,pubtest226of100,1,323,5302,17,230,5549
subtest210of10,pubtest226of100,1,323,5302,21,266,5589
subtest28of10,pubtest226of100,1,323,5302,22,303,5627
subtest26of10,pubtest226of100,1,323,5302,24,343,5669
subtest24of10,pubtest226of100,1,323,5302,24,382,5708
subtest210of10,pubtest227of100,1,323,5372,12,45,5429
subtest29of10,pubtest227of100,1,323,5372,11,85,5468
subtest23of10,pubtest227of100,1,323,5372,14,124,5510
subtest25of10,pubtest227of100,1,323,5372,15,164,5551
subtest24of10,pubtest227of100,1,323,5372,23,195,5590
subtest26of10,pubtest227of100,1,323,5372,35,223,5630
subtest27of10,pubtest227of100,1,323,5372,35,263,5670
subtest21of10,pubtest227of100,1,323,5372,38,300,5710
subtest22of10,pubtest227of100,1,323,5372,38,340,5750
subtest28of10,pubtest227of100,1,323,5372,43,375,5790
subtest21of10,pubtest228of100,1,323,5384,4,39,5427
subtest25of10,pubtest228of100,1,323,5384,10,73,5467
subtest24of10,pubtest228of100,1,323,5384,13,108,5505
subtest27of10,pubtest228of100,1,323,5384,13,148,5545
subtest210of10,pubtest228of100,1,323,5384,16,186,5586
subtest28of10,pubtest228of100,1,323,5384,17,225,5626
subtest22of10,pubtest228of100,1,323,5384,15,265,5664
subtest26of10,pubtest228of100,1,323,5384,10,305,5699
subtest29of10,pubtest228of100,1,323,5384,13,348,5745
subtest23of10,pubtest228of100,1,323,5384,18,383,5785
subtest24of10,pubtest229of100,1,321,5459,11,38,5508
subtest28of10,pubtest229of100,1,321,5459,15,74,5548
subtest21of10,pubtest229of100,1,321,5459,15,115,5589
subtest22of10,pubtest229of100,1,321,5459,16,151,5626
subtest27of10,pubtest229of100,1,321,5459,18,191,5668
subtest23of10,pubtest229of100,1,321,5459,19,230,5708
subtest210of10,pubtest229of100,1,321,5459,21,268,5748
subtest25of10,pubtest229of100,1,321,5459,21,308,5788
subtest29of10,pubtest229of100,1,321,5459,23,348,5830
subtest26of10,pubtest229of100,1,321,5459,24,385,5868
subtest22of10,pubtest230of100,1,323,5228,7,48,5283
subtest21of10,pubtest230of100,1,323,5228,8,87,5323
subtest27of10,pubtest230of100,1,323,5228,10,126,5364
subtest29of10,pubtest230of100,1,323,5228,14,160,5402
subtest28of10,pubtest230of100,1,323,5228,16,199,5443
subtest25of10,pubtest230of100,1,323,5228,16,239,5483
subtest23of10,pubtest230of100,1,323,5228,20,275,5523
subtest210of10,pubtest230of100,1,323,5228,23,311,5562
subtest24of10,pubtest230of100,1,323,5228,23,352,5603
subtest26of10,pubtest230of100,1,323,5228,27,389,5644
subtest23of10,pubtest231of100,1,323,5368,15,39,5422
subtest28of10,pubtest231of100,1,323,5368,15,78,5461
subtest25of10,pubtest231of100,1,323,5368,16,116,5500
subtest24of10,pubtest231of100,1,323,5368,18,154,5540
subtest29of10,pubtest231of100,1,323,5368,20,193,5581
subtest27of10,pubtest231of100,1,323,5368,21,232,5621
subtest210of10,pubtest231of100,1,323,5368,22,271,5661
subtest21of10,pubtest231of100,1,323,5368,23,310,5701
subtest22of10,pubtest231of100,1,323,5368,23,350,5741
subtest26of10,pubtest231of100,1,323,5368,25,388,5781
subtest21of10,pubtest232of100,1,323,5330,13,45,5388
subtest24of10,pubtest232of100,1,323,5330,17,81,5428
subtest27of10,pubtest232of100,1,323,5330,13,120,5463
subtest210of10,pubtest232of100,1,323,5330,16,159,5505
subtest28of10,pubtest232of100,1,323,5330,16,198,5544
subtest26of10,pubtest232of100,1,323,5330,19,238,5587
subtest22of10,pubtest232of100,1,323,5330,15,277,5622
subtest29of10,pubtest232of100,1,323,5330,14,317,5661
subtest23of10,pubtest232of100,1,323,5330,15,354,5699
subtest25of10,pubtest232of100,1,323,5330,17,394,5741
subtest29of10,pubtest233of100,1,323,5426,11,41,5478
subtest24of10,pubtest233of100,1,323,5426,12,79,5517
subtest25of10,pubtest233of100,1,323,5426,14,117,5557
subtest210of10,pubtest233of100,1,323,5426,17,154,5597
subtest23of10,pubtest233of100,1,323,5426,18,193,5637
subtest26of10,pubtest233of100,1,323,5426,19,232,5677
subtest22of10,pubtest233of100,1,323,5426,20,271,5717
subtest21of10,pubtest233of100,1,323,5426,21,311,5758
subtest28of10,pubtest233of100,1,323,5426,21,350,5797
subtest27of10,pubtest233of100,1,323,5426,17,394,5837
subtest25of10,pubtest234of100,1,323,5351,6,45,5402
subtest26of10,pubtest234of100,1,323,5351,7,84,5442
subtest27of10,pubtest234of100,1,323,5351,10,121,5482
subtest21of10,pubtest234of100,1,323,5351,16,155,5522
subtest29of10,pubtest234of100,1,323,5351,16,195,5562
subtest23of10,pubtest234of100,1,323,5351,21,230,5602
subtest210of10,pubtest234of100,1,323,5351,21,267,5639
subtest22of10,pubtest234of100,1,323,5351,21,307,5679
subtest24of10,pubtest234of100,1,323,5351,24,345,5720
subtest28of10,pubtest234of100,1,323,5351,25,386,5762
subtest21of10,pubtest235of100,1,321,5239,9,38,5286
subtest23of10,pubtest235of100,1,321,5239,12,74,5325
subtest27of10,pubtest235of100,1,321,5239,16,110,5365
subtest210of10,pubtest235of100,1,321,5239,16,454,5709
subtest22of10,pubtest235of100,1,321,5239,17,495,5751
subtest29of10,pubtest235of100,1,321,5239,22,529,5790
subtest25of10,pubtest235of100,1,321,5239,22,568,5829
subtest24of10,pubtest235of100,1,321,5239,24,606,5869
subtest26of10,pubtest235of100,1,321,5239,25,646,5910
subtest28of10,pubtest235of100,1,321,5239,31,679,5949
subtest23of10,pubtest236of100,1,323,5322,8,41,5371
subtest27of10,pubtest236of100,1,323,5322,12,76,5410
subtest25of10,pubtest236of100,1,323,5322,16,112,5450
subtest21of10,pubtest236of100,1,323,5322,18,150,5490
subtest29of10,pubtest236of100,1,323,5322,19,189,5530
subtest210of10,pubtest236of100,1,323,5322,23,225,5570
subtest28of10,pubtest236of100,1,323,5322,23,263,5608
subtest22of10,pubtest236of100,1,323,5322,26,302,5650
subtest24of10,pubtest236of100,1,323,5322,27,341,5690
subtest26of10,pubtest236of100,1,323,5322,28,380,5730
subtest24of10,pubtest237of100,1,323,5654,10,162,5826
subtest28of10,pubtest237of100,1,323,5654,19,191,5864
subtest25of10,pubtest237of100,1,323,5654,21,230,5905
subtest23of10,pubtest237of100,1,323,5654,22,268,5944
subtest26of10,pubtest237of100,1,323,5654,22,308,5984
subtest27of10,pubtest237of100,1,323,5654,24,346,6024
subtest29of10,pubtest237of100,1,323,5654,24,386,6064
subtest21of10,pubtest237of100,1,323,5654,24,425,6103
subtest22of10,pubtest237of100,1,323,5654,28,462,6144
subtest210of10,pubtest237of100,1,323,5654,29,500,6183
subtest22of10,pubtest238of100,1,323,5583,11,46,5640
subtest27of10,pubtest238of100,1,323,5583,12,85,5680
subtest28of10,pubtest238of100,1,323,5583,13,123,5719
subtest210of10,pubtest238of100,1,323,5583,15,161,5759
subtest29of10,pubtest238of100,1,323,5583,11,200,5794
subtest25of10,pubtest238of100,1,323,5583,18,237,5838
subtest26of10,pubtest238of100,1,323,5583,24,272,5879
subtest21of10,pubtest238of100,1,323,5583,31,305,5919
subtest23of10,pubtest238of100,1,323,5583,31,345,5959
subtest24of10,pubtest238of100,1,323,5583,32,384,5999
subtest21of10,pubtest239of100,1,323,5456,7,40,5503
subtest28of10,pubtest239of100,1,323,5456,11,77,5544
subtest27of10,pubtest239of100,1,323,5456,18,110,5584
subtest26of10,pubtest239of100,1,323,5456,21,147,5624
subtest29of10,pubtest239of100,1,323,5456,22,187,5665
subtest25of10,pubtest239of100,1,323,5456,21,226,5703
subtest23of10,pubtest239of100,1,323,5456,24,264,5744
subtest22of10,pubtest239of100,1,323,5456,28,300,5784
subtest210of10,pubtest239of100,1,323,5456,29,339,5824
subtest24of10,pubtest239of100,1,323,5456,28,378,5862
subtest210of10,pubtest240of100,1,323,5242,9,42,5293
subtest25of10,pubtest240of100,1,323,5242,9,81,5332
subtest21of10,pubtest240of100,1,323,5242,18,111,5371
subtest29of10,pubtest240of100,1,323,5242,18,151,5411
subtest27of10,pubtest240of100,1,323,5242,27,183,5452
subtest28of10,pubtest240of100,1,323,5242,27,223,5492
subtest26of10,pubtest240of100,1,323,5242,29,261,5532
subtest24of10,pubtest240of100,1,323,5242,29,301,5572
subtest22of10,pubtest240of100,1,323,5242,28,342,5612
subtest23of10,pubtest240of100,1,323,5242,31,381,5654
subtest23of10,pubtest241of100,1,323,5300,13,41,5354
subtest27of10,pubtest241of100,1,323,5300,14,79,5393
subtest24of10,pubtest241of100,1,323,5300,16,118,5434
subtest21of10,pubtest241of100,1,323,5300,16,157,5473
subtest29of10,pubtest241of100,1,323,5300,18,195,5513
subtest210of10,pubtest241of100,1,323,5300,18,235,5553
subtest25of10,pubtest241of100,1,323,5300,20,272,5592
subtest28of10,pubtest241of100,1,323,5300,21,312,5633
subtest26of10,pubtest241of100,1,323,5300,23,349,5672
subtest22of10,pubtest241of100,1,323,5300,25,388,5713
subtest27of10,pubtest242of100,1,323,5375,8,325,5708
subtest23of10,pubtest242of100,1,323,5375,9,363,5747
subtest26of10,pubtest242of100,1,323,5375,12,400,5787
subtest29of10,pubtest242of100,1,323,5375,16,436,5827
subtest21of10,pubtest242of100,1,323,5375,18,474,5867
subtest25of10,pubtest242of100,1,323,5375,19,515,5909
subtest210of10,pubtest242of100,1,323,5375,19,554,5948
subtest22of10,pubtest242of100,1,323,5375,21,591,5987
subtest24of10,pubtest242of100,1,323,5375,24,628,6027
subtest28of10,pubtest242of100,1,323,5375,24,668,6067
subtest29of10,pubtest243of100,1,323,5301,11,47,5359
subtest28of10,pubtest243of100,1,323,5301,12,80,5393
subtest23of10,pubtest243of100,1,323,5301,15,116,5432
subtest25of10,pubtest243of100,1,323,5301,19,152,5472
subtest22of10,pubtest243of100,1,323,5301,52,159,5512
subtest27of10,pubtest243of100,1,323,5301,53,197,5551
subtest26of10,pubtest243of100,1,323,5301,54,234,5589
subtest24of10,pubtest243of100,1,323,5301,56,274,5631
subtest210of10,pubtest243of100,1,323,5301,56,313,5670
subtest21of10,pubtest243of100,1,323,5301,56,353,5710
subtest27of10,pubtest244of100,1,323,5393,13,39,5445
subtest26of10,pubtest244of100,1,323,5393,11,79,5483
subtest25of10,pubtest244of100,1,323,5393,13,118,5524
subtest29of10,pubtest244of100,1,323,5393,17,155,5565
subtest21of10,pubtest244of100,1,323,5393,20,192,5605
subtest28of10,pubtest244of100,1,323,5393,20,232,5645
subtest23of10,pubtest244of100,1,323,5393,22,270,5685
subtest210of10,pubtest244of100,1,323,5393,23,310,5726
subtest22of10,pubtest244of100,1,323,5393,24,346,5763
subtest24of10,pubtest244of100,1,323,5393,25,386,5804
subtest29of10,pubtest245of100,1,322,5426,11,45,5482
subtest26of10,pubtest245of100,1,322,5426,11,84,5521
subtest23of10,pubtest245of100,1,322,5426,15,120,5561
subtest22of10,pubtest245of100,1,322,5426,16,158,5600
subtest25of10,pubtest245of100,1,322,5426,17,196,5639
subtest24of10,pubtest245of100,1,322,5426,20,235,5681
subtest21of10,pubtest245of100,1,322,5426,45,250,5721
subtest28of10,pubtest245of100,1,322,5426,46,289,5761
subtest27of10,pubtest245of100,1,322,5426,47,328,5801
subtest210of10,pubtest245of100,1,322,5426,48,367,5841
subtest26of10,pubtest246of100,1,323,5739,8,43,5790
subtest27of10,pubtest246of100,1,323,5739,10,80,5829
subtest21of10,pubtest246of100,1,323,5739,11,119,5869
subtest29of10,pubtest246of100,1,323,5739,16,155,5910
subtest23of10,pubtest246of100,1,323,5739,16,194,5949
subtest28of10,pubtest246of100,1,323,5739,16,233,5988
subtest25of10,pubtest246of100,1,323,5739,20,270,6029
subtest210of10,pubtest246of100,1,323,5739,24,306,6069
subtest24of10,pubtest246of100,1,323,5739,29,342,6110
subtest22of10,pubtest246of100,1,323,5739,29,381,6149
subtest27of10,pubtest247of100,1,323,5431,11,229,5671
subtest26of10,pubtest247of100,1,323,5431,11,229,5671
subtest23of10,pubtest247of100,1,323,5431,19,261,5711
subtest22of10,pubtest247of100,1,323,5431,25,295,5751
subtest28of10,pubtest247of100,1,323,5431,25,334,5790
subtest21of10,pubtest247of100,1,323,5431,26,374,5831
subtest210of10,pubtest247of100,1,323,5431,27,411,5869
subtest29of10,pubtest247of100,1,323,5431,51,429,5911
subtest24of10,pubtest247of100,1,323,5431,52,468,5951
subtest25of10,pubtest247of100,1,323,5431,55,505,5991
subtest29of10,pubtest248of100,1,323,5234,13,40,5287
subtest26of10,pubtest248of100,1,323,5234,14,78,5326
subtest25of10,pubtest248of100,1,323,5234,15,117,5366
subtest23of10,pubtest248of100,1,323,5234,16,155,5405
subtest28of10,pubtest248of100,1,323,5234,18,194,5446
subtest27of10,pubtest248of100,1,323,5234,23,229,5486
subtest21of10,pubtest248of100,1,323,5234,25,267,5526
subtest24of10,pubtest248of100,1,323,5234,26,305,5565
subtest22of10,pubtest248of100,1,323,5234,27,345,5606
subtest210of10,pubtest248of100,1,323,5234,28,384,5646
subtest27of10,pubtest249of100,1,323,5421,10,41,5472
subtest28of10,pubtest249of100,1,323,5421,13,78,5512
subtest25of10,pubtest249of100,1,323,5421,13,116,5550
subtest24of10,pubtest249of100,1,323,5421,18,152,5591
subtest21of10,pubtest249of100,1,323,5421,18,192,5631
subtest29of10,pubtest249of100,1,323,5421,19,233,5673
subtest26of10,pubtest249of100,1,323,5421,53,238,5712
subtest23of10,pubtest249of100,1,323,5421,57,273,5751
subtest22of10,pubtest249of100,1,323,5421,57,313,5791
subtest210of10,pubtest249of100,1,323,5421,59,351,5831
subtest27of10,pubtest250of100,1,323,5289,11,42,5342
subtest23of10,pubtest250of100,1,323,5289,14,78,5381
subtest21of10,pubtest250of100,1,323,5289,16,115,5420
subtest29of10,pubtest250of100,1,323,5289,16,155,5460
subtest28of10,pubtest250of100,1,323,5289,15,193,5497
subtest25of10,pubtest250of100,1,323,5289,60,191,5540
subtest24of10,pubtest250of100,1,323,5289,60,231,5580
subtest210of10,pubtest250of100,1,323,5289,64,265,5618
subtest26of10,pubtest250of100,1,323,5289,65,305,5659
subtest22of10,pubtest250of100,1,323,5289,66,344,5699
subtest22of10,pubtest251of100,1,323,5319,12,42,5373
subtest23of10,pubtest251of100,1,323,5319,12,79,5410
subtest24of10,pubtest251of100,1,323,5319,14,118,5451
subtest27of10,pubtest251of100,1,323,5319,21,152,5492
subtest25of10,pubtest251of100,1,323,5319,22,189,5530
subtest21of10,pubtest251of100,1,323,5319,24,228,5571
subtest26of10,pubtest251of100,1,323,5319,26,268,5613
subtest28of10,pubtest251of100,1,323,5319,22,306,5647
subtest210of10,pubtest251of100,1,323,5319,27,345,5691
subtest29of10,pubtest251of100,1,323,5319,27,384,5730
subtest27of10,pubtest252of100,1,323,5546,18,45,5609
subtest29of10,pubtest252of100,1,323,5546,15,87,5648
subtest21of10,pubtest252of100,1,323,5546,15,127,5688
subtest25of10,pubtest252of100,1,323,5546,18,164,5728
subtest23of10,pubtest252of100,1,323,5546,20,204,5770
subtest210of10,pubtest252of100,1,323,5546,23,240,5809
subtest22of10,pubtest252of100,1,323,5546,23,279,5848
subtest24of10,pubtest252of100,1,323,5546,24,318,5888
subtest26of10,pubtest252of100,1,323,5546,22,358,5926
subtest28of10,pubtest252of100,1,323,5546,26,396,5968
subtest28of10,pubtest253of100,1,322,5526,12,53,5591
subtest23of10,pubtest253of100,1,322,5526,17,87,5630
subtest25of10,pubtest253of100,1,322,5526,18,126,5670
subtest29of10,pubtest253of100,1,322,5526,19,165,5710
subtest24of10,pubtest253of100,1,322,5526,20,204,5750
subtest27of10,pubtest253of100,1,322,5526,20,243,5789
subtest210of10,pubtest253of100,1,322,5526,22,282,5830
subtest22of10,pubtest253of100,1,322,5526,22,322,5870
subtest21of10,pubtest253of100,1,322,5526,23,361,5910
subtest26of10,pubtest253of100,1,322,5526,26,398,5950
subtest210of10,pubtest254of100,1,323,6093,14,42,6149
subtest27of10,pubtest254of100,1,323,6093,15,80,6188
subtest25of10,pubtest254of100,1,323,6093,17,118,6228
subtest21of10,pubtest254of100,1,323,6093,17,158,6268
subtest28of10,pubtest254of100,1,323,6093,18,197,6308
subtest23of10,pubtest254of100,1,323,6093,18,234,6345
subtest24of10,pubtest254of100,1,323,6093,21,273,6387
subtest22of10,pubtest254of100,1,323,6093,22,313,6428
subtest26of10,pubtest254of100,1,323,6093,23,352,6468
subtest29of10,pubtest254of100,1,323,6093,24,391,6508
subtest22of10,pubtest255of100,1,322,5277,11,43,5331
subtest23of10,pubtest255of100,1,322,5277,12,79,5368
subtest27of10,pubtest255of100,1,322,5277,15,118,5410
subtest28of10,pubtest255of100,1,322,5277,15,158,5450
subtest29of10,pubtest255of100,1,322,5277,17,197,5491
subtest24of10,pubtest255of100,1,322,5277,17,236,5530
subtest21of10,pubtest255of100,1,322,5277,18,275,5570
subtest25of10,pubtest255of100,1,322,5277,20,315,5612
subtest210of10,pubtest255of100,1,322,5277,23,351,5651
subtest26of10,pubtest255of100,1,322,5277,24,390,5691
subtest29of10,pubtest256of100,1,323,5380,16,39,5435
subtest21of10,pubtest256of100,1,323,5380,53,41,5474
subtest23of10,pubtest256of100,1,323,5380,54,80,5514
subtest26of10,pubtest256of100,1,323,5380,60,113,5553
subtest25of10,pubtest256of100,1,323,5380,124,89,5593
subtest27of10,pubtest256of100,1,323,5380,125,127,5632
subtest210of10,pubtest256of100,1,323,5380,126,167,5673
subtest28of10,pubtest256of100,1,323,5380,128,204,5712
subtest24of10,pubtest256of100,1,323,5380,130,243,5753
subtest22of10,pubtest256of100,1,323,5380,128,284,5792
subtest24of10,pubtest257of100,1,323,5639,34,41,5714
subtest21of10,pubtest257of100,1,323,5639,34,80,5753
subtest27of10,pubtest257of100,1,323,5639,61,93,5793
subtest28of10,pubtest257of100,1,323,5639,61,133,5833
subtest210of10,pubtest257of100,1,323,5639,66,167,5872
subtest23of10,pubtest257of100,1,323,5639,62,206,5907
subtest22of10,pubtest257of100,1,323,5639,68,246,5953
subtest26of10,pubtest257of100,1,323,5639,66,287,5992
subtest29of10,pubtest257of100,1,323,5639,62,328,6029
subtest25of10,pubtest257of100,1,323,5639,65,365,6069
subtest28of10,pubtest258of100,1,323,5469,8,40,5517
subtest23of10,pubtest258of100,1,323,5469,11,76,5556
subtest25of10,pubtest258of100,1,323,5469,11,116,5596
subtest26of10,pubtest258of100,1,323,5469,13,154,5636
subtest21of10,pubtest258of100,1,323,5469,17,190,5676
subtest29of10,pubtest258of100,1,323,5469,18,230,5717
subtest210of10,pubtest258of100,1,323,5469,22,265,5756
subtest27of10,pubtest258of100,1,323,5469,23,304,5796
subtest22of10,pubtest258of100,1,323,5469,24,343,5836
subtest24of10,pubtest258of100,1,323,5469,29,378,5876
subtest21of10,pubtest259of100,1,323,5317,15,41,5373
subtest28of10,pubtest259of100,1,323,5317,16,81,5414
subtest24of10,pubtest259of100,1,323,5317,26,109,5452
subtest25of10,pubtest259of100,1,323,5317,26,149,5492
subtest26of10,pubtest259of100,1,323,5317,27,188,5532
subtest27of10,pubtest259of100,1,323,5317,28,227,5572
subtest23of10,pubtest259of100,1,323,5317,29,266,5612
subtest22of10,pubtest259of100,1,323,5317,33,300,5650
subtest29of10,pubtest259of100,1,323,5317,33,340,5690
subtest210of10,pubtest259of100,1,323,5317,37,378,5732
subtest210of10,pubtest260of100,1,323,5438,9,41,5488
subtest23of10,pubtest260of100,1,323,5438,15,75,5528
subtest21of10,pubtest260of100,1,323,5438,15,115,5568
subtest27of10,pubtest260of100,1,323,5438,17,153,5608
subtest26of10,pubtest260of100,1,323,5438,18,192,5648
subtest22of10,pubtest260of100,1,323,5438,25,225,5688
subtest28of10,pubtest260of100,1,323,5438,25,265,5728
subtest25of10,pubtest260of100,1,323,5438,27,303,5768
subtest24of10,pubtest260of100,1,323,5438,27,344,5809
subtest29of10,pubtest260of100,1,323,5438,25,382,5845
subtest25of10,pubtest261of100,1,323,5362,17,39,5418
subtest29of10,pubtest261of100,1,323,5362,20,75,5457
subtest28of10,pubtest261of100,1,323,5362,20,115,5497
subtest23of10,pubtest261of100,1,323,5362,21,154,5537
subtest210of10,pubtest261of100,1,323,5362,22,193,5577
subtest27of10,pubtest261of100,1,323,5362,23,232,5617
subtest22of10,pubtest261of100,1,323,5362,27,269,5658
subtest24of10,pubtest261of100,1,323,5362,28,307,5697
subtest21of10,pubtest261of100,1,323,5362,28,347,5737
subtest26of10,pubtest261of100,1,323,5362,30,385,5777
subtest21of10,pubtest262of100,1,323,5356,15,42,5413
subtest23of10,pubtest262of100,1,323,5356,17,79,5452
subtest27of10,pubtest262of100,1,323,5356,18,118,5492
subtest25of10,pubtest262of100,1,323,5356,19,157,5532
subtest29of10,pubtest262of100,1,323,5356,19,197,5572
subtest26of10,pubtest262of100,1,323,5356,21,235,5612
subtest210of10,pubtest262of100,1,323,5356,21,275,5652
subtest22of10,pubtest262of100,1,323,5356,15,321,5692
subtest24of10,pubtest262of100,1,323,5356,25,351,5732
subtest28of10,pubtest262of100,1,323,5356,28,388,5772
subtest22of10,pubtest263of100,1,322,5256,5,45,5306
subtest29of10,pubtest263of100,1,322,5256,7,83,5346
subtest24of10,pubtest263of100,1,322,5256,9,121,5386
subtest23of10,pubtest263of100,1,322,5256,13,158,5427
subtest26of10,pubtest263of100,1,322,5256,21,187,5464
subtest27of10,pubtest263of100,1,322,5256,24,226,5506
subtest25of10,pubtest263of100,1,322,5256,25,266,5547
subtest21of10,pubtest263of100,1,322,5256,25,305,5586
subtest210of10,pubtest263of100,1,322,5256,28,342,5626
subtest28of10,pubtest263of100,1,322,5256,29,381,5666
subtest22of10,pubtest264of100,1,322,5402,12,40,5454
subtest29of10,pubtest264of100,1,322,5402,16,75,5493
subtest23of10,pubtest264of100,1,322,5402,20,111,5533
subtest24of10,pubtest264of100,1,322,5402,22,150,5574
subtest27of10,pubtest264of100,1,322,5402,22,189,5613
subtest21of10,pubtest264of100,1,322,5402,24,227,5653
subtest25of10,pubtest264of100,1,322,5402,27,264,5693
subtest28of10,pubtest264of100,1,322,5402,27,304,5733
subtest26of10,pubtest264of100,1,322,5402,29,342,5773
subtest210of10,pubtest264of100,1,322,5402,30,381,5813
subtest26of10,pubtest265of100,1,323,5441,16,41,5498
subtest27of10,pubtest265of100,1,323,5441,16,79,5536
subtest210of10,pubtest265of100,1,323,5441,18,117,5576
subtest21of10,pubtest265of100,1,323,5441,21,154,5616
subtest29of10,pubtest265of100,1,323,5441,21,194,5656
subtest25of10,pubtest265of100,1,323,5441,22,233,5696
subtest23of10,pubtest265of100,1,323,5441,24,272,5737
subtest22of10,pubtest265of100,1,323,5441,24,311,5776
subtest24of10,pubtest265of100,1,323,5441,26,348,5815
subtest28of10,pubtest265of100,1,323,5441,25,387,5853
subtest29of10,pubtest266of100,1,321,5316,17,42,5375
subtest25of10,pubtest266of100,1,321,5316,19,79,5414
subtest210of10,pubtest266of100,1,321,5316,19,119,5454
subtest27of10,pubtest266of100,1,321,5316,21,155,5492
subtest26of10,pubtest266of100,1,321,5316,24,194,5534
subtest23of10,pubtest266of100,1,321,5316,22,234,5572
subtest21of10,pubtest266of100,1,321,5316,26,272,5614
subtest28of10,pubtest266of100,1,321,5316,28,310,5654
subtest24of10,pubtest266of100,1,321,5316,29,350,5695
subtest22of10,pubtest266of100,1,321,5316,31,389,5736
subtest23of10,pubtest267of100,1,323,5253,8,38,5299
subtest26of10,pubtest267of100,1,323,5253,9,76,5338
subtest28of10,pubtest267of100,1,323,5253,14,111,5378
subtest25of10,pubtest267of100,1,323,5253,14,151,5418
subtest27of10,pubtest267of100,1,323,5253,22,183,5458
subtest24of10,pubtest267of100,1,323,5253,23,222,5498
subtest29of10,pubtest267of100,1,323,5253,26,259,5538
subtest22of10,pubtest267of100,1,323,5253,26,299,5578
subtest21of10,pubtest267of100,1,323,5253,28,337,5618
subtest210of10,pubtest267of100,1,323,5253,28,376,5657
subtest23of10,pubtest268of100,1,323,5388,10,41,5439
subtest24of10,pubtest268of100,1,323,5388,16,74,5478
subtest25of10,pubtest268of100,1,323,5388,16,115,5519
subtest29of10,pubtest268of100,1,323,5388,21,149,5558
subtest27of10,pubtest268of100,1,323,5388,22,188,5598
subtest28of10,pubtest268of100,1,323,5388,23,227,5638
subtest21of10,pubtest268of100,1,323,5388,28,262,5678
subtest22of10,pubtest268of100,1,323,5388,28,302,5718
subtest210of10,pubtest268of100,1,323,5388,32,338,5758
subtest26of10,pubtest268of100,1,323,5388,32,378,5798
subtest24of10,pubtest269of100,1,323,5368,20,41,5429
subtest26of10,pubtest269of100,1,323,5368,24,77,5469
subtest210of10,pubtest269of100,1,323,5368,21,116,5505
subtest27of10,pubtest269of100,1,323,5368,20,157,5545
subtest25of10,pubtest269of100,1,323,5368,86,135,5589
subtest21of10,pubtest269of100,1,323,5368,87,173,5628
subtest22of10,pubtest269of100,1,323,5368,88,212,5668
subtest29of10,pubtest269of100,1,323,5368,90,250,5708
subtest23of10,pubtest269of100,1,323,5368,90,290,5748
subtest28of10,pubtest269of100,1,323,5368,92,328,5788
subtest23of10,pubtest270of100,1,323,5253,19,42,5314
subtest26of10,pubtest270of100,1,323,5253,20,80,5353
subtest29of10,pubtest270of100,1,323,5253,21,117,5391
subtest27of10,pubtest270of100,1,323,5253,21,157,5431
subtest210of10,pubtest270of100,1,323,5253,23,196,5472
subtest25of10,pubtest270of100,1,323,5253,23,236,5512
subtest21of10,pubtest270of100,1,323,5253,30,269,5552
subtest28of10,pubtest270of100,1,323,5253,30,309,5592
subtest24of10,pubtest270of100,1,323,5253,33,345,5631
subtest22of10,pubtest270of100,1,323,5253,33,385,5671
subtest24of10,pubtest271of100,1,323,5363,7,218,5588
subtest25of10,pubtest271of100,1,323,5363,12,253,5628
subtest22of10,pubtest271of100,1,323,5363,14,291,5668
subtest21of10,pubtest271of100,1,323,5363,14,331,5708
subtest210of10,pubtest271of100,1,323,5363,18,365,5746
subtest29of10,pubtest271of100,1,323,5363,18,405,5786
subtest27of10,pubtest271of100,1,323,5363,13,444,5820
subtest26of10,pubtest271of100,1,323,5363,19,484,5866
subtest23of10,pubtest271of100,1,323,5363,17,524,5904
subtest28of10,pubtest271of100,1,323,5363,19,564,5946
subtest25of10,pubtest272of100,1,323,5334,12,42,5388
subtest26of10,pubtest272of100,1,323,5334,14,79,5427
subtest21of10,pubtest272of100,1,323,5334,16,119,5469
subtest29of10,pubtest272of100,1,323,5334,18,156,5508
subtest23of10,pubtest272of100,1,323,5334,21,193,5548
subtest27of10,pubtest272of100,1,323,5334,21,233,5588
subtest210of10,pubtest272of100,1,323,5334,23,271,5628
subtest24of10,pubtest272of100,1,323,5334,23,311,5668
subtest22of10,pubtest272of100,1,323,5334,29,345,5708
subtest28of10,pubtest272of100,1,323,5334,29,385,5748
subtest22of10,pubtest273of100,1,321,5459,12,41,5512
subtest29of10,pubtest273of100,1,321,5459,13,79,5551
subtest26of10,pubtest273of100,1,321,5459,15,117,5591
subtest28of10,pubtest273of100,1,321,5459,15,157,5631
subtest210of10,pubtest273of100,1,321,5459,16,196,5671
subtest25of10,pubtest273of100,1,321,5459,22,230,5711
subtest24of10,pubtest273of100,1,321,5459,22,270,5751
subtest27of10,pubtest273of100,1,321,5459,44,288,5791
subtest23of10,pubtest273of100,1,321,5459,45,327,5831
subtest21of10,pubtest273of100,1,321,5459,46,366,5871
subtest21of10,pubtest274of100,1,323,5342,9,42,5393
subtest23of10,pubtest274of100,1,323,5342,13,76,5431
subtest25of10,pubtest274of100,1,323,5342,15,115,5472
subtest26of10,pubtest274of100,1,323,5342,12,159,5513
subtest29of10,pubtest274of100,1,323,5342,16,194,5552
subtest22of10,pubtest274of100,1,323,5342,17,235,5594
subtest27of10,pubtest274of100,1,323,5342,28,262,5632
subtest28of10,pubtest274of100,1,323,5342,29,302,5673
subtest24of10,pubtest274of100,1,323,5342,32,338,5712
subtest210of10,pubtest274of100,1,323,5342,34,376,5752
subtest27of10,pubtest275of100,1,323,5487,16,44,5547
subtest24of10,pubtest275of100,1,323,5487,17,82,5586
subtest29of10,pubtest275of100,1,323,5487,18,121,5626
subtest210of10,pubtest275of100,1,323,5487,19,160,5666
subtest22of10,pubtest275of100,1,323,5487,20,199,5706
subtest28of10,pubtest275of100,1,323,5487,21,238,5746
subtest21of10,pubtest275of100,1,323,5487,21,278,5786
subtest23of10,pubtest275of100,1,323,5487,22,317,5826
subtest26of10,pubtest275of100,1,323,5487,22,357,5866
subtest25of10,pubtest275of100,1,323,5487,25,394,5906
subtest28of10,pubtest276of100,1,323,5380,10,38,5428
subtest21of10,pubtest276of100,1,323,5380,13,74,5467
subtest25of10,pubtest276of100,1,323,5380,16,111,5507
subtest27of10,pubtest276of100,1,323,5380,17,148,5545
subtest24of10,pubtest276of100,1,323,5380,19,189,5588
subtest29of10,pubtest276of100,1,323,5380,19,228,5627
subtest23of10,pubtest276of100,1,323,5380,21,266,5667
subtest210of10,pubtest276of100,1,323,5380,37,291,5708
subtest26of10,pubtest276of100,1,323,5380,36,330,5746
subtest22of10,pubtest276of100,1,323,5380,38,369,5787
subtest22of10,pubtest277of100,1,323,5387,19,43,5449
subtest29of10,pubtest277of100,1,323,5387,21,78,5486
subtest21of10,pubtest277of100,1,323,5387,23,115,5525
subtest24of10,pubtest277of100,1,323,5387,24,154,5565
subtest210of10,pubtest277of100,1,323,5387,26,192,5605
subtest25of10,pubtest277of100,1,323,5387,26,232,5645
subtest27of10,pubtest277of100,1,323,5387,25,271,5683
subtest26of10,pubtest277of100,1,323,5387,27,310,5724
subtest23of10,pubtest277of100,1,323,5387,27,351,5765
subtest28of10,pubtest277of100,1,323,5387,19,356,5762
subtest29of10,pubtest278of100,1,323,5243,35,40,5318
subtest22of10,pubtest278of100,1,323,5243,35,80,5358
subtest21of10,pubtest278of100,1,323,5243,38,117,5398
subtest23of10,pubtest278of100,1,323,5243,37,157,5437
subtest28of10,pubtest278of100,1,323,5243,37,193,5473
subtest27of10,pubtest278of100,1,323,5243,42,232,5517
subtest25of10,pubtest278of100,1,323,5243,43,271,5557
subtest26of10,pubtest278of100,1,323,5243,81,273,5597
subtest24of10,pubtest278of100,1,323,5243,82,312,5637
subtest210of10,pubtest278of100,1,323,5243,83,351,5677
subtest28of10,pubtest279of100,1,323,5370,9,45,5424
subtest25of10,pubtest279of100,1,323,5370,9,81,5460
subtest21of10,pubtest279of100,1,323,5370,13,118,5501
subtest24of10,pubtest279of100,1,323,5370,14,157,5541
subtest29of10,pubtest279of100,1,323,5370,15,197,5582
subtest26of10,pubtest279of100,1,323,5370,16,235,5621
subtest27of10,pubtest279of100,1,323,5370,17,275,5662
subtest23of10,pubtest279of100,1,323,5370,22,309,5701
subtest22of10,pubtest279of100,1,323,5370,23,347,5740
subtest210of10,pubtest279of100,1,323,5370,24,387,5781
subtest29of10,pubtest280of100,1,323,5619,12,39,5670
subtest27of10,pubtest280of100,1,323,5619,11,78,5708
subtest21of10,pubtest280of100,1,323,5619,13,116,5748
subtest23of10,pubtest280of100,1,323,5619,14,155,5788
subtest25of10,pubtest280of100,1,323,5619,15,193,5827
subtest24of10,pubtest280of100,1,323,5619,21,228,5868
subtest26of10,pubtest280of100,1,323,5619,21,268,5908
subtest210of10,pubtest280of100,1,323,5619,23,306,5948
subtest28of10,pubtest280of100,1,323,5619,23,346,5988
subtest22of10,pubtest280of100,1,323,5619,24,385,6028
subtest24of10,pubtest281of100,1,323,5314,9,39,5362
subtest28of10,pubtest281of100,1,323,5314,12,75,5401
subtest23of10,pubtest281of100,1,323,5314,16,111,5441
subtest27of10,pubtest281of100,1,323,5314,20,147,5481
subtest22of10,pubtest281of100,1,323,5314,21,185,5520
subtest210of10,pubtest281of100,1,323,5314,23,224,5561
subtest25of10,pubtest281of100,1,323,5314,25,263,5602
subtest21of10,pubtest281of100,1,323,5314,25,302,5641
subtest29of10,pubtest281of100,1,323,5314,29,339,5682
subtest26of10,pubtest281of100,1,323,5314,30,375,5719
subtest23of10,pubtest282of100,1,323,5344,17,41,5402
subtest21of10,pubtest282of100,1,323,5344,19,79,5442
subtest27of10,pubtest282of100,1,323,5344,21,116,5481
subtest25of10,pubtest282of100,1,323,5344,21,156,5521
subtest24of10,pubtest282of100,1,323,5344,24,192,5560
subtest29of10,pubtest282of100,1,323,5344,21,232,5597
subtest26of10,pubtest282of100,1,323,5344,26,271,5641
subtest28of10,pubtest282of100,1,323,5344,27,311,5682
subtest210of10,pubtest282of100,1,323,5344,28,349,5721
subtest22of10,pubtest282of100,1,323,5344,24,389,5757
subtest24of10,pubtest283of100,1,323,5337,37,38,5412
subtest27of10,pubtest283of100,1,323,5337,44,69,5450
subtest21of10,pubtest283of100,1,323,5337,47,106,5490
subtest22of10,pubtest283of100,1,323,5337,46,146,5529
subtest210of10,pubtest283of100,1,323,5337,48,186,5571
subtest23of10,pubtest283of100,1,323,5337,45,224,5606
subtest28of10,pubtest283of100,1,323,5337,50,265,5652
subtest25of10,pubtest283of100,1,323,5337,46,304,5687
subtest29of10,pubtest283of100,1,323,5337,60,334,5731
subtest26of10,pubtest283of100,1,323,5337,61,374,5772
subtest25of10,pubtest284of100,1,323,5311,14,52,5377
subtest22of10,pubtest284of100,1,323,5311,14,91,5416
subtest210of10,pubtest284of100,1,323,5311,16,127,5454
subtest24of10,pubtest284of100,1,323,5311,19,165,5495
subtest27of10,pubtest284of100,1,323,5311,20,204,5535
subtest26of10,pubtest284of100,1,323,5311,22,242,5575
subtest23of10,pubtest284of100,1,323,5311,24,280,5615
subtest29of10,pubtest284of100,1,323,5311,16,320,5647
subtest28of10,pubtest284of100,1,323,5311,25,357,5693
subtest21of10,pubtest284of100,1,323,5311,25,397,5733
subtest23of10,pubtest285of100,1,323,5488,9,43,5540
subtest24of10,pubtest285of100,1,323,5488,11,80,5579
subtest25of10,pubtest285of100,1,323,5488,12,119,5619
subtest27of10,pubtest285of100,1,323,5488,14,157,5659
subtest22of10,pubtest285of100,1,323,5488,25,186,5699
subtest21of10,pubtest285of100,1,323,5488,28,223,5739
subtest28of10,pubtest285of100,1,323,5488,31,259,5778
subtest210of10,pubtest285of100,1,323,5488,32,299,5819
subtest29of10,pubtest285of100,1,323,5488,29,339,5856
subtest26of10,pubtest285of100,1,323,5488,33,378,5899
subtest23of10,pubtest286of100,1,323,5381,11,39,5431
subtest25of10,pubtest286of100,1,323,5381,16,73,5470
subtest210of10,pubtest286of100,1,323,5381,21,108,5510
subtest29of10,pubtest286of100,1,323,5381,21,148,5550
subtest21of10,pubtest286of100,1,323,5381,26,183,5590
subtest24of10,pubtest286of100,1,323,5381,26,222,5629
subtest27of10,pubtest286of100,1,323,5381,28,261,5670
subtest26of10,pubtest286of100,1,323,5381,33,296,5710
subtest22of10,pubtest286of100,1,323,5381,35,334,5750
subtest28of10,pubtest286of100,1,323,5381,37,372,5790
subtest26of10,pubtest287of100,1,323,5356,11,41,5408
subtest29of10,pubtest287of100,1,323,5356,13,80,5449
subtest28of10,pubtest287of100,1,323,5356,14,119,5489
subtest27of10,pubtest287of100,1,323,5356,18,155,5529
subtest25of10,pubtest287of100,1,323,5356,19,194,5569
subtest210of10,pubtest287of100,1,323,5356,20,233,5609
subtest21of10,pubtest287of100,1,323,5356,22,272,5650
subtest24of10,pubtest287of100,1,323,5356,23,310,5689
subtest23of10,pubtest287of100,1,323,5356,23,349,5728
subtest22of10,pubtest287of100,1,323,5356,25,389,5770
subtest29of10,pubtest288of100,1,323,5363,9,40,5412
subtest25of10,pubtest288of100,1,323,5363,11,77,5451
subtest26of10,pubtest288of100,1,323,5363,13,114,5490
subtest27of10,pubtest288of100,1,323,5363,14,153,5530
subtest22of10,pubtest288of100,1,323,5363,15,192,5570
subtest21of10,pubtest288of100,1,323,5363,17,230,5610
subtest23of10,pubtest288of100,1,323,5363,17,270,5650
subtest210of10,pubtest288of100,1,323,5363,21,306,5690
subtest28of10,pubtest288of100,1,323,5363,47,318,5728
subtest24of10,pubtest288of100,1,323,5363,47,358,5768
subtest29of10,pubtest289of100,1,323,5366,20,41,5427
subtest210of10,pubtest289of100,1,323,5366,27,71,5464
subtest23of10,pubtest289of100,1,323,5366,33,105,5504
subtest25of10,pubtest289of100,1,323,5366,34,145,5545
subtest26of10,pubtest289of100,1,323,5366,49,167,5582
subtest27of10,pubtest289of100,1,323,5366,52,206,5624
subtest24of10,pubtest289of100,1,323,5366,49,246,5661
subtest28of10,pubtest289of100,1,323,5366,53,285,5704
subtest22of10,pubtest289of100,1,323,5366,54,324,5744
subtest21of10,pubtest289of100,1,323,5366,55,364,5785
subtest29of10,pubtest290of100,1,323,5489,12,45,5546
subtest22of10,pubtest290of100,1,323,5489,13,84,5586
subtest23of10,pubtest290of100,1,323,5489,15,121,5625
subtest25of10,pubtest290of100,1,323,5489,18,159,5666
subtest27of10,pubtest290of100,1,323,5489,19,198,5706
subtest26of10,pubtest290of100,1,323,5489,21,236,5746
subtest210of10,pubtest290of100,1,323,5489,22,275,5786
subtest21of10,pubtest290of100,1,323,5489,21,316,5826
subtest28of10,pubtest290of100,1,323,5489,26,351,5866
subtest24of10,pubtest290of100,1,323,5489,28,390,5907
subtest24of10,pubtest291of100,1,323,5400,14,40,5454
subtest23of10,pubtest291of100,1,323,5400,16,76,5492
subtest27of10,pubtest291of100,1,323,5400,18,113,5531
subtest28of10,pubtest291of100,1,323,5400,22,149,5571
subtest21of10,pubtest291of100,1,323,5400,22,189,5611
subtest25of10,pubtest291of100,1,323,5400,24,227,5651
subtest29of10,pubtest291of100,1,323,5400,52,238,5690
subtest210of10,pubtest291of100,1,323,5400,53,278,5731
subtest22of10,pubtest291of100,1,323,5400,54,317,5771
subtest26of10,pubtest291of100,1,323,5400,55,355,5810
subtest29of10,pubtest292of100,1,323,5420,11,48,5479
subtest25of10,pubtest292of100,1,323,5420,14,85,5519
subtest28of10,pubtest292of100,1,323,5420,13,124,5557
subtest26of10,pubtest292of100,1,323,5420,15,164,5599
subtest23of10,pubtest292of100,1,323,5420,16,203,5639
subtest21of10,pubtest292of100,1,323,5420,13,246,5679
subtest24of10,pubtest292of100,1,323,5420,20,279,5719
subtest210of10,pubtest292of100,1,323,5420,20,319,5759
subtest22of10,pubtest292of100,1,323,5420,17,358,5795
subtest27of10,pubtest292of100,1,323,5420,22,397,5839
subtest25of10,pubtest293of100,1,323,5408,17,38,5463
subtest23of10,pubtest293of100,1,323,5408,22,73,5503
subtest21of10,pubtest293of100,1,323,5408,25,110,5543
subtest29of10,pubtest293of100,1,323,5408,26,148,5582
subtest24of10,pubtest293of100,1,323,5408,21,188,5617
subtest210of10,pubtest293of100,1,323,5408,27,227,5662
subtest27of10,pubtest293of100,1,323,5408,28,267,5703
subtest28of10,pubtest293of100,1,323,5408,23,306,5737
subtest26of10,pubtest293of100,1,323,5408,49,327,5784
subtest22of10,pubtest293of100,1,323,5408,50,365,5823
subtest210of10,pubtest294of100,1,323,5455,13,44,5512
subtest21of10,pubtest294of100,1,323,5455,13,84,5552
subtest27of10,pubtest294of100,1,323,5455,16,121,5592
subtest29of10,pubtest294of100,1,323,5455,15,161,5631
subtest26of10,pubtest294of100,1,323,5455,17,199,5671
subtest25of10,pubtest294of100,1,323,5455,15,239,5709
subtest23of10,pubtest294of100,1,323,5455,18,278,5751
subtest24of10,pubtest294of100,1,323,5455,24,311,5790
subtest22of10,pubtest294of100,1,323,5455,24,349,5828
subtest28of10,pubtest294of100,1,323,5455,25,389,5869
subtest25of10,pubtest295of100,1,323,5468,30,398,5896
subtest23of10,pubtest295of100,1,323,5468,30,438,5936
subtest27of10,pubtest295of100,1,323,5468,32,117,5617
subtest28of10,pubtest295of100,1,323,5468,106,157,5731
subtest210of10,pubtest295of100,1,323,5468,55,196,5719
subtest22of10,pubtest295of100,1,323,5468,55,236,5759
subtest24of10,pubtest295of100,1,323,5468,54,275,5797
subtest21of10,pubtest295of100,1,323,5468,44,315,5827
subtest29of10,pubtest295of100,1,323,5468,32,354,5854
subtest26of10,pubtest295of100,1,323,5468,106,394,5968
subtest25of10,pubtest296of100,1,322,5423,10,42,5475
subtest24of10,pubtest296of100,1,322,5423,11,80,5514
subtest27of10,pubtest296of100,1,322,5423,14,117,5554
subtest23of10,pubtest296of100,1,322,5423,20,151,5594
subtest29of10,pubtest296of100,1,322,5423,22,189,5634
subtest26of10,pubtest296of100,1,322,5423,22,229,5674
subtest21of10,pubtest296of100,1,322,5423,23,269,5715
subtest28of10,pubtest296of100,1,322,5423,33,298,5754
subtest210of10,pubtest296of100,1,322,5423,34,337,5794
subtest22of10,pubtest296of100,1,322,5423,40,371,5834
subtest25of10,pubtest297of100,1,323,5279,7,41,5327
subtest29of10,pubtest297of100,1,323,5279,8,79,5366
subtest210of10,pubtest297of100,1,323,5279,13,114,5406
subtest22of10,pubtest297of100,1,323,5279,14,153,5446
subtest23of10,pubtest297of100,1,323,5279,15,192,5486
subtest26of10,pubtest297of100,1,323,5279,16,231,5526
subtest27of10,pubtest297of100,1,323,5279,17,270,5566
subtest28of10,pubtest297of100,1,323,5279,18,310,5607
subtest21of10,pubtest297of100,1,323,5279,23,342,5644
subtest24of10,pubtest297of100,1,323,5279,25,382,5686
subtest29of10,pubtest298of100,1,323,5512,32,46,5590
subtest22of10,pubtest298of100,1,323,5512,34,83,5629
subtest25of10,pubtest298of100,1,323,5512,34,123,5669
subtest23of10,pubtest298of100,1,323,5512,36,160,5708
subtest21of10,pubtest298of100,1,323,5512,40,197,5749
subtest24of10,pubtest298of100,1,323,5512,73,204,5789
subtest210of10,pubtest298of100,1,323,5512,75,243,5830
subtest27of10,pubtest298of100,1,323,5512,75,282,5869
subtest28of10,pubtest298of100,1,323,5512,80,317,5909
subtest26of10,pubtest298of100,1,323,5512,81,356,5949
subtest22of10,pubtest299of100,1,323,5332,12,42,5386
subtest29of10,pubtest299of100,1,323,5332,15,78,5425
subtest27of10,pubtest299of100,1,323,5332,16,118,5466
subtest210of10,pubtest299of100,1,323,5332,17,156,5505
subtest23of10,pubtest299of100,1,323,5332,18,195,5545
subtest25of10,pubtest299of100,1,323,5332,19,234,5585
subtest21of10,pubtest299of100,1,323,5332,20,273,5625
subtest28of10,pubtest299of100,1,323,5332,26,307,5665
subtest24of10,pubtest299of100,1,323,5332,25,347,5704
subtest26of10,pubtest299of100,1,323,5332,27,384,5743
subtest21of10,pubtest2100of100,1,325,5582,10,42,5634
subtest24of10,pubtest2100of100,1,325,5582,11,80,5673
subtest29of10,pubtest2100of100,1,325,5582,12,119,5713
subtest22of10,pubtest2100of100,1,325,5582,13,157,5752
subtest23of10,pubtest2100of100,1,325,5582,18,192,5792
subtest28of10,pubtest2100of100,1,325,5582,22,229,5833
subtest27of10,pubtest2100of100,1,325,5582,22,269,5873
subtest210of10,pubtest2100of100,1,325,5582,24,307,5913
subtest25of10,pubtest2100of100,1,325,5582,25,346,5953
subtest26of10,pubtest2100of100,1,325,5582,27,384,5993
subtest27of10,pubtest21of100,1,322,10547,9,39,10595
subtest29of10,pubtest21of100,1,322,10547,12,76,10635
subtest26of10,pubtest21of100,1,322,10547,12,115,10674
subtest24of10,pubtest21of100,1,322,10547,14,153,10714
subtest25of10,pubtest21of100,1,322,10547,30,177,10754
subtest21of10,pubtest21of100,1,322,10547,30,217,10794
subtest210of10,pubtest21of100,1,322,10547,32,255,10834
subtest23of10,pubtest21of100,1,322,10547,32,295,10874
subtest28of10,pubtest21of100,1,322,10547,33,334,10914
subtest22of10,pubtest21of100,1,322,10547,34,373,10954
subtest29of10,pubtest22of100,1,321,5347,22,43,5412
subtest27of10,pubtest22of100,1,321,5347,24,80,5451
subtest24of10,pubtest22of100,1,321,5347,26,118,5491
subtest28of10,pubtest22of100,1,321,5347,27,157,5531
subtest23of10,pubtest22of100,1,321,5347,28,196,5571
subtest25of10,pubtest22of100,1,321,5347,52,212,5611
subtest21of10,pubtest22of100,1,321,5347,53,251,5651
subtest26of10,pubtest22of100,1,321,5347,57,287,5691
subtest210of10,pubtest22of100,1,321,5347,58,326,5731
subtest22of10,pubtest22of100,1,321,5347,63,361,5771
subtest23of10,pubtest23of100,1,321,5447,19,42,5508
subtest29of10,pubtest23of100,1,321,5447,21,77,5545
subtest28of10,pubtest23of100,1,321,5447,26,114,5587
subtest27of10,pubtest23of100,1,321,5447,27,155,5629
subtest25of10,pubtest23of100,1,321,5447,28,193,5668
subtest24of10,pubtest23of100,1,321,5447,30,230,5707
subtest21of10,pubtest23of100,1,321,5447,33,266,5746
subtest26of10,pubtest23of100,1,321,5447,33,306,5786
subtest210of10,pubtest23of100,1,321,5447,35,345,5827
subtest22of10,pubtest23of100,1,321,5447,35,386,5868
subtest23of10,pubtest24of100,1,321,5307,7,40,5354
subtest25of10,pubtest24of100,1,321,5307,11,74,5392
subtest24of10,pubtest24of100,1,321,5307,14,111,5432
subtest21of10,pubtest24of100,1,321,5307,15,150,5472
subtest29of10,pubtest24of100,1,321,5307,19,186,5512
subtest28of10,pubtest24of100,1,321,5307,23,222,5552
subtest27of10,pubtest24of100,1,321,5307,23,262,5592
subtest22of10,pubtest24of100,1,321,5307,27,297,5631
subtest210of10,pubtest24of100,1,321,5307,29,336,5672
subtest26of10,pubtest24of100,1,321,5307,31,375,5713
subtest28of10,pubtest25of100,1,321,5367,12,47,5426
subtest27of10,pubtest25of100,1,321,5367,13,85,5465
subtest21of10,pubtest25of100,1,321,5367,12,128,5507
subtest210of10,pubtest25of100,1,321,5367,33,147,5547
subtest26of10,pubtest25of100,1,321,5367,34,186,5587
subtest25of10,pubtest25of100,1,321,5367,36,224,5627
subtest22of10,pubtest25of100,1,321,5367,36,266,5669
subtest23of10,pubtest25of100,1,321,5367,38,303,5708
subtest29of10,pubtest25of100,1,321,5367,39,341,5747
subtest24of10,pubtest25of100,1,321,5367,53,367,5787
subtest21of10,pubtest26of100,1,321,5345,19,199,5563
subtest29of10,pubtest26of100,1,321,5345,20,235,5600
subtest27of10,pubtest26of100,1,321,5345,24,271,5640
subtest23of10,pubtest26of100,1,321,5345,24,311,5680
subtest25of10,pubtest26of100,1,321,5345,26,349,5720
subtest28of10,pubtest26of100,1,321,5345,27,388,5760
subtest26of10,pubtest26of100,1,321,5345,27,425,5797
subtest22of10,pubtest26of100,1,321,5345,24,464,5833
subtest24of10,pubtest26of100,1,321,5345,32,503,5880
subtest210of10,pubtest26of100,1,321,5345,31,542,5918
subtest27of10,pubtest27of100,1,320,5347,12,371,5730
subtest28of10,pubtest27of100,1,320,5347,15,368,5730
subtest23of10,pubtest27of100,1,320,5347,15,404,5766
subtest24of10,pubtest27of100,1,320,5347,18,443,5808
subtest25of10,pubtest27of100,1,320,5347,19,483,5849
subtest21of10,pubtest27of100,1,320,5347,19,522,5888
subtest22of10,pubtest27of100,1,320,5347,21,560,5928
subtest210of10,pubtest27of100,1,320,5347,22,599,5968
subtest29of10,pubtest27of100,1,320,5347,17,639,6003
subtest26of10,pubtest27of100,1,320,5347,21,678,6046
subtest27of10,pubtest28of100,1,321,5289,11,38,5338
subtest28of10,pubtest28of100,1,321,5289,17,71,5377
subtest21of10,pubtest28of100,1,321,5289,17,111,5417
subtest29of10,pubtest28of100,1,321,5289,19,150,5458
subtest23of10,pubtest28of100,1,321,5289,18,189,5496
subtest210of10,pubtest28of100,1,321,5289,20,228,5537
subtest26of10,pubtest28of100,1,321,5289,25,261,5575
subtest22of10,pubtest28of100,1,321,5289,27,301,5617
subtest25of10,pubtest28of100,1,321,5289,25,340,5654
subtest24of10,pubtest28of100,1,321,5289,29,379,5697
subtest23of10,pubtest29of100,1,321,5330,10,42,5382
subtest210of10,pubtest29of100,1,321,5330,11,80,5421
subtest22of10,pubtest29of100,1,321,5330,14,116,5460
subtest29of10,pubtest29of100,1,321,5330,15,158,5503
subtest25of10,pubtest29of100,1,321,5330,14,196,5540
subtest27of10,pubtest29of100,1,321,5330,17,234,5581
subtest24of10,pubtest29of100,1,321,5330,17,274,5621
subtest21of10,pubtest29of100,1,321,5330,16,313,5659
subtest26of10,pubtest29of100,1,321,5330,18,353,5701
subtest28of10,pubtest29of100,1,321,5330,15,392,5737
subtest29of10,pubtest210of100,1,323,5364,13,44,5421
subtest21of10,pubtest210of100,1,323,5364,18,79,5461
subtest210of10,pubtest210of100,1,323,5364,18,118,5500
subtest23of10,pubtest210of100,1,323,5364,20,157,5541
subtest27of10,pubtest210of100,1,323,5364,20,197,5581
subtest28of10,pubtest210of100,1,323,5364,21,234,5619
subtest25of10,pubtest210of100,1,323,5364,24,273,5661
subtest24of10,pubtest210of100,1,323,5364,25,312,5701
subtest26of10,pubtest210of100,1,323,5364,30,347,5741
subtest22of10,pubtest210of100,1,323,5364,30,387,5781
subtest24of10,pubtest211of100,1,323,5382,19,40,5441
subtest29of10,pubtest211of100,1,323,5382,17,80,5479
subtest210of10,pubtest211of100,1,323,5382,17,119,5518
subtest21of10,pubtest211of100,1,323,5382,22,156,5560
subtest25of10,pubtest211of100,1,323,5382,23,195,5600
subtest22of10,pubtest211of100,1,323,5382,25,233,5640
subtest23of10,pubtest211of100,1,323,5382,26,272,5680
subtest26of10,pubtest211of100,1,323,5382,27,311,5720
subtest27of10,pubtest211of100,1,323,5382,28,350,5760
subtest28of10,pubtest211of100,1,323,5382,29,389,5800
subtest25of10,pubtest212of100,1,323,5613,9,43,5665
subtest28of10,pubtest212of100,1,323,5613,17,74,5704
subtest23of10,pubtest212of100,1,323,5613,18,113,5744
subtest29of10,pubtest212of100,1,323,5613,17,153,5783
subtest27of10,pubtest212of100,1,323,5613,21,190,5824
subtest21of10,pubtest212of100,1,323,5613,21,230,5864
subtest24of10,pubtest212of100,1,323,5613,23,268,5904
subtest22of10,pubtest212of100,1,323,5613,24,307,5944
subtest26of10,pubtest212of100,1,323,5613,24,347,5984
subtest210of10,pubtest212of100,1,323,5613,25,386,6024
subtest23of10,pubtest213of100,1,322,5477,13,38,5528
subtest29of10,pubtest213of100,1,322,5477,13,78,5568
subtest27of10,pubtest213of100,1,322,5477,17,113,5607
subtest26of10,pubtest213of100,1,322,5477,17,153,5647
subtest21of10,pubtest213of100,1,322,5477,18,192,5687
subtest25of10,pubtest213of100,1,322,5477,26,224,5727
subtest22of10,pubtest213of100,1,322,5477,29,261,5767
subtest24of10,pubtest213of100,1,322,5477,30,300,5807
subtest210of10,pubtest213of100,1,322,5477,31,339,5847
subtest28of10,pubtest213of100,1,322,5477,31,379,5887
subtest21of10,pubtest214of100,1,323,5417,10,134,5561
subtest23of10,pubtest214of100,1,323,5417,12,171,5600
subtest26of10,pubtest214of100,1,323,5417,14,208,5639
subtest25of10,pubtest214of100,1,323,5417,14,248,5679
subtest22of10,pubtest214of100,1,323,5417,19,283,5719
subtest27of10,pubtest214of100,1,323,5417,22,320,5759
subtest210of10,pubtest214of100,1,323,5417,23,359,5799
subtest28of10,pubtest214of100,1,323,5417,146,277,5840
subtest29of10,pubtest214of100,1,323,5417,24,317,5758
subtest24of10,pubtest214of100,1,323,5417,147,355,5919
subtest27of10,pubtest215of100,1,323,5337,10,41,5388
subtest29of10,pubtest215of100,1,323,5337,12,79,5428
subtest21of10,pubtest215of100,1,323,5337,12,118,5467
subtest24of10,pubtest215of100,1,323,5337,11,160,5508
subtest26of10,pubtest215of100,1,323,5337,14,195,5546
subtest25of10,pubtest215of100,1,323,5337,16,233,5586
subtest210of10,pubtest215of100,1,323,5337,21,269,5627
subtest23of10,pubtest215of100,1,323,5337,21,310,5668
subtest22of10,pubtest215of100,1,323,5337,23,347,5707
subtest28of10,pubtest215of100,1,323,5337,27,383,5747
subtest24of10,pubtest216of100,1,323,5491,11,39,5541
subtest21of10,pubtest216of100,1,323,5491,12,77,5580
subtest23of10,pubtest216of100,1,323,5491,13,114,5618
subtest27of10,pubtest216of100,1,323,5491,21,148,5660
subtest28of10,pubtest216of100,1,323,5491,22,188,5701
subtest29of10,pubtest216of100,1,323,5491,23,226,5740
subtest25of10,pubtest216of100,1,323,5491,24,265,5780
subtest26of10,pubtest216of100,1,323,5491,24,305,5820
subtest22of10,pubtest216of100,1,323,5491,24,344,5859
subtest210of10,pubtest216of100,1,323,5491,37,372,5900
subtest27of10,pubtest217of100,1,322,5272,9,42,5323
subtest22of10,pubtest217of100,1,322,5272,11,78,5361
subtest21of10,pubtest217of100,1,322,5272,13,118,5403
subtest23of10,pubtest217of100,1,322,5272,14,156,5442
subtest26of10,pubtest217of100,1,322,5272,14,196,5482
subtest29of10,pubtest217of100,1,322,5272,29,221,5522
subtest25of10,pubtest217of100,1,322,5272,29,261,5562
subtest24of10,pubtest217of100,1,322,5272,31,299,5602
subtest28of10,pubtest217of100,1,322,5272,34,336,5642
subtest210of10,pubtest217of100,1,322,5272,35,375,5682
subtest29of10,pubtest218of100,1,323,5305,12,42,5359
subtest22of10,pubtest218of100,1,323,5305,16,78,5399
subtest21of10,pubtest218of100,1,323,5305,16,116,5437
subtest23of10,pubtest218of100,1,323,5305,18,155,5478
subtest28of10,pubtest218of100,1,323,5305,18,195,5518
subtest25of10,pubtest218of100,1,323,5305,20,233,5558
subtest27of10,pubtest218of100,1,323,5305,20,273,5598
subtest24of10,pubtest218of100,1,323,5305,23,310,5638
subtest210of10,pubtest218of100,1,323,5305,32,342,5679
subtest26of10,pubtest218of100,1,323,5305,44,369,5718
subtest210of10,pubtest219of100,1,323,5427,13,38,5478
subtest25of10,pubtest219of100,1,323,5427,14,76,5517
subtest21of10,pubtest219of100,1,323,5427,15,115,5557
subtest29of10,pubtest219of100,1,323,5427,16,154,5597
subtest23of10,pubtest219of100,1,323,5427,16,194,5637
subtest26of10,pubtest219of100,1,323,5427,17,233,5677
subtest22of10,pubtest219of100,1,323,5427,26,264,5717
subtest27of10,pubtest219of100,1,323,5427,27,303,5757
subtest24of10,pubtest219of100,1,323,5427,30,340,5797
subtest28of10,pubtest219of100,1,323,5427,31,380,5838
subtest25of10,pubtest220of100,1,323,5552,17,41,5610
subtest23of10,pubtest220of100,1,323,5552,25,72,5649
subtest29of10,pubtest220of100,1,323,5552,26,111,5689
subtest210of10,pubtest220of100,1,323,5552,26,151,5729
subtest28of10,pubtest220of100,1,323,5552,34,183,5769
subtest21of10,pubtest220of100,1,323,5552,31,223,5806
subtest26of10,pubtest220of100,1,323,5552,34,261,5847
subtest22of10,pubtest220of100,1,323,5552,36,301,5889
subtest24of10,pubtest220of100,1,323,5552,31,346,5929
subtest27of10,pubtest220of100,1,323,5552,37,380,5969
subtest24of10,pubtest221of100,1,323,5301,13,44,5358
subtest28of10,pubtest221of100,1,323,5301,16,74,5391
subtest25of10,pubtest221of100,1,323,5301,21,114,5436
subtest23of10,pubtest221of100,1,323,5301,22,153,5476
subtest26of10,pubtest221of100,1,323,5301,21,193,5515
subtest22of10,pubtest221of100,1,323,5301,17,233,5551
subtest210of10,pubtest221of100,1,323,5301,20,272,5593
subtest21of10,pubtest221of100,1,323,5301,14,312,5627
subtest29of10,pubtest221of100,1,323,5301,21,352,5674
subtest27of10,pubtest221of100,1,323,5301,21,391,5713
subtest21of10,pubtest222of100,1,323,5306,40,39,5385
subtest22of10,pubtest222of100,1,323,5306,47,72,5425
subtest29of10,pubtest222of100,1,323,5306,53,105,5464
subtest27of10,pubtest222of100,1,323,5306,60,138,5504
subtest23of10,pubtest222of100,1,323,5306,67,171,5544
subtest25of10,pubtest222of100,1,323,5306,73,206,5585
subtest28of10,pubtest222of100,1,323,5306,80,238,5624
subtest210of10,pubtest222of100,1,323,5306,87,271,5664
subtest26of10,pubtest222of100,1,323,5306,93,305,5704
subtest24of10,pubtest222of100,1,323,5306,100,338,5744
subtest21of10,pubtest223of100,1,323,5343,38,38,5419
subtest28of10,pubtest223of100,1,323,5343,39,77,5459
subtest23of10,pubtest223of100,1,323,5343,40,116,5499
subtest24of10,pubtest223of100,1,323,5343,42,154,5539
subtest29of10,pubtest223of100,1,323,5343,42,194,5579
subtest210of10,pubtest223of100,1,323,5343,56,220,5619
subtest25of10,pubtest223of100,1,323,5343,57,259,5659
subtest22of10,pubtest223of100,1,323,5343,58,298,5699
subtest26of10,pubtest223of100,1,323,5343,59,335,5737
subtest27of10,pubtest223of100,1,323,5343,57,374,5774
subtest21of10,pubtest224of100,1,323,5266,9,40,5315
subtest28of10,pubtest224of100,1,323,5266,11,78,5355
subtest23of10,pubtest224of100,1,323,5266,12,116,5394
subtest26of10,pubtest224of100,1,323,5266,13,155,5434
subtest27of10,pubtest224of100,1,323,5266,13,195,5474
subtest25of10,pubtest224of100,1,323,5266,40,208,5514
subtest22of10,pubtest224of100,1,323,5266,40,248,5554
subtest29of10,pubtest224of100,1,323,5266,40,285,5591
subtest24of10,pubtest224of100,1,323,5266,47,321,5634
subtest210of10,pubtest224of100,1,323,5266,48,360,5674
subtest27of10,pubtest225of100,1,323,5340,49,50,5439
subtest26of10,pubtest225of100,1,323,5340,51,88,5479
subtest24of10,pubtest225of100,1,323,5340,53,126,5519
subtest25of10,pubtest225of100,1,323,5340,54,166,5560
subtest22of10,pubtest225of100,1,323,5340,50,202,5592
subtest29of10,pubtest225of100,1,323,5340,55,239,5634
subtest210of10,pubtest225of100,1,323,5340,60,279,5679
subtest28of10,pubtest225of100,1,323,5340,55,318,5713
subtest21of10,pubtest225of100,1,323,5340,59,358,5757
subtest23of10,pubtest225of100,1,323,5340,55,396,5791
subtest25of10,pubtest226of100,1,323,5472,77,41,5590
subtest22of10,pubtest226of100,1,323,5472,77,78,5627
subtest23of10,pubtest226of100,1,323,5472,81,115,5668
subtest210of10,pubtest226of100,1,323,5472,82,155,5709
subtest27of10,pubtest226of100,1,323,5472,90,187,5749
subtest21of10,pubtest226of100,1,323,5472,92,225,5789
subtest29of10,pubtest226of100,1,323,5472,101,257,5830
subtest28of10,pubtest226of100,1,323,5472,101,296,5869
subtest26of10,pubtest226of100,1,323,5472,132,305,5909
subtest24of10,pubtest226of100,1,323,5472,133,344,5949
subtest29of10,pubtest227of100,1,323,5327,11,41,5379
subtest25of10,pubtest227of100,1,323,5327,15,75,5417
subtest210of10,pubtest227of100,1,323,5327,15,114,5456
subtest23of10,pubtest227of100,1,323,5327,17,153,5497
subtest24of10,pubtest227of100,1,323,5327,17,193,5537
subtest27of10,pubtest227of100,1,323,5327,19,231,5577
subtest26of10,pubtest227of100,1,323,5327,19,271,5617
subtest21of10,pubtest227of100,1,323,5327,21,309,5657
subtest22of10,pubtest227of100,1,323,5327,27,343,5697
subtest28of10,pubtest227of100,1,323,5327,27,383,5737
subtest21of10,pubtest228of100,1,323,5523,16,41,5580
subtest25of10,pubtest228of100,1,323,5523,34,63,5620
subtest26of10,pubtest228of100,1,323,5523,34,102,5659
subtest27of10,pubtest228of100,1,323,5523,36,140,5699
subtest24of10,pubtest228of100,1,323,5523,36,181,5740
subtest23of10,pubtest228of100,1,323,5523,37,219,5779
subtest29of10,pubtest228of100,1,323,5523,50,246,5819
subtest210of10,pubtest228of100,1,323,5523,51,283,5857
subtest22of10,pubtest228of100,1,323,5523,65,311,5899
subtest28of10,pubtest228of100,1,323,5523,65,352,5940
subtest24of10,pubtest229of100,1,321,5276,10,40,5326
subtest28of10,pubtest229of100,1,321,5276,12,76,5364
subtest21of10,pubtest229of100,1,321,5276,13,115,5404
subtest27of10,pubtest229of100,1,321,5276,25,143,5444
subtest22of10,pubtest229of100,1,321,5276,30,177,5483
subtest23of10,pubtest229of100,1,321,5276,32,216,5524
subtest25of10,pubtest229of100,1,321,5276,42,246,5564
subtest29of10,pubtest229of100,1,321,5276,42,286,5604
subtest210of10,pubtest229of100,1,321,5276,44,324,5644
subtest26of10,pubtest229of100,1,321,5276,45,363,5684
subtest21of10,pubtest230of100,1,323,5350,11,40,5401
subtest22of10,pubtest230of100,1,323,5350,10,77,5437
subtest27of10,pubtest230of100,1,323,5350,13,116,5479
subtest29of10,pubtest230of100,1,323,5350,15,154,5519
subtest28of10,pubtest230of100,1,323,5350,19,191,5560
subtest25of10,pubtest230of100,1,323,5350,22,228,5600
subtest23of10,pubtest230of100,1,323,5350,24,266,5640
subtest26of10,pubtest230of100,1,323,5350,30,300,5680
subtest210of10,pubtest230of100,1,323,5350,30,340,5720
subtest24of10,pubtest230of100,1,323,5350,30,379,5759
subtest23of10,pubtest231of100,1,323,5274,16,39,5329
subtest25of10,pubtest231of100,1,323,5274,20,75,5369
subtest28of10,pubtest231of100,1,323,5274,24,110,5408
subtest29of10,pubtest231of100,1,323,5274,24,152,5450
subtest27of10,pubtest231of100,1,323,5274,35,179,5488
subtest24of10,pubtest231of100,1,323,5274,35,219,5528
subtest210of10,pubtest231of100,1,323,5274,43,251,5568
subtest21of10,pubtest231of100,1,323,5274,43,291,5608
subtest26of10,pubtest231of100,1,323,5274,45,330,5649
subtest22of10,pubtest231of100,1,323,5274,49,365,5688
subtest21of10,pubtest232of100,1,323,5331,13,40,5384
subtest27of10,pubtest232of100,1,323,5331,16,75,5422
subtest22of10,pubtest232of100,1,323,5331,16,114,5461
subtest28of10,pubtest232of100,1,323,5331,17,154,5502
subtest23of10,pubtest232of100,1,323,5331,19,192,5542
subtest29of10,pubtest232of100,1,323,5331,24,227,5582
subtest210of10,pubtest232of100,1,323,5331,38,253,5622
subtest25of10,pubtest232of100,1,323,5331,38,293,5662
subtest26of10,pubtest232of100,1,323,5331,40,330,5701
subtest24of10,pubtest232of100,1,323,5331,40,369,5740
subtest24of10,pubtest233of100,1,323,5451,15,41,5507
subtest29of10,pubtest233of100,1,323,5451,17,79,5547
subtest25of10,pubtest233of100,1,323,5451,20,115,5586
subtest210of10,pubtest233of100,1,323,5451,20,155,5626
subtest27of10,pubtest233of100,1,323,5451,22,193,5666
subtest26of10,pubtest233of100,1,323,5451,22,233,5706
subtest22of10,pubtest233of100,1,323,5451,26,269,5746
subtest23of10,pubtest233of100,1,323,5451,26,307,5784
subtest28of10,pubtest233of100,1,323,5451,93,283,5827
subtest21of10,pubtest233of100,1,323,5451,93,323,5867
subtest25of10,pubtest234of100,1,323,5355,14,53,5422
subtest26of10,pubtest234of100,1,323,5355,15,91,5461
subtest210of10,pubtest234of100,1,323,5355,22,124,5501
subtest24of10,pubtest234of100,1,323,5355,23,163,5541
subtest27of10,pubtest234of100,1,323,5355,17,203,5575
subtest28of10,pubtest234of100,1,323,5355,24,242,5621
subtest23of10,pubtest234of100,1,323,5355,22,281,5658
subtest21of10,pubtest234of100,1,323,5355,23,320,5698
subtest29of10,pubtest234of100,1,323,5355,19,359,5733
subtest22of10,pubtest234of100,1,323,5355,18,398,5771
subtest210of10,pubtest235of100,1,321,5462,11,41,5514
subtest27of10,pubtest235of100,1,321,5462,16,76,5554
subtest21of10,pubtest235of100,1,321,5462,15,115,5592
subtest23of10,pubtest235of100,1,321,5462,17,154,5633
subtest22of10,pubtest235of100,1,321,5462,19,192,5673
subtest29of10,pubtest235of100,1,321,5462,22,229,5713
subtest24of10,pubtest235of100,1,321,5462,22,269,5753
subtest25of10,pubtest235of100,1,321,5462,24,309,5795
subtest26of10,pubtest235of100,1,321,5462,24,348,5834
subtest28of10,pubtest235of100,1,321,5462,30,381,5873
subtest210of10,pubtest236of100,1,323,5397,12,40,5449
subtest23of10,pubtest236of100,1,323,5397,13,79,5489
subtest27of10,pubtest236of100,1,323,5397,15,116,5528
subtest28of10,pubtest236of100,1,323,5397,22,148,5567
subtest25of10,pubtest236of100,1,323,5397,23,188,5608
subtest21of10,pubtest236of100,1,323,5397,28,223,5648
subtest29of10,pubtest236of100,1,323,5397,40,251,5688
subtest24of10,pubtest236of100,1,323,5397,46,285,5728
subtest26of10,pubtest236of100,1,323,5397,46,325,5768
subtest22of10,pubtest236of100,1,323,5397,48,363,5808
subtest24of10,pubtest237of100,1,323,5360,9,42,5411
subtest23of10,pubtest237of100,1,323,5360,19,72,5451
subtest28of10,pubtest237of100,1,323,5360,19,111,5490
subtest27of10,pubtest237of100,1,323,5360,21,149,5530
subtest25of10,pubtest237of100,1,323,5360,21,189,5570
subtest26of10,pubtest237of100,1,323,5360,21,228,5609
subtest21of10,pubtest237of100,1,323,5360,23,265,5648
subtest22of10,pubtest237of100,1,323,5360,26,304,5690
subtest210of10,pubtest237of100,1,323,5360,26,344,5730
subtest29of10,pubtest237of100,1,323,5360,28,382,5770
subtest29of10,pubtest238of100,1,323,5351,13,42,5406
subtest22of10,pubtest238of100,1,323,5351,15,80,5446
subtest27of10,pubtest238of100,1,323,5351,16,118,5485
subtest28of10,pubtest238of100,1,323,5351,20,154,5525
subtest25of10,pubtest238of100,1,323,5351,55,158,5564
subtest21of10,pubtest238of100,1,323,5351,57,197,5605
subtest210of10,pubtest238of100,1,323,5351,57,237,5645
subtest23of10,pubtest238of100,1,323,5351,58,276,5685
subtest26of10,pubtest238of100,1,323,5351,60,314,5725
subtest24of10,pubtest238of100,1,323,5351,64,350,5765
subtest21of10,pubtest239of100,1,323,5303,11,45,5359
subtest28of10,pubtest239of100,1,323,5303,11,83,5397
subtest27of10,pubtest239of100,1,323,5303,13,122,5438
subtest25of10,pubtest239of100,1,323,5303,16,160,5479
subtest26of10,pubtest239of100,1,323,5303,18,199,5520
subtest29of10,pubtest239of100,1,323,5303,17,239,5559
subtest23of10,pubtest239of100,1,323,5303,19,279,5601
subtest24of10,pubtest239of100,1,323,5303,19,318,5640
subtest210of10,pubtest239of100,1,323,5303,21,355,5679
subtest22of10,pubtest239of100,1,323,5303,21,395,5719
subtest25of10,pubtest240of100,1,323,5340,15,41,5396
subtest21of10,pubtest240of100,1,323,5340,16,80,5436
subtest210of10,pubtest240of100,1,323,5340,18,117,5475
subtest29of10,pubtest240of100,1,323,5340,20,155,5515
subtest27of10,pubtest240of100,1,323,5340,20,195,5555
subtest23of10,pubtest240of100,1,323,5340,25,230,5595
subtest28of10,pubtest240of100,1,323,5340,25,271,5636
subtest26of10,pubtest240of100,1,323,5340,27,309,5676
subtest24of10,pubtest240of100,1,323,5340,26,349,5715
subtest22of10,pubtest240of100,1,323,5340,28,387,5755
subtest23of10,pubtest241of100,1,323,5413,43,40,5496
subtest24of10,pubtest241of100,1,323,5413,47,77,5537
subtest21of10,pubtest241of100,1,323,5413,49,114,5576
subtest27of10,pubtest241of100,1,323,5413,48,154,5615
subtest210of10,pubtest241of100,1,323,5413,52,191,5656
subtest29of10,pubtest241of100,1,323,5413,53,230,5696
subtest25of10,pubtest241of100,1,323,5413,57,264,5734
subtest28of10,pubtest241of100,1,323,5413,58,304,5775
subtest26of10,pubtest241of100,1,323,5413,108,295,5816
subtest22of10,pubtest241of100,1,323,5413,110,333,5856
subtest27of10,pubtest242of100,1,323,5394,16,42,5452
subtest26of10,pubtest242of100,1,323,5394,16,81,5491
subtest23of10,pubtest242of100,1,323,5394,18,119,5531
subtest25of10,pubtest242of100,1,323,5394,19,158,5571
subtest210of10,pubtest242of100,1,323,5394,24,193,5611
subtest29of10,pubtest242of100,1,323,5394,24,233,5651
subtest21of10,pubtest242of100,1,323,5394,26,271,5691
subtest22of10,pubtest242of100,1,323,5394,30,307,5731
subtest28of10,pubtest242of100,1,323,5394,32,345,5771
subtest24of10,pubtest242of100,1,323,5394,32,385,5811
subtest23of10,pubtest243of100,1,323,5305,14,42,5361
subtest29of10,pubtest243of100,1,323,5305,11,82,5398
subtest28of10,pubtest243of100,1,323,5305,14,121,5440
subtest26of10,pubtest243of100,1,323,5305,16,159,5480
subtest25of10,pubtest243of100,1,323,5305,18,197,5520
subtest27of10,pubtest243of100,1,323,5305,18,237,5560
subtest22of10,pubtest243of100,1,323,5305,17,276,5598
subtest24of10,pubtest243of100,1,323,5305,19,316,5640
subtest21of10,pubtest243of100,1,323,5305,24,351,5680
subtest210of10,pubtest243of100,1,323,5305,30,385,5720
subtest27of10,pubtest244of100,1,323,5370,7,40,5417
subtest26of10,pubtest244of100,1,323,5370,13,74,5457
subtest25of10,pubtest244of100,1,323,5370,14,113,5497
subtest28of10,pubtest244of100,1,323,5370,17,150,5537
subtest29of10,pubtest244of100,1,323,5370,16,190,5576
subtest21of10,pubtest244of100,1,323,5370,18,228,5616
subtest23of10,pubtest244of100,1,323,5370,18,268,5656
subtest210of10,pubtest244of100,1,323,5370,22,303,5695
subtest24of10,pubtest244of100,1,323,5370,24,340,5734
subtest22of10,pubtest244of100,1,323,5370,23,380,5773
subtest29of10,pubtest245of100,1,322,5623,70,40,5733
subtest26of10,pubtest245of100,1,322,5623,72,77,5772
subtest23of10,pubtest245of100,1,322,5623,82,107,5812
subtest22of10,pubtest245of100,1,322,5623,85,144,5852
subtest25of10,pubtest245of100,1,322,5623,86,183,5892
subtest24of10,pubtest245of100,1,322,5623,85,222,5930
subtest28of10,pubtest245of100,1,322,5623,94,254,5971
subtest21of10,pubtest245of100,1,322,5623,95,293,6011
subtest27of10,pubtest245of100,1,322,5623,95,333,6051
subtest210of10,pubtest245of100,1,322,5623,97,372,6092
subtest26of10,pubtest246of100,1,323,5328,21,56,5405
subtest21of10,pubtest246of100,1,323,5328,22,93,5443
subtest25of10,pubtest246of100,1,323,5328,27,128,5483
subtest22of10,pubtest246of100,1,323,5328,29,167,5524
subtest28of10,pubtest246of100,1,323,5328,25,206,5559
subtest23of10,pubtest246of100,1,323,5328,32,244,5604
subtest24of10,pubtest246of100,1,323,5328,33,282,5643
subtest210of10,pubtest246of100,1,323,5328,34,321,5683
subtest27of10,pubtest246of100,1,323,5328,22,359,5709
subtest29of10,pubtest246of100,1,323,5328,37,399,5764
subtest27of10,pubtest247of100,1,323,5302,15,51,5368
subtest26of10,pubtest247of100,1,323,5302,15,91,5408
subtest22of10,pubtest247of100,1,323,5302,19,128,5449
subtest28of10,pubtest247of100,1,323,5302,21,165,5488
subtest29of10,pubtest247of100,1,323,5302,23,202,5527
subtest21of10,pubtest247of100,1,323,5302,25,240,5567
subtest25of10,pubtest247of100,1,323,5302,27,278,5607
subtest24of10,pubtest247of100,1,323,5302,27,318,5647
subtest210of10,pubtest247of100,1,323,5302,28,356,5686
subtest23of10,pubtest247of100,1,323,5302,29,396,5727
subtest29of10,pubtest248of100,1,323,5720,9,39,5768
subtest25of10,pubtest248of100,1,323,5720,13,74,5807
subtest26of10,pubtest248of100,1,323,5720,14,113,5847
subtest23of10,pubtest248of100,1,323,5720,16,151,5887
subtest27of10,pubtest248of100,1,323,5720,16,191,5927
subtest28of10,pubtest248of100,1,323,5720,33,214,5967
subtest21of10,pubtest248of100,1,323,5720,34,253,6007
subtest24of10,pubtest248of100,1,323,5720,34,289,6043
subtest22of10,pubtest248of100,1,323,5720,39,328,6087
subtest210of10,pubtest248of100,1,323,5720,40,367,6127
subtest28of10,pubtest249of100,1,323,5305,10,38,5353
subtest27of10,pubtest249of100,1,323,5305,19,68,5392
subtest25of10,pubtest249of100,1,323,5305,19,108,5432
subtest24of10,pubtest249of100,1,323,5305,21,146,5472
subtest29of10,pubtest249of100,1,323,5305,21,186,5512
subtest23of10,pubtest249of100,1,323,5305,24,222,5551
subtest21of10,pubtest249of100,1,323,5305,22,262,5589
subtest210of10,pubtest249of100,1,323,5305,26,301,5632
subtest26of10,pubtest249of100,1,323,5305,24,340,5669
subtest22of10,pubtest249of100,1,323,5305,26,380,5711
subtest27of10,pubtest250of100,1,323,5234,10,42,5286
subtest23of10,pubtest250of100,1,323,5234,12,79,5325
subtest29of10,pubtest250of100,1,323,5234,15,117,5366
subtest21of10,pubtest250of100,1,323,5234,16,156,5406
subtest28of10,pubtest250of100,1,323,5234,21,192,5447
subtest25of10,pubtest250of100,1,323,5234,24,229,5487
subtest24of10,pubtest250of100,1,323,5234,24,268,5526
subtest210of10,pubtest250of100,1,323,5234,25,306,5565
subtest22of10,pubtest250of100,1,323,5234,26,346,5606
subtest26of10,pubtest250of100,1,323,5234,27,385,5646
subtest23of10,pubtest251of100,1,323,5274,10,40,5324
subtest22of10,pubtest251of100,1,323,5274,11,79,5364
subtest27of10,pubtest251of100,1,323,5274,17,112,5403
subtest24of10,pubtest251of100,1,323,5274,18,151,5443
subtest28of10,pubtest251of100,1,323,5274,21,188,5483
subtest25of10,pubtest251of100,1,323,5274,24,225,5523
subtest21of10,pubtest251of100,1,323,5274,24,265,5563
subtest29of10,pubtest251of100,1,323,5274,25,304,5603
subtest210of10,pubtest251of100,1,323,5274,25,344,5643
subtest26of10,pubtest251of100,1,323,5274,27,382,5683
subtest29of10,pubtest252of100,1,323,5260,10,40,5310
subtest21of10,pubtest252of100,1,323,5260,13,76,5349
subtest27of10,pubtest252of100,1,323,5260,15,114,5389
subtest28of10,pubtest252of100,1,323,5260,21,148,5429
subtest24of10,pubtest252of100,1,323,5260,32,174,5466
subtest25of10,pubtest252of100,1,323,5260,30,214,5504
subtest23of10,pubtest252of100,1,323,5260,30,254,5544
subtest210of10,pubtest252of100,1,323,5260,35,293,5588
subtest22of10,pubtest252of100,1,323,5260,37,332,5629
subtest26of10,pubtest252of100,1,323,5260,37,371,5668
subtest28of10,pubtest253of100,1,322,5333,10,40,5383
subtest23of10,pubtest253of100,1,322,5333,16,73,5422
subtest25of10,pubtest253of100,1,322,5333,17,113,5463
subtest29of10,pubtest253of100,1,322,5333,19,149,5501
subtest24of10,pubtest253of100,1,322,5333,20,189,5542
subtest27of10,pubtest253of100,1,322,5333,21,228,5582
subtest21of10,pubtest253of100,1,322,5333,22,267,5622
subtest26of10,pubtest253of100,1,322,5333,24,305,5662
subtest210of10,pubtest253of100,1,322,5333,24,347,5704
subtest22of10,pubtest253of100,1,322,5333,25,384,5742
subtest210of10,pubtest254of100,1,323,5308,11,40,5359
subtest27of10,pubtest254of100,1,323,5308,12,78,5398
subtest28of10,pubtest254of100,1,323,5308,18,111,5437
subtest21of10,pubtest254of100,1,323,5308,18,151,5477
subtest24of10,pubtest254of100,1,323,5308,20,189,5517
subtest25of10,pubtest254of100,1,323,5308,23,226,5557
subtest23of10,pubtest254of100,1,323,5308,23,266,5597
subtest29of10,pubtest254of100,1,323,5308,24,305,5637
subtest22of10,pubtest254of100,1,323,5308,25,344,5677
subtest26of10,pubtest254of100,1,323,5308,27,380,5715
subtest23of10,pubtest255of100,1,322,5253,14,41,5308
subtest22of10,pubtest255of100,1,322,5253,14,80,5347
subtest27of10,pubtest255of100,1,322,5253,19,115,5387
subtest28of10,pubtest255of100,1,322,5253,21,153,5427
subtest21of10,pubtest255of100,1,322,5253,21,193,5467
subtest29of10,pubtest255of100,1,322,5253,22,232,5507
subtest24of10,pubtest255of100,1,322,5253,25,267,5545
subtest25of10,pubtest255of100,1,322,5253,28,306,5587
subtest26of10,pubtest255of100,1,322,5253,32,342,5627
subtest210of10,pubtest255of100,1,322,5253,33,381,5667
subtest29of10,pubtest256of100,1,323,5277,8,41,5326
subtest21of10,pubtest256of100,1,323,5277,9,79,5365
subtest25of10,pubtest256of100,1,323,5277,11,115,5403
subtest26of10,pubtest256of100,1,323,5277,11,154,5442
subtest210of10,pubtest256of100,1,323,5277,11,197,5485
subtest28of10,pubtest256of100,1,323,5277,15,233,5525
subtest23of10,pubtest256of100,1,323,5277,13,273,5563
subtest27of10,pubtest256of100,1,323,5277,17,311,5605
subtest22of10,pubtest256of100,1,323,5277,20,348,5645
subtest24of10,pubtest256of100,1,323,5277,20,388,5685
subtest21of10,pubtest257of100,1,323,5341,11,41,5393
subtest27of10,pubtest257of100,1,323,5341,14,76,5431
subtest28of10,pubtest257of100,1,323,5341,15,116,5472
subtest24of10,pubtest257of100,1,323,5341,13,158,5512
subtest23of10,pubtest257of100,1,323,5341,18,193,5552
subtest22of10,pubtest257of100,1,323,5341,21,230,5592
subtest29of10,pubtest257of100,1,323,5341,26,267,5634
subtest210of10,pubtest257of100,1,323,5341,35,297,5673
subtest25of10,pubtest257of100,1,323,5341,35,336,5712
subtest26of10,pubtest257of100,1,323,5341,37,374,5752
subtest23of10,pubtest258of100,1,323,5372,19,41,5432
subtest28of10,pubtest258of100,1,323,5372,23,78,5473
subtest25of10,pubtest258of100,1,323,5372,23,117,5512
subtest26of10,pubtest258of100,1,323,5372,53,127,5552
subtest29of10,pubtest258of100,1,323,5372,55,166,5593
subtest21of10,pubtest258of100,1,323,5372,54,206,5632
subtest27of10,pubtest258of100,1,323,5372,56,244,5672
subtest210of10,pubtest258of100,1,323,5372,57,282,5711
subtest22of10,pubtest258of100,1,323,5372,58,320,5750
subtest24of10,pubtest258of100,1,323,5372,61,359,5792
subtest21of10,pubtest259of100,1,323,5299,9,38,5346
subtest25of10,pubtest259of100,1,323,5299,18,68,5385
subtest28of10,pubtest259of100,1,323,5299,18,108,5425
subtest24of10,pubtest259of100,1,323,5299,20,146,5465
subtest26of10,pubtest259of100,1,323,5299,23,182,5504
subtest27of10,pubtest259of100,1,323,5299,23,220,5542
subtest210of10,pubtest259of100,1,323,5299,25,260,5584
subtest22of10,pubtest259of100,1,323,5299,26,299,5624
subtest23of10,pubtest259of100,1,323,5299,26,338,5663
subtest29of10,pubtest259of100,1,323,5299,29,377,5705
subtest23of10,pubtest260of100,1,323,5345,18,39,5402
subtest210of10,pubtest260of100,1,323,5345,17,81,5443
subtest21of10,pubtest260of100,1,323,5345,20,117,5482
subtest27of10,pubtest260of100,1,323,5345,43,134,5522
subtest26of10,pubtest260of100,1,323,5345,45,172,5562
subtest29of10,pubtest260of100,1,323,5345,45,213,5603
subtest25of10,pubtest260of100,1,323,5345,47,250,5642
subtest28of10,pubtest260of100,1,323,5345,48,289,5682
subtest22of10,pubtest260of100,1,323,5345,47,329,5721
subtest24of10,pubtest260of100,1,323,5345,50,367,5762
subtest25of10,pubtest261of100,1,323,5508,13,41,5562
subtest28of10,pubtest261of100,1,323,5508,14,79,5601
subtest210of10,pubtest261of100,1,323,5508,16,117,5641
subtest29of10,pubtest261of100,1,323,5508,16,157,5681
subtest22of10,pubtest261of100,1,323,5508,18,195,5721
subtest23of10,pubtest261of100,1,323,5508,22,231,5761
subtest24of10,pubtest261of100,1,323,5508,28,265,5801
subtest27of10,pubtest261of100,1,323,5508,32,301,5841
subtest21of10,pubtest261of100,1,323,5508,33,338,5879
subtest26of10,pubtest261of100,1,323,5508,33,378,5919
subtest21of10,pubtest262of100,1,323,5391,12,40,5443
subtest22of10,pubtest262of100,1,323,5391,16,74,5481
subtest23of10,pubtest262of100,1,323,5391,17,113,5521
subtest27of10,pubtest262of100,1,323,5391,18,152,5561
subtest26of10,pubtest262of100,1,323,5391,18,192,5601
subtest29of10,pubtest262of100,1,323,5391,43,207,5641
subtest210of10,pubtest262of100,1,323,5391,45,245,5681
subtest25of10,pubtest262of100,1,323,5391,46,284,5721
subtest24of10,pubtest262of100,1,323,5391,51,319,5761
subtest28of10,pubtest262of100,1,323,5391,53,357,5801
subtest22of10,pubtest263of100,1,322,5306,10,40,5356
subtest24of10,pubtest263of100,1,322,5306,12,75,5393
subtest29of10,pubtest263of100,1,322,5306,12,115,5433
subtest23of10,pubtest263of100,1,322,5306,16,153,5475
subtest26of10,pubtest263of100,1,322,5306,23,186,5515
subtest210of10,pubtest263of100,1,322,5306,23,227,5556
subtest25of10,pubtest263of100,1,322,5306,27,261,5594
subtest21of10,pubtest263of100,1,322,5306,28,301,5635
subtest27of10,pubtest263of100,1,322,5306,27,340,5673
subtest28of10,pubtest263of100,1,322,5306,29,380,5715
subtest22of10,pubtest264of100,1,322,5461,9,39,5509
subtest29of10,pubtest264of100,1,322,5461,10,77,5548
subtest24of10,pubtest264of100,1,322,5461,12,115,5588
subtest23of10,pubtest264of100,1,322,5461,12,155,5628
subtest21of10,pubtest264of100,1,322,5461,14,193,5668
subtest27of10,pubtest264of100,1,322,5461,14,233,5708
subtest28of10,pubtest264of100,1,322,5461,16,271,5748
subtest25of10,pubtest264of100,1,322,5461,16,312,5789
subtest26of10,pubtest264of100,1,322,5461,27,338,5826
subtest210of10,pubtest264of100,1,322,5461,27,378,5866
subtest26of10,pubtest265of100,1,323,5359,11,246,5616
subtest27of10,pubtest265of100,1,323,5359,20,277,5656
subtest210of10,pubtest265of100,1,323,5359,20,315,5694
subtest22of10,pubtest265of100,1,323,5359,21,355,5735
subtest28of10,pubtest265of100,1,323,5359,23,393,5775
subtest21of10,pubtest265of100,1,323,5359,23,434,5816
subtest25of10,pubtest265of100,1,323,5359,258,238,5855
subtest24of10,pubtest265of100,1,323,5359,258,278,5895
subtest23of10,pubtest265of100,1,323,5359,259,317,5935
subtest29of10,pubtest265of100,1,323,5359,259,357,5975
subtest29of10,pubtest266of100,1,321,5486,29,48,5563
subtest210of10,pubtest266of100,1,321,5486,32,83,5601
subtest27of10,pubtest266of100,1,321,5486,34,122,5642
subtest23of10,pubtest266of100,1,321,5486,36,160,5682
subtest21of10,pubtest266of100,1,321,5486,36,200,5722
subtest26of10,pubtest266of100,1,321,5486,36,238,5760
subtest28of10,pubtest266of100,1,321,5486,37,278,5801
subtest25of10,pubtest266of100,1,321,5486,30,318,5834
subtest24of10,pubtest266of100,1,321,5486,39,357,5882
subtest22of10,pubtest266of100,1,321,5486,40,396,5922
subtest23of10,pubtest267of100,1,323,5427,16,40,5483
subtest26of10,pubtest267of100,1,323,5427,25,70,5522
subtest25of10,pubtest267of100,1,323,5427,28,107,5562
subtest28of10,pubtest267of100,1,323,5427,28,147,5602
subtest24of10,pubtest267of100,1,323,5427,30,185,5642
subtest21of10,pubtest267of100,1,323,5427,31,224,5682
subtest27of10,pubtest267of100,1,323,5427,30,264,5721
subtest22of10,pubtest267of100,1,323,5427,30,303,5760
subtest210of10,pubtest267of100,1,323,5427,33,342,5802
subtest29of10,pubtest267of100,1,323,5427,36,379,5842
subtest23of10,pubtest268of100,1,323,5364,12,40,5416
subtest24of10,pubtest268of100,1,323,5364,14,78,5456
subtest25of10,pubtest268of100,1,323,5364,16,116,5496
subtest28of10,pubtest268of100,1,323,5364,17,155,5536
subtest29of10,pubtest268of100,1,323,5364,17,191,5572
subtest27of10,pubtest268of100,1,323,5364,22,230,5616
subtest22of10,pubtest268of100,1,323,5364,42,250,5656
subtest21of10,pubtest268of100,1,323,5364,43,289,5696
subtest26of10,pubtest268of100,1,323,5364,44,328,5736
subtest210of10,pubtest268of100,1,323,5364,45,367,5776
subtest24of10,pubtest269of100,1,323,5379,12,41,5432
subtest27of10,pubtest269of100,1,323,5379,24,68,5471
subtest210of10,pubtest269of100,1,323,5379,24,110,5513
subtest26of10,pubtest269of100,1,323,5379,27,146,5552
subtest25of10,pubtest269of100,1,323,5379,27,185,5591
subtest21of10,pubtest269of100,1,323,5379,29,223,5631
subtest22of10,pubtest269of100,1,323,5379,29,264,5672
subtest29of10,pubtest269of100,1,323,5379,39,293,5711
subtest23of10,pubtest269of100,1,323,5379,40,332,5751
subtest28of10,pubtest269of100,1,323,5379,41,371,5791
subtest23of10,pubtest270of100,1,323,5299,9,441,5749
subtest27of10,pubtest270of100,1,323,5299,14,474,5787
subtest26of10,pubtest270of100,1,323,5299,15,513,5827
subtest29of10,pubtest270of100,1,323,5299,16,552,5867
subtest210of10,pubtest270of100,1,323,5299,17,591,5907
subtest25of10,pubtest270of100,1,323,5299,20,628,5947
subtest21of10,pubtest270of100,1,323,5299,22,666,5987
subtest28of10,pubtest270of100,1,323,5299,23,704,6026
subtest24of10,pubtest270of100,1,323,5299,25,742,6066
subtest22of10,pubtest270of100,1,323,5299,26,782,6107
subtest24of10,pubtest271of100,1,323,5305,23,48,5376
subtest25of10,pubtest271of100,1,323,5305,28,82,5415
subtest27of10,pubtest271of100,1,323,5305,30,120,5455
subtest26of10,pubtest271of100,1,323,5305,32,516,5853
subtest22of10,pubtest271of100,1,323,5305,32,552,5889
subtest210of10,pubtest271of100,1,323,5305,32,591,5928
subtest21of10,pubtest271of100,1,323,5305,40,626,5971
subtest28of10,pubtest271of100,1,323,5305,41,665,6011
subtest23of10,pubtest271of100,1,323,5305,42,704,6051
subtest29of10,pubtest271of100,1,323,5305,42,744,6091
subtest25of10,pubtest272of100,1,323,5241,13,38,5292
subtest21of10,pubtest272of100,1,323,5241,15,76,5332
subtest26of10,pubtest272of100,1,323,5241,20,110,5371
subtest29of10,pubtest272of100,1,323,5241,21,149,5411
subtest24of10,pubtest272of100,1,323,5241,22,189,5452
subtest23of10,pubtest272of100,1,323,5241,23,228,5492
subtest27of10,pubtest272of100,1,323,5241,24,267,5532
subtest22of10,pubtest272of100,1,323,5241,29,301,5571
subtest28of10,pubtest272of100,1,323,5241,30,341,5612
subtest210of10,pubtest272of100,1,323,5241,29,379,5649
subtest22of10,pubtest273of100,1,321,5276,40,42,5358
subtest26of10,pubtest273of100,1,321,5276,41,79,5396
subtest29of10,pubtest273of100,1,321,5276,42,118,5436
subtest28of10,pubtest273of100,1,321,5276,43,157,5476
subtest25of10,pubtest273of100,1,321,5276,44,196,5516
subtest210of10,pubtest273of100,1,321,5276,47,234,5557
subtest27of10,pubtest273of100,1,321,5276,47,271,5594
subtest23of10,pubtest273of100,1,321,5276,50,310,5636
subtest21of10,pubtest273of100,1,321,5276,51,349,5676
subtest24of10,pubtest273of100,1,321,5276,52,389,5717
subtest21of10,pubtest274of100,1,323,5259,11,40,5310
subtest23of10,pubtest274of100,1,323,5259,19,70,5348
subtest26of10,pubtest274of100,1,323,5259,19,109,5387
subtest29of10,pubtest274of100,1,323,5259,21,149,5429
subtest25of10,pubtest274of100,1,323,5259,24,186,5469
subtest27of10,pubtest274of100,1,323,5259,25,226,5510
subtest22of10,pubtest274of100,1,323,5259,26,266,5551
subtest28of10,pubtest274of100,1,323,5259,27,304,5590
subtest24of10,pubtest274of100,1,323,5259,28,342,5629
subtest210of10,pubtest274of100,1,323,5259,35,375,5669
subtest27of10,pubtest275of100,1,323,5370,10,41,5421
subtest29of10,pubtest275of100,1,323,5370,12,78,5460
subtest24of10,pubtest275of100,1,323,5370,13,117,5500
subtest25of10,pubtest275of100,1,323,5370,14,156,5540
subtest22of10,pubtest275of100,1,323,5370,21,189,5580
subtest21of10,pubtest275of100,1,323,5370,21,229,5620
subtest210of10,pubtest275of100,1,323,5370,23,267,5660
subtest23of10,pubtest275of100,1,323,5370,28,302,5700
subtest26of10,pubtest275of100,1,323,5370,31,338,5739
subtest28of10,pubtest275of100,1,323,5370,32,378,5780
subtest28of10,pubtest276of100,1,323,5298,15,41,5354
subtest21of10,pubtest276of100,1,323,5298,15,80,5393
subtest25of10,pubtest276of100,1,323,5298,17,118,5433
subtest27of10,pubtest276of100,1,323,5298,18,157,5473
subtest26of10,pubtest276of100,1,323,5298,27,188,5513
subtest210of10,pubtest276of100,1,323,5298,28,227,5553
subtest29of10,pubtest276of100,1,323,5298,27,267,5592
subtest24of10,pubtest276of100,1,323,5298,24,306,5628
subtest22of10,pubtest276of100,1,323,5298,29,346,5673
subtest23of10,pubtest276of100,1,323,5298,30,385,5713
subtest22of10,pubtest277of100,1,323,5247,10,40,5297
subtest21of10,pubtest277of100,1,323,5247,13,76,5336
subtest29of10,pubtest277of100,1,323,5247,13,115,5375
subtest28of10,pubtest277of100,1,323,5247,16,155,5418
subtest27of10,pubtest277of100,1,323,5247,20,190,5457
subtest25of10,pubtest277of100,1,323,5247,27,222,5496
subtest24of10,pubtest277of100,1,323,5247,29,260,5536
subtest210of10,pubtest277of100,1,323,5247,29,300,5576
subtest23of10,pubtest277of100,1,323,5247,29,339,5615
subtest26of10,pubtest277of100,1,323,5247,31,378,5656
subtest29of10,pubtest278of100,1,323,5315,9,39,5363
subtest22of10,pubtest278of100,1,323,5315,10,79,5404
subtest21of10,pubtest278of100,1,323,5315,41,88,5444
subtest28of10,pubtest278of100,1,323,5315,41,127,5483
subtest23of10,pubtest278of100,1,323,5315,41,166,5522
subtest27of10,pubtest278of100,1,323,5315,43,205,5563
subtest25of10,pubtest278of100,1,323,5315,51,236,5602
subtest210of10,pubtest278of100,1,323,5315,53,275,5643
subtest26of10,pubtest278of100,1,323,5315,52,315,5682
subtest24of10,pubtest278of100,1,323,5315,53,354,5722
subtest28of10,pubtest279of100,1,323,6998,13,41,7052
subtest25of10,pubtest279of100,1,323,6998,15,78,7091
subtest21of10,pubtest279of100,1,323,6998,18,115,7131
subtest24of10,pubtest279of100,1,323,6998,18,155,7171
subtest29of10,pubtest279of100,1,323,6998,21,192,7211
subtest26of10,pubtest279of100,1,323,6998,22,232,7252
subtest27of10,pubtest279of100,1,323,6998,23,270,7291
subtest23of10,pubtest279of100,1,323,6998,30,303,7331
subtest210of10,pubtest279of100,1,323,6998,30,343,7371
subtest22of10,pubtest279of100,1,323,6998,30,382,7410
subtest27of10,pubtest280of100,1,323,6303,20,46,6369
subtest24of10,pubtest280of100,1,323,6303,21,84,6408
subtest29of10,pubtest280of100,1,323,6303,22,123,6448
subtest21of10,pubtest280of100,1,323,6303,23,162,6488
subtest23of10,pubtest280of100,1,323,6303,24,201,6528
subtest26of10,pubtest280of100,1,323,6303,25,240,6568
subtest25of10,pubtest280of100,1,323,6303,25,280,6608
subtest210of10,pubtest280of100,1,323,6303,27,318,6648
subtest28of10,pubtest280of100,1,323,6303,31,354,6688
subtest22of10,pubtest280of100,1,323,6303,32,393,6728
subtest24of10,pubtest281of100,1,323,5268,31,38,5337
subtest28of10,pubtest281of100,1,323,5268,35,73,5376
subtest22of10,pubtest281of100,1,323,5268,37,110,5415
subtest27of10,pubtest281of100,1,323,5268,40,148,5456
subtest210of10,pubtest281of100,1,323,5268,40,188,5496
subtest26of10,pubtest281of100,1,323,5268,42,226,5536
subtest25of10,pubtest281of100,1,323,5268,42,266,5576
subtest23of10,pubtest281of100,1,323,5268,37,306,5611
subtest21of10,pubtest281of100,1,323,5268,43,347,5658
subtest29of10,pubtest281of100,1,323,5268,44,385,5697
subtest23of10,pubtest282of100,1,323,5307,14,41,5362
subtest24of10,pubtest282of100,1,323,5307,15,79,5401
subtest21of10,pubtest282of100,1,323,5307,17,117,5441
subtest22of10,pubtest282of100,1,323,5307,17,158,5482
subtest29of10,pubtest282of100,1,323,5307,19,195,5521
subtest26of10,pubtest282of100,1,323,5307,19,235,5561
subtest27of10,pubtest282of100,1,323,5307,20,274,5601
subtest25of10,pubtest282of100,1,323,5307,19,314,5640
subtest210of10,pubtest282of100,1,323,5307,20,352,5679
subtest28of10,pubtest282of100,1,323,5307,22,390,5719
subtest27of10,pubtest283of100,1,323,5256,14,40,5310
subtest24of10,pubtest283of100,1,323,5256,14,78,5348
subtest22of10,pubtest283of100,1,323,5256,16,117,5389
subtest23of10,pubtest283of100,1,323,5256,16,156,5428
subtest28of10,pubtest283of100,1,323,5256,18,193,5467
subtest25of10,pubtest283of100,1,323,5256,18,233,5507
subtest21of10,pubtest283of100,1,323,5256,26,266,5548
subtest210of10,pubtest283of100,1,323,5256,32,300,5588
subtest29of10,pubtest283of100,1,323,5256,34,338,5628
subtest26of10,pubtest283of100,1,323,5256,39,374,5669
subtest24of10,pubtest284of100,1,323,5317,94,41,5452
subtest25of10,pubtest284of100,1,323,5317,11,87,5415
subtest26of10,pubtest284of100,1,323,5317,92,123,5532
subtest23of10,pubtest284of100,1,323,5317,96,159,5572
subtest210of10,pubtest284of100,1,323,5317,95,199,5611
subtest27of10,pubtest284of100,1,323,5317,95,237,5649
subtest28of10,pubtest284of100,1,323,5317,95,276,5688
subtest29of10,pubtest284of100,1,323,5317,98,316,5731
subtest21of10,pubtest284of100,1,323,5317,95,355,5767
subtest22of10,pubtest284of100,1,323,5317,98,395,5810
subtest23of10,pubtest285of100,1,323,5427,12,41,5480
subtest25of10,pubtest285of100,1,323,5427,15,78,5520
subtest27of10,pubtest285of100,1,323,5427,15,118,5560
subtest24of10,pubtest285of100,1,323,5427,17,156,5600
subtest21of10,pubtest285of100,1,323,5427,29,184,5640
subtest22of10,pubtest285of100,1,323,5427,30,221,5678
subtest29of10,pubtest285of100,1,323,5427,32,261,5720
subtest28of10,pubtest285of100,1,323,5427,36,297,5760
subtest210of10,pubtest285of100,1,323,5427,40,333,5800
subtest26of10,pubtest285of100,1,323,5427,44,369,5840
subtest24of10,pubtest286of100,1,323,5366,26,42,5434
subtest210of10,pubtest286of100,1,323,5366,27,81,5474
subtest25of10,pubtest286of100,1,323,5366,26,119,5511
subtest23of10,pubtest286of100,1,323,5366,24,159,5549
subtest29of10,pubtest286of100,1,323,5366,30,197,5593
subtest26of10,pubtest286of100,1,323,5366,31,236,5633
subtest27of10,pubtest286of100,1,323,5366,33,275,5674
subtest21of10,pubtest286of100,1,323,5366,32,315,5713
subtest22of10,pubtest286of100,1,323,5366,34,353,5753
subtest28of10,pubtest286of100,1,323,5366,35,392,5793
subtest26of10,pubtest287of100,1,323,5257,20,39,5316
subtest28of10,pubtest287of100,1,323,5257,20,78,5355
subtest29of10,pubtest287of100,1,323,5257,22,116,5395
subtest27of10,pubtest287of100,1,323,5257,25,153,5435
subtest25of10,pubtest287of100,1,323,5257,27,190,5474
subtest210of10,pubtest287of100,1,323,5257,25,232,5514
subtest24of10,pubtest287of100,1,323,5257,35,263,5555
subtest21of10,pubtest287of100,1,323,5257,36,302,5595
subtest23of10,pubtest287of100,1,323,5257,37,342,5636
subtest22of10,pubtest287of100,1,323,5257,42,376,5675
subtest29of10,pubtest288of100,1,323,5388,23,41,5452
subtest26of10,pubtest288of100,1,323,5388,24,79,5491
subtest25of10,pubtest288of100,1,323,5388,26,118,5532
subtest27of10,pubtest288of100,1,323,5388,62,121,5571
subtest22of10,pubtest288of100,1,323,5388,62,161,5611
subtest21of10,pubtest288of100,1,323,5388,64,200,5652
subtest210of10,pubtest288of100,1,323,5388,68,235,5691
subtest23of10,pubtest288of100,1,323,5388,68,275,5731
subtest28of10,pubtest288of100,1,323,5388,72,311,5771
subtest24of10,pubtest288of100,1,323,5388,74,349,5811
subtest29of10,pubtest289of100,1,323,5280,10,43,5333
subtest23of10,pubtest289of100,1,323,5280,12,80,5372
subtest24of10,pubtest289of100,1,323,5280,14,118,5412
subtest210of10,pubtest289of100,1,323,5280,14,158,5452
subtest25of10,pubtest289of100,1,323,5280,21,191,5492
subtest26of10,pubtest289of100,1,323,5280,21,232,5533
subtest27of10,pubtest289of100,1,323,5280,25,267,5572
subtest21of10,pubtest289of100,1,323,5280,28,303,5611
subtest28of10,pubtest289of100,1,323,5280,29,343,5652
subtest22of10,pubtest289of100,1,323,5280,30,382,5692
subtest29of10,pubtest290of100,1,323,5324,9,41,5374
subtest23of10,pubtest290of100,1,323,5324,13,78,5415
subtest22of10,pubtest290of100,1,323,5324,15,116,5455
subtest25of10,pubtest290of100,1,323,5324,16,155,5495
subtest26of10,pubtest290of100,1,323,5324,19,192,5535
subtest27of10,pubtest290of100,1,323,5324,21,230,5575
subtest21of10,pubtest290of100,1,323,5324,21,270,5615
subtest28of10,pubtest290of100,1,323,5324,24,307,5655
subtest210of10,pubtest290of100,1,323,5324,23,347,5694
subtest24of10,pubtest290of100,1,323,5324,25,386,5735
subtest24of10,pubtest291of100,1,323,5470,17,39,5526
subtest23of10,pubtest291of100,1,323,5470,18,78,5566
subtest28of10,pubtest291of100,1,323,5470,21,115,5606
subtest27of10,pubtest291of100,1,323,5470,21,155,5646
subtest25of10,pubtest291of100,1,323,5470,23,193,5686
subtest21of10,pubtest291of100,1,323,5470,23,232,5725
subtest22of10,pubtest291of100,1,323,5470,24,273,5767
subtest210of10,pubtest291of100,1,323,5470,23,311,5804
subtest29of10,pubtest291of100,1,323,5470,26,351,5847
subtest26of10,pubtest291of100,1,323,5470,48,368,5886
subtest21of10,pubtest292of100,1,323,5303,18,40,5361
subtest28of10,pubtest292of100,1,323,5303,17,79,5399
subtest29of10,pubtest292of100,1,323,5303,17,119,5439
subtest27of10,pubtest292of100,1,323,5303,20,157,5480
subtest25of10,pubtest292of100,1,323,5303,19,196,5518
subtest26of10,pubtest292of100,1,323,5303,23,234,5560
subtest23of10,pubtest292of100,1,323,5303,24,273,5600
subtest22of10,pubtest292of100,1,323,5303,25,312,5640
subtest24of10,pubtest292of100,1,323,5303,32,345,5680
subtest210of10,pubtest292of100,1,323,5303,33,384,5720
subtest24of10,pubtest293of100,1,323,5371,16,125,5512
subtest25of10,pubtest293of100,1,323,5371,17,160,5548
subtest23of10,pubtest293of100,1,323,5371,20,197,5588
subtest28of10,pubtest293of100,1,323,5371,22,235,5628
subtest27of10,pubtest293of100,1,323,5371,23,274,5668
subtest21of10,pubtest293of100,1,323,5371,24,314,5709
subtest210of10,pubtest293of100,1,323,5371,24,352,5747
subtest29of10,pubtest293of100,1,323,5371,25,392,5788
subtest26of10,pubtest293of100,1,323,5371,47,410,5828
subtest22of10,pubtest293of100,1,323,5371,48,451,5870
subtest21of10,pubtest294of100,1,323,5306,12,38,5356
subtest210of10,pubtest294of100,1,323,5306,14,76,5396
subtest25of10,pubtest294of100,1,323,5306,19,111,5436
subtest29of10,pubtest294of100,1,323,5306,20,150,5476
subtest26of10,pubtest294of100,1,323,5306,21,189,5516
subtest27of10,pubtest294of100,1,323,5306,21,229,5556
subtest23of10,pubtest294of100,1,323,5306,26,264,5596
subtest24of10,pubtest294of100,1,323,5306,27,303,5636
subtest22of10,pubtest294of100,1,323,5306,34,336,5676
subtest28of10,pubtest294of100,1,323,5306,34,377,5717
subtest25of10,pubtest295of100,1,323,5378,21,40,5439
subtest24of10,pubtest295of100,1,323,5378,33,68,5479
subtest23of10,pubtest295of100,1,323,5378,40,100,5518
subtest27of10,pubtest295of100,1,323,5378,55,126,5559
subtest29of10,pubtest295of100,1,323,5378,56,164,5598
subtest22of10,pubtest295of100,1,323,5378,56,204,5638
subtest28of10,pubtest295of100,1,323,5378,59,241,5678
subtest21of10,pubtest295of100,1,323,5378,58,281,5717
subtest210of10,pubtest295of100,1,323,5378,58,320,5756
subtest26of10,pubtest295of100,1,323,5378,61,360,5799
subtest25of10,pubtest296of100,1,322,5442,285,40,5767
subtest27of10,pubtest296of100,1,322,5442,288,76,5806
subtest23of10,pubtest296of100,1,322,5442,291,113,5846
subtest29of10,pubtest296of100,1,322,5442,292,152,5886
subtest21of10,pubtest296of100,1,322,5442,298,186,5926
subtest24of10,pubtest296of100,1,322,5442,299,225,5966
subtest26of10,pubtest296of100,1,322,5442,300,264,6006
subtest210of10,pubtest296of100,1,322,5442,301,305,6048
subtest22of10,pubtest296of100,1,322,5442,302,343,6087
subtest28of10,pubtest296of100,1,322,5442,301,382,6125
subtest25of10,pubtest297of100,1,323,5521,15,39,5575
subtest210of10,pubtest297of100,1,323,5521,15,78,5614
subtest23of10,pubtest297of100,1,323,5521,17,116,5654
subtest29of10,pubtest297of100,1,323,5521,17,156,5694
subtest22of10,pubtest297of100,1,323,5521,19,194,5734
subtest27of10,pubtest297of100,1,323,5521,20,233,5774
subtest21of10,pubtest297of100,1,323,5521,21,274,5816
subtest26of10,pubtest297of100,1,323,5521,22,311,5854
subtest28of10,pubtest297of100,1,323,5521,22,351,5894
subtest24of10,pubtest297of100,1,323,5521,28,385,5934
subtest29of10,pubtest298of100,1,323,5264,13,41,5318
subtest22of10,pubtest298of100,1,323,5264,14,80,5358
subtest24of10,pubtest298of100,1,323,5264,15,118,5397
subtest25of10,pubtest298of100,1,323,5264,15,158,5437
subtest23of10,pubtest298of100,1,323,5264,19,195,5478
subtest210of10,pubtest298of100,1,323,5264,21,232,5517
subtest21of10,pubtest298of100,1,323,5264,22,271,5557
subtest28of10,pubtest298of100,1,323,5264,28,305,5597
subtest27of10,pubtest298of100,1,323,5264,28,345,5637
subtest26of10,pubtest298of100,1,323,5264,30,384,5678
subtest22of10,pubtest299of100,1,323,5239,10,42,5291
subtest210of10,pubtest299of100,1,323,5239,11,80,5330
subtest29of10,pubtest299of100,1,323,5239,19,111,5369
subtest27of10,pubtest299of100,1,323,5239,20,151,5410
subtest25of10,pubtest299of100,1,323,5239,21,190,5450
subtest24of10,pubtest299of100,1,323,5239,22,230,5491
subtest21of10,pubtest299of100,1,323,5239,23,268,5530
subtest23of10,pubtest299of100,1,323,5239,23,308,5570
subtest28of10,pubtest299of100,1,323,5239,24,347,5610
subtest26of10,pubtest299of100,1,323,5239,25,386,5650
subtest21of10,pubtest2100of100,1,325,5236,10,40,5286
subtest24of10,pubtest2100of100,1,325,5236,17,71,5324
subtest22of10,pubtest2100of100,1,325,5236,19,111,5366
subtest27of10,pubtest2100of100,1,325,5236,18,151,5405
subtest23of10,pubtest2100of100,1,325,5236,17,189,5442
subtest29of10,pubtest2100of100,1,325,5236,17,228,5481
subtest25of10,pubtest2100of100,1,325,5236,28,262,5526
subtest210of10,pubtest2100of100,1,325,5236,30,300,5566
subtest26of10,pubtest2100of100,1,325,5236,31,338,5605
subtest28of10,pubtest2100of100,1,325,5236,29,378,5643
subtest27of10,pubtest21of100,1,322,10294,9,42,10345
subtest26of10,pubtest21of100,1,322,10294,12,79,10385
subtest29of10,pubtest21of100,1,322,10294,13,118,10425
subtest25of10,pubtest21of100,1,322,10294,15,155,10464
subtest24of10,pubtest21of100,1,322,10294,16,196,10506
subtest21of10,pubtest21of100,1,322,10294,19,231,10544
subtest210of10,pubtest21of100,1,322,10294,27,263,10584
subtest28of10,pubtest21of100,1,322,10294,52,277,10623
subtest23of10,pubtest21of100,1,322,10294,53,317,10664
subtest22of10,pubtest21of100,1,322,10294,56,355,10705
subtest29of10,pubtest22of100,1,321,5333,23,39,5395
subtest24of10,pubtest22of100,1,321,5333,30,71,5434
subtest27of10,pubtest22of100,1,321,5333,30,111,5474
subtest23of10,pubtest22of100,1,321,5333,34,147,5514
subtest28of10,pubtest22of100,1,321,5333,36,185,5554
subtest25of10,pubtest22of100,1,321,5333,36,225,5594
subtest21of10,pubtest22of100,1,321,5333,37,264,5634
subtest26of10,pubtest22of100,1,321,5333,38,303,5674
subtest22of10,pubtest22of100,1,321,5333,39,345,5717
subtest210of10,pubtest22of100,1,321,5333,39,382,5754
subtest29of10,pubtest23of100,1,321,5314,12,42,5368
subtest27of10,pubtest23of100,1,321,5314,14,79,5407
subtest23of10,pubtest23of100,1,321,5314,12,118,5444
subtest28of10,pubtest23of100,1,321,5314,17,156,5487
subtest25of10,pubtest23of100,1,321,5314,21,194,5529
subtest24of10,pubtest23of100,1,321,5314,25,229,5568
subtest21of10,pubtest23of100,1,321,5314,25,267,5606
subtest26of10,pubtest23of100,1,321,5314,27,306,5647
subtest22of10,pubtest23of100,1,321,5314,27,346,5687
subtest210of10,pubtest23of100,1,321,5314,30,383,5727
subtest23of10,pubtest24of100,1,321,5279,8,39,5326
subtest24of10,pubtest24of100,1,321,5279,9,77,5365
subtest25of10,pubtest24of100,1,321,5279,10,115,5404
subtest28of10,pubtest24of100,1,321,5279,11,155,5445
subtest21of10,pubtest24of100,1,321,5279,13,193,5485
subtest29of10,pubtest24of100,1,321,5279,14,232,5525
subtest27of10,pubtest24of100,1,321,5279,15,273,5567
subtest22of10,pubtest24of100,1,321,5279,21,306,5606
subtest210of10,pubtest24of100,1,321,5279,23,343,5645
subtest26of10,pubtest24of100,1,321,5279,27,379,5685
subtest28of10,pubtest25of100,1,321,5509,11,39,5559
subtest210of10,pubtest25of100,1,321,5509,12,79,5600
subtest21of10,pubtest25of100,1,321,5509,15,114,5638
subtest26of10,pubtest25of100,1,321,5509,52,117,5678
subtest27of10,pubtest25of100,1,321,5509,53,156,5718
subtest22of10,pubtest25of100,1,321,5509,84,167,5760
subtest25of10,pubtest25of100,1,321,5509,85,205,5799
subtest24of10,pubtest25of100,1,321,5509,88,241,5838
subtest23of10,pubtest25of100,1,321,5509,88,281,5878
subtest29of10,pubtest25of100,1,321,5509,93,316,5918
subtest22of10,pubtest26of100,1,321,5293,82,41,5416
subtest21of10,pubtest26of100,1,321,5293,99,63,5455
subtest23of10,pubtest26of100,1,321,5293,101,102,5496
subtest26of10,pubtest26of100,1,321,5293,101,141,5535
subtest25of10,pubtest26of100,1,321,5293,101,180,5574
subtest27of10,pubtest26of100,1,321,5293,101,219,5613
subtest210of10,pubtest26of100,1,321,5293,104,258,5655
subtest29of10,pubtest26of100,1,321,5293,99,298,5690
subtest28of10,pubtest26of100,1,321,5293,104,338,5735
subtest24of10,pubtest26of100,1,321,5293,106,376,5775
subtest28of10,pubtest27of100,1,320,5303,11,47,5361
subtest27of10,pubtest27of100,1,320,5303,10,88,5401
subtest23of10,pubtest27of100,1,320,5303,12,125,5440
subtest24of10,pubtest27of100,1,320,5303,16,161,5480
subtest29of10,pubtest27of100,1,320,5303,22,195,5520
subtest25of10,pubtest27of100,1,320,5303,23,234,5560
subtest21of10,pubtest27of100,1,320,5303,23,274,5600
subtest210of10,pubtest27of100,1,320,5303,27,309,5639
subtest22of10,pubtest27of100,1,320,5303,27,349,5679
subtest26of10,pubtest27of100,1,320,5303,34,383,5720
subtest27of10,pubtest28of100,1,321,5235,6,39,5280
subtest21of10,pubtest28of100,1,321,5235,12,72,5319
subtest28of10,pubtest28of100,1,321,5235,14,110,5359
subtest29of10,pubtest28of100,1,321,5235,15,150,5400
subtest23of10,pubtest28of100,1,321,5235,16,188,5439
subtest210of10,pubtest28of100,1,321,5235,19,229,5483
subtest25of10,pubtest28of100,1,321,5235,19,269,5523
subtest26of10,pubtest28of100,1,321,5235,24,304,5563
subtest24of10,pubtest28of100,1,321,5235,25,343,5603
subtest22of10,pubtest28of100,1,321,5235,29,377,5641
subtest23of10,pubtest29of100,1,321,5407,102,41,5550
subtest29of10,pubtest29of100,1,321,5407,103,79,5589
subtest210of10,pubtest29of100,1,321,5407,104,118,5629
subtest25of10,pubtest29of100,1,321,5407,105,157,5669
subtest21of10,pubtest29of100,1,321,5407,106,196,5709
subtest22of10,pubtest29of100,1,321,5407,106,236,5749
subtest27of10,pubtest29of100,1,321,5407,109,273,5789
subtest28of10,pubtest29of100,1,321,5407,110,312,5829
subtest24of10,pubtest29of100,1,321,5407,113,349,5869
subtest26of10,pubtest29of100,1,321,5407,113,387,5907
subtest29of10,pubtest210of100,1,323,5475,13,42,5530
subtest21of10,pubtest210of100,1,323,5475,14,80,5569
subtest27of10,pubtest210of100,1,323,5475,28,106,5609
subtest210of10,pubtest210of100,1,323,5475,34,139,5648
subtest23of10,pubtest210of100,1,323,5475,34,179,5688
subtest25of10,pubtest210of100,1,323,5475,35,217,5727
subtest28of10,pubtest210of100,1,323,5475,36,257,5768
subtest24of10,pubtest210of100,1,323,5475,89,244,5808
subtest22of10,pubtest210of100,1,323,5475,92,281,5848
subtest26of10,pubtest210of100,1,323,5475,92,321,5888
subtest210of10,pubtest211of100,1,323,5624,10,38,5672
subtest24of10,pubtest211of100,1,323,5624,13,74,5711
subtest21of10,pubtest211of100,1,323,5624,17,110,5751
subtest29of10,pubtest211of100,1,323,5624,17,150,5791
subtest22of10,pubtest211of100,1,323,5624,71,136,5831
subtest25of10,pubtest211of100,1,323,5624,71,176,5871
subtest23of10,pubtest211of100,1,323,5624,83,204,5911
subtest27of10,pubtest211of100,1,323,5624,83,244,5951
subtest28of10,pubtest211of100,1,323,5624,84,281,5989
subtest26of10,pubtest211of100,1,323,5624,86,321,6031
subtest25of10,pubtest212of100,1,323,5284,10,41,5335
subtest29of10,pubtest212of100,1,323,5284,17,73,5374
subtest28of10,pubtest212of100,1,323,5284,18,112,5414
subtest23of10,pubtest212of100,1,323,5284,21,149,5454
subtest24of10,pubtest212of100,1,323,5284,22,188,5494
subtest21of10,pubtest212of100,1,323,5284,23,227,5534
subtest27of10,pubtest212of100,1,323,5284,23,267,5574
subtest22of10,pubtest212of100,1,323,5284,25,305,5614
subtest26of10,pubtest212of100,1,323,5284,30,340,5654
subtest210of10,pubtest212of100,1,323,5284,30,381,5695
subtest23of10,pubtest213of100,1,322,5347,11,38,5396
subtest26of10,pubtest213of100,1,322,5347,13,75,5435
subtest22of10,pubtest213of100,1,322,5347,13,115,5475
subtest29of10,pubtest213of100,1,322,5347,14,154,5515
subtest27of10,pubtest213of100,1,322,5347,17,191,5555
subtest21of10,pubtest213of100,1,322,5347,17,231,5595
subtest24of10,pubtest213of100,1,322,5347,17,270,5634
subtest210of10,pubtest213of100,1,322,5347,24,305,5676
subtest25of10,pubtest213of100,1,322,5347,29,339,5715
subtest28of10,pubtest213of100,1,322,5347,29,378,5754
subtest21of10,pubtest214of100,1,323,5461,9,42,5512
subtest23of10,pubtest214of100,1,323,5461,10,80,5551
subtest26of10,pubtest214of100,1,323,5461,15,115,5591
subtest27of10,pubtest214of100,1,323,5461,15,155,5631
subtest29of10,pubtest214of100,1,323,5461,17,193,5671
subtest210of10,pubtest214of100,1,323,5461,17,231,5709
subtest24of10,pubtest214of100,1,323,5461,18,269,5748
subtest25of10,pubtest214of100,1,323,5461,15,309,5785
subtest28of10,pubtest214of100,1,323,5461,21,348,5830
subtest22of10,pubtest214of100,1,323,5461,17,389,5867
subtest27of10,pubtest215of100,1,323,5427,23,42,5492
subtest24of10,pubtest215of100,1,323,5427,24,80,5531
subtest29of10,pubtest215of100,1,323,5427,27,117,5571
subtest26of10,pubtest215of100,1,323,5427,28,156,5611
subtest21of10,pubtest215of100,1,323,5427,29,196,5652
subtest210of10,pubtest215of100,1,323,5427,32,230,5689
subtest25of10,pubtest215of100,1,323,5427,32,270,5729
subtest23of10,pubtest215of100,1,323,5427,34,309,5770
subtest22of10,pubtest215of100,1,323,5427,36,350,5813
subtest28of10,pubtest215of100,1,323,5427,42,382,5851
subtest24of10,pubtest216of100,1,323,5320,16,44,5380
subtest23of10,pubtest216of100,1,323,5320,20,78,5418
subtest21of10,pubtest216of100,1,323,5320,20,117,5457
subtest28of10,pubtest216of100,1,323,5320,25,152,5497
subtest27of10,pubtest216of100,1,323,5320,27,190,5537
subtest26of10,pubtest216of100,1,323,5320,33,224,5577
subtest25of10,pubtest216of100,1,323,5320,33,264,5617
subtest29of10,pubtest216of100,1,323,5320,34,302,5656
subtest22of10,pubtest216of100,1,323,5320,35,342,5697
subtest210of10,pubtest216of100,1,323,5320,81,336,5737
subtest27of10,pubtest217of100,1,322,5342,23,40,5405
subtest22of10,pubtest217of100,1,322,5342,23,77,5442
subtest21of10,pubtest217of100,1,322,5342,27,114,5483
subtest26of10,pubtest217of100,1,322,5342,31,150,5523
subtest23of10,pubtest217of100,1,322,5342,31,187,5560
subtest24of10,pubtest217of100,1,322,5342,32,226,5600
subtest25of10,pubtest217of100,1,322,5342,36,266,5644
subtest28of10,pubtest217of100,1,322,5342,34,305,5681
subtest29of10,pubtest217of100,1,322,5342,32,345,5719
subtest210of10,pubtest217of100,1,322,5342,52,369,5763
subtest29of10,pubtest218of100,1,323,5332,40,42,5414
subtest21of10,pubtest218of100,1,323,5332,43,78,5453
subtest27of10,pubtest218of100,1,323,5332,45,116,5493
subtest22of10,pubtest218of100,1,323,5332,47,154,5533
subtest25of10,pubtest218of100,1,323,5332,48,191,5571
subtest28of10,pubtest218of100,1,323,5332,50,231,5613
subtest24of10,pubtest218of100,1,323,5332,52,269,5653
subtest26of10,pubtest218of100,1,323,5332,53,308,5693
subtest210of10,pubtest218of100,1,323,5332,53,349,5734
subtest23of10,pubtest218of100,1,323,5332,48,388,5768
subtest210of10,pubtest219of100,1,323,5344,52,43,5439
subtest25of10,pubtest219of100,1,323,5344,53,81,5478
subtest26of10,pubtest219of100,1,323,5344,54,120,5518
subtest29of10,pubtest219of100,1,323,5344,56,155,5555
subtest27of10,pubtest219of100,1,323,5344,58,195,5597
subtest22of10,pubtest219of100,1,323,5344,55,235,5634
subtest24of10,pubtest219of100,1,323,5344,60,273,5677
subtest23of10,pubtest219of100,1,323,5344,61,312,5717
subtest28of10,pubtest219of100,1,323,5344,61,353,5758
subtest21of10,pubtest219of100,1,323,5344,55,391,5790
subtest25of10,pubtest220of100,1,323,5369,11,42,5422
subtest210of10,pubtest220of100,1,323,5369,13,79,5461
subtest23of10,pubtest220of100,1,323,5369,14,118,5501
subtest29of10,pubtest220of100,1,323,5369,20,149,5538
subtest21of10,pubtest220of100,1,323,5369,20,188,5577
subtest24of10,pubtest220of100,1,323,5369,24,228,5621
subtest27of10,pubtest220of100,1,323,5369,32,259,5660
subtest28of10,pubtest220of100,1,323,5369,32,299,5700
subtest22of10,pubtest220of100,1,323,5369,34,338,5741
subtest26of10,pubtest220of100,1,323,5369,34,376,5779
subtest24of10,pubtest221of100,1,323,5258,5,42,5305
subtest21of10,pubtest221of100,1,323,5258,30,55,5343
subtest23of10,pubtest221of100,1,323,5258,32,91,5381
subtest25of10,pubtest221of100,1,323,5258,35,131,5424
subtest28of10,pubtest221of100,1,323,5258,33,170,5461
subtest22of10,pubtest221of100,1,323,5258,44,201,5503
subtest29of10,pubtest221of100,1,323,5258,46,239,5543
subtest210of10,pubtest221of100,1,323,5258,46,280,5584
subtest27of10,pubtest221of100,1,323,5258,48,317,5623
subtest26of10,pubtest221of100,1,323,5258,50,355,5663
subtest21of10,pubtest222of100,1,323,5290,9,39,5338
subtest22of10,pubtest222of100,1,323,5290,9,78,5377
subtest27of10,pubtest222of100,1,323,5290,17,110,5417
subtest29of10,pubtest222of100,1,323,5290,18,149,5457
subtest23of10,pubtest222of100,1,323,5290,19,188,5497
subtest25of10,pubtest222of100,1,323,5290,19,228,5537
subtest28of10,pubtest222of100,1,323,5290,18,267,5575
subtest210of10,pubtest222of100,1,323,5290,21,306,5617
subtest26of10,pubtest222of100,1,323,5290,21,346,5657
subtest24of10,pubtest222of100,1,323,5290,24,383,5697
subtest21of10,pubtest223of100,1,323,5323,15,43,5381
subtest23of10,pubtest223of100,1,323,5323,16,80,5419
subtest28of10,pubtest223of100,1,323,5323,19,117,5459
subtest29of10,pubtest223of100,1,323,5323,20,156,5499
subtest24of10,pubtest223of100,1,323,5323,25,191,5539
subtest210of10,pubtest223of100,1,323,5323,25,231,5579
subtest27of10,pubtest223of100,1,323,5323,33,263,5619
subtest26of10,pubtest223of100,1,323,5323,36,299,5658
subtest22of10,pubtest223of100,1,323,5323,36,339,5698
subtest25of10,pubtest223of100,1,323,5323,42,374,5739
subtest21of10,pubtest224of100,1,323,5293,48,41,5382
subtest27of10,pubtest224of100,1,323,5293,99,42,5434
subtest28of10,pubtest224of100,1,323,5293,101,79,5473
subtest23of10,pubtest224of100,1,323,5293,102,118,5513
subtest26of10,pubtest224of100,1,323,5293,103,157,5553
subtest29of10,pubtest224of100,1,323,5293,103,197,5593
subtest25of10,pubtest224of100,1,323,5293,112,228,5633
subtest22of10,pubtest224of100,1,323,5293,112,268,5673
subtest24of10,pubtest224of100,1,323,5293,114,306,5713
subtest210of10,pubtest224of100,1,323,5293,114,346,5753
subtest27of10,pubtest225of100,1,323,5288,26,41,5355
subtest22of10,pubtest225of100,1,323,5288,28,78,5394
subtest21of10,pubtest225of100,1,323,5288,29,117,5434
subtest25of10,pubtest225of100,1,323,5288,31,155,5474
subtest26of10,pubtest225of100,1,323,5288,31,195,5514
subtest23of10,pubtest225of100,1,323,5288,42,224,5554
subtest24of10,pubtest225of100,1,323,5288,45,261,5594
subtest29of10,pubtest225of100,1,323,5288,46,301,5635
subtest28of10,pubtest225of100,1,323,5288,47,340,5675
subtest210of10,pubtest225of100,1,323,5288,48,378,5714
subtest25of10,pubtest226of100,1,323,5415,10,40,5465
subtest22of10,pubtest226of100,1,323,5415,11,79,5505
subtest23of10,pubtest226of100,1,323,5415,12,117,5544
subtest27of10,pubtest226of100,1,323,5415,13,155,5583
subtest210of10,pubtest226of100,1,323,5415,15,194,5624
subtest21of10,pubtest226of100,1,323,5415,18,231,5664
subtest29of10,pubtest226of100,1,323,5415,18,271,5704
subtest28of10,pubtest226of100,1,323,5415,20,309,5744
subtest26of10,pubtest226of100,1,323,5415,25,344,5784
subtest24of10,pubtest226of100,1,323,5415,27,382,5824
subtest23of10,pubtest227of100,1,323,5301,12,63,5376
subtest29of10,pubtest227of100,1,323,5301,11,101,5413
subtest21of10,pubtest227of100,1,323,5301,16,135,5452
subtest27of10,pubtest227of100,1,323,5301,16,176,5493
subtest210of10,pubtest227of100,1,323,5301,19,212,5532
subtest24of10,pubtest227of100,1,323,5301,21,252,5574
subtest26of10,pubtest227of100,1,323,5301,24,288,5613
subtest22of10,pubtest227of100,1,323,5301,27,324,5652
subtest28of10,pubtest227of100,1,323,5301,28,363,5692
subtest25of10,pubtest227of100,1,323,5301,11,357,5669
subtest21of10,pubtest228of100,1,323,5359,10,40,5409
subtest25of10,pubtest228of100,1,323,5359,13,76,5448
subtest26of10,pubtest228of100,1,323,5359,17,113,5489
subtest23of10,pubtest228of100,1,323,5359,22,146,5527
subtest27of10,pubtest228of100,1,323,5359,22,186,5567
subtest29of10,pubtest228of100,1,323,5359,24,227,5610
subtest210of10,pubtest228of100,1,323,5359,31,259,5649
subtest24of10,pubtest228of100,1,323,5359,31,298,5688
subtest22of10,pubtest228of100,1,323,5359,33,336,5728
subtest28of10,pubtest228of100,1,323,5359,33,376,5768
subtest24of10,pubtest229of100,1,321,5279,18,41,5338
subtest28of10,pubtest229of100,1,321,5279,20,80,5379
subtest21of10,pubtest229of100,1,321,5279,24,116,5419
subtest22of10,pubtest229of100,1,321,5279,26,153,5458
subtest27of10,pubtest229of100,1,321,5279,25,194,5498
subtest23of10,pubtest229of100,1,321,5279,28,232,5539
subtest210of10,pubtest229of100,1,321,5279,30,269,5578
subtest25of10,pubtest229of100,1,321,5279,34,305,5618
subtest26of10,pubtest229of100,1,321,5279,48,331,5658
subtest29of10,pubtest229of100,1,321,5279,49,368,5696
subtest22of10,pubtest230of100,1,323,5284,9,39,5332
subtest21of10,pubtest230of100,1,323,5284,10,77,5371
subtest29of10,pubtest230of100,1,323,5284,38,88,5410
subtest27of10,pubtest230of100,1,323,5284,38,128,5450
subtest25of10,pubtest230of100,1,323,5284,40,166,5490
subtest28of10,pubtest230of100,1,323,5284,40,205,5529
subtest23of10,pubtest230of100,1,323,5284,42,244,5570
subtest210of10,pubtest230of100,1,323,5284,45,281,5610
subtest24of10,pubtest230of100,1,323,5284,45,321,5650
subtest26of10,pubtest230of100,1,323,5284,48,357,5689
subtest23of10,pubtest231of100,1,323,5295,9,39,5343
subtest28of10,pubtest231of100,1,323,5295,11,77,5383
subtest25of10,pubtest231of100,1,323,5295,12,116,5423
subtest24of10,pubtest231of100,1,323,5295,14,154,5463
subtest29of10,pubtest231of100,1,323,5295,14,193,5502
subtest210of10,pubtest231of100,1,323,5295,16,231,5542
subtest27of10,pubtest231of100,1,323,5295,16,271,5582
subtest21of10,pubtest231of100,1,323,5295,18,308,5621
subtest22of10,pubtest231of100,1,323,5295,20,347,5662
subtest26of10,pubtest231of100,1,323,5295,18,386,5699
subtest21of10,pubtest232of100,1,323,5340,9,39,5388
subtest27of10,pubtest232of100,1,323,5340,10,77,5427
subtest22of10,pubtest232of100,1,323,5340,13,113,5466
subtest23of10,pubtest232of100,1,323,5340,14,153,5507
subtest29of10,pubtest232of100,1,323,5340,17,190,5547
subtest25of10,pubtest232of100,1,323,5340,18,229,5587
subtest28of10,pubtest232of100,1,323,5340,19,267,5626
subtest210of10,pubtest232of100,1,323,5340,22,305,5667
subtest24of10,pubtest232of100,1,323,5340,25,342,5707
subtest26of10,pubtest232of100,1,323,5340,26,382,5748
subtest24of10,pubtest233of100,1,323,5359,18,42,5419
subtest210of10,pubtest233of100,1,323,5359,19,79,5457
subtest26of10,pubtest233of100,1,323,5359,21,118,5498
subtest23of10,pubtest233of100,1,323,5359,23,155,5537
subtest25of10,pubtest233of100,1,323,5359,22,194,5575
subtest27of10,pubtest233of100,1,323,5359,21,233,5613
subtest29of10,pubtest233of100,1,323,5359,19,273,5651
subtest21of10,pubtest233of100,1,323,5359,26,312,5697
subtest22of10,pubtest233of100,1,323,5359,26,352,5737
subtest28of10,pubtest233of100,1,323,5359,27,390,5776
subtest25of10,pubtest234of100,1,323,5354,41,42,5437
subtest27of10,pubtest234of100,1,323,5354,42,78,5474
subtest26of10,pubtest234of100,1,323,5354,43,117,5514
subtest21of10,pubtest234of100,1,323,5354,44,154,5552
subtest22of10,pubtest234of100,1,323,5354,44,194,5592
subtest29of10,pubtest234of100,1,323,5354,47,233,5634
subtest23of10,pubtest234of100,1,323,5354,83,237,5674
subtest210of10,pubtest234of100,1,323,5354,84,276,5714
subtest28of10,pubtest234of100,1,323,5354,85,315,5754
subtest24of10,pubtest234of100,1,323,5354,86,354,5794
subtest210of10,pubtest235of100,1,321,5398,11,40,5449
subtest23of10,pubtest235of100,1,321,5398,21,69,5488
subtest27of10,pubtest235of100,1,321,5398,21,109,5528
subtest21of10,pubtest235of100,1,321,5398,19,151,5568
subtest29of10,pubtest235of100,1,321,5398,23,187,5608
subtest24of10,pubtest235of100,1,321,5398,24,226,5648
subtest25of10,pubtest235of100,1,321,5398,25,265,5688
subtest22of10,pubtest235of100,1,321,5398,26,304,5728
subtest26of10,pubtest235of100,1,321,5398,31,339,5768
subtest28of10,pubtest235of100,1,321,5398,31,378,5807
subtest23of10,pubtest236of100,1,323,5397,11,41,5449
subtest27of10,pubtest236of100,1,323,5397,19,74,5490
subtest25of10,pubtest236of100,1,323,5397,22,111,5530
subtest21of10,pubtest236of100,1,323,5397,23,150,5570
subtest210of10,pubtest236of100,1,323,5397,22,189,5608
subtest29of10,pubtest236of100,1,323,5397,25,228,5650
subtest28of10,pubtest236of100,1,323,5397,26,267,5690
subtest24of10,pubtest236of100,1,323,5397,27,307,5731
subtest26of10,pubtest236of100,1,323,5397,27,347,5771
subtest22of10,pubtest236of100,1,323,5397,28,385,5810
subtest23of10,pubtest237of100,1,323,5451,13,41,5505
subtest24of10,pubtest237of100,1,323,5451,13,80,5544
subtest25of10,pubtest237of100,1,323,5451,20,115,5586
subtest28of10,pubtest237of100,1,323,5451,21,153,5625
subtest26of10,pubtest237of100,1,323,5451,26,187,5664
subtest27of10,pubtest237of100,1,323,5451,26,227,5704
subtest21of10,pubtest237of100,1,323,5451,26,266,5743
subtest29of10,pubtest237of100,1,323,5451,28,305,5784
subtest210of10,pubtest237of100,1,323,5451,29,344,5824
subtest22of10,pubtest237of100,1,323,5451,29,383,5863
subtest29of10,pubtest238of100,1,323,5375,14,38,5427
subtest27of10,pubtest238of100,1,323,5375,16,75,5466
subtest28of10,pubtest238of100,1,323,5375,17,114,5506
subtest25of10,pubtest238of100,1,323,5375,18,153,5546
subtest210of10,pubtest238of100,1,323,5375,19,192,5586
subtest26of10,pubtest238of100,1,323,5375,20,231,5626
subtest22of10,pubtest238of100,1,323,5375,16,270,5661
subtest23of10,pubtest238of100,1,323,5375,19,310,5704
subtest21of10,pubtest238of100,1,323,5375,22,349,5746
subtest24of10,pubtest238of100,1,323,5375,24,386,5785
subtest21of10,pubtest239of100,1,323,5452,11,41,5504
subtest28of10,pubtest239of100,1,323,5452,12,80,5544
subtest27of10,pubtest239of100,1,323,5452,16,115,5583
subtest26of10,pubtest239of100,1,323,5452,16,155,5623
subtest24of10,pubtest239of100,1,323,5452,18,193,5663
subtest25of10,pubtest239of100,1,323,5452,48,203,5703
subtest22of10,pubtest239of100,1,323,5452,52,239,5743
subtest29of10,pubtest239of100,1,323,5452,55,275,5782
subtest210of10,pubtest239of100,1,323,5452,57,314,5823
subtest23of10,pubtest239of100,1,323,5452,55,354,5861
subtest25of10,pubtest240of100,1,323,5281,9,263,5553
subtest21of10,pubtest240of100,1,323,5281,12,298,5591
subtest210of10,pubtest240of100,1,323,5281,12,338,5631
subtest29of10,pubtest240of100,1,323,5281,13,377,5671
subtest27of10,pubtest240of100,1,323,5281,14,416,5711
subtest28of10,pubtest240of100,1,323,5281,22,449,5752
subtest24of10,pubtest240of100,1,323,5281,23,486,5790
subtest22of10,pubtest240of100,1,323,5281,25,525,5831
subtest23of10,pubtest240of100,1,323,5281,26,564,5871
subtest26of10,pubtest240of100,1,323,5281,37,593,5911
subtest23of10,pubtest241of100,1,323,5552,9,41,5602
subtest24of10,pubtest241of100,1,323,5552,10,79,5641
subtest27of10,pubtest241of100,1,323,5552,12,118,5682
subtest210of10,pubtest241of100,1,323,5552,11,158,5721
subtest21of10,pubtest241of100,1,323,5552,13,196,5761
subtest29of10,pubtest241of100,1,323,5552,18,229,5799
subtest25of10,pubtest241of100,1,323,5552,20,269,5841
subtest28of10,pubtest241of100,1,323,5552,22,307,5881
subtest26of10,pubtest241of100,1,323,5552,22,347,5921
subtest22of10,pubtest241of100,1,323,5552,28,381,5961
subtest27of10,pubtest242of100,1,323,5338,10,42,5390
subtest26of10,pubtest242of100,1,323,5338,15,75,5428
subtest25of10,pubtest242of100,1,323,5338,17,113,5468
subtest23of10,pubtest242of100,1,323,5338,17,153,5508
subtest210of10,pubtest242of100,1,323,5338,21,190,5549
subtest29of10,pubtest242of100,1,323,5338,20,230,5588
subtest21of10,pubtest242of100,1,323,5338,23,268,5629
subtest22of10,pubtest242of100,1,323,5338,23,307,5668
subtest24of10,pubtest242of100,1,323,5338,26,344,5708
subtest28of10,pubtest242of100,1,323,5338,29,382,5749
subtest29of10,pubtest243of100,1,323,5308,7,44,5359
subtest28of10,pubtest243of100,1,323,5308,8,84,5400
subtest22of10,pubtest243of100,1,323,5308,10,119,5437
subtest23of10,pubtest243of100,1,323,5308,11,158,5477
subtest27of10,pubtest243of100,1,323,5308,18,192,5518
subtest25of10,pubtest243of100,1,323,5308,18,232,5558
subtest26of10,pubtest243of100,1,323,5308,28,262,5598
subtest21of10,pubtest243of100,1,323,5308,28,302,5638
subtest24of10,pubtest243of100,1,323,5308,58,313,5679
subtest210of10,pubtest243of100,1,323,5308,58,352,5718
subtest27of10,pubtest244of100,1,323,5528,34,39,5601
subtest26of10,pubtest244of100,1,323,5528,34,78,5640
subtest25of10,pubtest244of100,1,323,5528,35,116,5679
subtest29of10,pubtest244of100,1,323,5528,37,155,5720
subtest28of10,pubtest244of100,1,323,5528,37,194,5759
subtest21of10,pubtest244of100,1,323,5528,38,234,5800
subtest23of10,pubtest244of100,1,323,5528,39,273,5840
subtest210of10,pubtest244of100,1,323,5528,40,312,5880
subtest22of10,pubtest244of100,1,323,5528,41,351,5920
subtest24of10,pubtest244of100,1,323,5528,42,390,5960
subtest29of10,pubtest245of100,1,322,5567,12,42,5621
subtest26of10,pubtest245of100,1,322,5567,14,79,5660
subtest22of10,pubtest245of100,1,322,5567,18,115,5700
subtest23of10,pubtest245of100,1,322,5567,16,159,5742
subtest21of10,pubtest245of100,1,322,5567,18,196,5781
subtest25of10,pubtest245of100,1,322,5567,17,234,5818
subtest27of10,pubtest245of100,1,322,5567,21,272,5860
subtest24of10,pubtest245of100,1,322,5567,21,312,5900
subtest28of10,pubtest245of100,1,322,5567,26,346,5939
subtest210of10,pubtest245of100,1,322,5567,26,386,5979
subtest26of10,pubtest246of100,1,323,5348,15,39,5402
subtest21of10,pubtest246of100,1,323,5348,18,76,5442
subtest27of10,pubtest246of100,1,323,5348,18,115,5481
subtest29of10,pubtest246of100,1,323,5348,47,126,5521
subtest24of10,pubtest246of100,1,323,5348,53,160,5561
subtest210of10,pubtest246of100,1,323,5348,52,200,5600
subtest22of10,pubtest246of100,1,323,5348,54,239,5641
subtest25of10,pubtest246of100,1,323,5348,52,277,5677
subtest28of10,pubtest246of100,1,323,5348,51,316,5715
subtest23of10,pubtest246of100,1,323,5348,51,356,5755
subtest27of10,pubtest247of100,1,323,5290,10,270,5570
subtest23of10,pubtest247of100,1,323,5290,12,308,5610
subtest26of10,pubtest247of100,1,323,5290,13,347,5650
subtest21of10,pubtest247of100,1,323,5290,15,385,5690
subtest29of10,pubtest247of100,1,323,5290,16,423,5729
subtest22of10,pubtest247of100,1,323,5290,17,463,5770
subtest28of10,pubtest247of100,1,323,5290,23,497,5810
subtest25of10,pubtest247of100,1,323,5290,23,534,5847
subtest24of10,pubtest247of100,1,323,5290,27,573,5890
subtest210of10,pubtest247of100,1,323,5290,29,611,5930
subtest29of10,pubtest248of100,1,323,5246,10,41,5297
subtest25of10,pubtest248of100,1,323,5246,12,78,5336
subtest26of10,pubtest248of100,1,323,5246,13,117,5376
subtest23of10,pubtest248of100,1,323,5246,15,155,5416
subtest28of10,pubtest248of100,1,323,5246,21,189,5456
subtest21of10,pubtest248of100,1,323,5246,24,225,5495
subtest27of10,pubtest248of100,1,323,5246,24,264,5534
subtest24of10,pubtest248of100,1,323,5246,27,303,5576
subtest22of10,pubtest248of100,1,323,5246,29,341,5616
subtest210of10,pubtest248of100,1,323,5246,36,374,5656
subtest28of10,pubtest249of100,1,323,5238,20,131,5389
subtest27of10,pubtest249of100,1,323,5238,21,167,5426
subtest24of10,pubtest249of100,1,323,5238,23,205,5466
subtest25of10,pubtest249of100,1,323,5238,23,245,5506
subtest21of10,pubtest249of100,1,323,5238,24,282,5544
subtest22of10,pubtest249of100,1,323,5238,27,321,5586
subtest26of10,pubtest249of100,1,323,5238,27,361,5626
subtest29of10,pubtest249of100,1,323,5238,25,400,5663
subtest23of10,pubtest249of100,1,323,5238,29,439,5706
subtest210of10,pubtest249of100,1,323,5238,30,478,5746
subtest27of10,pubtest250of100,1,323,5365,10,41,5416
subtest28of10,pubtest250of100,1,323,5365,16,75,5456
subtest24of10,pubtest250of100,1,323,5365,19,111,5495
subtest23of10,pubtest250of100,1,323,5365,19,152,5536
subtest29of10,pubtest250of100,1,323,5365,57,153,5575
subtest21of10,pubtest250of100,1,323,5365,57,193,5615
subtest25of10,pubtest250of100,1,323,5365,60,231,5656
subtest210of10,pubtest250of100,1,323,5365,61,269,5695
subtest26of10,pubtest250of100,1,323,5365,62,308,5735
subtest22of10,pubtest250of100,1,323,5365,68,342,5775
subtest23of10,pubtest251of100,1,323,5251,17,40,5308
subtest22of10,pubtest251of100,1,323,5251,19,78,5348
subtest24of10,pubtest251of100,1,323,5251,22,114,5387
subtest25of10,pubtest251of100,1,323,5251,22,154,5427
subtest27of10,pubtest251of100,1,323,5251,20,193,5464
subtest28of10,pubtest251of100,1,323,5251,27,229,5507
subtest210of10,pubtest251of100,1,323,5251,27,269,5547
subtest21of10,pubtest251of100,1,323,5251,32,304,5587
subtest26of10,pubtest251of100,1,323,5251,33,343,5627
subtest29of10,pubtest251of100,1,323,5251,33,383,5667
subtest29of10,pubtest252of100,1,323,5289,31,48,5368
subtest21of10,pubtest252of100,1,323,5289,35,85,5409
subtest28of10,pubtest252of100,1,323,5289,37,123,5449
subtest25of10,pubtest252of100,1,323,5289,39,161,5489
subtest24of10,pubtest252of100,1,323,5289,40,200,5529
subtest26of10,pubtest252of100,1,323,5289,41,238,5568
subtest27of10,pubtest252of100,1,323,5289,42,278,5609
subtest210of10,pubtest252of100,1,323,5289,43,317,5649
subtest22of10,pubtest252of100,1,323,5289,43,357,5689
subtest23of10,pubtest252of100,1,323,5289,45,395,5729
subtest28of10,pubtest253of100,1,322,5275,11,40,5326
subtest23of10,pubtest253of100,1,322,5275,14,75,5364
subtest25of10,pubtest253of100,1,322,5275,15,115,5405
subtest24of10,pubtest253of100,1,322,5275,17,153,5445
subtest29of10,pubtest253of100,1,322,5275,18,194,5487
subtest21of10,pubtest253of100,1,322,5275,20,231,5526
subtest26of10,pubtest253of100,1,322,5275,21,269,5565
subtest22of10,pubtest253of100,1,322,5275,19,309,5603
subtest210of10,pubtest253of100,1,322,5275,20,348,5643
subtest27of10,pubtest253of100,1,322,5275,22,387,5684
subtest210of10,pubtest254of100,1,323,5306,10,409,5725
subtest27of10,pubtest254of100,1,323,5306,12,444,5762
subtest21of10,pubtest254of100,1,323,5306,14,481,5801
subtest28of10,pubtest254of100,1,323,5306,16,519,5841
subtest24of10,pubtest254of100,1,323,5306,17,558,5881
subtest25of10,pubtest254of100,1,323,5306,19,596,5921
subtest29of10,pubtest254of100,1,323,5306,61,594,5961
subtest22of10,pubtest254of100,1,323,5306,62,633,6001
subtest23of10,pubtest254of100,1,323,5306,61,672,6039
subtest26of10,pubtest254of100,1,323,5306,66,708,6080
subtest22of10,pubtest255of100,1,322,5379,17,40,5436
subtest23of10,pubtest255of100,1,322,5379,19,78,5476
subtest28of10,pubtest255of100,1,322,5379,21,115,5515
subtest27of10,pubtest255of100,1,322,5379,20,155,5554
subtest24of10,pubtest255of100,1,322,5379,23,193,5595
subtest29of10,pubtest255of100,1,322,5379,25,231,5635
subtest21of10,pubtest255of100,1,322,5379,25,270,5674
subtest25of10,pubtest255of100,1,322,5379,29,307,5715
subtest26of10,pubtest255of100,1,322,5379,27,347,5753
subtest210of10,pubtest255of100,1,322,5379,29,385,5793
subtest29of10,pubtest256of100,1,323,5282,24,40,5346
subtest21of10,pubtest256of100,1,323,5282,25,77,5384
subtest26of10,pubtest256of100,1,323,5282,27,116,5425
subtest23of10,pubtest256of100,1,323,5282,29,154,5465
subtest210of10,pubtest256of100,1,323,5282,30,193,5505
subtest25of10,pubtest256of100,1,323,5282,39,224,5545
subtest22of10,pubtest256of100,1,323,5282,43,259,5584
subtest28of10,pubtest256of100,1,323,5282,43,299,5624
subtest27of10,pubtest256of100,1,323,5282,45,338,5665
subtest24of10,pubtest256of100,1,323,5282,46,378,5706
subtest24of10,pubtest257of100,1,323,5285,9,50,5344
subtest28of10,pubtest257of100,1,323,5285,16,83,5384
subtest23of10,pubtest257of100,1,323,5285,18,120,5423
subtest21of10,pubtest257of100,1,323,5285,15,163,5463
subtest22of10,pubtest257of100,1,323,5285,19,197,5501
subtest29of10,pubtest257of100,1,323,5285,22,235,5542
subtest25of10,pubtest257of100,1,323,5285,20,275,5580
subtest27of10,pubtest257of100,1,323,5285,21,314,5620
subtest210of10,pubtest257of100,1,323,5285,24,354,5663
subtest26of10,pubtest257of100,1,323,5285,26,392,5703
subtest28of10,pubtest258of100,1,323,5319,9,40,5368
subtest23of10,pubtest258of100,1,323,5319,10,78,5407
subtest25of10,pubtest258of100,1,323,5319,12,115,5446
subtest26of10,pubtest258of100,1,323,5319,17,151,5487
subtest21of10,pubtest258of100,1,323,5319,20,188,5527
subtest210of10,pubtest258of100,1,323,5319,22,226,5567
subtest22of10,pubtest258of100,1,323,5319,27,261,5607
subtest29of10,pubtest258of100,1,323,5319,27,300,5646
subtest27of10,pubtest258of100,1,323,5319,32,336,5687
subtest24of10,pubtest258of100,1,323,5319,36,372,5727
subtest24of10,pubtest259of100,1,323,5606,16,43,5665
subtest21of10,pubtest259of100,1,323,5606,17,82,5705
subtest25of10,pubtest259of100,1,323,5606,19,121,5746
subtest27of10,pubtest259of100,1,323,5606,18,159,5783
subtest26of10,pubtest259of100,1,323,5606,17,199,5822
subtest28of10,pubtest259of100,1,323,5606,14,240,5860
subtest23of10,pubtest259of100,1,323,5606,21,278,5905
subtest22of10,pubtest259of100,1,323,5606,74,264,5944
subtest29of10,pubtest259of100,1,323,5606,75,303,5984
subtest210of10,pubtest259of100,1,323,5606,76,342,6024
subtest210of10,pubtest260of100,1,323,5710,22,323,6055
subtest23of10,pubtest260of100,1,323,5710,22,362,6094
subtest27of10,pubtest260of100,1,323,5710,24,401,6135
subtest26of10,pubtest260of100,1,323,5710,24,440,6174
subtest21of10,pubtest260of100,1,323,5710,25,479,6214
subtest29of10,pubtest260of100,1,323,5710,27,517,6254
subtest25of10,pubtest260of100,1,323,5710,28,557,6295
subtest22of10,pubtest260of100,1,323,5710,29,595,6334
subtest28of10,pubtest260of100,1,323,5710,30,634,6374
subtest24of10,pubtest260of100,1,323,5710,30,674,6414
subtest25of10,pubtest261of100,1,323,5425,9,39,5473
subtest28of10,pubtest261of100,1,323,5425,10,79,5514
subtest29of10,pubtest261of100,1,323,5425,13,115,5553
subtest210of10,pubtest261of100,1,323,5425,19,149,5593
subtest23of10,pubtest261of100,1,323,5425,24,184,5633
subtest22of10,pubtest261of100,1,323,5425,28,220,5673
subtest27of10,pubtest261of100,1,323,5425,32,256,5713
subtest21of10,pubtest261of100,1,323,5425,39,289,5753
subtest24of10,pubtest261of100,1,323,5425,43,325,5793
subtest26of10,pubtest261of100,1,323,5425,49,359,5833
subtest21of10,pubtest262of100,1,323,5320,17,101,5438
subtest22of10,pubtest262of100,1,323,5320,18,138,5476
subtest26of10,pubtest262of100,1,323,5320,25,170,5515
subtest23of10,pubtest262of100,1,323,5320,26,208,5554
subtest210of10,pubtest262of100,1,323,5320,27,248,5595
subtest29of10,pubtest262of100,1,323,5320,29,286,5635
subtest27of10,pubtest262of100,1,323,5320,28,326,5674
subtest28of10,pubtest262of100,1,323,5320,32,363,5715
subtest24of10,pubtest262of100,1,323,5320,32,403,5755
subtest25of10,pubtest262of100,1,323,5320,32,442,5794
subtest22of10,pubtest263of100,1,322,5516,12,42,5570
subtest29of10,pubtest263of100,1,322,5516,13,81,5610
subtest24of10,pubtest263of100,1,322,5516,14,121,5651
subtest23of10,pubtest263of100,1,322,5516,17,157,5690
subtest26of10,pubtest263of100,1,322,5516,17,197,5730
subtest210of10,pubtest263of100,1,322,5516,18,234,5768
subtest28of10,pubtest263of100,1,322,5516,20,274,5810
subtest25of10,pubtest263of100,1,322,5516,20,312,5848
subtest21of10,pubtest263of100,1,322,5516,27,347,5890
subtest27of10,pubtest263of100,1,322,5516,27,387,5930
subtest22of10,pubtest264of100,1,322,5298,8,38,5344
subtest29of10,pubtest264of100,1,322,5298,11,74,5383
subtest23of10,pubtest264of100,1,322,5298,11,114,5423
subtest27of10,pubtest264of100,1,322,5298,13,150,5461
subtest21of10,pubtest264of100,1,322,5298,15,190,5503
subtest28of10,pubtest264of100,1,322,5298,15,229,5542
subtest24of10,pubtest264of100,1,322,5298,17,268,5583
subtest25of10,pubtest264of100,1,322,5298,18,307,5623
subtest26of10,pubtest264of100,1,322,5298,30,335,5663
subtest210of10,pubtest264of100,1,322,5298,32,373,5703
subtest26of10,pubtest265of100,1,323,5431,19,44,5494
subtest27of10,pubtest265of100,1,323,5431,20,79,5530
subtest210of10,pubtest265of100,1,323,5431,23,117,5571
subtest22of10,pubtest265of100,1,323,5431,32,149,5612
subtest21of10,pubtest265of100,1,323,5431,34,186,5651
subtest29of10,pubtest265of100,1,323,5431,34,226,5691
subtest25of10,pubtest265of100,1,323,5431,35,265,5731
subtest28of10,pubtest265of100,1,323,5431,35,305,5771
subtest23of10,pubtest265of100,1,323,5431,39,341,5811
subtest24of10,pubtest265of100,1,323,5431,43,378,5852
subtest29of10,pubtest266of100,1,321,6067,9,48,6124
subtest210of10,pubtest266of100,1,321,6067,18,79,6164
subtest25of10,pubtest266of100,1,321,6067,18,118,6203
subtest27of10,pubtest266of100,1,321,6067,19,157,6243
subtest23of10,pubtest266of100,1,321,6067,50,167,6284
subtest26of10,pubtest266of100,1,321,6067,51,206,6324
subtest21of10,pubtest266of100,1,321,6067,52,245,6364
subtest28of10,pubtest266of100,1,321,6067,53,283,6403
subtest24of10,pubtest266of100,1,321,6067,55,321,6443
subtest22of10,pubtest266of100,1,321,6067,59,357,6483
subtest26of10,pubtest267of100,1,323,5258,12,43,5313
subtest29of10,pubtest267of100,1,323,5258,15,79,5352
subtest28of10,pubtest267of100,1,323,5258,14,118,5390
subtest23of10,pubtest267of100,1,323,5258,12,162,5432
subtest27of10,pubtest267of100,1,323,5258,14,201,5473
subtest25of10,pubtest267of100,1,323,5258,15,239,5512
subtest24of10,pubtest267of100,1,323,5258,16,278,5552
subtest21of10,pubtest267of100,1,323,5258,22,312,5592
subtest22of10,pubtest267of100,1,323,5258,23,351,5632
subtest210of10,pubtest267of100,1,323,5258,23,391,5672
subtest23of10,pubtest268of100,1,323,5328,21,39,5388
subtest25of10,pubtest268of100,1,323,5328,27,72,5427
subtest24of10,pubtest268of100,1,323,5328,32,107,5467
subtest29of10,pubtest268of100,1,323,5328,36,143,5507
subtest28of10,pubtest268of100,1,323,5328,40,179,5547
subtest27of10,pubtest268of100,1,323,5328,43,216,5587
subtest21of10,pubtest268of100,1,323,5328,47,252,5627
subtest22of10,pubtest268of100,1,323,5328,51,287,5666
subtest210of10,pubtest268of100,1,323,5328,55,324,5707
subtest26of10,pubtest268of100,1,323,5328,59,360,5747
subtest24of10,pubtest269of100,1,323,5713,11,41,5765
subtest27of10,pubtest269of100,1,323,5713,11,80,5804
subtest25of10,pubtest269of100,1,323,5713,12,119,5844
subtest210of10,pubtest269of100,1,323,5713,16,155,5884
subtest26of10,pubtest269of100,1,323,5713,18,193,5924
subtest21of10,pubtest269of100,1,323,5713,20,229,5962
subtest29of10,pubtest269of100,1,323,5713,22,269,6004
subtest22of10,pubtest269of100,1,323,5713,23,308,6044
subtest23of10,pubtest269of100,1,323,5713,24,347,6084
subtest28of10,pubtest269of100,1,323,5713,26,385,6124
subtest23of10,pubtest270of100,1,323,5311,12,43,5366
subtest27of10,pubtest270of100,1,323,5311,13,81,5405
subtest26of10,pubtest270of100,1,323,5311,15,119,5445
subtest29of10,pubtest270of100,1,323,5311,18,154,5483
subtest25of10,pubtest270of100,1,323,5311,21,193,5525
subtest210of10,pubtest270of100,1,323,5311,23,231,5565
subtest28of10,pubtest270of100,1,323,5311,26,268,5605
subtest21of10,pubtest270of100,1,323,5311,28,306,5645
subtest24of10,pubtest270of100,1,323,5311,33,341,5685
subtest22of10,pubtest270of100,1,323,5311,37,377,5725
subtest24of10,pubtest271of100,1,323,5450,15,43,5508
subtest25of10,pubtest271of100,1,323,5450,16,79,5545
subtest22of10,pubtest271of100,1,323,5450,17,117,5584
subtest23of10,pubtest271of100,1,323,5450,20,158,5628
subtest21of10,pubtest271of100,1,323,5450,19,197,5666
subtest27of10,pubtest271of100,1,323,5450,17,235,5702
subtest26of10,pubtest271of100,1,323,5450,22,274,5746
subtest210of10,pubtest271of100,1,323,5450,23,314,5787
subtest28of10,pubtest271of100,1,323,5450,28,349,5827
subtest29of10,pubtest271of100,1,323,5450,29,388,5867
subtest25of10,pubtest272of100,1,323,5271,25,42,5338
subtest21of10,pubtest272of100,1,323,5271,25,82,5378
subtest29of10,pubtest272of100,1,323,5271,27,119,5417
subtest26of10,pubtest272of100,1,323,5271,27,159,5457
subtest23of10,pubtest272of100,1,323,5271,29,196,5496
subtest24of10,pubtest272of100,1,323,5271,30,236,5537
subtest27of10,pubtest272of100,1,323,5271,31,275,5577
subtest22of10,pubtest272of100,1,323,5271,53,294,5618
subtest210of10,pubtest272of100,1,323,5271,53,333,5657
subtest28of10,pubtest272of100,1,323,5271,105,321,5697
subtest22of10,pubtest273of100,1,321,5267,11,44,5322
subtest29of10,pubtest273of100,1,321,5267,13,82,5362
subtest26of10,pubtest273of100,1,321,5267,14,121,5402
subtest28of10,pubtest273of100,1,321,5267,20,157,5444
subtest25of10,pubtest273of100,1,321,5267,21,195,5483
subtest27of10,pubtest273of100,1,321,5267,25,230,5522
subtest23of10,pubtest273of100,1,321,5267,27,268,5562
subtest210of10,pubtest273of100,1,321,5267,26,308,5601
subtest21of10,pubtest273of100,1,321,5267,28,347,5642
subtest24of10,pubtest273of100,1,321,5267,28,387,5682
subtest21of10,pubtest274of100,1,323,5340,13,44,5397
subtest26of10,pubtest274of100,1,323,5340,13,83,5436
subtest22of10,pubtest274of100,1,323,5340,15,121,5476
subtest23of10,pubtest274of100,1,323,5340,15,161,5516
subtest29of10,pubtest274of100,1,323,5340,18,198,5556
subtest25of10,pubtest274of100,1,323,5340,21,235,5596
subtest28of10,pubtest274of100,1,323,5340,23,273,5636
subtest24of10,pubtest274of100,1,323,5340,26,310,5676
subtest27of10,pubtest274of100,1,323,5340,26,350,5716
subtest210of10,pubtest274of100,1,323,5340,30,386,5756
subtest27of10,pubtest275of100,1,323,5317,24,39,5380
subtest29of10,pubtest275of100,1,323,5317,24,78,5419
subtest24of10,pubtest275of100,1,323,5317,26,116,5459
subtest25of10,pubtest275of100,1,323,5317,30,152,5499
subtest22of10,pubtest275of100,1,323,5317,34,188,5539
subtest210of10,pubtest275of100,1,323,5317,35,225,5577
subtest21of10,pubtest275of100,1,323,5317,35,265,5617
subtest23of10,pubtest275of100,1,323,5317,38,304,5659
subtest26of10,pubtest275of100,1,323,5317,41,341,5699
subtest28of10,pubtest275of100,1,323,5317,43,379,5739
subtest28of10,pubtest276of100,1,323,6869,12,46,6927
subtest25of10,pubtest276of100,1,323,6869,13,84,6966
subtest21of10,pubtest276of100,1,323,6869,12,125,7006
subtest27of10,pubtest276of100,1,323,6869,15,162,7046
subtest24of10,pubtest276of100,1,323,6869,17,199,7085
subtest29of10,pubtest276of100,1,323,6869,21,236,7126
subtest26of10,pubtest276of100,1,323,6869,21,276,7166
subtest210of10,pubtest276of100,1,323,6869,23,314,7206
subtest22of10,pubtest276of100,1,323,6869,24,353,7246
subtest23of10,pubtest276of100,1,323,6869,22,393,7284
subtest22of10,pubtest277of100,1,323,8236,12,42,8290
subtest29of10,pubtest277of100,1,323,8236,13,81,8330
subtest28of10,pubtest277of100,1,323,8236,14,117,8367
subtest21of10,pubtest277of100,1,323,8236,16,157,8409
subtest27of10,pubtest277of100,1,323,8236,21,192,8449
subtest24of10,pubtest277of100,1,323,8236,22,231,8489
subtest25of10,pubtest277of100,1,323,8236,24,270,8530
subtest210of10,pubtest277of100,1,323,8236,23,310,8569
subtest26of10,pubtest277of100,1,323,8236,25,348,8609
subtest23of10,pubtest277of100,1,323,8236,25,388,8649
subtest29of10,pubtest278of100,1,323,5311,14,46,5371
subtest21of10,pubtest278of100,1,323,5311,14,85,5410
subtest22of10,pubtest278of100,1,323,5311,12,124,5447
subtest27of10,pubtest278of100,1,323,5311,16,163,5490
subtest25of10,pubtest278of100,1,323,5311,18,201,5530
subtest23of10,pubtest278of100,1,323,5311,19,239,5569
subtest28of10,pubtest278of100,1,323,5311,23,276,5610
subtest26of10,pubtest278of100,1,323,5311,28,311,5650
subtest24of10,pubtest278of100,1,323,5311,28,352,5691
subtest210of10,pubtest278of100,1,323,5311,33,386,5730
subtest28of10,pubtest279of100,1,323,5626,83,41,5750
subtest21of10,pubtest279of100,1,323,5626,85,78,5789
subtest29of10,pubtest279of100,1,323,5626,85,118,5829
subtest24of10,pubtest279of100,1,323,5626,86,159,5871
subtest27of10,pubtest279of100,1,323,5626,87,196,5909
subtest26of10,pubtest279of100,1,323,5626,88,236,5950
subtest210of10,pubtest279of100,1,323,5626,89,274,5989
subtest22of10,pubtest279of100,1,323,5626,89,314,6029
subtest25of10,pubtest279of100,1,323,5626,84,359,6069
subtest23of10,pubtest279of100,1,323,5626,106,377,6109
subtest27of10,pubtest280of100,1,323,5700,11,40,5751
subtest29of10,pubtest280of100,1,323,5700,13,77,5790
subtest24of10,pubtest280of100,1,323,5700,15,115,5830
subtest21of10,pubtest280of100,1,323,5700,15,155,5870
subtest26of10,pubtest280of100,1,323,5700,16,194,5910
subtest23of10,pubtest280of100,1,323,5700,22,228,5950
subtest25of10,pubtest280of100,1,323,5700,22,268,5990
subtest210of10,pubtest280of100,1,323,5700,23,307,6030
subtest28of10,pubtest280of100,1,323,5700,32,338,6070
subtest22of10,pubtest280of100,1,323,5700,36,372,6108
subtest28of10,pubtest281of100,1,323,5343,11,51,5405
subtest23of10,pubtest281of100,1,323,5343,12,88,5443
subtest22of10,pubtest281of100,1,323,5343,14,128,5485
subtest24of10,pubtest281of100,1,323,5343,11,166,5520
subtest27of10,pubtest281of100,1,323,5343,16,204,5563
subtest210of10,pubtest281of100,1,323,5343,18,244,5605
subtest21of10,pubtest281of100,1,323,5343,18,282,5643
subtest25of10,pubtest281of100,1,323,5343,20,319,5682
subtest29of10,pubtest281of100,1,323,5343,20,358,5721
subtest26of10,pubtest281of100,1,323,5343,23,397,5763
subtest23of10,pubtest282of100,1,323,5336,6,40,5382
subtest21of10,pubtest282of100,1,323,5336,15,70,5421
subtest24of10,pubtest282of100,1,323,5336,23,102,5461
subtest29of10,pubtest282of100,1,323,5336,24,141,5501
subtest25of10,pubtest282of100,1,323,5336,25,180,5541
subtest210of10,pubtest282of100,1,323,5336,28,216,5580
subtest26of10,pubtest282of100,1,323,5336,28,256,5620
subtest27of10,pubtest282of100,1,323,5336,28,295,5659
subtest28of10,pubtest282of100,1,323,5336,29,334,5699
subtest22of10,pubtest282of100,1,323,5336,26,373,5735
subtest27of10,pubtest283of100,1,323,5755,10,44,5809
subtest24of10,pubtest283of100,1,323,5755,10,84,5849
subtest23of10,pubtest283of100,1,323,5755,12,121,5888
subtest28of10,pubtest283of100,1,323,5755,15,158,5928
subtest22of10,pubtest283of100,1,323,5755,15,198,5968
subtest25of10,pubtest283of100,1,323,5755,21,232,6008
subtest210of10,pubtest283of100,1,323,5755,22,271,6048
subtest21of10,pubtest283of100,1,323,5755,56,276,6087
subtest26of10,pubtest283of100,1,323,5755,57,316,6128
subtest29of10,pubtest283of100,1,323,5755,57,355,6167
subtest25of10,pubtest284of100,1,323,5532,16,40,5588
subtest22of10,pubtest284of100,1,323,5532,18,79,5629
subtest29of10,pubtest284of100,1,323,5532,22,114,5668
subtest27of10,pubtest284of100,1,323,5532,25,151,5708
subtest210of10,pubtest284of100,1,323,5532,27,189,5748
subtest23of10,pubtest284of100,1,323,5532,28,228,5788
subtest21of10,pubtest284of100,1,323,5532,29,267,5828
subtest24of10,pubtest284of100,1,323,5532,34,302,5868
subtest28of10,pubtest284of100,1,323,5532,35,342,5909
subtest26of10,pubtest284of100,1,323,5532,37,379,5948
subtest23of10,pubtest285of100,1,323,5348,9,39,5396
subtest25of10,pubtest285of100,1,323,5348,13,75,5436
subtest27of10,pubtest285of100,1,323,5348,16,111,5475
subtest24of10,pubtest285of100,1,323,5348,17,150,5515
subtest22of10,pubtest285of100,1,323,5348,18,189,5555
subtest21of10,pubtest285of100,1,323,5348,25,222,5595
subtest28of10,pubtest285of100,1,323,5348,26,261,5635
subtest29of10,pubtest285of100,1,323,5348,27,300,5675
subtest210of10,pubtest285of100,1,323,5348,28,339,5715
subtest26of10,pubtest285of100,1,323,5348,29,378,5755
subtest23of10,pubtest286of100,1,323,5465,13,38,5516
subtest210of10,pubtest286of100,1,323,5465,18,72,5555
subtest29of10,pubtest286of100,1,323,5465,19,110,5594
subtest25of10,pubtest286of100,1,323,5465,18,150,5633
subtest24of10,pubtest286of100,1,323,5465,19,189,5673
subtest21of10,pubtest286of100,1,323,5465,22,228,5715
subtest26of10,pubtest286of100,1,323,5465,23,265,5753
subtest27of10,pubtest286of100,1,323,5465,23,305,5793
subtest28of10,pubtest286of100,1,323,5465,32,338,5835
subtest22of10,pubtest286of100,1,323,5465,31,378,5874
subtest26of10,pubtest287of100,1,323,5917,10,40,5967
subtest28of10,pubtest287of100,1,323,5917,15,74,6006
subtest29of10,pubtest287of100,1,323,5917,20,109,6046
subtest210of10,pubtest287of100,1,323,5917,23,146,6086
subtest24of10,pubtest287of100,1,323,5917,24,185,6126
subtest25of10,pubtest287of100,1,323,5917,25,222,6164
subtest22of10,pubtest287of100,1,323,5917,28,260,6205
subtest21of10,pubtest287of100,1,323,5917,28,300,6245
subtest27of10,pubtest287of100,1,323,5917,27,339,6283
subtest23of10,pubtest287of100,1,323,5917,30,379,6326
subtest29of10,pubtest288of100,1,323,6528,12,40,6580
subtest25of10,pubtest288of100,1,323,6528,14,77,6619
subtest26of10,pubtest288of100,1,323,6528,16,113,6657
subtest27of10,pubtest288of100,1,323,6528,19,152,6699
subtest22of10,pubtest288of100,1,323,6528,24,187,6739
subtest23of10,pubtest288of100,1,323,6528,24,227,6779
subtest21of10,pubtest288of100,1,323,6528,24,266,6818
subtest24of10,pubtest288of100,1,323,6528,29,302,6859
subtest210of10,pubtest288of100,1,323,6528,29,341,6898
subtest28of10,pubtest288of100,1,323,6528,31,380,6939
subtest29of10,pubtest289of100,1,323,5968,11,40,6019
subtest210of10,pubtest289of100,1,323,5968,12,79,6059
subtest24of10,pubtest289of100,1,323,5968,26,104,6098
subtest23of10,pubtest289of100,1,323,5968,27,143,6138
subtest25of10,pubtest289of100,1,323,5968,28,183,6179
subtest26of10,pubtest289of100,1,323,5968,29,222,6219
subtest27of10,pubtest289of100,1,323,5968,53,237,6258
subtest28of10,pubtest289of100,1,323,5968,54,277,6299
subtest21of10,pubtest289of100,1,323,5968,57,313,6338
subtest22of10,pubtest289of100,1,323,5968,59,351,6378
subtest29of10,pubtest290of100,1,323,5404,17,41,5462
subtest23of10,pubtest290of100,1,323,5404,20,76,5500
subtest22of10,pubtest290of100,1,323,5404,21,115,5540
subtest25of10,pubtest290of100,1,323,5404,24,152,5580
subtest26of10,pubtest290of100,1,323,5404,27,189,5620
subtest27of10,pubtest290of100,1,323,5404,29,227,5660
subtest210of10,pubtest290of100,1,323,5404,32,264,5700
subtest21of10,pubtest290of100,1,323,5404,35,301,5740
subtest28of10,pubtest290of100,1,323,5404,38,337,5779
subtest24of10,pubtest290of100,1,323,5404,41,375,5820
subtest23of10,pubtest291of100,1,323,5437,12,41,5490
subtest21of10,pubtest291of100,1,323,5437,14,77,5528
subtest27of10,pubtest291of100,1,323,5437,14,117,5568
subtest24of10,pubtest291of100,1,323,5437,13,159,5609
subtest28of10,pubtest291of100,1,323,5437,16,196,5649
subtest25of10,pubtest291of100,1,323,5437,26,224,5687
subtest210of10,pubtest291of100,1,323,5437,33,259,5729
subtest29of10,pubtest291of100,1,323,5437,34,298,5769
subtest26of10,pubtest291of100,1,323,5437,35,337,5809
subtest22of10,pubtest291of100,1,323,5437,35,377,5849
subtest29of10,pubtest292of100,1,323,5416,20,41,5477
subtest28of10,pubtest292of100,1,323,5416,28,72,5516
subtest25of10,pubtest292of100,1,323,5416,30,109,5555
subtest23of10,pubtest292of100,1,323,5416,32,148,5596
subtest24of10,pubtest292of100,1,323,5416,33,187,5636
subtest210of10,pubtest292of100,1,323,5416,33,227,5676
subtest21of10,pubtest292of100,1,323,5416,28,266,5710
subtest22of10,pubtest292of100,1,323,5416,33,306,5755
subtest26of10,pubtest292of100,1,323,5416,35,345,5796
subtest27of10,pubtest292of100,1,323,5416,36,384,5836
subtest25of10,pubtest293of100,1,323,5517,14,41,5572
subtest24of10,pubtest293of100,1,323,5517,13,80,5610
subtest23of10,pubtest293of100,1,323,5517,25,109,5651
subtest28of10,pubtest293of100,1,323,5517,25,151,5693
subtest210of10,pubtest293of100,1,323,5517,26,188,5731
subtest27of10,pubtest293of100,1,323,5517,27,227,5771
subtest29of10,pubtest293of100,1,323,5517,29,266,5812
subtest26of10,pubtest293of100,1,323,5517,30,304,5851
subtest22of10,pubtest293of100,1,323,5517,30,344,5891
subtest21of10,pubtest293of100,1,323,5517,28,384,5929
subtest21of10,pubtest294of100,1,323,5326,10,39,5375
subtest25of10,pubtest294of100,1,323,5326,11,78,5415
subtest210of10,pubtest294of100,1,323,5326,13,116,5455
subtest29of10,pubtest294of100,1,323,5326,20,149,5495
subtest27of10,pubtest294of100,1,323,5326,21,188,5535
subtest26of10,pubtest294of100,1,323,5326,22,227,5575
subtest23of10,pubtest294of100,1,323,5326,23,266,5615
subtest24of10,pubtest294of100,1,323,5326,27,300,5653
subtest22of10,pubtest294of100,1,323,5326,29,340,5695
subtest28of10,pubtest294of100,1,323,5326,30,379,5735
subtest25of10,pubtest295of100,1,323,5440,16,40,5496
subtest24of10,pubtest295of100,1,323,5440,17,78,5535
subtest23of10,pubtest295of100,1,323,5440,22,113,5575
subtest27of10,pubtest295of100,1,323,5440,22,153,5615
subtest22of10,pubtest295of100,1,323,5440,26,190,5656
subtest210of10,pubtest295of100,1,323,5440,39,216,5695
subtest21of10,pubtest295of100,1,323,5440,40,255,5735
subtest29of10,pubtest295of100,1,323,5440,39,295,5774
subtest28of10,pubtest295of100,1,323,5440,46,329,5815
subtest26of10,pubtest295of100,1,323,5440,49,366,5855
subtest25of10,pubtest296of100,1,322,5313,18,175,5506
subtest24of10,pubtest296of100,1,322,5313,18,212,5543
subtest26of10,pubtest296of100,1,322,5313,21,249,5583
subtest23of10,pubtest296of100,1,322,5313,21,288,5622
subtest27of10,pubtest296of100,1,322,5313,23,326,5662
subtest21of10,pubtest296of100,1,322,5313,24,366,5703
subtest29of10,pubtest296of100,1,322,5313,25,406,5744
subtest28of10,pubtest296of100,1,322,5313,25,445,5783
subtest210of10,pubtest296of100,1,322,5313,27,483,5823
subtest22of10,pubtest296of100,1,322,5313,31,519,5863
subtest25of10,pubtest297of100,1,323,5286,11,41,5338
subtest210of10,pubtest297of100,1,323,5286,12,78,5376
subtest29of10,pubtest297of100,1,323,5286,15,115,5416
subtest22of10,pubtest297of100,1,323,5286,15,155,5456
subtest26of10,pubtest297of100,1,323,5286,16,195,5497
subtest23of10,pubtest297of100,1,323,5286,23,227,5536
subtest27of10,pubtest297of100,1,323,5286,29,261,5576
subtest21of10,pubtest297of100,1,323,5286,34,297,5617
subtest28of10,pubtest297of100,1,323,5286,41,329,5656
subtest24of10,pubtest297of100,1,323,5286,46,364,5696
subtest29of10,pubtest298of100,1,323,5331,16,43,5390
subtest22of10,pubtest298of100,1,323,5331,16,83,5430
subtest25of10,pubtest298of100,1,323,5331,37,101,5469
subtest24of10,pubtest298of100,1,323,5331,49,129,5509
subtest21of10,pubtest298of100,1,323,5331,51,167,5549
subtest27of10,pubtest298of100,1,323,5331,56,202,5589
subtest210of10,pubtest298of100,1,323,5331,55,243,5629
subtest26of10,pubtest298of100,1,323,5331,56,282,5669
subtest23of10,pubtest298of100,1,323,5331,50,323,5704
subtest28of10,pubtest298of100,1,323,5331,52,363,5746
subtest22of10,pubtest299of100,1,323,5303,15,38,5356
subtest29of10,pubtest299of100,1,323,5303,19,74,5396
subtest27of10,pubtest299of100,1,323,5303,20,111,5434
subtest210of10,pubtest299of100,1,323,5303,24,148,5475
subtest23of10,pubtest299of100,1,323,5303,25,187,5515
subtest25of10,pubtest299of100,1,323,5303,25,226,5554
subtest24of10,pubtest299of100,1,323,5303,29,263,5595
subtest21of10,pubtest299of100,1,323,5303,29,303,5635
subtest28of10,pubtest299of100,1,323,5303,34,340,5677
subtest26of10,pubtest299of100,1,323,5303,47,366,5716
subtest21of10,pubtest2100of100,1,325,5340,12,47,5399
subtest24of10,pubtest2100of100,1,325,5340,15,83,5438
subtest29of10,pubtest2100of100,1,325,5340,17,121,5478
subtest28of10,pubtest2100of100,1,325,5340,19,160,5519
subtest23of10,pubtest2100of100,1,325,5340,20,199,5559
subtest25of10,pubtest2100of100,1,325,5340,21,237,5598
subtest27of10,pubtest2100of100,1,325,5340,21,277,5638
subtest210of10,pubtest2100of100,1,325,5340,21,316,5677
subtest22of10,pubtest2100of100,1,325,5340,23,357,5720
subtest26of10,pubtest2100of100,1,325,5340,24,394,5758
subtest27of10,pubtest21of100,1,322,10365,10,41,10416
subtest26of10,pubtest21of100,1,322,10365,10,80,10455
subtest29of10,pubtest21of100,1,322,10365,16,114,10495
subtest24of10,pubtest21of100,1,322,10365,19,151,10535
subtest25of10,pubtest21of100,1,322,10365,21,189,10575
subtest210of10,pubtest21of100,1,322,10365,24,226,10615
subtest21of10,pubtest21of100,1,322,10365,30,259,10654
subtest28of10,pubtest21of100,1,322,10365,32,297,10694
subtest23of10,pubtest21of100,1,322,10365,38,332,10735
subtest22of10,pubtest21of100,1,322,10365,40,370,10775
subtest29of10,pubtest22of100,1,321,5276,14,45,5335
subtest27of10,pubtest22of100,1,321,5276,18,80,5374
subtest24of10,pubtest22of100,1,321,5276,19,118,5413
subtest25of10,pubtest22of100,1,321,5276,27,151,5454
subtest26of10,pubtest22of100,1,321,5276,27,191,5494
subtest21of10,pubtest22of100,1,321,5276,29,229,5534
subtest210of10,pubtest22of100,1,321,5276,29,270,5575
subtest28of10,pubtest22of100,1,321,5276,30,308,5614
subtest22of10,pubtest22of100,1,321,5276,30,348,5654
subtest23of10,pubtest22of100,1,321,5276,25,387,5688
subtest24of10,pubtest23of100,1,321,5275,29,40,5344
subtest23of10,pubtest23of100,1,321,5275,26,81,5382
subtest29of10,pubtest23of100,1,321,5275,28,119,5422
subtest27of10,pubtest23of100,1,321,5275,30,158,5463
subtest28of10,pubtest23of100,1,321,5275,31,197,5503
subtest26of10,pubtest23of100,1,321,5275,55,213,5543
subtest25of10,pubtest23of100,1,321,5275,94,216,5585
subtest22of10,pubtest23of100,1,321,5275,94,254,5623
subtest21of10,pubtest23of100,1,321,5275,96,292,5663
subtest210of10,pubtest23of100,1,321,5275,96,331,5702
subtest23of10,pubtest24of100,1,321,5357,9,41,5407
subtest25of10,pubtest24of100,1,321,5357,16,74,5447
subtest24of10,pubtest24of100,1,321,5357,16,112,5485
subtest21of10,pubtest24of100,1,321,5357,17,152,5526
subtest28of10,pubtest24of100,1,321,5357,23,186,5566
subtest29of10,pubtest24of100,1,321,5357,23,226,5606
subtest27of10,pubtest24of100,1,321,5357,27,262,5646
subtest210of10,pubtest24of100,1,321,5357,28,299,5684
subtest22of10,pubtest24of100,1,321,5357,28,339,5724
subtest26of10,pubtest24of100,1,321,5357,59,350,5766
subtest21of10,pubtest25of100,1,321,5395,24,42,5461
subtest28of10,pubtest25of100,1,321,5395,24,82,5501
subtest25of10,pubtest25of100,1,321,5395,26,120,5541
subtest27of10,pubtest25of100,1,321,5395,26,160,5581
subtest29of10,pubtest25of100,1,321,5395,28,196,5619
subtest22of10,pubtest25of100,1,321,5395,30,236,5661
subtest210of10,pubtest25of100,1,321,5395,28,275,5698
subtest24of10,pubtest25of100,1,321,5395,32,314,5741
subtest23of10,pubtest25of100,1,321,5395,32,354,5781
subtest26of10,pubtest25of100,1,321,5395,34,392,5821
subtest21of10,pubtest26of100,1,321,5607,9,38,5654
subtest29of10,pubtest26of100,1,321,5607,14,71,5692
subtest22of10,pubtest26of100,1,321,5607,15,111,5733
subtest27of10,pubtest26of100,1,321,5607,17,149,5773
subtest23of10,pubtest26of100,1,321,5607,17,189,5813
subtest25of10,pubtest26of100,1,321,5607,19,227,5853
subtest26of10,pubtest26of100,1,321,5607,19,267,5893
subtest210of10,pubtest26of100,1,321,5607,25,301,5933
subtest28of10,pubtest26of100,1,321,5607,25,341,5973
subtest24of10,pubtest26of100,1,321,5607,33,373,6013
subtest28of10,pubtest27of100,1,320,5593,14,43,5650
subtest27of10,pubtest27of100,1,320,5593,13,82,5688
subtest23of10,pubtest27of100,1,320,5593,15,121,5729
subtest25of10,pubtest27of100,1,320,5593,17,159,5769
subtest22of10,pubtest27of100,1,320,5593,17,199,5809
subtest21of10,pubtest27of100,1,320,5593,18,238,5849
subtest24of10,pubtest27of100,1,320,5593,17,277,5887
subtest26of10,pubtest27of100,1,320,5593,20,315,5928
subtest210of10,pubtest27of100,1,320,5593,16,355,5964
subtest29of10,pubtest27of100,1,320,5593,16,393,6002
subtest27of10,pubtest28of100,1,321,5501,7,216,5724
subtest28of10,pubtest28of100,1,321,5501,11,251,5763
subtest21of10,pubtest28of100,1,321,5501,12,289,5802
subtest29of10,pubtest28of100,1,321,5501,12,329,5842
subtest23of10,pubtest28of100,1,321,5501,24,357,5882
subtest210of10,pubtest28of100,1,321,5501,27,393,5921
subtest25of10,pubtest28of100,1,321,5501,29,431,5961
subtest26of10,pubtest28of100,1,321,5501,34,467,6002
subtest24of10,pubtest28of100,1,321,5501,37,504,6042
subtest22of10,pubtest28of100,1,321,5501,40,541,6082
subtest23of10,pubtest29of100,1,321,5687,13,42,5742
subtest29of10,pubtest29of100,1,321,5687,22,71,5780
subtest210of10,pubtest29of100,1,321,5687,23,109,5819
subtest22of10,pubtest29of100,1,321,5687,30,143,5860
subtest25of10,pubtest29of100,1,321,5687,32,181,5900
subtest21of10,pubtest29of100,1,321,5687,38,215,5940
subtest27of10,pubtest29of100,1,321,5687,40,253,5980
subtest28of10,pubtest29of100,1,321,5687,43,290,6020
subtest24of10,pubtest29of100,1,321,5687,47,326,6060
subtest26of10,pubtest29of100,1,321,5687,50,364,6101
subtest29of10,pubtest210of100,1,323,5372,9,41,5422
subtest21of10,pubtest210of100,1,323,5372,12,76,5460
subtest210of10,pubtest210of100,1,323,5372,12,116,5500
subtest27of10,pubtest210of100,1,323,5372,15,154,5541
subtest23of10,pubtest210of100,1,323,5372,17,192,5581
subtest25of10,pubtest210of100,1,323,5372,22,227,5621
subtest28of10,pubtest210of100,1,323,5372,21,267,5660
subtest24of10,pubtest210of100,1,323,5372,23,306,5701
subtest22of10,pubtest210of100,1,323,5372,24,345,5741
subtest26of10,pubtest210of100,1,323,5372,33,375,5780
subtest210of10,pubtest211of100,1,323,5415,22,43,5480
subtest24of10,pubtest211of100,1,323,5415,28,75,5518
subtest21of10,pubtest211of100,1,323,5415,30,114,5559
subtest22of10,pubtest211of100,1,323,5415,30,154,5599
subtest25of10,pubtest211of100,1,323,5415,32,192,5639
subtest29of10,pubtest211of100,1,323,5415,28,232,5675
subtest23of10,pubtest211of100,1,323,5415,33,271,5719
subtest28of10,pubtest211of100,1,323,5415,38,306,5759
subtest27of10,pubtest211of100,1,323,5415,37,346,5798
subtest26of10,pubtest211of100,1,323,5415,32,386,5833
subtest25of10,pubtest212of100,1,323,5251,8,39,5298
subtest29of10,pubtest212of100,1,323,5251,15,71,5337
subtest28of10,pubtest212of100,1,323,5251,18,107,5376
subtest23of10,pubtest212of100,1,323,5251,21,145,5417
subtest27of10,pubtest212of100,1,323,5251,26,180,5457
subtest24of10,pubtest212of100,1,323,5251,29,217,5497
subtest21of10,pubtest212of100,1,323,5251,33,253,5537
subtest22of10,pubtest212of100,1,323,5251,38,288,5577
subtest26of10,pubtest212of100,1,323,5251,42,324,5617
subtest210of10,pubtest212of100,1,323,5251,46,360,5657
subtest26of10,pubtest213of100,1,322,5330,11,114,5455
subtest23of10,pubtest213of100,1,322,5330,33,131,5494
subtest29of10,pubtest213of100,1,322,5330,34,172,5536
subtest27of10,pubtest213of100,1,322,5330,39,206,5575
subtest22of10,pubtest213of100,1,322,5330,39,246,5615
subtest21of10,pubtest213of100,1,322,5330,40,285,5655
subtest24of10,pubtest213of100,1,322,5330,41,325,5696
subtest25of10,pubtest213of100,1,322,5330,43,362,5735
subtest210of10,pubtest213of100,1,322,5330,43,402,5775
subtest28of10,pubtest213of100,1,322,5330,46,439,5815
subtest21of10,pubtest214of100,1,323,5286,13,41,5340
subtest23of10,pubtest214of100,1,323,5286,19,74,5379
subtest26of10,pubtest214of100,1,323,5286,22,111,5419
subtest25of10,pubtest214of100,1,323,5286,26,147,5459
subtest22of10,pubtest214of100,1,323,5286,28,185,5499
subtest24of10,pubtest214of100,1,323,5286,33,220,5539
subtest28of10,pubtest214of100,1,323,5286,34,259,5579
subtest29of10,pubtest214of100,1,323,5286,34,299,5619
subtest27of10,pubtest214of100,1,323,5286,29,339,5654
subtest210of10,pubtest214of100,1,323,5286,32,381,5699
subtest24of10,pubtest215of100,1,323,5366,22,41,5429
subtest27of10,pubtest215of100,1,323,5366,23,79,5468
subtest26of10,pubtest215of100,1,323,5366,26,116,5508
subtest210of10,pubtest215of100,1,323,5366,51,132,5549
subtest29of10,pubtest215of100,1,323,5366,51,171,5588
subtest22of10,pubtest215of100,1,323,5366,52,209,5627
subtest23of10,pubtest215of100,1,323,5366,53,249,5668
subtest21of10,pubtest215of100,1,323,5366,54,288,5708
subtest28of10,pubtest215of100,1,323,5366,54,328,5748
subtest25of10,pubtest215of100,1,323,5366,56,366,5788
subtest24of10,pubtest216of100,1,323,5368,13,42,5423
subtest21of10,pubtest216of100,1,323,5368,14,80,5462
subtest27of10,pubtest216of100,1,323,5368,15,120,5503
subtest23of10,pubtest216of100,1,323,5368,15,159,5542
subtest28of10,pubtest216of100,1,323,5368,28,187,5583
subtest25of10,pubtest216of100,1,323,5368,28,227,5623
subtest22of10,pubtest216of100,1,323,5368,30,265,5663
subtest29of10,pubtest216of100,1,323,5368,30,305,5703
subtest26of10,pubtest216of100,1,323,5368,37,338,5743
subtest210of10,pubtest216of100,1,323,5368,38,375,5781
subtest27of10,pubtest217of100,1,322,5254,15,42,5311
subtest22of10,pubtest217of100,1,322,5254,18,79,5351
subtest21of10,pubtest217of100,1,322,5254,20,116,5390
subtest26of10,pubtest217of100,1,322,5254,21,155,5430
subtest23of10,pubtest217of100,1,322,5254,24,192,5470
subtest24of10,pubtest217of100,1,322,5254,24,232,5510
subtest28of10,pubtest217of100,1,322,5254,27,269,5550
subtest29of10,pubtest217of100,1,322,5254,27,309,5590
subtest210of10,pubtest217of100,1,322,5254,29,347,5630
subtest25of10,pubtest217of100,1,322,5254,29,387,5670
subtest21of10,pubtest218of100,1,323,5376,15,40,5431
subtest29of10,pubtest218of100,1,323,5376,15,79,5470
subtest22of10,pubtest218of100,1,323,5376,18,115,5509
subtest28of10,pubtest218of100,1,323,5376,19,155,5550
subtest23of10,pubtest218of100,1,323,5376,21,193,5590
subtest27of10,pubtest218of100,1,323,5376,21,233,5630
subtest25of10,pubtest218of100,1,323,5376,51,243,5670
subtest24of10,pubtest218of100,1,323,5376,52,282,5710
subtest26of10,pubtest218of100,1,323,5376,53,321,5750
subtest210of10,pubtest218of100,1,323,5376,53,361,5790
subtest210of10,pubtest219of100,1,323,5306,11,40,5357
subtest26of10,pubtest219of100,1,323,5306,21,70,5397
subtest25of10,pubtest219of100,1,323,5306,21,109,5436
subtest22of10,pubtest219of100,1,323,5306,26,144,5476
subtest21of10,pubtest219of100,1,323,5306,28,182,5516
subtest23of10,pubtest219of100,1,323,5306,28,222,5556
subtest29of10,pubtest219of100,1,323,5306,28,261,5595
subtest24of10,pubtest219of100,1,323,5306,30,300,5636
subtest27of10,pubtest219of100,1,323,5306,34,336,5676
subtest28of10,pubtest219of100,1,323,5306,57,353,5716
subtest25of10,pubtest220of100,1,323,5285,11,41,5337
subtest210of10,pubtest220of100,1,323,5285,12,80,5377
subtest23of10,pubtest220of100,1,323,5285,13,119,5417
subtest29of10,pubtest220of100,1,323,5285,25,145,5455
subtest27of10,pubtest220of100,1,323,5285,28,184,5497
subtest21of10,pubtest220of100,1,323,5285,25,224,5534
subtest24of10,pubtest220of100,1,323,5285,34,258,5577
subtest28of10,pubtest220of100,1,323,5285,35,297,5617
subtest26of10,pubtest220of100,1,323,5285,37,337,5659
subtest22of10,pubtest220of100,1,323,5285,38,375,5698
subtest24of10,pubtest221of100,1,323,5344,9,46,5399
subtest21of10,pubtest221of100,1,323,5344,13,82,5439
subtest28of10,pubtest221of100,1,323,5344,15,119,5478
subtest22of10,pubtest221of100,1,323,5344,22,152,5518
subtest23of10,pubtest221of100,1,323,5344,23,191,5558
subtest25of10,pubtest221of100,1,323,5344,29,225,5598
subtest210of10,pubtest221of100,1,323,5344,30,265,5639
subtest29of10,pubtest221of100,1,323,5344,33,301,5678
subtest27of10,pubtest221of100,1,323,5344,34,338,5716
subtest26of10,pubtest221of100,1,323,5344,36,378,5758
subtest21of10,pubtest222of100,1,323,5280,14,40,5334
subtest22of10,pubtest222of100,1,323,5280,15,78,5373
subtest29of10,pubtest222of100,1,323,5280,17,116,5413
subtest27of10,pubtest222of100,1,323,5280,21,152,5453
subtest23of10,pubtest222of100,1,323,5280,28,185,5493
subtest25of10,pubtest222of100,1,323,5280,64,188,5532
subtest28of10,pubtest222of100,1,323,5280,64,228,5572
subtest210of10,pubtest222of100,1,323,5280,67,266,5613
subtest26of10,pubtest222of100,1,323,5280,66,306,5652
subtest24of10,pubtest222of100,1,323,5280,70,343,5693
subtest28of10,pubtest223of100,1,323,5341,14,47,5402
subtest21of10,pubtest223of100,1,323,5341,13,84,5438
subtest23of10,pubtest223of100,1,323,5341,18,119,5478
subtest29of10,pubtest223of100,1,323,5341,24,154,5519
subtest24of10,pubtest223of100,1,323,5341,24,193,5558
subtest27of10,pubtest223of100,1,323,5341,25,232,5598
subtest210of10,pubtest223of100,1,323,5341,26,271,5638
subtest22of10,pubtest223of100,1,323,5341,27,310,5678
subtest26of10,pubtest223of100,1,323,5341,29,348,5718
subtest25of10,pubtest223of100,1,323,5341,29,388,5758
subtest21of10,pubtest224of100,1,323,5267,13,39,5319
subtest27of10,pubtest224of100,1,323,5267,19,72,5358
subtest28of10,pubtest224of100,1,323,5267,27,104,5398
subtest23of10,pubtest224of100,1,323,5267,27,144,5438
subtest26of10,pubtest224of100,1,323,5267,30,181,5478
subtest29of10,pubtest224of100,1,323,5267,32,219,5518
subtest25of10,pubtest224of100,1,323,5267,33,257,5557
subtest22of10,pubtest224of100,1,323,5267,41,290,5598
subtest210of10,pubtest224of100,1,323,5267,44,327,5638
subtest24of10,pubtest224of100,1,323,5267,44,368,5679
subtest22of10,pubtest225of100,1,323,5345,17,317,5679
subtest27of10,pubtest225of100,1,323,5345,16,354,5715
subtest25of10,pubtest225of100,1,323,5345,19,391,5755
subtest26of10,pubtest225of100,1,323,5345,21,431,5797
subtest24of10,pubtest225of100,1,323,5345,21,470,5836
subtest21of10,pubtest225of100,1,323,5345,21,509,5875
subtest28of10,pubtest225of100,1,323,5345,24,547,5916
subtest23of10,pubtest225of100,1,323,5345,25,586,5956
subtest29of10,pubtest225of100,1,323,5345,27,624,5996
subtest210of10,pubtest225of100,1,323,5345,27,664,6036
subtest25of10,pubtest226of100,1,323,5305,23,41,5369
subtest22of10,pubtest226of100,1,323,5305,23,81,5409
subtest210of10,pubtest226of100,1,323,5305,25,118,5448
subtest27of10,pubtest226of100,1,323,5305,25,158,5488
subtest28of10,pubtest226of100,1,323,5305,27,196,5528
subtest21of10,pubtest226of100,1,323,5305,27,236,5568
subtest23of10,pubtest226of100,1,323,5305,25,275,5605
subtest29of10,pubtest226of100,1,323,5305,29,313,5647
subtest24of10,pubtest226of100,1,323,5305,32,351,5688
subtest26of10,pubtest226of100,1,323,5305,32,391,5728
subtest210of10,pubtest227of100,1,323,5261,16,41,5318
subtest29of10,pubtest227of100,1,323,5261,15,79,5355
subtest24of10,pubtest227of100,1,323,5261,21,117,5399
subtest23of10,pubtest227of100,1,323,5261,22,154,5437
subtest25of10,pubtest227of100,1,323,5261,21,194,5476
subtest21of10,pubtest227of100,1,323,5261,24,232,5517
subtest27of10,pubtest227of100,1,323,5261,24,272,5557
subtest22of10,pubtest227of100,1,323,5261,25,311,5597
subtest26of10,pubtest227of100,1,323,5261,23,350,5634
subtest28of10,pubtest227of100,1,323,5261,32,384,5677
subtest21of10,pubtest228of100,1,323,5338,9,38,5385
subtest26of10,pubtest228of100,1,323,5338,19,68,5425
subtest25of10,pubtest228of100,1,323,5338,19,107,5464
subtest24of10,pubtest228of100,1,323,5338,21,145,5504
subtest23of10,pubtest228of100,1,323,5338,34,172,5544
subtest27of10,pubtest228of100,1,323,5338,36,208,5582
subtest210of10,pubtest228of100,1,323,5338,37,247,5622
subtest29of10,pubtest228of100,1,323,5338,39,287,5664
subtest22of10,pubtest228of100,1,323,5338,52,319,5709
subtest28of10,pubtest228of100,1,323,5338,53,357,5748
subtest24of10,pubtest229of100,1,321,5325,16,41,5382
subtest21of10,pubtest229of100,1,321,5325,17,501,5843
subtest28of10,pubtest229of100,1,321,5325,20,538,5883
subtest27of10,pubtest229of100,1,321,5325,21,577,5923
subtest23of10,pubtest229of100,1,321,5325,24,613,5962
subtest25of10,pubtest229of100,1,321,5325,24,653,6002
subtest22of10,pubtest229of100,1,321,5325,26,691,6042
subtest29of10,pubtest229of100,1,321,5325,25,730,6080
subtest26of10,pubtest229of100,1,321,5325,28,769,6122
subtest210of10,pubtest229of100,1,321,5325,26,809,6160
subtest22of10,pubtest230of100,1,323,5370,15,41,5426
subtest21of10,pubtest230of100,1,323,5370,15,80,5465
subtest27of10,pubtest230of100,1,323,5370,17,118,5505
subtest28of10,pubtest230of100,1,323,5370,23,153,5546
subtest29of10,pubtest230of100,1,323,5370,23,192,5585
subtest25of10,pubtest230of100,1,323,5370,25,230,5625
subtest23of10,pubtest230of100,1,323,5370,25,268,5663
subtest24of10,pubtest230of100,1,323,5370,28,307,5705
subtest26of10,pubtest230of100,1,323,5370,28,346,5744
subtest210of10,pubtest230of100,1,323,5370,30,385,5785
subtest23of10,pubtest231of100,1,323,5392,14,225,5631
subtest28of10,pubtest231of100,1,323,5392,21,257,5670
subtest24of10,pubtest231of100,1,323,5392,25,293,5710
subtest25of10,pubtest231of100,1,323,5392,25,335,5752
subtest29of10,pubtest231of100,1,323,5392,26,373,5791
subtest210of10,pubtest231of100,1,323,5392,54,384,5830
subtest26of10,pubtest231of100,1,323,5392,54,424,5870
subtest27of10,pubtest231of100,1,323,5392,58,460,5910
subtest21of10,pubtest231of100,1,323,5392,60,499,5951
subtest22of10,pubtest231of100,1,323,5392,60,538,5990
subtest21of10,pubtest232of100,1,323,5387,13,39,5439
subtest27of10,pubtest232of100,1,323,5387,13,78,5478
subtest22of10,pubtest232of100,1,323,5387,16,115,5518
subtest23of10,pubtest232of100,1,323,5387,17,154,5558
subtest29of10,pubtest232of100,1,323,5387,18,193,5598
subtest28of10,pubtest232of100,1,323,5387,21,230,5638
subtest25of10,pubtest232of100,1,323,5387,21,267,5675
subtest24of10,pubtest232of100,1,323,5387,26,305,5718
subtest26of10,pubtest232of100,1,323,5387,26,345,5758
subtest210of10,pubtest232of100,1,323,5387,25,384,5796
subtest24of10,pubtest233of100,1,323,5383,18,71,5472
subtest29of10,pubtest233of100,1,323,5383,19,111,5513
subtest26of10,pubtest233of100,1,323,5383,22,149,5554
subtest25of10,pubtest233of100,1,323,5383,22,187,5592
subtest210of10,pubtest233of100,1,323,5383,24,225,5632
subtest27of10,pubtest233of100,1,323,5383,24,265,5672
subtest23of10,pubtest233of100,1,323,5383,26,303,5712
subtest21of10,pubtest233of100,1,323,5383,30,339,5752
subtest28of10,pubtest233of100,1,323,5383,36,373,5792
subtest22of10,pubtest233of100,1,323,5383,36,413,5832
subtest25of10,pubtest234of100,1,323,5343,28,45,5416
subtest26of10,pubtest234of100,1,323,5343,28,84,5455
subtest27of10,pubtest234of100,1,323,5343,30,122,5495
subtest21of10,pubtest234of100,1,323,5343,30,162,5535
subtest29of10,pubtest234of100,1,323,5343,36,196,5575
subtest22of10,pubtest234of100,1,323,5343,36,236,5615
subtest23of10,pubtest234of100,1,323,5343,37,273,5653
subtest28of10,pubtest234of100,1,323,5343,40,312,5695
subtest24of10,pubtest234of100,1,323,5343,40,352,5735
subtest210of10,pubtest234of100,1,323,5343,38,391,5772
subtest21of10,pubtest235of100,1,321,5354,59,41,5454
subtest210of10,pubtest235of100,1,321,5354,60,79,5493
subtest23of10,pubtest235of100,1,321,5354,63,116,5533
subtest22of10,pubtest235of100,1,321,5354,65,154,5573
subtest27of10,pubtest235of100,1,321,5354,66,193,5613
subtest29of10,pubtest235of100,1,321,5354,68,232,5654
subtest26of10,pubtest235of100,1,321,5354,67,272,5693
subtest24of10,pubtest235of100,1,321,5354,66,312,5732
subtest25of10,pubtest235of100,1,321,5354,69,350,5773
subtest28of10,pubtest235of100,1,321,5354,73,388,5815
subtest210of10,pubtest236of100,1,323,5241,28,41,5310
subtest23of10,pubtest236of100,1,323,5241,29,79,5349
subtest27of10,pubtest236of100,1,323,5241,31,117,5389
subtest28of10,pubtest236of100,1,323,5241,32,156,5429
subtest29of10,pubtest236of100,1,323,5241,34,194,5469
subtest21of10,pubtest236of100,1,323,5241,34,233,5508
subtest26of10,pubtest236of100,1,323,5241,35,273,5549
subtest25of10,pubtest236of100,1,323,5241,33,310,5584
subtest24of10,pubtest236of100,1,323,5241,35,350,5626
subtest22of10,pubtest236of100,1,323,5241,40,388,5669
subtest24of10,pubtest237of100,1,323,5344,8,210,5562
subtest23of10,pubtest237of100,1,323,5344,12,245,5601
subtest28of10,pubtest237of100,1,323,5344,12,285,5641
subtest25of10,pubtest237of100,1,323,5344,15,323,5682
subtest26of10,pubtest237of100,1,323,5344,21,356,5721
subtest27of10,pubtest237of100,1,323,5344,22,395,5761
subtest21of10,pubtest237of100,1,323,5344,23,435,5802
subtest22of10,pubtest237of100,1,323,5344,55,442,5841
subtest29of10,pubtest237of100,1,323,5344,56,481,5881
subtest210of10,pubtest237of100,1,323,5344,58,519,5921
subtest29of10,pubtest238of100,1,323,5272,12,39,5323
subtest22of10,pubtest238of100,1,323,5272,16,74,5362
subtest27of10,pubtest238of100,1,323,5272,17,113,5402
subtest28of10,pubtest238of100,1,323,5272,22,149,5443
subtest25of10,pubtest238of100,1,323,5272,23,187,5482
subtest210of10,pubtest238of100,1,323,5272,27,224,5523
subtest21of10,pubtest238of100,1,323,5272,31,257,5560
subtest26of10,pubtest238of100,1,323,5272,33,297,5602
subtest23of10,pubtest238of100,1,323,5272,30,338,5640
subtest24of10,pubtest238of100,1,323,5272,34,377,5683
subtest28of10,pubtest239of100,1,323,5250,28,272,5550
subtest21of10,pubtest239of100,1,323,5250,29,310,5589
subtest27of10,pubtest239of100,1,323,5250,31,346,5627
subtest26of10,pubtest239of100,1,323,5250,34,385,5669
subtest25of10,pubtest239of100,1,323,5250,35,425,5710
subtest22of10,pubtest239of100,1,323,5250,36,463,5749
subtest29of10,pubtest239of100,1,323,5250,37,504,5791
subtest23of10,pubtest239of100,1,323,5250,38,543,5831
subtest24of10,pubtest239of100,1,323,5250,35,580,5865
subtest210of10,pubtest239of100,1,323,5250,39,620,5909
subtest25of10,pubtest240of100,1,323,5316,9,38,5363
subtest210of10,pubtest240of100,1,323,5316,25,62,5403
subtest29of10,pubtest240of100,1,323,5316,27,100,5443
subtest21of10,pubtest240of100,1,323,5316,26,139,5481
subtest27of10,pubtest240of100,1,323,5316,28,179,5523
subtest28of10,pubtest240of100,1,323,5316,30,216,5562
subtest23of10,pubtest240of100,1,323,5316,30,257,5603
subtest24of10,pubtest240of100,1,323,5316,36,291,5643
subtest22of10,pubtest240of100,1,323,5316,36,330,5682
subtest26of10,pubtest240of100,1,323,5316,37,369,5722
subtest23of10,pubtest241of100,1,323,5260,29,42,5331
subtest24of10,pubtest241of100,1,323,5260,33,77,5370
subtest27of10,pubtest241of100,1,323,5260,34,116,5410
subtest210of10,pubtest241of100,1,323,5260,37,153,5450
subtest29of10,pubtest241of100,1,323,5260,38,192,5490
subtest25of10,pubtest241of100,1,323,5260,40,230,5530
subtest28of10,pubtest241of100,1,323,5260,41,270,5571
subtest21of10,pubtest241of100,1,323,5260,36,309,5605
subtest26of10,pubtest241of100,1,323,5260,48,342,5650
subtest22of10,pubtest241of100,1,323,5260,48,382,5690
subtest27of10,pubtest242of100,1,323,5796,10,40,5846
subtest26of10,pubtest242of100,1,323,5796,20,69,5885
subtest23of10,pubtest242of100,1,323,5796,24,105,5925
subtest210of10,pubtest242of100,1,323,5796,26,143,5965
subtest25of10,pubtest242of100,1,323,5796,31,178,6005
subtest29of10,pubtest242of100,1,323,5796,34,214,6044
subtest21of10,pubtest242of100,1,323,5796,35,254,6085
subtest22of10,pubtest242of100,1,323,5796,36,290,6122
subtest24of10,pubtest242of100,1,323,5796,37,329,6162
subtest28of10,pubtest242of100,1,323,5796,39,369,6204
subtest29of10,pubtest243of100,1,323,5259,13,41,5313
subtest28of10,pubtest243of100,1,323,5259,13,80,5352
subtest23of10,pubtest243of100,1,323,5259,15,118,5392
subtest25of10,pubtest243of100,1,323,5259,18,154,5431
subtest22of10,pubtest243of100,1,323,5259,18,194,5471
subtest27of10,pubtest243of100,1,323,5259,21,232,5512
subtest26of10,pubtest243of100,1,323,5259,21,272,5552
subtest21of10,pubtest243of100,1,323,5259,24,310,5593
subtest24of10,pubtest243of100,1,323,5259,34,339,5632
subtest210of10,pubtest243of100,1,323,5259,34,379,5672
subtest27of10,pubtest244of100,1,323,5314,16,40,5370
subtest26of10,pubtest244of100,1,323,5314,20,75,5409
subtest25of10,pubtest244of100,1,323,5314,21,114,5449
subtest23of10,pubtest244of100,1,323,5314,22,152,5488
subtest29of10,pubtest244of100,1,323,5314,23,193,5530
subtest21of10,pubtest244of100,1,323,5314,22,231,5567
subtest210of10,pubtest244of100,1,323,5314,24,271,5609
subtest28of10,pubtest244of100,1,323,5314,25,310,5649
subtest24of10,pubtest244of100,1,323,5314,28,347,5689
subtest22of10,pubtest244of100,1,323,5314,28,387,5729
subtest29of10,pubtest245of100,1,322,5265,12,41,5318
subtest26of10,pubtest245of100,1,322,5265,16,74,5355
subtest23of10,pubtest245of100,1,322,5265,17,114,5396
subtest25of10,pubtest245of100,1,322,5265,23,150,5438
subtest22of10,pubtest245of100,1,322,5265,28,185,5478
subtest21of10,pubtest245of100,1,322,5265,29,223,5517
subtest27of10,pubtest245of100,1,322,5265,30,261,5556
subtest24of10,pubtest245of100,1,322,5265,30,301,5596
subtest210of10,pubtest245of100,1,322,5265,32,340,5637
subtest28of10,pubtest245of100,1,322,5265,32,380,5677
subtest26of10,pubtest246of100,1,323,5253,16,43,5312
subtest27of10,pubtest246of100,1,323,5253,17,83,5353
subtest21of10,pubtest246of100,1,323,5253,22,117,5392
subtest29of10,pubtest246of100,1,323,5253,22,157,5432
subtest28of10,pubtest246of100,1,323,5253,50,169,5472
subtest210of10,pubtest246of100,1,323,5253,62,195,5510
subtest23of10,pubtest246of100,1,323,5253,62,234,5549
subtest25of10,pubtest246of100,1,323,5253,63,273,5589
subtest24of10,pubtest246of100,1,323,5253,66,313,5632
subtest22of10,pubtest246of100,1,323,5253,67,352,5672
subtest27of10,pubtest247of100,1,323,5325,15,40,5380
subtest26of10,pubtest247of100,1,323,5325,16,76,5417
subtest23of10,pubtest247of100,1,323,5325,19,115,5459
subtest21of10,pubtest247of100,1,323,5325,20,154,5499
subtest22of10,pubtest247of100,1,323,5325,23,191,5539
subtest29of10,pubtest247of100,1,323,5325,25,229,5579
subtest25of10,pubtest247of100,1,323,5325,25,270,5620
subtest28of10,pubtest247of100,1,323,5325,38,295,5658
subtest210of10,pubtest247of100,1,323,5325,39,335,5699
subtest24of10,pubtest247of100,1,323,5325,40,374,5739
subtest29of10,pubtest248of100,1,323,5251,13,41,5305
subtest26of10,pubtest248of100,1,323,5251,14,80,5345
subtest25of10,pubtest248of100,1,323,5251,15,118,5384
subtest23of10,pubtest248of100,1,323,5251,16,157,5424
subtest28of10,pubtest248of100,1,323,5251,23,188,5462
subtest27of10,pubtest248of100,1,323,5251,24,228,5503
subtest24of10,pubtest248of100,1,323,5251,28,265,5544
subtest210of10,pubtest248of100,1,323,5251,29,304,5584
subtest21of10,pubtest248of100,1,323,5251,28,344,5623
subtest22of10,pubtest248of100,1,323,5251,30,383,5664
subtest27of10,pubtest249of100,1,323,5314,13,38,5365
subtest28of10,pubtest249of100,1,323,5314,25,66,5405
subtest24of10,pubtest249of100,1,323,5314,26,105,5445
subtest25of10,pubtest249of100,1,323,5314,27,144,5485
subtest21of10,pubtest249of100,1,323,5314,28,183,5525
subtest26of10,pubtest249of100,1,323,5314,30,221,5565
subtest29of10,pubtest249of100,1,323,5314,31,260,5605
subtest23of10,pubtest249of100,1,323,5314,32,299,5645
subtest22of10,pubtest249of100,1,323,5314,33,338,5685
subtest210of10,pubtest249of100,1,323,5314,36,375,5725
subtest27of10,pubtest250of100,1,323,5216,21,41,5278
subtest28of10,pubtest250of100,1,323,5216,21,80,5317
subtest23of10,pubtest250of100,1,323,5216,23,118,5357
subtest21of10,pubtest250of100,1,323,5216,26,155,5397
subtest25of10,pubtest250of100,1,323,5216,27,194,5437
subtest210of10,pubtest250of100,1,323,5216,28,235,5479
subtest29of10,pubtest250of100,1,323,5216,25,273,5514
subtest24of10,pubtest250of100,1,323,5216,28,311,5555
subtest26of10,pubtest250of100,1,323,5216,30,351,5597
subtest22of10,pubtest250of100,1,323,5216,31,390,5637
subtest22of10,pubtest251of100,1,323,5266,11,42,5319
subtest23of10,pubtest251of100,1,323,5266,10,81,5357
subtest27of10,pubtest251of100,1,323,5266,17,114,5397
subtest24of10,pubtest251of100,1,323,5266,18,153,5437
subtest25of10,pubtest251of100,1,323,5266,19,192,5477
subtest28of10,pubtest251of100,1,323,5266,20,231,5517
subtest210of10,pubtest251of100,1,323,5266,21,270,5557
subtest21of10,pubtest251of100,1,323,5266,22,307,5595
subtest29of10,pubtest251of100,1,323,5266,22,347,5635
subtest26of10,pubtest251of100,1,323,5266,22,386,5674
subtest28of10,pubtest252of100,1,323,5315,9,40,5364
subtest29of10,pubtest252of100,1,323,5315,16,70,5401
subtest21of10,pubtest252of100,1,323,5315,17,108,5440
subtest26of10,pubtest252of100,1,323,5315,19,148,5482
subtest27of10,pubtest252of100,1,323,5315,21,187,5523
subtest22of10,pubtest252of100,1,323,5315,21,226,5562
subtest25of10,pubtest252of100,1,323,5315,23,264,5602
subtest23of10,pubtest252of100,1,323,5315,23,304,5642
subtest210of10,pubtest252of100,1,323,5315,24,343,5682
subtest24of10,pubtest252of100,1,323,5315,24,382,5721
subtest28of10,pubtest253of100,1,322,5252,9,39,5300
subtest23of10,pubtest253of100,1,322,5252,16,71,5339
subtest24of10,pubtest253of100,1,322,5252,20,107,5379
subtest25of10,pubtest253of100,1,322,5252,23,144,5419
subtest29of10,pubtest253of100,1,322,5252,26,179,5457
subtest22of10,pubtest253of100,1,322,5252,28,219,5499
subtest27of10,pubtest253of100,1,322,5252,28,258,5538
subtest21of10,pubtest253of100,1,322,5252,32,295,5579
subtest210of10,pubtest253of100,1,322,5252,33,335,5620
subtest26of10,pubtest253of100,1,322,5252,35,373,5660
subtest210of10,pubtest254of100,1,323,5228,27,41,5296
subtest27of10,pubtest254of100,1,323,5228,27,80,5335
subtest28of10,pubtest254of100,1,323,5228,31,116,5375
subtest21of10,pubtest254of100,1,323,5228,33,154,5415
subtest25of10,pubtest254of100,1,323,5228,33,194,5455
subtest23of10,pubtest254of100,1,323,5228,35,232,5495
subtest24of10,pubtest254of100,1,323,5228,35,272,5535
subtest29of10,pubtest254of100,1,323,5228,37,308,5573
subtest22of10,pubtest254of100,1,323,5228,41,346,5615
subtest26of10,pubtest254of100,1,323,5228,43,384,5655
subtest23of10,pubtest255of100,1,322,5386,24,38,5448
subtest22of10,pubtest255of100,1,322,5386,24,77,5487
subtest29of10,pubtest255of100,1,322,5386,28,113,5527
subtest28of10,pubtest255of100,1,322,5386,27,153,5566
subtest27of10,pubtest255of100,1,322,5386,29,192,5607
subtest21of10,pubtest255of100,1,322,5386,29,232,5647
subtest24of10,pubtest255of100,1,322,5386,30,271,5687
subtest25of10,pubtest255of100,1,322,5386,31,310,5727
subtest210of10,pubtest255of100,1,322,5386,32,349,5767
subtest26of10,pubtest255of100,1,322,5386,51,370,5807
subtest29of10,pubtest256of100,1,323,5263,10,39,5312
subtest21of10,pubtest256of100,1,323,5263,14,74,5351
subtest23of10,pubtest256of100,1,323,5263,14,114,5391
subtest26of10,pubtest256of100,1,323,5263,19,149,5431
subtest25of10,pubtest256of100,1,323,5263,20,186,5469
subtest27of10,pubtest256of100,1,323,5263,23,226,5512
subtest24of10,pubtest256of100,1,323,5263,23,265,5551
subtest22of10,pubtest256of100,1,323,5263,23,304,5590
subtest28of10,pubtest256of100,1,323,5263,23,344,5630
subtest210of10,pubtest256of100,1,323,5263,26,382,5671
subtest24of10,pubtest257of100,1,323,5216,11,43,5270
subtest21of10,pubtest257of100,1,323,5216,39,55,5310
subtest27of10,pubtest257of100,1,323,5216,41,92,5349
subtest28of10,pubtest257of100,1,323,5216,44,130,5390
subtest23of10,pubtest257of100,1,323,5216,45,168,5429
subtest22of10,pubtest257of100,1,323,5216,45,209,5470
subtest29of10,pubtest257of100,1,323,5216,47,247,5510
subtest210of10,pubtest257of100,1,323,5216,48,285,5549
subtest25of10,pubtest257of100,1,323,5216,49,325,5590
subtest26of10,pubtest257of100,1,323,5216,57,356,5629
subtest28of10,pubtest258of100,1,323,5226,12,40,5278
subtest23of10,pubtest258of100,1,323,5226,14,76,5316
subtest25of10,pubtest258of100,1,323,5226,14,116,5356
subtest26of10,pubtest258of100,1,323,5226,16,154,5396
subtest21of10,pubtest258of100,1,323,5226,16,194,5436
subtest29of10,pubtest258of100,1,323,5226,17,233,5476
subtest27of10,pubtest258of100,1,323,5226,18,272,5516
subtest210of10,pubtest258of100,1,323,5226,21,309,5556
subtest22of10,pubtest258of100,1,323,5226,24,346,5596
subtest24of10,pubtest258of100,1,323,5226,24,386,5636
subtest21of10,pubtest259of100,1,323,5205,14,46,5265
subtest28of10,pubtest259of100,1,323,5205,15,84,5304
subtest24of10,pubtest259of100,1,323,5205,19,121,5345
subtest25of10,pubtest259of100,1,323,5205,17,158,5380
subtest26of10,pubtest259of100,1,323,5205,29,190,5424
subtest27of10,pubtest259of100,1,323,5205,31,229,5465
subtest23of10,pubtest259of100,1,323,5205,30,269,5504
subtest29of10,pubtest259of100,1,323,5205,32,307,5544
subtest22of10,pubtest259of100,1,323,5205,32,348,5585
subtest210of10,pubtest259of100,1,323,5205,34,385,5624
subtest23of10,pubtest260of100,1,323,5228,9,46,5283
subtest21of10,pubtest260of100,1,323,5228,34,60,5322
subtest27of10,pubtest260of100,1,323,5228,39,137,5404
subtest29of10,pubtest260of100,1,323,5228,41,172,5441
subtest25of10,pubtest260of100,1,323,5228,42,211,5481
subtest210of10,pubtest260of100,1,323,5228,46,247,5521
subtest26of10,pubtest260of100,1,323,5228,47,286,5561
subtest22of10,pubtest260of100,1,323,5228,48,325,5601
subtest28of10,pubtest260of100,1,323,5228,51,362,5641
subtest24of10,pubtest260of100,1,323,5228,51,400,5679
subtest25of10,pubtest261of100,1,323,5200,10,47,5257
subtest29of10,pubtest261of100,1,323,5200,11,84,5295
subtest28of10,pubtest261of100,1,323,5200,19,116,5335
subtest23of10,pubtest261of100,1,323,5200,21,154,5375
subtest210of10,pubtest261of100,1,323,5200,21,194,5415
subtest22of10,pubtest261of100,1,323,5200,26,229,5455
subtest24of10,pubtest261of100,1,323,5200,27,268,5495
subtest27of10,pubtest261of100,1,323,5200,26,308,5534
subtest21of10,pubtest261of100,1,323,5200,28,347,5575
subtest26of10,pubtest261of100,1,323,5200,28,388,5616
subtest22of10,pubtest262of100,1,323,5274,17,42,5333
subtest26of10,pubtest262of100,1,323,5274,18,81,5373
subtest21of10,pubtest262of100,1,323,5274,15,120,5409
subtest23of10,pubtest262of100,1,323,5274,19,158,5451
subtest29of10,pubtest262of100,1,323,5274,34,183,5491
subtest25of10,pubtest262of100,1,323,5274,35,222,5531
subtest28of10,pubtest262of100,1,323,5274,37,260,5571
subtest210of10,pubtest262of100,1,323,5274,36,300,5610
subtest27of10,pubtest262of100,1,323,5274,34,342,5650
subtest24of10,pubtest262of100,1,323,5274,37,378,5689
subtest22of10,pubtest263of100,1,322,5255,13,40,5308
subtest29of10,pubtest263of100,1,322,5255,19,73,5347
subtest23of10,pubtest263of100,1,322,5255,20,112,5387
subtest24of10,pubtest263of100,1,322,5255,23,149,5427
subtest25of10,pubtest263of100,1,322,5255,24,188,5467
subtest27of10,pubtest263of100,1,322,5255,25,227,5507
subtest26of10,pubtest263of100,1,322,5255,28,262,5545
subtest21of10,pubtest263of100,1,322,5255,30,302,5587
subtest28of10,pubtest263of100,1,322,5255,31,341,5627
subtest210of10,pubtest263of100,1,322,5255,32,380,5667
subtest22of10,pubtest264of100,1,322,5263,10,40,5313
subtest29of10,pubtest264of100,1,322,5263,11,77,5351
subtest23of10,pubtest264of100,1,322,5263,13,115,5391
subtest21of10,pubtest264of100,1,322,5263,15,154,5432
subtest25of10,pubtest264of100,1,322,5263,16,193,5472
subtest27of10,pubtest264of100,1,322,5263,16,233,5512
subtest24of10,pubtest264of100,1,322,5263,21,268,5552
subtest28of10,pubtest264of100,1,322,5263,21,308,5592
subtest26of10,pubtest264of100,1,322,5263,29,339,5631
subtest210of10,pubtest264of100,1,322,5263,30,380,5673
subtest26of10,pubtest265of100,1,323,5244,18,45,5307
subtest27of10,pubtest265of100,1,323,5244,73,42,5359
subtest210of10,pubtest265of100,1,323,5244,76,78,5398
subtest21of10,pubtest265of100,1,323,5244,79,115,5438
subtest29of10,pubtest265of100,1,323,5244,80,154,5478
subtest25of10,pubtest265of100,1,323,5244,83,191,5518
subtest22of10,pubtest265of100,1,323,5244,86,228,5558
subtest23of10,pubtest265of100,1,323,5244,88,267,5599
subtest28of10,pubtest265of100,1,323,5244,91,303,5638
subtest24of10,pubtest265of100,1,323,5244,93,341,5678
subtest29of10,pubtest266of100,1,321,5516,9,40,5565
subtest27of10,pubtest266of100,1,321,5516,12,76,5604
subtest25of10,pubtest266of100,1,321,5516,12,116,5644
subtest210of10,pubtest266of100,1,321,5516,21,146,5683
subtest26of10,pubtest266of100,1,321,5516,25,183,5724
subtest21of10,pubtest266of100,1,321,5516,27,221,5764
subtest23of10,pubtest266of100,1,321,5516,26,261,5803
subtest28of10,pubtest266of100,1,321,5516,28,301,5845
subtest24of10,pubtest266of100,1,321,5516,30,338,5884
subtest22of10,pubtest266of100,1,321,5516,32,376,5924
subtest23of10,pubtest267of100,1,323,6233,20,40,6293
subtest26of10,pubtest267of100,1,323,6233,21,78,6332
subtest25of10,pubtest267of100,1,323,6233,22,117,6372
subtest28of10,pubtest267of100,1,323,6233,24,155,6412
subtest27of10,pubtest267of100,1,323,6233,24,195,6452
subtest21of10,pubtest267of100,1,323,6233,25,233,6491
subtest29of10,pubtest267of100,1,323,6233,26,273,6532
subtest22of10,pubtest267of100,1,323,6233,27,313,6573
subtest24of10,pubtest267of100,1,323,6233,26,352,6611
subtest210of10,pubtest267of100,1,323,6233,30,389,6652
subtest23of10,pubtest268of100,1,323,5347,10,46,5403
subtest25of10,pubtest268of100,1,323,5347,19,76,5442
subtest24of10,pubtest268of100,1,323,5347,20,115,5482
subtest29of10,pubtest268of100,1,323,5347,24,151,5522
subtest27of10,pubtest268of100,1,323,5347,31,184,5562
subtest28of10,pubtest268of100,1,323,5347,32,223,5602
subtest21of10,pubtest268of100,1,323,5347,35,260,5642
subtest22of10,pubtest268of100,1,323,5347,40,295,5682
subtest210of10,pubtest268of100,1,323,5347,46,329,5722
subtest26of10,pubtest268of100,1,323,5347,49,367,5763
subtest21of10,pubtest269of100,1,323,5396,17,41,5454
subtest24of10,pubtest269of100,1,323,5396,17,80,5493
subtest25of10,pubtest269of100,1,323,5396,19,118,5533
subtest210of10,pubtest269of100,1,323,5396,19,158,5573
subtest27of10,pubtest269of100,1,323,5396,21,196,5613
subtest29of10,pubtest269of100,1,323,5396,35,222,5653
subtest23of10,pubtest269of100,1,323,5396,38,259,5693
subtest26of10,pubtest269of100,1,323,5396,39,298,5733
subtest22of10,pubtest269of100,1,323,5396,39,338,5773
subtest28of10,pubtest269of100,1,323,5396,41,375,5812
subtest23of10,pubtest270of100,1,323,5357,20,43,5420
subtest26of10,pubtest270of100,1,323,5357,23,79,5459
subtest210of10,pubtest270of100,1,323,5357,23,118,5498
subtest27of10,pubtest270of100,1,323,5357,22,159,5538
subtest29of10,pubtest270of100,1,323,5357,28,192,5577
subtest28of10,pubtest270of100,1,323,5357,29,230,5616
subtest22of10,pubtest270of100,1,323,5357,32,269,5658
subtest24of10,pubtest270of100,1,323,5357,32,309,5698
subtest25of10,pubtest270of100,1,323,5357,34,348,5739
subtest21of10,pubtest270of100,1,323,5357,33,388,5778
subtest25of10,pubtest271of100,1,323,5474,9,44,5527
subtest27of10,pubtest271of100,1,323,5474,10,80,5564
subtest24of10,pubtest271of100,1,323,5474,12,120,5606
subtest29of10,pubtest271of100,1,323,5474,14,158,5646
subtest21of10,pubtest271of100,1,323,5474,10,198,5682
subtest23of10,pubtest271of100,1,323,5474,15,237,5726
subtest22of10,pubtest271of100,1,323,5474,28,266,5768
subtest210of10,pubtest271of100,1,323,5474,28,305,5807
subtest26of10,pubtest271of100,1,323,5474,30,342,5846
subtest28of10,pubtest271of100,1,323,5474,30,382,5886
subtest25of10,pubtest272of100,1,323,5348,13,161,5522
subtest21of10,pubtest272of100,1,323,5348,17,157,5522
subtest29of10,pubtest272of100,1,323,5348,21,192,5561
subtest26of10,pubtest272of100,1,323,5348,21,232,5601
subtest210of10,pubtest272of100,1,323,5348,25,269,5642
subtest24of10,pubtest272of100,1,323,5348,24,309,5681
subtest23of10,pubtest272of100,1,323,5348,24,345,5717
subtest22of10,pubtest272of100,1,323,5348,26,385,5759
subtest27of10,pubtest272of100,1,323,5348,28,424,5800
subtest28of10,pubtest272of100,1,323,5348,34,459,5841
subtest29of10,pubtest273of100,1,321,5354,14,41,5409
subtest25of10,pubtest273of100,1,321,5354,15,80,5449
subtest27of10,pubtest273of100,1,321,5354,16,116,5486
subtest23of10,pubtest273of100,1,321,5354,23,151,5528
subtest21of10,pubtest273of100,1,321,5354,24,191,5569
subtest22of10,pubtest273of100,1,321,5354,25,230,5609
subtest28of10,pubtest273of100,1,321,5354,26,269,5649
subtest26of10,pubtest273of100,1,321,5354,25,308,5687
subtest210of10,pubtest273of100,1,321,5354,27,347,5728
subtest24of10,pubtest273of100,1,321,5354,28,386,5768
subtest21of10,pubtest274of100,1,323,5490,12,42,5544
subtest26of10,pubtest274of100,1,323,5490,13,80,5583
subtest23of10,pubtest274of100,1,323,5490,14,119,5623
subtest29of10,pubtest274of100,1,323,5490,15,159,5664
subtest22of10,pubtest274of100,1,323,5490,17,196,5703
subtest25of10,pubtest274of100,1,323,5490,18,235,5743
subtest27of10,pubtest274of100,1,323,5490,20,273,5783
subtest28of10,pubtest274of100,1,323,5490,21,312,5823
subtest24of10,pubtest274of100,1,323,5490,22,348,5860
subtest210of10,pubtest274of100,1,323,5490,26,387,5903
subtest27of10,pubtest275of100,1,323,5516,10,41,5567
subtest29of10,pubtest275of100,1,323,5516,11,80,5607
subtest24of10,pubtest275of100,1,323,5516,13,117,5646
subtest22of10,pubtest275of100,1,323,5516,18,152,5686
subtest25of10,pubtest275of100,1,323,5516,16,192,5724
subtest210of10,pubtest275of100,1,323,5516,79,171,5766
subtest21of10,pubtest275of100,1,323,5516,80,210,5806
subtest23of10,pubtest275of100,1,323,5516,81,249,5846
subtest26of10,pubtest275of100,1,323,5516,82,289,5887
subtest28of10,pubtest275of100,1,323,5516,85,326,5927
subtest28of10,pubtest276of100,1,323,7070,14,39,7123
subtest21of10,pubtest276of100,1,323,7070,15,78,7163
subtest25of10,pubtest276of100,1,323,7070,17,116,7203
subtest27of10,pubtest276of100,1,323,7070,26,147,7243
subtest24of10,pubtest276of100,1,323,7070,26,187,7283
subtest29of10,pubtest276of100,1,323,7070,28,225,7323
subtest23of10,pubtest276of100,1,323,7070,29,264,7363
subtest210of10,pubtest276of100,1,323,7070,30,303,7403
subtest26of10,pubtest276of100,1,323,7070,30,343,7443
subtest22of10,pubtest276of100,1,323,7070,33,380,7483
subtest22of10,pubtest277of100,1,323,5920,16,40,5976
subtest29of10,pubtest277of100,1,323,5920,17,78,6015
subtest27of10,pubtest277of100,1,323,5920,18,117,6055
subtest21of10,pubtest277of100,1,323,5920,19,156,6095
subtest28of10,pubtest277of100,1,323,5920,20,193,6133
subtest25of10,pubtest277of100,1,323,5920,25,230,6175
subtest23of10,pubtest277of100,1,323,5920,25,269,6214
subtest210of10,pubtest277of100,1,323,5920,27,308,6255
subtest26of10,pubtest277of100,1,323,5920,27,348,6295
subtest24of10,pubtest277of100,1,323,5920,28,387,6335
subtest22of10,pubtest278of100,1,323,5396,11,41,5448
subtest29of10,pubtest278of100,1,323,5396,16,76,5488
subtest23of10,pubtest278of100,1,323,5396,21,110,5527
subtest21of10,pubtest278of100,1,323,5396,22,149,5567
subtest27of10,pubtest278of100,1,323,5396,25,186,5607
subtest25of10,pubtest278of100,1,323,5396,29,222,5647
subtest28of10,pubtest278of100,1,323,5396,36,255,5687
subtest26of10,pubtest278of100,1,323,5396,38,293,5727
subtest210of10,pubtest278of100,1,323,5396,44,327,5767
subtest24of10,pubtest278of100,1,323,5396,44,366,5806
subtest28of10,pubtest279of100,1,323,5453,32,42,5527
subtest25of10,pubtest279of100,1,323,5453,35,78,5566
subtest24of10,pubtest279of100,1,323,5453,38,115,5606
subtest21of10,pubtest279of100,1,323,5453,41,152,5646
subtest29of10,pubtest279of100,1,323,5453,42,191,5686
subtest26of10,pubtest279of100,1,323,5453,45,228,5726
subtest27of10,pubtest279of100,1,323,5453,50,263,5766
subtest22of10,pubtest279of100,1,323,5453,52,301,5806
subtest23of10,pubtest279of100,1,323,5453,58,335,5846
subtest210of10,pubtest279of100,1,323,5453,62,371,5886
subtest27of10,pubtest280of100,1,323,5584,22,38,5644
subtest29of10,pubtest280of100,1,323,5584,26,74,5684
subtest24of10,pubtest280of100,1,323,5584,24,114,5722
subtest23of10,pubtest280of100,1,323,5584,34,146,5764
subtest26of10,pubtest280of100,1,323,5584,33,186,5803
subtest21of10,pubtest280of100,1,323,5584,35,224,5843
subtest25of10,pubtest280of100,1,323,5584,35,264,5883
subtest28of10,pubtest280of100,1,323,5584,41,298,5923
subtest210of10,pubtest280of100,1,323,5584,41,338,5963
subtest22of10,pubtest280of100,1,323,5584,42,377,6003
subtest24of10,pubtest281of100,1,323,5485,10,44,5539
subtest23of10,pubtest281of100,1,323,5485,11,82,5578
subtest28of10,pubtest281of100,1,323,5485,13,120,5618
subtest27of10,pubtest281of100,1,323,5485,19,154,5658
subtest22of10,pubtest281of100,1,323,5485,24,189,5698
subtest21of10,pubtest281of100,1,323,5485,28,223,5736
subtest25of10,pubtest281of100,1,323,5485,28,262,5775
subtest29of10,pubtest281of100,1,323,5485,31,301,5817
subtest210of10,pubtest281of100,1,323,5485,32,341,5858
subtest26of10,pubtest281of100,1,323,5485,31,380,5896
subtest23of10,pubtest282of100,1,323,5456,23,39,5518
subtest24of10,pubtest282of100,1,323,5456,28,73,5557
subtest21of10,pubtest282of100,1,323,5456,34,108,5598
subtest25of10,pubtest282of100,1,323,5456,35,147,5638
subtest22of10,pubtest282of100,1,323,5456,38,184,5678
subtest26of10,pubtest282of100,1,323,5456,39,222,5717
subtest27of10,pubtest282of100,1,323,5456,40,261,5757
subtest29of10,pubtest282of100,1,323,5456,40,301,5797
subtest28of10,pubtest282of100,1,323,5456,103,278,5837
subtest210of10,pubtest282of100,1,323,5456,104,317,5877
subtest24of10,pubtest283of100,1,323,5441,11,43,5495
subtest27of10,pubtest283of100,1,323,5441,17,75,5533
subtest23of10,pubtest283of100,1,323,5441,18,115,5574
subtest22of10,pubtest283of100,1,323,5441,24,148,5613
subtest25of10,pubtest283of100,1,323,5441,26,186,5653
subtest21of10,pubtest283of100,1,323,5441,26,226,5693
subtest26of10,pubtest283of100,1,323,5441,31,261,5733
subtest210of10,pubtest283of100,1,323,5441,31,300,5772
subtest29of10,pubtest283of100,1,323,5441,31,340,5812
subtest28of10,pubtest283of100,1,323,5441,31,379,5851
subtest25of10,pubtest284of100,1,323,5555,17,49,5621
subtest22of10,pubtest284of100,1,323,5555,18,88,5661
subtest24of10,pubtest284of100,1,323,5555,21,124,5700
subtest21of10,pubtest284of100,1,323,5555,24,163,5742
subtest210of10,pubtest284of100,1,323,5555,23,203,5781
subtest23of10,pubtest284of100,1,323,5555,23,240,5818
subtest29of10,pubtest284of100,1,323,5555,25,280,5860
subtest27of10,pubtest284of100,1,323,5555,26,319,5900
subtest26of10,pubtest284of100,1,323,5555,31,354,5940
subtest28of10,pubtest284of100,1,323,5555,31,394,5980
subtest23of10,pubtest285of100,1,323,5423,19,39,5481
subtest24of10,pubtest285of100,1,323,5423,21,77,5521
subtest27of10,pubtest285of100,1,323,5423,22,116,5561
subtest28of10,pubtest285of100,1,323,5423,23,155,5601
subtest21of10,pubtest285of100,1,323,5423,24,194,5641
subtest29of10,pubtest285of100,1,323,5423,25,234,5682
subtest22of10,pubtest285of100,1,323,5423,25,273,5721
subtest26of10,pubtest285of100,1,323,5423,29,309,5761
subtest210of10,pubtest285of100,1,323,5423,28,349,5800
subtest25of10,pubtest285of100,1,323,5423,28,389,5840
subtest23of10,pubtest286of100,1,323,5553,6,39,5598
subtest29of10,pubtest286of100,1,323,5553,7,75,5635
subtest21of10,pubtest286of100,1,323,5553,10,115,5678
subtest27of10,pubtest286of100,1,323,5553,10,156,5719
subtest25of10,pubtest286of100,1,323,5553,12,193,5758
subtest210of10,pubtest286of100,1,323,5553,32,211,5796
subtest24of10,pubtest286of100,1,323,5553,33,251,5837
subtest26of10,pubtest286of100,1,323,5553,34,290,5877
subtest22of10,pubtest286of100,1,323,5553,36,327,5916
subtest28of10,pubtest286of100,1,323,5553,37,367,5957
subtest26of10,pubtest287of100,1,323,5572,37,38,5647
subtest28of10,pubtest287of100,1,323,5572,50,64,5686
subtest29of10,pubtest287of100,1,323,5572,50,104,5726
subtest210of10,pubtest287of100,1,323,5572,52,142,5766
subtest27of10,pubtest287of100,1,323,5572,52,182,5806
subtest21of10,pubtest287of100,1,323,5572,54,220,5846
subtest25of10,pubtest287of100,1,323,5572,57,257,5886
subtest24of10,pubtest287of100,1,323,5572,55,297,5924
subtest23of10,pubtest287of100,1,323,5572,54,340,5966
subtest22of10,pubtest287of100,1,323,5572,59,375,6006
subtest29of10,pubtest288of100,1,323,5394,85,44,5523
subtest27of10,pubtest288of100,1,323,5394,89,79,5562
subtest26of10,pubtest288of100,1,323,5394,86,119,5599
subtest21of10,pubtest288of100,1,323,5394,91,157,5642
subtest25of10,pubtest288of100,1,323,5394,87,203,5684
subtest23of10,pubtest288of100,1,323,5394,92,237,5723
subtest210of10,pubtest288of100,1,323,5394,93,275,5762
subtest22of10,pubtest288of100,1,323,5394,93,315,5802
subtest24of10,pubtest288of100,1,323,5394,96,352,5842
subtest28of10,pubtest288of100,1,323,5394,97,391,5882
subtest29of10,pubtest289of100,1,323,5435,10,40,5485
subtest210of10,pubtest289of100,1,323,5435,11,76,5522
subtest23of10,pubtest289of100,1,323,5435,12,116,5563
subtest25of10,pubtest289of100,1,323,5435,17,151,5603
subtest24of10,pubtest289of100,1,323,5435,18,190,5643
subtest27of10,pubtest289of100,1,323,5435,20,228,5683
subtest21of10,pubtest289of100,1,323,5435,22,266,5723
subtest22of10,pubtest289of100,1,323,5435,27,302,5764
subtest28of10,pubtest289of100,1,323,5435,26,342,5803
subtest26of10,pubtest289of100,1,323,5435,28,380,5843
subtest29of10,pubtest290of100,1,323,5634,14,40,5688
subtest22of10,pubtest290of100,1,323,5634,15,79,5728
subtest23of10,pubtest290of100,1,323,5634,17,115,5766
subtest25of10,pubtest290of100,1,323,5634,19,154,5807
subtest27of10,pubtest290of100,1,323,5634,21,192,5847
subtest26of10,pubtest290of100,1,323,5634,21,233,5888
subtest21of10,pubtest290of100,1,323,5634,21,271,5926
subtest210of10,pubtest290of100,1,323,5634,25,308,5967
subtest28of10,pubtest290of100,1,323,5634,30,343,6007
subtest24of10,pubtest290of100,1,323,5634,34,380,6048
subtest23of10,pubtest291of100,1,323,5651,15,38,5704
subtest24of10,pubtest291of100,1,323,5651,15,77,5743
subtest27of10,pubtest291of100,1,323,5651,21,111,5783
subtest28of10,pubtest291of100,1,323,5651,24,148,5823
subtest21of10,pubtest291of100,1,323,5651,24,188,5863
subtest25of10,pubtest291of100,1,323,5651,26,226,5903
subtest22of10,pubtest291of100,1,323,5651,36,256,5943
subtest29of10,pubtest291of100,1,323,5651,36,296,5983
subtest210of10,pubtest291of100,1,323,5651,33,336,6020
subtest26of10,pubtest291of100,1,323,5651,38,374,6063
subtest28of10,pubtest292of100,1,323,6099,13,42,6154
subtest29of10,pubtest292of100,1,323,6099,14,80,6193
subtest21of10,pubtest292of100,1,323,6099,22,112,6233
subtest25of10,pubtest292of100,1,323,6099,25,148,6272
subtest27of10,pubtest292of100,1,323,6099,26,187,6312
subtest23of10,pubtest292of100,1,323,6099,27,227,6353
subtest26of10,pubtest292of100,1,323,6099,28,268,6395
subtest22of10,pubtest292of100,1,323,6099,32,302,6433
subtest210of10,pubtest292of100,1,323,6099,33,341,6473
subtest24of10,pubtest292of100,1,323,6099,33,380,6512
subtest25of10,pubtest293of100,1,323,6297,24,41,6362
subtest24of10,pubtest293of100,1,323,6297,25,80,6402
subtest28of10,pubtest293of100,1,323,6297,27,118,6442
subtest23of10,pubtest293of100,1,323,6297,30,155,6482
subtest210of10,pubtest293of100,1,323,6297,34,191,6522
subtest26of10,pubtest293of100,1,323,6297,38,227,6562
subtest27of10,pubtest293of100,1,323,6297,38,266,6601
subtest22of10,pubtest293of100,1,323,6297,42,303,6642
subtest29of10,pubtest293of100,1,323,6297,42,343,6682
subtest21of10,pubtest293of100,1,323,6297,39,382,6718
subtest21of10,pubtest294of100,1,323,5685,10,39,5734
subtest25of10,pubtest294of100,1,323,5685,14,74,5773
subtest29of10,pubtest294of100,1,323,5685,16,110,5811
subtest210of10,pubtest294of100,1,323,5685,18,150,5853
subtest26of10,pubtest294of100,1,323,5685,21,187,5893
subtest27of10,pubtest294of100,1,323,5685,21,227,5933
subtest23of10,pubtest294of100,1,323,5685,25,265,5975
subtest24of10,pubtest294of100,1,323,5685,29,300,6014
subtest22of10,pubtest294of100,1,323,5685,33,335,6053
subtest28of10,pubtest294of100,1,323,5685,34,374,6093
subtest25of10,pubtest295of100,1,323,5425,12,38,5475
subtest24of10,pubtest295of100,1,323,5425,13,77,5515
subtest22of10,pubtest295of100,1,323,5425,15,115,5555
subtest23of10,pubtest295of100,1,323,5425,15,154,5594
subtest27of10,pubtest295of100,1,323,5425,23,187,5635
subtest29of10,pubtest295of100,1,323,5425,28,223,5676
subtest210of10,pubtest295of100,1,323,5425,28,262,5715
subtest21of10,pubtest295of100,1,323,5425,29,299,5753
subtest28of10,pubtest295of100,1,323,5425,29,339,5793
subtest26of10,pubtest295of100,1,323,5425,39,371,5835
subtest25of10,pubtest296of100,1,322,5929,12,39,5980
subtest24of10,pubtest296of100,1,322,5929,12,79,6020
subtest27of10,pubtest296of100,1,322,5929,14,115,6058
subtest23of10,pubtest296of100,1,322,5929,21,148,6098
subtest29of10,pubtest296of100,1,322,5929,23,187,6139
subtest21of10,pubtest296of100,1,322,5929,27,224,6180
subtest26of10,pubtest296of100,1,322,5929,29,261,6219
subtest28of10,pubtest296of100,1,322,5929,34,297,6260
subtest210of10,pubtest296of100,1,322,5929,34,336,6299
subtest22of10,pubtest296of100,1,322,5929,39,371,6339
subtest25of10,pubtest297of100,1,323,5249,13,48,5310
subtest210of10,pubtest297of100,1,323,5249,16,85,5350
subtest29of10,pubtest297of100,1,323,5249,14,125,5388
subtest23of10,pubtest297of100,1,323,5249,20,161,5430
subtest22of10,pubtest297of100,1,323,5249,79,141,5469
subtest27of10,pubtest297of100,1,323,5249,79,181,5509
subtest21of10,pubtest297of100,1,323,5249,82,218,5549
subtest26of10,pubtest297of100,1,323,5249,82,258,5589
subtest28of10,pubtest297of100,1,323,5249,86,294,5629
subtest24of10,pubtest297of100,1,323,5249,87,333,5669
subtest22of10,pubtest298of100,1,323,5301,11,38,5350
subtest29of10,pubtest298of100,1,323,5301,11,77,5389
subtest25of10,pubtest298of100,1,323,5301,13,115,5429
subtest24of10,pubtest298of100,1,323,5301,26,142,5469
subtest23of10,pubtest298of100,1,323,5301,26,182,5509
subtest210of10,pubtest298of100,1,323,5301,28,220,5549
subtest21of10,pubtest298of100,1,323,5301,28,260,5589
subtest27of10,pubtest298of100,1,323,5301,35,293,5629
subtest28of10,pubtest298of100,1,323,5301,36,332,5669
subtest26of10,pubtest298of100,1,323,5301,37,372,5710
subtest29of10,pubtest299of100,1,323,5239,48,41,5328
subtest27of10,pubtest299of100,1,323,5239,48,81,5368
subtest23of10,pubtest299of100,1,323,5239,50,118,5407
subtest21of10,pubtest299of100,1,323,5239,50,159,5448
subtest210of10,pubtest299of100,1,323,5239,52,196,5487
subtest28of10,pubtest299of100,1,323,5239,53,235,5527
subtest24of10,pubtest299of100,1,323,5239,53,276,5568
subtest25of10,pubtest299of100,1,323,5239,50,314,5603
subtest22of10,pubtest299of100,1,323,5239,52,354,5645
subtest26of10,pubtest299of100,1,323,5239,58,390,5687
subtest24of10,pubtest2100of100,1,325,5321,14,38,5373
subtest21of10,pubtest2100of100,1,325,5321,13,77,5411
subtest29of10,pubtest2100of100,1,325,5321,16,116,5453
subtest23of10,pubtest2100of100,1,325,5321,18,151,5490
subtest22of10,pubtest2100of100,1,325,5321,22,189,5532
subtest27of10,pubtest2100of100,1,325,5321,24,227,5572
subtest25of10,pubtest2100of100,1,325,5321,24,265,5610
subtest28of10,pubtest2100of100,1,325,5321,27,304,5652
subtest210of10,pubtest2100of100,1,325,5321,29,343,5693
subtest26of10,pubtest2100of100,1,325,5321,31,380,5732
subtest26of10,pubtest21of100,1,322,11250,11,42,11303
subtest29of10,pubtest21of100,1,322,11250,13,80,11343
subtest27of10,pubtest21of100,1,322,11250,12,120,11382
subtest24of10,pubtest21of100,1,322,11250,15,158,11423
subtest25of10,pubtest21of100,1,322,11250,18,195,11463
subtest21of10,pubtest21of100,1,322,11250,28,225,11503
subtest210of10,pubtest21of100,1,322,11250,29,264,11543
subtest28of10,pubtest21of100,1,322,11250,30,303,11583
subtest22of10,pubtest21of100,1,322,11250,36,336,11622
subtest23of10,pubtest21of100,1,322,11250,36,376,11662
subtest29of10,pubtest22of100,1,321,5301,9,40,5350
subtest23of10,pubtest22of100,1,321,5301,18,70,5389
subtest24of10,pubtest22of100,1,321,5301,18,110,5429
subtest25of10,pubtest22of100,1,321,5301,21,146,5468
subtest28of10,pubtest22of100,1,321,5301,22,186,5509
subtest27of10,pubtest22of100,1,321,5301,18,225,5544
subtest21of10,pubtest22of100,1,321,5301,28,260,5589
subtest26of10,pubtest22of100,1,321,5301,28,301,5630
subtest22of10,pubtest22of100,1,321,5301,29,340,5670
subtest210of10,pubtest22of100,1,321,5301,30,378,5709
subtest23of10,pubtest23of100,1,321,5298,21,40,5359
subtest29of10,pubtest23of100,1,321,5298,30,70,5398
subtest28of10,pubtest23of100,1,321,5298,30,110,5438
subtest24of10,pubtest23of100,1,321,5298,32,148,5478
subtest25of10,pubtest23of100,1,321,5298,32,188,5518
subtest27of10,pubtest23of100,1,321,5298,34,226,5558
subtest26of10,pubtest23of100,1,321,5298,34,266,5598
subtest21of10,pubtest23of100,1,321,5298,35,305,5638
subtest22of10,pubtest23of100,1,321,5298,36,342,5676
subtest210of10,pubtest23of100,1,321,5298,39,381,5718
subtest24of10,pubtest24of100,1,321,5303,13,379,5695
subtest23of10,pubtest24of100,1,321,5303,13,416,5732
subtest25of10,pubtest24of100,1,321,5303,19,450,5772
subtest29of10,pubtest24of100,1,321,5303,29,480,5812
subtest21of10,pubtest24of100,1,321,5303,28,520,5851
subtest28of10,pubtest24of100,1,321,5303,30,561,5894
subtest27of10,pubtest24of100,1,321,5303,38,592,5933
subtest210of10,pubtest24of100,1,321,5303,39,630,5972
subtest26of10,pubtest24of100,1,321,5303,40,670,6013
subtest22of10,pubtest24of100,1,321,5303,38,709,6050
subtest21of10,pubtest25of100,1,321,5290,12,41,5343
subtest28of10,pubtest25of100,1,321,5290,13,79,5382
subtest210of10,pubtest25of100,1,321,5290,15,518,5823
subtest27of10,pubtest25of100,1,321,5290,17,554,5861
subtest25of10,pubtest25of100,1,321,5290,18,593,5901
subtest23of10,pubtest25of100,1,321,5290,22,629,5941
subtest29of10,pubtest25of100,1,321,5290,23,668,5981
subtest26of10,pubtest25of100,1,321,5290,26,705,6021
subtest22of10,pubtest25of100,1,321,5290,26,745,6061
subtest24of10,pubtest25of100,1,321,5290,27,784,6101
subtest21of10,pubtest26of100,1,321,5327,9,38,5374
subtest29of10,pubtest26of100,1,321,5327,14,74,5415
subtest22of10,pubtest26of100,1,321,5327,15,110,5452
subtest23of10,pubtest26of100,1,321,5327,17,150,5494
subtest27of10,pubtest26of100,1,321,5327,24,183,5534
subtest26of10,pubtest26of100,1,321,5327,25,224,5576
subtest25of10,pubtest26of100,1,321,5327,26,262,5615
subtest210of10,pubtest26of100,1,321,5327,32,296,5655
subtest28of10,pubtest26of100,1,321,5327,39,328,5694
subtest24of10,pubtest26of100,1,321,5327,40,367,5734
subtest27of10,pubtest27of100,1,320,5623,11,40,5674
subtest28of10,pubtest27of100,1,320,5623,12,79,5714
subtest23of10,pubtest27of100,1,320,5623,14,116,5753
subtest24of10,pubtest27of100,1,320,5623,16,154,5793
subtest29of10,pubtest27of100,1,320,5623,22,188,5833
subtest210of10,pubtest27of100,1,320,5623,27,221,5871
subtest25of10,pubtest27of100,1,320,5623,27,260,5910
subtest21of10,pubtest27of100,1,320,5623,30,300,5953
subtest22of10,pubtest27of100,1,320,5623,31,339,5993
subtest26of10,pubtest27of100,1,320,5623,34,376,6033
subtest27of10,pubtest28of100,1,321,5285,16,41,5342
subtest21of10,pubtest28of100,1,321,5285,17,79,5381
subtest29of10,pubtest28of100,1,321,5285,20,116,5421
subtest28of10,pubtest28of100,1,321,5285,20,156,5461
subtest23of10,pubtest28of100,1,321,5285,22,194,5501
subtest25of10,pubtest28of100,1,321,5285,30,227,5542
subtest210of10,pubtest28of100,1,321,5285,30,266,5581
subtest26of10,pubtest28of100,1,321,5285,33,303,5621
subtest24of10,pubtest28of100,1,321,5285,41,334,5660
subtest22of10,pubtest28of100,1,321,5285,42,374,5701
subtest23of10,pubtest29of100,1,321,5356,13,40,5409
subtest210of10,pubtest29of100,1,321,5356,14,79,5449
subtest22of10,pubtest29of100,1,321,5356,15,117,5488
subtest25of10,pubtest29of100,1,321,5356,16,156,5528
subtest29of10,pubtest29of100,1,321,5356,17,195,5568
subtest28of10,pubtest29of100,1,321,5356,18,234,5608
subtest24of10,pubtest29of100,1,321,5356,21,271,5648
subtest21of10,pubtest29of100,1,321,5356,21,311,5688
subtest26of10,pubtest29of100,1,321,5356,27,345,5728
subtest27of10,pubtest29of100,1,321,5356,27,385,5768
subtest29of10,pubtest210of100,1,323,5343,7,45,5395
subtest21of10,pubtest210of100,1,323,5343,9,84,5436
subtest27of10,pubtest210of100,1,323,5343,10,123,5476
subtest210of10,pubtest210of100,1,323,5343,10,162,5515
subtest23of10,pubtest210of100,1,323,5343,12,201,5556
subtest25of10,pubtest210of100,1,323,5343,22,231,5596
subtest28of10,pubtest210of100,1,323,5343,23,270,5636
subtest24of10,pubtest210of100,1,323,5343,24,309,5676
subtest22of10,pubtest210of100,1,323,5343,24,349,5716
subtest26of10,pubtest210of100,1,323,5343,27,384,5754
subtest210of10,pubtest211of100,1,323,5252,18,39,5309
subtest24of10,pubtest211of100,1,323,5252,19,77,5348
subtest29of10,pubtest211of100,1,323,5252,20,116,5388
subtest21of10,pubtest211of100,1,323,5252,22,154,5428
subtest22of10,pubtest211of100,1,323,5252,21,194,5467
subtest25of10,pubtest211of100,1,323,5252,23,231,5506
subtest23of10,pubtest211of100,1,323,5252,25,271,5548
subtest26of10,pubtest211of100,1,323,5252,23,310,5585
subtest27of10,pubtest211of100,1,323,5252,30,346,5628
subtest28of10,pubtest211of100,1,323,5252,36,380,5668
subtest25of10,pubtest212of100,1,323,5317,7,281,5605
subtest29of10,pubtest212of100,1,323,5317,12,315,5644
subtest28of10,pubtest212of100,1,323,5317,13,353,5683
subtest23of10,pubtest212of100,1,323,5317,19,387,5723
subtest24of10,pubtest212of100,1,323,5317,19,427,5763
subtest27of10,pubtest212of100,1,323,5317,24,462,5803
subtest22of10,pubtest212of100,1,323,5317,24,502,5843
subtest21of10,pubtest212of100,1,323,5317,84,481,5882
subtest26of10,pubtest212of100,1,323,5317,85,521,5923
subtest210of10,pubtest212of100,1,323,5317,86,560,5963
subtest23of10,pubtest213of100,1,322,6301,16,39,6356
subtest26of10,pubtest213of100,1,322,6301,17,78,6396
subtest22of10,pubtest213of100,1,322,6301,19,115,6435
subtest29of10,pubtest213of100,1,322,6301,19,155,6475
subtest27of10,pubtest213of100,1,322,6301,21,191,6513
subtest25of10,pubtest213of100,1,322,6301,24,230,6555
subtest21of10,pubtest213of100,1,322,6301,24,270,6595
subtest210of10,pubtest213of100,1,322,6301,25,309,6635
subtest24of10,pubtest213of100,1,322,6301,25,349,6675
subtest28of10,pubtest213of100,1,322,6301,32,383,6716
subtest21of10,pubtest214of100,1,323,6231,6,41,6278
subtest23of10,pubtest214of100,1,323,6231,10,76,6317
subtest26of10,pubtest214of100,1,323,6231,11,115,6357
subtest25of10,pubtest214of100,1,323,6231,34,132,6397
subtest27of10,pubtest214of100,1,323,6231,35,171,6437
subtest22of10,pubtest214of100,1,323,6231,36,210,6477
subtest29of10,pubtest214of100,1,323,6231,37,249,6517
subtest24of10,pubtest214of100,1,323,6231,38,288,6557
subtest210of10,pubtest214of100,1,323,6231,38,325,6594
subtest28of10,pubtest214of100,1,323,6231,41,365,6637
subtest27of10,pubtest215of100,1,323,5561,10,42,5613
subtest24of10,pubtest215of100,1,323,5561,14,77,5652
subtest26of10,pubtest215of100,1,323,5561,18,113,5692
subtest29of10,pubtest215of100,1,323,5561,16,153,5730
subtest25of10,pubtest215of100,1,323,5561,18,192,5771
subtest21of10,pubtest215of100,1,323,5561,16,232,5809
subtest210of10,pubtest215of100,1,323,5561,21,270,5852
subtest23of10,pubtest215of100,1,323,5561,23,308,5892
subtest22of10,pubtest215of100,1,323,5561,23,348,5932
subtest28of10,pubtest215of100,1,323,5561,36,375,5972
subtest24of10,pubtest216of100,1,323,5383,11,45,5439
subtest21of10,pubtest216of100,1,323,5383,11,84,5478
subtest23of10,pubtest216of100,1,323,5383,13,122,5518
subtest25of10,pubtest216of100,1,323,5383,14,161,5558
subtest27of10,pubtest216of100,1,323,5383,13,201,5597
subtest28of10,pubtest216of100,1,323,5383,15,240,5638
subtest29of10,pubtest216of100,1,323,5383,18,276,5677
subtest22of10,pubtest216of100,1,323,5383,20,315,5718
subtest210of10,pubtest216of100,1,323,5383,21,354,5758
subtest26of10,pubtest216of100,1,323,5383,22,393,5798
subtest22of10,pubtest217of100,1,322,5624,13,40,5677
subtest23of10,pubtest217of100,1,322,5624,16,77,5717
subtest24of10,pubtest217of100,1,322,5624,16,117,5757
subtest25of10,pubtest217of100,1,322,5624,19,156,5799
subtest29of10,pubtest217of100,1,322,5624,18,195,5837
subtest26of10,pubtest217of100,1,322,5624,17,235,5876
subtest21of10,pubtest217of100,1,322,5624,20,274,5918
subtest27of10,pubtest217of100,1,322,5624,14,314,5952
subtest28of10,pubtest217of100,1,322,5624,22,352,5998
subtest210of10,pubtest217of100,1,322,5624,22,391,6037
subtest29of10,pubtest218of100,1,323,7650,11,43,7704
subtest21of10,pubtest218of100,1,323,7650,12,81,7743
subtest22of10,pubtest218of100,1,323,7650,13,120,7783
subtest28of10,pubtest218of100,1,323,7650,14,159,7823
subtest27of10,pubtest218of100,1,323,7650,14,199,7863
subtest25of10,pubtest218of100,1,323,7650,18,235,7903
subtest24of10,pubtest218of100,1,323,7650,18,275,7943
subtest23of10,pubtest218of100,1,323,7650,18,314,7982
subtest210of10,pubtest218of100,1,323,7650,20,353,8023
subtest26of10,pubtest218of100,1,323,7650,21,394,8065
subtest210of10,pubtest219of100,1,323,6001,6,46,6053
subtest25of10,pubtest219of100,1,323,6001,10,81,6092
subtest26of10,pubtest219of100,1,323,6001,11,120,6132
subtest22of10,pubtest219of100,1,323,6001,13,158,6172
subtest29of10,pubtest219of100,1,323,6001,13,198,6212
subtest24of10,pubtest219of100,1,323,6001,15,237,6253
subtest21of10,pubtest219of100,1,323,6001,14,277,6292
subtest27of10,pubtest219of100,1,323,6001,21,308,6330
subtest23of10,pubtest219of100,1,323,6001,21,348,6370
subtest28of10,pubtest219of100,1,323,6001,24,387,6412
subtest25of10,pubtest220of100,1,323,5353,10,39,5402
subtest210of10,pubtest220of100,1,323,5353,11,78,5442
subtest23of10,pubtest220of100,1,323,5353,17,111,5481
subtest29of10,pubtest220of100,1,323,5353,18,148,5519
subtest21of10,pubtest220of100,1,323,5353,20,190,5563
subtest24of10,pubtest220of100,1,323,5353,21,228,5602
subtest27of10,pubtest220of100,1,323,5353,53,235,5641
subtest28of10,pubtest220of100,1,323,5353,54,274,5681
subtest22of10,pubtest220of100,1,323,5353,55,313,5721
subtest26of10,pubtest220of100,1,323,5353,56,352,5761
subtest24of10,pubtest221of100,1,323,5590,23,39,5652
subtest21of10,pubtest221of100,1,323,5590,25,77,5692
subtest23of10,pubtest221of100,1,323,5590,26,115,5731
subtest28of10,pubtest221of100,1,323,5590,25,156,5771
subtest22of10,pubtest221of100,1,323,5590,31,190,5811
subtest25of10,pubtest221of100,1,323,5590,39,222,5851
subtest210of10,pubtest221of100,1,323,5590,43,258,5891
subtest29of10,pubtest221of100,1,323,5590,45,296,5931
subtest27of10,pubtest221of100,1,323,5590,47,334,5971
subtest26of10,pubtest221of100,1,323,5590,49,372,6011
subtest23of10,pubtest222of100,1,323,5501,11,40,5552
subtest22of10,pubtest222of100,1,323,5501,8,83,5592
subtest27of10,pubtest222of100,1,323,5501,10,121,5632
subtest29of10,pubtest222of100,1,323,5501,11,159,5671
subtest21of10,pubtest222of100,1,323,5501,7,198,5706
subtest28of10,pubtest222of100,1,323,5501,13,237,5751
subtest25of10,pubtest222of100,1,323,5501,18,272,5791
subtest210of10,pubtest222of100,1,323,5501,18,312,5831
subtest26of10,pubtest222of100,1,323,5501,28,342,5871
subtest24of10,pubtest222of100,1,323,5501,31,379,5911
subtest21of10,pubtest223of100,1,323,6363,9,41,6413
subtest23of10,pubtest223of100,1,323,6363,29,61,6453
subtest29of10,pubtest223of100,1,323,6363,30,100,6493
subtest28of10,pubtest223of100,1,323,6363,31,139,6533
subtest24of10,pubtest223of100,1,323,6363,32,177,6572
subtest27of10,pubtest223of100,1,323,6363,31,216,6610
subtest210of10,pubtest223of100,1,323,6363,35,254,6652
subtest22of10,pubtest223of100,1,323,6363,36,294,6693
subtest26of10,pubtest223of100,1,323,6363,37,333,6733
subtest25of10,pubtest223of100,1,323,6363,37,374,6774
subtest21of10,pubtest224of100,1,323,7009,9,41,7059
subtest28of10,pubtest224of100,1,323,7009,17,72,7098
subtest23of10,pubtest224of100,1,323,7009,20,109,7138
subtest27of10,pubtest224of100,1,323,7009,20,148,7177
subtest29of10,pubtest224of100,1,323,7009,21,188,7218
subtest26of10,pubtest224of100,1,323,7009,25,224,7258
subtest25of10,pubtest224of100,1,323,7009,25,264,7298
subtest24of10,pubtest224of100,1,323,7009,27,302,7338
subtest22of10,pubtest224of100,1,323,7009,27,342,7378
subtest210of10,pubtest224of100,1,323,7009,30,379,7418
subtest27of10,pubtest225of100,1,323,6041,13,38,6092
subtest22of10,pubtest225of100,1,323,6041,14,71,6126
subtest210of10,pubtest225of100,1,323,6041,19,111,6171
subtest29of10,pubtest225of100,1,323,6041,19,150,6210
subtest28of10,pubtest225of100,1,323,6041,21,191,6253
subtest26of10,pubtest225of100,1,323,6041,16,230,6287
subtest21of10,pubtest225of100,1,323,6041,14,268,6323
subtest23of10,pubtest225of100,1,323,6041,22,308,6371
subtest25of10,pubtest225of100,1,323,6041,21,348,6410
subtest24of10,pubtest225of100,1,323,6041,23,387,6451
subtest25of10,pubtest226of100,1,323,5589,7,41,5637
subtest22of10,pubtest226of100,1,323,5589,8,80,5677
subtest23of10,pubtest226of100,1,323,5589,9,119,5717
subtest210of10,pubtest226of100,1,323,5589,10,159,5758
subtest28of10,pubtest226of100,1,323,5589,12,196,5797
subtest27of10,pubtest226of100,1,323,5589,13,235,5837
subtest29of10,pubtest226of100,1,323,5589,16,272,5877
subtest21of10,pubtest226of100,1,323,5589,16,312,5917
subtest26of10,pubtest226of100,1,323,5589,16,351,5956
subtest24of10,pubtest226of100,1,323,5589,19,389,5997
subtest29of10,pubtest227of100,1,323,6195,13,42,6250
subtest210of10,pubtest227of100,1,323,6195,14,81,6290
subtest25of10,pubtest227of100,1,323,6195,16,119,6330
subtest23of10,pubtest227of100,1,323,6195,33,142,6370
subtest24of10,pubtest227of100,1,323,6195,34,181,6410
subtest26of10,pubtest227of100,1,323,6195,35,220,6450
subtest21of10,pubtest227of100,1,323,6195,35,260,6490
subtest27of10,pubtest227of100,1,323,6195,36,299,6530
subtest22of10,pubtest227of100,1,323,6195,37,338,6570
subtest28of10,pubtest227of100,1,323,6195,39,375,6609
subtest21of10,pubtest228of100,1,323,6283,11,38,6332
subtest25of10,pubtest228of100,1,323,6283,14,74,6371
subtest26of10,pubtest228of100,1,323,6283,17,111,6411
subtest23of10,pubtest228of100,1,323,6283,19,149,6451
subtest27of10,pubtest228of100,1,323,6283,38,170,6491
subtest29of10,pubtest228of100,1,323,6283,39,209,6531
subtest24of10,pubtest228of100,1,323,6283,40,248,6571
subtest210of10,pubtest228of100,1,323,6283,43,285,6611
subtest22of10,pubtest228of100,1,323,6283,44,324,6651
subtest28of10,pubtest228of100,1,323,6283,45,363,6691
subtest24of10,pubtest229of100,1,321,6813,11,40,6864
subtest28of10,pubtest229of100,1,321,6813,17,73,6903
subtest27of10,pubtest229of100,1,321,6813,24,106,6943
subtest21of10,pubtest229of100,1,321,6813,24,145,6982
subtest22of10,pubtest229of100,1,321,6813,26,184,7023
subtest25of10,pubtest229of100,1,321,6813,29,221,7063
subtest210of10,pubtest229of100,1,321,6813,29,261,7103
subtest23of10,pubtest229of100,1,321,6813,30,300,7143
subtest26of10,pubtest229of100,1,321,6813,32,338,7183
subtest29of10,pubtest229of100,1,321,6813,32,380,7225
subtest22of10,pubtest230of100,1,323,5830,9,40,5879
subtest21of10,pubtest230of100,1,323,5830,14,74,5918
subtest27of10,pubtest230of100,1,323,5830,15,113,5958
subtest28of10,pubtest230of100,1,323,5830,16,152,5998
subtest29of10,pubtest230of100,1,323,5830,16,192,6038
subtest25of10,pubtest230of100,1,323,5830,18,230,6078
subtest23of10,pubtest230of100,1,323,5830,23,265,6118
subtest210of10,pubtest230of100,1,323,5830,28,300,6158
subtest24of10,pubtest230of100,1,323,5830,31,335,6196
subtest26of10,pubtest230of100,1,323,5830,34,374,6238
subtest23of10,pubtest231of100,1,323,5807,9,42,5858
subtest28of10,pubtest231of100,1,323,5807,16,74,5897
subtest210of10,pubtest231of100,1,323,5807,22,108,5937
subtest27of10,pubtest231of100,1,323,5807,24,146,5977
subtest26of10,pubtest231of100,1,323,5807,24,186,6017
subtest22of10,pubtest231of100,1,323,5807,25,226,6058
subtest29of10,pubtest231of100,1,323,5807,25,265,6097
subtest25of10,pubtest231of100,1,323,5807,19,305,6131
subtest24of10,pubtest231of100,1,323,5807,22,344,6173
subtest21of10,pubtest231of100,1,323,5807,27,383,6217
subtest23of10,pubtest232of100,1,323,5533,19,196,5748
subtest24of10,pubtest232of100,1,323,5533,21,237,5791
subtest210of10,pubtest232of100,1,323,5533,21,276,5830
subtest21of10,pubtest232of100,1,323,5533,15,323,5871
subtest28of10,pubtest232of100,1,323,5533,19,357,5909
subtest26of10,pubtest232of100,1,323,5533,18,398,5949
subtest25of10,pubtest232of100,1,323,5533,17,441,5991
subtest27of10,pubtest232of100,1,323,5533,17,481,6031
subtest29of10,pubtest232of100,1,323,5533,16,522,6071
subtest22of10,pubtest232of100,1,323,5533,15,563,6111
subtest29of10,pubtest233of100,1,323,6028,12,40,6080
subtest24of10,pubtest233of100,1,323,6028,12,79,6119
subtest210of10,pubtest233of100,1,323,6028,13,117,6158
subtest25of10,pubtest233of100,1,323,6028,14,157,6199
subtest27of10,pubtest233of100,1,323,6028,21,190,6239
subtest23of10,pubtest233of100,1,323,6028,26,225,6279
subtest21of10,pubtest233of100,1,323,6028,27,265,6320
subtest26of10,pubtest233of100,1,323,6028,26,304,6358
subtest22of10,pubtest233of100,1,323,6028,29,341,6398
subtest28of10,pubtest233of100,1,323,6028,28,381,6437
subtest25of10,pubtest234of100,1,323,5389,13,40,5442
subtest26of10,pubtest234of100,1,323,5389,13,79,5481
subtest27of10,pubtest234of100,1,323,5389,17,115,5521
subtest22of10,pubtest234of100,1,323,5389,20,152,5561
subtest21of10,pubtest234of100,1,323,5389,20,193,5602
subtest29of10,pubtest234of100,1,323,5389,20,231,5640
subtest210of10,pubtest234of100,1,323,5389,26,266,5681
subtest23of10,pubtest234of100,1,323,5389,26,305,5720
subtest28of10,pubtest234of100,1,323,5389,28,344,5761
subtest24of10,pubtest234of100,1,323,5389,28,384,5801
subtest210of10,pubtest235of100,1,321,7453,14,42,7509
subtest21of10,pubtest235of100,1,321,7453,14,81,7548
subtest23of10,pubtest235of100,1,321,7453,16,119,7588
subtest22of10,pubtest235of100,1,321,7453,42,133,7628
subtest27of10,pubtest235of100,1,321,7453,44,169,7666
subtest29of10,pubtest235of100,1,321,7453,47,208,7708
subtest28of10,pubtest235of100,1,321,7453,47,248,7748
subtest25of10,pubtest235of100,1,321,7453,49,286,7788
subtest26of10,pubtest235of100,1,321,7453,49,326,7828
subtest24of10,pubtest235of100,1,321,7453,44,371,7868
subtest23of10,pubtest236of100,1,323,7474,13,40,7527
subtest210of10,pubtest236of100,1,323,7474,12,79,7565
subtest27of10,pubtest236of100,1,323,7474,14,118,7606
subtest25of10,pubtest236of100,1,323,7474,16,156,7646
subtest21of10,pubtest236of100,1,323,7474,16,196,7686
subtest28of10,pubtest236of100,1,323,7474,17,235,7726
subtest24of10,pubtest236of100,1,323,7474,21,271,7766
subtest29of10,pubtest236of100,1,323,7474,21,311,7806
subtest26of10,pubtest236of100,1,323,7474,22,348,7844
subtest22of10,pubtest236of100,1,323,7474,23,388,7885
subtest24of10,pubtest237of100,1,323,5671,13,47,5731
subtest23of10,pubtest237of100,1,323,5671,14,86,5771
subtest22of10,pubtest237of100,1,323,5671,19,120,5810
subtest28of10,pubtest237of100,1,323,5671,20,159,5850
subtest27of10,pubtest237of100,1,323,5671,21,198,5890
subtest21of10,pubtest237of100,1,323,5671,22,237,5930
subtest25of10,pubtest237of100,1,323,5671,16,277,5964
subtest210of10,pubtest237of100,1,323,5671,23,316,6010
subtest26of10,pubtest237of100,1,323,5671,23,356,6050
subtest29of10,pubtest237of100,1,323,5671,25,394,6090
subtest29of10,pubtest238of100,1,323,6762,11,46,6819
subtest22of10,pubtest238of100,1,323,6762,12,85,6859
subtest27of10,pubtest238of100,1,323,6762,18,119,6899
subtest28of10,pubtest238of100,1,323,6762,22,155,6939
subtest25of10,pubtest238of100,1,323,6762,24,193,6979
subtest210of10,pubtest238of100,1,323,6762,29,228,7019
subtest23of10,pubtest238of100,1,323,6762,34,263,7059
subtest21of10,pubtest238of100,1,323,6762,35,302,7099
subtest26of10,pubtest238of100,1,323,6762,37,340,7139
subtest24of10,pubtest238of100,1,323,6762,42,375,7179
subtest21of10,pubtest239of100,1,323,6155,10,40,6205
subtest28of10,pubtest239of100,1,323,6155,11,79,6245
subtest27of10,pubtest239of100,1,323,6155,41,87,6283
subtest26of10,pubtest239of100,1,323,6155,43,126,6324
subtest25of10,pubtest239of100,1,323,6155,44,165,6364
subtest24of10,pubtest239of100,1,323,6155,46,203,6404
subtest29of10,pubtest239of100,1,323,6155,50,238,6443
subtest22of10,pubtest239of100,1,323,6155,54,275,6484
subtest23of10,pubtest239of100,1,323,6155,54,315,6524
subtest210of10,pubtest239of100,1,323,6155,61,348,6564
subtest25of10,pubtest240of100,1,323,5729,10,40,5779
subtest210of10,pubtest240of100,1,323,5729,12,77,5818
subtest21of10,pubtest240of100,1,323,5729,12,117,5858
subtest29of10,pubtest240of100,1,323,5729,15,154,5898
subtest27of10,pubtest240of100,1,323,5729,20,191,5940
subtest28of10,pubtest240of100,1,323,5729,20,230,5979
subtest24of10,pubtest240of100,1,323,5729,22,267,6018
subtest22of10,pubtest240of100,1,323,5729,22,307,6058
subtest23of10,pubtest240of100,1,323,5729,21,346,6096
subtest26of10,pubtest240of100,1,323,5729,28,381,6138
subtest24of10,pubtest241of100,1,323,6292,12,42,6346
subtest23of10,pubtest241of100,1,323,6292,11,82,6385
subtest27of10,pubtest241of100,1,323,6292,18,114,6424
subtest21of10,pubtest241of100,1,323,6292,20,152,6464
subtest210of10,pubtest241of100,1,323,6292,45,167,6504
subtest29of10,pubtest241of100,1,323,6292,46,205,6543
subtest28of10,pubtest241of100,1,323,6292,47,245,6584
subtest25of10,pubtest241of100,1,323,6292,48,284,6624
subtest26of10,pubtest241of100,1,323,6292,48,324,6664
subtest22of10,pubtest241of100,1,323,6292,53,359,6704
subtest27of10,pubtest242of100,1,323,5526,9,99,5634
subtest23of10,pubtest242of100,1,323,5526,12,134,5672
subtest26of10,pubtest242of100,1,323,5526,12,174,5712
subtest25of10,pubtest242of100,1,323,5526,13,213,5752
subtest29of10,pubtest242of100,1,323,5526,13,253,5792
subtest21of10,pubtest242of100,1,323,5526,16,290,5832
subtest210of10,pubtest242of100,1,323,5526,21,325,5872
subtest22of10,pubtest242of100,1,323,5526,21,363,5910
subtest24of10,pubtest242of100,1,323,5526,24,402,5952
subtest28of10,pubtest242of100,1,323,5526,25,441,5992
subtest29of10,pubtest243of100,1,323,5342,15,39,5396
subtest28of10,pubtest243of100,1,323,5342,15,78,5435
subtest22of10,pubtest243of100,1,323,5342,16,116,5474
subtest23of10,pubtest243of100,1,323,5342,17,156,5515
subtest25of10,pubtest243of100,1,323,5342,18,193,5553
subtest21of10,pubtest243of100,1,323,5342,21,232,5595
subtest27of10,pubtest243of100,1,323,5342,22,271,5635
subtest26of10,pubtest243of100,1,323,5342,18,311,5671
subtest24of10,pubtest243of100,1,323,5342,41,332,5715
subtest210of10,pubtest243of100,1,323,5342,42,371,5755
subtest26of10,pubtest244of100,1,323,5373,14,41,5428
subtest27of10,pubtest244of100,1,323,5373,15,80,5468
subtest29of10,pubtest244of100,1,323,5373,21,114,5508
subtest25of10,pubtest244of100,1,323,5373,19,154,5546
subtest28of10,pubtest244of100,1,323,5373,23,192,5588
subtest21of10,pubtest244of100,1,323,5373,23,232,5628
subtest23of10,pubtest244of100,1,323,5373,24,271,5668
subtest210of10,pubtest244of100,1,323,5373,25,310,5708
subtest22of10,pubtest244of100,1,323,5373,27,348,5748
subtest24of10,pubtest244of100,1,323,5373,48,367,5788
subtest29of10,pubtest245of100,1,322,5361,12,48,5421
subtest26of10,pubtest245of100,1,322,5361,14,87,5462
subtest23of10,pubtest245of100,1,322,5361,15,126,5502
subtest22of10,pubtest245of100,1,322,5361,17,164,5542
subtest24of10,pubtest245of100,1,322,5361,18,204,5583
subtest25of10,pubtest245of100,1,322,5361,20,243,5624
subtest28of10,pubtest245of100,1,322,5361,22,279,5662
subtest210of10,pubtest245of100,1,322,5361,23,319,5703
subtest27of10,pubtest245of100,1,322,5361,24,357,5742
subtest21of10,pubtest245of100,1,322,5361,24,397,5782
subtest26of10,pubtest246of100,1,323,5262,12,42,5316
subtest27of10,pubtest246of100,1,323,5262,16,77,5355
subtest21of10,pubtest246of100,1,323,5262,17,115,5394
subtest29of10,pubtest246of100,1,323,5262,18,154,5434
subtest28of10,pubtest246of100,1,323,5262,20,192,5474
subtest25of10,pubtest246of100,1,323,5262,22,230,5514
subtest210of10,pubtest246of100,1,323,5262,22,270,5554
subtest23of10,pubtest246of100,1,323,5262,21,310,5593
subtest24of10,pubtest246of100,1,323,5262,24,349,5635
subtest22of10,pubtest246of100,1,323,5262,24,388,5674
subtest23of10,pubtest247of100,1,323,5355,11,121,5487
subtest21of10,pubtest247of100,1,323,5355,14,153,5522
subtest22of10,pubtest247of100,1,323,5355,15,192,5562
subtest26of10,pubtest247of100,1,323,5355,14,232,5601
subtest29of10,pubtest247of100,1,323,5355,20,267,5642
subtest25of10,pubtest247of100,1,323,5355,25,302,5682
subtest27of10,pubtest247of100,1,323,5355,10,357,5722
subtest210of10,pubtest247of100,1,323,5355,132,275,5762
subtest24of10,pubtest247of100,1,323,5355,133,314,5802
subtest28of10,pubtest247of100,1,323,5355,26,353,5734
subtest29of10,pubtest248of100,1,323,5325,11,41,5377
subtest26of10,pubtest248of100,1,323,5325,12,79,5416
subtest25of10,pubtest248of100,1,323,5325,13,117,5455
subtest28of10,pubtest248of100,1,323,5325,14,156,5495
subtest27of10,pubtest248of100,1,323,5325,15,195,5535
subtest23of10,pubtest248of100,1,323,5325,15,233,5573
subtest21of10,pubtest248of100,1,323,5325,18,273,5616
subtest24of10,pubtest248of100,1,323,5325,19,311,5655
subtest22of10,pubtest248of100,1,323,5325,20,350,5695
subtest210of10,pubtest248of100,1,323,5325,21,389,5735
subtest27of10,pubtest249of100,1,323,5411,12,39,5462
subtest28of10,pubtest249of100,1,323,5411,15,76,5502
subtest25of10,pubtest249of100,1,323,5411,18,112,5541
subtest24of10,pubtest249of100,1,323,5411,20,148,5579
subtest21of10,pubtest249of100,1,323,5411,21,188,5620
subtest29of10,pubtest249of100,1,323,5411,23,227,5661
subtest26of10,pubtest249of100,1,323,5411,23,267,5701
subtest23of10,pubtest249of100,1,323,5411,25,305,5741
subtest210of10,pubtest249of100,1,323,5411,67,305,5783
subtest22of10,pubtest249of100,1,323,5411,66,344,5821
subtest28of10,pubtest250of100,1,323,5576,11,46,5633
subtest29of10,pubtest250of100,1,323,5576,13,84,5673
subtest23of10,pubtest250of100,1,323,5576,13,122,5711
subtest27of10,pubtest250of100,1,323,5576,10,164,5750
subtest21of10,pubtest250of100,1,323,5576,14,202,5792
subtest24of10,pubtest250of100,1,323,5576,16,241,5833
subtest25of10,pubtest250of100,1,323,5576,16,281,5873
subtest26of10,pubtest250of100,1,323,5576,18,321,5915
subtest210of10,pubtest250of100,1,323,5576,18,359,5953
subtest22of10,pubtest250of100,1,323,5576,19,398,5993
subtest23of10,pubtest251of100,1,323,5375,17,40,5432
subtest22of10,pubtest251of100,1,323,5375,18,78,5471
subtest24of10,pubtest251of100,1,323,5375,19,118,5512
subtest27of10,pubtest251of100,1,323,5375,20,156,5551
subtest25of10,pubtest251of100,1,323,5375,20,196,5591
subtest28of10,pubtest251of100,1,323,5375,22,235,5632
subtest21of10,pubtest251of100,1,323,5375,22,274,5671
subtest29of10,pubtest251of100,1,323,5375,24,314,5713
subtest210of10,pubtest251of100,1,323,5375,24,353,5752
subtest26of10,pubtest251of100,1,323,5375,26,390,5791
subtest29of10,pubtest252of100,1,323,5612,11,39,5662
subtest28of10,pubtest252of100,1,323,5612,11,78,5701
subtest21of10,pubtest252of100,1,323,5612,13,116,5741
subtest27of10,pubtest252of100,1,323,5612,15,154,5781
subtest26of10,pubtest252of100,1,323,5612,15,194,5821
subtest25of10,pubtest252of100,1,323,5612,17,232,5861
subtest23of10,pubtest252of100,1,323,5612,18,270,5900
subtest22of10,pubtest252of100,1,323,5612,18,309,5939
subtest24of10,pubtest252of100,1,323,5612,21,347,5980
subtest210of10,pubtest252of100,1,323,5612,25,384,6021
subtest28of10,pubtest253of100,1,322,5668,10,38,5716
subtest23of10,pubtest253of100,1,322,5668,11,75,5754
subtest25of10,pubtest253of100,1,322,5668,13,114,5795
subtest24of10,pubtest253of100,1,322,5668,15,152,5835
subtest22of10,pubtest253of100,1,322,5668,23,184,5875
subtest29of10,pubtest253of100,1,322,5668,23,224,5915
subtest27of10,pubtest253of100,1,322,5668,24,261,5953
subtest210of10,pubtest253of100,1,322,5668,26,301,5995
subtest21of10,pubtest253of100,1,322,5668,45,322,6035
subtest26of10,pubtest253of100,1,322,5668,46,361,6075
subtest210of10,pubtest254of100,1,323,5979,11,50,6040
subtest27of10,pubtest254of100,1,323,5979,12,89,6080
subtest28of10,pubtest254of100,1,323,5979,13,123,6115
subtest24of10,pubtest254of100,1,323,5979,18,162,6159
subtest29of10,pubtest254of100,1,323,5979,19,200,6198
subtest22of10,pubtest254of100,1,323,5979,20,240,6239
subtest21of10,pubtest254of100,1,323,5979,21,279,6279
subtest26of10,pubtest254of100,1,323,5979,22,318,6319
subtest25of10,pubtest254of100,1,323,5979,15,365,6359
subtest23of10,pubtest254of100,1,323,5979,23,397,6399
subtest22of10,pubtest255of100,1,322,5403,12,39,5454
subtest23of10,pubtest255of100,1,322,5403,13,76,5492
subtest27of10,pubtest255of100,1,322,5403,15,116,5534
subtest29of10,pubtest255of100,1,322,5403,21,150,5574
subtest28of10,pubtest255of100,1,322,5403,21,190,5614
subtest21of10,pubtest255of100,1,322,5403,22,229,5654
subtest24of10,pubtest255of100,1,322,5403,24,268,5695
subtest25of10,pubtest255of100,1,322,5403,24,307,5734
subtest210of10,pubtest255of100,1,322,5403,26,345,5774
subtest26of10,pubtest255of100,1,322,5403,26,385,5814
subtest29of10,pubtest256of100,1,323,5343,11,39,5393
subtest26of10,pubtest256of100,1,323,5343,13,77,5433
subtest21of10,pubtest256of100,1,323,5343,19,110,5472
subtest27of10,pubtest256of100,1,323,5343,21,148,5512
subtest25of10,pubtest256of100,1,323,5343,21,188,5552
subtest23of10,pubtest256of100,1,323,5343,20,227,5590
subtest210of10,pubtest256of100,1,323,5343,23,266,5632
subtest28of10,pubtest256of100,1,323,5343,24,305,5672
subtest22of10,pubtest256of100,1,323,5343,30,339,5712
subtest24of10,pubtest256of100,1,323,5343,30,379,5752
subtest21of10,pubtest257of100,1,323,5374,31,41,5446
subtest24of10,pubtest257of100,1,323,5374,36,75,5485
subtest23of10,pubtest257of100,1,323,5374,38,113,5525
subtest27of10,pubtest257of100,1,323,5374,37,153,5564
subtest22of10,pubtest257of100,1,323,5374,40,191,5605
subtest29of10,pubtest257of100,1,323,5374,40,231,5645
subtest25of10,pubtest257of100,1,323,5374,39,270,5683
subtest28of10,pubtest257of100,1,323,5374,40,310,5724
subtest210of10,pubtest257of100,1,323,5374,45,346,5765
subtest26of10,pubtest257of100,1,323,5374,49,382,5805
subtest23of10,pubtest258of100,1,323,6537,13,41,6591
subtest28of10,pubtest258of100,1,323,6537,13,80,6630
subtest26of10,pubtest258of100,1,323,6537,16,117,6670
subtest25of10,pubtest258of100,1,323,6537,41,132,6710
subtest21of10,pubtest258of100,1,323,6537,46,166,6749
subtest29of10,pubtest258of100,1,323,6537,49,204,6790
subtest27of10,pubtest258of100,1,323,6537,50,243,6830
subtest210of10,pubtest258of100,1,323,6537,51,282,6870
subtest22of10,pubtest258of100,1,323,6537,52,321,6910
subtest24of10,pubtest258of100,1,323,6537,52,361,6950
subtest21of10,pubtest259of100,1,323,5493,13,41,5547
subtest28of10,pubtest259of100,1,323,5493,15,79,5587
subtest25of10,pubtest259of100,1,323,5493,17,115,5625
subtest24of10,pubtest259of100,1,323,5493,18,155,5666
subtest27of10,pubtest259of100,1,323,5493,19,194,5706
subtest26of10,pubtest259of100,1,323,5493,32,221,5746
subtest29of10,pubtest259of100,1,323,5493,32,261,5786
subtest23of10,pubtest259of100,1,323,5493,32,300,5825
subtest22of10,pubtest259of100,1,323,5493,33,341,5867
subtest210of10,pubtest259of100,1,323,5493,35,379,5907
subtest210of10,pubtest260of100,1,323,6036,10,44,6090
subtest23of10,pubtest260of100,1,323,6036,11,83,6130
subtest26of10,pubtest260of100,1,323,6036,13,123,6172
subtest21of10,pubtest260of100,1,323,6036,14,161,6211
subtest27of10,pubtest260of100,1,323,6036,16,198,6250
subtest22of10,pubtest260of100,1,323,6036,18,236,6290
subtest29of10,pubtest260of100,1,323,6036,18,276,6330
subtest25of10,pubtest260of100,1,323,6036,23,311,6370
subtest28of10,pubtest260of100,1,323,6036,26,348,6410
subtest24of10,pubtest260of100,1,323,6036,31,383,6450
subtest25of10,pubtest261of100,1,323,5377,14,40,5431
subtest28of10,pubtest261of100,1,323,5377,14,79,5470
subtest23of10,pubtest261of100,1,323,5377,16,116,5509
subtest29of10,pubtest261of100,1,323,5377,16,156,5549
subtest210of10,pubtest261of100,1,323,5377,18,194,5589
subtest22of10,pubtest261of100,1,323,5377,18,234,5629
subtest24of10,pubtest261of100,1,323,5377,23,269,5669
subtest27of10,pubtest261of100,1,323,5377,26,306,5709
subtest21of10,pubtest261of100,1,323,5377,53,319,5749
subtest26of10,pubtest261of100,1,323,5377,53,359,5789
subtest22of10,pubtest262of100,1,323,5492,8,39,5539
subtest21of10,pubtest262of100,1,323,5492,9,78,5579
subtest23of10,pubtest262of100,1,323,5492,10,115,5617
subtest26of10,pubtest262of100,1,323,5492,10,155,5657
subtest27of10,pubtest262of100,1,323,5492,16,190,5698
subtest29of10,pubtest262of100,1,323,5492,18,228,5738
subtest25of10,pubtest262of100,1,323,5492,22,264,5778
subtest210of10,pubtest262of100,1,323,5492,26,300,5818
subtest24of10,pubtest262of100,1,323,5492,57,309,5858
subtest28of10,pubtest262of100,1,323,5492,57,349,5898
subtest22of10,pubtest263of100,1,322,7049,13,40,7102
subtest29of10,pubtest263of100,1,322,7049,13,79,7141
subtest24of10,pubtest263of100,1,322,7049,17,115,7181
subtest26of10,pubtest263of100,1,322,7049,18,155,7222
subtest23of10,pubtest263of100,1,322,7049,18,192,7259
subtest210of10,pubtest263of100,1,322,7049,21,231,7301
subtest25of10,pubtest263of100,1,322,7049,22,269,7340
subtest27of10,pubtest263of100,1,322,7049,23,309,7381
subtest21of10,pubtest263of100,1,322,7049,24,349,7422
subtest28of10,pubtest263of100,1,322,7049,26,386,7461
subtest22of10,pubtest264of100,1,322,5227,15,40,5282
subtest29of10,pubtest264of100,1,322,5227,18,78,5323
subtest23of10,pubtest264of100,1,322,5227,22,113,5362
subtest24of10,pubtest264of100,1,322,5227,26,149,5402
subtest27of10,pubtest264of100,1,322,5227,29,185,5441
subtest28of10,pubtest264of100,1,322,5227,33,221,5481
subtest21of10,pubtest264of100,1,322,5227,35,259,5521
subtest25of10,pubtest264of100,1,322,5227,38,296,5561
subtest210of10,pubtest264of100,1,322,5227,42,332,5601
subtest26of10,pubtest264of100,1,322,5227,41,372,5640
subtest26of10,pubtest265of100,1,323,5347,10,38,5395
subtest27of10,pubtest265of100,1,323,5347,12,75,5434
subtest210of10,pubtest265of100,1,323,5347,13,114,5474
subtest22of10,pubtest265of100,1,323,5347,26,143,5516
subtest21of10,pubtest265of100,1,323,5347,26,181,5554
subtest29of10,pubtest265of100,1,323,5347,27,220,5594
subtest25of10,pubtest265of100,1,323,5347,32,255,5634
subtest24of10,pubtest265of100,1,323,5347,33,292,5672
subtest28of10,pubtest265of100,1,323,5347,32,332,5711
subtest23of10,pubtest265of100,1,323,5347,33,371,5751
subtest29of10,pubtest266of100,1,321,5226,9,45,5280
subtest210of10,pubtest266of100,1,321,5226,11,83,5320
subtest25of10,pubtest266of100,1,321,5226,17,117,5360
subtest27of10,pubtest266of100,1,321,5226,17,156,5399
subtest26of10,pubtest266of100,1,321,5226,23,188,5437
subtest23of10,pubtest266of100,1,321,5226,26,227,5479
subtest21of10,pubtest266of100,1,321,5226,57,236,5519
subtest24of10,pubtest266of100,1,321,5226,58,275,5559
subtest22of10,pubtest266of100,1,321,5226,59,314,5599
subtest28of10,pubtest266of100,1,321,5226,60,353,5639
subtest23of10,pubtest267of100,1,323,5305,14,41,5360
subtest25of10,pubtest267of100,1,323,5305,14,79,5398
subtest26of10,pubtest267of100,1,323,5305,21,115,5441
subtest28of10,pubtest267of100,1,323,5305,25,150,5480
subtest27of10,pubtest267of100,1,323,5305,28,187,5520
subtest29of10,pubtest267of100,1,323,5305,32,223,5560
subtest24of10,pubtest267of100,1,323,5305,35,261,5601
subtest21of10,pubtest267of100,1,323,5305,38,297,5640
subtest22of10,pubtest267of100,1,323,5305,40,336,5681
subtest210of10,pubtest267of100,1,323,5305,43,372,5720
subtest23of10,pubtest268of100,1,323,5244,9,40,5293
subtest25of10,pubtest268of100,1,323,5244,10,78,5332
subtest24of10,pubtest268of100,1,323,5244,16,112,5372
subtest29of10,pubtest268of100,1,323,5244,17,151,5412
subtest27of10,pubtest268of100,1,323,5244,19,189,5452
subtest21of10,pubtest268of100,1,323,5244,22,227,5493
subtest28of10,pubtest268of100,1,323,5244,24,264,5532
subtest22of10,pubtest268of100,1,323,5244,27,301,5572
subtest26of10,pubtest268of100,1,323,5244,31,337,5612
subtest210of10,pubtest268of100,1,323,5244,30,377,5651
subtest24of10,pubtest269of100,1,323,5653,10,38,5701
subtest27of10,pubtest269of100,1,323,5653,15,72,5740
subtest210of10,pubtest269of100,1,323,5653,16,111,5780
subtest21of10,pubtest269of100,1,323,5653,19,146,5818
subtest26of10,pubtest269of100,1,323,5653,19,186,5858
subtest25of10,pubtest269of100,1,323,5653,19,225,5897
subtest29of10,pubtest269of100,1,323,5653,26,261,5940
subtest23of10,pubtest269of100,1,323,5653,26,301,5980
subtest28of10,pubtest269of100,1,323,5653,28,339,6020
subtest22of10,pubtest269of100,1,323,5653,28,379,6060
subtest29of10,pubtest270of100,1,323,5232,15,42,5289
subtest23of10,pubtest270of100,1,323,5232,12,81,5325
subtest27of10,pubtest270of100,1,323,5232,16,119,5367
subtest26of10,pubtest270of100,1,323,5232,13,159,5404
subtest210of10,pubtest270of100,1,323,5232,17,198,5447
subtest25of10,pubtest270of100,1,323,5232,18,238,5488
subtest21of10,pubtest270of100,1,323,5232,20,275,5527
subtest24of10,pubtest270of100,1,323,5232,20,315,5567
subtest28of10,pubtest270of100,1,323,5232,20,355,5607
subtest22of10,pubtest270of100,1,323,5232,22,393,5647
subtest25of10,pubtest271of100,1,323,5374,13,46,5433
subtest24of10,pubtest271of100,1,323,5374,12,86,5472
subtest22of10,pubtest271of100,1,323,5374,20,117,5511
subtest27of10,pubtest271of100,1,323,5374,23,154,5551
subtest21of10,pubtest271of100,1,323,5374,25,192,5591
subtest23of10,pubtest271of100,1,323,5374,29,228,5631
subtest29of10,pubtest271of100,1,323,5374,32,265,5671
subtest210of10,pubtest271of100,1,323,5374,34,303,5711
subtest26of10,pubtest271of100,1,323,5374,37,338,5749
subtest28of10,pubtest271of100,1,323,5374,41,376,5791
subtest25of10,pubtest272of100,1,323,5403,11,38,5452
subtest21of10,pubtest272of100,1,323,5403,37,52,5492
subtest26of10,pubtest272of100,1,323,5403,37,87,5527
subtest29of10,pubtest272of100,1,323,5403,38,126,5567
subtest24of10,pubtest272of100,1,323,5403,38,166,5607
subtest23of10,pubtest272of100,1,323,5403,38,205,5646
subtest210of10,pubtest272of100,1,323,5403,42,245,5690
subtest22of10,pubtest272of100,1,323,5403,39,283,5725
subtest28of10,pubtest272of100,1,323,5403,43,322,5768
subtest27of10,pubtest272of100,1,323,5403,39,361,5803
subtest22of10,pubtest273of100,1,321,5372,10,45,5427
subtest29of10,pubtest273of100,1,321,5372,12,84,5468
subtest26of10,pubtest273of100,1,321,5372,13,123,5508
subtest28of10,pubtest273of100,1,321,5372,14,161,5547
subtest210of10,pubtest273of100,1,321,5372,22,194,5588
subtest25of10,pubtest273of100,1,321,5372,22,233,5627
subtest27of10,pubtest273of100,1,321,5372,27,268,5667
subtest24of10,pubtest273of100,1,321,5372,28,307,5707
subtest21of10,pubtest273of100,1,321,5372,29,346,5747
subtest23of10,pubtest273of100,1,321,5372,30,385,5787
subtest21of10,pubtest274of100,1,323,5195,11,41,5247
subtest26of10,pubtest274of100,1,323,5195,11,80,5286
subtest23of10,pubtest274of100,1,323,5195,13,118,5326
subtest22of10,pubtest274of100,1,323,5195,13,158,5366
subtest29of10,pubtest274of100,1,323,5195,14,197,5406
subtest28of10,pubtest274of100,1,323,5195,17,234,5446
subtest25of10,pubtest274of100,1,323,5195,18,273,5486
subtest27of10,pubtest274of100,1,323,5195,21,310,5526
subtest24of10,pubtest274of100,1,323,5195,44,327,5566
subtest210of10,pubtest274of100,1,323,5195,46,365,5606
subtest27of10,pubtest275of100,1,323,5205,14,38,5257
subtest24of10,pubtest275of100,1,323,5205,19,72,5296
subtest29of10,pubtest275of100,1,323,5205,21,108,5334
subtest25of10,pubtest275of100,1,323,5205,23,147,5375
subtest22of10,pubtest275of100,1,323,5205,25,186,5416
subtest21of10,pubtest275of100,1,323,5205,25,226,5456
subtest210of10,pubtest275of100,1,323,5205,26,265,5496
subtest23of10,pubtest275of100,1,323,5205,26,305,5536
subtest26of10,pubtest275of100,1,323,5205,30,341,5576
subtest28of10,pubtest275of100,1,323,5205,30,381,5616
subtest28of10,pubtest276of100,1,323,5273,16,39,5328
subtest21of10,pubtest276of100,1,323,5273,17,77,5367
subtest25of10,pubtest276of100,1,323,5273,18,116,5407
subtest27of10,pubtest276of100,1,323,5273,19,155,5447
subtest29of10,pubtest276of100,1,323,5273,20,194,5487
subtest24of10,pubtest276of100,1,323,5273,22,232,5527
subtest23of10,pubtest276of100,1,323,5273,42,252,5567
subtest26of10,pubtest276of100,1,323,5273,43,291,5607
subtest210of10,pubtest276of100,1,323,5273,50,322,5645
subtest22of10,pubtest276of100,1,323,5273,53,361,5687
subtest22of10,pubtest277of100,1,323,5184,13,44,5241
subtest28of10,pubtest277of100,1,323,5184,14,83,5281
subtest29of10,pubtest277of100,1,323,5184,16,118,5318
subtest21of10,pubtest277of100,1,323,5184,16,158,5358
subtest27of10,pubtest277of100,1,323,5184,16,195,5395
subtest24of10,pubtest277of100,1,323,5184,17,235,5436
subtest210of10,pubtest277of100,1,323,5184,36,260,5480
subtest25of10,pubtest277of100,1,323,5184,37,299,5520
subtest23of10,pubtest277of100,1,323,5184,66,314,5564
subtest26of10,pubtest277of100,1,323,5184,66,354,5604
subtest29of10,pubtest278of100,1,323,5225,10,42,5277
subtest22of10,pubtest278of100,1,323,5225,10,81,5316
subtest28of10,pubtest278of100,1,323,5225,19,113,5357
subtest21of10,pubtest278of100,1,323,5225,25,149,5399
subtest23of10,pubtest278of100,1,323,5225,24,188,5437
subtest25of10,pubtest278of100,1,323,5225,26,227,5478
subtest26of10,pubtest278of100,1,323,5225,27,265,5517
subtest24of10,pubtest278of100,1,323,5225,28,304,5557
subtest27of10,pubtest278of100,1,323,5225,29,343,5597
subtest210of10,pubtest278of100,1,323,5225,29,383,5637
subtest25of10,pubtest279of100,1,323,5242,10,41,5293
subtest28of10,pubtest279of100,1,323,5242,12,78,5332
subtest24of10,pubtest279of100,1,323,5242,12,117,5371
subtest29of10,pubtest279of100,1,323,5242,14,156,5412
subtest21of10,pubtest279of100,1,323,5242,13,197,5452
subtest27of10,pubtest279of100,1,323,5242,18,232,5492
subtest22of10,pubtest279of100,1,323,5242,37,253,5532
subtest26of10,pubtest279of100,1,323,5242,37,293,5572
subtest23of10,pubtest279of100,1,323,5242,44,327,5613
subtest210of10,pubtest279of100,1,323,5242,49,361,5652
subtest27of10,pubtest280of100,1,323,5502,9,40,5551
subtest24of10,pubtest280of100,1,323,5502,15,73,5590
subtest29of10,pubtest280of100,1,323,5502,15,113,5630
subtest21of10,pubtest280of100,1,323,5502,17,150,5669
subtest23of10,pubtest280of100,1,323,5502,25,182,5709
subtest26of10,pubtest280of100,1,323,5502,25,221,5748
subtest210of10,pubtest280of100,1,323,5502,28,261,5791
subtest28of10,pubtest280of100,1,323,5502,32,296,5830
subtest25of10,pubtest280of100,1,323,5502,33,335,5870
subtest22of10,pubtest280of100,1,323,5502,33,374,5909
subtest27of10,pubtest281of100,1,323,6676,11,40,6727
subtest24of10,pubtest281of100,1,323,6676,10,80,6766
subtest23of10,pubtest281of100,1,323,6676,10,120,6806
subtest25of10,pubtest281of100,1,323,6676,13,157,6846
subtest22of10,pubtest281of100,1,323,6676,14,196,6886
subtest29of10,pubtest281of100,1,323,6676,15,235,6926
subtest21of10,pubtest281of100,1,323,6676,15,275,6966
subtest28of10,pubtest281of100,1,323,6676,12,314,7002
subtest26of10,pubtest281of100,1,323,6676,23,347,7046
subtest210of10,pubtest281of100,1,323,6676,23,387,7086
subtest23of10,pubtest282of100,1,323,5400,16,41,5457
subtest24of10,pubtest282of100,1,323,5400,16,80,5496
subtest21of10,pubtest282of100,1,323,5400,18,118,5536
subtest25of10,pubtest282of100,1,323,5400,19,158,5577
subtest22of10,pubtest282of100,1,323,5400,22,195,5617
subtest27of10,pubtest282of100,1,323,5400,23,231,5654
subtest210of10,pubtest282of100,1,323,5400,26,271,5697
subtest29of10,pubtest282of100,1,323,5400,23,309,5732
subtest28of10,pubtest282of100,1,323,5400,28,349,5777
subtest26of10,pubtest282of100,1,323,5400,29,388,5817
subtest24of10,pubtest283of100,1,323,6021,11,43,6075
subtest27of10,pubtest283of100,1,323,6021,14,79,6114
subtest22of10,pubtest283of100,1,323,6021,17,118,6156
subtest23of10,pubtest283of100,1,323,6021,19,154,6194
subtest28of10,pubtest283of100,1,323,6021,24,189,6234
subtest25of10,pubtest283of100,1,323,6021,24,229,6274
subtest21of10,pubtest283of100,1,323,6021,25,268,6314
subtest210of10,pubtest283of100,1,323,6021,32,301,6354
subtest29of10,pubtest283of100,1,323,6021,32,341,6394
subtest26of10,pubtest283of100,1,323,6021,38,375,6434
subtest25of10,pubtest284of100,1,323,5884,10,38,5932
subtest29of10,pubtest284of100,1,323,5884,15,72,5971
subtest27of10,pubtest284of100,1,323,5884,17,110,6011
subtest23of10,pubtest284of100,1,323,5884,18,149,6051
subtest21of10,pubtest284of100,1,323,5884,19,188,6091
subtest22of10,pubtest284of100,1,323,5884,17,227,6128
subtest210of10,pubtest284of100,1,323,5884,21,264,6169
subtest24of10,pubtest284of100,1,323,5884,24,303,6211
subtest26of10,pubtest284of100,1,323,5884,24,343,6251
subtest28of10,pubtest284of100,1,323,5884,26,381,6291
subtest23of10,pubtest285of100,1,323,6388,11,41,6440
subtest25of10,pubtest285of100,1,323,6388,12,80,6480
subtest24of10,pubtest285of100,1,323,6388,15,117,6520
subtest27of10,pubtest285of100,1,323,6388,17,155,6560
subtest21of10,pubtest285of100,1,323,6388,18,194,6600
subtest22of10,pubtest285of100,1,323,6388,42,212,6642
subtest29of10,pubtest285of100,1,323,6388,43,249,6680
subtest28of10,pubtest285of100,1,323,6388,46,286,6720
subtest210of10,pubtest285of100,1,323,6388,46,326,6760
subtest26of10,pubtest285of100,1,323,6388,48,364,6800
subtest23of10,pubtest286of100,1,323,5603,10,38,5651
subtest210of10,pubtest286of100,1,323,5603,16,71,5690
subtest25of10,pubtest286of100,1,323,5603,16,111,5730
subtest24of10,pubtest286of100,1,323,5603,21,146,5770
subtest27of10,pubtest286of100,1,323,5603,23,184,5810
subtest21of10,pubtest286of100,1,323,5603,23,224,5850
subtest28of10,pubtest286of100,1,323,5603,25,261,5889
subtest22of10,pubtest286of100,1,323,5603,27,300,5930
subtest26of10,pubtest286of100,1,323,5603,23,341,5967
subtest29of10,pubtest286of100,1,323,5603,22,379,6004
subtest26of10,pubtest287of100,1,323,5362,9,43,5414
subtest29of10,pubtest287of100,1,323,5362,10,81,5453
subtest27of10,pubtest287of100,1,323,5362,11,120,5493
subtest28of10,pubtest287of100,1,323,5362,19,150,5531
subtest25of10,pubtest287of100,1,323,5362,30,181,5573
subtest21of10,pubtest287of100,1,323,5362,31,220,5613
subtest23of10,pubtest287of100,1,323,5362,32,259,5653
subtest24of10,pubtest287of100,1,323,5362,34,297,5693
subtest22of10,pubtest287of100,1,323,5362,34,337,5733
subtest210of10,pubtest287of100,1,323,5362,32,378,5772
subtest29of10,pubtest288of100,1,323,5209,9,40,5258
subtest26of10,pubtest288of100,1,323,5209,10,79,5298
subtest21of10,pubtest288of100,1,323,5209,12,117,5338
subtest22of10,pubtest288of100,1,323,5209,13,156,5378
subtest27of10,pubtest288of100,1,323,5209,12,196,5417
subtest23of10,pubtest288of100,1,323,5209,14,235,5458
subtest25of10,pubtest288of100,1,323,5209,14,275,5498
subtest24of10,pubtest288of100,1,323,5209,19,309,5537
subtest28of10,pubtest288of100,1,323,5209,20,347,5576
subtest210of10,pubtest288of100,1,323,5209,21,386,5616
subtest29of10,pubtest289of100,1,323,5244,13,42,5299
subtest23of10,pubtest289of100,1,323,5244,14,80,5338
subtest210of10,pubtest289of100,1,323,5244,13,118,5375
subtest24of10,pubtest289of100,1,323,5244,19,154,5417
subtest25of10,pubtest289of100,1,323,5244,24,187,5455
subtest27of10,pubtest289of100,1,323,5244,26,228,5498
subtest21of10,pubtest289of100,1,323,5244,28,265,5537
subtest26of10,pubtest289of100,1,323,5244,27,305,5576
subtest28of10,pubtest289of100,1,323,5244,29,345,5618
subtest22of10,pubtest289of100,1,323,5244,30,383,5657
subtest29of10,pubtest290of100,1,323,5273,13,48,5334
subtest22of10,pubtest290of100,1,323,5273,15,86,5374
subtest23of10,pubtest290of100,1,323,5273,16,124,5413
subtest25of10,pubtest290of100,1,323,5273,17,163,5453
subtest26of10,pubtest290of100,1,323,5273,21,199,5493
subtest210of10,pubtest290of100,1,323,5273,24,235,5532
subtest28of10,pubtest290of100,1,323,5273,27,273,5573
subtest27of10,pubtest290of100,1,323,5273,27,314,5614
subtest21of10,pubtest290of100,1,323,5273,27,352,5652
subtest24of10,pubtest290of100,1,323,5273,31,389,5693
subtest24of10,pubtest291of100,1,323,5310,12,39,5361
subtest27of10,pubtest291of100,1,323,5310,13,77,5400
subtest23of10,pubtest291of100,1,323,5310,10,116,5436
subtest28of10,pubtest291of100,1,323,5310,14,156,5480
subtest21of10,pubtest291of100,1,323,5310,21,188,5519
subtest210of10,pubtest291of100,1,323,5310,21,228,5559
subtest22of10,pubtest291of100,1,323,5310,28,262,5600
subtest25of10,pubtest291of100,1,323,5310,28,302,5640
subtest26of10,pubtest291of100,1,323,5310,32,338,5680
subtest29of10,pubtest291of100,1,323,5310,32,378,5720
subtest29of10,pubtest292of100,1,323,5324,9,42,5375
subtest21of10,pubtest292of100,1,323,5324,16,73,5413
subtest27of10,pubtest292of100,1,323,5324,18,112,5454
subtest23of10,pubtest292of100,1,323,5324,20,151,5495
subtest26of10,pubtest292of100,1,323,5324,19,191,5534
subtest28of10,pubtest292of100,1,323,5324,21,230,5575
subtest25of10,pubtest292of100,1,323,5324,21,269,5614
subtest24of10,pubtest292of100,1,323,5324,22,308,5654
subtest210of10,pubtest292of100,1,323,5324,23,347,5694
subtest22of10,pubtest292of100,1,323,5324,24,386,5734
subtest25of10,pubtest293of100,1,323,5898,20,39,5957
subtest24of10,pubtest293of100,1,323,5898,21,79,5998
subtest23of10,pubtest293of100,1,323,5898,28,110,6036
subtest27of10,pubtest293of100,1,323,5898,31,147,6076
subtest28of10,pubtest293of100,1,323,5898,31,186,6115
subtest21of10,pubtest293of100,1,323,5898,32,226,6156
subtest210of10,pubtest293of100,1,323,5898,34,261,6193
subtest26of10,pubtest293of100,1,323,5898,34,301,6233
subtest29of10,pubtest293of100,1,323,5898,34,340,6272
subtest22of10,pubtest293of100,1,323,5898,34,379,6311
subtest21of10,pubtest294of100,1,323,5866,8,39,5913
subtest25of10,pubtest294of100,1,323,5866,14,72,5952
subtest29of10,pubtest294of100,1,323,5866,15,109,5990
subtest27of10,pubtest294of100,1,323,5866,18,148,6032
subtest23of10,pubtest294of100,1,323,5866,19,187,6072
subtest210of10,pubtest294of100,1,323,5866,19,227,6112
subtest24of10,pubtest294of100,1,323,5866,21,267,6154
subtest28of10,pubtest294of100,1,323,5866,21,306,6193
subtest26of10,pubtest294of100,1,323,5866,22,344,6232
subtest22of10,pubtest294of100,1,323,5866,21,384,6271
subtest25of10,pubtest295of100,1,323,6457,11,39,6507
subtest23of10,pubtest295of100,1,323,6457,12,78,6547
subtest24of10,pubtest295of100,1,323,6457,20,109,6586
subtest27of10,pubtest295of100,1,323,6457,20,148,6625
subtest29of10,pubtest295of100,1,323,6457,25,184,6666
subtest22of10,pubtest295of100,1,323,6457,26,223,6706
subtest210of10,pubtest295of100,1,323,6457,28,261,6746
subtest21of10,pubtest295of100,1,323,6457,27,301,6785
subtest26of10,pubtest295of100,1,323,6457,29,338,6824
subtest28of10,pubtest295of100,1,323,6457,28,378,6863
subtest25of10,pubtest296of100,1,322,6435,20,45,6500
subtest24of10,pubtest296of100,1,322,6435,20,83,6538
subtest27of10,pubtest296of100,1,322,6435,22,122,6579
subtest23of10,pubtest296of100,1,322,6435,24,161,6620
subtest26of10,pubtest296of100,1,322,6435,26,196,6657
subtest29of10,pubtest296of100,1,322,6435,29,235,6699
subtest21of10,pubtest296of100,1,322,6435,33,271,6739
subtest28of10,pubtest296of100,1,322,6435,34,310,6779
subtest22of10,pubtest296of100,1,322,6435,38,346,6819
subtest210of10,pubtest296of100,1,322,6435,38,386,6859
subtest25of10,pubtest297of100,1,323,6572,15,39,6626
subtest210of10,pubtest297of100,1,323,6572,17,77,6666
subtest29of10,pubtest297of100,1,323,6572,18,116,6706
subtest23of10,pubtest297of100,1,323,6572,19,155,6746
subtest22of10,pubtest297of100,1,323,6572,20,194,6786
subtest27of10,pubtest297of100,1,323,6572,21,233,6826
subtest28of10,pubtest297of100,1,323,6572,22,272,6866
subtest21of10,pubtest297of100,1,323,6572,23,311,6906
subtest26of10,pubtest297of100,1,323,6572,21,350,6943
subtest24of10,pubtest297of100,1,323,6572,24,390,6986
subtest29of10,pubtest298of100,1,323,5507,11,41,5559
subtest22of10,pubtest298of100,1,323,5507,11,80,5598
subtest25of10,pubtest298of100,1,323,5507,15,116,5638
subtest23of10,pubtest298of100,1,323,5507,17,153,5677
subtest21of10,pubtest298of100,1,323,5507,19,192,5718
subtest24of10,pubtest298of100,1,323,5507,16,231,5754
subtest210of10,pubtest298of100,1,323,5507,20,271,5798
subtest27of10,pubtest298of100,1,323,5507,22,309,5838
subtest28of10,pubtest298of100,1,323,5507,26,345,5878
subtest26of10,pubtest298of100,1,323,5507,31,380,5918
subtest22of10,pubtest299of100,1,323,5315,11,40,5366
subtest29of10,pubtest299of100,1,323,5315,12,78,5405
subtest27of10,pubtest299of100,1,323,5315,15,115,5445
subtest210of10,pubtest299of100,1,323,5315,15,155,5485
subtest24of10,pubtest299of100,1,323,5315,18,192,5525
subtest23of10,pubtest299of100,1,323,5315,21,229,5565
subtest28of10,pubtest299of100,1,323,5315,22,268,5605
subtest25of10,pubtest299of100,1,323,5315,23,307,5645
subtest21of10,pubtest299of100,1,323,5315,43,326,5684
subtest26of10,pubtest299of100,1,323,5315,43,365,5723
subtest21of10,pubtest2100of100,1,325,5328,10,40,5378
subtest24of10,pubtest2100of100,1,325,5328,13,77,5418
subtest29of10,pubtest2100of100,1,325,5328,15,114,5457
subtest22of10,pubtest2100of100,1,325,5328,17,152,5497
subtest27of10,pubtest2100of100,1,325,5328,20,188,5536
subtest23of10,pubtest2100of100,1,325,5328,20,228,5576
subtest25of10,pubtest2100of100,1,325,5328,59,230,5617
subtest28of10,pubtest2100of100,1,325,5328,60,269,5657
subtest210of10,pubtest2100of100,1,325,5328,61,309,5698
subtest26of10,pubtest2100of100,1,325,5328,63,346,5737
subtest26of10,pubtest21of100,1,322,10792,11,38,10841
subtest27of10,pubtest21of100,1,322,10792,13,75,10880
subtest29of10,pubtest21of100,1,322,10792,13,115,10920
subtest24of10,pubtest21of100,1,322,10792,15,153,10960
subtest25of10,pubtest21of100,1,322,10792,15,193,11000
subtest210of10,pubtest21of100,1,322,10792,21,227,11040
subtest21of10,pubtest21of100,1,322,10792,20,267,11079
subtest23of10,pubtest21of100,1,322,10792,24,302,11118
subtest22of10,pubtest21of100,1,322,10792,26,342,11160
subtest28of10,pubtest21of100,1,322,10792,24,381,11197
subtest29of10,pubtest22of100,1,321,5340,8,40,5388
subtest27of10,pubtest22of100,1,321,5340,12,75,5427
subtest24of10,pubtest22of100,1,321,5340,14,113,5467
subtest23of10,pubtest22of100,1,321,5340,19,146,5505
subtest28of10,pubtest22of100,1,321,5340,21,186,5547
subtest25of10,pubtest22of100,1,321,5340,21,225,5586
subtest26of10,pubtest22of100,1,321,5340,23,264,5627
subtest21of10,pubtest22of100,1,321,5340,24,305,5669
subtest210of10,pubtest22of100,1,321,5340,27,340,5707
subtest22of10,pubtest22of100,1,321,5340,27,380,5747
subtest23of10,pubtest23of100,1,321,5274,7,45,5326
subtest28of10,pubtest23of100,1,321,5274,7,84,5365
subtest29of10,pubtest23of100,1,321,5274,13,119,5406
subtest24of10,pubtest23of100,1,321,5274,14,157,5445
subtest26of10,pubtest23of100,1,321,5274,15,196,5485
subtest25of10,pubtest23of100,1,321,5274,17,234,5525
subtest27of10,pubtest23of100,1,321,5274,16,276,5566
subtest22of10,pubtest23of100,1,321,5274,17,314,5605
subtest21of10,pubtest23of100,1,321,5274,19,350,5643
subtest210of10,pubtest23of100,1,321,5274,20,390,5684
subtest23of10,pubtest24of100,1,321,5530,9,40,5579
subtest25of10,pubtest24of100,1,321,5530,36,52,5618
subtest24of10,pubtest24of100,1,321,5530,36,92,5658
subtest29of10,pubtest24of100,1,321,5530,39,129,5698
subtest21of10,pubtest24of100,1,321,5530,39,171,5740
subtest28of10,pubtest24of100,1,321,5530,41,207,5778
subtest22of10,pubtest24of100,1,321,5530,42,247,5819
subtest27of10,pubtest24of100,1,321,5530,43,286,5859
subtest210of10,pubtest24of100,1,321,5530,43,325,5898
subtest26of10,pubtest24of100,1,321,5530,44,364,5938
subtest28of10,pubtest25of100,1,321,6364,8,40,6412
subtest21of10,pubtest25of100,1,321,6364,8,79,6451
subtest210of10,pubtest25of100,1,321,6364,22,105,6491
subtest27of10,pubtest25of100,1,321,6364,22,144,6530
subtest23of10,pubtest25of100,1,321,6364,24,183,6571
subtest25of10,pubtest25of100,1,321,6364,24,222,6610
subtest26of10,pubtest25of100,1,321,6364,25,262,6651
subtest22of10,pubtest25of100,1,321,6364,28,299,6691
subtest29of10,pubtest25of100,1,321,6364,26,339,6729
subtest24of10,pubtest25of100,1,321,6364,29,378,6771
subtest21of10,pubtest26of100,1,321,6153,7,38,6198
subtest29of10,pubtest26of100,1,321,6153,10,74,6237
subtest23of10,pubtest26of100,1,321,6153,13,113,6279
subtest27of10,pubtest26of100,1,321,6153,14,151,6318
subtest22of10,pubtest26of100,1,321,6153,15,189,6357
subtest26of10,pubtest26of100,1,321,6153,16,228,6397
subtest25of10,pubtest26of100,1,321,6153,17,267,6437
subtest210of10,pubtest26of100,1,321,6153,28,296,6477
subtest28of10,pubtest26of100,1,321,6153,33,331,6517
subtest24of10,pubtest26of100,1,321,6153,36,368,6557
subtest27of10,pubtest27of100,1,320,5418,12,39,5469
subtest23of10,pubtest27of100,1,320,5418,15,75,5508
subtest28of10,pubtest27of100,1,320,5418,15,115,5548
subtest24of10,pubtest27of100,1,320,5418,17,153,5588
subtest29of10,pubtest27of100,1,320,5418,18,192,5628
subtest25of10,pubtest27of100,1,320,5418,22,226,5666
subtest210of10,pubtest27of100,1,320,5418,22,267,5707
subtest21of10,pubtest27of100,1,320,5418,27,304,5749
subtest22of10,pubtest27of100,1,320,5418,27,343,5788
subtest26of10,pubtest27of100,1,320,5418,28,382,5828
subtest27of10,pubtest28of100,1,321,5264,9,40,5313
subtest21of10,pubtest28of100,1,321,5264,12,77,5353
subtest29of10,pubtest28of100,1,321,5264,20,108,5392
subtest28of10,pubtest28of100,1,321,5264,21,147,5432
subtest23of10,pubtest28of100,1,321,5264,51,157,5472
subtest25of10,pubtest28of100,1,321,5264,51,197,5512
subtest210of10,pubtest28of100,1,321,5264,53,235,5552
subtest26of10,pubtest28of100,1,321,5264,56,272,5592
subtest24of10,pubtest28of100,1,321,5264,56,312,5632
subtest22of10,pubtest28of100,1,321,5264,60,346,5670
subtest23of10,pubtest29of100,1,321,5387,14,39,5440
subtest210of10,pubtest29of100,1,321,5387,15,78,5480
subtest29of10,pubtest29of100,1,321,5387,16,116,5519
subtest25of10,pubtest29of100,1,321,5387,17,155,5559
subtest28of10,pubtest29of100,1,321,5387,21,191,5599
subtest24of10,pubtest29of100,1,321,5387,21,231,5639
subtest22of10,pubtest29of100,1,321,5387,18,270,5675
subtest21of10,pubtest29of100,1,321,5387,18,310,5715
subtest27of10,pubtest29of100,1,321,5387,22,350,5759
subtest26of10,pubtest29of100,1,321,5387,26,388,5801
subtest29of10,pubtest210of100,1,323,5540,10,42,5592
subtest21of10,pubtest210of100,1,323,5540,15,76,5631
subtest27of10,pubtest210of100,1,323,5540,16,115,5671
subtest210of10,pubtest210of100,1,323,5540,23,148,5711
subtest23of10,pubtest210of100,1,323,5540,23,188,5751
subtest28of10,pubtest210of100,1,323,5540,25,226,5791
subtest25of10,pubtest210of100,1,323,5540,25,266,5831
subtest24of10,pubtest210of100,1,323,5540,27,304,5871
subtest22of10,pubtest210of100,1,323,5540,30,340,5910
subtest26of10,pubtest210of100,1,323,5540,30,380,5950
subtest210of10,pubtest211of100,1,323,5517,13,43,5573
subtest24of10,pubtest211of100,1,323,5517,14,82,5613
subtest29of10,pubtest211of100,1,323,5517,15,121,5653
subtest21of10,pubtest211of100,1,323,5517,17,157,5691
subtest22of10,pubtest211of100,1,323,5517,19,197,5733
subtest23of10,pubtest211of100,1,323,5517,19,238,5774
subtest25of10,pubtest211of100,1,323,5517,21,276,5814
subtest26of10,pubtest211of100,1,323,5517,22,314,5853
subtest27of10,pubtest211of100,1,323,5517,23,353,5893
subtest28of10,pubtest211of100,1,323,5517,24,392,5933
subtest25of10,pubtest212of100,1,323,5561,10,42,5613
subtest28of10,pubtest212of100,1,323,5561,14,78,5653
subtest29of10,pubtest212of100,1,323,5561,14,117,5692
subtest23of10,pubtest212of100,1,323,5561,22,149,5732
subtest24of10,pubtest212of100,1,323,5561,22,189,5772
subtest27of10,pubtest212of100,1,323,5561,28,223,5812
subtest22of10,pubtest212of100,1,323,5561,28,263,5852
subtest21of10,pubtest212of100,1,323,5561,61,269,5891
subtest26of10,pubtest212of100,1,323,5561,62,309,5932
subtest210of10,pubtest212of100,1,323,5561,63,348,5972
subtest23of10,pubtest213of100,1,322,6180,8,41,6229
subtest26of10,pubtest213of100,1,322,6180,11,76,6267
subtest29of10,pubtest213of100,1,322,6180,12,117,6309
subtest22of10,pubtest213of100,1,322,6180,22,146,6348
subtest27of10,pubtest213of100,1,322,6180,22,186,6388
subtest21of10,pubtest213of100,1,322,6180,23,225,6428
subtest24of10,pubtest213of100,1,322,6180,24,264,6468
subtest25of10,pubtest213of100,1,322,6180,25,303,6508
subtest28of10,pubtest213of100,1,322,6180,26,342,6548
subtest210of10,pubtest213of100,1,322,6180,27,381,6588
subtest21of10,pubtest214of100,1,323,5610,7,41,5658
subtest23of10,pubtest214of100,1,323,5610,8,81,5699
subtest27of10,pubtest214of100,1,323,5610,10,119,5739
subtest26of10,pubtest214of100,1,323,5610,10,158,5778
subtest25of10,pubtest214of100,1,323,5610,10,195,5815
subtest29of10,pubtest214of100,1,323,5610,14,234,5858
subtest22of10,pubtest214of100,1,323,5610,15,273,5898
subtest210of10,pubtest214of100,1,323,5610,50,278,5938
subtest24of10,pubtest214of100,1,323,5610,53,315,5978
subtest28of10,pubtest214of100,1,323,5610,54,355,6019
subtest27of10,pubtest215of100,1,323,5608,11,41,5660
subtest29of10,pubtest215of100,1,323,5608,12,79,5699
subtest24of10,pubtest215of100,1,323,5608,13,117,5738
subtest21of10,pubtest215of100,1,323,5608,14,157,5779
subtest25of10,pubtest215of100,1,323,5608,17,193,5818
subtest26of10,pubtest215of100,1,323,5608,17,233,5858
subtest210of10,pubtest215of100,1,323,5608,19,272,5899
subtest22of10,pubtest215of100,1,323,5608,20,311,5939
subtest23of10,pubtest215of100,1,323,5608,23,348,5979
subtest28of10,pubtest215of100,1,323,5608,27,384,6019
subtest24of10,pubtest216of100,1,323,5559,11,44,5614
subtest21of10,pubtest216of100,1,323,5559,12,83,5654
subtest23of10,pubtest216of100,1,323,5559,14,120,5693
subtest28of10,pubtest216of100,1,323,5559,19,155,5733
subtest27of10,pubtest216of100,1,323,5559,19,197,5775
subtest25of10,pubtest216of100,1,323,5559,20,234,5813
subtest22of10,pubtest216of100,1,323,5559,25,269,5853
subtest29of10,pubtest216of100,1,323,5559,25,309,5893
subtest26of10,pubtest216of100,1,323,5559,25,347,5931
subtest210of10,pubtest216of100,1,323,5559,33,381,5973
subtest27of10,pubtest217of100,1,322,5612,19,42,5673
subtest22of10,pubtest217of100,1,322,5612,20,80,5712
subtest21of10,pubtest217of100,1,322,5612,21,119,5752
subtest23of10,pubtest217of100,1,322,5612,23,157,5792
subtest26of10,pubtest217of100,1,322,5612,24,196,5832
subtest24of10,pubtest217of100,1,322,5612,26,234,5872
subtest29of10,pubtest217of100,1,322,5612,33,267,5912
subtest25of10,pubtest217of100,1,322,5612,39,301,5952
subtest210of10,pubtest217of100,1,322,5612,39,341,5992
subtest28of10,pubtest217of100,1,322,5612,40,380,6032
subtest29of10,pubtest218of100,1,323,5548,10,43,5601
subtest21of10,pubtest218of100,1,323,5548,12,78,5638
subtest22of10,pubtest218of100,1,323,5548,19,112,5679
subtest27of10,pubtest218of100,1,323,5548,19,152,5719
subtest24of10,pubtest218of100,1,323,5548,25,186,5759
subtest23of10,pubtest218of100,1,323,5548,25,226,5799
subtest25of10,pubtest218of100,1,323,5548,25,265,5838
subtest28of10,pubtest218of100,1,323,5548,27,304,5879
subtest26of10,pubtest218of100,1,323,5548,30,341,5919
subtest210of10,pubtest218of100,1,323,5548,30,381,5959
subtest210of10,pubtest219of100,1,323,5444,13,44,5501
subtest25of10,pubtest219of100,1,323,5444,15,81,5540
subtest26of10,pubtest219of100,1,323,5444,35,101,5580
subtest22of10,pubtest219of100,1,323,5444,35,142,5621
subtest21of10,pubtest219of100,1,323,5444,37,178,5659
subtest24of10,pubtest219of100,1,323,5444,39,217,5700
subtest29of10,pubtest219of100,1,323,5444,42,256,5742
subtest23of10,pubtest219of100,1,323,5444,44,292,5780
subtest27of10,pubtest219of100,1,323,5444,45,331,5820
subtest28of10,pubtest219of100,1,323,5444,47,369,5860
subtest25of10,pubtest220of100,1,323,5638,12,42,5692
subtest210of10,pubtest220of100,1,323,5638,13,80,5731
subtest29of10,pubtest220of100,1,323,5638,15,118,5771
subtest23of10,pubtest220of100,1,323,5638,14,158,5810
subtest21of10,pubtest220of100,1,323,5638,16,197,5851
subtest24of10,pubtest220of100,1,323,5638,16,241,5895
subtest27of10,pubtest220of100,1,323,5638,18,279,5935
subtest26of10,pubtest220of100,1,323,5638,21,316,5975
subtest28of10,pubtest220of100,1,323,5638,20,356,6014
subtest22of10,pubtest220of100,1,323,5638,23,394,6055
subtest24of10,pubtest221of100,1,323,5768,10,38,5816
subtest21of10,pubtest221of100,1,323,5768,11,75,5854
subtest23of10,pubtest221of100,1,323,5768,13,114,5895
subtest28of10,pubtest221of100,1,323,5768,21,146,5935
subtest25of10,pubtest221of100,1,323,5768,21,186,5975
subtest210of10,pubtest221of100,1,323,5768,25,222,6015
subtest22of10,pubtest221of100,1,323,5768,25,261,6054
subtest29of10,pubtest221of100,1,323,5768,29,298,6095
subtest26of10,pubtest221of100,1,323,5768,30,337,6135
subtest27of10,pubtest221of100,1,323,5768,31,377,6176
subtest21of10,pubtest222of100,1,323,5919,13,40,5972
subtest29of10,pubtest222of100,1,323,5919,14,79,6012
subtest22of10,pubtest222of100,1,323,5919,15,118,6052
subtest27of10,pubtest222of100,1,323,5919,15,158,6092
subtest28of10,pubtest222of100,1,323,5919,19,193,6131
subtest23of10,pubtest222of100,1,323,5919,24,229,6172
subtest210of10,pubtest222of100,1,323,5919,24,269,6212
subtest25of10,pubtest222of100,1,323,5919,25,308,6252
subtest26of10,pubtest222of100,1,323,5919,29,344,6292
subtest24of10,pubtest222of100,1,323,5919,30,383,6332
subtest23of10,pubtest223of100,1,323,6325,12,40,6377
subtest21of10,pubtest223of100,1,323,6325,11,82,6418
subtest29of10,pubtest223of100,1,323,6325,15,117,6457
subtest28of10,pubtest223of100,1,323,6325,21,150,6496
subtest27of10,pubtest223of100,1,323,6325,22,189,6536
subtest24of10,pubtest223of100,1,323,6325,26,225,6576
subtest25of10,pubtest223of100,1,323,6325,28,263,6616
subtest22of10,pubtest223of100,1,323,6325,28,303,6656
subtest210of10,pubtest223of100,1,323,6325,28,342,6695
subtest26of10,pubtest223of100,1,323,6325,53,358,6736
subtest21of10,pubtest224of100,1,323,6078,10,39,6127
subtest27of10,pubtest224of100,1,323,6078,18,70,6166
subtest28of10,pubtest224of100,1,323,6078,18,110,6206
subtest23of10,pubtest224of100,1,323,6078,19,149,6246
subtest26of10,pubtest224of100,1,323,6078,20,188,6286
subtest29of10,pubtest224of100,1,323,6078,21,227,6326
subtest22of10,pubtest224of100,1,323,6078,23,263,6364
subtest24of10,pubtest224of100,1,323,6078,26,302,6406
subtest25of10,pubtest224of100,1,323,6078,23,342,6443
subtest210of10,pubtest224of100,1,323,6078,29,379,6486
subtest27of10,pubtest225of100,1,323,5400,13,39,5452
subtest22of10,pubtest225of100,1,323,5400,13,78,5491
subtest21of10,pubtest225of100,1,323,5400,21,108,5529
subtest26of10,pubtest225of100,1,323,5400,23,148,5571
subtest25of10,pubtest225of100,1,323,5400,27,184,5611
subtest24of10,pubtest225of100,1,323,5400,28,223,5651
subtest23of10,pubtest225of100,1,323,5400,32,260,5692
subtest28of10,pubtest225of100,1,323,5400,33,298,5731
subtest29of10,pubtest225of100,1,323,5400,34,337,5771
subtest210of10,pubtest225of100,1,323,5400,34,377,5811
subtest25of10,pubtest226of100,1,323,5191,11,38,5240
subtest22of10,pubtest226of100,1,323,5191,39,50,5280
subtest23of10,pubtest226of100,1,323,5191,40,88,5319
subtest210of10,pubtest226of100,1,323,5191,41,128,5360
subtest21of10,pubtest226of100,1,323,5191,42,166,5399
subtest27of10,pubtest226of100,1,323,5191,42,206,5439
subtest28of10,pubtest226of100,1,323,5191,44,244,5479
subtest29of10,pubtest226of100,1,323,5191,43,284,5518
subtest26of10,pubtest226of100,1,323,5191,50,318,5559
subtest24of10,pubtest226of100,1,323,5191,51,358,5600
subtest210of10,pubtest227of100,1,323,5345,16,49,5410
subtest29of10,pubtest227of100,1,323,5345,17,87,5449
subtest24of10,pubtest227of100,1,323,5345,18,125,5488
subtest25of10,pubtest227of100,1,323,5345,20,162,5527
subtest27of10,pubtest227of100,1,323,5345,22,202,5569
subtest28of10,pubtest227of100,1,323,5345,25,239,5609
subtest23of10,pubtest227of100,1,323,5345,24,279,5648
subtest26of10,pubtest227of100,1,323,5345,27,317,5689
subtest21of10,pubtest227of100,1,323,5345,28,355,5728
subtest22of10,pubtest227of100,1,323,5345,29,395,5769
subtest21of10,pubtest228of100,1,323,5446,11,46,5503
subtest23of10,pubtest228of100,1,323,5446,18,78,5542
subtest25of10,pubtest228of100,1,323,5446,18,118,5582
subtest27of10,pubtest228of100,1,323,5446,24,152,5622
subtest29of10,pubtest228of100,1,323,5446,24,192,5662
subtest26of10,pubtest228of100,1,323,5446,26,230,5702
subtest24of10,pubtest228of100,1,323,5446,30,266,5742
subtest22of10,pubtest228of100,1,323,5446,31,303,5780
subtest28of10,pubtest228of100,1,323,5446,34,343,5823
subtest210of10,pubtest228of100,1,323,5446,31,382,5859
subtest24of10,pubtest229of100,1,321,5740,13,39,5792
subtest21of10,pubtest229of100,1,321,5740,15,77,5832
subtest27of10,pubtest229of100,1,321,5740,17,113,5870
subtest22of10,pubtest229of100,1,321,5740,19,153,5912
subtest28of10,pubtest229of100,1,321,5740,16,191,5947
subtest23of10,pubtest229of100,1,321,5740,20,231,5991
subtest210of10,pubtest229of100,1,321,5740,23,268,6031
subtest26of10,pubtest229of100,1,321,5740,23,308,6071
subtest25of10,pubtest229of100,1,321,5740,26,345,6111
subtest29of10,pubtest229of100,1,321,5740,27,384,6151
subtest22of10,pubtest230of100,1,323,5349,12,41,5402
subtest21of10,pubtest230of100,1,323,5349,14,79,5442
subtest27of10,pubtest230of100,1,323,5349,15,118,5482
subtest29of10,pubtest230of100,1,323,5349,16,156,5521
subtest25of10,pubtest230of100,1,323,5349,17,196,5562
subtest28of10,pubtest230of100,1,323,5349,18,235,5602
subtest24of10,pubtest230of100,1,323,5349,24,268,5641
subtest23of10,pubtest230of100,1,323,5349,24,308,5681
subtest210of10,pubtest230of100,1,323,5349,24,346,5719
subtest26of10,pubtest230of100,1,323,5349,30,383,5762
subtest23of10,pubtest231of100,1,323,5396,16,39,5451
subtest28of10,pubtest231of100,1,323,5396,17,77,5490
subtest25of10,pubtest231of100,1,323,5396,19,115,5530
subtest29of10,pubtest231of100,1,323,5396,20,152,5568
subtest24of10,pubtest231of100,1,323,5396,23,191,5610
subtest21of10,pubtest231of100,1,323,5396,23,231,5650
subtest210of10,pubtest231of100,1,323,5396,25,269,5690
subtest26of10,pubtest231of100,1,323,5396,25,309,5730
subtest27of10,pubtest231of100,1,323,5396,26,348,5770
subtest22of10,pubtest231of100,1,323,5396,28,386,5810
subtest21of10,pubtest232of100,1,323,5536,13,42,5591
subtest23of10,pubtest232of100,1,323,5536,15,79,5630
subtest29of10,pubtest232of100,1,323,5536,15,119,5670
subtest22of10,pubtest232of100,1,323,5536,13,158,5707
subtest27of10,pubtest232of100,1,323,5536,15,197,5748
subtest25of10,pubtest232of100,1,323,5536,35,218,5789
subtest210of10,pubtest232of100,1,323,5536,36,258,5830
subtest28of10,pubtest232of100,1,323,5536,35,297,5868
subtest24of10,pubtest232of100,1,323,5536,38,334,5908
subtest26of10,pubtest232of100,1,323,5536,41,373,5950
subtest24of10,pubtest233of100,1,323,5263,9,38,5310
subtest29of10,pubtest233of100,1,323,5263,11,75,5349
subtest210of10,pubtest233of100,1,323,5263,14,112,5389
subtest25of10,pubtest233of100,1,323,5263,18,146,5427
subtest27of10,pubtest233of100,1,323,5263,18,186,5467
subtest26of10,pubtest233of100,1,323,5263,21,225,5509
subtest23of10,pubtest233of100,1,323,5263,22,265,5550
subtest22of10,pubtest233of100,1,323,5263,26,300,5589
subtest21of10,pubtest233of100,1,323,5263,26,340,5629
subtest28of10,pubtest233of100,1,323,5263,29,378,5670
subtest25of10,pubtest234of100,1,323,5458,10,42,5510
subtest26of10,pubtest234of100,1,323,5458,14,79,5551
subtest27of10,pubtest234of100,1,323,5458,17,115,5590
subtest22of10,pubtest234of100,1,323,5458,19,153,5630
subtest29of10,pubtest234of100,1,323,5458,19,193,5670
subtest23of10,pubtest234of100,1,323,5458,20,232,5710
subtest210of10,pubtest234of100,1,323,5458,22,270,5750
subtest21of10,pubtest234of100,1,323,5458,18,312,5788
subtest24of10,pubtest234of100,1,323,5458,29,341,5828
subtest28of10,pubtest234of100,1,323,5458,32,380,5870
subtest21of10,pubtest235of100,1,321,5355,15,149,5519
subtest23of10,pubtest235of100,1,321,5355,15,187,5557
subtest22of10,pubtest235of100,1,321,5355,17,224,5596
subtest24of10,pubtest235of100,1,321,5355,18,263,5636
subtest29of10,pubtest235of100,1,321,5355,23,298,5676
subtest25of10,pubtest235of100,1,321,5355,23,338,5716
subtest27of10,pubtest235of100,1,321,5355,20,377,5752
subtest28of10,pubtest235of100,1,321,5355,24,419,5798
subtest26of10,pubtest235of100,1,321,5355,24,457,5836
subtest210of10,pubtest235of100,1,321,5355,27,494,5876
subtest210of10,pubtest236of100,1,323,5231,10,39,5280
subtest23of10,pubtest236of100,1,323,5231,11,77,5319
subtest27of10,pubtest236of100,1,323,5231,13,116,5360
subtest28of10,pubtest236of100,1,323,5231,13,155,5399
subtest25of10,pubtest236of100,1,323,5231,18,190,5439
subtest21of10,pubtest236of100,1,323,5231,23,225,5479
subtest24of10,pubtest236of100,1,323,5231,26,262,5519
subtest29of10,pubtest236of100,1,323,5231,26,302,5559
subtest22of10,pubtest236of100,1,323,5231,34,334,5599
subtest26of10,pubtest236of100,1,323,5231,32,374,5637
subtest24of10,pubtest237of100,1,323,5258,14,49,5321
subtest28of10,pubtest237of100,1,323,5258,15,88,5361
subtest23of10,pubtest237of100,1,323,5258,16,126,5400
subtest25of10,pubtest237of100,1,323,5258,22,161,5441
subtest21of10,pubtest237of100,1,323,5258,24,198,5480
subtest29of10,pubtest237of100,1,323,5258,24,238,5520
subtest27of10,pubtest237of100,1,323,5258,26,276,5560
subtest22of10,pubtest237of100,1,323,5258,26,316,5600
subtest26of10,pubtest237of100,1,323,5258,21,356,5635
subtest210of10,pubtest237of100,1,323,5258,27,395,5680
subtest29of10,pubtest238of100,1,323,5189,12,41,5242
subtest27of10,pubtest238of100,1,323,5189,14,78,5281
subtest210of10,pubtest238of100,1,323,5189,15,117,5321
subtest25of10,pubtest238of100,1,323,5189,16,156,5361
subtest21of10,pubtest238of100,1,323,5189,16,196,5401
subtest28of10,pubtest238of100,1,323,5189,14,234,5437
subtest24of10,pubtest238of100,1,323,5189,18,272,5479
subtest22of10,pubtest238of100,1,323,5189,13,312,5514
subtest26of10,pubtest238of100,1,323,5189,20,351,5560
subtest23of10,pubtest238of100,1,323,5189,22,390,5601
subtest21of10,pubtest239of100,1,323,5318,14,42,5374
subtest28of10,pubtest239of100,1,323,5318,15,81,5414
subtest27of10,pubtest239of100,1,323,5318,18,118,5454
subtest25of10,pubtest239of100,1,323,5318,19,158,5495
subtest29of10,pubtest239of100,1,323,5318,20,197,5535
subtest210of10,pubtest239of100,1,323,5318,20,236,5574
subtest24of10,pubtest239of100,1,323,5318,22,274,5614
subtest22of10,pubtest239of100,1,323,5318,22,314,5654
subtest26of10,pubtest239of100,1,323,5318,23,354,5695
subtest23of10,pubtest239of100,1,323,5318,25,391,5734
subtest21of10,pubtest240of100,1,323,5305,11,40,5356
subtest25of10,pubtest240of100,1,323,5305,11,79,5395
subtest27of10,pubtest240of100,1,323,5305,12,118,5435
subtest29of10,pubtest240of100,1,323,5305,12,157,5474
subtest23of10,pubtest240of100,1,323,5305,15,195,5515
subtest210of10,pubtest240of100,1,323,5305,20,230,5555
subtest24of10,pubtest240of100,1,323,5305,23,266,5594
subtest28of10,pubtest240of100,1,323,5305,23,306,5634
subtest22of10,pubtest240of100,1,323,5305,24,345,5674
subtest26of10,pubtest240of100,1,323,5305,29,381,5715
subtest23of10,pubtest241of100,1,323,5292,10,38,5340
subtest24of10,pubtest241of100,1,323,5292,17,68,5377
subtest27of10,pubtest241of100,1,323,5292,17,108,5417
subtest210of10,pubtest241of100,1,323,5292,21,148,5461
subtest21of10,pubtest241of100,1,323,5292,20,187,5499
subtest28of10,pubtest241of100,1,323,5292,22,225,5539
subtest25of10,pubtest241of100,1,323,5292,24,263,5579
subtest26of10,pubtest241of100,1,323,5292,23,303,5618
subtest29of10,pubtest241of100,1,323,5292,23,342,5657
subtest22of10,pubtest241of100,1,323,5292,25,382,5699
subtest27of10,pubtest242of100,1,323,5664,9,39,5712
subtest23of10,pubtest242of100,1,323,5664,15,73,5752
subtest25of10,pubtest242of100,1,323,5664,18,109,5791
subtest29of10,pubtest242of100,1,323,5664,18,149,5831
subtest210of10,pubtest242of100,1,323,5664,19,188,5871
subtest21of10,pubtest242of100,1,323,5664,23,224,5911
subtest24of10,pubtest242of100,1,323,5664,23,264,5951
subtest28of10,pubtest242of100,1,323,5664,23,303,5990
subtest26of10,pubtest242of100,1,323,5664,25,342,6031
subtest22of10,pubtest242of100,1,323,5664,20,382,6066
subtest29of10,pubtest243of100,1,323,5359,11,39,5409
subtest28of10,pubtest243of100,1,323,5359,10,79,5448
subtest22of10,pubtest243of100,1,323,5359,13,116,5488
subtest23of10,pubtest243of100,1,323,5359,18,151,5528
subtest25of10,pubtest243of100,1,323,5359,19,191,5569
subtest26of10,pubtest243of100,1,323,5359,31,218,5608
subtest27of10,pubtest243of100,1,323,5359,31,258,5648
subtest24of10,pubtest243of100,1,323,5359,53,276,5688
subtest21of10,pubtest243of100,1,323,5359,55,314,5728
subtest210of10,pubtest243of100,1,323,5359,56,353,5768
subtest29of10,pubtest244of100,1,323,5285,24,40,5349
subtest27of10,pubtest244of100,1,323,5285,22,81,5388
subtest28of10,pubtest244of100,1,323,5285,24,119,5428
subtest26of10,pubtest244of100,1,323,5285,22,158,5465
subtest25of10,pubtest244of100,1,323,5285,23,196,5504
subtest21of10,pubtest244of100,1,323,5285,34,229,5548
subtest210of10,pubtest244of100,1,323,5285,40,263,5588
subtest22of10,pubtest244of100,1,323,5285,42,301,5628
subtest23of10,pubtest244of100,1,323,5285,41,343,5669
subtest24of10,pubtest244of100,1,323,5285,44,380,5709
subtest26of10,pubtest245of100,1,322,5248,10,40,5298
subtest29of10,pubtest245of100,1,322,5248,10,79,5337
subtest22of10,pubtest245of100,1,322,5248,27,102,5377
subtest25of10,pubtest245of100,1,322,5248,28,142,5418
subtest21of10,pubtest245of100,1,322,5248,30,179,5457
subtest27of10,pubtest245of100,1,322,5248,31,218,5497
subtest24of10,pubtest245of100,1,322,5248,30,258,5536
subtest210of10,pubtest245of100,1,322,5248,33,294,5575
subtest28of10,pubtest245of100,1,322,5248,33,334,5615
subtest23of10,pubtest245of100,1,322,5248,28,373,5649
subtest26of10,pubtest246of100,1,323,5247,10,38,5295
subtest27of10,pubtest246of100,1,323,5247,11,76,5334
subtest25of10,pubtest246of100,1,323,5247,16,111,5374
subtest21of10,pubtest246of100,1,323,5247,17,151,5415
subtest28of10,pubtest246of100,1,323,5247,18,190,5455
subtest29of10,pubtest246of100,1,323,5247,12,230,5489
subtest23of10,pubtest246of100,1,323,5247,19,270,5536
subtest24of10,pubtest246of100,1,323,5247,31,297,5575
subtest210of10,pubtest246of100,1,323,5247,31,336,5614
subtest22of10,pubtest246of100,1,323,5247,32,375,5654
subtest27of10,pubtest247of100,1,323,5196,8,39,5243
subtest26of10,pubtest247of100,1,323,5196,14,72,5282
subtest21of10,pubtest247of100,1,323,5196,14,113,5323
subtest23of10,pubtest247of100,1,323,5196,12,154,5362
subtest29of10,pubtest247of100,1,323,5196,17,189,5402
subtest22of10,pubtest247of100,1,323,5196,18,227,5441
subtest28of10,pubtest247of100,1,323,5196,21,265,5482
subtest210of10,pubtest247of100,1,323,5196,43,282,5521
subtest25of10,pubtest247of100,1,323,5196,43,322,5561
subtest24of10,pubtest247of100,1,323,5196,46,360,5602
subtest29of10,pubtest248of100,1,323,5222,10,39,5271
subtest26of10,pubtest248of100,1,323,5222,10,78,5310
subtest28of10,pubtest248of100,1,323,5222,17,113,5352
subtest25of10,pubtest248of100,1,323,5222,16,153,5391
subtest24of10,pubtest248of100,1,323,5222,23,187,5432
subtest23of10,pubtest248of100,1,323,5222,24,226,5472
subtest22of10,pubtest248of100,1,323,5222,25,265,5512
subtest27of10,pubtest248of100,1,323,5222,31,300,5553
subtest21of10,pubtest248of100,1,323,5222,32,338,5592
subtest210of10,pubtest248of100,1,323,5222,33,376,5631
subtest27of10,pubtest249of100,1,323,5389,14,315,5718
subtest25of10,pubtest249of100,1,323,5389,16,314,5719
subtest28of10,pubtest249of100,1,323,5389,14,352,5755
subtest24of10,pubtest249of100,1,323,5389,18,391,5798
subtest29of10,pubtest249of100,1,323,5389,25,424,5838
subtest26of10,pubtest249of100,1,323,5389,26,463,5878
subtest21of10,pubtest249of100,1,323,5389,25,504,5918
subtest22of10,pubtest249of100,1,323,5389,28,542,5959
subtest210of10,pubtest249of100,1,323,5389,29,580,5998
subtest23of10,pubtest249of100,1,323,5389,27,620,6036
subtest27of10,pubtest250of100,1,323,5456,37,40,5533
subtest23of10,pubtest250of100,1,323,5456,38,77,5571
subtest28of10,pubtest250of100,1,323,5456,37,118,5611
subtest29of10,pubtest250of100,1,323,5456,41,156,5653
subtest21of10,pubtest250of100,1,323,5456,42,195,5693
subtest25of10,pubtest250of100,1,323,5456,51,225,5732
subtest24of10,pubtest250of100,1,323,5456,57,257,5770
subtest210of10,pubtest250of100,1,323,5456,61,296,5813
subtest26of10,pubtest250of100,1,323,5456,61,334,5851
subtest22of10,pubtest250of100,1,323,5456,63,373,5892
subtest23of10,pubtest251of100,1,323,5216,13,39,5268
subtest22of10,pubtest251of100,1,323,5216,12,78,5306
subtest24of10,pubtest251of100,1,323,5216,15,117,5348
subtest27of10,pubtest251of100,1,323,5216,16,155,5387
subtest25of10,pubtest251of100,1,323,5216,18,193,5427
subtest21of10,pubtest251of100,1,323,5216,21,231,5468
subtest29of10,pubtest251of100,1,323,5216,22,269,5507
subtest28of10,pubtest251of100,1,323,5216,24,307,5547
subtest210of10,pubtest251of100,1,323,5216,24,347,5587
subtest26of10,pubtest251of100,1,323,5216,26,385,5627
subtest29of10,pubtest252of100,1,323,5170,14,42,5226
subtest28of10,pubtest252of100,1,323,5170,15,80,5265
subtest21of10,pubtest252of100,1,323,5170,20,115,5305
subtest27of10,pubtest252of100,1,323,5170,42,133,5345
subtest25of10,pubtest252of100,1,323,5170,45,170,5385
subtest23of10,pubtest252of100,1,323,5170,45,210,5425
subtest22of10,pubtest252of100,1,323,5170,45,249,5464
subtest210of10,pubtest252of100,1,323,5170,47,288,5505
subtest26of10,pubtest252of100,1,323,5170,48,328,5546
subtest24of10,pubtest252of100,1,323,5170,49,366,5585
subtest28of10,pubtest253of100,1,322,5255,15,42,5312
subtest23of10,pubtest253of100,1,322,5255,17,80,5352
subtest24of10,pubtest253of100,1,322,5255,18,118,5391
subtest25of10,pubtest253of100,1,322,5255,18,157,5430
subtest29of10,pubtest253of100,1,322,5255,19,197,5471
subtest210of10,pubtest253of100,1,322,5255,21,234,5510
subtest22of10,pubtest253of100,1,322,5255,21,274,5550
subtest26of10,pubtest253of100,1,322,5255,25,311,5591
subtest27of10,pubtest253of100,1,322,5255,25,351,5631
subtest21of10,pubtest253of100,1,322,5255,27,389,5671
subtest210of10,pubtest254of100,1,323,5455,9,39,5503
subtest27of10,pubtest254of100,1,323,5455,10,77,5542
subtest21of10,pubtest254of100,1,323,5455,13,113,5581
subtest28of10,pubtest254of100,1,323,5455,13,153,5621
subtest25of10,pubtest254of100,1,323,5455,15,192,5662
subtest24of10,pubtest254of100,1,323,5455,20,227,5702
subtest23of10,pubtest254of100,1,323,5455,21,266,5742
subtest29of10,pubtest254of100,1,323,5455,24,302,5781
subtest26of10,pubtest254of100,1,323,5455,25,342,5822
subtest22of10,pubtest254of100,1,323,5455,22,382,5859
subtest22of10,pubtest255of100,1,322,6041,10,42,6093
subtest23of10,pubtest255of100,1,322,6041,13,77,6131
subtest27of10,pubtest255of100,1,322,6041,17,114,6172
subtest29of10,pubtest255of100,1,322,6041,25,146,6212
subtest28of10,pubtest255of100,1,322,6041,25,185,6251
subtest24of10,pubtest255of100,1,322,6041,31,220,6292
subtest21of10,pubtest255of100,1,322,6041,37,254,6332
subtest210of10,pubtest255of100,1,322,6041,37,294,6372
subtest26of10,pubtest255of100,1,322,6041,38,333,6412
subtest25of10,pubtest255of100,1,322,6041,39,371,6451
subtest29of10,pubtest256of100,1,323,6464,9,39,6512
subtest21of10,pubtest256of100,1,323,6464,12,75,6551
subtest23of10,pubtest256of100,1,323,6464,16,111,6591
subtest26of10,pubtest256of100,1,323,6464,28,137,6629
subtest25of10,pubtest256of100,1,323,6464,28,176,6668
subtest22of10,pubtest256of100,1,323,6464,30,217,6711
subtest210of10,pubtest256of100,1,323,6464,31,256,6751
subtest27of10,pubtest256of100,1,323,6464,31,294,6789
subtest24of10,pubtest256of100,1,323,6464,30,333,6827
subtest28of10,pubtest256of100,1,323,6464,30,373,6867
subtest21of10,pubtest257of100,1,323,5259,10,39,5308
subtest24of10,pubtest257of100,1,323,5259,11,77,5347
subtest27of10,pubtest257of100,1,323,5259,18,109,5386
subtest23of10,pubtest257of100,1,323,5259,19,149,5427
subtest29of10,pubtest257of100,1,323,5259,22,185,5466
subtest25of10,pubtest257of100,1,323,5259,22,225,5506
subtest28of10,pubtest257of100,1,323,5259,26,262,5547
subtest22of10,pubtest257of100,1,323,5259,26,302,5587
subtest26of10,pubtest257of100,1,323,5259,27,341,5627
subtest210of10,pubtest257of100,1,323,5259,26,381,5666
subtest28of10,pubtest258of100,1,323,5313,19,44,5376
subtest23of10,pubtest258of100,1,323,5313,18,83,5414
subtest25of10,pubtest258of100,1,323,5313,18,122,5453
subtest26of10,pubtest258of100,1,323,5313,21,161,5495
subtest24of10,pubtest258of100,1,323,5313,21,201,5535
subtest21of10,pubtest258of100,1,323,5313,23,239,5575
subtest22of10,pubtest258of100,1,323,5313,21,278,5612
subtest29of10,pubtest258of100,1,323,5313,23,318,5654
subtest210of10,pubtest258of100,1,323,5313,24,355,5692
subtest27of10,pubtest258of100,1,323,5313,23,395,5731
subtest21of10,pubtest259of100,1,323,5869,12,42,5923
subtest28of10,pubtest259of100,1,323,5869,12,81,5962
subtest25of10,pubtest259of100,1,323,5869,14,118,6001
subtest27of10,pubtest259of100,1,323,5869,23,150,6042
subtest24of10,pubtest259of100,1,323,5869,24,192,6085
subtest23of10,pubtest259of100,1,323,5869,25,229,6123
subtest29of10,pubtest259of100,1,323,5869,26,267,6162
subtest26of10,pubtest259of100,1,323,5869,27,306,6202
subtest22of10,pubtest259of100,1,323,5869,28,345,6242
subtest210of10,pubtest259of100,1,323,5869,29,384,6282
subtest23of10,pubtest260of100,1,323,5414,11,39,5464
subtest210of10,pubtest260of100,1,323,5414,11,78,5503
subtest21of10,pubtest260of100,1,323,5414,17,112,5543
subtest27of10,pubtest260of100,1,323,5414,20,149,5583
subtest29of10,pubtest260of100,1,323,5414,21,187,5622
subtest26of10,pubtest260of100,1,323,5414,22,227,5663
subtest22of10,pubtest260of100,1,323,5414,24,265,5703
subtest28of10,pubtest260of100,1,323,5414,24,305,5743
subtest25of10,pubtest260of100,1,323,5414,23,343,5780
subtest24of10,pubtest260of100,1,323,5414,31,378,5823
subtest25of10,pubtest261of100,1,323,5182,12,43,5237
subtest29of10,pubtest261of100,1,323,5182,13,82,5277
subtest28of10,pubtest261of100,1,323,5182,15,119,5316
subtest23of10,pubtest261of100,1,323,5182,16,159,5357
subtest210of10,pubtest261of100,1,323,5182,22,192,5396
subtest27of10,pubtest261of100,1,323,5182,22,230,5434
subtest21of10,pubtest261of100,1,323,5182,25,269,5476
subtest22of10,pubtest261of100,1,323,5182,25,309,5516
subtest24of10,pubtest261of100,1,323,5182,27,347,5556
subtest26of10,pubtest261of100,1,323,5182,27,387,5596
subtest21of10,pubtest262of100,1,323,5370,10,39,5419
subtest22of10,pubtest262of100,1,323,5370,12,77,5459
subtest23of10,pubtest262of100,1,323,5370,13,116,5499
subtest27of10,pubtest262of100,1,323,5370,19,150,5539
subtest29of10,pubtest262of100,1,323,5370,19,190,5579
subtest25of10,pubtest262of100,1,323,5370,20,229,5619
subtest26of10,pubtest262of100,1,323,5370,21,269,5660
subtest210of10,pubtest262of100,1,323,5370,22,307,5699
subtest24of10,pubtest262of100,1,323,5370,24,345,5739
subtest28of10,pubtest262of100,1,323,5370,24,384,5778
subtest22of10,pubtest263of100,1,322,5570,11,40,5621
subtest29of10,pubtest263of100,1,322,5570,13,76,5659
subtest24of10,pubtest263of100,1,322,5570,24,106,5700
subtest23of10,pubtest263of100,1,322,5570,24,146,5740
subtest26of10,pubtest263of100,1,322,5570,25,186,5781
subtest210of10,pubtest263of100,1,322,5570,28,221,5819
subtest27of10,pubtest263of100,1,322,5570,29,260,5859
subtest25of10,pubtest263of100,1,322,5570,28,300,5898
subtest21of10,pubtest263of100,1,322,5570,30,340,5940
subtest28of10,pubtest263of100,1,322,5570,32,378,5980
subtest22of10,pubtest264of100,1,322,5215,11,39,5265
subtest29of10,pubtest264of100,1,322,5215,11,78,5304
subtest24of10,pubtest264of100,1,322,5215,23,107,5345
subtest23of10,pubtest264of100,1,322,5215,23,146,5384
subtest27of10,pubtest264of100,1,322,5215,25,185,5425
subtest28of10,pubtest264of100,1,322,5215,30,221,5466
subtest21of10,pubtest264of100,1,322,5215,31,259,5505
subtest25of10,pubtest264of100,1,322,5215,33,297,5545
subtest26of10,pubtest264of100,1,322,5215,34,335,5584
subtest210of10,pubtest264of100,1,322,5215,37,372,5624
subtest26of10,pubtest265of100,1,323,5178,11,41,5230
subtest27of10,pubtest265of100,1,323,5178,17,72,5267
subtest29of10,pubtest265of100,1,323,5178,18,110,5306
subtest21of10,pubtest265of100,1,323,5178,18,150,5346
subtest22of10,pubtest265of100,1,323,5178,19,190,5387
subtest210of10,pubtest265of100,1,323,5178,17,229,5424
subtest25of10,pubtest265of100,1,323,5178,21,268,5467
subtest24of10,pubtest265of100,1,323,5178,23,308,5509
subtest23of10,pubtest265of100,1,323,5178,22,346,5546
subtest28of10,pubtest265of100,1,323,5178,22,383,5583
subtest29of10,pubtest266of100,1,321,5740,12,41,5793
subtest27of10,pubtest266of100,1,321,5740,15,78,5833
subtest23of10,pubtest266of100,1,321,5740,16,115,5871
subtest210of10,pubtest266of100,1,321,5740,15,155,5910
subtest25of10,pubtest266of100,1,321,5740,15,195,5950
subtest26of10,pubtest266of100,1,321,5740,26,225,5991
subtest21of10,pubtest266of100,1,321,5740,27,263,6030
subtest28of10,pubtest266of100,1,321,5740,30,302,6072
subtest22of10,pubtest266of100,1,321,5740,33,338,6111
subtest24of10,pubtest266of100,1,321,5740,33,378,6151
subtest23of10,pubtest267of100,1,323,5904,10,38,5952
subtest26of10,pubtest267of100,1,323,5904,15,73,5992
subtest28of10,pubtest267of100,1,323,5904,18,109,6031
subtest25of10,pubtest267of100,1,323,5904,18,147,6069
subtest24of10,pubtest267of100,1,323,5904,23,185,6112
subtest27of10,pubtest267of100,1,323,5904,23,225,6152
subtest29of10,pubtest267of100,1,323,5904,26,262,6192
subtest21of10,pubtest267of100,1,323,5904,27,301,6232
subtest22of10,pubtest267of100,1,323,5904,28,339,6271
subtest210of10,pubtest267of100,1,323,5904,29,379,6312
subtest23of10,pubtest268of100,1,323,5529,10,38,5577
subtest24of10,pubtest268of100,1,323,5529,16,72,5617
subtest25of10,pubtest268of100,1,323,5529,17,111,5657
subtest29of10,pubtest268of100,1,323,5529,18,150,5697
subtest28of10,pubtest268of100,1,323,5529,21,187,5737
subtest27of10,pubtest268of100,1,323,5529,22,228,5779
subtest21of10,pubtest268of100,1,323,5529,23,266,5818
subtest210of10,pubtest268of100,1,323,5529,26,302,5857
subtest22of10,pubtest268of100,1,323,5529,26,341,5896
subtest26of10,pubtest268of100,1,323,5529,27,380,5936
subtest24of10,pubtest269of100,1,323,5525,9,42,5576
subtest27of10,pubtest269of100,1,323,5525,11,79,5615
subtest210of10,pubtest269of100,1,323,5525,13,117,5655
subtest26of10,pubtest269of100,1,323,5525,34,136,5695
subtest25of10,pubtest269of100,1,323,5525,34,176,5735
subtest21of10,pubtest269of100,1,323,5525,36,214,5775
subtest22of10,pubtest269of100,1,323,5525,36,254,5815
subtest29of10,pubtest269of100,1,323,5525,38,293,5856
subtest23of10,pubtest269of100,1,323,5525,38,332,5895
subtest28of10,pubtest269of100,1,323,5525,41,370,5936
subtest23of10,pubtest270of100,1,323,5799,17,41,5857
subtest26of10,pubtest270of100,1,323,5799,21,76,5896
subtest27of10,pubtest270of100,1,323,5799,22,114,5935
subtest210of10,pubtest270of100,1,323,5799,23,154,5976
subtest24of10,pubtest270of100,1,323,5799,25,191,6015
subtest28of10,pubtest270of100,1,323,5799,24,228,6051
subtest21of10,pubtest270of100,1,323,5799,26,267,6092
subtest29of10,pubtest270of100,1,323,5799,29,307,6135
subtest22of10,pubtest270of100,1,323,5799,27,346,6172
subtest25of10,pubtest270of100,1,323,5799,25,386,6210
subtest24of10,pubtest271of100,1,323,5433,16,42,5491
subtest210of10,pubtest271of100,1,323,5433,18,79,5530
subtest25of10,pubtest271of100,1,323,5433,17,119,5569
subtest22of10,pubtest271of100,1,323,5433,18,158,5609
subtest29of10,pubtest271of100,1,323,5433,28,189,5650
subtest27of10,pubtest271of100,1,323,5433,25,229,5687
subtest28of10,pubtest271of100,1,323,5433,28,268,5729
subtest23of10,pubtest271of100,1,323,5433,27,308,5768
subtest26of10,pubtest271of100,1,323,5433,25,348,5806
subtest21of10,pubtest271of100,1,323,5433,27,387,5847
subtest25of10,pubtest272of100,1,323,5796,8,39,5843
subtest21of10,pubtest272of100,1,323,5796,16,68,5880
subtest24of10,pubtest272of100,1,323,5796,18,108,5922
subtest26of10,pubtest272of100,1,323,5796,15,147,5958
subtest29of10,pubtest272of100,1,323,5796,21,185,6002
subtest210of10,pubtest272of100,1,323,5796,22,224,6042
subtest23of10,pubtest272of100,1,323,5796,23,263,6082
subtest27of10,pubtest272of100,1,323,5796,23,303,6122
subtest22of10,pubtest272of100,1,323,5796,25,341,6162
subtest28of10,pubtest272of100,1,323,5796,25,382,6203
subtest22of10,pubtest273of100,1,321,5501,14,106,5621
subtest29of10,pubtest273of100,1,321,5501,15,143,5659
subtest23of10,pubtest273of100,1,321,5501,19,180,5700
subtest27of10,pubtest273of100,1,321,5501,19,220,5740
subtest25of10,pubtest273of100,1,321,5501,17,263,5781
subtest28of10,pubtest273of100,1,321,5501,20,299,5820
subtest26of10,pubtest273of100,1,321,5501,14,340,5855
subtest21of10,pubtest273of100,1,321,5501,27,372,5900
subtest210of10,pubtest273of100,1,321,5501,33,406,5940
subtest24of10,pubtest273of100,1,321,5501,33,446,5980
subtest26of10,pubtest274of100,1,323,5512,14,38,5564
subtest23of10,pubtest274of100,1,323,5512,14,77,5603
subtest21of10,pubtest274of100,1,323,5512,13,118,5643
subtest29of10,pubtest274of100,1,323,5512,32,139,5683
subtest22of10,pubtest274of100,1,323,5512,35,176,5723
subtest25of10,pubtest274of100,1,323,5512,36,215,5763
subtest27of10,pubtest274of100,1,323,5512,37,255,5804
subtest28of10,pubtest274of100,1,323,5512,38,293,5843
subtest24of10,pubtest274of100,1,323,5512,38,334,5884
subtest210of10,pubtest274of100,1,323,5512,44,367,5923
subtest27of10,pubtest275of100,1,323,5424,10,38,5472
subtest29of10,pubtest275of100,1,323,5424,16,71,5511
subtest25of10,pubtest275of100,1,323,5424,21,106,5551
subtest24of10,pubtest275of100,1,323,5424,22,145,5591
subtest21of10,pubtest275of100,1,323,5424,22,185,5631
subtest210of10,pubtest275of100,1,323,5424,24,221,5669
subtest28of10,pubtest275of100,1,323,5424,26,261,5711
subtest23of10,pubtest275of100,1,323,5424,27,300,5751
subtest22of10,pubtest275of100,1,323,5424,24,340,5788
subtest26of10,pubtest275of100,1,323,5424,29,378,5831
subtest28of10,pubtest276of100,1,323,5944,15,45,6004
subtest21of10,pubtest276of100,1,323,5944,15,84,6043
subtest25of10,pubtest276of100,1,323,5944,17,122,6083
subtest27of10,pubtest276of100,1,323,5944,18,161,6123
subtest23of10,pubtest276of100,1,323,5944,21,198,6163
subtest29of10,pubtest276of100,1,323,5944,23,236,6203
subtest26of10,pubtest276of100,1,323,5944,48,251,6243
subtest210of10,pubtest276of100,1,323,5944,49,289,6282
subtest24of10,pubtest276of100,1,323,5944,48,329,6321
subtest22of10,pubtest276of100,1,323,5944,50,369,6363
subtest29of10,pubtest277of100,1,323,5430,14,42,5486
subtest22of10,pubtest277of100,1,323,5430,12,82,5524
subtest28of10,pubtest277of100,1,323,5430,16,120,5566
subtest21of10,pubtest277of100,1,323,5430,17,159,5606
subtest27of10,pubtest277of100,1,323,5430,19,197,5646
subtest24of10,pubtest277of100,1,323,5430,19,237,5686
subtest25of10,pubtest277of100,1,323,5430,28,268,5726
subtest23of10,pubtest277of100,1,323,5430,35,302,5767
subtest210of10,pubtest277of100,1,323,5430,35,341,5806
subtest26of10,pubtest277of100,1,323,5430,37,379,5846
subtest29of10,pubtest278of100,1,323,5389,10,40,5439
subtest22of10,pubtest278of100,1,323,5389,11,80,5480
subtest23of10,pubtest278of100,1,323,5389,14,116,5519
subtest21of10,pubtest278of100,1,323,5389,19,151,5559
subtest28of10,pubtest278of100,1,323,5389,19,191,5599
subtest27of10,pubtest278of100,1,323,5389,21,229,5639
subtest25of10,pubtest278of100,1,323,5389,23,267,5679
subtest24of10,pubtest278of100,1,323,5389,24,306,5719
subtest26of10,pubtest278of100,1,323,5389,24,346,5759
subtest210of10,pubtest278of100,1,323,5389,26,382,5797
subtest25of10,pubtest279of100,1,323,5370,13,39,5422
subtest28of10,pubtest279of100,1,323,5370,13,78,5461
subtest21of10,pubtest279of100,1,323,5370,15,116,5501
subtest29of10,pubtest279of100,1,323,5370,17,154,5541
subtest26of10,pubtest279of100,1,323,5370,16,194,5580
subtest24of10,pubtest279of100,1,323,5370,15,234,5619
subtest27of10,pubtest279of100,1,323,5370,18,271,5659
subtest23of10,pubtest279of100,1,323,5370,22,309,5701
subtest210of10,pubtest279of100,1,323,5370,22,349,5741
subtest22of10,pubtest279of100,1,323,5370,19,388,5777
subtest27of10,pubtest280of100,1,323,5365,11,40,5416
subtest24of10,pubtest280of100,1,323,5365,11,78,5454
subtest29of10,pubtest280of100,1,323,5365,13,118,5496
subtest21of10,pubtest280of100,1,323,5365,14,157,5536
subtest23of10,pubtest280of100,1,323,5365,16,193,5574
subtest210of10,pubtest280of100,1,323,5365,17,233,5615
subtest26of10,pubtest280of100,1,323,5365,13,273,5651
subtest28of10,pubtest280of100,1,323,5365,18,312,5695
subtest25of10,pubtest280of100,1,323,5365,21,348,5734
subtest22of10,pubtest280of100,1,323,5365,22,388,5775
subtest23of10,pubtest281of100,1,323,5457,16,42,5515
subtest24of10,pubtest281of100,1,323,5457,15,83,5555
subtest27of10,pubtest281of100,1,323,5457,18,122,5597
subtest21of10,pubtest281of100,1,323,5457,19,161,5637
subtest29of10,pubtest281of100,1,323,5457,20,199,5676
subtest210of10,pubtest281of100,1,323,5457,21,241,5719
subtest25of10,pubtest281of100,1,323,5457,22,279,5758
subtest26of10,pubtest281of100,1,323,5457,23,317,5797
subtest28of10,pubtest281of100,1,323,5457,23,357,5837
subtest22of10,pubtest281of100,1,323,5457,18,396,5871
subtest23of10,pubtest282of100,1,323,5641,15,43,5699
subtest24of10,pubtest282of100,1,323,5641,15,82,5738
subtest21of10,pubtest282of100,1,323,5641,16,120,5777
subtest25of10,pubtest282of100,1,323,5641,17,160,5818
subtest29of10,pubtest282of100,1,323,5641,19,198,5858
subtest26of10,pubtest282of100,1,323,5641,19,238,5898
subtest27of10,pubtest282of100,1,323,5641,20,277,5938
subtest210of10,pubtest282of100,1,323,5641,21,316,5978
subtest22of10,pubtest282of100,1,323,5641,21,356,6018
subtest28of10,pubtest282of100,1,323,5641,23,394,6058
subtest27of10,pubtest283of100,1,323,5430,11,39,5480
subtest23of10,pubtest283of100,1,323,5430,16,74,5520
subtest24of10,pubtest283of100,1,323,5430,16,113,5559
subtest22of10,pubtest283of100,1,323,5430,18,152,5600
subtest25of10,pubtest283of100,1,323,5430,18,191,5639
subtest28of10,pubtest283of100,1,323,5430,18,230,5678
subtest210of10,pubtest283of100,1,323,5430,22,267,5719
subtest26of10,pubtest283of100,1,323,5430,22,307,5759
subtest21of10,pubtest283of100,1,323,5430,18,348,5796
subtest29of10,pubtest283of100,1,323,5430,24,385,5839
subtest22of10,pubtest284of100,1,323,5265,11,40,5316
subtest25of10,pubtest284of100,1,323,5265,12,78,5355
subtest210of10,pubtest284of100,1,323,5265,14,116,5395
subtest29of10,pubtest284of100,1,323,5265,17,152,5434
subtest27of10,pubtest284of100,1,323,5265,21,189,5475
subtest23of10,pubtest284of100,1,323,5265,23,227,5515
subtest24of10,pubtest284of100,1,323,5265,26,264,5555
subtest21of10,pubtest284of100,1,323,5265,27,303,5595
subtest28of10,pubtest284of100,1,323,5265,28,343,5636
subtest26of10,pubtest284of100,1,323,5265,31,379,5675
subtest210of10,pubtest285of100,1,323,5429,112,41,5582
subtest28of10,pubtest285of100,1,323,5429,113,79,5621
subtest27of10,pubtest285of100,1,323,5429,114,118,5661
subtest29of10,pubtest285of100,1,323,5429,114,158,5701
subtest26of10,pubtest285of100,1,323,5429,111,202,5742
subtest23of10,pubtest285of100,1,323,5429,111,241,5781
subtest24of10,pubtest285of100,1,323,5429,115,277,5821
subtest22of10,pubtest285of100,1,323,5429,116,316,5861
subtest21of10,pubtest285of100,1,323,5429,117,355,5901
subtest25of10,pubtest285of100,1,323,5429,118,394,5941
subtest23of10,pubtest286of100,1,323,5301,9,38,5348
subtest210of10,pubtest286of100,1,323,5301,11,75,5387
subtest25of10,pubtest286of100,1,323,5301,15,111,5427
subtest24of10,pubtest286of100,1,323,5301,19,147,5467
subtest29of10,pubtest286of100,1,323,5301,19,187,5507
subtest26of10,pubtest286of100,1,323,5301,21,225,5547
subtest27of10,pubtest286of100,1,323,5301,21,265,5587
subtest22of10,pubtest286of100,1,323,5301,22,304,5627
subtest21of10,pubtest286of100,1,323,5301,22,344,5667
subtest28of10,pubtest286of100,1,323,5301,26,380,5707
subtest29of10,pubtest287of100,1,323,5193,16,41,5250
subtest27of10,pubtest287of100,1,323,5193,16,81,5290
subtest25of10,pubtest287of100,1,323,5193,18,118,5329
subtest21of10,pubtest287of100,1,323,5193,18,158,5369
subtest23of10,pubtest287of100,1,323,5193,20,196,5409
subtest210of10,pubtest287of100,1,323,5193,23,233,5449
subtest24of10,pubtest287of100,1,323,5193,25,271,5489
subtest22of10,pubtest287of100,1,323,5193,25,311,5529
subtest28of10,pubtest287of100,1,323,5193,24,350,5567
subtest26of10,pubtest287of100,1,323,5193,20,396,5609
subtest29of10,pubtest288of100,1,323,5323,10,42,5375
subtest26of10,pubtest288of100,1,323,5323,15,76,5414
subtest23of10,pubtest288of100,1,323,5323,19,112,5454
subtest27of10,pubtest288of100,1,323,5323,17,152,5492
subtest25of10,pubtest288of100,1,323,5323,16,191,5530
subtest21of10,pubtest288of100,1,323,5323,21,230,5574
subtest22of10,pubtest288of100,1,323,5323,22,269,5614
subtest210of10,pubtest288of100,1,323,5323,23,308,5654
subtest24of10,pubtest288of100,1,323,5323,24,347,5694
subtest28of10,pubtest288of100,1,323,5323,26,386,5735
subtest29of10,pubtest289of100,1,323,5227,11,42,5280
subtest210of10,pubtest289of100,1,323,5227,11,79,5317
subtest23of10,pubtest289of100,1,323,5227,14,117,5358
subtest24of10,pubtest289of100,1,323,5227,14,157,5398
subtest26of10,pubtest289of100,1,323,5227,15,196,5438
subtest25of10,pubtest289of100,1,323,5227,16,237,5480
subtest27of10,pubtest289of100,1,323,5227,18,274,5519
subtest28of10,pubtest289of100,1,323,5227,30,301,5558
subtest21of10,pubtest289of100,1,323,5227,30,341,5598
subtest22of10,pubtest289of100,1,323,5227,31,380,5638
subtest29of10,pubtest290of100,1,323,5182,13,45,5240
subtest23of10,pubtest290of100,1,323,5182,14,83,5279
subtest25of10,pubtest290of100,1,323,5182,15,123,5320
subtest22of10,pubtest290of100,1,323,5182,14,162,5358
subtest26of10,pubtest290of100,1,323,5182,20,198,5400
subtest27of10,pubtest290of100,1,323,5182,21,236,5439
subtest24of10,pubtest290of100,1,323,5182,23,275,5480
subtest28of10,pubtest290of100,1,323,5182,23,315,5520
subtest21of10,pubtest290of100,1,323,5182,22,352,5556
subtest210of10,pubtest290of100,1,323,5182,26,392,5600
subtest24of10,pubtest291of100,1,323,5314,11,40,5365
subtest28of10,pubtest291of100,1,323,5314,13,77,5404
subtest23of10,pubtest291of100,1,323,5314,15,115,5444
subtest210of10,pubtest291of100,1,323,5314,16,154,5484
subtest22of10,pubtest291of100,1,323,5314,19,190,5523
subtest29of10,pubtest291of100,1,323,5314,20,230,5564
subtest27of10,pubtest291of100,1,323,5314,17,269,5600
subtest26of10,pubtest291of100,1,323,5314,21,309,5644
subtest25of10,pubtest291of100,1,323,5314,21,347,5682
subtest21of10,pubtest291of100,1,323,5314,23,387,5724
subtest28of10,pubtest292of100,1,323,5258,13,41,5312
subtest29of10,pubtest292of100,1,323,5258,15,77,5350
subtest21of10,pubtest292of100,1,323,5258,17,115,5390
subtest25of10,pubtest292of100,1,323,5258,19,154,5431
subtest27of10,pubtest292of100,1,323,5258,19,194,5471
subtest22of10,pubtest292of100,1,323,5258,26,227,5511
subtest26of10,pubtest292of100,1,323,5258,26,269,5553
subtest24of10,pubtest292of100,1,323,5258,49,284,5591
subtest23of10,pubtest292of100,1,323,5258,50,323,5631
subtest210of10,pubtest292of100,1,323,5258,51,362,5671
subtest24of10,pubtest293of100,1,323,5254,15,40,5309
subtest25of10,pubtest293of100,1,323,5254,16,78,5348
subtest23of10,pubtest293of100,1,323,5254,18,116,5388
subtest28of10,pubtest293of100,1,323,5254,18,156,5428
subtest210of10,pubtest293of100,1,323,5254,22,192,5468
subtest27of10,pubtest293of100,1,323,5254,22,232,5508
subtest26of10,pubtest293of100,1,323,5254,24,270,5548
subtest21of10,pubtest293of100,1,323,5254,26,308,5588
subtest22of10,pubtest293of100,1,323,5254,27,347,5628
subtest29of10,pubtest293of100,1,323,5254,29,384,5667
subtest21of10,pubtest294of100,1,323,5253,15,42,5310
subtest29of10,pubtest294of100,1,323,5253,16,79,5348
subtest210of10,pubtest294of100,1,323,5253,17,119,5389
subtest27of10,pubtest294of100,1,323,5253,18,158,5429
subtest23of10,pubtest294of100,1,323,5253,19,195,5467
subtest25of10,pubtest294of100,1,323,5253,16,235,5504
subtest26of10,pubtest294of100,1,323,5253,25,271,5549
subtest24of10,pubtest294of100,1,323,5253,26,310,5589
subtest22of10,pubtest294of100,1,323,5253,27,349,5629
subtest28of10,pubtest294of100,1,323,5253,29,387,5669
subtest25of10,pubtest295of100,1,323,5196,14,50,5260
subtest24of10,pubtest295of100,1,323,5196,15,89,5300
subtest23of10,pubtest295of100,1,323,5196,16,127,5339
subtest22of10,pubtest295of100,1,323,5196,20,163,5379
subtest21of10,pubtest295of100,1,323,5196,22,202,5420
subtest29of10,pubtest295of100,1,323,5196,23,240,5459
subtest210of10,pubtest295of100,1,323,5196,23,278,5497
subtest26of10,pubtest295of100,1,323,5196,25,317,5538
subtest28of10,pubtest295of100,1,323,5196,24,358,5578
subtest27of10,pubtest295of100,1,323,5196,24,397,5617
subtest25of10,pubtest296of100,1,322,5272,10,40,5322
subtest24of10,pubtest296of100,1,322,5272,11,80,5363
subtest26of10,pubtest296of100,1,322,5272,14,116,5402
subtest27of10,pubtest296of100,1,322,5272,15,155,5442
subtest23of10,pubtest296of100,1,322,5272,16,194,5482
subtest29of10,pubtest296of100,1,322,5272,17,233,5522
subtest21of10,pubtest296of100,1,322,5272,18,272,5562
subtest28of10,pubtest296of100,1,322,5272,21,309,5602
subtest22of10,pubtest296of100,1,322,5272,23,347,5642
subtest210of10,pubtest296of100,1,322,5272,23,387,5682
subtest25of10,pubtest297of100,1,323,6829,12,42,6883
subtest210of10,pubtest297of100,1,323,6829,14,79,6922
subtest29of10,pubtest297of100,1,323,6829,18,115,6962
subtest22of10,pubtest297of100,1,323,6829,19,154,7002
subtest23of10,pubtest297of100,1,323,6829,20,193,7042
subtest27of10,pubtest297of100,1,323,6829,20,233,7082
subtest21of10,pubtest297of100,1,323,6829,22,271,7122
subtest28of10,pubtest297of100,1,323,6829,26,307,7162
subtest26of10,pubtest297of100,1,323,6829,26,347,7202
subtest24of10,pubtest297of100,1,323,6829,28,385,7242
subtest29of10,pubtest298of100,1,323,8093,13,42,8148
subtest22of10,pubtest298of100,1,323,8093,14,81,8188
subtest25of10,pubtest298of100,1,323,8093,15,119,8227
subtest24of10,pubtest298of100,1,323,8093,16,156,8265
subtest23of10,pubtest298of100,1,323,8093,19,194,8306
subtest210of10,pubtest298of100,1,323,8093,20,234,8347
subtest21of10,pubtest298of100,1,323,8093,50,244,8387
subtest27of10,pubtest298of100,1,323,8093,52,282,8427
subtest26of10,pubtest298of100,1,323,8093,55,319,8467
subtest28of10,pubtest298of100,1,323,8093,55,358,8506
subtest22of10,pubtest299of100,1,323,5870,11,42,5923
subtest29of10,pubtest299of100,1,323,5870,14,79,5963
subtest210of10,pubtest299of100,1,323,5870,14,119,6003
subtest27of10,pubtest299of100,1,323,5870,16,158,6044
subtest24of10,pubtest299of100,1,323,5870,19,194,6083
subtest23of10,pubtest299of100,1,323,5870,23,230,6123
subtest28of10,pubtest299of100,1,323,5870,23,270,6163
subtest25of10,pubtest299of100,1,323,5870,25,308,6203
subtest21of10,pubtest299of100,1,323,5870,30,344,6244
subtest26of10,pubtest299of100,1,323,5870,32,381,6283
subtest21of10,pubtest2100of100,1,325,5524,11,125,5660
subtest24of10,pubtest2100of100,1,325,5524,12,163,5699
subtest29of10,pubtest2100of100,1,325,5524,14,203,5741
subtest22of10,pubtest2100of100,1,325,5524,15,241,5780
subtest23of10,pubtest2100of100,1,325,5524,23,273,5820
subtest27of10,pubtest2100of100,1,325,5524,23,314,5861
subtest28of10,pubtest2100of100,1,325,5524,26,350,5900
subtest25of10,pubtest2100of100,1,325,5524,26,388,5938
subtest210of10,pubtest2100of100,1,325,5524,29,427,5980
subtest26of10,pubtest2100of100,1,325,5524,33,463,6020
subtest27of10,pubtest21of100,1,322,10249,14,40,10303
subtest26of10,pubtest21of100,1,322,10249,15,78,10342
subtest29of10,pubtest21of100,1,322,10249,17,116,10382
subtest24of10,pubtest21of100,1,322,10249,19,154,10422
subtest21of10,pubtest21of100,1,322,10249,28,185,10462
subtest22of10,pubtest21of100,1,322,10249,30,223,10502
subtest23of10,pubtest21of100,1,322,10249,30,263,10542
subtest210of10,pubtest21of100,1,322,10249,28,305,10582
subtest25of10,pubtest21of100,1,322,10249,26,342,10617
subtest28of10,pubtest21of100,1,322,10249,32,381,10662
subtest29of10,pubtest22of100,1,321,5285,8,39,5332
subtest24of10,pubtest22of100,1,321,5285,16,70,5371
subtest23of10,pubtest22of100,1,321,5285,18,108,5411
subtest27of10,pubtest22of100,1,321,5285,18,148,5451
subtest28of10,pubtest22of100,1,321,5285,17,187,5489
subtest25of10,pubtest22of100,1,321,5285,21,225,5531
subtest21of10,pubtest22of100,1,321,5285,25,263,5573
subtest26of10,pubtest22of100,1,321,5285,25,302,5612
subtest22of10,pubtest22of100,1,321,5285,26,339,5650
subtest210of10,pubtest22of100,1,321,5285,27,379,5691
subtest23of10,pubtest23of100,1,321,5300,13,41,5354
subtest28of10,pubtest23of100,1,321,5300,13,80,5393
subtest29of10,pubtest23of100,1,321,5300,15,118,5433
subtest24of10,pubtest23of100,1,321,5300,17,156,5473
subtest26of10,pubtest23of100,1,321,5300,21,192,5513
subtest27of10,pubtest23of100,1,321,5300,27,226,5553
subtest22of10,pubtest23of100,1,321,5300,28,265,5593
subtest210of10,pubtest23of100,1,321,5300,29,304,5633
subtest25of10,pubtest23of100,1,321,5300,30,343,5673
subtest21of10,pubtest23of100,1,321,5300,36,377,5713
subtest23of10,pubtest24of100,1,321,5345,8,43,5396
subtest24of10,pubtest24of100,1,321,5345,16,73,5434
subtest25of10,pubtest24of100,1,321,5345,16,113,5474
subtest21of10,pubtest24of100,1,321,5345,17,152,5514
subtest28of10,pubtest24of100,1,321,5345,22,185,5552
subtest22of10,pubtest24of100,1,321,5345,25,224,5594
subtest27of10,pubtest24of100,1,321,5345,25,264,5634
subtest29of10,pubtest24of100,1,321,5345,22,303,5670
subtest210of10,pubtest24of100,1,321,5345,26,343,5714
subtest26of10,pubtest24of100,1,321,5345,28,381,5754
subtest27of10,pubtest25of100,1,321,5281,21,40,5342
subtest28of10,pubtest25of100,1,321,5281,19,82,5382
subtest26of10,pubtest25of100,1,321,5281,22,120,5423
subtest210of10,pubtest25of100,1,321,5281,23,158,5462
subtest25of10,pubtest25of100,1,321,5281,24,197,5502
subtest22of10,pubtest25of100,1,321,5281,25,237,5543
subtest21of10,pubtest25of100,1,321,5281,19,276,5576
subtest23of10,pubtest25of100,1,321,5281,25,315,5621
subtest29of10,pubtest25of100,1,321,5281,27,354,5662
subtest24of10,pubtest25of100,1,321,5281,34,387,5702
subtest21of10,pubtest26of100,1,321,5322,10,38,5370
subtest29of10,pubtest26of100,1,321,5322,15,73,5410
subtest22of10,pubtest26of100,1,321,5322,16,112,5450
subtest23of10,pubtest26of100,1,321,5322,17,152,5491
subtest26of10,pubtest26of100,1,321,5322,21,187,5530
subtest27of10,pubtest26of100,1,321,5322,22,226,5570
subtest25of10,pubtest26of100,1,321,5322,25,264,5611
subtest210of10,pubtest26of100,1,321,5322,25,303,5650
subtest24of10,pubtest26of100,1,321,5322,28,340,5690
subtest28of10,pubtest26of100,1,321,5322,28,380,5730
subtest27of10,pubtest27of100,1,320,5229,10,40,5279
subtest23of10,pubtest27of100,1,320,5229,16,73,5318
subtest28of10,pubtest27of100,1,320,5229,15,113,5357
subtest29of10,pubtest27of100,1,320,5229,22,148,5399
subtest210of10,pubtest27of100,1,320,5229,22,187,5438
subtest25of10,pubtest27of100,1,320,5229,22,226,5477
subtest24of10,pubtest27of100,1,320,5229,19,265,5513
subtest21of10,pubtest27of100,1,320,5229,24,304,5557
subtest26of10,pubtest27of100,1,320,5229,24,343,5596
subtest22of10,pubtest27of100,1,320,5229,23,384,5636
subtest27of10,pubtest28of100,1,321,5184,13,40,5237
subtest21of10,pubtest28of100,1,321,5184,19,73,5276
subtest29of10,pubtest28of100,1,321,5184,21,111,5316
subtest28of10,pubtest28of100,1,321,5184,21,151,5356
subtest23of10,pubtest28of100,1,321,5184,24,188,5396
subtest210of10,pubtest28of100,1,321,5184,25,227,5436
subtest25of10,pubtest28of100,1,321,5184,26,265,5475
subtest26of10,pubtest28of100,1,321,5184,27,305,5516
subtest24of10,pubtest28of100,1,321,5184,28,344,5556
subtest22of10,pubtest28of100,1,321,5184,29,381,5594
subtest23of10,pubtest29of100,1,321,5245,10,42,5297
subtest29of10,pubtest29of100,1,321,5245,19,72,5336
subtest210of10,pubtest29of100,1,321,5245,19,112,5376
subtest21of10,pubtest29of100,1,321,5245,21,150,5416
subtest28of10,pubtest29of100,1,321,5245,21,190,5456
subtest25of10,pubtest29of100,1,321,5245,22,226,5493
subtest22of10,pubtest29of100,1,321,5245,22,266,5533
subtest24of10,pubtest29of100,1,321,5245,24,305,5574
subtest26of10,pubtest29of100,1,321,5245,26,345,5616
subtest27of10,pubtest29of100,1,321,5245,24,384,5653
subtest29of10,pubtest210of100,1,323,5346,9,47,5402
subtest21of10,pubtest210of100,1,323,5346,11,86,5443
subtest27of10,pubtest210of100,1,323,5346,14,122,5482
subtest210of10,pubtest210of100,1,323,5346,21,155,5522
subtest23of10,pubtest210of100,1,323,5346,22,194,5562
subtest25of10,pubtest210of100,1,323,5346,26,230,5602
subtest24of10,pubtest210of100,1,323,5346,34,262,5642
subtest28of10,pubtest210of100,1,323,5346,34,302,5682
subtest26of10,pubtest210of100,1,323,5346,35,340,5721
subtest22of10,pubtest210of100,1,323,5346,35,380,5761
subtest210of10,pubtest211of100,1,323,5288,13,43,5344
subtest24of10,pubtest211of100,1,323,5288,15,78,5381
subtest29of10,pubtest211of100,1,323,5288,18,115,5421
subtest22of10,pubtest211of100,1,323,5288,19,154,5461
subtest21of10,pubtest211of100,1,323,5288,21,192,5501
subtest25of10,pubtest211of100,1,323,5288,24,229,5541
subtest26of10,pubtest211of100,1,323,5288,25,268,5581
subtest27of10,pubtest211of100,1,323,5288,29,304,5621
subtest23of10,pubtest211of100,1,323,5288,29,345,5662
subtest28of10,pubtest211of100,1,323,5288,42,371,5701
subtest25of10,pubtest212of100,1,323,5259,11,40,5310
subtest28of10,pubtest212of100,1,323,5259,19,72,5350
subtest23of10,pubtest212of100,1,323,5259,19,111,5389
subtest29of10,pubtest212of100,1,323,5259,19,152,5430
subtest27of10,pubtest212of100,1,323,5259,26,184,5469
subtest24of10,pubtest212of100,1,323,5259,27,223,5509
subtest22of10,pubtest212of100,1,323,5259,28,263,5550
subtest21of10,pubtest212of100,1,323,5259,26,302,5587
subtest26of10,pubtest212of100,1,323,5259,29,341,5629
subtest210of10,pubtest212of100,1,323,5259,57,353,5669
subtest23of10,pubtest213of100,1,322,5772,14,41,5827
subtest26of10,pubtest213of100,1,322,5772,15,79,5866
subtest29of10,pubtest213of100,1,322,5772,16,118,5906
subtest22of10,pubtest213of100,1,322,5772,20,154,5946
subtest27of10,pubtest213of100,1,322,5772,26,188,5986
subtest21of10,pubtest213of100,1,322,5772,26,228,6026
subtest24of10,pubtest213of100,1,322,5772,27,265,6064
subtest210of10,pubtest213of100,1,322,5772,32,302,6106
subtest25of10,pubtest213of100,1,322,5772,32,342,6146
subtest28of10,pubtest213of100,1,322,5772,37,377,6186
subtest21of10,pubtest214of100,1,323,6017,12,41,6070
subtest25of10,pubtest214of100,1,323,6017,19,73,6109
subtest23of10,pubtest214of100,1,323,6017,16,112,6145
subtest26of10,pubtest214of100,1,323,6017,18,153,6188
subtest29of10,pubtest214of100,1,323,6017,23,189,6229
subtest27of10,pubtest214of100,1,323,6017,23,229,6269
subtest22of10,pubtest214of100,1,323,6017,24,268,6309
subtest24of10,pubtest214of100,1,323,6017,25,308,6350
subtest210of10,pubtest214of100,1,323,6017,26,346,6389
subtest28of10,pubtest214of100,1,323,6017,26,386,6429
subtest27of10,pubtest215of100,1,323,5192,7,41,5240
subtest21of10,pubtest215of100,1,323,5192,14,73,5279
subtest29of10,pubtest215of100,1,323,5192,14,112,5318
subtest25of10,pubtest215of100,1,323,5192,18,149,5359
subtest24of10,pubtest215of100,1,323,5192,44,162,5398
subtest23of10,pubtest215of100,1,323,5192,44,202,5438
subtest26of10,pubtest215of100,1,323,5192,47,239,5478
subtest210of10,pubtest215of100,1,323,5192,47,279,5518
subtest22of10,pubtest215of100,1,323,5192,52,314,5558
subtest28of10,pubtest215of100,1,323,5192,53,353,5598
subtest24of10,pubtest216of100,1,323,5789,15,38,5842
subtest21of10,pubtest216of100,1,323,5789,15,78,5882
subtest23of10,pubtest216of100,1,323,5789,18,114,5921
subtest27of10,pubtest216of100,1,323,5789,18,154,5961
subtest28of10,pubtest216of100,1,323,5789,20,194,6003
subtest25of10,pubtest216of100,1,323,5789,30,223,6042
subtest29of10,pubtest216of100,1,323,5789,32,260,6081
subtest22of10,pubtest216of100,1,323,5789,43,289,6121
subtest26of10,pubtest216of100,1,323,5789,45,327,6161
subtest210of10,pubtest216of100,1,323,5789,45,367,6201
subtest27of10,pubtest217of100,1,322,5908,15,49,5972
subtest21of10,pubtest217of100,1,322,5908,17,87,6012
subtest29of10,pubtest217of100,1,322,5908,19,124,6051
subtest26of10,pubtest217of100,1,322,5908,21,163,6092
subtest23of10,pubtest217of100,1,322,5908,19,202,6129
subtest25of10,pubtest217of100,1,322,5908,22,242,6172
subtest24of10,pubtest217of100,1,322,5908,19,277,6204
subtest28of10,pubtest217of100,1,322,5908,23,316,6247
subtest22of10,pubtest217of100,1,322,5908,16,356,6280
subtest210of10,pubtest217of100,1,322,5908,29,394,6331
subtest29of10,pubtest218of100,1,323,5511,12,41,5564
subtest22of10,pubtest218of100,1,323,5511,12,80,5603
subtest21of10,pubtest218of100,1,323,5511,14,117,5642
subtest27of10,pubtest218of100,1,323,5511,18,156,5685
subtest23of10,pubtest218of100,1,323,5511,23,190,5724
subtest28of10,pubtest218of100,1,323,5511,23,229,5763
subtest25of10,pubtest218of100,1,323,5511,27,265,5803
subtest24of10,pubtest218of100,1,323,5511,29,303,5843
subtest26of10,pubtest218of100,1,323,5511,31,341,5883
subtest210of10,pubtest218of100,1,323,5511,31,379,5921
subtest210of10,pubtest219of100,1,323,5936,12,39,5987
subtest25of10,pubtest219of100,1,323,5936,16,74,6026
subtest26of10,pubtest219of100,1,323,5936,17,113,6066
subtest21of10,pubtest219of100,1,323,5936,17,154,6107
subtest22of10,pubtest219of100,1,323,5936,17,191,6144
subtest24of10,pubtest219of100,1,323,5936,25,225,6186
subtest29of10,pubtest219of100,1,323,5936,25,265,6226
subtest23of10,pubtest219of100,1,323,5936,29,301,6266
subtest27of10,pubtest219of100,1,323,5936,29,341,6306
subtest28of10,pubtest219of100,1,323,5936,31,379,6346
subtest25of10,pubtest220of100,1,323,5769,9,418,6196
subtest23of10,pubtest220of100,1,323,5769,17,449,6235
subtest210of10,pubtest220of100,1,323,5769,18,486,6273
subtest29of10,pubtest220of100,1,323,5769,20,526,6315
subtest24of10,pubtest220of100,1,323,5769,21,566,6356
subtest21of10,pubtest220of100,1,323,5769,24,602,6395
subtest27of10,pubtest220of100,1,323,5769,24,641,6434
subtest22of10,pubtest220of100,1,323,5769,26,680,6475
subtest28of10,pubtest220of100,1,323,5769,26,720,6515
subtest26of10,pubtest220of100,1,323,5769,27,759,6555
subtest24of10,pubtest221of100,1,323,5391,10,43,5444
subtest21of10,pubtest221of100,1,323,5391,11,80,5482
subtest23of10,pubtest221of100,1,323,5391,12,119,5522
subtest28of10,pubtest221of100,1,323,5391,13,158,5562
subtest25of10,pubtest221of100,1,323,5391,14,197,5602
subtest22of10,pubtest221of100,1,323,5391,22,229,5642
subtest29of10,pubtest221of100,1,323,5391,22,267,5680
subtest210of10,pubtest221of100,1,323,5391,25,306,5722
subtest26of10,pubtest221of100,1,323,5391,26,345,5762
subtest27of10,pubtest221of100,1,323,5391,27,384,5802
subtest21of10,pubtest222of100,1,323,5383,13,40,5436
subtest22of10,pubtest222of100,1,323,5383,14,77,5474
subtest29of10,pubtest222of100,1,323,5383,16,114,5513
subtest27of10,pubtest222of100,1,323,5383,20,152,5555
subtest23of10,pubtest222of100,1,323,5383,20,192,5595
subtest28of10,pubtest222of100,1,323,5383,22,230,5635
subtest25of10,pubtest222of100,1,323,5383,24,269,5676
subtest26of10,pubtest222of100,1,323,5383,24,307,5714
subtest210of10,pubtest222of100,1,323,5383,23,346,5752
subtest24of10,pubtest222of100,1,323,5383,25,387,5795
subtest21of10,pubtest223of100,1,323,5941,15,40,5996
subtest24of10,pubtest223of100,1,323,5941,17,77,6035
subtest23of10,pubtest223of100,1,323,5941,18,115,6074
subtest29of10,pubtest223of100,1,323,5941,19,155,6115
subtest28of10,pubtest223of100,1,323,5941,17,194,6152
subtest27of10,pubtest223of100,1,323,5941,20,233,6194
subtest210of10,pubtest223of100,1,323,5941,21,273,6235
subtest25of10,pubtest223of100,1,323,5941,29,303,6273
subtest26of10,pubtest223of100,1,323,5941,31,343,6315
subtest22of10,pubtest223of100,1,323,5941,31,382,6354
subtest21of10,pubtest224of100,1,323,5645,10,42,5697
subtest27of10,pubtest224of100,1,323,5645,11,80,5736
subtest28of10,pubtest224of100,1,323,5645,14,116,5775
subtest23of10,pubtest224of100,1,323,5645,13,156,5814
subtest26of10,pubtest224of100,1,323,5645,23,188,5856
subtest29of10,pubtest224of100,1,323,5645,24,227,5896
subtest25of10,pubtest224of100,1,323,5645,25,268,5938
subtest22of10,pubtest224of100,1,323,5645,27,305,5977
subtest24of10,pubtest224of100,1,323,5645,31,340,6016
subtest210of10,pubtest224of100,1,323,5645,31,380,6056
subtest27of10,pubtest225of100,1,323,5436,10,40,5486
subtest22of10,pubtest225of100,1,323,5436,13,76,5525
subtest26of10,pubtest225of100,1,323,5436,15,114,5565
subtest21of10,pubtest225of100,1,323,5436,17,152,5605
subtest24of10,pubtest225of100,1,323,5436,21,188,5645
subtest25of10,pubtest225of100,1,323,5436,24,225,5685
subtest23of10,pubtest225of100,1,323,5436,24,265,5725
subtest29of10,pubtest225of100,1,323,5436,26,303,5765
subtest28of10,pubtest225of100,1,323,5436,26,343,5805
subtest210of10,pubtest225of100,1,323,5436,29,380,5845
subtest25of10,pubtest226of100,1,323,5638,12,40,5690
subtest22of10,pubtest226of100,1,323,5638,13,78,5729
subtest210of10,pubtest226of100,1,323,5638,14,117,5769
subtest23of10,pubtest226of100,1,323,5638,22,149,5809
subtest27of10,pubtest226of100,1,323,5638,23,189,5850
subtest21of10,pubtest226of100,1,323,5638,25,226,5889
subtest28of10,pubtest226of100,1,323,5638,26,265,5929
subtest29of10,pubtest226of100,1,323,5638,27,304,5969
subtest24of10,pubtest226of100,1,323,5638,31,340,6009
subtest26of10,pubtest226of100,1,323,5638,30,380,6048
subtest29of10,pubtest227of100,1,323,6166,11,41,6218
subtest210of10,pubtest227of100,1,323,6166,16,76,6258
subtest25of10,pubtest227of100,1,323,6166,18,114,6298
subtest24of10,pubtest227of100,1,323,6166,19,153,6338
subtest23of10,pubtest227of100,1,323,6166,23,189,6378
subtest26of10,pubtest227of100,1,323,6166,23,229,6418
subtest22of10,pubtest227of100,1,323,6166,24,266,6456
subtest27of10,pubtest227of100,1,323,6166,24,305,6495
subtest21of10,pubtest227of100,1,323,6166,28,344,6538
subtest28of10,pubtest227of100,1,323,6166,27,384,6577
subtest21of10,pubtest228of100,1,323,5243,11,227,5481
subtest26of10,pubtest228of100,1,323,5243,13,264,5520
subtest25of10,pubtest228of100,1,323,5243,14,304,5561
subtest27of10,pubtest228of100,1,323,5243,18,340,5601
subtest23of10,pubtest228of100,1,323,5243,18,380,5641
subtest24of10,pubtest228of100,1,323,5243,21,417,5681
subtest29of10,pubtest228of100,1,323,5243,24,454,5721
subtest210of10,pubtest228of100,1,323,5243,24,494,5761
subtest28of10,pubtest228of100,1,323,5243,26,532,5801
subtest22of10,pubtest228of100,1,323,5243,26,572,5841
subtest24of10,pubtest229of100,1,321,5281,16,57,5354
subtest21of10,pubtest229of100,1,321,5281,16,95,5392
subtest22of10,pubtest229of100,1,321,5281,18,135,5434
subtest23of10,pubtest229of100,1,321,5281,19,173,5473
subtest27of10,pubtest229of100,1,321,5281,18,213,5512
subtest28of10,pubtest229of100,1,321,5281,18,253,5552
subtest25of10,pubtest229of100,1,321,5281,23,289,5593
subtest29of10,pubtest229of100,1,321,5281,23,330,5634
subtest210of10,pubtest229of100,1,321,5281,25,367,5673
subtest26of10,pubtest229of100,1,321,5281,54,378,5713
subtest21of10,pubtest230of100,1,323,6185,12,42,6239
subtest27of10,pubtest230of100,1,323,6185,20,75,6280
subtest29of10,pubtest230of100,1,323,6185,20,114,6319
subtest22of10,pubtest230of100,1,323,6185,20,152,6357
subtest25of10,pubtest230of100,1,323,6185,22,191,6398
subtest28of10,pubtest230of100,1,323,6185,26,227,6438
subtest23of10,pubtest230of100,1,323,6185,26,266,6477
subtest26of10,pubtest230of100,1,323,6185,28,305,6518
subtest210of10,pubtest230of100,1,323,6185,28,345,6558
subtest24of10,pubtest230of100,1,323,6185,30,383,6598
subtest23of10,pubtest231of100,1,323,6006,11,38,6055
subtest28of10,pubtest231of100,1,323,6006,14,75,6095
subtest25of10,pubtest231of100,1,323,6006,14,115,6135
subtest29of10,pubtest231of100,1,323,6006,16,153,6175
subtest24of10,pubtest231of100,1,323,6006,16,193,6215
subtest26of10,pubtest231of100,1,323,6006,19,230,6255
subtest210of10,pubtest231of100,1,323,6006,19,270,6295
subtest21of10,pubtest231of100,1,323,6006,21,308,6335
subtest27of10,pubtest231of100,1,323,6006,19,348,6373
subtest22of10,pubtest231of100,1,323,6006,21,387,6414
subtest21of10,pubtest232of100,1,323,5419,12,41,5472
subtest27of10,pubtest232of100,1,323,5419,13,79,5511
subtest22of10,pubtest232of100,1,323,5419,16,116,5551
subtest23of10,pubtest232of100,1,323,5419,21,151,5591
subtest29of10,pubtest232of100,1,323,5419,25,187,5631
subtest28of10,pubtest232of100,1,323,5419,27,225,5671
subtest26of10,pubtest232of100,1,323,5419,29,263,5711
subtest24of10,pubtest232of100,1,323,5419,30,303,5752
subtest25of10,pubtest232of100,1,323,5419,28,342,5789
subtest210of10,pubtest232of100,1,323,5419,29,380,5828
subtest24of10,pubtest233of100,1,323,5390,13,38,5441
subtest29of10,pubtest233of100,1,323,5390,14,77,5481
subtest25of10,pubtest233of100,1,323,5390,15,116,5521
subtest210of10,pubtest233of100,1,323,5390,17,154,5561
subtest27of10,pubtest233of100,1,323,5390,17,194,5601
subtest26of10,pubtest233of100,1,323,5390,20,231,5641
subtest22of10,pubtest233of100,1,323,5390,23,268,5681
subtest21of10,pubtest233of100,1,323,5390,23,308,5721
subtest23of10,pubtest233of100,1,323,5390,23,347,5760
subtest28of10,pubtest233of100,1,323,5390,25,386,5801
subtest26of10,pubtest234of100,1,323,5832,12,41,5885
subtest25of10,pubtest234of100,1,323,5832,12,80,5924
subtest27of10,pubtest234of100,1,323,5832,15,117,5964
subtest22of10,pubtest234of100,1,323,5832,15,157,6004
subtest21of10,pubtest234of100,1,323,5832,39,173,6044
subtest29of10,pubtest234of100,1,323,5832,40,212,6084
subtest23of10,pubtest234of100,1,323,5832,41,253,6126
subtest210of10,pubtest234of100,1,323,5832,42,292,6166
subtest28of10,pubtest234of100,1,323,5832,74,298,6204
subtest24of10,pubtest234of100,1,323,5832,74,338,6244
subtest21of10,pubtest235of100,1,321,5925,11,40,5976
subtest23of10,pubtest235of100,1,321,5925,12,78,6015
subtest27of10,pubtest235of100,1,321,5925,19,110,6054
subtest210of10,pubtest235of100,1,321,5925,18,150,6093
subtest22of10,pubtest235of100,1,321,5925,18,189,6132
subtest24of10,pubtest235of100,1,321,5925,20,229,6174
subtest29of10,pubtest235of100,1,321,5925,22,266,6213
subtest25of10,pubtest235of100,1,321,5925,22,306,6253
subtest28of10,pubtest235of100,1,321,5925,24,345,6294
subtest26of10,pubtest235of100,1,321,5925,24,385,6334
subtest210of10,pubtest236of100,1,323,5798,13,41,5852
subtest23of10,pubtest236of100,1,323,5798,14,81,5893
subtest28of10,pubtest236of100,1,323,5798,16,118,5932
subtest25of10,pubtest236of100,1,323,5798,19,155,5972
subtest27of10,pubtest236of100,1,323,5798,19,195,6012
subtest21of10,pubtest236of100,1,323,5798,21,234,6053
subtest29of10,pubtest236of100,1,323,5798,22,272,6092
subtest24of10,pubtest236of100,1,323,5798,27,306,6131
subtest26of10,pubtest236of100,1,323,5798,30,344,6172
subtest22of10,pubtest236of100,1,323,5798,32,383,6213
subtest23of10,pubtest237of100,1,323,5684,8,38,5730
subtest25of10,pubtest237of100,1,323,5684,9,76,5769
subtest27of10,pubtest237of100,1,323,5684,11,115,5810
subtest29of10,pubtest237of100,1,323,5684,27,137,5848
subtest21of10,pubtest237of100,1,323,5684,28,175,5887
subtest28of10,pubtest237of100,1,323,5684,31,214,5929
subtest22of10,pubtest237of100,1,323,5684,32,253,5969
subtest26of10,pubtest237of100,1,323,5684,31,292,6007
subtest210of10,pubtest237of100,1,323,5684,33,332,6049
subtest24of10,pubtest237of100,1,323,5684,31,371,6086
subtest27of10,pubtest238of100,1,323,5593,15,41,5649
subtest29of10,pubtest238of100,1,323,5593,15,80,5688
subtest22of10,pubtest238of100,1,323,5593,12,123,5728
subtest25of10,pubtest238of100,1,323,5593,19,156,5768
subtest23of10,pubtest238of100,1,323,5593,19,196,5808
subtest28of10,pubtest238of100,1,323,5593,20,236,5849
subtest26of10,pubtest238of100,1,323,5593,25,270,5888
subtest210of10,pubtest238of100,1,323,5593,24,310,5927
subtest24of10,pubtest238of100,1,323,5593,26,349,5968
subtest21of10,pubtest238of100,1,323,5593,25,388,6006
subtest21of10,pubtest239of100,1,323,6010,10,102,6122
subtest27of10,pubtest239of100,1,323,6010,17,135,6162
subtest28of10,pubtest239of100,1,323,6010,18,174,6202
subtest25of10,pubtest239of100,1,323,6010,21,210,6241
subtest26of10,pubtest239of100,1,323,6010,21,250,6281
subtest24of10,pubtest239of100,1,323,6010,28,283,6321
subtest29of10,pubtest239of100,1,323,6010,28,323,6361
subtest22of10,pubtest239of100,1,323,6010,31,360,6401
subtest23of10,pubtest239of100,1,323,6010,32,399,6441
subtest210of10,pubtest239of100,1,323,6010,34,436,6480
subtest25of10,pubtest240of100,1,323,5316,11,40,5367
subtest210of10,pubtest240of100,1,323,5316,11,79,5406
subtest21of10,pubtest240of100,1,323,5316,13,117,5446
subtest29of10,pubtest240of100,1,323,5316,14,156,5486
subtest28of10,pubtest240of100,1,323,5316,14,195,5525
subtest23of10,pubtest240of100,1,323,5316,16,235,5567
subtest24of10,pubtest240of100,1,323,5316,19,271,5606
subtest27of10,pubtest240of100,1,323,5316,19,311,5646
subtest22of10,pubtest240of100,1,323,5316,19,350,5685
subtest26of10,pubtest240of100,1,323,5316,17,389,5722
subtest23of10,pubtest241of100,1,323,5264,36,41,5341
subtest27of10,pubtest241of100,1,323,5264,37,80,5381
subtest24of10,pubtest241of100,1,323,5264,42,115,5421
subtest21of10,pubtest241of100,1,323,5264,45,152,5461
subtest210of10,pubtest241of100,1,323,5264,45,192,5501
subtest29of10,pubtest241of100,1,323,5264,47,230,5541
subtest28of10,pubtest241of100,1,323,5264,52,265,5581
subtest25of10,pubtest241of100,1,323,5264,53,305,5622
subtest22of10,pubtest241of100,1,323,5264,54,343,5661
subtest26of10,pubtest241of100,1,323,5264,54,384,5702
subtest27of10,pubtest242of100,1,323,5815,13,42,5870
subtest26of10,pubtest242of100,1,323,5815,13,81,5909
subtest23of10,pubtest242of100,1,323,5815,15,118,5948
subtest25of10,pubtest242of100,1,323,5815,15,158,5988
subtest29of10,pubtest242of100,1,323,5815,16,197,6028
subtest21of10,pubtest242of100,1,323,5815,16,237,6068
subtest210of10,pubtest242of100,1,323,5815,18,275,6108
subtest22of10,pubtest242of100,1,323,5815,21,312,6148
subtest24of10,pubtest242of100,1,323,5815,23,350,6188
subtest28of10,pubtest242of100,1,323,5815,24,389,6228
subtest29of10,pubtest243of100,1,323,5738,8,41,5787
subtest28of10,pubtest243of100,1,323,5738,9,79,5826
subtest22of10,pubtest243of100,1,323,5738,13,115,5866
subtest23of10,pubtest243of100,1,323,5738,14,154,5906
subtest25of10,pubtest243of100,1,323,5738,15,193,5946
subtest27of10,pubtest243of100,1,323,5738,19,227,5984
subtest26of10,pubtest243of100,1,323,5738,19,266,6023
subtest21of10,pubtest243of100,1,323,5738,20,306,6064
subtest24of10,pubtest243of100,1,323,5738,26,342,6106
subtest210of10,pubtest243of100,1,323,5738,29,379,6146
subtest27of10,pubtest244of100,1,323,6175,12,45,6232
subtest25of10,pubtest244of100,1,323,6175,12,84,6271
subtest29of10,pubtest244of100,1,323,6175,17,117,6309
subtest26of10,pubtest244of100,1,323,6175,24,152,6351
subtest21of10,pubtest244of100,1,323,6175,28,187,6390
subtest23of10,pubtest244of100,1,323,6175,29,227,6431
subtest22of10,pubtest244of100,1,323,6175,38,258,6471
subtest28of10,pubtest244of100,1,323,6175,37,298,6510
subtest210of10,pubtest244of100,1,323,6175,37,337,6549
subtest24of10,pubtest244of100,1,323,6175,38,378,6591
subtest29of10,pubtest245of100,1,322,5895,13,38,5946
subtest26of10,pubtest245of100,1,322,5895,37,53,5985
subtest23of10,pubtest245of100,1,322,5895,37,93,6025
subtest22of10,pubtest245of100,1,322,5895,38,132,6065
subtest25of10,pubtest245of100,1,322,5895,40,170,6105
subtest21of10,pubtest245of100,1,322,5895,44,206,6145
subtest24of10,pubtest245of100,1,322,5895,44,246,6185
subtest28of10,pubtest245of100,1,322,5895,46,284,6225
subtest210of10,pubtest245of100,1,322,5895,46,324,6265
subtest27of10,pubtest245of100,1,322,5895,46,363,6304
subtest26of10,pubtest246of100,1,323,5615,12,38,5665
subtest27of10,pubtest246of100,1,323,5615,12,77,5704
subtest21of10,pubtest246of100,1,323,5615,20,109,5744
subtest29of10,pubtest246of100,1,323,5615,20,149,5784
subtest28of10,pubtest246of100,1,323,5615,22,187,5824
subtest25of10,pubtest246of100,1,323,5615,22,227,5864
subtest23of10,pubtest246of100,1,323,5615,23,264,5902
subtest210of10,pubtest246of100,1,323,5615,27,302,5944
subtest24of10,pubtest246of100,1,323,5615,27,342,5984
subtest22of10,pubtest246of100,1,323,5615,29,380,6024
subtest27of10,pubtest247of100,1,323,5493,11,38,5542
subtest23of10,pubtest247of100,1,323,5493,12,77,5582
subtest26of10,pubtest247of100,1,323,5493,15,111,5619
subtest21of10,pubtest247of100,1,323,5493,18,151,5662
subtest22of10,pubtest247of100,1,323,5493,19,189,5701
subtest29of10,pubtest247of100,1,323,5493,19,228,5740
subtest25of10,pubtest247of100,1,323,5493,23,265,5781
subtest28of10,pubtest247of100,1,323,5493,24,306,5823
subtest210of10,pubtest247of100,1,323,5493,30,339,5862
subtest24of10,pubtest247of100,1,323,5493,67,341,5901
subtest29of10,pubtest248of100,1,323,5616,9,40,5665
subtest26of10,pubtest248of100,1,323,5616,19,69,5704
subtest25of10,pubtest248of100,1,323,5616,22,106,5744
subtest23of10,pubtest248of100,1,323,5616,25,143,5784
subtest28of10,pubtest248of100,1,323,5616,26,182,5824
subtest21of10,pubtest248of100,1,323,5616,27,222,5865
subtest27of10,pubtest248of100,1,323,5616,28,261,5905
subtest24of10,pubtest248of100,1,323,5616,28,300,5944
subtest22of10,pubtest248of100,1,323,5616,29,340,5985
subtest210of10,pubtest248of100,1,323,5616,29,379,6024
subtest27of10,pubtest249of100,1,323,5382,13,39,5434
subtest28of10,pubtest249of100,1,323,5382,13,79,5474
subtest25of10,pubtest249of100,1,323,5382,15,116,5513
subtest21of10,pubtest249of100,1,323,5382,17,154,5553
subtest24of10,pubtest249of100,1,323,5382,21,190,5593
subtest29of10,pubtest249of100,1,323,5382,24,225,5631
subtest23of10,pubtest249of100,1,323,5382,27,264,5673
subtest26of10,pubtest249of100,1,323,5382,30,301,5713
subtest22of10,pubtest249of100,1,323,5382,31,340,5753
subtest210of10,pubtest249of100,1,323,5382,32,379,5793
subtest27of10,pubtest250of100,1,323,5358,20,42,5420
subtest28of10,pubtest250of100,1,323,5358,20,81,5459
subtest29of10,pubtest250of100,1,323,5358,23,117,5498
subtest24of10,pubtest250of100,1,323,5358,24,158,5540
subtest25of10,pubtest250of100,1,323,5358,25,196,5579
subtest21of10,pubtest250of100,1,323,5358,23,235,5616
subtest26of10,pubtest250of100,1,323,5358,25,273,5656
subtest22of10,pubtest250of100,1,323,5358,28,313,5699
subtest210of10,pubtest250of100,1,323,5358,26,353,5737
subtest23of10,pubtest250of100,1,323,5358,29,392,5779
subtest23of10,pubtest251of100,1,323,5638,16,39,5693
subtest22of10,pubtest251of100,1,323,5638,18,76,5732
subtest27of10,pubtest251of100,1,323,5638,19,115,5772
subtest24of10,pubtest251of100,1,323,5638,20,154,5812
subtest25of10,pubtest251of100,1,323,5638,25,189,5852
subtest21of10,pubtest251of100,1,323,5638,26,228,5892
subtest28of10,pubtest251of100,1,323,5638,27,267,5932
subtest29of10,pubtest251of100,1,323,5638,28,307,5973
subtest210of10,pubtest251of100,1,323,5638,31,341,6010
subtest26of10,pubtest251of100,1,323,5638,33,381,6052
subtest28of10,pubtest252of100,1,323,5668,12,38,5718
subtest29of10,pubtest252of100,1,323,5668,13,78,5759
subtest21of10,pubtest252of100,1,323,5668,15,115,5798
subtest27of10,pubtest252of100,1,323,5668,16,155,5839
subtest25of10,pubtest252of100,1,323,5668,19,191,5878
subtest26of10,pubtest252of100,1,323,5668,23,227,5918
subtest22of10,pubtest252of100,1,323,5668,23,267,5958
subtest23of10,pubtest252of100,1,323,5668,24,308,6000
subtest24of10,pubtest252of100,1,323,5668,27,343,6038
subtest210of10,pubtest252of100,1,323,5668,27,383,6078
subtest28of10,pubtest253of100,1,322,5430,10,41,5481
subtest23of10,pubtest253of100,1,322,5430,13,77,5520
subtest24of10,pubtest253of100,1,322,5430,15,115,5560
subtest25of10,pubtest253of100,1,322,5430,14,154,5598
subtest29of10,pubtest253of100,1,322,5430,19,191,5640
subtest22of10,pubtest253of100,1,322,5430,20,230,5680
subtest27of10,pubtest253of100,1,322,5430,21,269,5720
subtest21of10,pubtest253of100,1,322,5430,32,298,5760
subtest210of10,pubtest253of100,1,322,5430,35,333,5798
subtest26of10,pubtest253of100,1,322,5430,35,373,5838
subtest210of10,pubtest254of100,1,323,5592,33,42,5667
subtest27of10,pubtest254of100,1,323,5592,34,80,5706
subtest28of10,pubtest254of100,1,323,5592,35,119,5746
subtest21of10,pubtest254of100,1,323,5592,44,150,5786
subtest22of10,pubtest254of100,1,323,5592,48,185,5825
subtest26of10,pubtest254of100,1,323,5592,48,225,5865
subtest23of10,pubtest254of100,1,323,5592,46,264,5902
subtest29of10,pubtest254of100,1,323,5592,48,304,5944
subtest24of10,pubtest254of100,1,323,5592,48,342,5982
subtest25of10,pubtest254of100,1,323,5592,46,382,6020
subtest23of10,pubtest255of100,1,322,5216,17,42,5275
subtest21of10,pubtest255of100,1,322,5216,19,81,5316
subtest29of10,pubtest255of100,1,322,5216,21,119,5356
subtest25of10,pubtest255of100,1,322,5216,22,158,5396
subtest27of10,pubtest255of100,1,322,5216,23,197,5436
subtest22of10,pubtest255of100,1,322,5216,23,237,5476
subtest28of10,pubtest255of100,1,322,5216,25,275,5516
subtest24of10,pubtest255of100,1,322,5216,27,313,5556
subtest210of10,pubtest255of100,1,322,5216,29,351,5596
subtest26of10,pubtest255of100,1,322,5216,30,390,5636
subtest29of10,pubtest256of100,1,323,5554,16,41,5611
subtest21of10,pubtest256of100,1,323,5554,19,77,5650
subtest210of10,pubtest256of100,1,323,5554,24,112,5690
subtest25of10,pubtest256of100,1,323,5554,25,151,5730
subtest23of10,pubtest256of100,1,323,5554,23,191,5768
subtest27of10,pubtest256of100,1,323,5554,26,228,5808
subtest26of10,pubtest256of100,1,323,5554,23,267,5844
subtest28of10,pubtest256of100,1,323,5554,28,307,5889
subtest22of10,pubtest256of100,1,323,5554,32,344,5930
subtest24of10,pubtest256of100,1,323,5554,33,383,5970
subtest21of10,pubtest257of100,1,323,5694,11,43,5748
subtest24of10,pubtest257of100,1,323,5694,14,80,5788
subtest27of10,pubtest257of100,1,323,5694,14,119,5827
subtest28of10,pubtest257of100,1,323,5694,21,152,5867
subtest23of10,pubtest257of100,1,323,5694,21,191,5906
subtest29of10,pubtest257of100,1,323,5694,23,230,5947
subtest22of10,pubtest257of100,1,323,5694,29,264,5987
subtest210of10,pubtest257of100,1,323,5694,30,303,6027
subtest25of10,pubtest257of100,1,323,5694,29,342,6065
subtest26of10,pubtest257of100,1,323,5694,31,382,6107
subtest28of10,pubtest258of100,1,323,5427,11,160,5598
subtest25of10,pubtest258of100,1,323,5427,13,196,5636
subtest29of10,pubtest258of100,1,323,5427,16,234,5677
subtest21of10,pubtest258of100,1,323,5427,15,274,5716
subtest23of10,pubtest258of100,1,323,5427,13,316,5756
subtest26of10,pubtest258of100,1,323,5427,15,352,5794
subtest210of10,pubtest258of100,1,323,5427,17,392,5836
subtest22of10,pubtest258of100,1,323,5427,19,431,5877
subtest27of10,pubtest258of100,1,323,5427,23,466,5916
subtest24of10,pubtest258of100,1,323,5427,34,495,5956
subtest21of10,pubtest259of100,1,323,5338,11,41,5390
subtest28of10,pubtest259of100,1,323,5338,18,73,5429
subtest25of10,pubtest259of100,1,323,5338,19,112,5469
subtest24of10,pubtest259of100,1,323,5338,21,150,5509
subtest27of10,pubtest259of100,1,323,5338,21,190,5549
subtest23of10,pubtest259of100,1,323,5338,35,216,5589
subtest29of10,pubtest259of100,1,323,5338,37,254,5629
subtest210of10,pubtest259of100,1,323,5338,40,291,5669
subtest22of10,pubtest259of100,1,323,5338,40,331,5709
subtest26of10,pubtest259of100,1,323,5338,38,370,5746
subtest210of10,pubtest260of100,1,323,5843,11,49,5903
subtest23of10,pubtest260of100,1,323,5843,12,87,5942
subtest21of10,pubtest260of100,1,323,5843,16,123,5982
subtest26of10,pubtest260of100,1,323,5843,18,161,6022
subtest27of10,pubtest260of100,1,323,5843,19,200,6062
subtest25of10,pubtest260of100,1,323,5843,23,236,6102
subtest22of10,pubtest260of100,1,323,5843,24,275,6142
subtest29of10,pubtest260of100,1,323,5843,22,315,6180
subtest28of10,pubtest260of100,1,323,5843,24,355,6222
subtest24of10,pubtest260of100,1,323,5843,28,391,6262
subtest25of10,pubtest261of100,1,323,5366,15,51,5432
subtest28of10,pubtest261of100,1,323,5366,16,89,5471
subtest27of10,pubtest261of100,1,323,5366,20,125,5511
subtest23of10,pubtest261of100,1,323,5366,21,164,5551
subtest22of10,pubtest261of100,1,323,5366,21,204,5591
subtest210of10,pubtest261of100,1,323,5366,20,243,5629
subtest21of10,pubtest261of100,1,323,5366,23,282,5671
subtest24of10,pubtest261of100,1,323,5366,25,320,5711
subtest26of10,pubtest261of100,1,323,5366,25,360,5751
subtest29of10,pubtest261of100,1,323,5366,15,399,5780
subtest21of10,pubtest262of100,1,323,5587,12,50,5649
subtest22of10,pubtest262of100,1,323,5587,12,90,5689
subtest26of10,pubtest262of100,1,323,5587,14,129,5730
subtest27of10,pubtest262of100,1,323,5587,16,167,5770
subtest23of10,pubtest262of100,1,323,5587,14,208,5809
subtest29of10,pubtest262of100,1,323,5587,17,245,5849
subtest25of10,pubtest262of100,1,323,5587,18,284,5889
subtest210of10,pubtest262of100,1,323,5587,18,324,5929
subtest24of10,pubtest262of100,1,323,5587,29,353,5969
subtest28of10,pubtest262of100,1,323,5587,30,392,6009
subtest22of10,pubtest263of100,1,322,5447,11,41,5499
subtest29of10,pubtest263of100,1,322,5447,15,75,5537
subtest24of10,pubtest263of100,1,322,5447,17,113,5577
subtest23of10,pubtest263of100,1,322,5447,23,147,5617
subtest26of10,pubtest263of100,1,322,5447,28,182,5657
subtest25of10,pubtest263of100,1,322,5447,31,219,5697
subtest27of10,pubtest263of100,1,322,5447,34,256,5737
subtest210of10,pubtest263of100,1,322,5447,35,296,5778
subtest21of10,pubtest263of100,1,322,5447,39,329,5815
subtest28of10,pubtest263of100,1,322,5447,40,369,5856
subtest22of10,pubtest264of100,1,322,5292,12,41,5345
subtest29of10,pubtest264of100,1,322,5292,13,79,5384
subtest23of10,pubtest264of100,1,322,5292,13,118,5423
subtest27of10,pubtest264of100,1,322,5292,18,154,5464
subtest24of10,pubtest264of100,1,322,5292,19,193,5504
subtest21of10,pubtest264of100,1,322,5292,20,232,5544
subtest210of10,pubtest264of100,1,322,5292,26,266,5584
subtest25of10,pubtest264of100,1,322,5292,25,306,5623
subtest26of10,pubtest264of100,1,322,5292,25,345,5662
subtest28of10,pubtest264of100,1,322,5292,25,385,5702
subtest26of10,pubtest265of100,1,323,5255,13,39,5307
subtest27of10,pubtest265of100,1,323,5255,16,76,5347
subtest210of10,pubtest265of100,1,323,5255,16,115,5386
subtest22of10,pubtest265of100,1,323,5255,19,152,5426
subtest21of10,pubtest265of100,1,323,5255,19,192,5466
subtest29of10,pubtest265of100,1,323,5255,21,230,5506
subtest28of10,pubtest265of100,1,323,5255,26,265,5546
subtest23of10,pubtest265of100,1,323,5255,26,304,5585
subtest25of10,pubtest265of100,1,323,5255,26,343,5624
subtest24of10,pubtest265of100,1,323,5255,28,385,5668
subtest210of10,pubtest266of100,1,321,5374,12,38,5424
subtest29of10,pubtest266of100,1,321,5374,12,78,5464
subtest25of10,pubtest266of100,1,321,5374,21,108,5503
subtest26of10,pubtest266of100,1,321,5374,22,148,5544
subtest27of10,pubtest266of100,1,321,5374,23,186,5583
subtest23of10,pubtest266of100,1,321,5374,30,219,5623
subtest28of10,pubtest266of100,1,321,5374,36,253,5663
subtest21of10,pubtest266of100,1,321,5374,48,281,5703
subtest24of10,pubtest266of100,1,321,5374,49,320,5743
subtest22of10,pubtest266of100,1,321,5374,50,359,5783
subtest23of10,pubtest267of100,1,323,5323,17,40,5380
subtest26of10,pubtest267of100,1,323,5323,17,79,5419
subtest25of10,pubtest267of100,1,323,5323,19,117,5459
subtest28of10,pubtest267of100,1,323,5323,19,157,5499
subtest24of10,pubtest267of100,1,323,5323,21,195,5539
subtest27of10,pubtest267of100,1,323,5323,21,235,5579
subtest29of10,pubtest267of100,1,323,5323,22,274,5619
subtest21of10,pubtest267of100,1,323,5323,23,313,5659
subtest22of10,pubtest267of100,1,323,5323,26,350,5699
subtest210of10,pubtest267of100,1,323,5323,24,390,5737
subtest23of10,pubtest268of100,1,323,5213,11,38,5262
subtest24of10,pubtest268of100,1,323,5213,15,73,5301
subtest25of10,pubtest268of100,1,323,5213,15,113,5341
subtest29of10,pubtest268of100,1,323,5213,17,151,5381
subtest21of10,pubtest268of100,1,323,5213,23,185,5421
subtest27of10,pubtest268of100,1,323,5213,21,223,5457
subtest22of10,pubtest268of100,1,323,5213,25,264,5502
subtest28of10,pubtest268of100,1,323,5213,21,302,5536
subtest210of10,pubtest268of100,1,323,5213,26,342,5581
subtest26of10,pubtest268of100,1,323,5213,31,377,5621
subtest24of10,pubtest269of100,1,323,5216,12,39,5267
subtest27of10,pubtest269of100,1,323,5216,13,77,5306
subtest210of10,pubtest269of100,1,323,5216,20,109,5345
subtest25of10,pubtest269of100,1,323,5216,23,147,5386
subtest26of10,pubtest269of100,1,323,5216,26,184,5426
subtest21of10,pubtest269of100,1,323,5216,26,224,5466
subtest22of10,pubtest269of100,1,323,5216,28,262,5506
subtest29of10,pubtest269of100,1,323,5216,28,302,5546
subtest28of10,pubtest269of100,1,323,5216,29,341,5586
subtest23of10,pubtest269of100,1,323,5216,29,381,5626
subtest23of10,pubtest270of100,1,323,5310,13,43,5366
subtest26of10,pubtest270of100,1,323,5310,14,80,5404
subtest27of10,pubtest270of100,1,323,5310,15,119,5444
subtest210of10,pubtest270of100,1,323,5310,16,157,5483
subtest29of10,pubtest270of100,1,323,5310,17,197,5524
subtest28of10,pubtest270of100,1,323,5310,21,233,5564
subtest25of10,pubtest270of100,1,323,5310,23,272,5605
subtest24of10,pubtest270of100,1,323,5310,24,310,5644
subtest21of10,pubtest270of100,1,323,5310,26,348,5684
subtest22of10,pubtest270of100,1,323,5310,26,388,5724
subtest24of10,pubtest271of100,1,323,5173,12,39,5224
subtest25of10,pubtest271of100,1,323,5173,13,77,5263
subtest22of10,pubtest271of100,1,323,5173,15,115,5303
subtest27of10,pubtest271of100,1,323,5173,15,156,5344
subtest210of10,pubtest271of100,1,323,5173,21,189,5383
subtest21of10,pubtest271of100,1,323,5173,24,226,5423
subtest23of10,pubtest271of100,1,323,5173,25,265,5463
subtest26of10,pubtest271of100,1,323,5173,26,302,5501
subtest29of10,pubtest271of100,1,323,5173,28,342,5543
subtest28of10,pubtest271of100,1,323,5173,26,381,5580
subtest25of10,pubtest272of100,1,323,5182,10,38,5230
subtest26of10,pubtest272of100,1,323,5182,14,73,5269
subtest21of10,pubtest272of100,1,323,5182,14,113,5309
subtest29of10,pubtest272of100,1,323,5182,16,151,5349
subtest24of10,pubtest272of100,1,323,5182,18,187,5387
subtest23of10,pubtest272of100,1,323,5182,20,227,5429
subtest210of10,pubtest272of100,1,323,5182,22,266,5470
subtest27of10,pubtest272of100,1,323,5182,21,305,5508
subtest22of10,pubtest272of100,1,323,5182,21,344,5547
subtest28of10,pubtest272of100,1,323,5182,24,383,5589
subtest29of10,pubtest273of100,1,321,5228,14,39,5281
subtest22of10,pubtest273of100,1,321,5228,14,80,5322
subtest26of10,pubtest273of100,1,321,5228,17,116,5361
subtest28of10,pubtest273of100,1,321,5228,19,154,5401
subtest25of10,pubtest273of100,1,321,5228,24,189,5441
subtest27of10,pubtest273of100,1,321,5228,24,229,5481
subtest210of10,pubtest273of100,1,321,5228,26,267,5521
subtest23of10,pubtest273of100,1,321,5228,26,307,5561
subtest21of10,pubtest273of100,1,321,5228,28,345,5601
subtest24of10,pubtest273of100,1,321,5228,28,385,5641
subtest26of10,pubtest274of100,1,323,5182,13,42,5237
subtest21of10,pubtest274of100,1,323,5182,14,83,5279
subtest23of10,pubtest274of100,1,323,5182,16,119,5317
subtest29of10,pubtest274of100,1,323,5182,16,159,5357
subtest25of10,pubtest274of100,1,323,5182,17,198,5397
subtest22of10,pubtest274of100,1,323,5182,18,237,5437
subtest27of10,pubtest274of100,1,323,5182,24,270,5476
subtest24of10,pubtest274of100,1,323,5182,25,310,5517
subtest28of10,pubtest274of100,1,323,5182,25,349,5556
subtest210of10,pubtest274of100,1,323,5182,29,386,5597
subtest27of10,pubtest275of100,1,323,5403,17,39,5459
subtest29of10,pubtest275of100,1,323,5403,19,77,5499
subtest24of10,pubtest275of100,1,323,5403,22,113,5538
subtest21of10,pubtest275of100,1,323,5403,25,151,5579
subtest25of10,pubtest275of100,1,323,5403,24,190,5617
subtest23of10,pubtest275of100,1,323,5403,27,227,5657
subtest210of10,pubtest275of100,1,323,5403,31,264,5698
subtest22of10,pubtest275of100,1,323,5403,27,303,5733
subtest26of10,pubtest275of100,1,323,5403,33,342,5778
subtest28of10,pubtest275of100,1,323,5403,58,357,5818
subtest28of10,pubtest276of100,1,323,5589,17,55,5661
subtest21of10,pubtest276of100,1,323,5589,18,93,5700
subtest25of10,pubtest276of100,1,323,5589,19,132,5740
subtest24of10,pubtest276of100,1,323,5589,21,164,5774
subtest27of10,pubtest276of100,1,323,5589,27,203,5819
subtest29of10,pubtest276of100,1,323,5589,26,242,5857
subtest26of10,pubtest276of100,1,323,5589,25,281,5895
subtest22of10,pubtest276of100,1,323,5589,25,321,5935
subtest210of10,pubtest276of100,1,323,5589,24,360,5973
subtest23of10,pubtest276of100,1,323,5589,21,400,6010
subtest22of10,pubtest277of100,1,323,5446,10,41,5497
subtest29of10,pubtest277of100,1,323,5446,12,79,5537
subtest24of10,pubtest277of100,1,323,5446,13,118,5577
subtest28of10,pubtest277of100,1,323,5446,14,158,5618
subtest21of10,pubtest277of100,1,323,5446,12,199,5657
subtest210of10,pubtest277of100,1,323,5446,18,232,5696
subtest27of10,pubtest277of100,1,323,5446,18,272,5736
subtest26of10,pubtest277of100,1,323,5446,26,304,5776
subtest25of10,pubtest277of100,1,323,5446,26,344,5816
subtest23of10,pubtest277of100,1,323,5446,31,379,5856
subtest29of10,pubtest278of100,1,323,5605,13,399,6017
subtest22of10,pubtest278of100,1,323,5605,14,436,6055
subtest23of10,pubtest278of100,1,323,5605,15,475,6095
subtest21of10,pubtest278of100,1,323,5605,17,512,6134
subtest27of10,pubtest278of100,1,323,5605,17,552,6174
subtest28of10,pubtest278of100,1,323,5605,16,594,6215
subtest25of10,pubtest278of100,1,323,5605,20,630,6255
subtest26of10,pubtest278of100,1,323,5605,26,663,6294
subtest24of10,pubtest278of100,1,323,5605,28,702,6335
subtest210of10,pubtest278of100,1,323,5605,29,741,6375
subtest28of10,pubtest279of100,1,323,5871,12,40,5923
subtest25of10,pubtest279of100,1,323,5871,14,77,5962
subtest21of10,pubtest279of100,1,323,5871,14,117,6002
subtest29of10,pubtest279of100,1,323,5871,16,156,6043
subtest24of10,pubtest279of100,1,323,5871,15,195,6081
subtest23of10,pubtest279of100,1,323,5871,18,232,6121
subtest26of10,pubtest279of100,1,323,5871,19,271,6161
subtest27of10,pubtest279of100,1,323,5871,20,311,6202
subtest210of10,pubtest279of100,1,323,5871,21,350,6242
subtest22of10,pubtest279of100,1,323,5871,21,390,6282
subtest23of10,pubtest280of100,1,323,5340,23,39,5402
subtest27of10,pubtest280of100,1,323,5340,18,83,5441
subtest21of10,pubtest280of100,1,323,5340,23,118,5481
subtest26of10,pubtest280of100,1,323,5340,21,159,5520
subtest24of10,pubtest280of100,1,323,5340,24,196,5560
subtest29of10,pubtest280of100,1,323,5340,19,242,5601
subtest25of10,pubtest280of100,1,323,5340,25,277,5642
subtest210of10,pubtest280of100,1,323,5340,26,314,5680
subtest22of10,pubtest280of100,1,323,5340,27,354,5721
subtest28of10,pubtest280of100,1,323,5340,28,393,5761
subtest24of10,pubtest281of100,1,323,5362,12,41,5415
subtest23of10,pubtest281of100,1,323,5362,12,80,5454
subtest27of10,pubtest281of100,1,323,5362,14,118,5494
subtest25of10,pubtest281of100,1,323,5362,15,158,5535
subtest28of10,pubtest281of100,1,323,5362,16,196,5574
subtest21of10,pubtest281of100,1,323,5362,16,236,5614
subtest29of10,pubtest281of100,1,323,5362,18,274,5654
subtest26of10,pubtest281of100,1,323,5362,18,314,5694
subtest210of10,pubtest281of100,1,323,5362,19,351,5732
subtest22of10,pubtest281of100,1,323,5362,19,391,5772
subtest23of10,pubtest282of100,1,323,5973,11,39,6023
subtest21of10,pubtest282of100,1,323,5973,13,76,6062
subtest24of10,pubtest282of100,1,323,5973,13,116,6102
subtest25of10,pubtest282of100,1,323,5973,15,154,6142
subtest22of10,pubtest282of100,1,323,5973,15,194,6182
subtest26of10,pubtest282of100,1,323,5973,16,233,6222
subtest29of10,pubtest282of100,1,323,5973,21,268,6262
subtest210of10,pubtest282of100,1,323,5973,23,306,6302
subtest27of10,pubtest282of100,1,323,5973,24,344,6341
subtest28of10,pubtest282of100,1,323,5973,25,384,6382
subtest27of10,pubtest283of100,1,323,5346,12,40,5398
subtest23of10,pubtest283of100,1,323,5346,21,69,5436
subtest25of10,pubtest283of100,1,323,5346,23,108,5477
subtest24of10,pubtest283of100,1,323,5346,21,147,5514
subtest22of10,pubtest283of100,1,323,5346,25,186,5557
subtest21of10,pubtest283of100,1,323,5346,25,226,5597
subtest210of10,pubtest283of100,1,323,5346,27,264,5637
subtest28of10,pubtest283of100,1,323,5346,27,304,5677
subtest29of10,pubtest283of100,1,323,5346,32,339,5717
subtest26of10,pubtest283of100,1,323,5346,32,379,5757
subtest25of10,pubtest284of100,1,323,5247,13,211,5471
subtest22of10,pubtest284of100,1,323,5247,13,250,5510
subtest29of10,pubtest284of100,1,323,5247,15,287,5549
subtest210of10,pubtest284of100,1,323,5247,16,326,5589
subtest23of10,pubtest284of100,1,323,5247,17,365,5629
subtest27of10,pubtest284of100,1,323,5247,17,405,5669
subtest21of10,pubtest284of100,1,323,5247,19,443,5709
subtest24of10,pubtest284of100,1,323,5247,25,477,5749
subtest28of10,pubtest284of100,1,323,5247,26,516,5789
subtest26of10,pubtest284of100,1,323,5247,27,555,5829
subtest23of10,pubtest285of100,1,323,5536,12,45,5593
subtest25of10,pubtest285of100,1,323,5536,13,83,5632
subtest24of10,pubtest285of100,1,323,5536,15,122,5673
subtest22of10,pubtest285of100,1,323,5536,17,160,5713
subtest27of10,pubtest285of100,1,323,5536,17,200,5753
subtest28of10,pubtest285of100,1,323,5536,19,238,5793
subtest210of10,pubtest285of100,1,323,5536,25,272,5833
subtest21of10,pubtest285of100,1,323,5536,23,312,5871
subtest29of10,pubtest285of100,1,323,5536,25,351,5912
subtest26of10,pubtest285of100,1,323,5536,27,391,5954
subtest23of10,pubtest286of100,1,323,6096,10,38,6144
subtest210of10,pubtest286of100,1,323,6096,14,73,6183
subtest25of10,pubtest286of100,1,323,6096,16,109,6221
subtest24of10,pubtest286of100,1,323,6096,17,149,6262
subtest29of10,pubtest286of100,1,323,6096,24,183,6303
subtest27of10,pubtest286of100,1,323,6096,24,223,6343
subtest21of10,pubtest286of100,1,323,6096,25,262,6383
subtest26of10,pubtest286of100,1,323,6096,27,300,6423
subtest28of10,pubtest286of100,1,323,6096,36,331,6463
subtest22of10,pubtest286of100,1,323,6096,36,371,6503
subtest26of10,pubtest287of100,1,323,5512,11,228,5751
subtest210of10,pubtest287of100,1,323,5512,11,267,5790
subtest27of10,pubtest287of100,1,323,5512,13,305,5830
subtest29of10,pubtest287of100,1,323,5512,13,347,5872
subtest25of10,pubtest287of100,1,323,5512,14,384,5910
subtest28of10,pubtest287of100,1,323,5512,14,423,5949
subtest24of10,pubtest287of100,1,323,5512,16,462,5990
subtest21of10,pubtest287of100,1,323,5512,25,493,6030
subtest22of10,pubtest287of100,1,323,5512,51,507,6070
subtest23of10,pubtest287of100,1,323,5512,52,546,6110
subtest29of10,pubtest288of100,1,323,6032,11,41,6084
subtest26of10,pubtest288of100,1,323,6032,18,74,6124
subtest25of10,pubtest288of100,1,323,6032,18,113,6163
subtest27of10,pubtest288of100,1,323,6032,20,152,6204
subtest22of10,pubtest288of100,1,323,6032,20,192,6244
subtest210of10,pubtest288of100,1,323,6032,20,231,6283
subtest21of10,pubtest288of100,1,323,6032,22,270,6324
subtest28of10,pubtest288of100,1,323,6032,24,306,6362
subtest23of10,pubtest288of100,1,323,6032,23,349,6404
subtest24of10,pubtest288of100,1,323,6032,26,386,6444
subtest29of10,pubtest289of100,1,323,5871,15,45,5931
subtest210of10,pubtest289of100,1,323,5871,16,83,5970
subtest23of10,pubtest289of100,1,323,5871,22,116,6009
subtest24of10,pubtest289of100,1,323,5871,22,156,6049
subtest26of10,pubtest289of100,1,323,5871,28,190,6089
subtest28of10,pubtest289of100,1,323,5871,33,226,6130
subtest25of10,pubtest289of100,1,323,5871,33,266,6170
subtest22of10,pubtest289of100,1,323,5871,39,300,6210
subtest27of10,pubtest289of100,1,323,5871,38,339,6248
subtest21of10,pubtest289of100,1,323,5871,38,379,6288
subtest29of10,pubtest290of100,1,323,5790,12,42,5844
subtest22of10,pubtest290of100,1,323,5790,20,72,5882
subtest23of10,pubtest290of100,1,323,5790,20,112,5922
subtest25of10,pubtest290of100,1,323,5790,20,151,5961
subtest210of10,pubtest290of100,1,323,5790,22,190,6002
subtest27of10,pubtest290of100,1,323,5790,23,229,6042
subtest21of10,pubtest290of100,1,323,5790,23,269,6082
subtest26of10,pubtest290of100,1,323,5790,25,308,6123
subtest28of10,pubtest290of100,1,323,5790,26,348,6164
subtest24of10,pubtest290of100,1,323,5790,27,386,6203
subtest24of10,pubtest291of100,1,323,5333,11,39,5383
subtest27of10,pubtest291of100,1,323,5333,13,76,5422
subtest28of10,pubtest291of100,1,323,5333,14,115,5462
subtest25of10,pubtest291of100,1,323,5333,16,153,5502
subtest21of10,pubtest291of100,1,323,5333,16,193,5542
subtest23of10,pubtest291of100,1,323,5333,12,233,5578
subtest29of10,pubtest291of100,1,323,5333,17,271,5621
subtest210of10,pubtest291of100,1,323,5333,17,310,5660
subtest22of10,pubtest291of100,1,323,5333,20,347,5700
subtest26of10,pubtest291of100,1,323,5333,26,383,5742
subtest28of10,pubtest292of100,1,323,5222,13,39,5274
subtest21of10,pubtest292of100,1,323,5222,13,77,5312
subtest29of10,pubtest292of100,1,323,5222,13,116,5351
subtest27of10,pubtest292of100,1,323,5222,20,151,5393
subtest25of10,pubtest292of100,1,323,5222,20,191,5433
subtest26of10,pubtest292of100,1,323,5222,23,228,5473
subtest23of10,pubtest292of100,1,323,5222,25,266,5513
subtest22of10,pubtest292of100,1,323,5222,25,306,5553
subtest24of10,pubtest292of100,1,323,5222,26,345,5593
subtest210of10,pubtest292of100,1,323,5222,27,385,5634
subtest27of10,pubtest293of100,1,323,5143,20,38,5201
subtest24of10,pubtest293of100,1,323,5143,15,81,5239
subtest28of10,pubtest293of100,1,323,5143,20,117,5280
subtest25of10,pubtest293of100,1,323,5143,16,157,5316
subtest210of10,pubtest293of100,1,323,5143,22,195,5360
subtest23of10,pubtest293of100,1,323,5143,23,234,5400
subtest26of10,pubtest293of100,1,323,5143,25,273,5441
subtest21of10,pubtest293of100,1,323,5143,25,312,5480
subtest29of10,pubtest293of100,1,323,5143,25,350,5518
subtest22of10,pubtest293of100,1,323,5143,27,390,5560
subtest21of10,pubtest294of100,1,323,5302,21,38,5361
subtest210of10,pubtest294of100,1,323,5302,21,77,5400
subtest25of10,pubtest294of100,1,323,5302,23,116,5441
subtest27of10,pubtest294of100,1,323,5302,24,155,5481
subtest24of10,pubtest294of100,1,323,5302,25,193,5520
subtest23of10,pubtest294of100,1,323,5302,25,232,5559
subtest22of10,pubtest294of100,1,323,5302,26,272,5600
subtest26of10,pubtest294of100,1,323,5302,27,311,5640
subtest28of10,pubtest294of100,1,323,5302,28,348,5678
subtest29of10,pubtest294of100,1,323,5302,30,387,5719
subtest24of10,pubtest295of100,1,323,5417,15,40,5472
subtest23of10,pubtest295of100,1,323,5417,14,78,5509
subtest25of10,pubtest295of100,1,323,5417,14,118,5549
subtest22of10,pubtest295of100,1,323,5417,16,159,5592
subtest27of10,pubtest295of100,1,323,5417,19,195,5631
subtest21of10,pubtest295of100,1,323,5417,22,232,5671
subtest210of10,pubtest295of100,1,323,5417,22,272,5711
subtest28of10,pubtest295of100,1,323,5417,24,311,5752
subtest26of10,pubtest295of100,1,323,5417,24,350,5791
subtest29of10,pubtest295of100,1,323,5417,24,389,5830
subtest24of10,pubtest296of100,1,322,5247,11,38,5296
subtest25of10,pubtest296of100,1,322,5247,11,78,5336
subtest26of10,pubtest296of100,1,322,5247,15,116,5378
subtest23of10,pubtest296of100,1,322,5247,32,139,5418
subtest27of10,pubtest296of100,1,322,5247,32,179,5458
subtest29of10,pubtest296of100,1,322,5247,34,216,5497
subtest21of10,pubtest296of100,1,322,5247,35,258,5540
subtest28of10,pubtest296of100,1,322,5247,37,295,5579
subtest210of10,pubtest296of100,1,322,5247,38,333,5618
subtest22of10,pubtest296of100,1,322,5247,41,370,5658
subtest25of10,pubtest297of100,1,323,5274,11,42,5327
subtest210of10,pubtest297of100,1,323,5274,13,80,5367
subtest29of10,pubtest297of100,1,323,5274,13,118,5405
subtest22of10,pubtest297of100,1,323,5274,15,157,5446
subtest23of10,pubtest297of100,1,323,5274,14,198,5486
subtest26of10,pubtest297of100,1,323,5274,20,231,5525
subtest27of10,pubtest297of100,1,323,5274,20,271,5565
subtest24of10,pubtest297of100,1,323,5274,21,308,5603
subtest28of10,pubtest297of100,1,323,5274,20,348,5642
subtest21of10,pubtest297of100,1,323,5274,20,387,5681
subtest22of10,pubtest298of100,1,323,5306,11,39,5356
subtest29of10,pubtest298of100,1,323,5306,12,77,5395
subtest25of10,pubtest298of100,1,323,5306,13,116,5435
subtest24of10,pubtest298of100,1,323,5306,16,153,5475
subtest23of10,pubtest298of100,1,323,5306,22,187,5515
subtest210of10,pubtest298of100,1,323,5306,24,225,5555
subtest28of10,pubtest298of100,1,323,5306,24,264,5594
subtest21of10,pubtest298of100,1,323,5306,26,303,5635
subtest26of10,pubtest298of100,1,323,5306,27,342,5675
subtest27of10,pubtest298of100,1,323,5306,26,382,5714
subtest22of10,pubtest299of100,1,323,5401,12,39,5452
subtest29of10,pubtest299of100,1,323,5401,14,77,5492
subtest210of10,pubtest299of100,1,323,5401,17,113,5531
subtest27of10,pubtest299of100,1,323,5401,17,153,5571
subtest24of10,pubtest299of100,1,323,5401,20,191,5612
subtest28of10,pubtest299of100,1,323,5401,20,230,5651
subtest26of10,pubtest299of100,1,323,5401,26,264,5691
subtest23of10,pubtest299of100,1,323,5401,26,304,5731
subtest25of10,pubtest299of100,1,323,5401,26,341,5768
subtest21of10,pubtest299of100,1,323,5401,27,381,5809
subtest24of10,pubtest2100of100,1,325,5225,15,41,5281
subtest21of10,pubtest2100of100,1,325,5225,16,80,5321
subtest29of10,pubtest2100of100,1,325,5225,17,118,5360
subtest23of10,pubtest2100of100,1,325,5225,18,157,5400
subtest25of10,pubtest2100of100,1,325,5225,19,194,5438
subtest27of10,pubtest2100of100,1,325,5225,21,234,5480
subtest22of10,pubtest2100of100,1,325,5225,23,272,5520
subtest28of10,pubtest2100of100,1,325,5225,24,311,5560
subtest210of10,pubtest2100of100,1,325,5225,25,350,5600
subtest26of10,pubtest2100of100,1,325,5225,54,361,5640
subtest27of10,pubtest21of100,1,322,10951,16,48,11015
subtest26of10,pubtest21of100,1,322,10951,16,86,11053
subtest25of10,pubtest21of100,1,322,10951,18,125,11094
subtest21of10,pubtest21of100,1,322,10951,20,163,11134
subtest210of10,pubtest21of100,1,322,10951,20,203,11174
subtest29of10,pubtest21of100,1,322,10951,21,242,11214
subtest24of10,pubtest21of100,1,322,10951,20,282,11253
subtest28of10,pubtest21of100,1,322,10951,23,320,11294
subtest23of10,pubtest21of100,1,322,10951,23,360,11334
subtest22of10,pubtest21of100,1,322,10951,31,390,11372
subtest29of10,pubtest22of100,1,321,5587,12,39,5638
subtest24of10,pubtest22of100,1,321,5587,12,78,5677
subtest23of10,pubtest22of100,1,321,5587,14,116,5717
subtest27of10,pubtest22of100,1,321,5587,14,156,5757
subtest28of10,pubtest22of100,1,321,5587,16,194,5797
subtest25of10,pubtest22of100,1,321,5587,21,229,5837
subtest21of10,pubtest22of100,1,321,5587,25,265,5877
subtest26of10,pubtest22of100,1,321,5587,25,304,5916
subtest210of10,pubtest22of100,1,321,5587,29,341,5957
subtest22of10,pubtest22of100,1,321,5587,30,380,5997
subtest23of10,pubtest23of100,1,321,5376,11,40,5427
subtest29of10,pubtest23of100,1,321,5376,13,79,5468
subtest28of10,pubtest23of100,1,321,5376,15,117,5508
subtest24of10,pubtest23of100,1,321,5376,18,154,5548
subtest25of10,pubtest23of100,1,321,5376,28,184,5588
subtest27of10,pubtest23of100,1,321,5376,28,224,5628
subtest26of10,pubtest23of100,1,321,5376,29,262,5667
subtest21of10,pubtest23of100,1,321,5376,30,302,5708
subtest22of10,pubtest23of100,1,321,5376,30,341,5747
subtest210of10,pubtest23of100,1,321,5376,31,381,5788
subtest23of10,pubtest24of100,1,321,5391,11,38,5440
subtest24of10,pubtest24of100,1,321,5391,11,77,5479
subtest25of10,pubtest24of100,1,321,5391,13,116,5520
subtest22of10,pubtest24of100,1,321,5391,13,156,5560
subtest28of10,pubtest24of100,1,321,5391,14,194,5599
subtest29of10,pubtest24of100,1,321,5391,15,233,5639
subtest26of10,pubtest24of100,1,321,5391,18,270,5679
subtest27of10,pubtest24of100,1,321,5391,18,310,5719
subtest210of10,pubtest24of100,1,321,5391,20,348,5759
subtest21of10,pubtest24of100,1,321,5391,20,388,5799
subtest25of10,pubtest25of100,1,321,5536,21,44,5601
subtest27of10,pubtest25of100,1,321,5536,20,84,5640
subtest21of10,pubtest25of100,1,321,5536,18,125,5679
subtest210of10,pubtest25of100,1,321,5536,21,163,5720
subtest23of10,pubtest25of100,1,321,5536,23,200,5759
subtest29of10,pubtest25of100,1,321,5536,23,239,5798
subtest26of10,pubtest25of100,1,321,5536,24,279,5839
subtest28of10,pubtest25of100,1,321,5536,18,318,5872
subtest22of10,pubtest25of100,1,321,5536,25,358,5919
subtest24of10,pubtest25of100,1,321,5536,27,396,5959
subtest22of10,pubtest26of100,1,321,5470,9,41,5520
subtest21of10,pubtest26of100,1,321,5470,10,79,5559
subtest29of10,pubtest26of100,1,321,5470,13,116,5599
subtest23of10,pubtest26of100,1,321,5470,15,154,5639
subtest26of10,pubtest26of100,1,321,5470,15,194,5679
subtest27of10,pubtest26of100,1,321,5470,22,227,5719
subtest210of10,pubtest26of100,1,321,5470,28,261,5759
subtest25of10,pubtest26of100,1,321,5470,28,301,5799
subtest28of10,pubtest26of100,1,321,5470,28,340,5838
subtest24of10,pubtest26of100,1,321,5470,33,376,5879
subtest27of10,pubtest27of100,1,320,5399,11,41,5451
subtest28of10,pubtest27of100,1,320,5399,23,68,5490
subtest23of10,pubtest27of100,1,320,5399,23,109,5531
subtest24of10,pubtest27of100,1,320,5399,27,144,5570
subtest29of10,pubtest27of100,1,320,5399,27,184,5610
subtest25of10,pubtest27of100,1,320,5399,28,223,5650
subtest21of10,pubtest27of100,1,320,5399,34,256,5689
subtest26of10,pubtest27of100,1,320,5399,35,297,5731
subtest210of10,pubtest27of100,1,320,5399,34,336,5769
subtest22of10,pubtest27of100,1,320,5399,34,375,5808
subtest27of10,pubtest28of100,1,321,5661,11,39,5711
subtest21of10,pubtest28of100,1,321,5661,12,80,5753
subtest28of10,pubtest28of100,1,321,5661,13,120,5794
subtest29of10,pubtest28of100,1,321,5661,14,159,5834
subtest23of10,pubtest28of100,1,321,5661,15,198,5874
subtest25of10,pubtest28of100,1,321,5661,16,237,5914
subtest210of10,pubtest28of100,1,321,5661,23,270,5954
subtest26of10,pubtest28of100,1,321,5661,27,306,5994
subtest24of10,pubtest28of100,1,321,5661,34,339,6034
subtest22of10,pubtest28of100,1,321,5661,35,378,6074
subtest23of10,pubtest29of100,1,321,5228,10,478,5716
subtest29of10,pubtest29of100,1,321,5228,10,518,5756
subtest25of10,pubtest29of100,1,321,5228,13,555,5796
subtest22of10,pubtest29of100,1,321,5228,14,595,5837
subtest210of10,pubtest29of100,1,321,5228,13,634,5875
subtest21of10,pubtest29of100,1,321,5228,25,662,5915
subtest27of10,pubtest29of100,1,321,5228,26,702,5956
subtest28of10,pubtest29of100,1,321,5228,27,741,5996
subtest24of10,pubtest29of100,1,321,5228,29,779,6036
subtest26of10,pubtest29of100,1,321,5228,30,818,6076
subtest29of10,pubtest210of100,1,323,5220,10,42,5272
subtest21of10,pubtest210of100,1,323,5220,13,77,5310
subtest27of10,pubtest210of100,1,323,5220,15,116,5351
subtest23of10,pubtest210of100,1,323,5220,20,154,5394
subtest210of10,pubtest210of100,1,323,5220,20,194,5434
subtest25of10,pubtest210of100,1,323,5220,22,230,5472
subtest22of10,pubtest210of100,1,323,5220,25,269,5514
subtest26of10,pubtest210of100,1,323,5220,25,309,5554
subtest28of10,pubtest210of100,1,323,5220,22,348,5590
subtest24of10,pubtest210of100,1,323,5220,26,388,5634
subtest210of10,pubtest211of100,1,323,5318,12,42,5372
subtest24of10,pubtest211of100,1,323,5318,13,81,5412
subtest29of10,pubtest211of100,1,323,5318,19,114,5451
subtest21of10,pubtest211of100,1,323,5318,22,151,5491
subtest22of10,pubtest211of100,1,323,5318,23,191,5532
subtest25of10,pubtest211of100,1,323,5318,24,229,5571
subtest23of10,pubtest211of100,1,323,5318,26,267,5611
subtest28of10,pubtest211of100,1,323,5318,27,306,5651
subtest26of10,pubtest211of100,1,323,5318,26,345,5689
subtest27of10,pubtest211of100,1,323,5318,28,384,5730
subtest25of10,pubtest212of100,1,323,5308,11,41,5360
subtest28of10,pubtest212of100,1,323,5308,12,80,5400
subtest24of10,pubtest212of100,1,323,5308,14,117,5439
subtest29of10,pubtest212of100,1,323,5308,15,157,5480
subtest23of10,pubtest212of100,1,323,5308,20,191,5519
subtest22of10,pubtest212of100,1,323,5308,21,230,5559
subtest27of10,pubtest212of100,1,323,5308,21,266,5595
subtest26of10,pubtest212of100,1,323,5308,25,306,5639
subtest21of10,pubtest212of100,1,323,5308,22,346,5676
subtest210of10,pubtest212of100,1,323,5308,26,385,5719
subtest23of10,pubtest213of100,1,322,5582,13,42,5637
subtest26of10,pubtest213of100,1,322,5582,13,81,5676
subtest29of10,pubtest213of100,1,322,5582,22,112,5716
subtest27of10,pubtest213of100,1,322,5582,25,149,5756
subtest22of10,pubtest213of100,1,322,5582,25,189,5796
subtest24of10,pubtest213of100,1,322,5582,28,226,5836
subtest21of10,pubtest213of100,1,322,5582,28,266,5876
subtest28of10,pubtest213of100,1,322,5582,30,304,5916
subtest210of10,pubtest213of100,1,322,5582,30,344,5956
subtest25of10,pubtest213of100,1,322,5582,30,383,5995
subtest21of10,pubtest214of100,1,323,5252,11,44,5307
subtest26of10,pubtest214of100,1,323,5252,15,81,5348
subtest23of10,pubtest214of100,1,323,5252,23,112,5387
subtest29of10,pubtest214of100,1,323,5252,26,150,5428
subtest25of10,pubtest214of100,1,323,5252,26,188,5466
subtest210of10,pubtest214of100,1,323,5252,28,225,5505
subtest24of10,pubtest214of100,1,323,5252,30,265,5547
subtest27of10,pubtest214of100,1,323,5252,26,304,5582
subtest22of10,pubtest214of100,1,323,5252,32,343,5627
subtest28of10,pubtest214of100,1,323,5252,35,380,5667
subtest24of10,pubtest215of100,1,323,5412,20,50,5482
subtest29of10,pubtest215of100,1,323,5412,26,85,5523
subtest22of10,pubtest215of100,1,323,5412,25,125,5562
subtest21of10,pubtest215of100,1,323,5412,25,167,5604
subtest25of10,pubtest215of100,1,323,5412,24,206,5642
subtest26of10,pubtest215of100,1,323,5412,22,248,5682
subtest27of10,pubtest215of100,1,323,5412,27,283,5722
subtest210of10,pubtest215of100,1,323,5412,23,328,5763
subtest28of10,pubtest215of100,1,323,5412,27,361,5800
subtest23of10,pubtest215of100,1,323,5412,31,400,5843
subtest24of10,pubtest216of100,1,323,5171,13,62,5246
subtest21of10,pubtest216of100,1,323,5171,14,102,5287
subtest29of10,pubtest216of100,1,323,5171,17,136,5324
subtest25of10,pubtest216of100,1,323,5171,19,175,5365
subtest22of10,pubtest216of100,1,323,5171,17,216,5404
subtest28of10,pubtest216of100,1,323,5171,16,247,5434
subtest210of10,pubtest216of100,1,323,5171,28,286,5485
subtest27of10,pubtest216of100,1,323,5171,16,327,5514
subtest23of10,pubtest216of100,1,323,5171,29,365,5565
subtest26of10,pubtest216of100,1,323,5171,30,404,5605
subtest27of10,pubtest217of100,1,322,5345,17,58,5420
subtest22of10,pubtest217of100,1,322,5345,18,95,5458
subtest23of10,pubtest217of100,1,322,5345,23,131,5499
subtest26of10,pubtest217of100,1,322,5345,24,169,5538
subtest24of10,pubtest217of100,1,322,5345,25,208,5578
subtest21of10,pubtest217of100,1,322,5345,19,247,5611
subtest210of10,pubtest217of100,1,322,5345,28,285,5658
subtest29of10,pubtest217of100,1,322,5345,30,323,5698
subtest25of10,pubtest217of100,1,322,5345,31,362,5738
subtest28of10,pubtest217of100,1,322,5345,33,400,5778
subtest29of10,pubtest218of100,1,323,5320,10,41,5371
subtest21of10,pubtest218of100,1,323,5320,12,79,5411
subtest27of10,pubtest218of100,1,323,5320,15,115,5450
subtest23of10,pubtest218of100,1,323,5320,24,146,5490
subtest22of10,pubtest218of100,1,323,5320,23,185,5528
subtest28of10,pubtest218of100,1,323,5320,25,224,5569
subtest25of10,pubtest218of100,1,323,5320,26,264,5610
subtest24of10,pubtest218of100,1,323,5320,27,303,5650
subtest210of10,pubtest218of100,1,323,5320,28,342,5690
subtest26of10,pubtest218of100,1,323,5320,29,381,5730
subtest210of10,pubtest219of100,1,323,5359,16,40,5415
subtest26of10,pubtest219of100,1,323,5359,17,78,5454
subtest25of10,pubtest219of100,1,323,5359,18,117,5494
subtest22of10,pubtest219of100,1,323,5359,21,154,5534
subtest21of10,pubtest219of100,1,323,5359,22,193,5574
subtest29of10,pubtest219of100,1,323,5359,24,231,5614
subtest24of10,pubtest219of100,1,323,5359,23,271,5653
subtest28of10,pubtest219of100,1,323,5359,25,310,5694
subtest23of10,pubtest219of100,1,323,5359,29,346,5734
subtest27of10,pubtest219of100,1,323,5359,36,379,5774
subtest25of10,pubtest220of100,1,323,5172,10,41,5223
subtest210of10,pubtest220of100,1,323,5172,18,72,5262
subtest23of10,pubtest220of100,1,323,5172,18,110,5300
subtest29of10,pubtest220of100,1,323,5172,19,150,5341
subtest21of10,pubtest220of100,1,323,5172,20,189,5381
subtest26of10,pubtest220of100,1,323,5172,49,200,5421
subtest27of10,pubtest220of100,1,323,5172,49,240,5461
subtest24of10,pubtest220of100,1,323,5172,48,281,5501
subtest28of10,pubtest220of100,1,323,5172,51,318,5541
subtest22of10,pubtest220of100,1,323,5172,52,357,5581
subtest24of10,pubtest221of100,1,323,5219,11,41,5271
subtest21of10,pubtest221of100,1,323,5219,16,75,5310
subtest28of10,pubtest221of100,1,323,5219,16,114,5349
subtest22of10,pubtest221of100,1,323,5219,18,154,5391
subtest23of10,pubtest221of100,1,323,5219,20,191,5430
subtest210of10,pubtest221of100,1,323,5219,21,229,5469
subtest25of10,pubtest221of100,1,323,5219,22,268,5509
subtest26of10,pubtest221of100,1,323,5219,30,300,5549
subtest29of10,pubtest221of100,1,323,5219,31,338,5588
subtest27of10,pubtest221of100,1,323,5219,32,378,5629
subtest21of10,pubtest222of100,1,323,5222,14,42,5278
subtest22of10,pubtest222of100,1,323,5222,18,77,5317
subtest29of10,pubtest222of100,1,323,5222,17,119,5358
subtest27of10,pubtest222of100,1,323,5222,17,157,5396
subtest23of10,pubtest222of100,1,323,5222,26,189,5437
subtest28of10,pubtest222of100,1,323,5222,27,229,5478
subtest25of10,pubtest222of100,1,323,5222,30,265,5517
subtest26of10,pubtest222of100,1,323,5222,32,303,5557
subtest210of10,pubtest222of100,1,323,5222,31,343,5596
subtest24of10,pubtest222of100,1,323,5222,33,382,5637
subtest21of10,pubtest223of100,1,323,5329,13,40,5382
subtest28of10,pubtest223of100,1,323,5329,14,78,5421
subtest29of10,pubtest223of100,1,323,5329,16,116,5461
subtest23of10,pubtest223of100,1,323,5329,16,156,5501
subtest24of10,pubtest223of100,1,323,5329,22,191,5542
subtest27of10,pubtest223of100,1,323,5329,22,230,5581
subtest210of10,pubtest223of100,1,323,5329,26,266,5621
subtest22of10,pubtest223of100,1,323,5329,30,303,5662
subtest26of10,pubtest223of100,1,323,5329,34,336,5699
subtest25of10,pubtest223of100,1,323,5329,34,376,5739
subtest21of10,pubtest224of100,1,323,5264,12,41,5317
subtest28of10,pubtest224of100,1,323,5264,17,75,5356
subtest26of10,pubtest224of100,1,323,5264,21,111,5396
subtest23of10,pubtest224of100,1,323,5264,21,150,5435
subtest27of10,pubtest224of100,1,323,5264,21,190,5475
subtest25of10,pubtest224of100,1,323,5264,23,229,5516
subtest29of10,pubtest224of100,1,323,5264,23,269,5556
subtest22of10,pubtest224of100,1,323,5264,25,307,5596
subtest24of10,pubtest224of100,1,323,5264,29,341,5634
subtest210of10,pubtest224of100,1,323,5264,29,446,5739
subtest22of10,pubtest225of100,1,323,5200,16,40,5256
subtest27of10,pubtest225of100,1,323,5200,16,79,5295
subtest21of10,pubtest225of100,1,323,5200,19,116,5335
subtest26of10,pubtest225of100,1,323,5200,20,455,5675
subtest23of10,pubtest225of100,1,323,5200,21,490,5711
subtest29of10,pubtest225of100,1,323,5200,22,529,5751
subtest24of10,pubtest225of100,1,323,5200,21,568,5789
subtest28of10,pubtest225of100,1,323,5200,24,607,5831
subtest210of10,pubtest225of100,1,323,5200,25,644,5869
subtest25of10,pubtest225of100,1,323,5200,21,684,5905
subtest22of10,pubtest226of100,1,323,5293,12,298,5603
subtest25of10,pubtest226of100,1,323,5293,12,298,5603
subtest23of10,pubtest226of100,1,323,5293,21,327,5641
subtest210of10,pubtest226of100,1,323,5293,21,367,5681
subtest27of10,pubtest226of100,1,323,5293,25,403,5721
subtest21of10,pubtest226of100,1,323,5293,26,442,5761
subtest28of10,pubtest226of100,1,323,5293,27,479,5799
subtest29of10,pubtest226of100,1,323,5293,31,518,5842
subtest24of10,pubtest226of100,1,323,5293,30,558,5881
subtest26of10,pubtest226of100,1,323,5293,28,597,5918
subtest29of10,pubtest227of100,1,323,5777,13,41,5831
subtest25of10,pubtest227of100,1,323,5777,19,75,5871
subtest210of10,pubtest227of100,1,323,5777,20,113,5910
subtest23of10,pubtest227of100,1,323,5777,21,152,5950
subtest24of10,pubtest227of100,1,323,5777,23,190,5990
subtest27of10,pubtest227of100,1,323,5777,24,229,6030
subtest21of10,pubtest227of100,1,323,5777,31,262,6070
subtest22of10,pubtest227of100,1,323,5777,33,300,6110
subtest26of10,pubtest227of100,1,323,5777,33,340,6150
subtest28of10,pubtest227of100,1,323,5777,34,379,6190
subtest26of10,pubtest228of100,1,323,5302,50,86,5438
subtest21of10,pubtest228of100,1,323,5302,48,87,5437
subtest25of10,pubtest228of100,1,323,5302,52,118,5472
subtest23of10,pubtest228of100,1,323,5302,54,156,5512
subtest27of10,pubtest228of100,1,323,5302,54,195,5551
subtest29of10,pubtest228of100,1,323,5302,136,153,5591
subtest22of10,pubtest228of100,1,323,5302,138,191,5631
subtest210of10,pubtest228of100,1,323,5302,139,230,5671
subtest24of10,pubtest228of100,1,323,5302,141,268,5711
subtest28of10,pubtest228of100,1,323,5302,142,307,5751
subtest24of10,pubtest229of100,1,321,5531,10,39,5580
subtest28of10,pubtest229of100,1,321,5531,12,77,5620
subtest21of10,pubtest229of100,1,321,5531,34,95,5660
subtest23of10,pubtest229of100,1,321,5531,40,129,5700
subtest25of10,pubtest229of100,1,321,5531,40,169,5740
subtest27of10,pubtest229of100,1,321,5531,37,208,5776
subtest22of10,pubtest229of100,1,321,5531,42,246,5819
subtest210of10,pubtest229of100,1,321,5531,43,286,5860
subtest29of10,pubtest229of100,1,321,5531,44,325,5900
subtest26of10,pubtest229of100,1,321,5531,44,365,5940
subtest21of10,pubtest230of100,1,323,5586,17,40,5643
subtest27of10,pubtest230of100,1,323,5586,17,79,5682
subtest23of10,pubtest230of100,1,323,5586,22,114,5722
subtest25of10,pubtest230of100,1,323,5586,22,154,5762
subtest29of10,pubtest230of100,1,323,5586,20,193,5799
subtest210of10,pubtest230of100,1,323,5586,24,232,5842
subtest28of10,pubtest230of100,1,323,5586,24,272,5882
subtest22of10,pubtest230of100,1,323,5586,19,311,5916
subtest24of10,pubtest230of100,1,323,5586,26,350,5962
subtest26of10,pubtest230of100,1,323,5586,26,391,6003
subtest23of10,pubtest231of100,1,323,5551,9,40,5600
subtest25of10,pubtest231of100,1,323,5551,10,78,5639
subtest24of10,pubtest231of100,1,323,5551,12,115,5678
subtest28of10,pubtest231of100,1,323,5551,12,154,5717
subtest29of10,pubtest231of100,1,323,5551,19,189,5759
subtest210of10,pubtest231of100,1,323,5551,19,229,5799
subtest26of10,pubtest231of100,1,323,5551,22,266,5839
subtest22of10,pubtest231of100,1,323,5551,26,302,5879
subtest27of10,pubtest231of100,1,323,5551,29,339,5919
subtest21of10,pubtest231of100,1,323,5551,30,378,5959
subtest21of10,pubtest232of100,1,323,5460,10,39,5509
subtest22of10,pubtest232of100,1,323,5460,17,70,5547
subtest27of10,pubtest232of100,1,323,5460,21,108,5589
subtest23of10,pubtest232of100,1,323,5460,21,147,5628
subtest29of10,pubtest232of100,1,323,5460,22,186,5668
subtest25of10,pubtest232of100,1,323,5460,23,226,5709
subtest210of10,pubtest232of100,1,323,5460,24,263,5747
subtest28of10,pubtest232of100,1,323,5460,25,303,5788
subtest24of10,pubtest232of100,1,323,5460,24,342,5826
subtest26of10,pubtest232of100,1,323,5460,26,382,5868
subtest24of10,pubtest233of100,1,323,5341,12,41,5394
subtest25of10,pubtest233of100,1,323,5341,16,80,5437
subtest29of10,pubtest233of100,1,323,5341,12,121,5474
subtest210of10,pubtest233of100,1,323,5341,18,158,5517
subtest27of10,pubtest233of100,1,323,5341,22,195,5558
subtest26of10,pubtest233of100,1,323,5341,22,233,5596
subtest23of10,pubtest233of100,1,323,5341,24,272,5637
subtest22of10,pubtest233of100,1,323,5341,24,312,5677
subtest21of10,pubtest233of100,1,323,5341,51,325,5717
subtest28of10,pubtest233of100,1,323,5341,53,363,5757
subtest25of10,pubtest234of100,1,323,5238,13,41,5292
subtest26of10,pubtest234of100,1,323,5238,14,78,5330
subtest22of10,pubtest234of100,1,323,5238,15,117,5370
subtest21of10,pubtest234of100,1,323,5238,17,156,5411
subtest27of10,pubtest234of100,1,323,5238,15,197,5450
subtest210of10,pubtest234of100,1,323,5238,18,234,5490
subtest29of10,pubtest234of100,1,323,5238,21,271,5530
subtest23of10,pubtest234of100,1,323,5238,22,310,5570
subtest24of10,pubtest234of100,1,323,5238,24,348,5610
subtest28of10,pubtest234of100,1,323,5238,24,388,5650
subtest21of10,pubtest235of100,1,321,5271,9,41,5321
subtest210of10,pubtest235of100,1,321,5271,10,80,5361
subtest27of10,pubtest235of100,1,321,5271,14,117,5402
subtest22of10,pubtest235of100,1,321,5271,14,156,5441
subtest23of10,pubtest235of100,1,321,5271,14,194,5479
subtest24of10,pubtest235of100,1,321,5271,20,230,5521
subtest29of10,pubtest235of100,1,321,5271,20,270,5561
subtest25of10,pubtest235of100,1,321,5271,21,309,5601
subtest26of10,pubtest235of100,1,321,5271,25,345,5641
subtest28of10,pubtest235of100,1,321,5271,25,386,5682
subtest210of10,pubtest236of100,1,323,5284,13,42,5339
subtest23of10,pubtest236of100,1,323,5284,13,81,5378
subtest28of10,pubtest236of100,1,323,5284,15,119,5418
subtest27of10,pubtest236of100,1,323,5284,15,159,5458
subtest21of10,pubtest236of100,1,323,5284,17,197,5498
subtest29of10,pubtest236of100,1,323,5284,17,238,5539
subtest25of10,pubtest236of100,1,323,5284,18,276,5578
subtest24of10,pubtest236of100,1,323,5284,20,314,5618
subtest26of10,pubtest236of100,1,323,5284,20,354,5658
subtest22of10,pubtest236of100,1,323,5284,22,392,5698
subtest24of10,pubtest237of100,1,323,5340,14,39,5393
subtest23of10,pubtest237of100,1,323,5340,17,75,5432
subtest25of10,pubtest237of100,1,323,5340,19,495,5854
subtest28of10,pubtest237of100,1,323,5340,21,530,5891
subtest26of10,pubtest237of100,1,323,5340,22,569,5931
subtest21of10,pubtest237of100,1,323,5340,24,611,5975
subtest27of10,pubtest237of100,1,323,5340,24,651,6015
subtest22of10,pubtest237of100,1,323,5340,42,672,6054
subtest210of10,pubtest237of100,1,323,5340,43,712,6095
subtest29of10,pubtest237of100,1,323,5340,42,751,6133
subtest29of10,pubtest238of100,1,323,5640,28,41,5709
subtest22of10,pubtest238of100,1,323,5640,31,77,5748
subtest27of10,pubtest238of100,1,323,5640,31,117,5788
subtest28of10,pubtest238of100,1,323,5640,35,153,5828
subtest23of10,pubtest238of100,1,323,5640,36,191,5867
subtest25of10,pubtest238of100,1,323,5640,35,231,5906
subtest26of10,pubtest238of100,1,323,5640,38,270,5948
subtest21of10,pubtest238of100,1,323,5640,38,310,5988
subtest210of10,pubtest238of100,1,323,5640,40,348,6028
subtest24of10,pubtest238of100,1,323,5640,40,386,6066
subtest27of10,pubtest239of100,1,323,5887,12,39,5938
subtest21of10,pubtest239of100,1,323,5887,12,78,5977
subtest28of10,pubtest239of100,1,323,5887,14,116,6017
subtest26of10,pubtest239of100,1,323,5887,16,154,6057
subtest25of10,pubtest239of100,1,323,5887,19,191,6097
subtest24of10,pubtest239of100,1,323,5887,21,229,6137
subtest29of10,pubtest239of100,1,323,5887,25,265,6177
subtest23of10,pubtest239of100,1,323,5887,27,303,6217
subtest22of10,pubtest239of100,1,323,5887,30,340,6257
subtest210of10,pubtest239of100,1,323,5887,33,377,6297
subtest25of10,pubtest240of100,1,323,5746,12,40,5798
subtest21of10,pubtest240of100,1,323,5746,12,79,5837
subtest210of10,pubtest240of100,1,323,5746,14,117,5877
subtest29of10,pubtest240of100,1,323,5746,14,157,5917
subtest27of10,pubtest240of100,1,323,5746,20,191,5957
subtest28of10,pubtest240of100,1,323,5746,26,225,5997
subtest24of10,pubtest240of100,1,323,5746,28,262,6036
subtest23of10,pubtest240of100,1,323,5746,28,302,6076
subtest26of10,pubtest240of100,1,323,5746,34,337,6117
subtest22of10,pubtest240of100,1,323,5746,34,377,6157
subtest23of10,pubtest241of100,1,323,5743,20,39,5802
subtest27of10,pubtest241of100,1,323,5743,20,78,5841
subtest210of10,pubtest241of100,1,323,5743,27,111,5881
subtest21of10,pubtest241of100,1,323,5743,28,150,5921
subtest24of10,pubtest241of100,1,323,5743,27,190,5960
subtest29of10,pubtest241of100,1,323,5743,29,229,6001
subtest28of10,pubtest241of100,1,323,5743,34,263,6040
subtest26of10,pubtest241of100,1,323,5743,37,301,6081
subtest22of10,pubtest241of100,1,323,5743,37,341,6121
subtest25of10,pubtest241of100,1,323,5743,34,381,6158
subtest27of10,pubtest242of100,1,323,5522,12,359,5893
subtest26of10,pubtest242of100,1,323,5522,15,393,5930
subtest23of10,pubtest242of100,1,323,5522,15,433,5970
subtest25of10,pubtest242of100,1,323,5522,16,471,6009
subtest29of10,pubtest242of100,1,323,5522,21,507,6050
subtest21of10,pubtest242of100,1,323,5522,21,547,6090
subtest22of10,pubtest242of100,1,323,5522,23,583,6128
subtest210of10,pubtest242of100,1,323,5522,23,622,6167
subtest24of10,pubtest242of100,1,323,5522,26,662,6210
subtest28of10,pubtest242of100,1,323,5522,30,698,6250
subtest29of10,pubtest243of100,1,323,6081,13,42,6136
subtest28of10,pubtest243of100,1,323,6081,14,80,6175
subtest22of10,pubtest243of100,1,323,6081,16,118,6215
subtest23of10,pubtest243of100,1,323,6081,20,155,6256
subtest26of10,pubtest243of100,1,323,6081,22,191,6294
subtest27of10,pubtest243of100,1,323,6081,24,231,6336
subtest25of10,pubtest243of100,1,323,6081,21,270,6372
subtest24of10,pubtest243of100,1,323,6081,28,305,6414
subtest21of10,pubtest243of100,1,323,6081,29,345,6455
subtest210of10,pubtest243of100,1,323,6081,30,384,6495
subtest26of10,pubtest244of100,1,323,5639,18,40,5697
subtest27of10,pubtest244of100,1,323,5639,19,79,5737
subtest29of10,pubtest244of100,1,323,5639,21,117,5777
subtest25of10,pubtest244of100,1,323,5639,21,157,5817
subtest28of10,pubtest244of100,1,323,5639,24,195,5858
subtest21of10,pubtest244of100,1,323,5639,24,234,5897
subtest210of10,pubtest244of100,1,323,5639,28,270,5937
subtest23of10,pubtest244of100,1,323,5639,28,310,5977
subtest22of10,pubtest244of100,1,323,5639,30,348,6017
subtest24of10,pubtest244of100,1,323,5639,30,388,6057
subtest26of10,pubtest245of100,1,322,5817,15,39,5871
subtest29of10,pubtest245of100,1,322,5817,14,79,5910
subtest22of10,pubtest245of100,1,322,5817,15,118,5950
subtest23of10,pubtest245of100,1,322,5817,16,155,5988
subtest24of10,pubtest245of100,1,322,5817,20,192,6029
subtest25of10,pubtest245of100,1,322,5817,20,232,6069
subtest21of10,pubtest245of100,1,322,5817,27,266,6110
subtest28of10,pubtest245of100,1,322,5817,28,305,6150
subtest27of10,pubtest245of100,1,322,5817,29,344,6190
subtest210of10,pubtest245of100,1,322,5817,30,383,6230
subtest26of10,pubtest246of100,1,323,5843,18,41,5902
subtest27of10,pubtest246of100,1,323,5843,20,79,5942
subtest21of10,pubtest246of100,1,323,5843,24,113,5980
subtest29of10,pubtest246of100,1,323,5843,26,152,6021
subtest28of10,pubtest246of100,1,323,5843,27,192,6062
subtest23of10,pubtest246of100,1,323,5843,29,230,6102
subtest210of10,pubtest246of100,1,323,5843,29,270,6142
subtest25of10,pubtest246of100,1,323,5843,30,309,6182
subtest24of10,pubtest246of100,1,323,5843,30,349,6222
subtest22of10,pubtest246of100,1,323,5843,34,385,6262
subtest27of10,pubtest247of100,1,323,5401,12,39,5452
subtest26of10,pubtest247of100,1,323,5401,13,75,5489
subtest21of10,pubtest247of100,1,323,5401,16,114,5531
subtest23of10,pubtest247of100,1,323,5401,17,153,5571
subtest22of10,pubtest247of100,1,323,5401,18,192,5611
subtest29of10,pubtest247of100,1,323,5401,29,221,5651
subtest28of10,pubtest247of100,1,323,5401,30,260,5691
subtest210of10,pubtest247of100,1,323,5401,33,297,5731
subtest25of10,pubtest247of100,1,323,5401,34,335,5770
subtest24of10,pubtest247of100,1,323,5401,35,375,5811
subtest29of10,pubtest248of100,1,323,5924,11,43,5978
subtest25of10,pubtest248of100,1,323,5924,17,76,6017
subtest26of10,pubtest248of100,1,323,5924,17,114,6055
subtest23of10,pubtest248of100,1,323,5924,18,154,6096
subtest28of10,pubtest248of100,1,323,5924,19,194,6137
subtest27of10,pubtest248of100,1,323,5924,26,227,6177
subtest21of10,pubtest248of100,1,323,5924,26,267,6217
subtest24of10,pubtest248of100,1,323,5924,28,306,6258
subtest210of10,pubtest248of100,1,323,5924,28,345,6297
subtest22of10,pubtest248of100,1,323,5924,28,384,6336
subtest27of10,pubtest249of100,1,323,5753,12,39,5804
subtest28of10,pubtest249of100,1,323,5753,17,73,5843
subtest24of10,pubtest249of100,1,323,5753,18,112,5883
subtest25of10,pubtest249of100,1,323,5753,19,151,5923
subtest29of10,pubtest249of100,1,323,5753,20,191,5964
subtest26of10,pubtest249of100,1,323,5753,20,231,6004
subtest23of10,pubtest249of100,1,323,5753,22,268,6043
subtest22of10,pubtest249of100,1,323,5753,22,308,6083
subtest21of10,pubtest249of100,1,323,5753,20,347,6120
subtest210of10,pubtest249of100,1,323,5753,22,386,6161
subtest27of10,pubtest250of100,1,323,5488,23,39,5550
subtest28of10,pubtest250of100,1,323,5488,24,77,5589
subtest24of10,pubtest250of100,1,323,5488,25,116,5629
subtest23of10,pubtest250of100,1,323,5488,25,155,5668
subtest29of10,pubtest250of100,1,323,5488,31,190,5709
subtest25of10,pubtest250of100,1,323,5488,32,229,5749
subtest26of10,pubtest250of100,1,323,5488,33,268,5789
subtest21of10,pubtest250of100,1,323,5488,32,307,5827
subtest210of10,pubtest250of100,1,323,5488,34,347,5869
subtest22of10,pubtest250of100,1,323,5488,35,386,5909
subtest23of10,pubtest251of100,1,323,5333,11,40,5384
subtest22of10,pubtest251of100,1,323,5333,13,77,5423
subtest27of10,pubtest251of100,1,323,5333,19,111,5463
subtest24of10,pubtest251of100,1,323,5333,19,151,5503
subtest25of10,pubtest251of100,1,323,5333,23,187,5543
subtest21of10,pubtest251of100,1,323,5333,24,228,5585
subtest29of10,pubtest251of100,1,323,5333,26,264,5623
subtest28of10,pubtest251of100,1,323,5333,26,304,5663
subtest26of10,pubtest251of100,1,323,5333,28,342,5703
subtest210of10,pubtest251of100,1,323,5333,28,382,5743
subtest29of10,pubtest252of100,1,323,5602,17,40,5659
subtest28of10,pubtest252of100,1,323,5602,17,80,5699
subtest21of10,pubtest252of100,1,323,5602,19,117,5738
subtest27of10,pubtest252of100,1,323,5602,23,153,5778
subtest26of10,pubtest252of100,1,323,5602,24,192,5818
subtest22of10,pubtest252of100,1,323,5602,25,231,5858
subtest23of10,pubtest252of100,1,323,5602,26,269,5897
subtest210of10,pubtest252of100,1,323,5602,27,309,5938
subtest25of10,pubtest252of100,1,323,5602,26,348,5976
subtest24of10,pubtest252of100,1,323,5602,27,388,6017
subtest28of10,pubtest253of100,1,322,5765,14,41,5820
subtest23of10,pubtest253of100,1,322,5765,38,56,5859
subtest24of10,pubtest253of100,1,322,5765,39,94,5898
subtest25of10,pubtest253of100,1,322,5765,40,133,5938
subtest22of10,pubtest253of100,1,322,5765,41,172,5978
subtest29of10,pubtest253of100,1,322,5765,42,211,6018
subtest27of10,pubtest253of100,1,322,5765,43,250,6058
subtest21of10,pubtest253of100,1,322,5765,48,285,6098
subtest210of10,pubtest253of100,1,322,5765,49,324,6138
subtest26of10,pubtest253of100,1,322,5765,50,363,6178
subtest210of10,pubtest254of100,1,323,5600,13,40,5653
subtest27of10,pubtest254of100,1,323,5600,14,79,5693
subtest21of10,pubtest254of100,1,323,5600,15,118,5733
subtest25of10,pubtest254of100,1,323,5600,18,154,5772
subtest23of10,pubtest254of100,1,323,5600,18,194,5812
subtest28of10,pubtest254of100,1,323,5600,18,233,5851
subtest29of10,pubtest254of100,1,323,5600,25,267,5892
subtest24of10,pubtest254of100,1,323,5600,25,307,5932
subtest22of10,pubtest254of100,1,323,5600,26,344,5970
subtest26of10,pubtest254of100,1,323,5600,35,377,6012
subtest23of10,pubtest255of100,1,322,5436,11,38,5485
subtest22of10,pubtest255of100,1,322,5436,16,72,5524
subtest27of10,pubtest255of100,1,322,5436,19,109,5564
subtest28of10,pubtest255of100,1,322,5436,19,149,5604
subtest29of10,pubtest255of100,1,322,5436,23,185,5644
subtest21of10,pubtest255of100,1,322,5436,24,224,5684
subtest25of10,pubtest255of100,1,322,5436,25,261,5722
subtest24of10,pubtest255of100,1,322,5436,25,300,5761
subtest210of10,pubtest255of100,1,322,5436,28,340,5804
subtest26of10,pubtest255of100,1,322,5436,29,379,5844
subtest29of10,pubtest256of100,1,323,5436,13,39,5488
subtest21of10,pubtest256of100,1,323,5436,20,71,5527
subtest26of10,pubtest256of100,1,323,5436,24,107,5567
subtest25of10,pubtest256of100,1,323,5436,25,146,5607
subtest210of10,pubtest256of100,1,323,5436,26,185,5647
subtest23of10,pubtest256of100,1,323,5436,24,222,5682
subtest27of10,pubtest256of100,1,323,5436,27,263,5726
subtest24of10,pubtest256of100,1,323,5436,27,301,5764
subtest28of10,pubtest256of100,1,323,5436,31,340,5807
subtest22of10,pubtest256of100,1,323,5436,31,380,5847
subtest24of10,pubtest257of100,1,323,5618,13,49,5680
subtest21of10,pubtest257of100,1,323,5618,14,87,5719
subtest28of10,pubtest257of100,1,323,5618,15,125,5758
subtest23of10,pubtest257of100,1,323,5618,17,164,5799
subtest22of10,pubtest257of100,1,323,5618,17,204,5839
subtest29of10,pubtest257of100,1,323,5618,18,240,5876
subtest25of10,pubtest257of100,1,323,5618,22,279,5919
subtest26of10,pubtest257of100,1,323,5618,22,320,5960
subtest210of10,pubtest257of100,1,323,5618,23,358,5999
subtest27of10,pubtest257of100,1,323,5618,25,396,6039
subtest28of10,pubtest258of100,1,323,5216,13,38,5267
subtest23of10,pubtest258of100,1,323,5216,18,71,5305
subtest25of10,pubtest258of100,1,323,5216,19,111,5346
subtest21of10,pubtest258of100,1,323,5216,20,150,5386
subtest26of10,pubtest258of100,1,323,5216,26,184,5426
subtest29of10,pubtest258of100,1,323,5216,26,224,5466
subtest27of10,pubtest258of100,1,323,5216,28,262,5506
subtest210of10,pubtest258of100,1,323,5216,29,300,5545
subtest22of10,pubtest258of100,1,323,5216,30,340,5586
subtest24of10,pubtest258of100,1,323,5216,31,379,5626
subtest21of10,pubtest259of100,1,323,5638,12,40,5690
subtest28of10,pubtest259of100,1,323,5638,12,79,5729
subtest24of10,pubtest259of100,1,323,5638,22,107,5767
subtest25of10,pubtest259of100,1,323,5638,22,147,5807
subtest27of10,pubtest259of100,1,323,5638,24,186,5848
subtest23of10,pubtest259of100,1,323,5638,27,225,5890
subtest22of10,pubtest259of100,1,323,5638,27,264,5929
subtest26of10,pubtest259of100,1,323,5638,28,303,5969
subtest29of10,pubtest259of100,1,323,5638,29,342,6009
subtest210of10,pubtest259of100,1,323,5638,30,381,6049
subtest210of10,pubtest260of100,1,323,5788,12,39,5839
subtest23of10,pubtest260of100,1,323,5788,13,76,5877
subtest21of10,pubtest260of100,1,323,5788,19,110,5917
subtest26of10,pubtest260of100,1,323,5788,20,149,5957
subtest27of10,pubtest260of100,1,323,5788,21,188,5997
subtest29of10,pubtest260of100,1,323,5788,22,227,6037
subtest24of10,pubtest260of100,1,323,5788,25,265,6078
subtest28of10,pubtest260of100,1,323,5788,24,305,6117
subtest25of10,pubtest260of100,1,323,5788,23,344,6155
subtest22of10,pubtest260of100,1,323,5788,24,384,6196
subtest28of10,pubtest261of100,1,323,5298,16,47,5361
subtest210of10,pubtest261of100,1,323,5298,18,86,5402
subtest29of10,pubtest261of100,1,323,5298,19,125,5442
subtest24of10,pubtest261of100,1,323,5298,21,163,5482
subtest22of10,pubtest261of100,1,323,5298,21,203,5522
subtest23of10,pubtest261of100,1,323,5298,22,242,5562
subtest27of10,pubtest261of100,1,323,5298,22,282,5602
subtest26of10,pubtest261of100,1,323,5298,24,320,5642
subtest25of10,pubtest261of100,1,323,5298,18,361,5677
subtest21of10,pubtest261of100,1,323,5298,24,399,5721
subtest21of10,pubtest262of100,1,323,5210,11,43,5264
subtest22of10,pubtest262of100,1,323,5210,15,78,5303
subtest23of10,pubtest262of100,1,323,5210,45,87,5342
subtest27of10,pubtest262of100,1,323,5210,46,126,5382
subtest29of10,pubtest262of100,1,323,5210,50,162,5422
subtest26of10,pubtest262of100,1,323,5210,50,203,5463
subtest25of10,pubtest262of100,1,323,5210,51,241,5502
subtest210of10,pubtest262of100,1,323,5210,52,280,5542
subtest24of10,pubtest262of100,1,323,5210,54,318,5582
subtest28of10,pubtest262of100,1,323,5210,56,355,5621
subtest22of10,pubtest263of100,1,322,5227,15,41,5283
subtest24of10,pubtest263of100,1,322,5227,17,79,5323
subtest29of10,pubtest263of100,1,322,5227,16,120,5363
subtest23of10,pubtest263of100,1,322,5227,18,157,5402
subtest26of10,pubtest263of100,1,322,5227,19,196,5442
subtest25of10,pubtest263of100,1,322,5227,23,232,5482
subtest210of10,pubtest263of100,1,322,5227,23,272,5522
subtest27of10,pubtest263of100,1,322,5227,25,310,5562
subtest21of10,pubtest263of100,1,322,5227,25,350,5602
subtest28of10,pubtest263of100,1,322,5227,27,389,5643
subtest29of10,pubtest264of100,1,322,5604,9,39,5652
subtest23of10,pubtest264of100,1,322,5604,9,78,5691
subtest27of10,pubtest264of100,1,322,5604,11,116,5731
subtest21of10,pubtest264of100,1,322,5604,12,155,5771
subtest25of10,pubtest264of100,1,322,5604,13,194,5811
subtest22of10,pubtest264of100,1,322,5604,18,229,5851
subtest24of10,pubtest264of100,1,322,5604,18,269,5891
subtest26of10,pubtest264of100,1,322,5604,20,307,5931
subtest210of10,pubtest264of100,1,322,5604,20,347,5971
subtest28of10,pubtest264of100,1,322,5604,21,386,6011
subtest26of10,pubtest265of100,1,323,5401,17,45,5463
subtest27of10,pubtest265of100,1,323,5401,18,83,5502
subtest21of10,pubtest265of100,1,323,5401,19,123,5543
subtest29of10,pubtest265of100,1,323,5401,21,161,5583
subtest210of10,pubtest265of100,1,323,5401,21,202,5624
subtest28of10,pubtest265of100,1,323,5401,21,240,5662
subtest25of10,pubtest265of100,1,323,5401,23,279,5703
subtest23of10,pubtest265of100,1,323,5401,23,319,5743
subtest24of10,pubtest265of100,1,323,5401,24,358,5783
subtest22of10,pubtest265of100,1,323,5401,25,395,5821
subtest29of10,pubtest266of100,1,321,5182,12,44,5238
subtest210of10,pubtest266of100,1,321,5182,14,81,5277
subtest25of10,pubtest266of100,1,321,5182,16,119,5317
subtest27of10,pubtest266of100,1,321,5182,17,158,5357
subtest23of10,pubtest266of100,1,321,5182,18,197,5397
subtest26of10,pubtest266of100,1,321,5182,19,236,5437
subtest28of10,pubtest266of100,1,321,5182,19,277,5478
subtest21of10,pubtest266of100,1,321,5182,25,311,5518
subtest24of10,pubtest266of100,1,321,5182,33,342,5557
subtest22of10,pubtest266of100,1,321,5182,34,381,5597
subtest23of10,pubtest267of100,1,323,5168,13,44,5225
subtest26of10,pubtest267of100,1,323,5168,14,83,5265
subtest25of10,pubtest267of100,1,323,5168,15,121,5304
subtest24of10,pubtest267of100,1,323,5168,20,156,5344
subtest29of10,pubtest267of100,1,323,5168,17,196,5381
subtest28of10,pubtest267of100,1,323,5168,17,235,5420
subtest27of10,pubtest267of100,1,323,5168,16,275,5459
subtest21of10,pubtest267of100,1,323,5168,22,314,5504
subtest22of10,pubtest267of100,1,323,5168,23,353,5544
subtest210of10,pubtest267of100,1,323,5168,24,392,5584
subtest23of10,pubtest268of100,1,323,5218,17,39,5274
subtest29of10,pubtest268of100,1,323,5218,19,76,5313
subtest25of10,pubtest268of100,1,323,5218,17,113,5348
subtest21of10,pubtest268of100,1,323,5218,23,153,5394
subtest24of10,pubtest268of100,1,323,5218,23,192,5433
subtest28of10,pubtest268of100,1,323,5218,19,231,5468
subtest210of10,pubtest268of100,1,323,5218,25,269,5512
subtest26of10,pubtest268of100,1,323,5218,25,309,5552
subtest27of10,pubtest268of100,1,323,5218,23,349,5590
subtest22of10,pubtest268of100,1,323,5218,26,388,5632
subtest24of10,pubtest269of100,1,323,5157,11,58,5226
subtest210of10,pubtest269of100,1,323,5157,22,87,5266
subtest22of10,pubtest269of100,1,323,5157,22,126,5305
subtest29of10,pubtest269of100,1,323,5157,23,165,5345
subtest21of10,pubtest269of100,1,323,5157,24,204,5385
subtest27of10,pubtest269of100,1,323,5157,16,243,5416
subtest25of10,pubtest269of100,1,323,5157,25,283,5465
subtest23of10,pubtest269of100,1,323,5157,27,321,5505
subtest26of10,pubtest269of100,1,323,5157,27,361,5545
subtest28of10,pubtest269of100,1,323,5157,37,391,5585
subtest23of10,pubtest270of100,1,323,5304,12,45,5361
subtest27of10,pubtest270of100,1,323,5304,17,79,5400
subtest26of10,pubtest270of100,1,323,5304,17,119,5440
subtest29of10,pubtest270of100,1,323,5304,19,157,5480
subtest210of10,pubtest270of100,1,323,5304,21,195,5520
subtest25of10,pubtest270of100,1,323,5304,22,234,5560
subtest21of10,pubtest270of100,1,323,5304,22,274,5600
subtest22of10,pubtest270of100,1,323,5304,24,313,5641
subtest28of10,pubtest270of100,1,323,5304,24,352,5680
subtest24of10,pubtest270of100,1,323,5304,25,390,5719
subtest24of10,pubtest271of100,1,323,5531,12,40,5583
subtest25of10,pubtest271of100,1,323,5531,20,71,5622
subtest22of10,pubtest271of100,1,323,5531,20,111,5662
subtest27of10,pubtest271of100,1,323,5531,24,147,5702
subtest26of10,pubtest271of100,1,323,5531,24,192,5747
subtest21of10,pubtest271of100,1,323,5531,26,230,5787
subtest210of10,pubtest271of100,1,323,5531,24,270,5825
subtest28of10,pubtest271of100,1,323,5531,27,308,5866
subtest23of10,pubtest271of100,1,323,5531,27,348,5906
subtest29of10,pubtest271of100,1,323,5531,29,386,5946
subtest25of10,pubtest272of100,1,323,5188,13,38,5239
subtest26of10,pubtest272of100,1,323,5188,15,75,5278
subtest21of10,pubtest272of100,1,323,5188,15,115,5318
subtest29of10,pubtest272of100,1,323,5188,23,147,5358
subtest24of10,pubtest272of100,1,323,5188,24,187,5399
subtest23of10,pubtest272of100,1,323,5188,25,225,5438
subtest27of10,pubtest272of100,1,323,5188,25,265,5478
subtest22of10,pubtest272of100,1,323,5188,27,303,5518
subtest28of10,pubtest272of100,1,323,5188,27,343,5558
subtest210of10,pubtest272of100,1,323,5188,27,382,5597
subtest22of10,pubtest273of100,1,321,5148,11,45,5204
subtest26of10,pubtest273of100,1,321,5148,13,81,5242
subtest29of10,pubtest273of100,1,321,5148,12,122,5282
subtest25of10,pubtest273of100,1,321,5148,20,153,5321
subtest23of10,pubtest273of100,1,321,5148,22,193,5363
subtest27of10,pubtest273of100,1,321,5148,22,232,5402
subtest21of10,pubtest273of100,1,321,5148,24,270,5442
subtest210of10,pubtest273of100,1,321,5148,24,310,5482
subtest24of10,pubtest273of100,1,321,5148,24,346,5518
subtest28of10,pubtest273of100,1,321,5148,20,394,5562
subtest21of10,pubtest274of100,1,323,5260,11,39,5310
subtest23of10,pubtest274of100,1,323,5260,16,73,5349
subtest26of10,pubtest274of100,1,323,5260,20,108,5388
subtest27of10,pubtest274of100,1,323,5260,25,143,5428
subtest25of10,pubtest274of100,1,323,5260,24,183,5467
subtest29of10,pubtest274of100,1,323,5260,24,222,5506
subtest22of10,pubtest274of100,1,323,5260,26,263,5549
subtest28of10,pubtest274of100,1,323,5260,32,296,5588
subtest210of10,pubtest274of100,1,323,5260,32,336,5628
subtest24of10,pubtest274of100,1,323,5260,34,375,5669
subtest27of10,pubtest275of100,1,323,5264,16,54,5334
subtest29of10,pubtest275of100,1,323,5264,18,92,5374
subtest24of10,pubtest275of100,1,323,5264,17,130,5411
subtest21of10,pubtest275of100,1,323,5264,21,168,5453
subtest25of10,pubtest275of100,1,323,5264,22,201,5487
subtest26of10,pubtest275of100,1,323,5264,28,241,5533
subtest23of10,pubtest275of100,1,323,5264,28,280,5572
subtest28of10,pubtest275of100,1,323,5264,30,319,5613
subtest22of10,pubtest275of100,1,323,5264,30,359,5653
subtest210of10,pubtest275of100,1,323,5264,32,397,5693
subtest28of10,pubtest276of100,1,323,5246,13,38,5297
subtest25of10,pubtest276of100,1,323,5246,15,75,5336
subtest21of10,pubtest276of100,1,323,5246,15,115,5376
subtest27of10,pubtest276of100,1,323,5246,17,151,5414
subtest23of10,pubtest276of100,1,323,5246,20,190,5456
subtest24of10,pubtest276of100,1,323,5246,20,230,5496
subtest26of10,pubtest276of100,1,323,5246,22,462,5730
subtest29of10,pubtest276of100,1,323,5246,22,500,5768
subtest210of10,pubtest276of100,1,323,5246,23,539,5808
subtest22of10,pubtest276of100,1,323,5246,23,579,5848
subtest22of10,pubtest277of100,1,323,5160,10,46,5216
subtest28of10,pubtest277of100,1,323,5160,16,80,5256
subtest27of10,pubtest277of100,1,323,5160,16,119,5295
subtest29of10,pubtest277of100,1,323,5160,12,158,5330
subtest21of10,pubtest277of100,1,323,5160,18,197,5375
subtest24of10,pubtest277of100,1,323,5160,23,232,5415
subtest25of10,pubtest277of100,1,323,5160,36,259,5455
subtest210of10,pubtest277of100,1,323,5160,54,281,5495
subtest23of10,pubtest277of100,1,323,5160,55,320,5535
subtest26of10,pubtest277of100,1,323,5160,56,359,5575
subtest29of10,pubtest278of100,1,323,5244,10,41,5295
subtest28of10,pubtest278of100,1,323,5244,15,76,5335
subtest22of10,pubtest278of100,1,323,5244,14,115,5373
subtest21of10,pubtest278of100,1,323,5244,16,155,5415
subtest26of10,pubtest278of100,1,323,5244,18,193,5455
subtest25of10,pubtest278of100,1,323,5244,19,231,5494
subtest210of10,pubtest278of100,1,323,5244,20,271,5535
subtest27of10,pubtest278of100,1,323,5244,17,311,5572
subtest23of10,pubtest278of100,1,323,5244,15,351,5610
subtest24of10,pubtest278of100,1,323,5244,21,390,5655
subtest25of10,pubtest279of100,1,323,5171,13,48,5232
subtest28of10,pubtest279of100,1,323,5171,14,87,5272
subtest24of10,pubtest279of100,1,323,5171,15,125,5311
subtest21of10,pubtest279of100,1,323,5171,17,163,5351
subtest210of10,pubtest279of100,1,323,5171,20,201,5392
subtest26of10,pubtest279of100,1,323,5171,21,240,5432
subtest22of10,pubtest279of100,1,323,5171,19,279,5469
subtest27of10,pubtest279of100,1,323,5171,22,318,5511
subtest29of10,pubtest279of100,1,323,5171,23,357,5551
subtest23of10,pubtest279of100,1,323,5171,24,396,5591
subtest27of10,pubtest280of100,1,323,5199,14,41,5254
subtest29of10,pubtest280of100,1,323,5199,23,72,5294
subtest24of10,pubtest280of100,1,323,5199,24,110,5333
subtest21of10,pubtest280of100,1,323,5199,25,149,5373
subtest26of10,pubtest280of100,1,323,5199,29,185,5413
subtest23of10,pubtest280of100,1,323,5199,64,190,5453
subtest25of10,pubtest280of100,1,323,5199,65,229,5493
subtest210of10,pubtest280of100,1,323,5199,66,268,5533
subtest28of10,pubtest280of100,1,323,5199,67,307,5573
subtest22of10,pubtest280of100,1,323,5199,67,347,5613
subtest24of10,pubtest281of100,1,323,5230,13,42,5285
subtest23of10,pubtest281of100,1,323,5230,21,72,5323
subtest28of10,pubtest281of100,1,323,5230,22,112,5364
subtest22of10,pubtest281of100,1,323,5230,23,151,5404
subtest27of10,pubtest281of100,1,323,5230,25,189,5444
subtest210of10,pubtest281of100,1,323,5230,26,228,5484
subtest21of10,pubtest281of100,1,323,5230,28,265,5523
subtest26of10,pubtest281of100,1,323,5230,27,304,5561
subtest29of10,pubtest281of100,1,323,5230,30,344,5604
subtest25of10,pubtest281of100,1,323,5230,27,386,5643
subtest24of10,pubtest282of100,1,323,5233,12,40,5285
subtest23of10,pubtest282of100,1,323,5233,12,79,5324
subtest21of10,pubtest282of100,1,323,5233,15,116,5364
subtest22of10,pubtest282of100,1,323,5233,22,149,5404
subtest29of10,pubtest282of100,1,323,5233,23,188,5444
subtest27of10,pubtest282of100,1,323,5233,23,228,5484
subtest210of10,pubtest282of100,1,323,5233,29,262,5524
subtest28of10,pubtest282of100,1,323,5233,29,302,5564
subtest26of10,pubtest282of100,1,323,5233,28,341,5602
subtest25of10,pubtest282of100,1,323,5233,22,385,5640
subtest27of10,pubtest283of100,1,323,5150,16,44,5210
subtest24of10,pubtest283of100,1,323,5150,17,82,5249
subtest23of10,pubtest283of100,1,323,5150,18,121,5289
subtest22of10,pubtest283of100,1,323,5150,19,160,5329
subtest28of10,pubtest283of100,1,323,5150,24,195,5369
subtest25of10,pubtest283of100,1,323,5150,24,235,5409
subtest21of10,pubtest283of100,1,323,5150,30,269,5449
subtest29of10,pubtest283of100,1,323,5150,34,305,5489
subtest210of10,pubtest283of100,1,323,5150,34,345,5529
subtest26of10,pubtest283of100,1,323,5150,35,384,5569
subtest25of10,pubtest284of100,1,323,5166,14,94,5274
subtest210of10,pubtest284of100,1,323,5166,15,132,5313
subtest27of10,pubtest284of100,1,323,5166,65,122,5353
subtest22of10,pubtest284of100,1,323,5166,14,161,5341
subtest26of10,pubtest284of100,1,323,5166,67,200,5433
subtest21of10,pubtest284of100,1,323,5166,68,239,5473
subtest24of10,pubtest284of100,1,323,5166,69,278,5513
subtest28of10,pubtest284of100,1,323,5166,67,317,5550
subtest23of10,pubtest284of100,1,323,5166,70,357,5593
subtest29of10,pubtest284of100,1,323,5166,70,396,5632
subtest25of10,pubtest285of100,1,323,5172,15,46,5233
subtest23of10,pubtest285of100,1,323,5172,13,85,5270
subtest24of10,pubtest285of100,1,323,5172,19,121,5312
subtest27of10,pubtest285of100,1,323,5172,20,160,5352
subtest21of10,pubtest285of100,1,323,5172,22,198,5392
subtest22of10,pubtest285of100,1,323,5172,26,234,5432
subtest29of10,pubtest285of100,1,323,5172,26,276,5474
subtest26of10,pubtest285of100,1,323,5172,32,309,5513
subtest28of10,pubtest285of100,1,323,5172,32,348,5552
subtest210of10,pubtest285of100,1,323,5172,32,387,5591
subtest23of10,pubtest286of100,1,323,5271,10,40,5321
subtest210of10,pubtest286of100,1,323,5271,23,66,5360
subtest25of10,pubtest286of100,1,323,5271,23,105,5399
subtest29of10,pubtest286of100,1,323,5271,30,139,5440
subtest24of10,pubtest286of100,1,323,5271,32,177,5480
subtest21of10,pubtest286of100,1,323,5271,32,217,5520
subtest26of10,pubtest286of100,1,323,5271,34,255,5560
subtest22of10,pubtest286of100,1,323,5271,34,294,5599
subtest28of10,pubtest286of100,1,323,5271,35,334,5640
subtest27of10,pubtest286of100,1,323,5271,34,373,5678
subtest26of10,pubtest287of100,1,323,5248,11,38,5297
subtest28of10,pubtest287of100,1,323,5248,22,67,5337
subtest29of10,pubtest287of100,1,323,5248,22,106,5376
subtest25of10,pubtest287of100,1,323,5248,24,144,5416
subtest27of10,pubtest287of100,1,323,5248,24,184,5456
subtest210of10,pubtest287of100,1,323,5248,25,223,5496
subtest24of10,pubtest287of100,1,323,5248,25,263,5536
subtest21of10,pubtest287of100,1,323,5248,67,261,5576
subtest23of10,pubtest287of100,1,323,5248,67,299,5614
subtest22of10,pubtest287of100,1,323,5248,70,339,5657
subtest29of10,pubtest288of100,1,323,5426,12,104,5542
subtest25of10,pubtest288of100,1,323,5426,17,137,5580
subtest26of10,pubtest288of100,1,323,5426,18,176,5620
subtest27of10,pubtest288of100,1,323,5426,19,214,5659
subtest21of10,pubtest288of100,1,323,5426,21,252,5699
subtest22of10,pubtest288of100,1,323,5426,21,292,5739
subtest23of10,pubtest288of100,1,323,5426,25,328,5779
subtest24of10,pubtest288of100,1,323,5426,30,362,5818
subtest28of10,pubtest288of100,1,323,5426,31,402,5859
subtest210of10,pubtest288of100,1,323,5426,31,441,5898
subtest29of10,pubtest289of100,1,323,5176,17,46,5239
subtest25of10,pubtest289of100,1,323,5176,21,81,5278
subtest24of10,pubtest289of100,1,323,5176,20,121,5317
subtest23of10,pubtest289of100,1,323,5176,19,160,5355
subtest210of10,pubtest289of100,1,323,5176,18,199,5393
subtest26of10,pubtest289of100,1,323,5176,28,234,5438
subtest27of10,pubtest289of100,1,323,5176,28,274,5478
subtest21of10,pubtest289of100,1,323,5176,30,312,5518
subtest28of10,pubtest289of100,1,323,5176,30,352,5558
subtest22of10,pubtest289of100,1,323,5176,32,390,5598
subtest29of10,pubtest290of100,1,323,5166,33,42,5241
subtest22of10,pubtest290of100,1,323,5166,34,80,5280
subtest23of10,pubtest290of100,1,323,5166,36,118,5320
subtest25of10,pubtest290of100,1,323,5166,41,152,5359
subtest27of10,pubtest290of100,1,323,5166,42,192,5400
subtest26of10,pubtest290of100,1,323,5166,44,229,5439
subtest21of10,pubtest290of100,1,323,5166,46,268,5480
subtest210of10,pubtest290of100,1,323,5166,46,308,5520
subtest28of10,pubtest290of100,1,323,5166,48,346,5560
subtest24of10,pubtest290of100,1,323,5166,52,382,5600
subtest24of10,pubtest291of100,1,323,5332,11,41,5384
subtest27of10,pubtest291of100,1,323,5332,18,73,5423
subtest23of10,pubtest291of100,1,323,5332,18,113,5463
subtest28of10,pubtest291of100,1,323,5332,22,150,5504
subtest21of10,pubtest291of100,1,323,5332,24,187,5543
subtest25of10,pubtest291of100,1,323,5332,25,226,5583
subtest29of10,pubtest291of100,1,323,5332,26,266,5624
subtest22of10,pubtest291of100,1,323,5332,26,305,5663
subtest210of10,pubtest291of100,1,323,5332,27,345,5704
subtest26of10,pubtest291of100,1,323,5332,28,384,5744
subtest29of10,pubtest292of100,1,323,5270,13,40,5323
subtest28of10,pubtest292of100,1,323,5270,15,77,5362
subtest21of10,pubtest292of100,1,323,5270,15,116,5401
subtest26of10,pubtest292of100,1,323,5270,16,155,5441
subtest25of10,pubtest292of100,1,323,5270,18,194,5482
subtest27of10,pubtest292of100,1,323,5270,21,232,5523
subtest22of10,pubtest292of100,1,323,5270,22,270,5562
subtest24of10,pubtest292of100,1,323,5270,23,309,5602
subtest23of10,pubtest292of100,1,323,5270,24,348,5642
subtest210of10,pubtest292of100,1,323,5270,26,386,5682
subtest25of10,pubtest293of100,1,323,5192,15,41,5248
subtest24of10,pubtest293of100,1,323,5192,14,80,5286
subtest28of10,pubtest293of100,1,323,5192,23,111,5326
subtest210of10,pubtest293of100,1,323,5192,24,150,5366
subtest27of10,pubtest293of100,1,323,5192,25,189,5406
subtest26of10,pubtest293of100,1,323,5192,26,228,5446
subtest23of10,pubtest293of100,1,323,5192,23,267,5482
subtest21of10,pubtest293of100,1,323,5192,27,307,5526
subtest29of10,pubtest293of100,1,323,5192,29,346,5567
subtest22of10,pubtest293of100,1,323,5192,34,378,5604
subtest21of10,pubtest294of100,1,323,5671,12,41,5724
subtest25of10,pubtest294of100,1,323,5671,12,80,5763
subtest27of10,pubtest294of100,1,323,5671,14,118,5803
subtest29of10,pubtest294of100,1,323,5671,14,156,5841
subtest210of10,pubtest294of100,1,323,5671,16,196,5883
subtest26of10,pubtest294of100,1,323,5671,15,235,5921
subtest23of10,pubtest294of100,1,323,5671,16,272,5959
subtest24of10,pubtest294of100,1,323,5671,17,311,5999
subtest22of10,pubtest294of100,1,323,5671,16,351,6038
subtest28of10,pubtest294of100,1,323,5671,42,370,6083
subtest25of10,pubtest295of100,1,323,5253,18,40,5311
subtest24of10,pubtest295of100,1,323,5253,18,79,5350
subtest23of10,pubtest295of100,1,323,5253,20,117,5390
subtest26of10,pubtest295of100,1,323,5253,38,467,5758
subtest22of10,pubtest295of100,1,323,5253,20,157,5430
subtest27of10,pubtest295of100,1,323,5253,23,194,5470
subtest210of10,pubtest295of100,1,323,5253,28,229,5510
subtest21of10,pubtest295of100,1,323,5253,36,261,5550
subtest29of10,pubtest295of100,1,323,5253,37,300,5590
subtest28of10,pubtest295of100,1,323,5253,39,502,5794
subtest25of10,pubtest296of100,1,322,5565,9,39,5613
subtest24of10,pubtest296of100,1,322,5565,10,78,5653
subtest27of10,pubtest296of100,1,322,5565,11,117,5693
subtest26of10,pubtest296of100,1,322,5565,13,155,5733
subtest23of10,pubtest296of100,1,322,5565,16,191,5772
subtest29of10,pubtest296of100,1,322,5565,19,230,5814
subtest21of10,pubtest296of100,1,322,5565,22,266,5853
subtest28of10,pubtest296of100,1,322,5565,22,306,5893
subtest210of10,pubtest296of100,1,322,5565,24,344,5933
subtest22of10,pubtest296of100,1,322,5565,46,362,5973
subtest25of10,pubtest297of100,1,323,5481,14,39,5534
subtest210of10,pubtest297of100,1,323,5481,15,77,5573
subtest23of10,pubtest297of100,1,323,5481,18,113,5612
subtest26of10,pubtest297of100,1,323,5481,19,153,5653
subtest27of10,pubtest297of100,1,323,5481,20,192,5693
subtest28of10,pubtest297of100,1,323,5481,21,231,5733
subtest24of10,pubtest297of100,1,323,5481,22,270,5773
subtest22of10,pubtest297of100,1,323,5481,17,310,5808
subtest29of10,pubtest297of100,1,323,5481,16,354,5851
subtest21of10,pubtest297of100,1,323,5481,23,389,5893
subtest29of10,pubtest298of100,1,323,5197,11,96,5304
subtest21of10,pubtest298of100,1,323,5197,15,135,5347
subtest210of10,pubtest298of100,1,323,5197,16,173,5386
subtest24of10,pubtest298of100,1,323,5197,13,216,5426
subtest22of10,pubtest298of100,1,323,5197,14,255,5466
subtest25of10,pubtest298of100,1,323,5197,16,293,5506
subtest23of10,pubtest298of100,1,323,5197,17,332,5546
subtest27of10,pubtest298of100,1,323,5197,36,355,5588
subtest28of10,pubtest298of100,1,323,5197,40,390,5627
subtest26of10,pubtest298of100,1,323,5197,41,428,5666
subtest22of10,pubtest299of100,1,323,5173,16,40,5229
subtest29of10,pubtest299of100,1,323,5173,16,81,5270
subtest27of10,pubtest299of100,1,323,5173,17,119,5309
subtest210of10,pubtest299of100,1,323,5173,21,154,5348
subtest24of10,pubtest299of100,1,323,5173,29,186,5388
subtest28of10,pubtest299of100,1,323,5173,30,225,5428
subtest25of10,pubtest299of100,1,323,5173,31,264,5468
subtest23of10,pubtest299of100,1,323,5173,29,304,5506
subtest21of10,pubtest299of100,1,323,5173,33,342,5548
subtest26of10,pubtest299of100,1,323,5173,33,382,5588
subtest24of10,pubtest2100of100,1,325,5211,19,42,5272
subtest21of10,pubtest2100of100,1,325,5211,19,82,5312
subtest29of10,pubtest2100of100,1,325,5211,20,120,5351
subtest22of10,pubtest2100of100,1,325,5211,22,158,5391
subtest23of10,pubtest2100of100,1,325,5211,24,196,5431
subtest25of10,pubtest2100of100,1,325,5211,25,234,5470
subtest27of10,pubtest2100of100,1,325,5211,25,274,5510
subtest28of10,pubtest2100of100,1,325,5211,39,301,5551
subtest210of10,pubtest2100of100,1,325,5211,42,338,5591
subtest26of10,pubtest2100of100,1,325,5211,71,349,5631
subtest26of10,pubtest21of100,10,1484,11578,17,41,11636
subtest27of10,pubtest21of100,10,1484,11578,19,79,11676
subtest29of10,pubtest21of100,10,1484,11578,25,113,11716
subtest24of10,pubtest21of100,10,1484,11578,30,147,11755
subtest25of10,pubtest21of100,10,1484,11578,32,185,11795
subtest21of10,pubtest21of100,10,1484,11578,42,216,11836
subtest210of10,pubtest21of100,10,1484,11578,47,251,11876
subtest28of10,pubtest21of100,10,1484,11578,48,289,11915
subtest22of10,pubtest21of100,10,1484,11578,52,326,11956
subtest23of10,pubtest21of100,10,1484,11578,76,342,11996
subtest29of10,pubtest22of100,10,1483,6185,19,39,6243
subtest27of10,pubtest22of100,10,1483,6185,21,78,6284
subtest24of10,pubtest22of100,10,1483,6185,25,114,6324
subtest28of10,pubtest22of100,10,1483,6185,27,152,6364
subtest23of10,pubtest22of100,10,1483,6185,29,190,6404
subtest25of10,pubtest22of100,10,1483,6185,31,226,6442
subtest21of10,pubtest22of100,10,1483,6185,33,265,6483
subtest26of10,pubtest22of100,10,1483,6185,34,304,6523
subtest210of10,pubtest22of100,10,1483,6185,38,340,6563
subtest22of10,pubtest22of100,10,1483,6185,43,376,6604
subtest25of10,pubtest23of100,10,1483,5487,187,41,5715
subtest210of10,pubtest23of100,10,1483,5487,185,83,5755
subtest23of10,pubtest23of100,10,1483,5487,185,123,5795
subtest21of10,pubtest23of100,10,1483,5487,187,161,5835
subtest27of10,pubtest23of100,10,1483,5487,188,200,5875
subtest22of10,pubtest23of100,10,1483,5487,188,239,5914
subtest24of10,pubtest23of100,10,1483,5487,190,278,5955
subtest26of10,pubtest23of100,10,1483,5487,190,318,5995
subtest28of10,pubtest23of100,10,1483,5487,192,355,6034
subtest29of10,pubtest23of100,10,1483,5487,194,394,6075
subtest23of10,pubtest24of100,10,1483,5329,38,451,5818
subtest25of10,pubtest24of100,10,1483,5329,41,486,5856
subtest21of10,pubtest24of100,10,1483,5329,56,513,5898
subtest24of10,pubtest24of100,10,1483,5329,56,553,5938
subtest29of10,pubtest24of100,10,1483,5329,64,584,5977
subtest28of10,pubtest24of100,10,1483,5329,66,623,6018
subtest27of10,pubtest24of100,10,1483,5329,69,660,6058
subtest22of10,pubtest24of100,10,1483,5329,70,698,6097
subtest210of10,pubtest24of100,10,1483,5329,71,738,6138
subtest26of10,pubtest24of100,10,1483,5329,72,777,6178
subtest28of10,pubtest25of100,10,1483,5369,21,41,5431
subtest21of10,pubtest25of100,10,1483,5369,23,79,5471
subtest210of10,pubtest25of100,10,1483,5369,23,118,5510
subtest26of10,pubtest25of100,10,1483,5369,27,155,5551
subtest27of10,pubtest25of100,10,1483,5369,28,193,5590
subtest22of10,pubtest25of100,10,1483,5369,44,217,5630
subtest25of10,pubtest25of100,10,1483,5369,51,251,5671
subtest23of10,pubtest25of100,10,1483,5369,53,289,5711
subtest29of10,pubtest25of100,10,1483,5369,59,323,5751
subtest24of10,pubtest25of100,10,1483,5369,59,363,5791
subtest21of10,pubtest26of100,10,1483,5410,15,40,5465
subtest22of10,pubtest26of100,10,1483,5410,19,76,5505
subtest29of10,pubtest26of100,10,1483,5410,21,114,5545
subtest23of10,pubtest26of100,10,1483,5410,24,150,5584
subtest26of10,pubtest26of100,10,1483,5410,35,180,5625
subtest210of10,pubtest26of100,10,1483,5410,38,217,5665
subtest27of10,pubtest26of100,10,1483,5410,39,256,5705
subtest28of10,pubtest26of100,10,1483,5410,42,293,5745
subtest25of10,pubtest26of100,10,1483,5410,43,331,5784
subtest24of10,pubtest26of100,10,1483,5410,46,369,5825
subtest27of10,pubtest27of100,10,1482,5283,16,43,5342
subtest28of10,pubtest27of100,10,1482,5283,26,74,5383
subtest23of10,pubtest27of100,10,1482,5283,28,112,5423
subtest24of10,pubtest27of100,10,1482,5283,33,147,5463
subtest210of10,pubtest27of100,10,1482,5283,34,186,5503
subtest29of10,pubtest27of100,10,1482,5283,40,220,5543
subtest25of10,pubtest27of100,10,1482,5283,41,258,5582
subtest21of10,pubtest27of100,10,1482,5283,49,291,5623
subtest22of10,pubtest27of100,10,1482,5283,50,328,5661
subtest26of10,pubtest27of100,10,1482,5283,53,366,5702
subtest27of10,pubtest28of100,10,1481,5288,13,41,5342
subtest28of10,pubtest28of100,10,1481,5288,20,75,5383
subtest21of10,pubtest28of100,10,1481,5288,21,113,5422
subtest29of10,pubtest28of100,10,1481,5288,22,152,5462
subtest23of10,pubtest28of100,10,1481,5288,49,165,5502
subtest210of10,pubtest28of100,10,1481,5288,51,203,5542
subtest25of10,pubtest28of100,10,1481,5288,52,242,5582
subtest26of10,pubtest28of100,10,1481,5288,60,272,5620
subtest22of10,pubtest28of100,10,1481,5288,64,310,5662
subtest24of10,pubtest28of100,10,1481,5288,63,350,5701
subtest23of10,pubtest29of100,10,1483,5662,106,40,5808
subtest210of10,pubtest29of100,10,1483,5662,107,79,5848
subtest29of10,pubtest29of100,10,1483,5662,109,117,5888
subtest22of10,pubtest29of100,10,1483,5662,110,156,5928
subtest25of10,pubtest29of100,10,1483,5662,144,162,5968
subtest28of10,pubtest29of100,10,1483,5662,149,197,6008
subtest24of10,pubtest29of100,10,1483,5662,150,236,6048
subtest21of10,pubtest29of100,10,1483,5662,153,271,6086
subtest27of10,pubtest29of100,10,1483,5662,155,311,6128
subtest26of10,pubtest29of100,10,1483,5662,157,349,6168
subtest29of10,pubtest210of100,10,1494,5334,15,38,5387
subtest21of10,pubtest210of100,10,1494,5334,23,70,5427
subtest27of10,pubtest210of100,10,1494,5334,24,108,5466
subtest210of10,pubtest210of100,10,1494,5334,30,143,5507
subtest28of10,pubtest210of100,10,1494,5334,35,178,5547
subtest24of10,pubtest210of100,10,1494,5334,39,213,5586
subtest23of10,pubtest210of100,10,1494,5334,38,253,5625
subtest25of10,pubtest210of100,10,1494,5334,42,291,5667
subtest22of10,pubtest210of100,10,1494,5334,43,329,5706
subtest26of10,pubtest210of100,10,1494,5334,45,368,5747
subtest210of10,pubtest211of100,10,1493,5260,17,43,5320
subtest24of10,pubtest211of100,10,1493,5260,44,55,5359
subtest29of10,pubtest211of100,10,1493,5260,44,94,5398
subtest22of10,pubtest211of100,10,1493,5260,46,133,5439
subtest21of10,pubtest211of100,10,1493,5260,47,172,5479
subtest26of10,pubtest211of100,10,1493,5260,49,210,5519
subtest25of10,pubtest211of100,10,1493,5260,52,246,5558
subtest23of10,pubtest211of100,10,1493,5260,53,286,5599
subtest28of10,pubtest211of100,10,1493,5260,55,324,5639
subtest27of10,pubtest211of100,10,1493,5260,55,364,5679
subtest25of10,pubtest212of100,10,1492,5419,16,43,5478
subtest28of10,pubtest212of100,10,1492,5419,27,71,5517
subtest29of10,pubtest212of100,10,1492,5419,29,108,5556
subtest24of10,pubtest212of100,10,1492,5419,30,147,5596
subtest23of10,pubtest212of100,10,1492,5419,31,185,5635
subtest22of10,pubtest212of100,10,1492,5419,42,216,5677
subtest27of10,pubtest212of100,10,1492,5419,43,255,5717
subtest21of10,pubtest212of100,10,1492,5419,46,291,5756
subtest26of10,pubtest212of100,10,1492,5419,47,330,5796
subtest210of10,pubtest212of100,10,1492,5419,48,369,5836
subtest23of10,pubtest213of100,10,1487,6621,13,40,6674
subtest29of10,pubtest213of100,10,1487,6621,15,77,6713
subtest26of10,pubtest213of100,10,1487,6621,24,111,6756
subtest27of10,pubtest213of100,10,1487,6621,28,146,6795
subtest22of10,pubtest213of100,10,1487,6621,29,185,6835
subtest24of10,pubtest213of100,10,1487,6621,35,221,6877
subtest21of10,pubtest213of100,10,1487,6621,37,258,6916
subtest210of10,pubtest213of100,10,1487,6621,46,290,6957
subtest28of10,pubtest213of100,10,1487,6621,50,326,6997
subtest25of10,pubtest213of100,10,1487,6621,52,364,7037
subtest21of10,pubtest214of100,10,1494,5444,18,41,5503
subtest23of10,pubtest214of100,10,1494,5444,28,71,5543
subtest25of10,pubtest214of100,10,1494,5444,29,109,5582
subtest26of10,pubtest214of100,10,1494,5444,33,146,5623
subtest27of10,pubtest214of100,10,1494,5444,36,183,5663
subtest29of10,pubtest214of100,10,1494,5444,36,222,5702
subtest22of10,pubtest214of100,10,1494,5444,38,261,5743
subtest210of10,pubtest214of100,10,1494,5444,48,291,5783
subtest24of10,pubtest214of100,10,1494,5444,49,329,5822
subtest28of10,pubtest214of100,10,1494,5444,52,367,5863
subtest24of10,pubtest215of100,10,1494,5594,16,40,5650
subtest27of10,pubtest215of100,10,1494,5594,19,75,5688
subtest26of10,pubtest215of100,10,1494,5594,20,115,5729
subtest210of10,pubtest215of100,10,1494,5594,23,153,5770
subtest29of10,pubtest215of100,10,1494,5594,25,191,5810
subtest21of10,pubtest215of100,10,1494,5594,33,223,5850
subtest25of10,pubtest215of100,10,1494,5594,36,261,5891
subtest22of10,pubtest215of100,10,1494,5594,35,301,5930
subtest28of10,pubtest215of100,10,1494,5594,46,329,5969
subtest23of10,pubtest215of100,10,1494,5594,56,360,6010
subtest24of10,pubtest216of100,10,1494,5295,16,39,5350
subtest21of10,pubtest216of100,10,1494,5295,17,78,5390
subtest23of10,pubtest216of100,10,1494,5295,21,115,5431
subtest27of10,pubtest216of100,10,1494,5295,22,154,5471
subtest28of10,pubtest216of100,10,1494,5295,37,178,5510
subtest22of10,pubtest216of100,10,1494,5295,41,214,5550
subtest25of10,pubtest216of100,10,1494,5295,43,252,5590
subtest26of10,pubtest216of100,10,1494,5295,44,292,5631
subtest29of10,pubtest216of100,10,1494,5295,45,331,5671
subtest210of10,pubtest216of100,10,1494,5295,48,368,5711
subtest22of10,pubtest217of100,10,1493,5378,20,40,5438
subtest27of10,pubtest217of100,10,1493,5378,20,80,5478
subtest21of10,pubtest217of100,10,1493,5378,22,118,5518
subtest26of10,pubtest217of100,10,1493,5378,23,157,5558
subtest23of10,pubtest217of100,10,1493,5378,25,194,5597
subtest24of10,pubtest217of100,10,1493,5378,28,232,5638
subtest29of10,pubtest217of100,10,1493,5378,29,271,5678
subtest25of10,pubtest217of100,10,1493,5378,36,303,5717
subtest28of10,pubtest217of100,10,1493,5378,74,305,5757
subtest210of10,pubtest217of100,10,1493,5378,75,344,5797
subtest29of10,pubtest218of100,10,1492,5323,37,42,5402
subtest22of10,pubtest218of100,10,1492,5323,39,78,5440
subtest21of10,pubtest218of100,10,1492,5323,41,116,5480
subtest28of10,pubtest218of100,10,1492,5323,48,148,5519
subtest27of10,pubtest218of100,10,1492,5323,51,186,5560
subtest23of10,pubtest218of100,10,1492,5323,52,225,5600
subtest25of10,pubtest218of100,10,1492,5323,53,263,5639
subtest24of10,pubtest218of100,10,1492,5323,55,302,5680
subtest210of10,pubtest218of100,10,1492,5323,66,331,5720
subtest26of10,pubtest218of100,10,1492,5323,67,370,5760
subtest210of10,pubtest219of100,10,1493,5212,14,44,5270
subtest25of10,pubtest219of100,10,1493,5212,17,80,5309
subtest26of10,pubtest219of100,10,1493,5212,20,117,5349
subtest22of10,pubtest219of100,10,1493,5212,22,154,5388
subtest21of10,pubtest219of100,10,1493,5212,25,192,5429
subtest24of10,pubtest219of100,10,1493,5212,41,216,5469
subtest29of10,pubtest219of100,10,1493,5212,45,251,5508
subtest23of10,pubtest219of100,10,1493,5212,46,290,5548
subtest27of10,pubtest219of100,10,1493,5212,54,323,5589
subtest28of10,pubtest219of100,10,1493,5212,56,361,5629
subtest25of10,pubtest220of100,10,1492,5252,13,43,5308
subtest23of10,pubtest220of100,10,1492,5252,15,79,5346
subtest29of10,pubtest220of100,10,1492,5252,32,102,5386
subtest210of10,pubtest220of100,10,1492,5252,41,133,5426
subtest21of10,pubtest220of100,10,1492,5252,45,169,5466
subtest24of10,pubtest220of100,10,1492,5252,46,208,5506
subtest27of10,pubtest220of100,10,1492,5252,47,247,5546
subtest28of10,pubtest220of100,10,1492,5252,53,281,5586
subtest26of10,pubtest220of100,10,1492,5252,54,320,5626
subtest22of10,pubtest220of100,10,1492,5252,56,356,5664
subtest24of10,pubtest221of100,10,1493,5269,22,40,5331
subtest21of10,pubtest221of100,10,1493,5269,24,78,5371
subtest28of10,pubtest221of100,10,1493,5269,30,110,5409
subtest22of10,pubtest221of100,10,1493,5269,31,150,5450
subtest23of10,pubtest221of100,10,1493,5269,35,186,5490
subtest210of10,pubtest221of100,10,1493,5269,39,222,5530
subtest25of10,pubtest221of100,10,1493,5269,43,258,5570
subtest29of10,pubtest221of100,10,1493,5269,95,246,5610
subtest26of10,pubtest221of100,10,1493,5269,96,283,5648
subtest27of10,pubtest221of100,10,1493,5269,98,322,5689
subtest21of10,pubtest222of100,10,1494,5234,16,48,5298
subtest27of10,pubtest222of100,10,1494,5234,21,83,5338
subtest22of10,pubtest222of100,10,1494,5234,18,125,5377
subtest29of10,pubtest222of100,10,1494,5234,23,161,5418
subtest23of10,pubtest222of100,10,1494,5234,28,196,5458
subtest28of10,pubtest222of100,10,1494,5234,34,230,5498
subtest25of10,pubtest222of100,10,1494,5234,36,268,5538
subtest210of10,pubtest222of100,10,1494,5234,37,307,5578
subtest26of10,pubtest222of100,10,1494,5234,44,339,5617
subtest24of10,pubtest222of100,10,1494,5234,46,378,5658
subtest21of10,pubtest223of100,10,1494,5421,17,42,5480
subtest28of10,pubtest223of100,10,1494,5421,18,81,5520
subtest23of10,pubtest223of100,10,1494,5421,20,119,5560
subtest24of10,pubtest223of100,10,1494,5421,24,154,5599
subtest210of10,pubtest223of100,10,1494,5421,35,184,5640
subtest29of10,pubtest223of100,10,1494,5421,36,222,5679
subtest22of10,pubtest223of100,10,1494,5421,40,258,5719
subtest27of10,pubtest223of100,10,1494,5421,38,298,5757
subtest26of10,pubtest223of100,10,1494,5421,45,333,5799
subtest25of10,pubtest223of100,10,1494,5421,46,373,5840
subtest21of10,pubtest224of100,10,1494,5319,12,43,5374
subtest27of10,pubtest224of100,10,1494,5319,28,66,5413
subtest28of10,pubtest224of100,10,1494,5319,28,105,5452
subtest23of10,pubtest224of100,10,1494,5319,30,144,5493
subtest26of10,pubtest224of100,10,1494,5319,36,178,5533
subtest29of10,pubtest224of100,10,1494,5319,37,214,5570
subtest22of10,pubtest224of100,10,1494,5319,38,254,5611
subtest25of10,pubtest224of100,10,1494,5319,42,292,5653
subtest24of10,pubtest224of100,10,1494,5319,45,329,5693
subtest210of10,pubtest224of100,10,1494,5319,51,363,5733
subtest27of10,pubtest225of100,10,1494,5312,16,42,5370
subtest22of10,pubtest225of100,10,1494,5312,25,74,5411
subtest21of10,pubtest225of100,10,1494,5312,27,112,5451
subtest26of10,pubtest225of100,10,1494,5312,28,150,5490
subtest24of10,pubtest225of100,10,1494,5312,31,187,5530
subtest23of10,pubtest225of100,10,1494,5312,40,218,5570
subtest25of10,pubtest225of100,10,1494,5312,38,258,5608
subtest210of10,pubtest225of100,10,1494,5312,42,296,5650
subtest28of10,pubtest225of100,10,1494,5312,41,335,5688
subtest29of10,pubtest225of100,10,1494,5312,41,374,5727
subtest22of10,pubtest226of100,10,1494,5563,17,42,5622
subtest25of10,pubtest226of100,10,1494,5563,20,78,5661
subtest23of10,pubtest226of100,10,1494,5563,24,115,5702
subtest27of10,pubtest226of100,10,1494,5563,27,152,5742
subtest210of10,pubtest226of100,10,1494,5563,49,168,5780
subtest21of10,pubtest226of100,10,1494,5563,51,207,5821
subtest28of10,pubtest226of100,10,1494,5563,53,245,5861
subtest29of10,pubtest226of100,10,1494,5563,54,284,5901
subtest26of10,pubtest226of100,10,1494,5563,65,314,5942
subtest24of10,pubtest226of100,10,1494,5563,65,354,5982
subtest29of10,pubtest227of100,10,1493,5354,17,40,5411
subtest210of10,pubtest227of100,10,1493,5354,21,75,5450
subtest25of10,pubtest227of100,10,1493,5354,25,111,5490
subtest23of10,pubtest227of100,10,1493,5354,26,148,5528
subtest24of10,pubtest227of100,10,1493,5354,31,185,5570
subtest26of10,pubtest227of100,10,1493,5354,35,220,5609
subtest27of10,pubtest227of100,10,1493,5354,37,259,5650
subtest22of10,pubtest227of100,10,1493,5354,42,294,5690
subtest21of10,pubtest227of100,10,1493,5354,43,333,5730
subtest28of10,pubtest227of100,10,1493,5354,70,346,5770
subtest21of10,pubtest228of100,10,1494,5303,19,42,5364
subtest26of10,pubtest228of100,10,1494,5303,22,79,5404
subtest25of10,pubtest228of100,10,1494,5303,23,116,5442
subtest23of10,pubtest228of100,10,1494,5303,26,155,5484
subtest27of10,pubtest228of100,10,1494,5303,27,194,5524
subtest24of10,pubtest228of100,10,1494,5303,37,224,5564
subtest29of10,pubtest228of100,10,1494,5303,38,263,5604
subtest210of10,pubtest228of100,10,1494,5303,75,266,5644
subtest22of10,pubtest228of100,10,1494,5303,78,303,5684
subtest28of10,pubtest228of100,10,1494,5303,80,341,5724
subtest24of10,pubtest229of100,10,1490,5285,26,38,5349
subtest28of10,pubtest229of100,10,1490,5285,33,70,5388
subtest21of10,pubtest229of100,10,1490,5285,35,109,5429
subtest22of10,pubtest229of100,10,1490,5285,36,148,5469
subtest27of10,pubtest229of100,10,1490,5285,37,186,5508
subtest210of10,pubtest229of100,10,1490,5285,39,225,5549
subtest23of10,pubtest229of100,10,1490,5285,40,263,5588
subtest26of10,pubtest229of100,10,1490,5285,41,303,5629
subtest25of10,pubtest229of100,10,1490,5285,43,341,5669
subtest29of10,pubtest229of100,10,1490,5285,45,379,5709
subtest22of10,pubtest230of100,10,1494,5350,17,267,5634
subtest21of10,pubtest230of100,10,1494,5350,21,302,5673
subtest27of10,pubtest230of100,10,1494,5350,23,340,5713
subtest28of10,pubtest230of100,10,1494,5350,26,378,5754
subtest29of10,pubtest230of100,10,1494,5350,32,412,5794
subtest210of10,pubtest230of100,10,1494,5350,43,441,5834
subtest25of10,pubtest230of100,10,1494,5350,46,477,5873
subtest24of10,pubtest230of100,10,1494,5350,54,510,5914
subtest23of10,pubtest230of100,10,1494,5350,55,549,5954
subtest26of10,pubtest230of100,10,1494,5350,56,588,5994
subtest28of10,pubtest231of100,10,1494,5372,21,39,5432
subtest23of10,pubtest231of100,10,1494,5372,29,72,5473
subtest24of10,pubtest231of100,10,1494,5372,32,109,5513
subtest25of10,pubtest231of100,10,1494,5372,42,139,5553
subtest210of10,pubtest231of100,10,1494,5372,42,178,5592
subtest26of10,pubtest231of100,10,1494,5372,47,214,5633
subtest29of10,pubtest231of100,10,1494,5372,50,251,5673
subtest22of10,pubtest231of100,10,1494,5372,51,290,5713
subtest27of10,pubtest231of100,10,1494,5372,56,325,5753
subtest21of10,pubtest231of100,10,1494,5372,75,346,5793
subtest21of10,pubtest232of100,10,1493,5383,18,40,5441
subtest27of10,pubtest232of100,10,1493,5383,27,70,5480
subtest22of10,pubtest232of100,10,1493,5383,30,108,5521
subtest23of10,pubtest232of100,10,1493,5383,31,147,5561
subtest28of10,pubtest232of100,10,1493,5383,35,184,5602
subtest29of10,pubtest232of100,10,1493,5383,36,222,5641
subtest210of10,pubtest232of100,10,1493,5383,40,258,5681
subtest25of10,pubtest232of100,10,1493,5383,44,294,5721
subtest24of10,pubtest232of100,10,1493,5383,44,333,5760
subtest26of10,pubtest232of100,10,1493,5383,49,369,5801
subtest24of10,pubtest233of100,10,1493,5387,18,46,5451
subtest29of10,pubtest233of100,10,1493,5387,20,84,5491
subtest25of10,pubtest233of100,10,1493,5387,22,122,5531
subtest210of10,pubtest233of100,10,1493,5387,25,159,5571
subtest27of10,pubtest233of100,10,1493,5387,27,197,5611
subtest26of10,pubtest233of100,10,1493,5387,33,231,5651
subtest22of10,pubtest233of100,10,1493,5387,35,269,5691
subtest23of10,pubtest233of100,10,1493,5387,43,301,5731
subtest28of10,pubtest233of100,10,1493,5387,44,340,5771
subtest21of10,pubtest233of100,10,1493,5387,48,376,5811
subtest26of10,pubtest234of100,10,1494,5355,14,265,5634
subtest25of10,pubtest234of100,10,1494,5355,16,301,5672
subtest27of10,pubtest234of100,10,1494,5355,19,338,5712
subtest21of10,pubtest234of100,10,1494,5355,50,347,5752
subtest29of10,pubtest234of100,10,1494,5355,53,384,5792
subtest22of10,pubtest234of100,10,1494,5355,55,422,5832
subtest23of10,pubtest234of100,10,1494,5355,68,449,5872
subtest210of10,pubtest234of100,10,1494,5355,72,485,5912
subtest24of10,pubtest234of100,10,1494,5355,79,516,5950
subtest28of10,pubtest234of100,10,1494,5355,79,556,5990
subtest21of10,pubtest235of100,10,1492,5524,27,39,5590
subtest210of10,pubtest235of100,10,1492,5524,28,78,5630
subtest22of10,pubtest235of100,10,1492,5524,31,115,5670
subtest23of10,pubtest235of100,10,1492,5524,33,153,5710
subtest24of10,pubtest235of100,10,1492,5524,34,191,5749
subtest27of10,pubtest235of100,10,1492,5524,35,231,5790
subtest26of10,pubtest235of100,10,1492,5524,37,269,5830
subtest29of10,pubtest235of100,10,1492,5524,39,306,5869
subtest25of10,pubtest235of100,10,1492,5524,42,344,5910
subtest28of10,pubtest235of100,10,1492,5524,47,379,5950
subtest210of10,pubtest236of100,10,1493,5303,15,40,5358
subtest23of10,pubtest236of100,10,1493,5303,44,49,5396
subtest28of10,pubtest236of100,10,1493,5303,47,87,5437
subtest27of10,pubtest236of100,10,1493,5303,50,124,5477
subtest25of10,pubtest236of100,10,1493,5303,54,160,5517
subtest21of10,pubtest236of100,10,1493,5303,65,189,5557
subtest24of10,pubtest236of100,10,1493,5303,72,221,5596
subtest29of10,pubtest236of100,10,1493,5303,74,259,5636
subtest26of10,pubtest236of100,10,1493,5303,76,298,5677
subtest22of10,pubtest236of100,10,1493,5303,78,336,5717
subtest24of10,pubtest237of100,10,1493,5336,19,43,5398
subtest23of10,pubtest237of100,10,1493,5336,21,80,5437
subtest28of10,pubtest237of100,10,1493,5336,25,116,5477
subtest25of10,pubtest237of100,10,1493,5336,29,152,5517
subtest27of10,pubtest237of100,10,1493,5336,31,190,5557
subtest21of10,pubtest237of100,10,1493,5336,34,226,5596
subtest26of10,pubtest237of100,10,1493,5336,40,261,5637
subtest29of10,pubtest237of100,10,1493,5336,42,299,5677
subtest22of10,pubtest237of100,10,1493,5336,45,336,5717
subtest210of10,pubtest237of100,10,1493,5336,45,376,5757
subtest22of10,pubtest238of100,10,1494,5442,12,44,5498
subtest29of10,pubtest238of100,10,1494,5442,20,75,5537
subtest28of10,pubtest238of100,10,1494,5442,27,108,5577
subtest27of10,pubtest238of100,10,1494,5442,29,145,5616
subtest25of10,pubtest238of100,10,1494,5442,30,182,5654
subtest210of10,pubtest238of100,10,1494,5442,33,222,5697
subtest23of10,pubtest238of100,10,1494,5442,36,259,5737
subtest26of10,pubtest238of100,10,1494,5442,38,297,5777
subtest21of10,pubtest238of100,10,1494,5442,38,337,5817
subtest24of10,pubtest238of100,10,1494,5442,50,364,5856
subtest21of10,pubtest239of100,10,1492,5405,16,200,5621
subtest28of10,pubtest239of100,10,1492,5405,18,239,5662
subtest27of10,pubtest239of100,10,1492,5405,21,276,5702
subtest26of10,pubtest239of100,10,1492,5405,57,280,5742
subtest25of10,pubtest239of100,10,1492,5405,58,318,5781
subtest29of10,pubtest239of100,10,1492,5405,61,356,5822
subtest24of10,pubtest239of100,10,1492,5405,63,394,5862
subtest23of10,pubtest239of100,10,1492,5405,65,431,5901
subtest22of10,pubtest239of100,10,1492,5405,66,470,5941
subtest210of10,pubtest239of100,10,1492,5405,68,509,5982
subtest25of10,pubtest240of100,10,1494,5299,11,44,5354
subtest21of10,pubtest240of100,10,1494,5299,25,67,5391
subtest210of10,pubtest240of100,10,1494,5299,38,94,5431
subtest29of10,pubtest240of100,10,1494,5299,39,132,5470
subtest28of10,pubtest240of100,10,1494,5299,40,172,5511
subtest27of10,pubtest240of100,10,1494,5299,42,210,5551
subtest23of10,pubtest240of100,10,1494,5299,42,250,5591
subtest24of10,pubtest240of100,10,1494,5299,45,286,5630
subtest22of10,pubtest240of100,10,1494,5299,45,326,5670
subtest26of10,pubtest240of100,10,1494,5299,47,364,5710
subtest23of10,pubtest241of100,10,1493,5447,25,70,5542
subtest210of10,pubtest241of100,10,1493,5447,29,105,5581
subtest27of10,pubtest241of100,10,1493,5447,31,143,5621
subtest24of10,pubtest241of100,10,1493,5447,32,182,5661
subtest21of10,pubtest241of100,10,1493,5447,67,187,5701
subtest28of10,pubtest241of100,10,1493,5447,68,226,5741
subtest29of10,pubtest241of100,10,1493,5447,71,263,5781
subtest25of10,pubtest241of100,10,1493,5447,76,298,5821
subtest26of10,pubtest241of100,10,1493,5447,78,336,5861
subtest22of10,pubtest241of100,10,1493,5447,79,374,5900
subtest27of10,pubtest242of100,10,1494,5217,17,39,5273
subtest23of10,pubtest242of100,10,1494,5217,25,71,5313
subtest26of10,pubtest242of100,10,1494,5217,26,110,5353
subtest210of10,pubtest242of100,10,1494,5217,28,148,5393
subtest22of10,pubtest242of100,10,1494,5217,30,186,5433
subtest25of10,pubtest242of100,10,1494,5217,52,204,5473
subtest29of10,pubtest242of100,10,1494,5217,55,241,5513
subtest24of10,pubtest242of100,10,1494,5217,58,278,5553
subtest21of10,pubtest242of100,10,1494,5217,60,316,5593
subtest28of10,pubtest242of100,10,1494,5217,60,356,5633
subtest29of10,pubtest243of100,10,1493,5711,17,79,5807
subtest28of10,pubtest243of100,10,1493,5711,19,119,5849
subtest22of10,pubtest243of100,10,1493,5711,20,158,5889
subtest23of10,pubtest243of100,10,1493,5711,23,196,5930
subtest26of10,pubtest243of100,10,1493,5711,47,211,5969
subtest25of10,pubtest243of100,10,1493,5711,47,250,6008
subtest24of10,pubtest243of100,10,1493,5711,49,289,6049
subtest27of10,pubtest243of100,10,1493,5711,50,328,6089
subtest21of10,pubtest243of100,10,1493,5711,53,365,6129
subtest210of10,pubtest243of100,10,1493,5711,54,404,6169
subtest27of10,pubtest244of100,10,1494,5598,21,161,5780
subtest25of10,pubtest244of100,10,1494,5598,32,191,5821
subtest26of10,pubtest244of100,10,1494,5598,34,229,5861
subtest29of10,pubtest244of100,10,1494,5598,36,267,5901
subtest28of10,pubtest244of100,10,1494,5598,41,301,5940
subtest21of10,pubtest244of100,10,1494,5598,42,340,5980
subtest23of10,pubtest244of100,10,1494,5598,47,375,6020
subtest210of10,pubtest244of100,10,1494,5598,48,415,6061
subtest22of10,pubtest244of100,10,1494,5598,51,452,6101
subtest24of10,pubtest244of100,10,1494,5598,55,486,6139
subtest29of10,pubtest245of100,10,1492,5305,26,46,5377
subtest26of10,pubtest245of100,10,1492,5305,28,83,5416
subtest22of10,pubtest245of100,10,1492,5305,30,122,5457
subtest23of10,pubtest245of100,10,1492,5305,31,161,5497
subtest25of10,pubtest245of100,10,1492,5305,33,199,5537
subtest24of10,pubtest245of100,10,1492,5305,57,215,5577
subtest21of10,pubtest245of100,10,1492,5305,58,254,5617
subtest28of10,pubtest245of100,10,1492,5305,62,290,5657
subtest27of10,pubtest245of100,10,1492,5305,67,325,5697
subtest210of10,pubtest245of100,10,1492,5305,69,363,5737
subtest26of10,pubtest246of100,10,1494,5554,21,39,5614
subtest27of10,pubtest246of100,10,1494,5554,23,77,5654
subtest21of10,pubtest246of100,10,1494,5554,28,112,5694
subtest28of10,pubtest246of100,10,1494,5554,31,149,5734
subtest29of10,pubtest246of100,10,1494,5554,32,188,5774
subtest210of10,pubtest246of100,10,1494,5554,33,226,5813
subtest24of10,pubtest246of100,10,1494,5554,38,262,5854
subtest23of10,pubtest246of100,10,1494,5554,35,302,5891
subtest25of10,pubtest246of100,10,1494,5554,39,340,5933
subtest22of10,pubtest246of100,10,1494,5554,41,379,5974
subtest26of10,pubtest247of100,10,1494,5659,16,57,5732
subtest23of10,pubtest247of100,10,1494,5659,19,94,5772
subtest22of10,pubtest247of100,10,1494,5659,26,127,5812
subtest28of10,pubtest247of100,10,1494,5659,27,166,5852
subtest27of10,pubtest247of100,10,1494,5659,14,219,5892
subtest21of10,pubtest247of100,10,1494,5659,35,199,5893
subtest25of10,pubtest247of100,10,1494,5659,76,237,5972
subtest210of10,pubtest247of100,10,1494,5659,76,276,6011
subtest24of10,pubtest247of100,10,1494,5659,77,315,6051
subtest29of10,pubtest247of100,10,1494,5659,78,355,6092
subtest29of10,pubtest248of100,10,1494,5810,15,39,5864
subtest26of10,pubtest248of100,10,1494,5810,18,76,5904
subtest25of10,pubtest248of100,10,1494,5810,20,114,5944
subtest23of10,pubtest248of100,10,1494,5810,28,146,5984
subtest28of10,pubtest248of100,10,1494,5810,36,177,6023
subtest27of10,pubtest248of100,10,1494,5810,44,210,6064
subtest24of10,pubtest248of100,10,1494,5810,45,248,6103
subtest21of10,pubtest248of100,10,1494,5810,46,288,6144
subtest22of10,pubtest248of100,10,1494,5810,48,326,6184
subtest210of10,pubtest248of100,10,1494,5810,50,364,6224
subtest27of10,pubtest249of100,10,1494,5334,20,41,5395
subtest28of10,pubtest249of100,10,1494,5334,22,78,5434
subtest25of10,pubtest249of100,10,1494,5334,25,113,5472
subtest24of10,pubtest249of100,10,1494,5334,28,152,5514
subtest21of10,pubtest249of100,10,1494,5334,28,192,5554
subtest26of10,pubtest249of100,10,1494,5334,30,230,5594
subtest29of10,pubtest249of100,10,1494,5334,32,268,5634
subtest23of10,pubtest249of100,10,1494,5334,56,467,5857
subtest22of10,pubtest249of100,10,1494,5334,57,502,5893
subtest210of10,pubtest249of100,10,1494,5334,59,540,5933
subtest27of10,pubtest250of100,10,1494,5904,18,41,5963
subtest28of10,pubtest250of100,10,1494,5904,20,77,6001
subtest23of10,pubtest250of100,10,1494,5904,23,116,6043
subtest29of10,pubtest250of100,10,1494,5904,25,154,6083
subtest21of10,pubtest250of100,10,1494,5904,26,193,6123
subtest24of10,pubtest250of100,10,1494,5904,51,208,6163
subtest25of10,pubtest250of100,10,1494,5904,52,246,6202
subtest210of10,pubtest250of100,10,1494,5904,59,280,6243
subtest26of10,pubtest250of100,10,1494,5904,65,314,6283
subtest22of10,pubtest250of100,10,1494,5904,67,352,6323
subtest23of10,pubtest251of100,10,1494,5279,15,41,5335
subtest22of10,pubtest251of100,10,1494,5279,21,75,5375
subtest24of10,pubtest251of100,10,1494,5279,29,106,5414
subtest27of10,pubtest251of100,10,1494,5279,39,137,5455
subtest28of10,pubtest251of100,10,1494,5279,40,176,5495
subtest25of10,pubtest251of100,10,1494,5279,41,215,5535
subtest21of10,pubtest251of100,10,1494,5279,46,250,5575
subtest210of10,pubtest251of100,10,1494,5279,48,288,5615
subtest29of10,pubtest251of100,10,1494,5279,48,328,5655
subtest26of10,pubtest251of100,10,1494,5279,50,365,5694
subtest29of10,pubtest252of100,10,1491,5612,34,41,5687
subtest28of10,pubtest252of100,10,1491,5612,37,77,5726
subtest21of10,pubtest252of100,10,1491,5612,39,116,5767
subtest27of10,pubtest252of100,10,1491,5612,40,155,5807
subtest26of10,pubtest252of100,10,1491,5612,57,178,5847
subtest25of10,pubtest252of100,10,1491,5612,59,216,5887
subtest23of10,pubtest252of100,10,1491,5612,64,251,5927
subtest22of10,pubtest252of100,10,1491,5612,64,291,5967
subtest24of10,pubtest252of100,10,1491,5612,86,309,6007
subtest210of10,pubtest252of100,10,1491,5612,88,347,6047
subtest28of10,pubtest253of100,10,1492,5728,27,40,5795
subtest23of10,pubtest253of100,10,1492,5728,32,75,5835
subtest24of10,pubtest253of100,10,1492,5728,37,110,5875
subtest25of10,pubtest253of100,10,1492,5728,38,148,5914
subtest22of10,pubtest253of100,10,1492,5728,40,187,5955
subtest210of10,pubtest253of100,10,1492,5728,41,226,5995
subtest29of10,pubtest253of100,10,1492,5728,42,265,6035
subtest27of10,pubtest253of100,10,1492,5728,46,301,6075
subtest26of10,pubtest253of100,10,1492,5728,47,340,6115
subtest21of10,pubtest253of100,10,1492,5728,48,377,6153
subtest27of10,pubtest254of100,10,1491,5817,15,40,5872
subtest210of10,pubtest254of100,10,1491,5817,28,68,5913
subtest21of10,pubtest254of100,10,1491,5817,33,103,5953
subtest28of10,pubtest254of100,10,1491,5817,34,141,5992
subtest25of10,pubtest254of100,10,1491,5817,35,181,6033
subtest23of10,pubtest254of100,10,1491,5817,37,219,6073
subtest29of10,pubtest254of100,10,1491,5817,40,256,6113
subtest24of10,pubtest254of100,10,1491,5817,41,294,6152
subtest26of10,pubtest254of100,10,1491,5817,45,331,6193
subtest22of10,pubtest254of100,10,1491,5817,45,371,6233
subtest23of10,pubtest255of100,10,1492,5571,30,39,5640
subtest22of10,pubtest255of100,10,1492,5571,31,77,5679
subtest28of10,pubtest255of100,10,1492,5571,34,115,5720
subtest27of10,pubtest255of100,10,1492,5571,35,154,5760
subtest29of10,pubtest255of100,10,1492,5571,36,192,5799
subtest24of10,pubtest255of100,10,1492,5571,37,230,5838
subtest210of10,pubtest255of100,10,1492,5571,42,267,5880
subtest21of10,pubtest255of100,10,1492,5571,42,306,5919
subtest25of10,pubtest255of100,10,1492,5571,44,345,5960
subtest26of10,pubtest255of100,10,1492,5571,45,384,6000
subtest29of10,pubtest256of100,10,1493,5269,18,43,5330
subtest21of10,pubtest256of100,10,1493,5269,35,64,5368
subtest23of10,pubtest256of100,10,1493,5269,37,102,5408
subtest26of10,pubtest256of100,10,1493,5269,41,138,5448
subtest210of10,pubtest256of100,10,1493,5269,70,147,5486
subtest25of10,pubtest256of100,10,1493,5269,73,186,5528
subtest27of10,pubtest256of100,10,1493,5269,75,224,5568
subtest28of10,pubtest256of100,10,1493,5269,76,263,5608
subtest22of10,pubtest256of100,10,1493,5269,78,301,5648
subtest24of10,pubtest256of100,10,1493,5269,98,320,5687
subtest24of10,pubtest257of100,10,1488,5366,21,41,5428
subtest21of10,pubtest257of100,10,1488,5366,23,79,5468
subtest27of10,pubtest257of100,10,1488,5366,25,117,5508
subtest28of10,pubtest257of100,10,1488,5366,29,152,5547
subtest23of10,pubtest257of100,10,1488,5366,31,191,5588
subtest22of10,pubtest257of100,10,1488,5366,32,230,5628
subtest29of10,pubtest257of100,10,1488,5366,44,258,5668
subtest210of10,pubtest257of100,10,1488,5366,49,293,5708
subtest25of10,pubtest257of100,10,1488,5366,51,331,5748
subtest26of10,pubtest257of100,10,1488,5366,77,345,5788
subtest23of10,pubtest258of100,10,1492,5888,14,40,5942
subtest25of10,pubtest258of100,10,1492,5888,21,72,5981
subtest28of10,pubtest258of100,10,1492,5888,23,112,6023
subtest21of10,pubtest258of100,10,1492,5888,26,149,6063
subtest29of10,pubtest258of100,10,1492,5888,49,166,6103
subtest26of10,pubtest258of100,10,1492,5888,51,204,6143
subtest27of10,pubtest258of100,10,1492,5888,60,235,6183
subtest210of10,pubtest258of100,10,1492,5888,63,272,6223
subtest22of10,pubtest258of100,10,1492,5888,64,311,6263
subtest24of10,pubtest258of100,10,1492,5888,67,348,6303
subtest21of10,pubtest259of100,10,1493,5255,15,42,5312
subtest28of10,pubtest259of100,10,1493,5255,20,76,5351
subtest25of10,pubtest259of100,10,1493,5255,22,115,5392
subtest24of10,pubtest259of100,10,1493,5255,24,153,5432
subtest26of10,pubtest259of100,10,1493,5255,26,191,5472
subtest22of10,pubtest259of100,10,1493,5255,36,221,5512
subtest27of10,pubtest259of100,10,1493,5255,36,261,5552
subtest23of10,pubtest259of100,10,1493,5255,41,296,5592
subtest210of10,pubtest259of100,10,1493,5255,43,334,5632
subtest29of10,pubtest259of100,10,1493,5255,44,373,5672
subtest210of10,pubtest260of100,10,1491,5259,11,40,5310
subtest23of10,pubtest260of100,10,1491,5259,13,77,5349
subtest26of10,pubtest260of100,10,1491,5259,21,108,5388
subtest22of10,pubtest260of100,10,1491,5259,25,145,5429
subtest21of10,pubtest260of100,10,1491,5259,25,184,5468
subtest27of10,pubtest260of100,10,1491,5259,29,221,5509
subtest28of10,pubtest260of100,10,1491,5259,61,228,5548
subtest29of10,pubtest260of100,10,1491,5259,65,265,5589
subtest25of10,pubtest260of100,10,1491,5259,76,294,5629
subtest24of10,pubtest260of100,10,1491,5259,78,331,5668
subtest25of10,pubtest261of100,10,1494,5241,16,40,5297
subtest28of10,pubtest261of100,10,1494,5241,18,76,5335
subtest29of10,pubtest261of100,10,1494,5241,24,110,5375
subtest210of10,pubtest261of100,10,1494,5241,33,141,5415
subtest22of10,pubtest261of100,10,1494,5241,34,179,5454
subtest23of10,pubtest261of100,10,1494,5241,35,218,5494
subtest24of10,pubtest261of100,10,1494,5241,38,256,5535
subtest27of10,pubtest261of100,10,1494,5241,43,291,5575
subtest21of10,pubtest261of100,10,1494,5241,47,325,5613
subtest26of10,pubtest261of100,10,1494,5241,49,364,5654
subtest22of10,pubtest262of100,10,1494,5551,13,41,5605
subtest21of10,pubtest262of100,10,1494,5551,21,74,5646
subtest23of10,pubtest262of100,10,1494,5551,22,113,5686
subtest26of10,pubtest262of100,10,1494,5551,31,144,5726
subtest27of10,pubtest262of100,10,1494,5551,35,180,5766
subtest29of10,pubtest262of100,10,1494,5551,36,219,5806
subtest25of10,pubtest262of100,10,1494,5551,41,253,5845
subtest210of10,pubtest262of100,10,1494,5551,43,291,5885
subtest24of10,pubtest262of100,10,1494,5551,53,322,5926
subtest28of10,pubtest262of100,10,1494,5551,54,361,5966
subtest22of10,pubtest263of100,10,1492,5380,19,47,5446
subtest24of10,pubtest263of100,10,1492,5380,23,82,5485
subtest29of10,pubtest263of100,10,1492,5380,24,120,5524
subtest23of10,pubtest263of100,10,1492,5380,26,159,5565
subtest26of10,pubtest263of100,10,1492,5380,40,185,5605
subtest210of10,pubtest263of100,10,1492,5380,44,219,5643
subtest28of10,pubtest263of100,10,1492,5380,46,259,5685
subtest25of10,pubtest263of100,10,1492,5380,48,297,5725
subtest27of10,pubtest263of100,10,1492,5380,83,302,5765
subtest21of10,pubtest263of100,10,1492,5380,84,340,5804
subtest22of10,pubtest264of100,10,1493,5643,16,41,5700
subtest29of10,pubtest264of100,10,1493,5643,22,75,5740
subtest23of10,pubtest264of100,10,1493,5643,25,112,5780
subtest27of10,pubtest264of100,10,1493,5643,28,148,5819
subtest24of10,pubtest264of100,10,1493,5643,33,184,5860
subtest21of10,pubtest264of100,10,1493,5643,33,223,5899
subtest25of10,pubtest264of100,10,1493,5643,35,262,5940
subtest28of10,pubtest264of100,10,1493,5643,36,301,5980
subtest26of10,pubtest264of100,10,1493,5643,41,336,6020
subtest210of10,pubtest264of100,10,1493,5643,51,366,6060
subtest26of10,pubtest265of100,10,1492,5780,20,41,5841
subtest27of10,pubtest265of100,10,1492,5780,23,78,5881
subtest210of10,pubtest265of100,10,1492,5780,25,116,5921
subtest22of10,pubtest265of100,10,1492,5780,27,155,5962
subtest28of10,pubtest265of100,10,1492,5780,33,188,6001
subtest21of10,pubtest265of100,10,1492,5780,38,224,6042
subtest29of10,pubtest265of100,10,1492,5780,44,258,6082
subtest24of10,pubtest265of100,10,1492,5780,46,296,6122
subtest25of10,pubtest265of100,10,1492,5780,47,334,6161
subtest23of10,pubtest265of100,10,1492,5780,57,365,6202
subtest29of10,pubtest266of100,10,1490,5169,17,40,5226
subtest210of10,pubtest266of100,10,1490,5169,21,77,5267
subtest25of10,pubtest266of100,10,1490,5169,23,115,5307
subtest26of10,pubtest266of100,10,1490,5169,31,147,5347
subtest27of10,pubtest266of100,10,1490,5169,41,177,5387
subtest23of10,pubtest266of100,10,1490,5169,46,212,5427
subtest28of10,pubtest266of100,10,1490,5169,47,251,5467
subtest21of10,pubtest266of100,10,1490,5169,48,290,5507
subtest24of10,pubtest266of100,10,1490,5169,51,327,5547
subtest22of10,pubtest266of100,10,1490,5169,52,366,5587
subtest23of10,pubtest267of100,10,1493,5349,22,43,5414
subtest26of10,pubtest267of100,10,1493,5349,24,79,5452
subtest25of10,pubtest267of100,10,1493,5349,26,117,5492
subtest28of10,pubtest267of100,10,1493,5349,31,153,5533
subtest27of10,pubtest267of100,10,1493,5349,35,188,5572
subtest24of10,pubtest267of100,10,1493,5349,36,226,5611
subtest29of10,pubtest267of100,10,1493,5349,38,265,5652
subtest21of10,pubtest267of100,10,1493,5349,40,303,5692
subtest22of10,pubtest267of100,10,1493,5349,43,339,5731
subtest210of10,pubtest267of100,10,1493,5349,46,377,5772
subtest23of10,pubtest268of100,10,1492,5398,15,38,5451
subtest24of10,pubtest268of100,10,1492,5398,20,73,5491
subtest25of10,pubtest268of100,10,1492,5398,23,111,5532
subtest29of10,pubtest268of100,10,1492,5398,28,146,5572
subtest28of10,pubtest268of100,10,1492,5398,30,184,5612
subtest27of10,pubtest268of100,10,1492,5398,41,213,5652
subtest21of10,pubtest268of100,10,1492,5398,42,252,5692
subtest22of10,pubtest268of100,10,1492,5398,62,272,5732
subtest210of10,pubtest268of100,10,1492,5398,67,305,5770
subtest26of10,pubtest268of100,10,1492,5398,69,345,5812
subtest24of10,pubtest269of100,10,1494,5331,16,44,5391
subtest210of10,pubtest269of100,10,1494,5331,18,81,5430
subtest27of10,pubtest269of100,10,1494,5331,29,110,5470
subtest26of10,pubtest269of100,10,1494,5331,40,139,5510
subtest25of10,pubtest269of100,10,1494,5331,42,177,5550
subtest22of10,pubtest269of100,10,1494,5331,42,217,5590
subtest21of10,pubtest269of100,10,1494,5331,44,255,5630
subtest29of10,pubtest269of100,10,1494,5331,59,280,5670
subtest23of10,pubtest269of100,10,1494,5331,61,318,5710
subtest28of10,pubtest269of100,10,1494,5331,64,355,5750
subtest23of10,pubtest270of100,10,1494,5590,21,39,5650
subtest27of10,pubtest270of100,10,1494,5590,27,73,5690
subtest26of10,pubtest270of100,10,1494,5590,29,111,5730
subtest29of10,pubtest270of100,10,1494,5590,31,149,5770
subtest210of10,pubtest270of100,10,1494,5590,32,188,5810
subtest21of10,pubtest270of100,10,1494,5590,37,220,5847
subtest24of10,pubtest270of100,10,1494,5590,40,259,5889
subtest22of10,pubtest270of100,10,1494,5590,42,298,5930
subtest25of10,pubtest270of100,10,1494,5590,36,338,5964
subtest28of10,pubtest270of100,10,1494,5590,43,376,6009
subtest24of10,pubtest271of100,10,1494,5648,19,41,5708
subtest22of10,pubtest271of100,10,1494,5648,25,76,5749
subtest25of10,pubtest271of100,10,1494,5648,27,114,5789
subtest27of10,pubtest271of100,10,1494,5648,29,152,5829
subtest210of10,pubtest271of100,10,1494,5648,30,189,5867
subtest21of10,pubtest271of100,10,1494,5648,37,224,5909
subtest26of10,pubtest271of100,10,1494,5648,46,255,5949
subtest23of10,pubtest271of100,10,1494,5648,47,294,5989
subtest28of10,pubtest271of100,10,1494,5648,48,333,6029
subtest29of10,pubtest271of100,10,1494,5648,52,368,6068
subtest25of10,pubtest272of100,10,1494,5277,13,39,5329
subtest21of10,pubtest272of100,10,1494,5277,21,71,5369
subtest26of10,pubtest272of100,10,1494,5277,23,107,5407
subtest29of10,pubtest272of100,10,1494,5277,26,146,5449
subtest23of10,pubtest272of100,10,1494,5277,27,184,5488
subtest24of10,pubtest272of100,10,1494,5277,42,209,5528
subtest27of10,pubtest272of100,10,1494,5277,47,245,5569
subtest210of10,pubtest272of100,10,1494,5277,54,278,5609
subtest22of10,pubtest272of100,10,1494,5277,55,316,5648
subtest28of10,pubtest272of100,10,1494,5277,57,355,5689
subtest22of10,pubtest273of100,10,1488,5317,21,41,5379
subtest29of10,pubtest273of100,10,1488,5317,24,77,5418
subtest26of10,pubtest273of100,10,1488,5317,26,116,5459
subtest28of10,pubtest273of100,10,1488,5317,27,155,5499
subtest210of10,pubtest273of100,10,1488,5317,39,183,5539
subtest25of10,pubtest273of100,10,1488,5317,40,222,5579
subtest27of10,pubtest273of100,10,1488,5317,41,261,5619
subtest23of10,pubtest273of100,10,1488,5317,43,299,5659
subtest24of10,pubtest273of100,10,1488,5317,46,336,5699
subtest21of10,pubtest273of100,10,1488,5317,48,375,5740
subtest21of10,pubtest274of100,10,1493,5506,21,43,5570
subtest26of10,pubtest274of100,10,1493,5506,21,81,5608
subtest23of10,pubtest274of100,10,1493,5506,27,115,5648
subtest29of10,pubtest274of100,10,1493,5506,28,154,5688
subtest22of10,pubtest274of100,10,1493,5506,30,192,5728
subtest28of10,pubtest274of100,10,1493,5506,33,229,5768
subtest24of10,pubtest274of100,10,1493,5506,39,263,5808
subtest25of10,pubtest274of100,10,1493,5506,43,299,5848
subtest27of10,pubtest274of100,10,1493,5506,46,337,5889
subtest210of10,pubtest274of100,10,1493,5506,47,375,5928
subtest27of10,pubtest275of100,10,1494,5463,17,39,5519
subtest24of10,pubtest275of100,10,1494,5463,18,78,5559
subtest29of10,pubtest275of100,10,1494,5463,25,111,5599
subtest22of10,pubtest275of100,10,1494,5463,27,149,5639
subtest25of10,pubtest275of100,10,1494,5463,34,181,5678
subtest210of10,pubtest275of100,10,1494,5463,37,219,5719
subtest26of10,pubtest275of100,10,1494,5463,44,252,5759
subtest28of10,pubtest275of100,10,1494,5463,49,287,5799
subtest21of10,pubtest275of100,10,1494,5463,49,326,5838
subtest23of10,pubtest275of100,10,1494,5463,51,363,5877
subtest21of10,pubtest276of100,10,1494,5804,15,38,5857
subtest28of10,pubtest276of100,10,1494,5804,18,76,5898
subtest25of10,pubtest276of100,10,1494,5804,19,115,5938
subtest27of10,pubtest276of100,10,1494,5804,30,143,5977
subtest24of10,pubtest276of100,10,1494,5804,33,181,6018
subtest29of10,pubtest276of100,10,1494,5804,34,220,6058
subtest23of10,pubtest276of100,10,1494,5804,35,258,6097
subtest26of10,pubtest276of100,10,1494,5804,37,295,6136
subtest210of10,pubtest276of100,10,1494,5804,40,334,6178
subtest22of10,pubtest276of100,10,1494,5804,44,370,6218
subtest22of10,pubtest277of100,10,1491,6031,16,39,6086
subtest29of10,pubtest277of100,10,1491,6031,18,76,6125
subtest28of10,pubtest277of100,10,1491,6031,20,115,6166
subtest24of10,pubtest277of100,10,1491,6031,23,152,6206
subtest21of10,pubtest277of100,10,1491,6031,31,184,6246
subtest210of10,pubtest277of100,10,1491,6031,36,219,6286
subtest27of10,pubtest277of100,10,1491,6031,37,257,6325
subtest26of10,pubtest277of100,10,1491,6031,42,292,6365
subtest25of10,pubtest277of100,10,1491,6031,44,331,6406
subtest23of10,pubtest277of100,10,1491,6031,46,369,6446
subtest29of10,pubtest278of100,10,1493,5419,20,39,5478
subtest22of10,pubtest278of100,10,1493,5419,23,77,5519
subtest23of10,pubtest278of100,10,1493,5419,26,113,5558
subtest21of10,pubtest278of100,10,1493,5419,29,151,5599
subtest27of10,pubtest278of100,10,1493,5419,30,188,5637
subtest28of10,pubtest278of100,10,1493,5419,33,227,5679
subtest25of10,pubtest278of100,10,1493,5419,34,266,5719
subtest26of10,pubtest278of100,10,1493,5419,45,295,5759
subtest24of10,pubtest278of100,10,1493,5419,45,335,5799
subtest210of10,pubtest278of100,10,1493,5419,47,373,5839
subtest28of10,pubtest279of100,10,1494,5301,23,212,5536
subtest25of10,pubtest279of100,10,1494,5301,25,247,5573
subtest24of10,pubtest279of100,10,1494,5301,26,287,5614
subtest21of10,pubtest279of100,10,1494,5301,29,322,5652
subtest26of10,pubtest279of100,10,1494,5301,31,362,5694
subtest29of10,pubtest279of100,10,1494,5301,32,400,5733
subtest27of10,pubtest279of100,10,1494,5301,34,439,5774
subtest22of10,pubtest279of100,10,1494,5301,36,477,5814
subtest210of10,pubtest279of100,10,1494,5301,38,515,5854
subtest23of10,pubtest279of100,10,1494,5301,48,545,5894
subtest27of10,pubtest280of100,10,1494,5608,16,40,5664
subtest29of10,pubtest280of100,10,1494,5608,21,75,5704
subtest24of10,pubtest280of100,10,1494,5608,24,112,5744
subtest21of10,pubtest280of100,10,1494,5608,29,147,5784
subtest26of10,pubtest280of100,10,1494,5608,33,183,5824
subtest23of10,pubtest280of100,10,1494,5608,34,222,5864
subtest210of10,pubtest280of100,10,1494,5608,35,261,5904
subtest28of10,pubtest280of100,10,1494,5608,39,297,5944
subtest25of10,pubtest280of100,10,1494,5608,39,336,5983
subtest22of10,pubtest280of100,10,1494,5608,41,375,6024
subtest24of10,pubtest281of100,10,1494,5769,14,41,5824
subtest23of10,pubtest281of100,10,1494,5769,16,80,5865
subtest28of10,pubtest281of100,10,1494,5769,18,118,5905
subtest27of10,pubtest281of100,10,1494,5769,23,152,5944
subtest22of10,pubtest281of100,10,1494,5769,25,191,5985
subtest210of10,pubtest281of100,10,1494,5769,33,223,6025
subtest26of10,pubtest281of100,10,1494,5769,34,262,6065
subtest25of10,pubtest281of100,10,1494,5769,42,294,6105
subtest21of10,pubtest281of100,10,1494,5769,43,332,6144
subtest29of10,pubtest281of100,10,1494,5769,44,371,6184
